Game,Opponent,PlayerA_Score,PlayerB_Score,Cumulative_Score,CCs,DDs,Winner
0,QLearningPlayer,180,380,560,60,0,QLearningPlayer
1,QLearningPlayer,153,398,551,51,0,QLearningPlayer
2,QLearningPlayer,153,398,551,51,0,QLearningPlayer
3,QLearningPlayer,138,408,546,46,0,QLearningPlayer
4,QLearningPlayer,144,404,548,48,0,QLearningPlayer
5,QLearningPlayer,138,408,546,46,0,QLearningPlayer
6,QLearningPlayer,111,426,537,37,0,QLearningPlayer
7,QLearningPlayer,165,390,555,55,0,QLearningPlayer
8,QLearningPlayer,144,404,548,48,0,QLearningPlayer
9,QLearningPlayer,120,420,540,40,0,QLearningPlayer
10,QLearningPlayer,156,396,552,52,0,QLearningPlayer
11,QLearningPlayer,138,408,546,46,0,QLearningPlayer
12,QLearningPlayer,156,396,552,52,0,QLearningPlayer
13,QLearningPlayer,150,400,550,50,0,QLearningPlayer
14,QLearningPlayer,153,398,551,51,0,QLearningPlayer
15,QLearningPlayer,156,396,552,52,0,QLearningPlayer
16,QLearningPlayer,123,418,541,41,0,QLearningPlayer
17,QLearningPlayer,156,396,552,52,0,QLearningPlayer
18,QLearningPlayer,141,406,547,47,0,QLearningPlayer
19,QLearningPlayer,135,410,545,45,0,QLearningPlayer
20,QLearningPlayer,150,400,550,50,0,QLearningPlayer
21,QLearningPlayer,126,416,542,42,0,QLearningPlayer
22,QLearningPlayer,132,412,544,44,0,QLearningPlayer
23,QLearningPlayer,135,410,545,45,0,QLearningPlayer
24,QLearningPlayer,180,380,560,60,0,QLearningPlayer
25,QLearningPlayer,168,388,556,56,0,QLearningPlayer
26,QLearningPlayer,123,418,541,41,0,QLearningPlayer
27,QLearningPlayer,177,382,559,59,0,QLearningPlayer
28,QLearningPlayer,153,398,551,51,0,QLearningPlayer
29,QLearningPlayer,150,400,550,50,0,QLearningPlayer
30,QLearningPlayer,150,400,550,50,0,QLearningPlayer
31,QLearningPlayer,144,404,548,48,0,QLearningPlayer
32,QLearningPlayer,159,394,553,53,0,QLearningPlayer
33,QLearningPlayer,141,406,547,47,0,QLearningPlayer
34,QLearningPlayer,135,410,545,45,0,QLearningPlayer
35,QLearningPlayer,156,396,552,52,0,QLearningPlayer
36,QLearningPlayer,156,396,552,52,0,QLearningPlayer
37,QLearningPlayer,156,396,552,52,0,QLearningPlayer
38,QLearningPlayer,147,402,549,49,0,QLearningPlayer
39,QLearningPlayer,138,408,546,46,0,QLearningPlayer
40,QLearningPlayer,150,400,550,50,0,QLearningPlayer
41,QLearningPlayer,159,394,553,53,0,QLearningPlayer
42,QLearningPlayer,144,404,548,48,0,QLearningPlayer
43,QLearningPlayer,129,414,543,43,0,QLearningPlayer
44,QLearningPlayer,165,390,555,55,0,QLearningPlayer
45,QLearningPlayer,156,396,552,52,0,QLearningPlayer
46,QLearningPlayer,168,388,556,56,0,QLearningPlayer
47,QLearningPlayer,123,418,541,41,0,QLearningPlayer
48,QLearningPlayer,168,388,556,56,0,QLearningPlayer
49,QLearningPlayer,129,414,543,43,0,QLearningPlayer
50,QLearningPlayer,171,386,557,57,0,QLearningPlayer
51,QLearningPlayer,156,396,552,52,0,QLearningPlayer
52,QLearningPlayer,150,400,550,50,0,QLearningPlayer
53,QLearningPlayer,162,392,554,54,0,QLearningPlayer
54,QLearningPlayer,168,388,556,56,0,QLearningPlayer
55,QLearningPlayer,147,402,549,49,0,QLearningPlayer
56,QLearningPlayer,189,374,563,63,0,QLearningPlayer
57,QLearningPlayer,153,398,551,51,0,QLearningPlayer
58,QLearningPlayer,138,408,546,46,0,QLearningPlayer
59,QLearningPlayer,135,410,545,45,0,QLearningPlayer
60,QLearningPlayer,153,398,551,51,0,QLearningPlayer
61,QLearningPlayer,153,398,551,51,0,QLearningPlayer
62,QLearningPlayer,153,398,551,51,0,QLearningPlayer
63,QLearningPlayer,132,412,544,44,0,QLearningPlayer
64,QLearningPlayer,93,438,531,31,0,QLearningPlayer
65,QLearningPlayer,147,402,549,49,0,QLearningPlayer
66,QLearningPlayer,168,388,556,56,0,QLearningPlayer
67,QLearningPlayer,162,392,554,54,0,QLearningPlayer
68,QLearningPlayer,138,408,546,46,0,QLearningPlayer
69,QLearningPlayer,171,386,557,57,0,QLearningPlayer
70,QLearningPlayer,162,392,554,54,0,QLearningPlayer
71,QLearningPlayer,144,404,548,48,0,QLearningPlayer
72,QLearningPlayer,177,382,559,59,0,QLearningPlayer
73,QLearningPlayer,144,404,548,48,0,QLearningPlayer
74,QLearningPlayer,135,410,545,45,0,QLearningPlayer
75,QLearningPlayer,135,410,545,45,0,QLearningPlayer
76,QLearningPlayer,153,398,551,51,0,QLearningPlayer
77,QLearningPlayer,135,410,545,45,0,QLearningPlayer
78,QLearningPlayer,153,398,551,51,0,QLearningPlayer
79,QLearningPlayer,159,394,553,53,0,QLearningPlayer
80,QLearningPlayer,117,422,539,39,0,QLearningPlayer
81,QLearningPlayer,156,396,552,52,0,QLearningPlayer
82,QLearningPlayer,150,400,550,50,0,QLearningPlayer
83,QLearningPlayer,132,412,544,44,0,QLearningPlayer
84,QLearningPlayer,153,398,551,51,0,QLearningPlayer
85,QLearningPlayer,126,416,542,42,0,QLearningPlayer
86,QLearningPlayer,180,380,560,60,0,QLearningPlayer
87,QLearningPlayer,159,394,553,53,0,QLearningPlayer
88,QLearningPlayer,141,406,547,47,0,QLearningPlayer
89,QLearningPlayer,147,402,549,49,0,QLearningPlayer
90,QLearningPlayer,156,396,552,52,0,QLearningPlayer
91,QLearningPlayer,144,404,548,48,0,QLearningPlayer
92,QLearningPlayer,120,420,540,40,0,QLearningPlayer
93,QLearningPlayer,135,410,545,45,0,QLearningPlayer
94,QLearningPlayer,129,414,543,43,0,QLearningPlayer
95,QLearningPlayer,141,406,547,47,0,QLearningPlayer
96,QLearningPlayer,129,414,543,43,0,QLearningPlayer
97,QLearningPlayer,159,394,553,53,0,QLearningPlayer
98,QLearningPlayer,156,396,552,52,0,QLearningPlayer
99,QLearningPlayer,138,408,546,46,0,QLearningPlayer
100,QLearningPlayer,147,402,549,49,0,QLearningPlayer
101,QLearningPlayer,171,386,557,57,0,QLearningPlayer
102,QLearningPlayer,150,400,550,50,0,QLearningPlayer
103,QLearningPlayer,135,410,545,45,0,QLearningPlayer
104,QLearningPlayer,171,386,557,57,0,QLearningPlayer
105,QLearningPlayer,147,402,549,49,0,QLearningPlayer
106,QLearningPlayer,159,394,553,53,0,QLearningPlayer
107,QLearningPlayer,144,404,548,48,0,QLearningPlayer
108,QLearningPlayer,174,384,558,58,0,QLearningPlayer
109,QLearningPlayer,150,400,550,50,0,QLearningPlayer
110,QLearningPlayer,147,402,549,49,0,QLearningPlayer
111,QLearningPlayer,153,398,551,51,0,QLearningPlayer
112,QLearningPlayer,138,408,546,46,0,QLearningPlayer
113,QLearningPlayer,141,406,547,47,0,QLearningPlayer
114,QLearningPlayer,126,416,542,42,0,QLearningPlayer
115,QLearningPlayer,150,400,550,50,0,QLearningPlayer
116,QLearningPlayer,156,396,552,52,0,QLearningPlayer
117,QLearningPlayer,162,392,554,54,0,QLearningPlayer
118,QLearningPlayer,144,404,548,48,0,QLearningPlayer
119,QLearningPlayer,156,396,552,52,0,QLearningPlayer
120,QLearningPlayer,162,392,554,54,0,QLearningPlayer
121,QLearningPlayer,138,408,546,46,0,QLearningPlayer
122,QLearningPlayer,144,404,548,48,0,QLearningPlayer
123,QLearningPlayer,132,412,544,44,0,QLearningPlayer
124,QLearningPlayer,168,388,556,56,0,QLearningPlayer
125,QLearningPlayer,153,398,551,51,0,QLearningPlayer
126,QLearningPlayer,153,398,551,51,0,QLearningPlayer
127,QLearningPlayer,147,402,549,49,0,QLearningPlayer
128,QLearningPlayer,162,392,554,54,0,QLearningPlayer
129,QLearningPlayer,138,408,546,46,0,QLearningPlayer
130,QLearningPlayer,132,412,544,44,0,QLearningPlayer
131,QLearningPlayer,150,400,550,50,0,QLearningPlayer
132,QLearningPlayer,135,410,545,45,0,QLearningPlayer
133,QLearningPlayer,150,400,550,50,0,QLearningPlayer
134,QLearningPlayer,147,402,549,49,0,QLearningPlayer
135,QLearningPlayer,165,390,555,55,0,QLearningPlayer
136,QLearningPlayer,159,394,553,53,0,QLearningPlayer
137,QLearningPlayer,141,406,547,47,0,QLearningPlayer
138,QLearningPlayer,162,392,554,54,0,QLearningPlayer
139,QLearningPlayer,156,396,552,52,0,QLearningPlayer
140,QLearningPlayer,117,422,539,39,0,QLearningPlayer
141,QLearningPlayer,168,388,556,56,0,QLearningPlayer
142,QLearningPlayer,138,408,546,46,0,QLearningPlayer
143,QLearningPlayer,141,406,547,47,0,QLearningPlayer
144,QLearningPlayer,177,382,559,59,0,QLearningPlayer
145,QLearningPlayer,147,402,549,49,0,QLearningPlayer
146,QLearningPlayer,165,390,555,55,0,QLearningPlayer
147,QLearningPlayer,159,394,553,53,0,QLearningPlayer
148,QLearningPlayer,159,394,553,53,0,QLearningPlayer
149,QLearningPlayer,147,402,549,49,0,QLearningPlayer
150,QLearningPlayer,129,414,543,43,0,QLearningPlayer
151,QLearningPlayer,117,422,539,39,0,QLearningPlayer
152,QLearningPlayer,159,394,553,53,0,QLearningPlayer
153,QLearningPlayer,114,424,538,38,0,QLearningPlayer
154,QLearningPlayer,138,408,546,46,0,QLearningPlayer
155,QLearningPlayer,114,424,538,38,0,QLearningPlayer
156,QLearningPlayer,180,380,560,60,0,QLearningPlayer
157,QLearningPlayer,141,406,547,47,0,QLearningPlayer
158,QLearningPlayer,159,394,553,53,0,QLearningPlayer
159,QLearningPlayer,198,368,566,66,0,QLearningPlayer
160,QLearningPlayer,162,392,554,54,0,QLearningPlayer
161,QLearningPlayer,132,412,544,44,0,QLearningPlayer
162,QLearningPlayer,162,392,554,54,0,QLearningPlayer
163,QLearningPlayer,156,396,552,52,0,QLearningPlayer
164,QLearningPlayer,180,380,560,60,0,QLearningPlayer
165,QLearningPlayer,141,406,547,47,0,QLearningPlayer
166,QLearningPlayer,171,386,557,57,0,QLearningPlayer
167,QLearningPlayer,168,388,556,56,0,QLearningPlayer
168,QLearningPlayer,171,386,557,57,0,QLearningPlayer
169,QLearningPlayer,117,422,539,39,0,QLearningPlayer
170,QLearningPlayer,144,404,548,48,0,QLearningPlayer
171,QLearningPlayer,141,406,547,47,0,QLearningPlayer
172,QLearningPlayer,171,386,557,57,0,QLearningPlayer
0,PatternLearningPlayer,297,302,599,99,0,PatternLearningPlayer
1,PatternLearningPlayer,300,300,600,100,0,Tie
2,PatternLearningPlayer,297,302,599,99,0,PatternLearningPlayer
3,PatternLearningPlayer,294,304,598,98,0,PatternLearningPlayer
4,PatternLearningPlayer,297,302,599,99,0,PatternLearningPlayer
5,PatternLearningPlayer,297,302,599,99,0,PatternLearningPlayer
6,PatternLearningPlayer,294,304,598,98,0,PatternLearningPlayer
7,PatternLearningPlayer,297,302,599,99,0,PatternLearningPlayer
8,PatternLearningPlayer,300,300,600,100,0,Tie
9,PatternLearningPlayer,294,304,598,98,0,PatternLearningPlayer
10,PatternLearningPlayer,300,300,600,100,0,Tie
0,TitForTat,300,300,600,100,0,Tie
1,TitForTat,300,300,600,100,0,Tie
2,TitForTat,300,300,600,100,0,Tie
3,TitForTat,300,300,600,100,0,Tie
4,TitForTat,300,300,600,100,0,Tie
5,TitForTat,300,300,600,100,0,Tie
6,TitForTat,300,300,600,100,0,Tie
7,TitForTat,300,300,600,100,0,Tie
8,TitForTat,300,300,600,100,0,Tie
9,TitForTat,300,300,600,100,0,Tie
10,TitForTat,300,300,600,100,0,Tie
0,Bayesian,285,310,595,95,0,Bayesian
1,Bayesian,300,300,600,100,0,Tie
2,Bayesian,294,304,598,98,0,Bayesian
3,Bayesian,300,300,600,100,0,Tie
4,Bayesian,297,302,599,99,0,Bayesian
5,Bayesian,300,300,600,100,0,Tie
6,Bayesian,300,300,600,100,0,Tie
7,Bayesian,300,300,600,100,0,Tie
8,Bayesian,300,300,600,100,0,Tie
9,Bayesian,300,300,600,100,0,Tie
10,Bayesian,300,300,600,100,0,Tie
0,UCBPlayer,6,496,502,2,0,UCBPlayer
1,UCBPlayer,6,496,502,2,0,UCBPlayer
2,UCBPlayer,6,496,502,2,0,UCBPlayer
3,UCBPlayer,6,496,502,2,0,UCBPlayer
4,UCBPlayer,6,496,502,2,0,UCBPlayer
5,UCBPlayer,6,496,502,2,0,UCBPlayer
6,UCBPlayer,6,496,502,2,0,UCBPlayer
7,UCBPlayer,6,496,502,2,0,UCBPlayer
8,UCBPlayer,6,496,502,2,0,UCBPlayer
9,UCBPlayer,6,496,502,2,0,UCBPlayer
10,UCBPlayer,6,496,502,2,0,UCBPlayer
0,JointPQPlayer,105,430,535,35,0,JointPQPlayer
1,JointPQPlayer,201,366,567,67,0,JointPQPlayer
2,JointPQPlayer,201,366,567,67,0,JointPQPlayer
3,JointPQPlayer,96,436,532,32,0,JointPQPlayer
4,JointPQPlayer,180,380,560,60,0,JointPQPlayer
5,JointPQPlayer,207,362,569,69,0,JointPQPlayer
6,JointPQPlayer,225,350,575,75,0,JointPQPlayer
7,JointPQPlayer,75,450,525,25,0,JointPQPlayer
8,JointPQPlayer,228,348,576,76,0,JointPQPlayer
9,JointPQPlayer,222,352,574,74,0,JointPQPlayer
10,JointPQPlayer,96,436,532,32,0,JointPQPlayer
11,JointPQPlayer,69,454,523,23,0,JointPQPlayer
12,JointPQPlayer,72,452,524,24,0,JointPQPlayer
13,JointPQPlayer,186,376,562,62,0,JointPQPlayer
14,JointPQPlayer,87,442,529,29,0,JointPQPlayer
15,JointPQPlayer,222,352,574,74,0,JointPQPlayer
16,JointPQPlayer,180,380,560,60,0,JointPQPlayer
17,JointPQPlayer,84,444,528,28,0,JointPQPlayer
18,JointPQPlayer,225,350,575,75,0,JointPQPlayer
19,JointPQPlayer,213,358,571,71,0,JointPQPlayer
20,JointPQPlayer,210,360,570,70,0,JointPQPlayer
21,JointPQPlayer,216,356,572,72,0,JointPQPlayer
22,JointPQPlayer,66,456,522,22,0,JointPQPlayer
23,JointPQPlayer,93,438,531,31,0,JointPQPlayer
24,JointPQPlayer,222,352,574,74,0,JointPQPlayer
25,JointPQPlayer,240,340,580,80,0,JointPQPlayer
26,JointPQPlayer,204,364,568,68,0,JointPQPlayer
27,JointPQPlayer,105,430,535,35,0,JointPQPlayer
28,JointPQPlayer,210,360,570,70,0,JointPQPlayer
29,JointPQPlayer,108,428,536,36,0,JointPQPlayer
30,JointPQPlayer,90,440,530,30,0,JointPQPlayer
31,JointPQPlayer,216,356,572,72,0,JointPQPlayer
32,JointPQPlayer,186,376,562,62,0,JointPQPlayer
33,JointPQPlayer,171,386,557,57,0,JointPQPlayer
34,JointPQPlayer,216,356,572,72,0,JointPQPlayer
35,JointPQPlayer,186,376,562,62,0,JointPQPlayer
36,JointPQPlayer,120,420,540,40,0,JointPQPlayer
37,JointPQPlayer,207,362,569,69,0,JointPQPlayer
38,JointPQPlayer,84,444,528,28,0,JointPQPlayer
39,JointPQPlayer,195,370,565,65,0,JointPQPlayer
40,JointPQPlayer,81,446,527,27,0,JointPQPlayer
41,JointPQPlayer,204,364,568,68,0,JointPQPlayer
42,JointPQPlayer,207,362,569,69,0,JointPQPlayer
43,JointPQPlayer,84,444,528,28,0,JointPQPlayer
44,JointPQPlayer,192,372,564,64,0,JointPQPlayer
45,JointPQPlayer,192,372,564,64,0,JointPQPlayer
46,JointPQPlayer,219,354,573,73,0,JointPQPlayer
47,JointPQPlayer,228,348,576,76,0,JointPQPlayer
48,JointPQPlayer,69,454,523,23,0,JointPQPlayer
49,JointPQPlayer,210,360,570,70,0,JointPQPlayer
50,JointPQPlayer,78,448,526,26,0,JointPQPlayer
51,JointPQPlayer,219,354,573,73,0,JointPQPlayer
52,JointPQPlayer,216,356,572,72,0,JointPQPlayer
53,JointPQPlayer,210,360,570,70,0,JointPQPlayer
54,JointPQPlayer,198,368,566,66,0,JointPQPlayer
55,JointPQPlayer,99,434,533,33,0,JointPQPlayer
56,JointPQPlayer,219,354,573,73,0,JointPQPlayer
57,JointPQPlayer,207,362,569,69,0,JointPQPlayer
58,JointPQPlayer,204,364,568,68,0,JointPQPlayer
59,JointPQPlayer,198,368,566,66,0,JointPQPlayer
60,JointPQPlayer,84,444,528,28,0,JointPQPlayer
61,JointPQPlayer,105,430,535,35,0,JointPQPlayer
62,JointPQPlayer,198,368,566,66,0,JointPQPlayer
63,JointPQPlayer,216,356,572,72,0,JointPQPlayer
64,JointPQPlayer,99,434,533,33,0,JointPQPlayer
65,JointPQPlayer,168,388,556,56,0,JointPQPlayer
66,JointPQPlayer,165,390,555,55,0,JointPQPlayer
67,JointPQPlayer,225,350,575,75,0,JointPQPlayer
68,JointPQPlayer,201,366,567,67,0,JointPQPlayer
69,JointPQPlayer,228,348,576,76,0,JointPQPlayer
70,JointPQPlayer,81,446,527,27,0,JointPQPlayer
71,JointPQPlayer,162,392,554,54,0,JointPQPlayer
72,JointPQPlayer,90,440,530,30,0,JointPQPlayer
73,JointPQPlayer,195,370,565,65,0,JointPQPlayer
74,JointPQPlayer,69,454,523,23,0,JointPQPlayer
75,JointPQPlayer,231,346,577,77,0,JointPQPlayer
76,JointPQPlayer,213,358,571,71,0,JointPQPlayer
77,JointPQPlayer,216,356,572,72,0,JointPQPlayer
78,JointPQPlayer,213,358,571,71,0,JointPQPlayer
79,JointPQPlayer,186,376,562,62,0,JointPQPlayer
80,JointPQPlayer,66,456,522,22,0,JointPQPlayer
81,JointPQPlayer,213,358,571,71,0,JointPQPlayer
82,JointPQPlayer,201,366,567,67,0,JointPQPlayer
83,JointPQPlayer,219,354,573,73,0,JointPQPlayer
84,JointPQPlayer,204,364,568,68,0,JointPQPlayer
85,JointPQPlayer,78,448,526,26,0,JointPQPlayer
86,JointPQPlayer,219,354,573,73,0,JointPQPlayer
87,JointPQPlayer,63,458,521,21,0,JointPQPlayer
88,JointPQPlayer,228,348,576,76,0,JointPQPlayer
89,JointPQPlayer,216,356,572,72,0,JointPQPlayer
90,JointPQPlayer,222,352,574,74,0,JointPQPlayer
91,JointPQPlayer,225,350,575,75,0,JointPQPlayer
92,JointPQPlayer,240,340,580,80,0,JointPQPlayer
93,JointPQPlayer,75,450,525,25,0,JointPQPlayer
94,JointPQPlayer,81,446,527,27,0,JointPQPlayer
95,JointPQPlayer,204,364,568,68,0,JointPQPlayer
96,JointPQPlayer,93,438,531,31,0,JointPQPlayer
97,JointPQPlayer,204,364,568,68,0,JointPQPlayer
98,JointPQPlayer,195,370,565,65,0,JointPQPlayer
99,JointPQPlayer,225,350,575,75,0,JointPQPlayer
100,JointPQPlayer,207,362,569,69,0,JointPQPlayer
101,JointPQPlayer,234,344,578,78,0,JointPQPlayer
102,JointPQPlayer,99,434,533,33,0,JointPQPlayer
103,JointPQPlayer,225,350,575,75,0,JointPQPlayer
104,JointPQPlayer,222,352,574,74,0,JointPQPlayer
105,JointPQPlayer,213,358,571,71,0,JointPQPlayer
106,JointPQPlayer,216,356,572,72,0,JointPQPlayer
107,JointPQPlayer,225,350,575,75,0,JointPQPlayer
108,JointPQPlayer,216,356,572,72,0,JointPQPlayer
109,JointPQPlayer,81,446,527,27,0,JointPQPlayer
110,JointPQPlayer,87,442,529,29,0,JointPQPlayer
111,JointPQPlayer,237,342,579,79,0,JointPQPlayer
112,JointPQPlayer,84,444,528,28,0,JointPQPlayer
113,JointPQPlayer,213,358,571,71,0,JointPQPlayer
114,JointPQPlayer,210,360,570,70,0,JointPQPlayer
115,JointPQPlayer,210,360,570,70,0,JointPQPlayer
116,JointPQPlayer,195,370,565,65,0,JointPQPlayer
117,JointPQPlayer,201,366,567,67,0,JointPQPlayer
118,JointPQPlayer,231,346,577,77,0,JointPQPlayer
119,JointPQPlayer,213,358,571,71,0,JointPQPlayer
120,JointPQPlayer,192,372,564,64,0,JointPQPlayer
121,JointPQPlayer,195,370,565,65,0,JointPQPlayer
122,JointPQPlayer,138,408,546,46,0,JointPQPlayer
123,JointPQPlayer,174,384,558,58,0,JointPQPlayer
124,JointPQPlayer,204,364,568,68,0,JointPQPlayer
125,JointPQPlayer,225,350,575,75,0,JointPQPlayer
126,JointPQPlayer,216,356,572,72,0,JointPQPlayer
127,JointPQPlayer,78,448,526,26,0,JointPQPlayer
128,JointPQPlayer,90,440,530,30,0,JointPQPlayer
129,JointPQPlayer,204,364,568,68,0,JointPQPlayer
130,JointPQPlayer,129,414,543,43,0,JointPQPlayer
131,JointPQPlayer,201,366,567,67,0,JointPQPlayer
132,JointPQPlayer,87,442,529,29,0,JointPQPlayer
133,JointPQPlayer,225,350,575,75,0,JointPQPlayer
134,JointPQPlayer,189,374,563,63,0,JointPQPlayer
135,JointPQPlayer,60,460,520,20,0,JointPQPlayer
136,JointPQPlayer,87,442,529,29,0,JointPQPlayer
137,JointPQPlayer,81,446,527,27,0,JointPQPlayer
138,JointPQPlayer,240,340,580,80,0,JointPQPlayer
139,JointPQPlayer,222,352,574,74,0,JointPQPlayer
140,JointPQPlayer,183,378,561,61,0,JointPQPlayer
141,JointPQPlayer,207,362,569,69,0,JointPQPlayer
142,JointPQPlayer,219,354,573,73,0,JointPQPlayer
143,JointPQPlayer,81,446,527,27,0,JointPQPlayer
144,JointPQPlayer,189,374,563,63,0,JointPQPlayer
145,JointPQPlayer,93,438,531,31,0,JointPQPlayer
146,JointPQPlayer,78,448,526,26,0,JointPQPlayer
147,JointPQPlayer,75,450,525,25,0,JointPQPlayer
148,JointPQPlayer,102,432,534,34,0,JointPQPlayer
149,JointPQPlayer,219,354,573,73,0,JointPQPlayer
150,JointPQPlayer,132,412,544,44,0,JointPQPlayer
151,JointPQPlayer,213,358,571,71,0,JointPQPlayer
152,JointPQPlayer,216,356,572,72,0,JointPQPlayer
153,JointPQPlayer,192,372,564,64,0,JointPQPlayer
154,JointPQPlayer,195,370,565,65,0,JointPQPlayer
155,JointPQPlayer,207,362,569,69,0,JointPQPlayer
156,JointPQPlayer,189,374,563,63,0,JointPQPlayer
157,JointPQPlayer,90,440,530,30,0,JointPQPlayer
158,JointPQPlayer,195,370,565,65,0,JointPQPlayer
159,JointPQPlayer,195,370,565,65,0,JointPQPlayer
160,JointPQPlayer,183,378,561,61,0,JointPQPlayer
161,JointPQPlayer,183,378,561,61,0,JointPQPlayer
162,JointPQPlayer,81,446,527,27,0,JointPQPlayer
163,JointPQPlayer,102,432,534,34,0,JointPQPlayer
164,JointPQPlayer,219,354,573,73,0,JointPQPlayer
165,JointPQPlayer,216,356,572,72,0,JointPQPlayer
166,JointPQPlayer,222,352,574,74,0,JointPQPlayer
167,JointPQPlayer,240,340,580,80,0,JointPQPlayer
168,JointPQPlayer,210,360,570,70,0,JointPQPlayer
169,JointPQPlayer,219,354,573,73,0,JointPQPlayer
170,JointPQPlayer,195,370,565,65,0,JointPQPlayer
171,JointPQPlayer,90,440,530,30,0,JointPQPlayer
172,JointPQPlayer,225,350,575,75,0,JointPQPlayer
173,JointPQPlayer,231,346,577,77,0,JointPQPlayer
174,JointPQPlayer,93,438,531,31,0,JointPQPlayer
175,JointPQPlayer,219,354,573,73,0,JointPQPlayer
176,JointPQPlayer,204,364,568,68,0,JointPQPlayer
177,JointPQPlayer,180,380,560,60,0,JointPQPlayer
178,JointPQPlayer,207,362,569,69,0,JointPQPlayer
179,JointPQPlayer,213,358,571,71,0,JointPQPlayer
180,JointPQPlayer,207,362,569,69,0,JointPQPlayer
181,JointPQPlayer,228,348,576,76,0,JointPQPlayer
182,JointPQPlayer,162,392,554,54,0,JointPQPlayer
183,JointPQPlayer,234,344,578,78,0,JointPQPlayer
184,JointPQPlayer,99,434,533,33,0,JointPQPlayer
185,JointPQPlayer,96,436,532,32,0,JointPQPlayer
186,JointPQPlayer,90,440,530,30,0,JointPQPlayer
187,JointPQPlayer,216,356,572,72,0,JointPQPlayer
188,JointPQPlayer,237,342,579,79,0,JointPQPlayer
189,JointPQPlayer,63,458,521,21,0,JointPQPlayer
190,JointPQPlayer,93,438,531,31,0,JointPQPlayer
191,JointPQPlayer,198,368,566,66,0,JointPQPlayer
192,JointPQPlayer,210,360,570,70,0,JointPQPlayer
193,JointPQPlayer,72,452,524,24,0,JointPQPlayer
194,JointPQPlayer,120,420,540,40,0,JointPQPlayer
195,JointPQPlayer,213,358,571,71,0,JointPQPlayer
196,JointPQPlayer,219,354,573,73,0,JointPQPlayer
197,JointPQPlayer,177,382,559,59,0,JointPQPlayer
198,JointPQPlayer,72,452,524,24,0,JointPQPlayer
199,JointPQPlayer,198,368,566,66,0,JointPQPlayer
200,JointPQPlayer,90,440,530,30,0,JointPQPlayer
201,JointPQPlayer,213,358,571,71,0,JointPQPlayer
202,JointPQPlayer,216,356,572,72,0,JointPQPlayer
203,JointPQPlayer,195,370,565,65,0,JointPQPlayer
204,JointPQPlayer,222,352,574,74,0,JointPQPlayer
205,JointPQPlayer,87,442,529,29,0,JointPQPlayer
206,JointPQPlayer,237,342,579,79,0,JointPQPlayer
207,JointPQPlayer,159,394,553,53,0,JointPQPlayer
208,JointPQPlayer,207,362,569,69,0,JointPQPlayer
209,JointPQPlayer,96,436,532,32,0,JointPQPlayer
210,JointPQPlayer,69,454,523,23,0,JointPQPlayer
211,JointPQPlayer,84,444,528,28,0,JointPQPlayer
212,JointPQPlayer,204,364,568,68,0,JointPQPlayer
213,JointPQPlayer,204,364,568,68,0,JointPQPlayer
214,JointPQPlayer,231,346,577,77,0,JointPQPlayer
215,JointPQPlayer,96,436,532,32,0,JointPQPlayer
216,JointPQPlayer,225,350,575,75,0,JointPQPlayer
217,JointPQPlayer,210,360,570,70,0,JointPQPlayer
218,JointPQPlayer,87,442,529,29,0,JointPQPlayer
219,JointPQPlayer,63,458,521,21,0,JointPQPlayer
220,JointPQPlayer,201,366,567,67,0,JointPQPlayer
221,JointPQPlayer,210,360,570,70,0,JointPQPlayer
222,JointPQPlayer,210,360,570,70,0,JointPQPlayer
223,JointPQPlayer,87,442,529,29,0,JointPQPlayer
224,JointPQPlayer,99,434,533,33,0,JointPQPlayer
225,JointPQPlayer,78,448,526,26,0,JointPQPlayer
226,JointPQPlayer,192,372,564,64,0,JointPQPlayer
227,JointPQPlayer,219,354,573,73,0,JointPQPlayer
228,JointPQPlayer,222,352,574,74,0,JointPQPlayer
229,JointPQPlayer,90,440,530,30,0,JointPQPlayer
230,JointPQPlayer,195,370,565,65,0,JointPQPlayer
231,JointPQPlayer,213,358,571,71,0,JointPQPlayer
232,JointPQPlayer,75,450,525,25,0,JointPQPlayer
233,JointPQPlayer,96,436,532,32,0,JointPQPlayer
234,JointPQPlayer,216,356,572,72,0,JointPQPlayer
235,JointPQPlayer,228,348,576,76,0,JointPQPlayer
236,JointPQPlayer,213,358,571,71,0,JointPQPlayer
237,JointPQPlayer,219,354,573,73,0,JointPQPlayer
238,JointPQPlayer,210,360,570,70,0,JointPQPlayer
239,JointPQPlayer,204,364,568,68,0,JointPQPlayer
240,JointPQPlayer,189,374,563,63,0,JointPQPlayer
241,JointPQPlayer,78,448,526,26,0,JointPQPlayer
242,JointPQPlayer,84,444,528,28,0,JointPQPlayer
243,JointPQPlayer,198,368,566,66,0,JointPQPlayer
244,JointPQPlayer,90,440,530,30,0,JointPQPlayer
245,JointPQPlayer,201,366,567,67,0,JointPQPlayer
246,JointPQPlayer,222,352,574,74,0,JointPQPlayer
247,JointPQPlayer,81,446,527,27,0,JointPQPlayer
248,JointPQPlayer,84,444,528,28,0,JointPQPlayer
249,JointPQPlayer,210,360,570,70,0,JointPQPlayer
250,JointPQPlayer,198,368,566,66,0,JointPQPlayer
251,JointPQPlayer,216,356,572,72,0,JointPQPlayer
252,JointPQPlayer,84,444,528,28,0,JointPQPlayer
253,JointPQPlayer,210,360,570,70,0,JointPQPlayer
254,JointPQPlayer,228,348,576,76,0,JointPQPlayer
255,JointPQPlayer,213,358,571,71,0,JointPQPlayer
256,JointPQPlayer,99,434,533,33,0,JointPQPlayer
257,JointPQPlayer,87,442,529,29,0,JointPQPlayer
258,JointPQPlayer,201,366,567,67,0,JointPQPlayer
259,JointPQPlayer,78,448,526,26,0,JointPQPlayer
260,JointPQPlayer,189,374,563,63,0,JointPQPlayer
261,JointPQPlayer,78,448,526,26,0,JointPQPlayer
262,JointPQPlayer,216,356,572,72,0,JointPQPlayer
263,JointPQPlayer,96,436,532,32,0,JointPQPlayer
264,JointPQPlayer,204,364,568,68,0,JointPQPlayer
265,JointPQPlayer,96,436,532,32,0,JointPQPlayer
266,JointPQPlayer,198,368,566,66,0,JointPQPlayer
267,JointPQPlayer,222,352,574,74,0,JointPQPlayer
268,JointPQPlayer,87,442,529,29,0,JointPQPlayer
269,JointPQPlayer,93,438,531,31,0,JointPQPlayer
270,JointPQPlayer,204,364,568,68,0,JointPQPlayer
271,JointPQPlayer,222,352,574,74,0,JointPQPlayer
272,JointPQPlayer,219,354,573,73,0,JointPQPlayer
273,JointPQPlayer,84,444,528,28,0,JointPQPlayer
274,JointPQPlayer,102,432,534,34,0,JointPQPlayer
275,JointPQPlayer,201,366,567,67,0,JointPQPlayer
276,JointPQPlayer,186,376,562,62,0,JointPQPlayer
277,JointPQPlayer,87,442,529,29,0,JointPQPlayer
278,JointPQPlayer,213,358,571,71,0,JointPQPlayer
279,JointPQPlayer,75,450,525,25,0,JointPQPlayer
280,JointPQPlayer,240,340,580,80,0,JointPQPlayer
281,JointPQPlayer,198,368,566,66,0,JointPQPlayer
282,JointPQPlayer,225,350,575,75,0,JointPQPlayer
283,JointPQPlayer,210,360,570,70,0,JointPQPlayer
284,JointPQPlayer,204,364,568,68,0,JointPQPlayer
285,JointPQPlayer,198,368,566,66,0,JointPQPlayer
286,JointPQPlayer,117,422,539,39,0,JointPQPlayer
287,JointPQPlayer,84,444,528,28,0,JointPQPlayer
288,JointPQPlayer,207,362,569,69,0,JointPQPlayer
289,JointPQPlayer,177,382,559,59,0,JointPQPlayer
290,JointPQPlayer,195,370,565,65,0,JointPQPlayer
291,JointPQPlayer,222,352,574,74,0,JointPQPlayer
292,JointPQPlayer,84,444,528,28,0,JointPQPlayer
293,JointPQPlayer,60,460,520,20,0,JointPQPlayer
294,JointPQPlayer,231,346,577,77,0,JointPQPlayer
295,JointPQPlayer,78,448,526,26,0,JointPQPlayer
296,JointPQPlayer,90,440,530,30,0,JointPQPlayer
297,JointPQPlayer,213,358,571,71,0,JointPQPlayer
298,JointPQPlayer,153,398,551,51,0,JointPQPlayer
299,JointPQPlayer,216,356,572,72,0,JointPQPlayer
300,JointPQPlayer,207,362,569,69,0,JointPQPlayer
301,JointPQPlayer,213,358,571,71,0,JointPQPlayer
302,JointPQPlayer,213,358,571,71,0,JointPQPlayer
303,JointPQPlayer,192,372,564,64,0,JointPQPlayer
304,JointPQPlayer,210,360,570,70,0,JointPQPlayer
305,JointPQPlayer,207,362,569,69,0,JointPQPlayer
306,JointPQPlayer,216,356,572,72,0,JointPQPlayer
307,JointPQPlayer,216,356,572,72,0,JointPQPlayer
308,JointPQPlayer,57,462,519,19,0,JointPQPlayer
309,JointPQPlayer,93,438,531,31,0,JointPQPlayer
310,JointPQPlayer,222,352,574,74,0,JointPQPlayer
311,JointPQPlayer,54,464,518,18,0,JointPQPlayer
312,JointPQPlayer,210,360,570,70,0,JointPQPlayer
313,JointPQPlayer,99,434,533,33,0,JointPQPlayer
314,JointPQPlayer,210,360,570,70,0,JointPQPlayer
315,JointPQPlayer,222,352,574,74,0,JointPQPlayer
316,JointPQPlayer,225,350,575,75,0,JointPQPlayer
317,JointPQPlayer,180,380,560,60,0,JointPQPlayer
318,JointPQPlayer,96,436,532,32,0,JointPQPlayer
319,JointPQPlayer,207,362,569,69,0,JointPQPlayer
320,JointPQPlayer,198,368,566,66,0,JointPQPlayer
321,JointPQPlayer,96,436,532,32,0,JointPQPlayer
322,JointPQPlayer,186,376,562,62,0,JointPQPlayer
323,JointPQPlayer,219,354,573,73,0,JointPQPlayer
324,JointPQPlayer,222,352,574,74,0,JointPQPlayer
325,JointPQPlayer,114,424,538,38,0,JointPQPlayer
326,JointPQPlayer,165,390,555,55,0,JointPQPlayer
327,JointPQPlayer,93,438,531,31,0,JointPQPlayer
328,JointPQPlayer,222,352,574,74,0,JointPQPlayer
329,JointPQPlayer,216,356,572,72,0,JointPQPlayer
330,JointPQPlayer,237,342,579,79,0,JointPQPlayer
331,JointPQPlayer,216,356,572,72,0,JointPQPlayer
332,JointPQPlayer,204,364,568,68,0,JointPQPlayer
333,JointPQPlayer,201,366,567,67,0,JointPQPlayer
334,JointPQPlayer,84,444,528,28,0,JointPQPlayer
335,JointPQPlayer,207,362,569,69,0,JointPQPlayer
336,JointPQPlayer,204,364,568,68,0,JointPQPlayer
337,JointPQPlayer,213,358,571,71,0,JointPQPlayer
338,JointPQPlayer,201,366,567,67,0,JointPQPlayer
339,JointPQPlayer,222,352,574,74,0,JointPQPlayer
340,JointPQPlayer,201,366,567,67,0,JointPQPlayer
341,JointPQPlayer,78,448,526,26,0,JointPQPlayer
342,JointPQPlayer,81,446,527,27,0,JointPQPlayer
343,JointPQPlayer,213,358,571,71,0,JointPQPlayer
344,JointPQPlayer,240,340,580,80,0,JointPQPlayer
345,JointPQPlayer,69,454,523,23,0,JointPQPlayer
346,JointPQPlayer,189,374,563,63,0,JointPQPlayer
347,JointPQPlayer,168,388,556,56,0,JointPQPlayer
348,JointPQPlayer,69,454,523,23,0,JointPQPlayer
349,JointPQPlayer,105,430,535,35,0,JointPQPlayer
350,JointPQPlayer,204,364,568,68,0,JointPQPlayer
351,JointPQPlayer,201,366,567,67,0,JointPQPlayer
352,JointPQPlayer,198,368,566,66,0,JointPQPlayer
353,JointPQPlayer,201,366,567,67,0,JointPQPlayer
354,JointPQPlayer,210,360,570,70,0,JointPQPlayer
355,JointPQPlayer,87,442,529,29,0,JointPQPlayer
356,JointPQPlayer,75,450,525,25,0,JointPQPlayer
357,JointPQPlayer,204,364,568,68,0,JointPQPlayer
358,JointPQPlayer,228,348,576,76,0,JointPQPlayer
359,JointPQPlayer,216,356,572,72,0,JointPQPlayer
360,JointPQPlayer,117,422,539,39,0,JointPQPlayer
361,JointPQPlayer,99,434,533,33,0,JointPQPlayer
362,JointPQPlayer,198,368,566,66,0,JointPQPlayer
363,JointPQPlayer,204,364,568,68,0,JointPQPlayer
364,JointPQPlayer,219,354,573,73,0,JointPQPlayer
365,JointPQPlayer,204,364,568,68,0,JointPQPlayer
366,JointPQPlayer,216,356,572,72,0,JointPQPlayer
367,JointPQPlayer,216,356,572,72,0,JointPQPlayer
368,JointPQPlayer,156,396,552,52,0,JointPQPlayer
369,JointPQPlayer,96,436,532,32,0,JointPQPlayer
370,JointPQPlayer,213,358,571,71,0,JointPQPlayer
371,JointPQPlayer,216,356,572,72,0,JointPQPlayer
372,JointPQPlayer,210,360,570,70,0,JointPQPlayer
373,JointPQPlayer,219,354,573,73,0,JointPQPlayer
374,JointPQPlayer,195,370,565,65,0,JointPQPlayer
375,JointPQPlayer,201,366,567,67,0,JointPQPlayer
376,JointPQPlayer,192,372,564,64,0,JointPQPlayer
377,JointPQPlayer,81,446,527,27,0,JointPQPlayer
378,JointPQPlayer,87,442,529,29,0,JointPQPlayer
379,JointPQPlayer,84,444,528,28,0,JointPQPlayer
380,JointPQPlayer,219,354,573,73,0,JointPQPlayer
381,JointPQPlayer,201,366,567,67,0,JointPQPlayer
382,JointPQPlayer,213,358,571,71,0,JointPQPlayer
383,JointPQPlayer,204,364,568,68,0,JointPQPlayer
384,JointPQPlayer,192,372,564,64,0,JointPQPlayer
385,JointPQPlayer,189,374,563,63,0,JointPQPlayer
386,JointPQPlayer,87,442,529,29,0,JointPQPlayer
387,JointPQPlayer,216,356,572,72,0,JointPQPlayer
388,JointPQPlayer,213,358,571,71,0,JointPQPlayer
389,JointPQPlayer,213,358,571,71,0,JointPQPlayer
390,JointPQPlayer,162,392,554,54,0,JointPQPlayer
391,JointPQPlayer,75,450,525,25,0,JointPQPlayer
392,JointPQPlayer,204,364,568,68,0,JointPQPlayer
393,JointPQPlayer,84,444,528,28,0,JointPQPlayer
394,JointPQPlayer,219,354,573,73,0,JointPQPlayer
395,JointPQPlayer,111,426,537,37,0,JointPQPlayer
396,JointPQPlayer,222,352,574,74,0,JointPQPlayer
397,JointPQPlayer,204,364,568,68,0,JointPQPlayer
398,JointPQPlayer,84,444,528,28,0,JointPQPlayer
399,JointPQPlayer,93,438,531,31,0,JointPQPlayer
400,JointPQPlayer,93,438,531,31,0,JointPQPlayer
401,JointPQPlayer,204,364,568,68,0,JointPQPlayer
402,JointPQPlayer,63,458,521,21,0,JointPQPlayer
403,JointPQPlayer,210,360,570,70,0,JointPQPlayer
404,JointPQPlayer,216,356,572,72,0,JointPQPlayer
405,JointPQPlayer,204,364,568,68,0,JointPQPlayer
406,JointPQPlayer,216,356,572,72,0,JointPQPlayer
407,JointPQPlayer,195,370,565,65,0,JointPQPlayer
408,JointPQPlayer,84,444,528,28,0,JointPQPlayer
409,JointPQPlayer,195,370,565,65,0,JointPQPlayer
410,JointPQPlayer,90,440,530,30,0,JointPQPlayer
411,JointPQPlayer,192,372,564,64,0,JointPQPlayer
412,JointPQPlayer,204,364,568,68,0,JointPQPlayer
413,JointPQPlayer,210,360,570,70,0,JointPQPlayer
414,JointPQPlayer,219,354,573,73,0,JointPQPlayer
415,JointPQPlayer,78,448,526,26,0,JointPQPlayer
416,JointPQPlayer,81,446,527,27,0,JointPQPlayer
417,JointPQPlayer,105,430,535,35,0,JointPQPlayer
418,JointPQPlayer,114,424,538,38,0,JointPQPlayer
419,JointPQPlayer,216,356,572,72,0,JointPQPlayer
420,JointPQPlayer,93,438,531,31,0,JointPQPlayer
421,JointPQPlayer,93,438,531,31,0,JointPQPlayer
422,JointPQPlayer,207,362,569,69,0,JointPQPlayer
423,JointPQPlayer,228,348,576,76,0,JointPQPlayer
424,JointPQPlayer,192,372,564,64,0,JointPQPlayer
425,JointPQPlayer,96,436,532,32,0,JointPQPlayer
426,JointPQPlayer,192,372,564,64,0,JointPQPlayer
427,JointPQPlayer,63,458,521,21,0,JointPQPlayer
428,JointPQPlayer,195,370,565,65,0,JointPQPlayer
429,JointPQPlayer,216,356,572,72,0,JointPQPlayer
430,JointPQPlayer,213,358,571,71,0,JointPQPlayer
431,JointPQPlayer,72,452,524,24,0,JointPQPlayer
432,JointPQPlayer,150,400,550,50,0,JointPQPlayer
433,JointPQPlayer,201,366,567,67,0,JointPQPlayer
434,JointPQPlayer,216,356,572,72,0,JointPQPlayer
435,JointPQPlayer,213,358,571,71,0,JointPQPlayer
436,JointPQPlayer,231,346,577,77,0,JointPQPlayer
437,JointPQPlayer,204,364,568,68,0,JointPQPlayer
438,JointPQPlayer,90,440,530,30,0,JointPQPlayer
439,JointPQPlayer,198,368,566,66,0,JointPQPlayer
440,JointPQPlayer,81,446,527,27,0,JointPQPlayer
441,JointPQPlayer,222,352,574,74,0,JointPQPlayer
442,JointPQPlayer,216,356,572,72,0,JointPQPlayer
443,JointPQPlayer,201,366,567,67,0,JointPQPlayer
444,JointPQPlayer,228,348,576,76,0,JointPQPlayer
445,JointPQPlayer,219,354,573,73,0,JointPQPlayer
446,JointPQPlayer,216,356,572,72,0,JointPQPlayer
447,JointPQPlayer,213,358,571,71,0,JointPQPlayer
448,JointPQPlayer,213,358,571,71,0,JointPQPlayer
449,JointPQPlayer,204,364,568,68,0,JointPQPlayer
450,JointPQPlayer,174,384,558,58,0,JointPQPlayer
451,JointPQPlayer,222,352,574,74,0,JointPQPlayer
452,JointPQPlayer,162,392,554,54,0,JointPQPlayer
453,JointPQPlayer,216,356,572,72,0,JointPQPlayer
454,JointPQPlayer,213,358,571,71,0,JointPQPlayer
455,JointPQPlayer,213,358,571,71,0,JointPQPlayer
456,JointPQPlayer,78,448,526,26,0,JointPQPlayer
457,JointPQPlayer,225,350,575,75,0,JointPQPlayer
458,JointPQPlayer,204,364,568,68,0,JointPQPlayer
459,JointPQPlayer,201,366,567,67,0,JointPQPlayer
460,JointPQPlayer,210,360,570,70,0,JointPQPlayer
461,JointPQPlayer,72,452,524,24,0,JointPQPlayer
462,JointPQPlayer,204,364,568,68,0,JointPQPlayer
463,JointPQPlayer,195,370,565,65,0,JointPQPlayer
464,JointPQPlayer,225,350,575,75,0,JointPQPlayer
465,JointPQPlayer,234,344,578,78,0,JointPQPlayer
466,JointPQPlayer,216,356,572,72,0,JointPQPlayer
467,JointPQPlayer,204,364,568,68,0,JointPQPlayer
468,JointPQPlayer,111,426,537,37,0,JointPQPlayer
469,JointPQPlayer,195,370,565,65,0,JointPQPlayer
470,JointPQPlayer,216,356,572,72,0,JointPQPlayer
471,JointPQPlayer,219,354,573,73,0,JointPQPlayer
472,JointPQPlayer,195,370,565,65,0,JointPQPlayer
473,JointPQPlayer,213,358,571,71,0,JointPQPlayer
474,JointPQPlayer,210,360,570,70,0,JointPQPlayer
475,JointPQPlayer,231,346,577,77,0,JointPQPlayer
476,JointPQPlayer,213,358,571,71,0,JointPQPlayer
477,JointPQPlayer,96,436,532,32,0,JointPQPlayer
478,JointPQPlayer,180,380,560,60,0,JointPQPlayer
479,JointPQPlayer,213,358,571,71,0,JointPQPlayer
480,JointPQPlayer,222,352,574,74,0,JointPQPlayer
481,JointPQPlayer,225,350,575,75,0,JointPQPlayer
482,JointPQPlayer,195,370,565,65,0,JointPQPlayer
483,JointPQPlayer,93,438,531,31,0,JointPQPlayer
484,JointPQPlayer,210,360,570,70,0,JointPQPlayer
485,JointPQPlayer,216,356,572,72,0,JointPQPlayer
486,JointPQPlayer,216,356,572,72,0,JointPQPlayer
487,JointPQPlayer,180,380,560,60,0,JointPQPlayer
488,JointPQPlayer,204,364,568,68,0,JointPQPlayer
489,JointPQPlayer,204,364,568,68,0,JointPQPlayer
490,JointPQPlayer,216,356,572,72,0,JointPQPlayer
491,JointPQPlayer,72,452,524,24,0,JointPQPlayer
492,JointPQPlayer,216,356,572,72,0,JointPQPlayer
493,JointPQPlayer,198,368,566,66,0,JointPQPlayer
494,JointPQPlayer,186,376,562,62,0,JointPQPlayer
495,JointPQPlayer,192,372,564,64,0,JointPQPlayer
496,JointPQPlayer,90,440,530,30,0,JointPQPlayer
497,JointPQPlayer,90,440,530,30,0,JointPQPlayer
498,JointPQPlayer,180,380,560,60,0,JointPQPlayer
499,JointPQPlayer,93,438,531,31,0,JointPQPlayer
500,JointPQPlayer,108,428,536,36,0,JointPQPlayer
501,JointPQPlayer,216,356,572,72,0,JointPQPlayer
502,JointPQPlayer,150,400,550,50,0,JointPQPlayer
503,JointPQPlayer,63,458,521,21,0,JointPQPlayer
504,JointPQPlayer,207,362,569,69,0,JointPQPlayer
505,JointPQPlayer,216,356,572,72,0,JointPQPlayer
506,JointPQPlayer,90,440,530,30,0,JointPQPlayer
507,JointPQPlayer,198,368,566,66,0,JointPQPlayer
508,JointPQPlayer,213,358,571,71,0,JointPQPlayer
509,JointPQPlayer,204,364,568,68,0,JointPQPlayer
510,JointPQPlayer,144,404,548,48,0,JointPQPlayer
511,JointPQPlayer,192,372,564,64,0,JointPQPlayer
512,JointPQPlayer,201,366,567,67,0,JointPQPlayer
513,JointPQPlayer,207,362,569,69,0,JointPQPlayer
514,JointPQPlayer,237,342,579,79,0,JointPQPlayer
515,JointPQPlayer,225,350,575,75,0,JointPQPlayer
516,JointPQPlayer,189,374,563,63,0,JointPQPlayer
517,JointPQPlayer,195,370,565,65,0,JointPQPlayer
518,JointPQPlayer,189,374,563,63,0,JointPQPlayer
519,JointPQPlayer,93,438,531,31,0,JointPQPlayer
520,JointPQPlayer,219,354,573,73,0,JointPQPlayer
521,JointPQPlayer,189,374,563,63,0,JointPQPlayer
522,JointPQPlayer,195,370,565,65,0,JointPQPlayer
523,JointPQPlayer,210,360,570,70,0,JointPQPlayer
524,JointPQPlayer,225,350,575,75,0,JointPQPlayer
525,JointPQPlayer,228,348,576,76,0,JointPQPlayer
526,JointPQPlayer,225,350,575,75,0,JointPQPlayer
527,JointPQPlayer,213,358,571,71,0,JointPQPlayer
528,JointPQPlayer,204,364,568,68,0,JointPQPlayer
529,JointPQPlayer,216,356,572,72,0,JointPQPlayer
530,JointPQPlayer,213,358,571,71,0,JointPQPlayer
531,JointPQPlayer,216,356,572,72,0,JointPQPlayer
532,JointPQPlayer,216,356,572,72,0,JointPQPlayer
533,JointPQPlayer,228,348,576,76,0,JointPQPlayer
534,JointPQPlayer,198,368,566,66,0,JointPQPlayer
535,JointPQPlayer,201,366,567,67,0,JointPQPlayer
536,JointPQPlayer,210,360,570,70,0,JointPQPlayer
537,JointPQPlayer,72,452,524,24,0,JointPQPlayer
538,JointPQPlayer,75,450,525,25,0,JointPQPlayer
539,JointPQPlayer,84,444,528,28,0,JointPQPlayer
540,JointPQPlayer,228,348,576,76,0,JointPQPlayer
541,JointPQPlayer,225,350,575,75,0,JointPQPlayer
542,JointPQPlayer,84,444,528,28,0,JointPQPlayer
543,JointPQPlayer,114,424,538,38,0,JointPQPlayer
544,JointPQPlayer,192,372,564,64,0,JointPQPlayer
545,JointPQPlayer,186,376,562,62,0,JointPQPlayer
546,JointPQPlayer,78,448,526,26,0,JointPQPlayer
547,JointPQPlayer,93,438,531,31,0,JointPQPlayer
548,JointPQPlayer,210,360,570,70,0,JointPQPlayer
549,JointPQPlayer,225,350,575,75,0,JointPQPlayer
550,JointPQPlayer,144,404,548,48,0,JointPQPlayer
551,JointPQPlayer,204,364,568,68,0,JointPQPlayer
552,JointPQPlayer,174,384,558,58,0,JointPQPlayer
553,JointPQPlayer,219,354,573,73,0,JointPQPlayer
554,JointPQPlayer,210,360,570,70,0,JointPQPlayer
555,JointPQPlayer,93,438,531,31,0,JointPQPlayer
556,JointPQPlayer,213,358,571,71,0,JointPQPlayer
557,JointPQPlayer,210,360,570,70,0,JointPQPlayer
558,JointPQPlayer,213,358,571,71,0,JointPQPlayer
559,JointPQPlayer,180,380,560,60,0,JointPQPlayer
560,JointPQPlayer,90,440,530,30,0,JointPQPlayer
561,JointPQPlayer,78,448,526,26,0,JointPQPlayer
562,JointPQPlayer,63,458,521,21,0,JointPQPlayer
563,JointPQPlayer,84,444,528,28,0,JointPQPlayer
564,JointPQPlayer,207,362,569,69,0,JointPQPlayer
565,JointPQPlayer,225,350,575,75,0,JointPQPlayer
566,JointPQPlayer,213,358,571,71,0,JointPQPlayer
567,JointPQPlayer,87,442,529,29,0,JointPQPlayer
568,JointPQPlayer,228,348,576,76,0,JointPQPlayer
569,JointPQPlayer,219,354,573,73,0,JointPQPlayer
570,JointPQPlayer,219,354,573,73,0,JointPQPlayer
571,JointPQPlayer,219,354,573,73,0,JointPQPlayer
572,JointPQPlayer,150,400,550,50,0,JointPQPlayer
573,JointPQPlayer,201,366,567,67,0,JointPQPlayer
574,JointPQPlayer,213,358,571,71,0,JointPQPlayer
575,JointPQPlayer,195,370,565,65,0,JointPQPlayer
576,JointPQPlayer,228,348,576,76,0,JointPQPlayer
577,JointPQPlayer,222,352,574,74,0,JointPQPlayer
578,JointPQPlayer,93,438,531,31,0,JointPQPlayer
579,JointPQPlayer,231,346,577,77,0,JointPQPlayer
580,JointPQPlayer,195,370,565,65,0,JointPQPlayer
581,JointPQPlayer,237,342,579,79,0,JointPQPlayer
582,JointPQPlayer,69,454,523,23,0,JointPQPlayer
583,JointPQPlayer,204,364,568,68,0,JointPQPlayer
584,JointPQPlayer,207,362,569,69,0,JointPQPlayer
585,JointPQPlayer,213,358,571,71,0,JointPQPlayer
586,JointPQPlayer,234,344,578,78,0,JointPQPlayer
587,JointPQPlayer,183,378,561,61,0,JointPQPlayer
588,JointPQPlayer,63,458,521,21,0,JointPQPlayer
589,JointPQPlayer,213,358,571,71,0,JointPQPlayer
590,JointPQPlayer,204,364,568,68,0,JointPQPlayer
591,JointPQPlayer,60,460,520,20,0,JointPQPlayer
592,JointPQPlayer,210,360,570,70,0,JointPQPlayer
593,JointPQPlayer,186,376,562,62,0,JointPQPlayer
594,JointPQPlayer,99,434,533,33,0,JointPQPlayer
595,JointPQPlayer,216,356,572,72,0,JointPQPlayer
596,JointPQPlayer,207,362,569,69,0,JointPQPlayer
597,JointPQPlayer,192,372,564,64,0,JointPQPlayer
598,JointPQPlayer,99,434,533,33,0,JointPQPlayer
599,JointPQPlayer,204,364,568,68,0,JointPQPlayer
600,JointPQPlayer,210,360,570,70,0,JointPQPlayer
601,JointPQPlayer,207,362,569,69,0,JointPQPlayer
602,JointPQPlayer,219,354,573,73,0,JointPQPlayer
603,JointPQPlayer,195,370,565,65,0,JointPQPlayer
604,JointPQPlayer,207,362,569,69,0,JointPQPlayer
605,JointPQPlayer,75,450,525,25,0,JointPQPlayer
606,JointPQPlayer,216,356,572,72,0,JointPQPlayer
607,JointPQPlayer,222,352,574,74,0,JointPQPlayer
608,JointPQPlayer,228,348,576,76,0,JointPQPlayer
609,JointPQPlayer,222,352,574,74,0,JointPQPlayer
610,JointPQPlayer,186,376,562,62,0,JointPQPlayer
611,JointPQPlayer,198,368,566,66,0,JointPQPlayer
612,JointPQPlayer,87,442,529,29,0,JointPQPlayer
613,JointPQPlayer,78,448,526,26,0,JointPQPlayer
614,JointPQPlayer,93,438,531,31,0,JointPQPlayer
615,JointPQPlayer,216,356,572,72,0,JointPQPlayer
616,JointPQPlayer,207,362,569,69,0,JointPQPlayer
617,JointPQPlayer,219,354,573,73,0,JointPQPlayer
618,JointPQPlayer,222,352,574,74,0,JointPQPlayer
619,JointPQPlayer,222,352,574,74,0,JointPQPlayer
620,JointPQPlayer,216,356,572,72,0,JointPQPlayer
621,JointPQPlayer,219,354,573,73,0,JointPQPlayer
622,JointPQPlayer,204,364,568,68,0,JointPQPlayer
623,JointPQPlayer,60,460,520,20,0,JointPQPlayer
624,JointPQPlayer,219,354,573,73,0,JointPQPlayer
625,JointPQPlayer,156,396,552,52,0,JointPQPlayer
626,JointPQPlayer,84,444,528,28,0,JointPQPlayer
627,JointPQPlayer,195,370,565,65,0,JointPQPlayer
628,JointPQPlayer,216,356,572,72,0,JointPQPlayer
629,JointPQPlayer,90,440,530,30,0,JointPQPlayer
630,JointPQPlayer,198,368,566,66,0,JointPQPlayer
631,JointPQPlayer,213,358,571,71,0,JointPQPlayer
632,JointPQPlayer,201,366,567,67,0,JointPQPlayer
633,JointPQPlayer,216,356,572,72,0,JointPQPlayer
634,JointPQPlayer,222,352,574,74,0,JointPQPlayer
635,JointPQPlayer,66,456,522,22,0,JointPQPlayer
636,JointPQPlayer,81,446,527,27,0,JointPQPlayer
637,JointPQPlayer,198,368,566,66,0,JointPQPlayer
638,JointPQPlayer,216,356,572,72,0,JointPQPlayer
639,JointPQPlayer,207,362,569,69,0,JointPQPlayer
640,JointPQPlayer,216,356,572,72,0,JointPQPlayer
641,JointPQPlayer,195,370,565,65,0,JointPQPlayer
642,JointPQPlayer,219,354,573,73,0,JointPQPlayer
643,JointPQPlayer,195,370,565,65,0,JointPQPlayer
644,JointPQPlayer,198,368,566,66,0,JointPQPlayer
645,JointPQPlayer,210,360,570,70,0,JointPQPlayer
646,JointPQPlayer,234,344,578,78,0,JointPQPlayer
647,JointPQPlayer,39,474,513,13,0,JointPQPlayer
648,JointPQPlayer,96,436,532,32,0,JointPQPlayer
649,JointPQPlayer,90,440,530,30,0,JointPQPlayer
650,JointPQPlayer,210,360,570,70,0,JointPQPlayer
651,JointPQPlayer,81,446,527,27,0,JointPQPlayer
652,JointPQPlayer,183,378,561,61,0,JointPQPlayer
653,JointPQPlayer,204,364,568,68,0,JointPQPlayer
654,JointPQPlayer,216,356,572,72,0,JointPQPlayer
655,JointPQPlayer,234,344,578,78,0,JointPQPlayer
656,JointPQPlayer,198,368,566,66,0,JointPQPlayer
657,JointPQPlayer,195,370,565,65,0,JointPQPlayer
658,JointPQPlayer,216,356,572,72,0,JointPQPlayer
659,JointPQPlayer,210,360,570,70,0,JointPQPlayer
660,JointPQPlayer,219,354,573,73,0,JointPQPlayer
661,JointPQPlayer,219,354,573,73,0,JointPQPlayer
662,JointPQPlayer,177,382,559,59,0,JointPQPlayer
663,JointPQPlayer,183,378,561,61,0,JointPQPlayer
664,JointPQPlayer,207,362,569,69,0,JointPQPlayer
665,JointPQPlayer,192,372,564,64,0,JointPQPlayer
666,JointPQPlayer,222,352,574,74,0,JointPQPlayer
667,JointPQPlayer,195,370,565,65,0,JointPQPlayer
668,JointPQPlayer,204,364,568,68,0,JointPQPlayer
669,JointPQPlayer,189,374,563,63,0,JointPQPlayer
670,JointPQPlayer,207,362,569,69,0,JointPQPlayer
671,JointPQPlayer,222,352,574,74,0,JointPQPlayer
672,JointPQPlayer,243,338,581,81,0,JointPQPlayer
673,JointPQPlayer,207,362,569,69,0,JointPQPlayer
674,JointPQPlayer,126,416,542,42,0,JointPQPlayer
675,JointPQPlayer,207,362,569,69,0,JointPQPlayer
676,JointPQPlayer,210,360,570,70,0,JointPQPlayer
677,JointPQPlayer,204,364,568,68,0,JointPQPlayer
678,JointPQPlayer,222,352,574,74,0,JointPQPlayer
679,JointPQPlayer,96,436,532,32,0,JointPQPlayer
680,JointPQPlayer,207,362,569,69,0,JointPQPlayer
681,JointPQPlayer,216,356,572,72,0,JointPQPlayer
682,JointPQPlayer,198,368,566,66,0,JointPQPlayer
683,JointPQPlayer,96,436,532,32,0,JointPQPlayer
684,JointPQPlayer,84,444,528,28,0,JointPQPlayer
685,JointPQPlayer,222,352,574,74,0,JointPQPlayer
686,JointPQPlayer,78,448,526,26,0,JointPQPlayer
687,JointPQPlayer,78,448,526,26,0,JointPQPlayer
688,JointPQPlayer,216,356,572,72,0,JointPQPlayer
689,JointPQPlayer,84,444,528,28,0,JointPQPlayer
690,JointPQPlayer,219,354,573,73,0,JointPQPlayer
691,JointPQPlayer,219,354,573,73,0,JointPQPlayer
692,JointPQPlayer,87,442,529,29,0,JointPQPlayer
693,JointPQPlayer,87,442,529,29,0,JointPQPlayer
694,JointPQPlayer,216,356,572,72,0,JointPQPlayer
695,JointPQPlayer,222,352,574,74,0,JointPQPlayer
696,JointPQPlayer,201,366,567,67,0,JointPQPlayer
697,JointPQPlayer,186,376,562,62,0,JointPQPlayer
698,JointPQPlayer,81,446,527,27,0,JointPQPlayer
699,JointPQPlayer,204,364,568,68,0,JointPQPlayer
700,JointPQPlayer,201,366,567,67,0,JointPQPlayer
701,JointPQPlayer,93,438,531,31,0,JointPQPlayer
702,JointPQPlayer,195,370,565,65,0,JointPQPlayer
703,JointPQPlayer,72,452,524,24,0,JointPQPlayer
704,JointPQPlayer,207,362,569,69,0,JointPQPlayer
705,JointPQPlayer,207,362,569,69,0,JointPQPlayer
706,JointPQPlayer,207,362,569,69,0,JointPQPlayer
707,JointPQPlayer,72,452,524,24,0,JointPQPlayer
708,JointPQPlayer,213,358,571,71,0,JointPQPlayer
709,JointPQPlayer,225,350,575,75,0,JointPQPlayer
710,JointPQPlayer,93,438,531,31,0,JointPQPlayer
711,JointPQPlayer,201,366,567,67,0,JointPQPlayer
712,JointPQPlayer,213,358,571,71,0,JointPQPlayer
713,JointPQPlayer,219,354,573,73,0,JointPQPlayer
714,JointPQPlayer,198,368,566,66,0,JointPQPlayer
715,JointPQPlayer,198,368,566,66,0,JointPQPlayer
716,JointPQPlayer,69,454,523,23,0,JointPQPlayer
717,JointPQPlayer,210,360,570,70,0,JointPQPlayer
718,JointPQPlayer,210,360,570,70,0,JointPQPlayer
719,JointPQPlayer,216,356,572,72,0,JointPQPlayer
720,JointPQPlayer,216,356,572,72,0,JointPQPlayer
721,JointPQPlayer,216,356,572,72,0,JointPQPlayer
722,JointPQPlayer,78,448,526,26,0,JointPQPlayer
723,JointPQPlayer,93,438,531,31,0,JointPQPlayer
724,JointPQPlayer,213,358,571,71,0,JointPQPlayer
725,JointPQPlayer,219,354,573,73,0,JointPQPlayer
726,JointPQPlayer,213,358,571,71,0,JointPQPlayer
727,JointPQPlayer,225,350,575,75,0,JointPQPlayer
728,JointPQPlayer,213,358,571,71,0,JointPQPlayer
729,JointPQPlayer,177,382,559,59,0,JointPQPlayer
730,JointPQPlayer,207,362,569,69,0,JointPQPlayer
731,JointPQPlayer,90,440,530,30,0,JointPQPlayer
732,JointPQPlayer,201,366,567,67,0,JointPQPlayer
733,JointPQPlayer,207,362,569,69,0,JointPQPlayer
734,JointPQPlayer,84,444,528,28,0,JointPQPlayer
735,JointPQPlayer,210,360,570,70,0,JointPQPlayer
736,JointPQPlayer,207,362,569,69,0,JointPQPlayer
737,JointPQPlayer,177,382,559,59,0,JointPQPlayer
738,JointPQPlayer,210,360,570,70,0,JointPQPlayer
739,JointPQPlayer,207,362,569,69,0,JointPQPlayer
740,JointPQPlayer,195,370,565,65,0,JointPQPlayer
741,JointPQPlayer,195,370,565,65,0,JointPQPlayer
742,JointPQPlayer,219,354,573,73,0,JointPQPlayer
743,JointPQPlayer,87,442,529,29,0,JointPQPlayer
744,JointPQPlayer,195,370,565,65,0,JointPQPlayer
745,JointPQPlayer,198,368,566,66,0,JointPQPlayer
746,JointPQPlayer,219,354,573,73,0,JointPQPlayer
747,JointPQPlayer,84,444,528,28,0,JointPQPlayer
748,JointPQPlayer,99,434,533,33,0,JointPQPlayer
749,JointPQPlayer,219,354,573,73,0,JointPQPlayer
750,JointPQPlayer,99,434,533,33,0,JointPQPlayer
751,JointPQPlayer,201,366,567,67,0,JointPQPlayer
752,JointPQPlayer,225,350,575,75,0,JointPQPlayer
753,JointPQPlayer,225,350,575,75,0,JointPQPlayer
754,JointPQPlayer,213,358,571,71,0,JointPQPlayer
755,JointPQPlayer,189,374,563,63,0,JointPQPlayer
756,JointPQPlayer,204,364,568,68,0,JointPQPlayer
757,JointPQPlayer,93,438,531,31,0,JointPQPlayer
758,JointPQPlayer,225,350,575,75,0,JointPQPlayer
759,JointPQPlayer,210,360,570,70,0,JointPQPlayer
760,JointPQPlayer,204,364,568,68,0,JointPQPlayer
761,JointPQPlayer,90,440,530,30,0,JointPQPlayer
762,JointPQPlayer,210,360,570,70,0,JointPQPlayer
763,JointPQPlayer,192,372,564,64,0,JointPQPlayer
764,JointPQPlayer,195,370,565,65,0,JointPQPlayer
765,JointPQPlayer,93,438,531,31,0,JointPQPlayer
766,JointPQPlayer,108,428,536,36,0,JointPQPlayer
767,JointPQPlayer,210,360,570,70,0,JointPQPlayer
768,JointPQPlayer,219,354,573,73,0,JointPQPlayer
769,JointPQPlayer,231,346,577,77,0,JointPQPlayer
770,JointPQPlayer,195,370,565,65,0,JointPQPlayer
771,JointPQPlayer,204,364,568,68,0,JointPQPlayer
772,JointPQPlayer,219,354,573,73,0,JointPQPlayer
773,JointPQPlayer,201,366,567,67,0,JointPQPlayer
774,JointPQPlayer,198,368,566,66,0,JointPQPlayer
775,JointPQPlayer,222,352,574,74,0,JointPQPlayer
776,JointPQPlayer,210,360,570,70,0,JointPQPlayer
777,JointPQPlayer,213,358,571,71,0,JointPQPlayer
778,JointPQPlayer,204,364,568,68,0,JointPQPlayer
779,JointPQPlayer,99,434,533,33,0,JointPQPlayer
780,JointPQPlayer,219,354,573,73,0,JointPQPlayer
781,JointPQPlayer,96,436,532,32,0,JointPQPlayer
782,JointPQPlayer,210,360,570,70,0,JointPQPlayer
783,JointPQPlayer,78,448,526,26,0,JointPQPlayer
784,JointPQPlayer,81,446,527,27,0,JointPQPlayer
785,JointPQPlayer,216,356,572,72,0,JointPQPlayer
786,JointPQPlayer,84,444,528,28,0,JointPQPlayer
787,JointPQPlayer,234,344,578,78,0,JointPQPlayer
788,JointPQPlayer,222,352,574,74,0,JointPQPlayer
789,JointPQPlayer,87,442,529,29,0,JointPQPlayer
790,JointPQPlayer,186,376,562,62,0,JointPQPlayer
791,JointPQPlayer,189,374,563,63,0,JointPQPlayer
792,JointPQPlayer,216,356,572,72,0,JointPQPlayer
793,JointPQPlayer,78,448,526,26,0,JointPQPlayer
794,JointPQPlayer,213,358,571,71,0,JointPQPlayer
795,JointPQPlayer,198,368,566,66,0,JointPQPlayer
796,JointPQPlayer,204,364,568,68,0,JointPQPlayer
797,JointPQPlayer,201,366,567,67,0,JointPQPlayer
798,JointPQPlayer,90,440,530,30,0,JointPQPlayer
799,JointPQPlayer,87,442,529,29,0,JointPQPlayer
800,JointPQPlayer,207,362,569,69,0,JointPQPlayer
801,JointPQPlayer,219,354,573,73,0,JointPQPlayer
802,JointPQPlayer,156,396,552,52,0,JointPQPlayer
803,JointPQPlayer,189,374,563,63,0,JointPQPlayer
804,JointPQPlayer,210,360,570,70,0,JointPQPlayer
805,JointPQPlayer,228,348,576,76,0,JointPQPlayer
806,JointPQPlayer,213,358,571,71,0,JointPQPlayer
807,JointPQPlayer,201,366,567,67,0,JointPQPlayer
808,JointPQPlayer,204,364,568,68,0,JointPQPlayer
809,JointPQPlayer,219,354,573,73,0,JointPQPlayer
810,JointPQPlayer,87,442,529,29,0,JointPQPlayer
811,JointPQPlayer,192,372,564,64,0,JointPQPlayer
812,JointPQPlayer,144,404,548,48,0,JointPQPlayer
813,JointPQPlayer,207,362,569,69,0,JointPQPlayer
814,JointPQPlayer,195,370,565,65,0,JointPQPlayer
815,JointPQPlayer,72,452,524,24,0,JointPQPlayer
816,JointPQPlayer,219,354,573,73,0,JointPQPlayer
817,JointPQPlayer,201,366,567,67,0,JointPQPlayer
818,JointPQPlayer,204,364,568,68,0,JointPQPlayer
819,JointPQPlayer,216,356,572,72,0,JointPQPlayer
820,JointPQPlayer,189,374,563,63,0,JointPQPlayer
821,JointPQPlayer,90,440,530,30,0,JointPQPlayer
822,JointPQPlayer,93,438,531,31,0,JointPQPlayer
823,JointPQPlayer,81,446,527,27,0,JointPQPlayer
824,JointPQPlayer,93,438,531,31,0,JointPQPlayer
825,JointPQPlayer,81,446,527,27,0,JointPQPlayer
826,JointPQPlayer,198,368,566,66,0,JointPQPlayer
827,JointPQPlayer,201,366,567,67,0,JointPQPlayer
828,JointPQPlayer,219,354,573,73,0,JointPQPlayer
829,JointPQPlayer,213,358,571,71,0,JointPQPlayer
830,JointPQPlayer,102,432,534,34,0,JointPQPlayer
831,JointPQPlayer,204,364,568,68,0,JointPQPlayer
832,JointPQPlayer,219,354,573,73,0,JointPQPlayer
833,JointPQPlayer,207,362,569,69,0,JointPQPlayer
834,JointPQPlayer,222,352,574,74,0,JointPQPlayer
835,JointPQPlayer,231,346,577,77,0,JointPQPlayer
836,JointPQPlayer,84,444,528,28,0,JointPQPlayer
837,JointPQPlayer,99,434,533,33,0,JointPQPlayer
838,JointPQPlayer,213,358,571,71,0,JointPQPlayer
839,JointPQPlayer,213,358,571,71,0,JointPQPlayer
840,JointPQPlayer,207,362,569,69,0,JointPQPlayer
841,JointPQPlayer,231,346,577,77,0,JointPQPlayer
842,JointPQPlayer,174,384,558,58,0,JointPQPlayer
843,JointPQPlayer,90,440,530,30,0,JointPQPlayer
844,JointPQPlayer,219,354,573,73,0,JointPQPlayer
845,JointPQPlayer,78,448,526,26,0,JointPQPlayer
846,JointPQPlayer,201,366,567,67,0,JointPQPlayer
847,JointPQPlayer,204,364,568,68,0,JointPQPlayer
848,JointPQPlayer,90,440,530,30,0,JointPQPlayer
849,JointPQPlayer,84,444,528,28,0,JointPQPlayer
850,JointPQPlayer,210,360,570,70,0,JointPQPlayer
851,JointPQPlayer,210,360,570,70,0,JointPQPlayer
852,JointPQPlayer,90,440,530,30,0,JointPQPlayer
853,JointPQPlayer,198,368,566,66,0,JointPQPlayer
854,JointPQPlayer,126,416,542,42,0,JointPQPlayer
855,JointPQPlayer,201,366,567,67,0,JointPQPlayer
856,JointPQPlayer,222,352,574,74,0,JointPQPlayer
857,JointPQPlayer,84,444,528,28,0,JointPQPlayer
858,JointPQPlayer,216,356,572,72,0,JointPQPlayer
859,JointPQPlayer,87,442,529,29,0,JointPQPlayer
860,JointPQPlayer,189,374,563,63,0,JointPQPlayer
861,JointPQPlayer,222,352,574,74,0,JointPQPlayer
862,JointPQPlayer,84,444,528,28,0,JointPQPlayer
863,JointPQPlayer,213,358,571,71,0,JointPQPlayer
864,JointPQPlayer,165,390,555,55,0,JointPQPlayer
865,JointPQPlayer,90,440,530,30,0,JointPQPlayer
866,JointPQPlayer,192,372,564,64,0,JointPQPlayer
867,JointPQPlayer,99,434,533,33,0,JointPQPlayer
868,JointPQPlayer,93,438,531,31,0,JointPQPlayer
869,JointPQPlayer,57,462,519,19,0,JointPQPlayer
870,JointPQPlayer,87,442,529,29,0,JointPQPlayer
871,JointPQPlayer,198,368,566,66,0,JointPQPlayer
872,JointPQPlayer,84,444,528,28,0,JointPQPlayer
873,JointPQPlayer,213,358,571,71,0,JointPQPlayer
874,JointPQPlayer,198,368,566,66,0,JointPQPlayer
875,JointPQPlayer,75,450,525,25,0,JointPQPlayer
876,JointPQPlayer,222,352,574,74,0,JointPQPlayer
877,JointPQPlayer,210,360,570,70,0,JointPQPlayer
878,JointPQPlayer,93,438,531,31,0,JointPQPlayer
879,JointPQPlayer,219,354,573,73,0,JointPQPlayer
880,JointPQPlayer,96,436,532,32,0,JointPQPlayer
881,JointPQPlayer,60,460,520,20,0,JointPQPlayer
882,JointPQPlayer,201,366,567,67,0,JointPQPlayer
883,JointPQPlayer,207,362,569,69,0,JointPQPlayer
884,JointPQPlayer,87,442,529,29,0,JointPQPlayer
885,JointPQPlayer,195,370,565,65,0,JointPQPlayer
886,JointPQPlayer,204,364,568,68,0,JointPQPlayer
887,JointPQPlayer,195,370,565,65,0,JointPQPlayer
888,JointPQPlayer,222,352,574,74,0,JointPQPlayer
889,JointPQPlayer,240,340,580,80,0,JointPQPlayer
890,JointPQPlayer,216,356,572,72,0,JointPQPlayer
891,JointPQPlayer,195,370,565,65,0,JointPQPlayer
892,JointPQPlayer,192,372,564,64,0,JointPQPlayer
893,JointPQPlayer,210,360,570,70,0,JointPQPlayer
894,JointPQPlayer,81,446,527,27,0,JointPQPlayer
895,JointPQPlayer,75,450,525,25,0,JointPQPlayer
896,JointPQPlayer,66,456,522,22,0,JointPQPlayer
897,JointPQPlayer,213,358,571,71,0,JointPQPlayer
898,JointPQPlayer,141,406,547,47,0,JointPQPlayer
899,JointPQPlayer,225,350,575,75,0,JointPQPlayer
900,JointPQPlayer,201,366,567,67,0,JointPQPlayer
901,JointPQPlayer,213,358,571,71,0,JointPQPlayer
902,JointPQPlayer,219,354,573,73,0,JointPQPlayer
903,JointPQPlayer,201,366,567,67,0,JointPQPlayer
904,JointPQPlayer,216,356,572,72,0,JointPQPlayer
905,JointPQPlayer,222,352,574,74,0,JointPQPlayer
906,JointPQPlayer,189,374,563,63,0,JointPQPlayer
907,JointPQPlayer,201,366,567,67,0,JointPQPlayer
908,JointPQPlayer,225,350,575,75,0,JointPQPlayer
909,JointPQPlayer,240,340,580,80,0,JointPQPlayer
910,JointPQPlayer,132,412,544,44,0,JointPQPlayer
911,JointPQPlayer,72,452,524,24,0,JointPQPlayer
912,JointPQPlayer,207,362,569,69,0,JointPQPlayer
913,JointPQPlayer,219,354,573,73,0,JointPQPlayer
914,JointPQPlayer,201,366,567,67,0,JointPQPlayer
915,JointPQPlayer,111,426,537,37,0,JointPQPlayer
916,JointPQPlayer,72,452,524,24,0,JointPQPlayer
917,JointPQPlayer,84,444,528,28,0,JointPQPlayer
918,JointPQPlayer,159,394,553,53,0,JointPQPlayer
919,JointPQPlayer,198,368,566,66,0,JointPQPlayer
920,JointPQPlayer,81,446,527,27,0,JointPQPlayer
921,JointPQPlayer,216,356,572,72,0,JointPQPlayer
922,JointPQPlayer,75,450,525,25,0,JointPQPlayer
923,JointPQPlayer,93,438,531,31,0,JointPQPlayer
924,JointPQPlayer,213,358,571,71,0,JointPQPlayer
925,JointPQPlayer,201,366,567,67,0,JointPQPlayer
926,JointPQPlayer,204,364,568,68,0,JointPQPlayer
927,JointPQPlayer,96,436,532,32,0,JointPQPlayer
928,JointPQPlayer,210,360,570,70,0,JointPQPlayer
929,JointPQPlayer,228,348,576,76,0,JointPQPlayer
930,JointPQPlayer,87,442,529,29,0,JointPQPlayer
931,JointPQPlayer,72,452,524,24,0,JointPQPlayer
932,JointPQPlayer,69,454,523,23,0,JointPQPlayer
933,JointPQPlayer,216,356,572,72,0,JointPQPlayer
934,JointPQPlayer,219,354,573,73,0,JointPQPlayer
935,JointPQPlayer,63,458,521,21,0,JointPQPlayer
936,JointPQPlayer,219,354,573,73,0,JointPQPlayer
937,JointPQPlayer,219,354,573,73,0,JointPQPlayer
938,JointPQPlayer,216,356,572,72,0,JointPQPlayer
939,JointPQPlayer,222,352,574,74,0,JointPQPlayer
940,JointPQPlayer,204,364,568,68,0,JointPQPlayer
941,JointPQPlayer,84,444,528,28,0,JointPQPlayer
942,JointPQPlayer,192,372,564,64,0,JointPQPlayer
943,JointPQPlayer,210,360,570,70,0,JointPQPlayer
944,JointPQPlayer,78,448,526,26,0,JointPQPlayer
945,JointPQPlayer,204,364,568,68,0,JointPQPlayer
946,JointPQPlayer,78,448,526,26,0,JointPQPlayer
947,JointPQPlayer,192,372,564,64,0,JointPQPlayer
948,JointPQPlayer,210,360,570,70,0,JointPQPlayer
949,JointPQPlayer,213,358,571,71,0,JointPQPlayer
950,JointPQPlayer,87,442,529,29,0,JointPQPlayer
951,JointPQPlayer,213,358,571,71,0,JointPQPlayer
952,JointPQPlayer,195,370,565,65,0,JointPQPlayer
953,JointPQPlayer,213,358,571,71,0,JointPQPlayer
954,JointPQPlayer,243,338,581,81,0,JointPQPlayer
955,JointPQPlayer,96,436,532,32,0,JointPQPlayer
956,JointPQPlayer,219,354,573,73,0,JointPQPlayer
957,JointPQPlayer,96,436,532,32,0,JointPQPlayer
958,JointPQPlayer,66,456,522,22,0,JointPQPlayer
959,JointPQPlayer,243,338,581,81,0,JointPQPlayer
960,JointPQPlayer,87,442,529,29,0,JointPQPlayer
961,JointPQPlayer,198,368,566,66,0,JointPQPlayer
962,JointPQPlayer,216,356,572,72,0,JointPQPlayer
963,JointPQPlayer,195,370,565,65,0,JointPQPlayer
964,JointPQPlayer,225,350,575,75,0,JointPQPlayer
965,JointPQPlayer,66,456,522,22,0,JointPQPlayer
966,JointPQPlayer,198,368,566,66,0,JointPQPlayer
967,JointPQPlayer,84,444,528,28,0,JointPQPlayer
968,JointPQPlayer,144,404,548,48,0,JointPQPlayer
969,JointPQPlayer,168,388,556,56,0,JointPQPlayer
970,JointPQPlayer,99,434,533,33,0,JointPQPlayer
971,JointPQPlayer,195,370,565,65,0,JointPQPlayer
972,JointPQPlayer,225,350,575,75,0,JointPQPlayer
973,JointPQPlayer,201,366,567,67,0,JointPQPlayer
974,JointPQPlayer,216,356,572,72,0,JointPQPlayer
975,JointPQPlayer,84,444,528,28,0,JointPQPlayer
976,JointPQPlayer,87,442,529,29,0,JointPQPlayer
977,JointPQPlayer,222,352,574,74,0,JointPQPlayer
978,JointPQPlayer,234,344,578,78,0,JointPQPlayer
979,JointPQPlayer,213,358,571,71,0,JointPQPlayer
980,JointPQPlayer,222,352,574,74,0,JointPQPlayer
981,JointPQPlayer,213,358,571,71,0,JointPQPlayer
982,JointPQPlayer,78,448,526,26,0,JointPQPlayer
983,JointPQPlayer,216,356,572,72,0,JointPQPlayer
984,JointPQPlayer,216,356,572,72,0,JointPQPlayer
985,JointPQPlayer,90,440,530,30,0,JointPQPlayer
986,JointPQPlayer,96,436,532,32,0,JointPQPlayer
987,JointPQPlayer,225,350,575,75,0,JointPQPlayer
988,JointPQPlayer,222,352,574,74,0,JointPQPlayer
989,JointPQPlayer,186,376,562,62,0,JointPQPlayer
990,JointPQPlayer,96,436,532,32,0,JointPQPlayer
991,JointPQPlayer,207,362,569,69,0,JointPQPlayer
992,JointPQPlayer,90,440,530,30,0,JointPQPlayer
993,JointPQPlayer,207,362,569,69,0,JointPQPlayer
994,JointPQPlayer,93,438,531,31,0,JointPQPlayer
995,JointPQPlayer,189,374,563,63,0,JointPQPlayer
996,JointPQPlayer,219,354,573,73,0,JointPQPlayer
997,JointPQPlayer,222,352,574,74,0,JointPQPlayer
998,JointPQPlayer,213,358,571,71,0,JointPQPlayer
999,JointPQPlayer,213,358,571,71,0,JointPQPlayer
1000,JointPQPlayer,69,454,523,23,0,JointPQPlayer
1001,JointPQPlayer,216,356,572,72,0,JointPQPlayer
1002,JointPQPlayer,93,438,531,31,0,JointPQPlayer
1003,JointPQPlayer,225,350,575,75,0,JointPQPlayer
1004,JointPQPlayer,198,368,566,66,0,JointPQPlayer
1005,JointPQPlayer,72,452,524,24,0,JointPQPlayer
1006,JointPQPlayer,75,450,525,25,0,JointPQPlayer
1007,JointPQPlayer,84,444,528,28,0,JointPQPlayer
1008,JointPQPlayer,84,444,528,28,0,JointPQPlayer
1009,JointPQPlayer,69,454,523,23,0,JointPQPlayer
1010,JointPQPlayer,102,432,534,34,0,JointPQPlayer
1011,JointPQPlayer,198,368,566,66,0,JointPQPlayer
1012,JointPQPlayer,195,370,565,65,0,JointPQPlayer
1013,JointPQPlayer,231,346,577,77,0,JointPQPlayer
1014,JointPQPlayer,78,448,526,26,0,JointPQPlayer
1015,JointPQPlayer,87,442,529,29,0,JointPQPlayer
1016,JointPQPlayer,225,350,575,75,0,JointPQPlayer
1017,JointPQPlayer,207,362,569,69,0,JointPQPlayer
1018,JointPQPlayer,207,362,569,69,0,JointPQPlayer
1019,JointPQPlayer,228,348,576,76,0,JointPQPlayer
1020,JointPQPlayer,219,354,573,73,0,JointPQPlayer
1021,JointPQPlayer,210,360,570,70,0,JointPQPlayer
1022,JointPQPlayer,114,424,538,38,0,JointPQPlayer
1023,JointPQPlayer,207,362,569,69,0,JointPQPlayer
1024,JointPQPlayer,174,384,558,58,0,JointPQPlayer
1025,JointPQPlayer,141,406,547,47,0,JointPQPlayer
1026,JointPQPlayer,192,372,564,64,0,JointPQPlayer
1027,JointPQPlayer,54,464,518,18,0,JointPQPlayer
1028,JointPQPlayer,210,360,570,70,0,JointPQPlayer
1029,JointPQPlayer,69,454,523,23,0,JointPQPlayer
1030,JointPQPlayer,195,370,565,65,0,JointPQPlayer
1031,JointPQPlayer,81,446,527,27,0,JointPQPlayer
1032,JointPQPlayer,180,380,560,60,0,JointPQPlayer
1033,JointPQPlayer,105,430,535,35,0,JointPQPlayer
1034,JointPQPlayer,207,362,569,69,0,JointPQPlayer
1035,JointPQPlayer,141,406,547,47,0,JointPQPlayer
1036,JointPQPlayer,189,374,563,63,0,JointPQPlayer
1037,JointPQPlayer,102,432,534,34,0,JointPQPlayer
1038,JointPQPlayer,195,370,565,65,0,JointPQPlayer
1039,JointPQPlayer,201,366,567,67,0,JointPQPlayer
1040,JointPQPlayer,132,412,544,44,0,JointPQPlayer
1041,JointPQPlayer,66,456,522,22,0,JointPQPlayer
1042,JointPQPlayer,219,354,573,73,0,JointPQPlayer
1043,JointPQPlayer,207,362,569,69,0,JointPQPlayer
1044,JointPQPlayer,201,366,567,67,0,JointPQPlayer
1045,JointPQPlayer,219,354,573,73,0,JointPQPlayer
1046,JointPQPlayer,210,360,570,70,0,JointPQPlayer
1047,JointPQPlayer,210,360,570,70,0,JointPQPlayer
1048,JointPQPlayer,90,440,530,30,0,JointPQPlayer
1049,JointPQPlayer,84,444,528,28,0,JointPQPlayer
1050,JointPQPlayer,99,434,533,33,0,JointPQPlayer
1051,JointPQPlayer,210,360,570,70,0,JointPQPlayer
1052,JointPQPlayer,198,368,566,66,0,JointPQPlayer
1053,JointPQPlayer,72,452,524,24,0,JointPQPlayer
1054,JointPQPlayer,87,442,529,29,0,JointPQPlayer
1055,JointPQPlayer,216,356,572,72,0,JointPQPlayer
1056,JointPQPlayer,213,358,571,71,0,JointPQPlayer
1057,JointPQPlayer,201,366,567,67,0,JointPQPlayer
1058,JointPQPlayer,75,450,525,25,0,JointPQPlayer
1059,JointPQPlayer,201,366,567,67,0,JointPQPlayer
1060,JointPQPlayer,81,446,527,27,0,JointPQPlayer
1061,JointPQPlayer,186,376,562,62,0,JointPQPlayer
1062,JointPQPlayer,222,352,574,74,0,JointPQPlayer
1063,JointPQPlayer,192,372,564,64,0,JointPQPlayer
1064,JointPQPlayer,219,354,573,73,0,JointPQPlayer
1065,JointPQPlayer,207,362,569,69,0,JointPQPlayer
1066,JointPQPlayer,198,368,566,66,0,JointPQPlayer
1067,JointPQPlayer,204,364,568,68,0,JointPQPlayer
1068,JointPQPlayer,93,438,531,31,0,JointPQPlayer
1069,JointPQPlayer,228,348,576,76,0,JointPQPlayer
1070,JointPQPlayer,78,448,526,26,0,JointPQPlayer
1071,JointPQPlayer,195,370,565,65,0,JointPQPlayer
1072,JointPQPlayer,222,352,574,74,0,JointPQPlayer
1073,JointPQPlayer,213,358,571,71,0,JointPQPlayer
1074,JointPQPlayer,225,350,575,75,0,JointPQPlayer
1075,JointPQPlayer,213,358,571,71,0,JointPQPlayer
1076,JointPQPlayer,84,444,528,28,0,JointPQPlayer
1077,JointPQPlayer,84,444,528,28,0,JointPQPlayer
1078,JointPQPlayer,213,358,571,71,0,JointPQPlayer
1079,JointPQPlayer,204,364,568,68,0,JointPQPlayer
1080,JointPQPlayer,165,390,555,55,0,JointPQPlayer
1081,JointPQPlayer,87,442,529,29,0,JointPQPlayer
1082,JointPQPlayer,78,448,526,26,0,JointPQPlayer
1083,JointPQPlayer,219,354,573,73,0,JointPQPlayer
1084,JointPQPlayer,78,448,526,26,0,JointPQPlayer
1085,JointPQPlayer,183,378,561,61,0,JointPQPlayer
1086,JointPQPlayer,222,352,574,74,0,JointPQPlayer
1087,JointPQPlayer,222,352,574,74,0,JointPQPlayer
1088,JointPQPlayer,228,348,576,76,0,JointPQPlayer
1089,JointPQPlayer,90,440,530,30,0,JointPQPlayer
1090,JointPQPlayer,210,360,570,70,0,JointPQPlayer
1091,JointPQPlayer,225,350,575,75,0,JointPQPlayer
1092,JointPQPlayer,240,340,580,80,0,JointPQPlayer
1093,JointPQPlayer,78,448,526,26,0,JointPQPlayer
1094,JointPQPlayer,99,434,533,33,0,JointPQPlayer
1095,JointPQPlayer,216,356,572,72,0,JointPQPlayer
1096,JointPQPlayer,234,344,578,78,0,JointPQPlayer
1097,JointPQPlayer,147,402,549,49,0,JointPQPlayer
1098,JointPQPlayer,198,368,566,66,0,JointPQPlayer
1099,JointPQPlayer,207,362,569,69,0,JointPQPlayer
1100,JointPQPlayer,87,442,529,29,0,JointPQPlayer
1101,JointPQPlayer,213,358,571,71,0,JointPQPlayer
1102,JointPQPlayer,210,360,570,70,0,JointPQPlayer
1103,JointPQPlayer,222,352,574,74,0,JointPQPlayer
1104,JointPQPlayer,102,432,534,34,0,JointPQPlayer
1105,JointPQPlayer,126,416,542,42,0,JointPQPlayer
1106,JointPQPlayer,219,354,573,73,0,JointPQPlayer
1107,JointPQPlayer,183,378,561,61,0,JointPQPlayer
1108,JointPQPlayer,195,370,565,65,0,JointPQPlayer
1109,JointPQPlayer,225,350,575,75,0,JointPQPlayer
1110,JointPQPlayer,192,372,564,64,0,JointPQPlayer
1111,JointPQPlayer,195,370,565,65,0,JointPQPlayer
1112,JointPQPlayer,72,452,524,24,0,JointPQPlayer
1113,JointPQPlayer,69,454,523,23,0,JointPQPlayer
1114,JointPQPlayer,204,364,568,68,0,JointPQPlayer
1115,JointPQPlayer,75,450,525,25,0,JointPQPlayer
1116,JointPQPlayer,108,428,536,36,0,JointPQPlayer
1117,JointPQPlayer,207,362,569,69,0,JointPQPlayer
1118,JointPQPlayer,213,358,571,71,0,JointPQPlayer
1119,JointPQPlayer,93,438,531,31,0,JointPQPlayer
1120,JointPQPlayer,198,368,566,66,0,JointPQPlayer
1121,JointPQPlayer,81,446,527,27,0,JointPQPlayer
1122,JointPQPlayer,240,340,580,80,0,JointPQPlayer
1123,JointPQPlayer,96,436,532,32,0,JointPQPlayer
1124,JointPQPlayer,180,380,560,60,0,JointPQPlayer
1125,JointPQPlayer,222,352,574,74,0,JointPQPlayer
1126,JointPQPlayer,216,356,572,72,0,JointPQPlayer
1127,JointPQPlayer,207,362,569,69,0,JointPQPlayer
1128,JointPQPlayer,213,358,571,71,0,JointPQPlayer
1129,JointPQPlayer,162,392,554,54,0,JointPQPlayer
1130,JointPQPlayer,198,368,566,66,0,JointPQPlayer
1131,JointPQPlayer,78,448,526,26,0,JointPQPlayer
1132,JointPQPlayer,204,364,568,68,0,JointPQPlayer
1133,JointPQPlayer,198,368,566,66,0,JointPQPlayer
1134,JointPQPlayer,249,334,583,83,0,JointPQPlayer
1135,JointPQPlayer,210,360,570,70,0,JointPQPlayer
1136,JointPQPlayer,204,364,568,68,0,JointPQPlayer
1137,JointPQPlayer,102,432,534,34,0,JointPQPlayer
1138,JointPQPlayer,114,424,538,38,0,JointPQPlayer
1139,JointPQPlayer,222,352,574,74,0,JointPQPlayer
1140,JointPQPlayer,210,360,570,70,0,JointPQPlayer
1141,JointPQPlayer,204,364,568,68,0,JointPQPlayer
1142,JointPQPlayer,216,356,572,72,0,JointPQPlayer
1143,JointPQPlayer,195,370,565,65,0,JointPQPlayer
1144,JointPQPlayer,66,456,522,22,0,JointPQPlayer
1145,JointPQPlayer,216,356,572,72,0,JointPQPlayer
1146,JointPQPlayer,210,360,570,70,0,JointPQPlayer
1147,JointPQPlayer,219,354,573,73,0,JointPQPlayer
1148,JointPQPlayer,87,442,529,29,0,JointPQPlayer
1149,JointPQPlayer,72,452,524,24,0,JointPQPlayer
1150,JointPQPlayer,93,438,531,31,0,JointPQPlayer
1151,JointPQPlayer,78,448,526,26,0,JointPQPlayer
1152,JointPQPlayer,93,438,531,31,0,JointPQPlayer
1153,JointPQPlayer,75,450,525,25,0,JointPQPlayer
1154,JointPQPlayer,222,352,574,74,0,JointPQPlayer
1155,JointPQPlayer,87,442,529,29,0,JointPQPlayer
1156,JointPQPlayer,123,418,541,41,0,JointPQPlayer
1157,JointPQPlayer,216,356,572,72,0,JointPQPlayer
1158,JointPQPlayer,72,452,524,24,0,JointPQPlayer
1159,JointPQPlayer,183,378,561,61,0,JointPQPlayer
1160,JointPQPlayer,225,350,575,75,0,JointPQPlayer
1161,JointPQPlayer,228,348,576,76,0,JointPQPlayer
1162,JointPQPlayer,78,448,526,26,0,JointPQPlayer
1163,JointPQPlayer,204,364,568,68,0,JointPQPlayer
1164,JointPQPlayer,153,398,551,51,0,JointPQPlayer
1165,JointPQPlayer,174,384,558,58,0,JointPQPlayer
1166,JointPQPlayer,210,360,570,70,0,JointPQPlayer
1167,JointPQPlayer,204,364,568,68,0,JointPQPlayer
1168,JointPQPlayer,96,436,532,32,0,JointPQPlayer
1169,JointPQPlayer,198,368,566,66,0,JointPQPlayer
1170,JointPQPlayer,198,368,566,66,0,JointPQPlayer
1171,JointPQPlayer,234,344,578,78,0,JointPQPlayer
1172,JointPQPlayer,186,376,562,62,0,JointPQPlayer
1173,JointPQPlayer,210,360,570,70,0,JointPQPlayer
1174,JointPQPlayer,156,396,552,52,0,JointPQPlayer
1175,JointPQPlayer,213,358,571,71,0,JointPQPlayer
1176,JointPQPlayer,216,356,572,72,0,JointPQPlayer
1177,JointPQPlayer,228,348,576,76,0,JointPQPlayer
1178,JointPQPlayer,78,448,526,26,0,JointPQPlayer
1179,JointPQPlayer,81,446,527,27,0,JointPQPlayer
1180,JointPQPlayer,210,360,570,70,0,JointPQPlayer
1181,JointPQPlayer,234,344,578,78,0,JointPQPlayer
1182,JointPQPlayer,234,344,578,78,0,JointPQPlayer
1183,JointPQPlayer,219,354,573,73,0,JointPQPlayer
1184,JointPQPlayer,207,362,569,69,0,JointPQPlayer
1185,JointPQPlayer,204,364,568,68,0,JointPQPlayer
1186,JointPQPlayer,228,348,576,76,0,JointPQPlayer
1187,JointPQPlayer,159,394,553,53,0,JointPQPlayer
1188,JointPQPlayer,81,446,527,27,0,JointPQPlayer
1189,JointPQPlayer,195,370,565,65,0,JointPQPlayer
1190,JointPQPlayer,210,360,570,70,0,JointPQPlayer
1191,JointPQPlayer,207,362,569,69,0,JointPQPlayer
1192,JointPQPlayer,222,352,574,74,0,JointPQPlayer
1193,JointPQPlayer,186,376,562,62,0,JointPQPlayer
1194,JointPQPlayer,204,364,568,68,0,JointPQPlayer
1195,JointPQPlayer,213,358,571,71,0,JointPQPlayer
1196,JointPQPlayer,195,370,565,65,0,JointPQPlayer
1197,JointPQPlayer,90,440,530,30,0,JointPQPlayer
1198,JointPQPlayer,249,334,583,83,0,JointPQPlayer
1199,JointPQPlayer,201,366,567,67,0,JointPQPlayer
1200,JointPQPlayer,195,370,565,65,0,JointPQPlayer
1201,JointPQPlayer,213,358,571,71,0,JointPQPlayer
1202,JointPQPlayer,102,432,534,34,0,JointPQPlayer
1203,JointPQPlayer,213,358,571,71,0,JointPQPlayer
1204,JointPQPlayer,201,366,567,67,0,JointPQPlayer
1205,JointPQPlayer,216,356,572,72,0,JointPQPlayer
1206,JointPQPlayer,78,448,526,26,0,JointPQPlayer
1207,JointPQPlayer,237,342,579,79,0,JointPQPlayer
1208,JointPQPlayer,90,440,530,30,0,JointPQPlayer
1209,JointPQPlayer,213,358,571,71,0,JointPQPlayer
1210,JointPQPlayer,189,374,563,63,0,JointPQPlayer
1211,JointPQPlayer,228,348,576,76,0,JointPQPlayer
1212,JointPQPlayer,195,370,565,65,0,JointPQPlayer
1213,JointPQPlayer,231,346,577,77,0,JointPQPlayer
1214,JointPQPlayer,201,366,567,67,0,JointPQPlayer
1215,JointPQPlayer,204,364,568,68,0,JointPQPlayer
1216,JointPQPlayer,84,444,528,28,0,JointPQPlayer
1217,JointPQPlayer,87,442,529,29,0,JointPQPlayer
1218,JointPQPlayer,213,358,571,71,0,JointPQPlayer
1219,JointPQPlayer,195,370,565,65,0,JointPQPlayer
1220,JointPQPlayer,87,442,529,29,0,JointPQPlayer
1221,JointPQPlayer,87,442,529,29,0,JointPQPlayer
1222,JointPQPlayer,216,356,572,72,0,JointPQPlayer
1223,JointPQPlayer,156,396,552,52,0,JointPQPlayer
1224,JointPQPlayer,189,374,563,63,0,JointPQPlayer
1225,JointPQPlayer,216,356,572,72,0,JointPQPlayer
1226,JointPQPlayer,75,450,525,25,0,JointPQPlayer
1227,JointPQPlayer,72,452,524,24,0,JointPQPlayer
1228,JointPQPlayer,87,442,529,29,0,JointPQPlayer
1229,JointPQPlayer,69,454,523,23,0,JointPQPlayer
1230,JointPQPlayer,228,348,576,76,0,JointPQPlayer
1231,JointPQPlayer,87,442,529,29,0,JointPQPlayer
1232,JointPQPlayer,210,360,570,70,0,JointPQPlayer
1233,JointPQPlayer,201,366,567,67,0,JointPQPlayer
1234,JointPQPlayer,228,348,576,76,0,JointPQPlayer
1235,JointPQPlayer,78,448,526,26,0,JointPQPlayer
1236,JointPQPlayer,216,356,572,72,0,JointPQPlayer
1237,JointPQPlayer,99,434,533,33,0,JointPQPlayer
1238,JointPQPlayer,222,352,574,74,0,JointPQPlayer
1239,JointPQPlayer,216,356,572,72,0,JointPQPlayer
1240,JointPQPlayer,90,440,530,30,0,JointPQPlayer
1241,JointPQPlayer,69,454,523,23,0,JointPQPlayer
1242,JointPQPlayer,75,450,525,25,0,JointPQPlayer
1243,JointPQPlayer,105,430,535,35,0,JointPQPlayer
1244,JointPQPlayer,87,442,529,29,0,JointPQPlayer
1245,JointPQPlayer,213,358,571,71,0,JointPQPlayer
1246,JointPQPlayer,192,372,564,64,0,JointPQPlayer
1247,JointPQPlayer,87,442,529,29,0,JointPQPlayer
1248,JointPQPlayer,216,356,572,72,0,JointPQPlayer
1249,JointPQPlayer,207,362,569,69,0,JointPQPlayer
1250,JointPQPlayer,72,452,524,24,0,JointPQPlayer
1251,JointPQPlayer,198,368,566,66,0,JointPQPlayer
1252,JointPQPlayer,225,350,575,75,0,JointPQPlayer
1253,JointPQPlayer,222,352,574,74,0,JointPQPlayer
1254,JointPQPlayer,204,364,568,68,0,JointPQPlayer
1255,JointPQPlayer,192,372,564,64,0,JointPQPlayer
1256,JointPQPlayer,219,354,573,73,0,JointPQPlayer
1257,JointPQPlayer,219,354,573,73,0,JointPQPlayer
1258,JointPQPlayer,189,374,563,63,0,JointPQPlayer
1259,JointPQPlayer,210,360,570,70,0,JointPQPlayer
1260,JointPQPlayer,195,370,565,65,0,JointPQPlayer
1261,JointPQPlayer,93,438,531,31,0,JointPQPlayer
1262,JointPQPlayer,222,352,574,74,0,JointPQPlayer
1263,JointPQPlayer,231,346,577,77,0,JointPQPlayer
1264,JointPQPlayer,195,370,565,65,0,JointPQPlayer
1265,JointPQPlayer,201,366,567,67,0,JointPQPlayer
1266,JointPQPlayer,201,366,567,67,0,JointPQPlayer
1267,JointPQPlayer,111,426,537,37,0,JointPQPlayer
1268,JointPQPlayer,195,370,565,65,0,JointPQPlayer
1269,JointPQPlayer,222,352,574,74,0,JointPQPlayer
1270,JointPQPlayer,84,444,528,28,0,JointPQPlayer
1271,JointPQPlayer,213,358,571,71,0,JointPQPlayer
1272,JointPQPlayer,84,444,528,28,0,JointPQPlayer
1273,JointPQPlayer,108,428,536,36,0,JointPQPlayer
1274,JointPQPlayer,207,362,569,69,0,JointPQPlayer
1275,JointPQPlayer,225,350,575,75,0,JointPQPlayer
1276,JointPQPlayer,93,438,531,31,0,JointPQPlayer
1277,JointPQPlayer,198,368,566,66,0,JointPQPlayer
1278,JointPQPlayer,219,354,573,73,0,JointPQPlayer
1279,JointPQPlayer,78,448,526,26,0,JointPQPlayer
1280,JointPQPlayer,207,362,569,69,0,JointPQPlayer
1281,JointPQPlayer,84,444,528,28,0,JointPQPlayer
1282,JointPQPlayer,225,350,575,75,0,JointPQPlayer
1283,JointPQPlayer,207,362,569,69,0,JointPQPlayer
1284,JointPQPlayer,219,354,573,73,0,JointPQPlayer
1285,JointPQPlayer,180,380,560,60,0,JointPQPlayer
1286,JointPQPlayer,228,348,576,76,0,JointPQPlayer
1287,JointPQPlayer,192,372,564,64,0,JointPQPlayer
1288,JointPQPlayer,228,348,576,76,0,JointPQPlayer
1289,JointPQPlayer,69,454,523,23,0,JointPQPlayer
1290,JointPQPlayer,204,364,568,68,0,JointPQPlayer
1291,JointPQPlayer,192,372,564,64,0,JointPQPlayer
1292,JointPQPlayer,216,356,572,72,0,JointPQPlayer
1293,JointPQPlayer,201,366,567,67,0,JointPQPlayer
1294,JointPQPlayer,210,360,570,70,0,JointPQPlayer
1295,JointPQPlayer,174,384,558,58,0,JointPQPlayer
1296,JointPQPlayer,216,356,572,72,0,JointPQPlayer
1297,JointPQPlayer,204,364,568,68,0,JointPQPlayer
1298,JointPQPlayer,201,366,567,67,0,JointPQPlayer
1299,JointPQPlayer,228,348,576,76,0,JointPQPlayer
1300,JointPQPlayer,192,372,564,64,0,JointPQPlayer
1301,JointPQPlayer,204,364,568,68,0,JointPQPlayer
1302,JointPQPlayer,207,362,569,69,0,JointPQPlayer
1303,JointPQPlayer,210,360,570,70,0,JointPQPlayer
1304,JointPQPlayer,234,344,578,78,0,JointPQPlayer
1305,JointPQPlayer,213,358,571,71,0,JointPQPlayer
1306,JointPQPlayer,231,346,577,77,0,JointPQPlayer
1307,JointPQPlayer,87,442,529,29,0,JointPQPlayer
1308,JointPQPlayer,204,364,568,68,0,JointPQPlayer
1309,JointPQPlayer,105,430,535,35,0,JointPQPlayer
1310,JointPQPlayer,219,354,573,73,0,JointPQPlayer
1311,JointPQPlayer,75,450,525,25,0,JointPQPlayer
1312,JointPQPlayer,204,364,568,68,0,JointPQPlayer
1313,JointPQPlayer,78,448,526,26,0,JointPQPlayer
1314,JointPQPlayer,192,372,564,64,0,JointPQPlayer
1315,JointPQPlayer,207,362,569,69,0,JointPQPlayer
1316,JointPQPlayer,207,362,569,69,0,JointPQPlayer
1317,JointPQPlayer,144,404,548,48,0,JointPQPlayer
1318,JointPQPlayer,96,436,532,32,0,JointPQPlayer
1319,JointPQPlayer,207,362,569,69,0,JointPQPlayer
1320,JointPQPlayer,216,356,572,72,0,JointPQPlayer
1321,JointPQPlayer,189,374,563,63,0,JointPQPlayer
1322,JointPQPlayer,228,348,576,76,0,JointPQPlayer
1323,JointPQPlayer,186,376,562,62,0,JointPQPlayer
1324,JointPQPlayer,210,360,570,70,0,JointPQPlayer
1325,JointPQPlayer,84,444,528,28,0,JointPQPlayer
1326,JointPQPlayer,204,364,568,68,0,JointPQPlayer
1327,JointPQPlayer,84,444,528,28,0,JointPQPlayer
1328,JointPQPlayer,192,372,564,64,0,JointPQPlayer
1329,JointPQPlayer,237,342,579,79,0,JointPQPlayer
1330,JointPQPlayer,210,360,570,70,0,JointPQPlayer
1331,JointPQPlayer,183,378,561,61,0,JointPQPlayer
1332,JointPQPlayer,189,374,563,63,0,JointPQPlayer
1333,JointPQPlayer,144,404,548,48,0,JointPQPlayer
1334,JointPQPlayer,99,434,533,33,0,JointPQPlayer
1335,JointPQPlayer,216,356,572,72,0,JointPQPlayer
1336,JointPQPlayer,213,358,571,71,0,JointPQPlayer
1337,JointPQPlayer,87,442,529,29,0,JointPQPlayer
1338,JointPQPlayer,234,344,578,78,0,JointPQPlayer
1339,JointPQPlayer,75,450,525,25,0,JointPQPlayer
1340,JointPQPlayer,222,352,574,74,0,JointPQPlayer
1341,JointPQPlayer,96,436,532,32,0,JointPQPlayer
1342,JointPQPlayer,213,358,571,71,0,JointPQPlayer
1343,JointPQPlayer,228,348,576,76,0,JointPQPlayer
1344,JointPQPlayer,87,442,529,29,0,JointPQPlayer
1345,JointPQPlayer,78,448,526,26,0,JointPQPlayer
1346,JointPQPlayer,213,358,571,71,0,JointPQPlayer
1347,JointPQPlayer,195,370,565,65,0,JointPQPlayer
1348,JointPQPlayer,216,356,572,72,0,JointPQPlayer
1349,JointPQPlayer,141,406,547,47,0,JointPQPlayer
1350,JointPQPlayer,222,352,574,74,0,JointPQPlayer
1351,JointPQPlayer,198,368,566,66,0,JointPQPlayer
1352,JointPQPlayer,66,456,522,22,0,JointPQPlayer
1353,JointPQPlayer,114,424,538,38,0,JointPQPlayer
1354,JointPQPlayer,216,356,572,72,0,JointPQPlayer
1355,JointPQPlayer,201,366,567,67,0,JointPQPlayer
1356,JointPQPlayer,105,430,535,35,0,JointPQPlayer
1357,JointPQPlayer,219,354,573,73,0,JointPQPlayer
1358,JointPQPlayer,114,424,538,38,0,JointPQPlayer
1359,JointPQPlayer,201,366,567,67,0,JointPQPlayer
1360,JointPQPlayer,216,356,572,72,0,JointPQPlayer
1361,JointPQPlayer,219,354,573,73,0,JointPQPlayer
1362,JointPQPlayer,195,370,565,65,0,JointPQPlayer
1363,JointPQPlayer,225,350,575,75,0,JointPQPlayer
1364,JointPQPlayer,210,360,570,70,0,JointPQPlayer
1365,JointPQPlayer,213,358,571,71,0,JointPQPlayer
1366,JointPQPlayer,66,456,522,22,0,JointPQPlayer
1367,JointPQPlayer,222,352,574,74,0,JointPQPlayer
1368,JointPQPlayer,204,364,568,68,0,JointPQPlayer
1369,JointPQPlayer,219,354,573,73,0,JointPQPlayer
1370,JointPQPlayer,168,388,556,56,0,JointPQPlayer
1371,JointPQPlayer,186,376,562,62,0,JointPQPlayer
1372,JointPQPlayer,168,388,556,56,0,JointPQPlayer
1373,JointPQPlayer,90,440,530,30,0,JointPQPlayer
1374,JointPQPlayer,219,354,573,73,0,JointPQPlayer
1375,JointPQPlayer,96,436,532,32,0,JointPQPlayer
1376,JointPQPlayer,93,438,531,31,0,JointPQPlayer
1377,JointPQPlayer,234,344,578,78,0,JointPQPlayer
1378,JointPQPlayer,207,362,569,69,0,JointPQPlayer
1379,JointPQPlayer,96,436,532,32,0,JointPQPlayer
1380,JointPQPlayer,210,360,570,70,0,JointPQPlayer
1381,JointPQPlayer,207,362,569,69,0,JointPQPlayer
1382,JointPQPlayer,96,436,532,32,0,JointPQPlayer
1383,JointPQPlayer,192,372,564,64,0,JointPQPlayer
1384,JointPQPlayer,147,402,549,49,0,JointPQPlayer
1385,JointPQPlayer,222,352,574,74,0,JointPQPlayer
1386,JointPQPlayer,150,400,550,50,0,JointPQPlayer
1387,JointPQPlayer,243,338,581,81,0,JointPQPlayer
1388,JointPQPlayer,78,448,526,26,0,JointPQPlayer
1389,JointPQPlayer,231,346,577,77,0,JointPQPlayer
1390,JointPQPlayer,219,354,573,73,0,JointPQPlayer
1391,JointPQPlayer,219,354,573,73,0,JointPQPlayer
1392,JointPQPlayer,192,372,564,64,0,JointPQPlayer
1393,JointPQPlayer,219,354,573,73,0,JointPQPlayer
1394,JointPQPlayer,189,374,563,63,0,JointPQPlayer
1395,JointPQPlayer,207,362,569,69,0,JointPQPlayer
1396,JointPQPlayer,225,350,575,75,0,JointPQPlayer
1397,JointPQPlayer,213,358,571,71,0,JointPQPlayer
1398,JointPQPlayer,240,340,580,80,0,JointPQPlayer
1399,JointPQPlayer,201,366,567,67,0,JointPQPlayer
1400,JointPQPlayer,159,394,553,53,0,JointPQPlayer
1401,JointPQPlayer,87,442,529,29,0,JointPQPlayer
1402,JointPQPlayer,195,370,565,65,0,JointPQPlayer
1403,JointPQPlayer,207,362,569,69,0,JointPQPlayer
1404,JointPQPlayer,207,362,569,69,0,JointPQPlayer
1405,JointPQPlayer,213,358,571,71,0,JointPQPlayer
1406,JointPQPlayer,72,452,524,24,0,JointPQPlayer
1407,JointPQPlayer,207,362,569,69,0,JointPQPlayer
1408,JointPQPlayer,207,362,569,69,0,JointPQPlayer
1409,JointPQPlayer,207,362,569,69,0,JointPQPlayer
1410,JointPQPlayer,225,350,575,75,0,JointPQPlayer
1411,JointPQPlayer,159,394,553,53,0,JointPQPlayer
1412,JointPQPlayer,63,458,521,21,0,JointPQPlayer
1413,JointPQPlayer,72,452,524,24,0,JointPQPlayer
1414,JointPQPlayer,231,346,577,77,0,JointPQPlayer
1415,JointPQPlayer,171,386,557,57,0,JointPQPlayer
1416,JointPQPlayer,213,358,571,71,0,JointPQPlayer
1417,JointPQPlayer,234,344,578,78,0,JointPQPlayer
1418,JointPQPlayer,213,358,571,71,0,JointPQPlayer
1419,JointPQPlayer,204,364,568,68,0,JointPQPlayer
1420,JointPQPlayer,198,368,566,66,0,JointPQPlayer
1421,JointPQPlayer,153,398,551,51,0,JointPQPlayer
1422,JointPQPlayer,210,360,570,70,0,JointPQPlayer
1423,JointPQPlayer,237,342,579,79,0,JointPQPlayer
1424,JointPQPlayer,69,454,523,23,0,JointPQPlayer
1425,JointPQPlayer,69,454,523,23,0,JointPQPlayer
1426,JointPQPlayer,84,444,528,28,0,JointPQPlayer
1427,JointPQPlayer,147,402,549,49,0,JointPQPlayer
1428,JointPQPlayer,210,360,570,70,0,JointPQPlayer
1429,JointPQPlayer,201,366,567,67,0,JointPQPlayer
1430,JointPQPlayer,81,446,527,27,0,JointPQPlayer
1431,JointPQPlayer,213,358,571,71,0,JointPQPlayer
1432,JointPQPlayer,180,380,560,60,0,JointPQPlayer
1433,JointPQPlayer,90,440,530,30,0,JointPQPlayer
1434,JointPQPlayer,75,450,525,25,0,JointPQPlayer
1435,JointPQPlayer,183,378,561,61,0,JointPQPlayer
1436,JointPQPlayer,210,360,570,70,0,JointPQPlayer
1437,JointPQPlayer,186,376,562,62,0,JointPQPlayer
1438,JointPQPlayer,90,440,530,30,0,JointPQPlayer
1439,JointPQPlayer,240,340,580,80,0,JointPQPlayer
1440,JointPQPlayer,213,358,571,71,0,JointPQPlayer
1441,JointPQPlayer,198,368,566,66,0,JointPQPlayer
1442,JointPQPlayer,210,360,570,70,0,JointPQPlayer
1443,JointPQPlayer,219,354,573,73,0,JointPQPlayer
1444,JointPQPlayer,72,452,524,24,0,JointPQPlayer
1445,JointPQPlayer,210,360,570,70,0,JointPQPlayer
1446,JointPQPlayer,201,366,567,67,0,JointPQPlayer
1447,JointPQPlayer,183,378,561,61,0,JointPQPlayer
1448,JointPQPlayer,90,440,530,30,0,JointPQPlayer
1449,JointPQPlayer,207,362,569,69,0,JointPQPlayer
1450,JointPQPlayer,81,446,527,27,0,JointPQPlayer
1451,JointPQPlayer,216,356,572,72,0,JointPQPlayer
1452,JointPQPlayer,216,356,572,72,0,JointPQPlayer
1453,JointPQPlayer,231,346,577,77,0,JointPQPlayer
1454,JointPQPlayer,141,406,547,47,0,JointPQPlayer
1455,JointPQPlayer,207,362,569,69,0,JointPQPlayer
1456,JointPQPlayer,207,362,569,69,0,JointPQPlayer
1457,JointPQPlayer,213,358,571,71,0,JointPQPlayer
1458,JointPQPlayer,90,440,530,30,0,JointPQPlayer
1459,JointPQPlayer,84,444,528,28,0,JointPQPlayer
1460,JointPQPlayer,150,400,550,50,0,JointPQPlayer
1461,JointPQPlayer,195,370,565,65,0,JointPQPlayer
1462,JointPQPlayer,210,360,570,70,0,JointPQPlayer
1463,JointPQPlayer,216,356,572,72,0,JointPQPlayer
1464,JointPQPlayer,99,434,533,33,0,JointPQPlayer
1465,JointPQPlayer,201,366,567,67,0,JointPQPlayer
1466,JointPQPlayer,216,356,572,72,0,JointPQPlayer
1467,JointPQPlayer,213,358,571,71,0,JointPQPlayer
1468,JointPQPlayer,204,364,568,68,0,JointPQPlayer
1469,JointPQPlayer,225,350,575,75,0,JointPQPlayer
1470,JointPQPlayer,222,352,574,74,0,JointPQPlayer
1471,JointPQPlayer,195,370,565,65,0,JointPQPlayer
1472,JointPQPlayer,90,440,530,30,0,JointPQPlayer
0,revTitforTat,3,498,501,1,0,revTitforTat
1,revTitforTat,0,500,500,0,0,revTitforTat
2,revTitforTat,0,500,500,0,0,revTitforTat
3,revTitforTat,0,500,500,0,0,revTitforTat
4,revTitforTat,0,500,500,0,0,revTitforTat
5,revTitforTat,0,500,500,0,0,revTitforTat
6,revTitforTat,0,500,500,0,0,revTitforTat
7,revTitforTat,0,500,500,0,0,revTitforTat
8,revTitforTat,0,500,500,0,0,revTitforTat
9,revTitforTat,0,500,500,0,0,revTitforTat
10,revTitforTat,0,500,500,0,0,revTitforTat
0,PatternPlayer,150,400,550,50,0,PatternPlayer
1,PatternPlayer,150,400,550,50,0,PatternPlayer
2,PatternPlayer,150,400,550,50,0,PatternPlayer
3,PatternPlayer,150,400,550,50,0,PatternPlayer
4,PatternPlayer,150,400,550,50,0,PatternPlayer
5,PatternPlayer,150,400,550,50,0,PatternPlayer
6,PatternPlayer,150,400,550,50,0,PatternPlayer
7,PatternPlayer,150,400,550,50,0,PatternPlayer
8,PatternPlayer,150,400,550,50,0,PatternPlayer
9,PatternPlayer,150,400,550,50,0,PatternPlayer
10,PatternPlayer,150,400,550,50,0,PatternPlayer
0,GrudgePlayer,300,300,600,100,0,Tie
1,GrudgePlayer,300,300,600,100,0,Tie
2,GrudgePlayer,300,300,600,100,0,Tie
3,GrudgePlayer,300,300,600,100,0,Tie
4,GrudgePlayer,300,300,600,100,0,Tie
5,GrudgePlayer,300,300,600,100,0,Tie
6,GrudgePlayer,300,300,600,100,0,Tie
7,GrudgePlayer,300,300,600,100,0,Tie
8,GrudgePlayer,300,300,600,100,0,Tie
9,GrudgePlayer,300,300,600,100,0,Tie
10,GrudgePlayer,300,300,600,100,0,Tie
0,Gullible,300,300,600,100,0,Tie
1,Gullible,300,300,600,100,0,Tie
2,Gullible,300,300,600,100,0,Tie
3,Gullible,300,300,600,100,0,Tie
4,Gullible,300,300,600,100,0,Tie
5,Gullible,300,300,600,100,0,Tie
6,Gullible,300,300,600,100,0,Tie
7,Gullible,300,300,600,100,0,Tie
8,Gullible,300,300,600,100,0,Tie
9,Gullible,300,300,600,100,0,Tie
10,Gullible,300,300,600,100,0,Tie
0,Sly Fox,0,500,500,0,0,Sly Fox
1,Sly Fox,0,500,500,0,0,Sly Fox
2,Sly Fox,0,500,500,0,0,Sly Fox
3,Sly Fox,0,500,500,0,0,Sly Fox
4,Sly Fox,0,500,500,0,0,Sly Fox
5,Sly Fox,0,500,500,0,0,Sly Fox
6,Sly Fox,0,500,500,0,0,Sly Fox
7,Sly Fox,0,500,500,0,0,Sly Fox
8,Sly Fox,0,500,500,0,0,Sly Fox
9,Sly Fox,0,500,500,0,0,Sly Fox
10,Sly Fox,0,500,500,0,0,Sly Fox
0,Evan,150,400,550,50,0,Evan
1,Evan,150,400,550,50,0,Evan
2,Evan,150,400,550,50,0,Evan
3,Evan,150,400,550,50,0,Evan
4,Evan,150,400,550,50,0,Evan
5,Evan,150,400,550,50,0,Evan
6,Evan,150,400,550,50,0,Evan
7,Evan,150,400,550,50,0,Evan
8,Evan,150,400,550,50,0,Evan
9,Evan,150,400,550,50,0,Evan
10,Evan,150,400,550,50,0,Evan
0,Randy,162,392,554,54,0,Randy
1,Randy,141,406,547,47,0,Randy
2,Randy,135,410,545,45,0,Randy
3,Randy,162,392,554,54,0,Randy
4,Randy,156,396,552,52,0,Randy
5,Randy,186,376,562,62,0,Randy
6,Randy,144,404,548,48,0,Randy
7,Randy,165,390,555,55,0,Randy
8,Randy,174,384,558,58,0,Randy
9,Randy,171,386,557,57,0,Randy
10,Randy,120,420,540,40,0,Randy
11,Randy,147,402,549,49,0,Randy
12,Randy,135,410,545,45,0,Randy
13,Randy,150,400,550,50,0,Randy
14,Randy,159,394,553,53,0,Randy
15,Randy,156,396,552,52,0,Randy
16,Randy,171,386,557,57,0,Randy
17,Randy,147,402,549,49,0,Randy
18,Randy,159,394,553,53,0,Randy
19,Randy,162,392,554,54,0,Randy
20,Randy,144,404,548,48,0,Randy
21,Randy,159,394,553,53,0,Randy
22,Randy,180,380,560,60,0,Randy
23,Randy,147,402,549,49,0,Randy
24,Randy,162,392,554,54,0,Randy
25,Randy,150,400,550,50,0,Randy
26,Randy,153,398,551,51,0,Randy
27,Randy,135,410,545,45,0,Randy
28,Randy,162,392,554,54,0,Randy
29,Randy,171,386,557,57,0,Randy
30,Randy,150,400,550,50,0,Randy
31,Randy,153,398,551,51,0,Randy
32,Randy,174,384,558,58,0,Randy
33,Randy,132,412,544,44,0,Randy
34,Randy,132,412,544,44,0,Randy
35,Randy,162,392,554,54,0,Randy
36,Randy,150,400,550,50,0,Randy
37,Randy,162,392,554,54,0,Randy
38,Randy,153,398,551,51,0,Randy
39,Randy,147,402,549,49,0,Randy
40,Randy,141,406,547,47,0,Randy
41,Randy,135,410,545,45,0,Randy
42,Randy,150,400,550,50,0,Randy
43,Randy,138,408,546,46,0,Randy
44,Randy,153,398,551,51,0,Randy
45,Randy,138,408,546,46,0,Randy
46,Randy,159,394,553,53,0,Randy
47,Randy,144,404,548,48,0,Randy
48,Randy,159,394,553,53,0,Randy
49,Randy,174,384,558,58,0,Randy
50,Randy,153,398,551,51,0,Randy
51,Randy,132,412,544,44,0,Randy
52,Randy,147,402,549,49,0,Randy
53,Randy,147,402,549,49,0,Randy
54,Randy,186,376,562,62,0,Randy
55,Randy,162,392,554,54,0,Randy
56,Randy,132,412,544,44,0,Randy
57,Randy,147,402,549,49,0,Randy
58,Randy,159,394,553,53,0,Randy
59,Randy,138,408,546,46,0,Randy
60,Randy,150,400,550,50,0,Randy
61,Randy,150,400,550,50,0,Randy
62,Randy,132,412,544,44,0,Randy
63,Randy,153,398,551,51,0,Randy
64,Randy,147,402,549,49,0,Randy
65,Randy,150,400,550,50,0,Randy
66,Randy,129,414,543,43,0,Randy
67,Randy,177,382,559,59,0,Randy
68,Randy,141,406,547,47,0,Randy
69,Randy,186,376,562,62,0,Randy
70,Randy,144,404,548,48,0,Randy
71,Randy,144,404,548,48,0,Randy
72,Randy,141,406,547,47,0,Randy
73,Randy,159,394,553,53,0,Randy
74,Randy,156,396,552,52,0,Randy
75,Randy,162,392,554,54,0,Randy
76,Randy,168,388,556,56,0,Randy
77,Randy,141,406,547,47,0,Randy
78,Randy,114,424,538,38,0,Randy
79,Randy,129,414,543,43,0,Randy
80,Randy,171,386,557,57,0,Randy
81,Randy,141,406,547,47,0,Randy
82,Randy,171,386,557,57,0,Randy
83,Randy,174,384,558,58,0,Randy
84,Randy,144,404,548,48,0,Randy
85,Randy,171,386,557,57,0,Randy
86,Randy,129,414,543,43,0,Randy
87,Randy,147,402,549,49,0,Randy
88,Randy,144,404,548,48,0,Randy
89,Randy,159,394,553,53,0,Randy
90,Randy,138,408,546,46,0,Randy
91,Randy,168,388,556,56,0,Randy
92,Randy,162,392,554,54,0,Randy
93,Randy,156,396,552,52,0,Randy
94,Randy,129,414,543,43,0,Randy
95,Randy,174,384,558,58,0,Randy
96,Randy,162,392,554,54,0,Randy
97,Randy,135,410,545,45,0,Randy
98,Randy,147,402,549,49,0,Randy
99,Randy,150,400,550,50,0,Randy
100,Randy,126,416,542,42,0,Randy
101,Randy,150,400,550,50,0,Randy
102,Randy,147,402,549,49,0,Randy
103,Randy,162,392,554,54,0,Randy
104,Randy,126,416,542,42,0,Randy
105,Randy,162,392,554,54,0,Randy
106,Randy,153,398,551,51,0,Randy
107,Randy,168,388,556,56,0,Randy
108,Randy,153,398,551,51,0,Randy
