Game,Opponent,PlayerA_Score,PlayerB_Score,Cumulative_Score,CCs,DDs,Winner
0,QLearningPlayer,222,177,399,22,41,Player A
1,QLearningPlayer,220,210,430,23,31,Player A
2,QLearningPlayer,214,214,428,27,33,Tie
3,QLearningPlayer,209,239,448,20,24,QLearningPlayer
4,QLearningPlayer,230,220,450,25,25,Player A
5,QLearningPlayer,222,217,439,23,28,Player A
6,QLearningPlayer,193,263,456,22,22,QLearningPlayer
7,QLearningPlayer,215,195,410,15,35,Player A
8,QLearningPlayer,257,182,439,26,29,Player A
9,QLearningPlayer,222,207,429,22,31,Player A
10,QLearningPlayer,261,191,452,24,24,Player A
11,QLearningPlayer,216,236,452,24,24,QLearningPlayer
12,QLearningPlayer,202,217,419,24,35,QLearningPlayer
13,QLearningPlayer,243,223,466,29,21,Player A
14,QLearningPlayer,223,208,431,18,29,Player A
15,QLearningPlayer,251,226,477,40,21,Player A
16,QLearningPlayer,232,247,479,36,19,QLearningPlayer
17,QLearningPlayer,249,209,458,18,20,Player A
18,QLearningPlayer,275,205,480,25,15,Player A
19,QLearningPlayer,208,263,471,25,18,QLearningPlayer
20,QLearningPlayer,231,186,417,25,36,Player A
21,QLearningPlayer,273,198,471,25,18,Player A
22,QLearningPlayer,241,201,442,20,26,Player A
23,QLearningPlayer,216,241,457,32,25,QLearningPlayer
24,QLearningPlayer,224,249,473,27,18,QLearningPlayer
25,QLearningPlayer,201,221,422,18,32,QLearningPlayer
26,QLearningPlayer,252,222,474,34,20,Player A
27,QLearningPlayer,216,221,437,27,30,QLearningPlayer
28,QLearningPlayer,250,200,450,19,23,Player A
29,QLearningPlayer,202,252,454,26,24,QLearningPlayer
30,QLearningPlayer,237,232,469,26,19,Player A
31,QLearningPlayer,221,261,482,30,16,QLearningPlayer
32,QLearningPlayer,237,222,459,31,24,Player A
33,QLearningPlayer,193,233,426,22,32,QLearningPlayer
34,QLearningPlayer,201,261,462,25,21,QLearningPlayer
35,QLearningPlayer,157,257,414,19,35,QLearningPlayer
36,QLearningPlayer,233,208,441,25,28,Player A
37,QLearningPlayer,217,212,429,25,32,Player A
38,QLearningPlayer,232,187,419,21,34,Player A
39,QLearningPlayer,179,264,443,24,27,QLearningPlayer
40,QLearningPlayer,207,242,449,27,26,QLearningPlayer
41,QLearningPlayer,236,226,462,34,24,Player A
42,QLearningPlayer,257,202,459,28,23,Player A
43,QLearningPlayer,221,246,467,33,22,QLearningPlayer
44,QLearningPlayer,216,236,452,21,23,QLearningPlayer
45,QLearningPlayer,225,225,450,19,23,Tie
46,QLearningPlayer,231,231,462,31,23,Tie
47,QLearningPlayer,232,227,459,34,25,Player A
48,QLearningPlayer,196,251,447,22,25,QLearningPlayer
49,QLearningPlayer,245,195,440,21,27,Player A
50,QLearningPlayer,250,205,455,27,24,Player A
51,QLearningPlayer,224,244,468,31,21,QLearningPlayer
52,QLearningPlayer,204,244,448,29,27,QLearningPlayer
53,QLearningPlayer,208,228,436,26,30,QLearningPlayer
54,QLearningPlayer,204,239,443,27,28,QLearningPlayer
55,QLearningPlayer,214,214,428,21,31,Tie
56,QLearningPlayer,206,246,452,24,24,QLearningPlayer
57,QLearningPlayer,213,248,461,27,22,QLearningPlayer
58,QLearningPlayer,238,243,481,20,13,QLearningPlayer
59,QLearningPlayer,230,235,465,31,22,QLearningPlayer
60,QLearningPlayer,220,225,445,29,28,QLearningPlayer
61,QLearningPlayer,217,232,449,27,26,QLearningPlayer
62,QLearningPlayer,214,224,438,22,28,QLearningPlayer
63,QLearningPlayer,223,238,461,33,24,QLearningPlayer
64,QLearningPlayer,199,239,438,22,28,QLearningPlayer
65,QLearningPlayer,243,243,486,28,14,Tie
66,QLearningPlayer,216,226,442,23,27,QLearningPlayer
67,QLearningPlayer,225,230,455,24,23,QLearningPlayer
68,QLearningPlayer,216,241,457,23,22,QLearningPlayer
69,QLearningPlayer,233,218,451,29,26,Player A
70,QLearningPlayer,239,214,453,19,22,Player A
71,QLearningPlayer,242,232,474,31,19,Player A
72,QLearningPlayer,230,215,445,20,25,Player A
73,QLearningPlayer,215,215,430,20,30,Tie
74,QLearningPlayer,233,233,466,26,20,Tie
75,QLearningPlayer,241,226,467,33,22,Player A
76,QLearningPlayer,252,217,469,32,21,Player A
77,QLearningPlayer,185,245,430,23,31,QLearningPlayer
78,QLearningPlayer,226,241,467,27,20,QLearningPlayer
79,QLearningPlayer,225,240,465,25,20,QLearningPlayer
80,QLearningPlayer,253,188,441,22,27,Player A
81,QLearningPlayer,229,219,448,23,25,Player A
82,QLearningPlayer,240,205,445,29,28,Player A
83,QLearningPlayer,236,236,472,29,19,Tie
84,QLearningPlayer,245,225,470,36,22,Player A
85,QLearningPlayer,215,225,440,24,28,QLearningPlayer
86,QLearningPlayer,253,233,486,31,15,Player A
87,QLearningPlayer,235,210,445,26,27,Player A
88,QLearningPlayer,225,210,435,28,31,Player A
89,QLearningPlayer,229,219,448,26,26,Player A
90,QLearningPlayer,192,242,434,24,30,QLearningPlayer
91,QLearningPlayer,228,208,436,32,32,Player A
92,QLearningPlayer,219,219,438,25,29,Tie
93,QLearningPlayer,198,243,441,25,28,QLearningPlayer
94,QLearningPlayer,228,223,451,32,27,Player A
95,QLearningPlayer,218,243,461,27,22,QLearningPlayer
96,QLearningPlayer,212,257,469,26,19,QLearningPlayer
97,QLearningPlayer,224,214,438,25,29,Player A
98,QLearningPlayer,219,219,438,31,31,Tie
99,QLearningPlayer,223,193,416,18,34,Player A
100,QLearningPlayer,259,179,438,16,26,Player A
101,QLearningPlayer,197,237,434,27,31,QLearningPlayer
102,QLearningPlayer,224,244,468,25,19,QLearningPlayer
103,QLearningPlayer,227,232,459,19,20,QLearningPlayer
104,QLearningPlayer,208,228,436,23,29,QLearningPlayer
105,QLearningPlayer,263,198,461,24,21,Player A
106,QLearningPlayer,244,199,443,27,28,Player A
107,QLearningPlayer,235,230,465,28,21,Player A
108,QLearningPlayer,237,252,489,37,16,QLearningPlayer
109,QLearningPlayer,199,264,463,29,22,QLearningPlayer
110,QLearningPlayer,271,201,472,26,18,Player A
111,QLearningPlayer,250,200,450,31,27,Player A
112,QLearningPlayer,156,286,442,23,27,QLearningPlayer
113,QLearningPlayer,234,209,443,24,27,Player A
114,QLearningPlayer,241,201,442,23,27,Player A
115,QLearningPlayer,235,205,440,21,27,Player A
116,QLearningPlayer,206,226,432,25,31,QLearningPlayer
117,QLearningPlayer,274,184,458,24,22,Player A
118,QLearningPlayer,235,220,455,30,25,Player A
119,QLearningPlayer,214,209,423,31,36,Player A
120,QLearningPlayer,213,218,431,18,29,QLearningPlayer
121,QLearningPlayer,253,198,451,17,22,Player A
122,QLearningPlayer,206,211,417,22,35,QLearningPlayer
123,QLearningPlayer,258,193,451,20,23,Player A
124,QLearningPlayer,226,211,437,18,27,Player A
125,QLearningPlayer,209,229,438,28,30,QLearningPlayer
126,QLearningPlayer,232,232,464,30,22,Tie
127,QLearningPlayer,283,183,466,26,20,Player A
128,QLearningPlayer,204,234,438,25,29,QLearningPlayer
129,QLearningPlayer,226,216,442,26,28,Player A
130,QLearningPlayer,205,250,455,24,23,QLearningPlayer
131,QLearningPlayer,195,250,445,26,27,QLearningPlayer
132,QLearningPlayer,206,216,422,21,33,QLearningPlayer
133,QLearningPlayer,243,233,476,33,19,Player A
134,QLearningPlayer,227,242,469,35,22,QLearningPlayer
135,QLearningPlayer,239,204,443,24,27,Player A
136,QLearningPlayer,229,199,428,21,31,Player A
137,QLearningPlayer,220,240,460,29,23,QLearningPlayer
138,QLearningPlayer,212,232,444,31,29,QLearningPlayer
139,QLearningPlayer,235,210,445,26,27,Player A
140,QLearningPlayer,236,251,487,32,15,QLearningPlayer
141,QLearningPlayer,231,206,437,21,28,Player A
142,QLearningPlayer,211,231,442,26,28,QLearningPlayer
143,QLearningPlayer,248,198,446,24,26,Player A
144,QLearningPlayer,223,228,451,29,26,QLearningPlayer
145,QLearningPlayer,225,225,450,25,25,Tie
146,QLearningPlayer,210,240,450,25,25,QLearningPlayer
147,QLearningPlayer,246,221,467,30,21,Player A
148,QLearningPlayer,197,237,434,27,31,QLearningPlayer
149,QLearningPlayer,212,242,454,23,23,QLearningPlayer
150,QLearningPlayer,221,261,482,30,16,QLearningPlayer
151,QLearningPlayer,226,236,462,34,24,QLearningPlayer
152,QLearningPlayer,218,243,461,30,23,QLearningPlayer
153,QLearningPlayer,239,234,473,30,19,Player A
154,QLearningPlayer,216,251,467,30,21,QLearningPlayer
155,QLearningPlayer,197,252,449,21,24,QLearningPlayer
156,QLearningPlayer,223,243,466,35,23,QLearningPlayer
157,QLearningPlayer,236,236,472,26,18,Tie
158,QLearningPlayer,201,246,447,25,26,QLearningPlayer
159,QLearningPlayer,238,208,446,27,27,Player A
160,QLearningPlayer,214,214,428,21,31,Tie
161,QLearningPlayer,212,247,459,22,21,QLearningPlayer
162,QLearningPlayer,222,242,464,24,20,QLearningPlayer
163,QLearningPlayer,204,219,423,25,34,QLearningPlayer
164,QLearningPlayer,219,244,463,26,21,QLearningPlayer
165,QLearningPlayer,202,232,434,21,29,QLearningPlayer
166,QLearningPlayer,250,170,420,22,34,Player A
167,QLearningPlayer,216,216,432,19,29,Tie
168,QLearningPlayer,215,250,465,34,23,QLearningPlayer
169,QLearningPlayer,232,202,434,21,29,Player A
170,QLearningPlayer,232,207,439,23,28,Player A
171,QLearningPlayer,264,199,463,23,20,Player A
172,QLearningPlayer,242,202,444,28,28,Player A
173,QLearningPlayer,175,265,440,21,27,QLearningPlayer
174,QLearningPlayer,201,251,452,27,25,QLearningPlayer
175,QLearningPlayer,206,226,432,19,29,QLearningPlayer
176,QLearningPlayer,214,239,453,25,24,QLearningPlayer
177,QLearningPlayer,226,241,467,27,20,QLearningPlayer
178,QLearningPlayer,194,234,428,21,31,QLearningPlayer
179,QLearningPlayer,208,233,441,28,29,QLearningPlayer
180,QLearningPlayer,218,243,461,27,22,QLearningPlayer
181,QLearningPlayer,224,214,438,22,28,Player A
182,QLearningPlayer,198,258,456,25,23,QLearningPlayer
183,QLearningPlayer,223,223,446,27,27,Tie
184,QLearningPlayer,228,223,451,26,25,Player A
185,QLearningPlayer,214,214,428,27,33,Tie
186,QLearningPlayer,201,251,452,27,25,QLearningPlayer
187,QLearningPlayer,226,236,462,25,21,QLearningPlayer
188,QLearningPlayer,187,247,434,27,31,QLearningPlayer
189,QLearningPlayer,191,256,447,25,26,QLearningPlayer
190,QLearningPlayer,212,252,464,30,22,QLearningPlayer
191,QLearningPlayer,231,231,462,31,23,Tie
192,QLearningPlayer,221,206,427,20,31,Player A
193,QLearningPlayer,216,231,447,28,27,QLearningPlayer
194,QLearningPlayer,221,211,432,19,29,Player A
195,QLearningPlayer,213,218,431,18,29,QLearningPlayer
196,QLearningPlayer,226,221,447,19,24,Player A
197,QLearningPlayer,195,270,465,28,21,QLearningPlayer
198,QLearningPlayer,214,214,428,18,30,Tie
199,QLearningPlayer,212,227,439,26,29,QLearningPlayer
200,QLearningPlayer,169,274,443,27,28,QLearningPlayer
201,QLearningPlayer,291,181,472,23,17,Player A
202,QLearningPlayer,232,222,454,20,22,Player A
203,QLearningPlayer,231,211,442,26,28,Player A
204,QLearningPlayer,197,232,429,22,31,QLearningPlayer
205,QLearningPlayer,199,244,443,24,27,QLearningPlayer
206,QLearningPlayer,220,240,460,23,21,QLearningPlayer
207,QLearningPlayer,199,234,433,20,29,QLearningPlayer
208,QLearningPlayer,221,216,437,21,28,Player A
209,QLearningPlayer,207,222,429,28,33,QLearningPlayer
210,QLearningPlayer,193,243,436,23,29,QLearningPlayer
211,QLearningPlayer,225,215,440,21,27,Player A
212,QLearningPlayer,229,229,458,27,23,Tie
213,QLearningPlayer,226,226,452,27,25,Tie
214,QLearningPlayer,236,231,467,24,19,Player A
215,QLearningPlayer,200,250,450,25,25,QLearningPlayer
216,QLearningPlayer,228,228,456,22,22,Tie
217,QLearningPlayer,246,221,467,24,19,Player A
218,QLearningPlayer,248,188,436,20,28,Player A
219,QLearningPlayer,218,228,446,24,26,QLearningPlayer
220,QLearningPlayer,221,211,432,19,29,Player A
221,QLearningPlayer,237,202,439,20,27,Player A
222,QLearningPlayer,230,250,480,28,16,QLearningPlayer
223,QLearningPlayer,235,215,450,25,25,Player A
224,QLearningPlayer,221,246,467,24,19,QLearningPlayer
225,QLearningPlayer,250,215,465,25,20,Player A
226,QLearningPlayer,229,244,473,27,18,QLearningPlayer
227,QLearningPlayer,195,275,470,30,20,QLearningPlayer
228,QLearningPlayer,234,234,468,25,19,Tie
229,QLearningPlayer,215,230,445,23,26,QLearningPlayer
230,QLearningPlayer,207,237,444,25,27,QLearningPlayer
231,QLearningPlayer,231,221,452,18,22,Player A
232,QLearningPlayer,214,259,473,30,19,QLearningPlayer
233,QLearningPlayer,236,206,442,26,28,Player A
234,QLearningPlayer,214,229,443,18,25,QLearningPlayer
235,QLearningPlayer,242,232,474,31,19,Player A
236,QLearningPlayer,246,206,452,24,24,Player A
237,QLearningPlayer,222,232,454,20,22,QLearningPlayer
238,QLearningPlayer,222,202,424,20,32,Player A
239,QLearningPlayer,214,214,428,21,31,Tie
240,QLearningPlayer,252,202,454,26,24,Player A
241,QLearningPlayer,228,223,451,23,24,Player A
242,QLearningPlayer,235,225,460,26,22,Player A
243,QLearningPlayer,197,247,444,28,28,QLearningPlayer
244,QLearningPlayer,203,228,431,21,30,QLearningPlayer
245,QLearningPlayer,199,234,433,20,29,QLearningPlayer
246,QLearningPlayer,206,256,462,34,24,QLearningPlayer
247,QLearningPlayer,198,218,416,12,32,QLearningPlayer
248,QLearningPlayer,235,205,440,18,26,Player A
249,QLearningPlayer,239,229,468,31,21,Player A
250,QLearningPlayer,264,209,473,30,19,Player A
251,QLearningPlayer,216,216,432,25,31,Tie
252,QLearningPlayer,233,208,441,25,28,Player A
253,QLearningPlayer,198,223,421,20,33,QLearningPlayer
254,QLearningPlayer,220,220,440,27,29,Tie
255,QLearningPlayer,254,169,423,16,31,Player A
256,QLearningPlayer,234,214,448,26,26,Player A
257,QLearningPlayer,240,225,465,25,20,Player A
258,QLearningPlayer,220,230,450,19,23,QLearningPlayer
259,QLearningPlayer,211,226,437,24,29,QLearningPlayer
260,QLearningPlayer,236,231,467,33,22,Player A
261,QLearningPlayer,231,226,457,26,23,Player A
262,QLearningPlayer,199,274,473,30,19,QLearningPlayer
263,QLearningPlayer,207,242,449,24,25,QLearningPlayer
264,QLearningPlayer,246,226,472,32,20,Player A
265,QLearningPlayer,213,213,426,22,32,Tie
266,QLearningPlayer,261,186,447,28,27,Player A
267,QLearningPlayer,228,228,456,25,23,Tie
268,QLearningPlayer,256,206,462,25,21,Player A
269,QLearningPlayer,245,205,450,22,24,Player A
270,QLearningPlayer,215,230,445,23,26,QLearningPlayer
271,QLearningPlayer,246,181,427,20,31,Player A
272,QLearningPlayer,228,218,446,24,26,Player A
273,QLearningPlayer,275,180,455,24,23,Player A
274,QLearningPlayer,232,227,459,28,23,Player A
275,QLearningPlayer,212,232,444,22,26,QLearningPlayer
276,QLearningPlayer,226,226,452,27,25,Tie
277,QLearningPlayer,177,237,414,16,34,QLearningPlayer
278,QLearningPlayer,224,229,453,19,22,QLearningPlayer
279,QLearningPlayer,215,240,455,21,22,QLearningPlayer
280,QLearningPlayer,224,209,433,23,30,Player A
281,QLearningPlayer,234,224,458,24,22,Player A
282,QLearningPlayer,239,229,468,25,19,Player A
283,QLearningPlayer,203,223,426,19,31,QLearningPlayer
284,QLearningPlayer,237,227,464,30,22,Player A
285,QLearningPlayer,202,247,449,30,27,QLearningPlayer
286,QLearningPlayer,227,227,454,23,23,Tie
287,QLearningPlayer,248,198,446,27,27,Player A
288,QLearningPlayer,210,235,445,23,26,QLearningPlayer
289,QLearningPlayer,206,241,447,25,26,QLearningPlayer
290,QLearningPlayer,223,243,466,26,20,QLearningPlayer
291,QLearningPlayer,253,183,436,17,27,Player A
292,QLearningPlayer,201,236,437,30,31,QLearningPlayer
293,QLearningPlayer,219,239,458,27,23,QLearningPlayer
294,QLearningPlayer,203,248,451,17,22,QLearningPlayer
295,QLearningPlayer,212,232,444,22,26,QLearningPlayer
296,QLearningPlayer,207,232,439,23,28,QLearningPlayer
297,QLearningPlayer,237,227,464,24,20,Player A
298,QLearningPlayer,238,238,476,30,18,Tie
299,QLearningPlayer,215,240,455,30,25,QLearningPlayer
300,QLearningPlayer,254,194,448,26,26,Player A
301,QLearningPlayer,247,222,469,32,21,Player A
302,QLearningPlayer,209,229,438,22,28,QLearningPlayer
303,QLearningPlayer,233,228,461,27,22,Player A
304,QLearningPlayer,206,241,447,25,26,QLearningPlayer
305,QLearningPlayer,212,232,444,25,27,QLearningPlayer
306,QLearningPlayer,261,176,437,21,28,Player A
307,QLearningPlayer,213,233,446,18,24,QLearningPlayer
308,QLearningPlayer,219,229,448,26,26,QLearningPlayer
309,QLearningPlayer,224,219,443,24,27,Player A
310,QLearningPlayer,197,222,419,24,35,QLearningPlayer
311,QLearningPlayer,238,233,471,34,21,Player A
312,QLearningPlayer,198,248,446,24,26,QLearningPlayer
313,QLearningPlayer,227,197,424,26,34,Player A
314,QLearningPlayer,214,229,443,27,28,QLearningPlayer
315,QLearningPlayer,211,221,432,22,30,QLearningPlayer
316,QLearningPlayer,208,223,431,24,31,QLearningPlayer
317,QLearningPlayer,222,227,449,21,24,QLearningPlayer
318,QLearningPlayer,236,216,452,27,25,Player A
319,QLearningPlayer,218,228,446,21,25,QLearningPlayer
320,QLearningPlayer,237,227,464,30,22,Player A
321,QLearningPlayer,234,209,443,21,26,Player A
322,QLearningPlayer,232,237,469,20,17,QLearningPlayer
323,QLearningPlayer,224,214,438,22,28,Player A
324,QLearningPlayer,235,190,425,24,33,Player A
325,QLearningPlayer,236,216,452,24,24,Player A
326,QLearningPlayer,199,249,448,17,23,QLearningPlayer
327,QLearningPlayer,206,241,447,28,27,QLearningPlayer
328,QLearningPlayer,242,202,444,22,26,Player A
329,QLearningPlayer,233,213,446,21,25,Player A
330,QLearningPlayer,244,189,433,23,30,Player A
331,QLearningPlayer,262,227,489,28,13,Player A
332,QLearningPlayer,198,223,421,20,33,QLearningPlayer
333,QLearningPlayer,215,210,425,27,34,Player A
334,QLearningPlayer,224,219,443,27,28,Player A
335,QLearningPlayer,229,209,438,19,27,Player A
336,QLearningPlayer,222,217,439,29,30,Player A
337,QLearningPlayer,175,250,425,15,30,QLearningPlayer
338,QLearningPlayer,276,186,462,22,20,Player A
339,QLearningPlayer,213,223,436,17,27,QLearningPlayer
340,QLearningPlayer,182,257,439,26,29,QLearningPlayer
341,QLearningPlayer,215,240,455,24,23,QLearningPlayer
342,QLearningPlayer,214,229,443,27,28,QLearningPlayer
343,QLearningPlayer,193,223,416,18,34,QLearningPlayer
344,QLearningPlayer,253,223,476,33,19,Player A
345,QLearningPlayer,227,237,464,33,23,QLearningPlayer
346,QLearningPlayer,210,235,445,26,27,QLearningPlayer
347,QLearningPlayer,245,220,465,28,21,Player A
348,QLearningPlayer,213,218,431,18,29,QLearningPlayer
349,QLearningPlayer,209,239,448,23,25,QLearningPlayer
350,QLearningPlayer,243,198,441,22,27,Player A
351,QLearningPlayer,228,218,446,30,28,Player A
352,QLearningPlayer,198,238,436,23,29,QLearningPlayer
353,QLearningPlayer,227,202,429,25,32,Player A
354,QLearningPlayer,179,269,448,20,24,QLearningPlayer
355,QLearningPlayer,223,228,451,26,25,QLearningPlayer
356,QLearningPlayer,244,209,453,22,23,Player A
357,QLearningPlayer,249,224,473,24,17,Player A
358,QLearningPlayer,241,196,437,24,29,Player A
359,QLearningPlayer,238,203,441,19,26,Player A
360,QLearningPlayer,232,197,429,25,32,Player A
361,QLearningPlayer,215,210,425,24,33,Player A
362,QLearningPlayer,211,246,457,29,24,QLearningPlayer
363,QLearningPlayer,210,235,445,20,25,QLearningPlayer
364,QLearningPlayer,230,235,465,34,23,QLearningPlayer
365,QLearningPlayer,245,215,460,26,22,Player A
366,QLearningPlayer,215,225,440,24,28,QLearningPlayer
367,QLearningPlayer,234,214,448,23,25,Player A
368,QLearningPlayer,248,218,466,26,20,Player A
369,QLearningPlayer,220,230,450,25,25,QLearningPlayer
370,QLearningPlayer,226,216,442,26,28,Player A
371,QLearningPlayer,217,237,454,26,24,QLearningPlayer
372,QLearningPlayer,221,221,442,23,27,Tie
373,QLearningPlayer,240,225,465,34,23,Player A
374,QLearningPlayer,215,240,455,27,24,QLearningPlayer
375,QLearningPlayer,214,229,443,24,27,QLearningPlayer
376,QLearningPlayer,217,237,454,23,23,QLearningPlayer
377,QLearningPlayer,242,222,464,27,21,Player A
378,QLearningPlayer,180,240,420,25,35,QLearningPlayer
379,QLearningPlayer,235,220,455,24,23,Player A
380,QLearningPlayer,213,238,451,29,26,QLearningPlayer
381,QLearningPlayer,220,230,450,28,26,QLearningPlayer
382,QLearningPlayer,239,229,468,25,19,Player A
383,QLearningPlayer,230,225,455,30,25,Player A
384,QLearningPlayer,221,226,447,25,26,QLearningPlayer
385,QLearningPlayer,211,231,442,26,28,QLearningPlayer
386,QLearningPlayer,237,212,449,18,23,Player A
387,QLearningPlayer,204,229,433,23,30,QLearningPlayer
388,QLearningPlayer,203,263,466,23,19,QLearningPlayer
389,QLearningPlayer,227,217,444,22,26,Player A
390,QLearningPlayer,203,238,441,19,26,QLearningPlayer
391,QLearningPlayer,258,183,441,28,29,Player A
392,QLearningPlayer,238,233,471,28,19,Player A
393,QLearningPlayer,231,221,452,33,27,Player A
394,QLearningPlayer,227,237,464,30,22,QLearningPlayer
395,QLearningPlayer,224,239,463,29,22,QLearningPlayer
396,QLearningPlayer,239,229,468,19,17,Player A
397,QLearningPlayer,201,231,432,16,28,QLearningPlayer
398,QLearningPlayer,230,215,445,23,26,Player A
399,QLearningPlayer,253,198,451,26,25,Player A
400,QLearningPlayer,227,227,454,23,23,Tie
401,QLearningPlayer,206,236,442,23,27,QLearningPlayer
402,QLearningPlayer,239,229,468,19,17,Player A
403,QLearningPlayer,200,265,465,31,22,QLearningPlayer
404,QLearningPlayer,197,247,444,22,26,QLearningPlayer
405,QLearningPlayer,229,239,468,34,22,QLearningPlayer
406,QLearningPlayer,240,215,455,21,22,Player A
407,QLearningPlayer,242,212,454,23,23,Player A
408,QLearningPlayer,246,216,462,28,22,Player A
409,QLearningPlayer,208,233,441,25,28,QLearningPlayer
410,QLearningPlayer,228,243,471,40,23,QLearningPlayer
411,QLearningPlayer,208,233,441,22,27,QLearningPlayer
412,QLearningPlayer,228,233,461,27,22,QLearningPlayer
413,QLearningPlayer,222,227,449,21,24,QLearningPlayer
414,QLearningPlayer,214,244,458,24,22,QLearningPlayer
415,QLearningPlayer,251,186,437,18,27,Player A
416,QLearningPlayer,249,189,438,22,28,Player A
417,QLearningPlayer,256,181,437,21,28,Player A
418,QLearningPlayer,244,204,448,29,27,Player A
419,QLearningPlayer,216,226,442,26,28,QLearningPlayer
420,QLearningPlayer,221,241,462,25,21,QLearningPlayer
421,QLearningPlayer,215,230,445,20,25,QLearningPlayer
422,QLearningPlayer,207,262,469,26,19,QLearningPlayer
423,QLearningPlayer,224,234,458,27,23,QLearningPlayer
424,QLearningPlayer,239,224,463,26,21,Player A
425,QLearningPlayer,202,217,419,21,34,QLearningPlayer
426,QLearningPlayer,220,230,450,25,25,QLearningPlayer
427,QLearningPlayer,212,207,419,15,32,Player A
428,QLearningPlayer,227,207,434,21,29,Player A
429,QLearningPlayer,217,217,434,27,31,Tie
430,QLearningPlayer,249,224,473,33,20,Player A
431,QLearningPlayer,204,244,448,26,26,QLearningPlayer
432,QLearningPlayer,236,201,437,15,26,Player A
433,QLearningPlayer,267,162,429,22,31,Player A
434,QLearningPlayer,244,179,423,19,32,Player A
435,QLearningPlayer,234,219,453,25,24,Player A
436,QLearningPlayer,224,224,448,20,24,Tie
437,QLearningPlayer,214,219,433,23,30,QLearningPlayer
438,QLearningPlayer,223,218,441,31,30,Player A
439,QLearningPlayer,225,215,440,27,29,Player A
440,QLearningPlayer,184,264,448,29,27,QLearningPlayer
441,QLearningPlayer,220,245,465,22,19,QLearningPlayer
442,QLearningPlayer,209,244,453,28,25,QLearningPlayer
443,QLearningPlayer,225,230,455,21,22,QLearningPlayer
444,QLearningPlayer,239,204,443,24,27,Player A
445,QLearningPlayer,212,217,429,19,30,QLearningPlayer
446,QLearningPlayer,222,202,424,20,32,Player A
447,QLearningPlayer,197,262,459,28,23,QLearningPlayer
448,QLearningPlayer,214,229,443,18,25,QLearningPlayer
449,QLearningPlayer,247,222,469,26,19,Player A
450,QLearningPlayer,194,239,433,23,30,QLearningPlayer
451,QLearningPlayer,241,211,452,21,23,Player A
452,QLearningPlayer,235,210,445,20,25,Player A
453,QLearningPlayer,230,235,465,28,21,QLearningPlayer
454,QLearningPlayer,213,223,436,23,29,QLearningPlayer
455,QLearningPlayer,246,176,422,15,31,Player A
456,QLearningPlayer,228,218,446,27,27,Player A
457,QLearningPlayer,216,236,452,30,26,QLearningPlayer
458,QLearningPlayer,258,198,456,22,22,Player A
459,QLearningPlayer,233,223,456,22,22,Player A
460,QLearningPlayer,249,214,463,26,21,Player A
461,QLearningPlayer,219,229,448,20,24,QLearningPlayer
462,QLearningPlayer,230,225,455,33,26,Player A
463,QLearningPlayer,246,206,452,24,24,Player A
464,QLearningPlayer,194,229,423,16,31,QLearningPlayer
465,QLearningPlayer,230,215,445,23,26,Player A
466,QLearningPlayer,208,248,456,28,24,QLearningPlayer
467,QLearningPlayer,212,212,424,17,31,Tie
468,QLearningPlayer,234,209,443,24,27,Player A
469,QLearningPlayer,244,209,453,25,24,Player A
470,QLearningPlayer,210,225,435,16,27,QLearningPlayer
471,QLearningPlayer,199,209,408,19,37,QLearningPlayer
472,QLearningPlayer,227,202,429,25,32,Player A
473,QLearningPlayer,227,232,459,25,22,QLearningPlayer
474,QLearningPlayer,246,216,462,25,21,Player A
475,QLearningPlayer,229,199,428,18,30,Player A
476,QLearningPlayer,238,218,456,28,24,Player A
477,QLearningPlayer,240,230,470,24,18,Player A
478,QLearningPlayer,262,192,454,26,24,Player A
479,QLearningPlayer,246,206,452,24,24,Player A
480,QLearningPlayer,187,217,404,15,37,QLearningPlayer
481,QLearningPlayer,218,233,451,26,25,QLearningPlayer
482,QLearningPlayer,209,244,453,22,23,QLearningPlayer
483,QLearningPlayer,224,214,438,25,29,Player A
484,QLearningPlayer,196,251,447,25,26,QLearningPlayer
485,QLearningPlayer,258,183,441,19,26,Player A
486,QLearningPlayer,241,206,447,25,26,Player A
487,QLearningPlayer,228,198,426,25,33,Player A
488,QLearningPlayer,226,216,442,14,24,Player A
489,QLearningPlayer,214,254,468,25,19,QLearningPlayer
490,QLearningPlayer,237,212,449,27,26,Player A
491,QLearningPlayer,199,234,433,29,32,QLearningPlayer
492,QLearningPlayer,220,220,440,27,29,Tie
493,QLearningPlayer,195,225,420,19,33,QLearningPlayer
494,QLearningPlayer,221,216,437,21,28,Player A
495,QLearningPlayer,225,210,435,25,30,Player A
496,QLearningPlayer,245,215,460,29,23,Player A
497,QLearningPlayer,223,223,446,27,27,Tie
498,QLearningPlayer,207,232,439,17,26,QLearningPlayer
499,QLearningPlayer,204,224,428,18,30,QLearningPlayer
500,QLearningPlayer,176,256,432,19,29,QLearningPlayer
501,QLearningPlayer,215,205,420,13,31,Player A
502,QLearningPlayer,240,215,455,30,25,Player A
503,QLearningPlayer,191,231,422,18,32,QLearningPlayer
504,QLearningPlayer,206,241,447,22,25,QLearningPlayer
505,QLearningPlayer,227,217,444,16,24,Player A
506,QLearningPlayer,236,236,472,32,20,Tie
507,QLearningPlayer,224,234,458,24,22,QLearningPlayer
508,QLearningPlayer,203,238,441,25,28,QLearningPlayer
509,QLearningPlayer,242,207,449,24,25,Player A
510,QLearningPlayer,204,244,448,26,26,QLearningPlayer
511,QLearningPlayer,249,204,453,28,25,Player A
512,QLearningPlayer,244,214,458,27,23,Player A
513,QLearningPlayer,235,205,440,21,27,Player A
514,QLearningPlayer,220,225,445,20,25,QLearningPlayer
515,QLearningPlayer,217,227,444,28,28,QLearningPlayer
516,QLearningPlayer,229,229,458,27,23,Tie
517,QLearningPlayer,223,233,456,25,23,QLearningPlayer
518,QLearningPlayer,250,185,435,19,28,Player A
519,QLearningPlayer,212,227,439,20,27,QLearningPlayer
520,QLearningPlayer,200,255,455,27,24,QLearningPlayer
521,QLearningPlayer,239,214,453,25,24,Player A
522,QLearningPlayer,238,203,441,22,27,Player A
523,QLearningPlayer,229,214,443,21,26,Player A
524,QLearningPlayer,205,245,450,25,25,QLearningPlayer
525,QLearningPlayer,253,218,471,31,20,Player A
526,QLearningPlayer,249,214,463,35,24,Player A
527,QLearningPlayer,230,210,440,18,26,Player A
528,QLearningPlayer,235,200,435,28,31,Player A
529,QLearningPlayer,247,227,474,25,17,Player A
530,QLearningPlayer,214,214,428,24,32,Tie
531,QLearningPlayer,209,239,448,32,28,QLearningPlayer
532,QLearningPlayer,203,233,436,23,29,QLearningPlayer
533,QLearningPlayer,211,226,437,27,30,QLearningPlayer
534,QLearningPlayer,232,242,474,34,20,QLearningPlayer
535,QLearningPlayer,178,248,426,13,29,QLearningPlayer
536,QLearningPlayer,229,224,453,22,23,Player A
537,QLearningPlayer,220,260,480,19,13,QLearningPlayer
538,QLearningPlayer,220,215,435,22,29,Player A
539,QLearningPlayer,218,233,451,26,25,QLearningPlayer
540,QLearningPlayer,203,233,436,17,27,QLearningPlayer
541,QLearningPlayer,248,213,461,33,24,Player A
542,QLearningPlayer,169,259,428,30,34,QLearningPlayer
543,QLearningPlayer,232,212,444,22,26,Player A
544,QLearningPlayer,256,226,482,36,18,Player A
545,QLearningPlayer,210,235,445,23,26,QLearningPlayer
546,QLearningPlayer,206,251,457,26,23,QLearningPlayer
547,QLearningPlayer,235,220,455,30,25,Player A
548,QLearningPlayer,233,238,471,28,19,QLearningPlayer
549,QLearningPlayer,223,218,441,22,27,Player A
550,QLearningPlayer,221,201,422,24,34,Player A
551,QLearningPlayer,233,208,441,22,27,Player A
552,QLearningPlayer,212,217,429,25,32,QLearningPlayer
553,QLearningPlayer,203,263,466,26,20,QLearningPlayer
554,QLearningPlayer,256,211,467,24,19,Player A
555,QLearningPlayer,219,214,433,29,32,Player A
556,QLearningPlayer,253,193,446,18,24,Player A
557,QLearningPlayer,239,229,468,34,22,Player A
558,QLearningPlayer,216,251,467,24,19,QLearningPlayer
559,QLearningPlayer,247,217,464,30,22,Player A
560,QLearningPlayer,213,253,466,26,20,QLearningPlayer
561,QLearningPlayer,227,217,444,22,26,Player A
562,QLearningPlayer,275,175,450,25,25,Player A
563,QLearningPlayer,240,210,450,22,24,Player A
564,QLearningPlayer,218,233,451,26,25,QLearningPlayer
565,QLearningPlayer,225,245,470,27,19,QLearningPlayer
566,QLearningPlayer,270,210,480,28,16,Player A
567,QLearningPlayer,228,198,426,22,32,Player A
568,QLearningPlayer,213,228,441,22,27,QLearningPlayer
569,QLearningPlayer,232,227,459,25,22,Player A
570,QLearningPlayer,222,212,434,21,29,Player A
571,QLearningPlayer,256,196,452,24,24,Player A
572,QLearningPlayer,233,218,451,20,23,Player A
573,QLearningPlayer,188,238,426,22,32,QLearningPlayer
574,QLearningPlayer,247,197,444,22,26,Player A
575,QLearningPlayer,235,215,450,28,26,Player A
576,QLearningPlayer,238,243,481,26,15,QLearningPlayer
577,QLearningPlayer,243,188,431,21,30,Player A
578,QLearningPlayer,212,227,439,20,27,QLearningPlayer
579,QLearningPlayer,220,255,475,29,18,QLearningPlayer
580,QLearningPlayer,220,240,460,20,20,QLearningPlayer
581,QLearningPlayer,250,190,440,27,29,Player A
582,QLearningPlayer,240,215,455,21,22,Player A
583,QLearningPlayer,219,239,458,24,22,QLearningPlayer
584,QLearningPlayer,231,206,437,18,27,Player A
585,QLearningPlayer,192,242,434,24,30,QLearningPlayer
586,QLearningPlayer,243,228,471,28,19,Player A
587,QLearningPlayer,212,257,469,32,21,QLearningPlayer
588,QLearningPlayer,238,228,466,23,19,Player A
589,QLearningPlayer,245,210,455,24,23,Player A
590,QLearningPlayer,199,214,413,18,35,QLearningPlayer
591,QLearningPlayer,208,213,421,23,34,QLearningPlayer
592,QLearningPlayer,193,238,431,24,31,QLearningPlayer
593,QLearningPlayer,223,213,436,26,30,Player A
594,QLearningPlayer,237,237,474,25,17,Tie
595,QLearningPlayer,212,237,449,24,25,QLearningPlayer
596,QLearningPlayer,223,223,446,30,28,Tie
597,QLearningPlayer,211,216,427,20,31,QLearningPlayer
598,QLearningPlayer,263,183,446,27,27,Player A
599,QLearningPlayer,204,279,483,28,15,QLearningPlayer
600,QLearningPlayer,228,243,471,28,19,QLearningPlayer
601,QLearningPlayer,213,223,436,23,29,QLearningPlayer
602,QLearningPlayer,212,237,449,24,25,QLearningPlayer
603,QLearningPlayer,233,223,456,31,25,Player A
604,QLearningPlayer,221,241,462,31,23,QLearningPlayer
605,QLearningPlayer,227,247,474,31,19,QLearningPlayer
606,QLearningPlayer,236,201,437,21,28,Player A
607,QLearningPlayer,251,246,497,33,12,Player A
608,QLearningPlayer,226,201,427,26,33,Player A
609,QLearningPlayer,246,221,467,27,20,Player A
610,QLearningPlayer,244,229,473,24,17,Player A
611,QLearningPlayer,187,262,449,21,24,QLearningPlayer
612,QLearningPlayer,190,240,430,26,32,QLearningPlayer
613,QLearningPlayer,204,244,448,29,27,QLearningPlayer
614,QLearningPlayer,225,235,460,20,20,QLearningPlayer
615,QLearningPlayer,190,255,445,23,26,QLearningPlayer
616,QLearningPlayer,221,236,457,20,21,QLearningPlayer
617,QLearningPlayer,229,224,453,25,24,Player A
618,QLearningPlayer,187,247,434,18,28,QLearningPlayer
619,QLearningPlayer,212,232,444,22,26,QLearningPlayer
620,QLearningPlayer,233,208,441,25,28,Player A
621,QLearningPlayer,199,254,453,28,25,QLearningPlayer
622,QLearningPlayer,208,223,431,21,30,QLearningPlayer
623,QLearningPlayer,225,210,435,25,30,Player A
624,QLearningPlayer,213,248,461,30,23,QLearningPlayer
625,QLearningPlayer,217,247,464,30,22,QLearningPlayer
626,QLearningPlayer,219,224,443,27,28,QLearningPlayer
627,QLearningPlayer,237,207,444,28,28,Player A
628,QLearningPlayer,234,199,433,20,29,Player A
629,QLearningPlayer,202,247,449,30,27,QLearningPlayer
630,QLearningPlayer,220,220,440,24,28,Tie
631,QLearningPlayer,230,205,435,22,29,Player A
632,QLearningPlayer,222,217,439,26,29,Player A
633,QLearningPlayer,243,188,431,24,31,Player A
634,QLearningPlayer,240,195,435,19,28,Player A
635,QLearningPlayer,214,214,428,27,33,Tie
636,QLearningPlayer,242,197,439,20,27,Player A
637,QLearningPlayer,221,221,442,20,26,Tie
638,QLearningPlayer,232,197,429,22,31,Player A
639,QLearningPlayer,229,234,463,29,22,QLearningPlayer
640,QLearningPlayer,213,213,426,19,31,Tie
641,QLearningPlayer,230,245,475,32,19,QLearningPlayer
642,QLearningPlayer,237,222,459,31,24,Player A
643,QLearningPlayer,203,223,426,22,32,QLearningPlayer
644,QLearningPlayer,245,175,420,19,33,Player A
645,QLearningPlayer,229,219,448,17,23,Player A
646,QLearningPlayer,243,233,476,24,16,Player A
647,QLearningPlayer,214,199,413,27,38,Player A
648,QLearningPlayer,221,221,442,26,28,Tie
649,QLearningPlayer,209,254,463,26,21,QLearningPlayer
650,QLearningPlayer,217,232,449,21,24,QLearningPlayer
651,QLearningPlayer,220,230,450,22,24,QLearningPlayer
652,QLearningPlayer,219,244,463,26,21,QLearningPlayer
653,QLearningPlayer,265,200,465,25,20,Player A
654,QLearningPlayer,221,226,447,25,26,QLearningPlayer
655,QLearningPlayer,202,242,444,22,26,QLearningPlayer
656,QLearningPlayer,206,231,437,30,31,QLearningPlayer
657,QLearningPlayer,222,212,434,21,29,Player A
658,QLearningPlayer,214,239,453,25,24,QLearningPlayer
659,QLearningPlayer,236,211,447,25,26,Player A
660,QLearningPlayer,200,240,440,27,29,QLearningPlayer
661,QLearningPlayer,240,220,460,29,23,Player A
662,QLearningPlayer,223,208,431,27,32,Player A
663,QLearningPlayer,218,238,456,25,23,QLearningPlayer
664,QLearningPlayer,250,235,485,33,16,Player A
665,QLearningPlayer,232,222,454,17,21,Player A
666,QLearningPlayer,249,209,458,24,22,Player A
667,QLearningPlayer,218,228,446,24,26,QLearningPlayer
668,QLearningPlayer,229,234,463,20,19,QLearningPlayer
669,QLearningPlayer,232,212,444,22,26,Player A
670,QLearningPlayer,211,241,452,30,26,QLearningPlayer
671,QLearningPlayer,218,218,436,20,28,Tie
672,QLearningPlayer,238,223,461,30,23,Player A
673,QLearningPlayer,205,225,430,20,30,QLearningPlayer
674,QLearningPlayer,274,189,463,23,20,Player A
675,QLearningPlayer,159,244,403,20,39,QLearningPlayer
676,QLearningPlayer,210,225,435,22,29,QLearningPlayer
677,QLearningPlayer,219,204,423,16,31,Player A
678,QLearningPlayer,234,229,463,32,23,Player A
679,QLearningPlayer,246,216,462,25,21,Player A
680,QLearningPlayer,213,188,401,24,41,Player A
681,QLearningPlayer,251,216,467,30,21,Player A
682,QLearningPlayer,219,234,453,22,23,QLearningPlayer
683,QLearningPlayer,210,225,435,19,28,QLearningPlayer
684,QLearningPlayer,265,220,485,36,17,Player A
685,QLearningPlayer,212,247,459,25,22,QLearningPlayer
686,QLearningPlayer,241,221,462,34,24,Player A
687,QLearningPlayer,246,201,447,19,24,Player A
688,QLearningPlayer,209,209,418,20,34,Tie
689,QLearningPlayer,240,195,435,22,29,Player A
690,QLearningPlayer,241,221,462,25,21,Player A
691,QLearningPlayer,232,202,434,24,30,Player A
692,QLearningPlayer,244,199,443,18,25,Player A
693,QLearningPlayer,248,218,466,23,19,Player A
694,QLearningPlayer,204,244,448,17,23,QLearningPlayer
695,QLearningPlayer,243,223,466,26,20,Player A
696,QLearningPlayer,203,233,436,23,29,QLearningPlayer
697,QLearningPlayer,200,220,420,19,33,QLearningPlayer
698,QLearningPlayer,219,269,488,33,15,QLearningPlayer
699,QLearningPlayer,215,235,450,28,26,QLearningPlayer
700,QLearningPlayer,220,215,435,22,29,Player A
701,QLearningPlayer,236,221,457,23,22,Player A
702,QLearningPlayer,220,245,465,25,20,QLearningPlayer
703,QLearningPlayer,211,216,427,20,31,QLearningPlayer
704,QLearningPlayer,224,254,478,26,16,QLearningPlayer
705,QLearningPlayer,210,250,460,20,20,QLearningPlayer
706,QLearningPlayer,199,254,453,28,25,QLearningPlayer
707,QLearningPlayer,223,238,461,33,24,QLearningPlayer
708,QLearningPlayer,215,225,440,24,28,QLearningPlayer
709,QLearningPlayer,228,213,441,22,27,Player A
710,QLearningPlayer,255,210,465,25,20,Player A
711,QLearningPlayer,196,261,457,26,23,QLearningPlayer
712,QLearningPlayer,246,196,442,23,27,Player A
713,QLearningPlayer,205,240,445,29,28,QLearningPlayer
714,QLearningPlayer,233,218,451,32,27,Player A
715,QLearningPlayer,207,242,449,27,26,QLearningPlayer
716,QLearningPlayer,245,195,440,27,29,Player A
717,QLearningPlayer,243,218,461,27,22,Player A
718,QLearningPlayer,185,260,445,29,28,QLearningPlayer
719,QLearningPlayer,249,224,473,27,18,Player A
720,QLearningPlayer,237,227,464,27,21,Player A
721,QLearningPlayer,227,212,439,26,29,Player A
722,QLearningPlayer,221,206,427,20,31,Player A
723,QLearningPlayer,220,220,440,24,28,Tie
724,QLearningPlayer,216,241,457,26,23,QLearningPlayer
725,QLearningPlayer,212,252,464,30,22,QLearningPlayer
726,QLearningPlayer,234,244,478,29,17,QLearningPlayer
727,QLearningPlayer,220,200,420,19,33,Player A
728,QLearningPlayer,237,227,464,27,21,Player A
729,QLearningPlayer,203,228,431,18,29,QLearningPlayer
730,QLearningPlayer,226,211,437,27,30,Player A
731,QLearningPlayer,229,224,453,28,25,Player A
732,QLearningPlayer,219,229,448,23,25,QLearningPlayer
733,QLearningPlayer,191,251,442,20,26,QLearningPlayer
734,QLearningPlayer,253,203,456,25,23,Player A
735,QLearningPlayer,215,215,430,26,32,Tie
736,QLearningPlayer,250,220,470,36,22,Player A
737,QLearningPlayer,226,231,457,23,22,QLearningPlayer
738,QLearningPlayer,203,248,451,23,24,QLearningPlayer
739,QLearningPlayer,227,217,444,25,27,Player A
740,QLearningPlayer,222,222,444,25,27,Tie
741,QLearningPlayer,255,215,470,30,20,Player A
742,QLearningPlayer,225,220,445,23,26,Player A
743,QLearningPlayer,232,227,459,31,24,Player A
744,QLearningPlayer,266,201,467,27,20,Player A
745,QLearningPlayer,251,211,462,34,24,Player A
746,QLearningPlayer,221,241,462,22,20,QLearningPlayer
747,QLearningPlayer,221,216,437,27,30,Player A
748,QLearningPlayer,206,236,442,26,28,QLearningPlayer
749,QLearningPlayer,254,199,453,28,25,Player A
750,QLearningPlayer,228,228,456,25,23,Tie
751,QLearningPlayer,207,252,459,28,23,QLearningPlayer
752,QLearningPlayer,232,217,449,21,24,Player A
753,QLearningPlayer,214,244,458,27,23,QLearningPlayer
754,QLearningPlayer,201,256,457,26,23,QLearningPlayer
755,QLearningPlayer,247,197,444,25,27,Player A
756,QLearningPlayer,231,226,457,26,23,Player A
757,QLearningPlayer,223,198,421,20,33,Player A
758,QLearningPlayer,190,230,420,16,32,QLearningPlayer
759,QLearningPlayer,232,232,464,33,23,Tie
760,QLearningPlayer,192,252,444,25,27,QLearningPlayer
761,QLearningPlayer,250,190,440,24,28,Player A
762,QLearningPlayer,262,212,474,31,19,Player A
763,QLearningPlayer,220,225,445,20,25,QLearningPlayer
764,QLearningPlayer,228,203,431,24,31,Player A
765,QLearningPlayer,214,224,438,19,27,QLearningPlayer
766,QLearningPlayer,220,230,450,25,25,QLearningPlayer
767,QLearningPlayer,239,224,463,23,20,Player A
768,QLearningPlayer,219,209,428,24,32,Player A
769,QLearningPlayer,204,244,448,14,22,QLearningPlayer
770,QLearningPlayer,253,208,461,27,22,Player A
771,QLearningPlayer,240,250,490,32,14,QLearningPlayer
772,QLearningPlayer,225,225,450,25,25,Tie
773,QLearningPlayer,234,229,463,29,22,Player A
774,QLearningPlayer,219,229,448,20,24,QLearningPlayer
775,QLearningPlayer,232,237,469,26,19,QLearningPlayer
776,QLearningPlayer,272,187,459,28,23,Player A
777,QLearningPlayer,228,198,426,25,33,Player A
778,QLearningPlayer,208,213,421,20,33,QLearningPlayer
779,QLearningPlayer,232,182,414,13,33,Player A
780,QLearningPlayer,242,217,459,28,23,Player A
781,QLearningPlayer,216,226,442,23,27,QLearningPlayer
782,QLearningPlayer,210,235,445,23,26,QLearningPlayer
783,QLearningPlayer,242,197,439,23,28,Player A
784,QLearningPlayer,240,245,485,36,17,QLearningPlayer
785,QLearningPlayer,256,191,447,28,27,Player A
786,QLearningPlayer,210,230,440,27,29,QLearningPlayer
787,QLearningPlayer,235,230,465,25,20,Player A
788,QLearningPlayer,226,196,422,27,35,Player A
789,QLearningPlayer,231,221,452,24,24,Player A
790,QLearningPlayer,209,234,443,18,25,QLearningPlayer
791,QLearningPlayer,214,219,433,26,31,QLearningPlayer
792,QLearningPlayer,237,192,429,22,31,Player A
793,QLearningPlayer,275,190,465,25,20,Player A
794,QLearningPlayer,219,229,448,14,22,QLearningPlayer
795,QLearningPlayer,224,224,448,23,25,Tie
796,QLearningPlayer,219,224,443,24,27,QLearningPlayer
797,QLearningPlayer,223,248,471,28,19,QLearningPlayer
798,QLearningPlayer,204,264,468,31,21,QLearningPlayer
799,QLearningPlayer,225,215,440,27,29,Player A
800,QLearningPlayer,250,205,455,24,23,Player A
801,QLearningPlayer,231,216,447,25,26,Player A
802,QLearningPlayer,192,267,459,28,23,QLearningPlayer
803,QLearningPlayer,217,242,459,34,25,QLearningPlayer
804,QLearningPlayer,240,210,450,28,26,Player A
805,QLearningPlayer,224,234,458,21,21,QLearningPlayer
806,QLearningPlayer,261,196,457,20,21,Player A
807,QLearningPlayer,226,226,452,27,25,Tie
808,QLearningPlayer,220,235,455,30,25,QLearningPlayer
809,QLearningPlayer,221,241,462,28,22,QLearningPlayer
810,QLearningPlayer,214,234,448,26,26,QLearningPlayer
811,QLearningPlayer,230,230,460,26,22,Tie
812,QLearningPlayer,239,219,458,30,24,Player A
813,QLearningPlayer,239,224,463,32,23,Player A
814,QLearningPlayer,236,211,447,25,26,Player A
815,QLearningPlayer,215,255,470,27,19,QLearningPlayer
816,QLearningPlayer,234,244,478,35,19,QLearningPlayer
817,QLearningPlayer,213,228,441,28,29,QLearningPlayer
818,QLearningPlayer,207,232,439,26,29,QLearningPlayer
819,QLearningPlayer,238,223,461,27,22,Player A
820,QLearningPlayer,227,227,454,26,24,Tie
821,QLearningPlayer,237,227,464,27,21,Player A
822,QLearningPlayer,230,230,460,26,22,Tie
823,QLearningPlayer,192,252,444,25,27,QLearningPlayer
824,QLearningPlayer,202,237,439,29,30,QLearningPlayer
825,QLearningPlayer,220,250,470,30,20,QLearningPlayer
826,QLearningPlayer,257,207,464,27,21,Player A
827,QLearningPlayer,248,188,436,26,30,Player A
828,QLearningPlayer,223,223,446,21,25,Tie
829,QLearningPlayer,218,218,436,17,27,Tie
830,QLearningPlayer,257,192,449,27,26,Player A
831,QLearningPlayer,222,242,464,30,22,QLearningPlayer
832,QLearningPlayer,256,211,467,24,19,Player A
833,QLearningPlayer,219,224,443,27,28,QLearningPlayer
834,QLearningPlayer,245,195,440,27,29,Player A
835,QLearningPlayer,239,224,463,29,22,Player A
836,QLearningPlayer,218,218,436,29,31,Tie
837,QLearningPlayer,247,217,464,24,20,Player A
838,QLearningPlayer,228,233,461,24,21,QLearningPlayer
839,QLearningPlayer,225,245,470,27,19,QLearningPlayer
840,QLearningPlayer,224,229,453,25,24,QLearningPlayer
841,QLearningPlayer,208,213,421,20,33,QLearningPlayer
842,QLearningPlayer,219,229,448,20,24,QLearningPlayer
843,QLearningPlayer,233,238,471,31,20,QLearningPlayer
844,QLearningPlayer,239,169,408,13,35,Player A
845,QLearningPlayer,227,232,459,28,23,QLearningPlayer
846,QLearningPlayer,262,207,469,32,21,Player A
847,QLearningPlayer,230,195,425,18,31,Player A
848,QLearningPlayer,200,250,450,25,25,QLearningPlayer
849,QLearningPlayer,229,234,463,20,19,QLearningPlayer
850,QLearningPlayer,242,202,444,22,26,Player A
851,QLearningPlayer,223,238,461,27,22,QLearningPlayer
852,QLearningPlayer,227,227,454,32,26,Tie
853,QLearningPlayer,255,200,455,30,25,Player A
854,QLearningPlayer,231,201,432,22,30,Player A
855,QLearningPlayer,186,271,457,23,22,QLearningPlayer
856,QLearningPlayer,214,229,443,30,29,QLearningPlayer
857,QLearningPlayer,255,205,460,23,21,Player A
858,QLearningPlayer,234,209,443,24,27,Player A
859,QLearningPlayer,213,233,446,21,25,QLearningPlayer
860,QLearningPlayer,211,231,442,23,27,QLearningPlayer
861,QLearningPlayer,219,219,438,13,25,Tie
862,QLearningPlayer,210,260,470,27,19,QLearningPlayer
863,QLearningPlayer,198,243,441,28,29,QLearningPlayer
864,QLearningPlayer,215,200,415,23,36,Player A
865,QLearningPlayer,246,196,442,26,28,Player A
866,QLearningPlayer,220,220,440,27,29,Tie
867,QLearningPlayer,204,244,448,20,24,QLearningPlayer
868,QLearningPlayer,232,212,444,22,26,Player A
869,QLearningPlayer,250,225,475,35,20,Player A
870,QLearningPlayer,261,191,452,24,24,Player A
871,QLearningPlayer,228,208,436,29,31,Player A
872,QLearningPlayer,260,205,465,28,21,Player A
873,QLearningPlayer,227,227,454,26,24,Tie
874,QLearningPlayer,197,242,439,23,28,QLearningPlayer
875,QLearningPlayer,226,216,442,26,28,Player A
876,QLearningPlayer,214,204,418,17,33,Player A
877,QLearningPlayer,259,204,463,26,21,Player A
878,QLearningPlayer,235,205,440,24,28,Player A
879,QLearningPlayer,200,240,440,21,27,QLearningPlayer
880,QLearningPlayer,243,198,441,28,29,Player A
881,QLearningPlayer,199,229,428,27,33,QLearningPlayer
882,QLearningPlayer,241,221,462,25,21,Player A
883,QLearningPlayer,197,247,444,22,26,QLearningPlayer
884,QLearningPlayer,250,215,465,22,19,Player A
885,QLearningPlayer,232,192,424,20,32,Player A
886,QLearningPlayer,231,196,427,20,31,Player A
887,QLearningPlayer,236,206,442,26,28,Player A
888,QLearningPlayer,203,248,451,20,23,QLearningPlayer
889,QLearningPlayer,194,289,483,28,15,QLearningPlayer
890,QLearningPlayer,217,227,444,22,26,QLearningPlayer
891,QLearningPlayer,253,198,451,26,25,Player A
892,QLearningPlayer,220,235,455,24,23,QLearningPlayer
893,QLearningPlayer,234,234,468,28,20,Tie
894,QLearningPlayer,262,182,444,25,27,Player A
895,QLearningPlayer,228,218,446,27,27,Player A
896,QLearningPlayer,229,254,483,31,16,QLearningPlayer
897,QLearningPlayer,230,215,445,29,28,Player A
898,QLearningPlayer,240,250,490,26,12,QLearningPlayer
899,QLearningPlayer,237,187,424,17,31,Player A
900,QLearningPlayer,204,229,433,20,29,QLearningPlayer
901,QLearningPlayer,256,201,457,26,23,Player A
902,QLearningPlayer,220,215,435,19,28,Player A
903,QLearningPlayer,213,243,456,22,22,QLearningPlayer
904,QLearningPlayer,230,235,465,28,21,QLearningPlayer
905,QLearningPlayer,247,212,459,31,24,Player A
906,QLearningPlayer,212,222,434,18,28,QLearningPlayer
907,QLearningPlayer,231,206,437,27,30,Player A
908,QLearningPlayer,228,223,451,20,23,Player A
909,QLearningPlayer,217,232,449,24,25,QLearningPlayer
910,QLearningPlayer,228,228,456,25,23,Tie
911,QLearningPlayer,244,194,438,22,28,Player A
912,QLearningPlayer,210,245,455,21,22,QLearningPlayer
913,QLearningPlayer,242,207,449,30,27,Player A
914,QLearningPlayer,182,267,449,33,28,QLearningPlayer
915,QLearningPlayer,248,218,466,32,22,Player A
916,QLearningPlayer,211,236,447,31,28,QLearningPlayer
917,QLearningPlayer,222,222,444,22,26,Tie
918,QLearningPlayer,221,251,472,35,21,QLearningPlayer
919,QLearningPlayer,257,207,464,30,22,Player A
920,QLearningPlayer,223,233,456,25,23,QLearningPlayer
921,QLearningPlayer,258,193,451,26,25,Player A
922,QLearningPlayer,201,251,452,24,24,QLearningPlayer
923,QLearningPlayer,206,231,437,21,28,QLearningPlayer
924,QLearningPlayer,243,233,476,27,17,Player A
925,QLearningPlayer,263,203,466,32,22,Player A
926,QLearningPlayer,239,219,458,33,25,Player A
927,QLearningPlayer,237,197,434,21,29,Player A
928,QLearningPlayer,205,230,435,22,29,QLearningPlayer
929,QLearningPlayer,198,268,466,32,22,QLearningPlayer
930,QLearningPlayer,268,193,461,30,23,Player A
931,QLearningPlayer,263,198,461,27,22,Player A
932,QLearningPlayer,213,233,446,27,27,QLearningPlayer
933,QLearningPlayer,214,229,443,27,28,QLearningPlayer
934,QLearningPlayer,244,224,468,28,20,Player A
935,QLearningPlayer,261,211,472,29,19,Player A
936,QLearningPlayer,198,268,466,26,20,QLearningPlayer
937,QLearningPlayer,217,212,429,22,31,Player A
938,QLearningPlayer,235,225,460,23,21,Player A
939,QLearningPlayer,231,196,427,26,33,Player A
940,QLearningPlayer,214,224,438,28,30,QLearningPlayer
941,QLearningPlayer,231,216,447,25,26,Player A
942,QLearningPlayer,236,221,457,29,24,Player A
943,QLearningPlayer,226,246,472,29,19,QLearningPlayer
944,QLearningPlayer,221,221,442,26,28,Tie
945,QLearningPlayer,231,221,452,27,25,Player A
946,QLearningPlayer,216,221,437,24,29,QLearningPlayer
947,QLearningPlayer,212,227,439,29,30,QLearningPlayer
948,QLearningPlayer,174,274,448,26,26,QLearningPlayer
949,QLearningPlayer,227,202,429,22,31,Player A
950,QLearningPlayer,206,241,447,19,24,QLearningPlayer
951,QLearningPlayer,216,221,437,27,30,QLearningPlayer
952,QLearningPlayer,235,215,450,25,25,Player A
953,QLearningPlayer,237,227,464,33,23,Player A
954,QLearningPlayer,239,194,433,20,29,Player A
955,QLearningPlayer,223,258,481,32,17,QLearningPlayer
956,QLearningPlayer,200,235,435,25,30,QLearningPlayer
957,QLearningPlayer,195,255,450,25,25,QLearningPlayer
958,QLearningPlayer,254,219,473,30,19,Player A
959,QLearningPlayer,280,190,470,24,18,Player A
960,QLearningPlayer,189,249,438,22,28,QLearningPlayer
961,QLearningPlayer,220,240,460,26,22,QLearningPlayer
962,QLearningPlayer,233,213,446,24,26,Player A
963,QLearningPlayer,199,254,453,25,24,QLearningPlayer
964,QLearningPlayer,189,239,428,24,32,QLearningPlayer
965,QLearningPlayer,222,222,444,25,27,Tie
966,QLearningPlayer,194,254,448,26,26,QLearningPlayer
967,QLearningPlayer,239,204,443,24,27,Player A
968,QLearningPlayer,232,222,454,29,25,Player A
969,QLearningPlayer,218,243,461,36,25,QLearningPlayer
970,QLearningPlayer,241,226,467,27,20,Player A
971,QLearningPlayer,239,229,468,31,21,Player A
972,QLearningPlayer,251,216,467,27,20,Player A
973,QLearningPlayer,232,192,424,20,32,Player A
974,QLearningPlayer,255,200,455,24,23,Player A
975,QLearningPlayer,216,241,457,26,23,QLearningPlayer
976,QLearningPlayer,182,262,444,22,26,QLearningPlayer
977,QLearningPlayer,220,210,430,26,32,Player A
978,QLearningPlayer,205,240,445,23,26,QLearningPlayer
979,QLearningPlayer,212,192,404,15,37,Player A
980,QLearningPlayer,248,228,476,30,18,Player A
981,QLearningPlayer,213,233,446,21,25,QLearningPlayer
982,QLearningPlayer,227,227,454,26,24,Tie
983,QLearningPlayer,227,217,444,25,27,Player A
984,QLearningPlayer,258,203,461,27,22,Player A
985,QLearningPlayer,226,191,417,16,33,Player A
986,QLearningPlayer,223,228,451,23,24,QLearningPlayer
987,QLearningPlayer,211,261,472,20,16,QLearningPlayer
988,QLearningPlayer,244,184,428,27,33,Player A
989,QLearningPlayer,240,210,450,25,25,Player A
990,QLearningPlayer,219,229,448,26,26,QLearningPlayer
991,QLearningPlayer,264,179,443,24,27,Player A
992,QLearningPlayer,262,182,444,22,26,Player A
993,QLearningPlayer,216,236,452,24,24,QLearningPlayer
994,QLearningPlayer,250,200,450,25,25,Player A
995,QLearningPlayer,227,207,434,18,28,Player A
996,QLearningPlayer,252,202,454,23,23,Player A
997,QLearningPlayer,227,212,439,23,28,Player A
998,QLearningPlayer,232,222,454,20,22,Player A
999,QLearningPlayer,215,240,455,24,23,QLearningPlayer
1000,QLearningPlayer,209,224,433,23,30,QLearningPlayer
1001,QLearningPlayer,260,190,450,28,26,Player A
1002,QLearningPlayer,231,231,462,28,22,Tie
1003,QLearningPlayer,186,241,427,17,30,QLearningPlayer
1004,QLearningPlayer,216,216,432,19,29,Tie
1005,QLearningPlayer,216,251,467,24,19,QLearningPlayer
1006,QLearningPlayer,228,213,441,28,29,Player A
1007,QLearningPlayer,225,195,420,16,32,Player A
1008,QLearningPlayer,227,217,444,22,26,Player A
1009,QLearningPlayer,169,264,433,20,29,QLearningPlayer
1010,QLearningPlayer,201,251,452,27,25,QLearningPlayer
1011,QLearningPlayer,235,215,450,31,27,Player A
1012,QLearningPlayer,222,227,449,21,24,QLearningPlayer
1013,QLearningPlayer,248,198,446,18,24,Player A
1014,QLearningPlayer,236,206,442,29,29,Player A
1015,QLearningPlayer,240,235,475,29,18,Player A
1016,QLearningPlayer,196,261,457,23,22,QLearningPlayer
1017,QLearningPlayer,210,245,455,30,25,QLearningPlayer
1018,QLearningPlayer,164,269,433,23,30,QLearningPlayer
1019,QLearningPlayer,211,226,437,21,28,QLearningPlayer
1020,QLearningPlayer,211,241,452,30,26,QLearningPlayer
1021,QLearningPlayer,199,244,443,18,25,QLearningPlayer
1022,QLearningPlayer,261,236,497,30,11,Player A
1023,QLearningPlayer,226,206,432,28,32,Player A
1024,QLearningPlayer,207,237,444,25,27,QLearningPlayer
1025,QLearningPlayer,261,191,452,27,25,Player A
1026,QLearningPlayer,242,227,469,32,21,Player A
1027,QLearningPlayer,188,258,446,24,26,QLearningPlayer
1028,QLearningPlayer,240,225,465,31,22,Player A
1029,QLearningPlayer,229,239,468,28,20,QLearningPlayer
1030,QLearningPlayer,216,206,422,21,33,Player A
1031,QLearningPlayer,241,216,457,26,23,Player A
1032,QLearningPlayer,208,248,456,22,22,QLearningPlayer
1033,QLearningPlayer,220,190,410,21,37,Player A
1034,QLearningPlayer,220,230,450,28,26,QLearningPlayer
1035,QLearningPlayer,221,226,447,28,27,QLearningPlayer
1036,QLearningPlayer,238,208,446,24,26,Player A
1037,QLearningPlayer,251,201,452,33,27,Player A
1038,QLearningPlayer,197,257,454,23,23,QLearningPlayer
1039,QLearningPlayer,220,230,450,25,25,QLearningPlayer
1040,QLearningPlayer,213,228,441,25,28,QLearningPlayer
1041,QLearningPlayer,235,215,450,28,26,Player A
1042,QLearningPlayer,207,217,424,20,32,QLearningPlayer
1043,QLearningPlayer,258,188,446,27,27,Player A
1044,QLearningPlayer,236,216,452,21,23,Player A
1045,QLearningPlayer,230,225,455,36,27,Player A
1046,QLearningPlayer,230,240,470,24,18,QLearningPlayer
1047,QLearningPlayer,224,239,463,29,22,QLearningPlayer
1048,QLearningPlayer,199,264,463,29,22,QLearningPlayer
1049,QLearningPlayer,218,228,446,24,26,QLearningPlayer
1050,QLearningPlayer,220,195,415,20,35,Player A
1051,QLearningPlayer,225,215,440,24,28,Player A
1052,QLearningPlayer,235,205,440,24,28,Player A
1053,QLearningPlayer,224,224,448,26,26,Tie
1054,QLearningPlayer,232,227,459,25,22,Player A
1055,QLearningPlayer,219,244,463,23,20,QLearningPlayer
1056,QLearningPlayer,197,257,454,29,25,QLearningPlayer
1057,QLearningPlayer,211,246,457,32,25,QLearningPlayer
1058,QLearningPlayer,242,212,454,29,25,Player A
1059,QLearningPlayer,213,213,426,22,32,Tie
1060,QLearningPlayer,233,218,451,29,26,Player A
1061,QLearningPlayer,218,218,436,23,29,Tie
1062,QLearningPlayer,202,212,414,19,35,QLearningPlayer
1063,QLearningPlayer,230,210,440,24,28,Player A
1064,QLearningPlayer,211,256,467,21,18,QLearningPlayer
1065,QLearningPlayer,212,227,439,23,28,QLearningPlayer
1066,QLearningPlayer,261,191,452,27,25,Player A
1067,QLearningPlayer,204,214,418,23,35,QLearningPlayer
1068,QLearningPlayer,219,229,448,29,27,QLearningPlayer
1069,QLearningPlayer,231,231,462,25,21,Tie
1070,QLearningPlayer,226,236,462,28,22,QLearningPlayer
1071,QLearningPlayer,234,214,448,26,26,Player A
1072,QLearningPlayer,203,238,441,22,27,QLearningPlayer
1073,QLearningPlayer,222,207,429,28,33,Player A
1074,QLearningPlayer,236,191,427,26,33,Player A
1075,QLearningPlayer,235,195,430,23,31,Player A
1076,QLearningPlayer,216,231,447,31,28,QLearningPlayer
1077,QLearningPlayer,200,255,455,24,23,QLearningPlayer
1078,QLearningPlayer,234,219,453,22,23,Player A
1079,QLearningPlayer,219,224,443,21,26,QLearningPlayer
1080,QLearningPlayer,229,219,448,23,25,Player A
1081,QLearningPlayer,234,214,448,26,26,Player A
1082,QLearningPlayer,211,226,437,27,30,QLearningPlayer
1083,QLearningPlayer,215,225,440,27,29,QLearningPlayer
1084,QLearningPlayer,188,263,451,20,23,QLearningPlayer
1085,QLearningPlayer,206,236,442,20,26,QLearningPlayer
1086,QLearningPlayer,226,256,482,30,16,QLearningPlayer
1087,QLearningPlayer,234,209,443,24,27,Player A
1088,QLearningPlayer,250,205,455,24,23,Player A
1089,QLearningPlayer,246,186,432,19,29,Player A
1090,QLearningPlayer,241,216,457,23,22,Player A
1091,QLearningPlayer,213,243,456,31,25,QLearningPlayer
1092,QLearningPlayer,246,191,437,21,28,Player A
1093,QLearningPlayer,223,233,456,28,24,QLearningPlayer
1094,QLearningPlayer,243,223,466,26,20,Player A
1095,QLearningPlayer,265,210,475,32,19,Player A
1096,QLearningPlayer,224,214,438,25,29,Player A
1097,QLearningPlayer,224,239,463,26,21,QLearningPlayer
1098,QLearningPlayer,230,220,450,25,25,Player A
1099,QLearningPlayer,219,224,443,21,26,QLearningPlayer
1100,QLearningPlayer,238,223,461,21,20,Player A
1101,QLearningPlayer,247,232,479,36,19,Player A
1102,QLearningPlayer,227,217,444,25,27,Player A
1103,QLearningPlayer,235,245,480,34,18,QLearningPlayer
1104,QLearningPlayer,241,206,447,19,24,Player A
1105,QLearningPlayer,208,228,436,23,29,QLearningPlayer
1106,QLearningPlayer,224,219,443,33,30,Player A
1107,QLearningPlayer,193,228,421,20,33,QLearningPlayer
1108,QLearningPlayer,224,244,468,25,19,QLearningPlayer
1109,QLearningPlayer,212,242,454,29,25,QLearningPlayer
1110,QLearningPlayer,210,235,445,29,28,QLearningPlayer
1111,QLearningPlayer,240,220,460,26,22,Player A
1112,QLearningPlayer,240,225,465,34,23,Player A
1113,QLearningPlayer,216,221,437,21,28,QLearningPlayer
1114,QLearningPlayer,228,223,451,17,22,Player A
1115,QLearningPlayer,204,244,448,20,24,QLearningPlayer
1116,QLearningPlayer,244,229,473,30,19,Player A
1117,QLearningPlayer,265,210,475,35,20,Player A
1118,QLearningPlayer,233,238,471,25,18,QLearningPlayer
1119,QLearningPlayer,217,217,434,27,31,Tie
1120,QLearningPlayer,237,212,449,21,24,Player A
1121,QLearningPlayer,231,246,477,31,18,QLearningPlayer
1122,QLearningPlayer,238,213,451,32,27,Player A
1123,QLearningPlayer,220,250,470,33,21,QLearningPlayer
1124,QLearningPlayer,245,210,455,21,22,Player A
1125,QLearningPlayer,225,215,440,30,30,Player A
1126,QLearningPlayer,214,239,453,31,26,QLearningPlayer
1127,QLearningPlayer,216,271,487,38,17,QLearningPlayer
1128,QLearningPlayer,224,224,448,26,26,Tie
1129,QLearningPlayer,219,239,458,24,22,QLearningPlayer
1130,QLearningPlayer,230,220,450,25,25,Player A
1131,QLearningPlayer,225,205,430,23,31,Player A
1132,QLearningPlayer,242,197,439,23,28,Player A
1133,QLearningPlayer,226,216,442,20,26,Player A
1134,QLearningPlayer,199,234,433,23,30,QLearningPlayer
1135,QLearningPlayer,188,238,426,22,32,QLearningPlayer
1136,QLearningPlayer,264,214,478,29,17,Player A
1137,QLearningPlayer,251,196,447,25,26,Player A
1138,QLearningPlayer,267,207,474,25,17,Player A
1139,QLearningPlayer,242,217,459,31,24,Player A
1140,QLearningPlayer,237,237,474,28,18,Tie
1141,QLearningPlayer,190,250,440,24,28,QLearningPlayer
1142,QLearningPlayer,215,235,450,25,25,QLearningPlayer
1143,QLearningPlayer,234,189,423,25,34,Player A
1144,QLearningPlayer,233,208,441,28,29,Player A
1145,QLearningPlayer,244,204,448,26,26,Player A
1146,QLearningPlayer,254,189,443,21,26,Player A
1147,QLearningPlayer,250,225,475,35,20,Player A
1148,QLearningPlayer,237,202,439,29,30,Player A
1149,QLearningPlayer,232,207,439,23,28,Player A
1150,QLearningPlayer,230,220,450,22,24,Player A
1151,QLearningPlayer,210,220,430,26,32,QLearningPlayer
1152,QLearningPlayer,241,191,432,16,28,Player A
1153,QLearningPlayer,208,253,461,27,22,QLearningPlayer
1154,QLearningPlayer,225,225,450,31,27,Tie
1155,QLearningPlayer,222,232,454,32,26,QLearningPlayer
1156,QLearningPlayer,216,266,482,30,16,QLearningPlayer
1157,QLearningPlayer,258,183,441,16,25,Player A
1158,QLearningPlayer,227,212,439,26,29,Player A
1159,QLearningPlayer,216,211,427,23,32,Player A
1160,QLearningPlayer,220,210,430,26,32,Player A
1161,QLearningPlayer,272,192,464,27,21,Player A
1162,QLearningPlayer,194,244,438,22,28,QLearningPlayer
1163,QLearningPlayer,224,239,463,20,19,QLearningPlayer
1164,QLearningPlayer,200,235,435,13,26,QLearningPlayer
1165,QLearningPlayer,234,209,443,21,26,Player A
1166,QLearningPlayer,232,207,439,23,28,Player A
1167,QLearningPlayer,236,216,452,27,25,Player A
1168,QLearningPlayer,246,191,437,18,27,Player A
1169,QLearningPlayer,209,244,453,31,26,QLearningPlayer
1170,QLearningPlayer,224,209,433,17,28,Player A
1171,QLearningPlayer,203,228,431,27,32,QLearningPlayer
1172,QLearningPlayer,210,245,455,27,24,QLearningPlayer
1173,QLearningPlayer,224,229,453,25,24,QLearningPlayer
1174,QLearningPlayer,262,207,469,29,20,Player A
1175,QLearningPlayer,188,253,441,25,28,QLearningPlayer
1176,QLearningPlayer,232,227,459,28,23,Player A
1177,QLearningPlayer,243,213,456,25,23,Player A
1178,QLearningPlayer,218,228,446,21,25,QLearningPlayer
1179,QLearningPlayer,232,212,444,22,26,Player A
1180,QLearningPlayer,202,237,439,20,27,QLearningPlayer
1181,QLearningPlayer,211,206,417,16,33,Player A
1182,QLearningPlayer,191,271,462,28,22,QLearningPlayer
1183,QLearningPlayer,253,223,476,30,18,Player A
1184,QLearningPlayer,224,229,453,25,24,QLearningPlayer
1185,QLearningPlayer,250,210,460,26,22,Player A
1186,QLearningPlayer,230,220,450,25,25,Player A
1187,QLearningPlayer,239,204,443,30,29,Player A
1188,QLearningPlayer,216,206,422,27,35,Player A
1189,QLearningPlayer,252,222,474,25,17,Player A
1190,QLearningPlayer,217,217,434,21,29,Tie
1191,QLearningPlayer,236,231,467,21,18,Player A
1192,QLearningPlayer,175,260,435,22,29,QLearningPlayer
1193,QLearningPlayer,235,210,445,20,25,Player A
1194,QLearningPlayer,203,233,436,26,30,QLearningPlayer
1195,QLearningPlayer,214,224,438,22,28,QLearningPlayer
1196,QLearningPlayer,200,245,445,29,28,QLearningPlayer
1197,QLearningPlayer,232,217,449,30,27,Player A
1198,QLearningPlayer,218,238,456,28,24,QLearningPlayer
1199,QLearningPlayer,222,217,439,23,28,Player A
1200,QLearningPlayer,192,247,439,20,27,QLearningPlayer
1201,QLearningPlayer,205,250,455,24,23,QLearningPlayer
1202,QLearningPlayer,198,243,441,25,28,QLearningPlayer
1203,QLearningPlayer,208,228,436,32,32,QLearningPlayer
1204,QLearningPlayer,218,218,436,17,27,Tie
1205,QLearningPlayer,276,191,467,24,19,Player A
1206,QLearningPlayer,207,217,424,23,33,QLearningPlayer
1207,QLearningPlayer,223,238,461,24,21,QLearningPlayer
1208,QLearningPlayer,220,240,460,29,23,QLearningPlayer
1209,QLearningPlayer,222,227,449,24,25,QLearningPlayer
1210,QLearningPlayer,262,227,489,37,16,Player A
1211,QLearningPlayer,238,223,461,24,21,Player A
1212,QLearningPlayer,212,227,439,26,29,QLearningPlayer
1213,QLearningPlayer,244,189,433,23,30,Player A
1214,QLearningPlayer,230,225,455,24,23,Player A
1215,QLearningPlayer,227,212,439,17,26,Player A
1216,QLearningPlayer,221,221,442,29,29,Tie
0,PatternLearningPlayer,280,210,490,29,13,Player A
1,PatternLearningPlayer,220,225,445,20,25,PatternLearningPlayer
2,PatternLearningPlayer,265,215,480,31,17,Player A
3,PatternLearningPlayer,217,222,439,23,28,PatternLearningPlayer
4,PatternLearningPlayer,254,224,478,26,16,Player A
5,PatternLearningPlayer,227,202,429,16,29,Player A
6,PatternLearningPlayer,316,206,522,52,10,Player A
7,PatternLearningPlayer,296,206,502,35,11,Player A
8,PatternLearningPlayer,242,227,469,23,18,Player A
9,PatternLearningPlayer,276,201,477,31,18,Player A
10,PatternLearningPlayer,277,212,489,28,13,Player A
11,PatternLearningPlayer,202,227,429,19,30,PatternLearningPlayer
12,PatternLearningPlayer,324,179,503,42,13,Player A
13,PatternLearningPlayer,230,235,465,31,22,PatternLearningPlayer
14,PatternLearningPlayer,264,209,473,33,20,Player A
15,PatternLearningPlayer,233,203,436,26,30,Player A
16,PatternLearningPlayer,288,198,486,40,18,Player A
17,PatternLearningPlayer,251,201,452,27,25,Player A
18,PatternLearningPlayer,335,185,520,44,8,Player A
19,PatternLearningPlayer,345,185,530,48,6,Player A
20,PatternLearningPlayer,212,217,429,13,28,PatternLearningPlayer
21,PatternLearningPlayer,232,222,454,32,26,Player A
22,PatternLearningPlayer,285,195,480,31,17,Player A
23,PatternLearningPlayer,277,212,489,34,15,Player A
24,PatternLearningPlayer,268,218,486,34,16,Player A
25,PatternLearningPlayer,314,199,513,43,10,Player A
26,PatternLearningPlayer,244,219,463,26,21,Player A
27,PatternLearningPlayer,283,213,496,32,12,Player A
28,PatternLearningPlayer,249,229,478,29,17,Player A
29,PatternLearningPlayer,301,216,517,44,9,Player A
30,PatternLearningPlayer,340,190,530,48,6,Player A
31,PatternLearningPlayer,245,220,465,28,21,Player A
32,PatternLearningPlayer,173,223,396,10,38,PatternLearningPlayer
33,PatternLearningPlayer,278,193,471,37,22,Player A
34,PatternLearningPlayer,287,192,479,30,17,Player A
35,PatternLearningPlayer,253,223,476,27,17,Player A
36,PatternLearningPlayer,229,224,453,19,22,Player A
37,PatternLearningPlayer,238,228,466,35,23,Player A
38,PatternLearningPlayer,225,225,450,25,25,Tie
39,PatternLearningPlayer,229,209,438,22,28,Player A
40,PatternLearningPlayer,233,223,456,25,23,Player A
41,PatternLearningPlayer,314,189,503,45,14,Player A
42,PatternLearningPlayer,242,197,439,26,29,Player A
43,PatternLearningPlayer,253,238,491,36,15,Player A
44,PatternLearningPlayer,273,203,476,33,19,Player A
45,PatternLearningPlayer,250,200,450,28,26,Player A
46,PatternLearningPlayer,223,228,451,29,26,PatternLearningPlayer
47,PatternLearningPlayer,261,201,462,31,23,Player A
48,PatternLearningPlayer,274,194,468,25,19,Player A
49,PatternLearningPlayer,318,198,516,40,8,Player A
50,PatternLearningPlayer,318,203,521,42,7,Player A
51,PatternLearningPlayer,288,198,486,31,15,Player A
52,PatternLearningPlayer,271,216,487,38,17,Player A
53,PatternLearningPlayer,261,216,477,28,17,Player A
54,PatternLearningPlayer,248,223,471,34,21,Player A
55,PatternLearningPlayer,302,207,509,39,10,Player A
56,PatternLearningPlayer,259,214,473,24,17,Player A
57,PatternLearningPlayer,296,221,517,50,11,Player A
58,PatternLearningPlayer,278,213,491,36,15,Player A
59,PatternLearningPlayer,324,204,528,49,7,Player A
60,PatternLearningPlayer,302,217,519,37,6,Player A
61,PatternLearningPlayer,291,216,507,34,9,Player A
62,PatternLearningPlayer,276,201,477,34,19,Player A
63,PatternLearningPlayer,264,199,463,29,22,Player A
64,PatternLearningPlayer,296,196,492,31,13,Player A
65,PatternLearningPlayer,314,189,503,42,13,Player A
66,PatternLearningPlayer,259,219,478,35,19,Player A
67,PatternLearningPlayer,237,222,459,25,22,Player A
68,PatternLearningPlayer,232,217,449,27,26,Player A
69,PatternLearningPlayer,287,207,494,39,15,Player A
70,PatternLearningPlayer,252,207,459,37,26,Player A
71,PatternLearningPlayer,214,234,448,23,25,PatternLearningPlayer
72,PatternLearningPlayer,343,178,521,42,7,Player A
73,PatternLearningPlayer,240,220,460,23,21,Player A
74,PatternLearningPlayer,236,226,462,25,21,Player A
75,PatternLearningPlayer,170,215,385,8,41,PatternLearningPlayer
76,PatternLearningPlayer,284,214,498,40,14,Player A
77,PatternLearningPlayer,254,194,448,26,26,Player A
78,PatternLearningPlayer,251,206,457,29,24,Player A
79,PatternLearningPlayer,322,222,544,50,2,Player A
80,PatternLearningPlayer,288,198,486,34,16,Player A
81,PatternLearningPlayer,274,204,478,29,17,Player A
82,PatternLearningPlayer,236,211,447,22,25,Player A
83,PatternLearningPlayer,262,202,464,33,23,Player A
84,PatternLearningPlayer,338,183,521,51,10,Player A
85,PatternLearningPlayer,280,210,490,32,14,Player A
86,PatternLearningPlayer,179,219,398,12,38,PatternLearningPlayer
87,PatternLearningPlayer,249,229,478,32,18,Player A
88,PatternLearningPlayer,324,174,498,34,12,Player A
89,PatternLearningPlayer,265,210,475,32,19,Player A
90,PatternLearningPlayer,236,221,457,23,22,Player A
91,PatternLearningPlayer,260,215,475,35,20,Player A
92,PatternLearningPlayer,256,211,467,30,21,Player A
93,PatternLearningPlayer,223,203,426,19,31,Player A
94,PatternLearningPlayer,291,196,487,29,14,Player A
95,PatternLearningPlayer,242,207,449,24,25,Player A
96,PatternLearningPlayer,263,193,456,25,23,Player A
97,PatternLearningPlayer,249,209,458,30,24,Player A
98,PatternLearningPlayer,306,206,512,36,8,Player A
99,PatternLearningPlayer,248,203,451,29,26,Player A
100,PatternLearningPlayer,216,201,417,16,33,Player A
101,PatternLearningPlayer,282,202,484,29,15,Player A
102,PatternLearningPlayer,159,214,373,8,45,PatternLearningPlayer
103,PatternLearningPlayer,287,217,504,43,13,Player A
104,PatternLearningPlayer,213,228,441,25,28,PatternLearningPlayer
105,PatternLearningPlayer,230,215,445,20,25,Player A
106,PatternLearningPlayer,268,198,466,20,18,Player A
107,PatternLearningPlayer,249,214,463,26,21,Player A
108,PatternLearningPlayer,229,219,448,26,26,Player A
109,PatternLearningPlayer,327,197,524,42,6,Player A
110,PatternLearningPlayer,303,218,521,39,6,Player A
111,PatternLearningPlayer,341,196,537,49,4,Player A
112,PatternLearningPlayer,315,210,525,46,7,Player A
113,PatternLearningPlayer,246,216,462,25,21,Player A
114,PatternLearningPlayer,282,202,484,32,16,Player A
115,PatternLearningPlayer,298,198,496,41,15,Player A
116,PatternLearningPlayer,281,211,492,37,15,Player A
117,PatternLearningPlayer,247,237,484,38,18,Player A
118,PatternLearningPlayer,294,199,493,29,12,Player A
119,PatternLearningPlayer,234,209,443,30,29,Player A
120,PatternLearningPlayer,263,193,456,25,23,Player A
121,PatternLearningPlayer,329,204,533,48,5,Player A
122,PatternLearningPlayer,278,198,476,33,19,Player A
123,PatternLearningPlayer,272,202,474,25,17,Player A
124,PatternLearningPlayer,193,223,416,18,34,PatternLearningPlayer
125,PatternLearningPlayer,270,205,475,32,19,Player A
126,PatternLearningPlayer,273,218,491,30,13,Player A
127,PatternLearningPlayer,324,184,508,41,11,Player A
128,PatternLearningPlayer,288,198,486,31,15,Player A
129,PatternLearningPlayer,245,215,460,20,20,Player A
130,PatternLearningPlayer,320,205,525,46,7,Player A
131,PatternLearningPlayer,243,223,466,26,20,Player A
132,PatternLearningPlayer,274,209,483,25,14,Player A
133,PatternLearningPlayer,199,234,433,14,27,PatternLearningPlayer
134,PatternLearningPlayer,242,212,454,20,22,Player A
135,PatternLearningPlayer,295,195,490,38,16,Player A
136,PatternLearningPlayer,272,207,479,30,17,Player A
137,PatternLearningPlayer,251,231,482,36,18,Player A
138,PatternLearningPlayer,279,194,473,27,18,Player A
139,PatternLearningPlayer,286,206,492,37,15,Player A
140,PatternLearningPlayer,295,205,500,33,11,Player A
141,PatternLearningPlayer,290,195,485,33,16,Player A
142,PatternLearningPlayer,198,228,426,16,30,PatternLearningPlayer
143,PatternLearningPlayer,229,209,438,25,29,Player A
144,PatternLearningPlayer,220,220,440,24,28,Tie
145,PatternLearningPlayer,293,203,496,32,12,Player A
146,PatternLearningPlayer,200,235,435,19,28,PatternLearningPlayer
147,PatternLearningPlayer,309,214,523,44,7,Player A
148,PatternLearningPlayer,293,198,491,39,16,Player A
149,PatternLearningPlayer,252,207,459,31,24,Player A
150,PatternLearningPlayer,255,225,480,31,17,Player A
151,PatternLearningPlayer,243,223,466,32,22,Player A
152,PatternLearningPlayer,241,201,442,29,29,Player A
153,PatternLearningPlayer,211,226,437,21,28,PatternLearningPlayer
154,PatternLearningPlayer,249,204,453,22,23,Player A
155,PatternLearningPlayer,293,223,516,46,10,Player A
156,PatternLearningPlayer,266,226,492,34,14,Player A
157,PatternLearningPlayer,194,219,413,18,35,PatternLearningPlayer
158,PatternLearningPlayer,310,205,515,45,10,Player A
159,PatternLearningPlayer,277,212,489,37,16,Player A
160,PatternLearningPlayer,289,224,513,40,9,Player A
161,PatternLearningPlayer,307,212,519,40,7,Player A
162,PatternLearningPlayer,253,208,461,24,21,Player A
163,PatternLearningPlayer,281,201,482,30,16,Player A
164,PatternLearningPlayer,291,211,502,41,13,Player A
165,PatternLearningPlayer,331,211,542,51,3,Player A
166,PatternLearningPlayer,313,193,506,42,12,Player A
167,PatternLearningPlayer,284,204,488,33,15,Player A
168,PatternLearningPlayer,327,207,534,52,6,Player A
169,PatternLearningPlayer,203,208,411,19,36,PatternLearningPlayer
170,PatternLearningPlayer,289,184,473,33,20,Player A
171,PatternLearningPlayer,282,227,509,33,8,Player A
172,PatternLearningPlayer,202,222,424,17,31,PatternLearningPlayer
173,PatternLearningPlayer,257,212,469,32,21,Player A
174,PatternLearningPlayer,262,197,459,34,25,Player A
175,PatternLearningPlayer,244,224,468,34,22,Player A
176,PatternLearningPlayer,333,198,531,46,5,Player A
177,PatternLearningPlayer,252,237,489,34,15,Player A
178,PatternLearningPlayer,267,212,479,33,18,Player A
179,PatternLearningPlayer,281,216,497,42,15,Player A
180,PatternLearningPlayer,325,195,520,44,8,Player A
181,PatternLearningPlayer,260,215,475,26,17,Player A
182,PatternLearningPlayer,192,227,419,15,32,PatternLearningPlayer
183,PatternLearningPlayer,289,209,498,37,13,Player A
184,PatternLearningPlayer,250,205,455,36,27,Player A
185,PatternLearningPlayer,281,196,477,31,18,Player A
186,PatternLearningPlayer,274,239,513,46,11,Player A
187,PatternLearningPlayer,267,217,484,29,15,Player A
188,PatternLearningPlayer,318,203,521,45,8,Player A
189,PatternLearningPlayer,265,230,495,31,12,Player A
190,PatternLearningPlayer,276,231,507,40,11,Player A
191,PatternLearningPlayer,320,210,530,48,6,Player A
192,PatternLearningPlayer,262,212,474,34,20,Player A
193,PatternLearningPlayer,236,226,462,31,23,Player A
194,PatternLearningPlayer,273,213,486,25,13,Player A
195,PatternLearningPlayer,291,196,487,35,16,Player A
196,PatternLearningPlayer,258,218,476,27,17,Player A
197,PatternLearningPlayer,275,205,480,31,17,Player A
198,PatternLearningPlayer,332,177,509,36,9,Player A
199,PatternLearningPlayer,329,189,518,48,10,Player A
200,PatternLearningPlayer,271,221,492,43,17,Player A
201,PatternLearningPlayer,289,224,513,49,12,Player A
202,PatternLearningPlayer,327,192,519,40,7,Player A
203,PatternLearningPlayer,290,220,510,46,12,Player A
204,PatternLearningPlayer,280,210,490,35,15,Player A
205,PatternLearningPlayer,292,202,494,33,13,Player A
206,PatternLearningPlayer,204,224,428,15,29,PatternLearningPlayer
207,PatternLearningPlayer,327,187,514,44,10,Player A
208,PatternLearningPlayer,199,224,423,16,31,PatternLearningPlayer
209,PatternLearningPlayer,258,213,471,34,21,Player A
210,PatternLearningPlayer,244,199,443,24,27,Player A
211,PatternLearningPlayer,287,222,509,42,11,Player A
212,PatternLearningPlayer,291,231,522,43,7,Player A
213,PatternLearningPlayer,233,228,461,21,20,Player A
214,PatternLearningPlayer,283,203,486,31,15,Player A
215,PatternLearningPlayer,226,221,447,31,28,Player A
216,PatternLearningPlayer,291,211,502,41,13,Player A
217,PatternLearningPlayer,259,219,478,32,18,Player A
218,PatternLearningPlayer,286,191,477,31,18,Player A
219,PatternLearningPlayer,276,201,477,28,17,Player A
220,PatternLearningPlayer,221,191,412,17,35,Player A
221,PatternLearningPlayer,278,208,486,37,17,Player A
222,PatternLearningPlayer,258,213,471,34,21,Player A
223,PatternLearningPlayer,260,195,455,27,24,Player A
224,PatternLearningPlayer,230,215,445,29,28,Player A
225,PatternLearningPlayer,248,198,446,27,27,Player A
226,PatternLearningPlayer,276,201,477,34,19,Player A
227,PatternLearningPlayer,281,201,482,39,19,Player A
228,PatternLearningPlayer,251,216,467,24,19,Player A
229,PatternLearningPlayer,261,216,477,40,21,Player A
230,PatternLearningPlayer,272,212,484,32,16,Player A
231,PatternLearningPlayer,226,211,437,24,29,Player A
232,PatternLearningPlayer,290,210,500,39,13,Player A
233,PatternLearningPlayer,310,195,505,44,13,Player A
234,PatternLearningPlayer,307,202,509,42,11,Player A
235,PatternLearningPlayer,267,202,469,32,21,Player A
236,PatternLearningPlayer,264,229,493,38,15,Player A
237,PatternLearningPlayer,245,215,460,26,22,Player A
238,PatternLearningPlayer,184,204,388,14,42,PatternLearningPlayer
239,PatternLearningPlayer,222,217,439,23,28,Player A
240,PatternLearningPlayer,290,205,495,34,13,Player A
241,PatternLearningPlayer,342,197,539,48,3,Player A
242,PatternLearningPlayer,303,208,511,38,9,Player A
243,PatternLearningPlayer,296,206,502,38,12,Player A
244,PatternLearningPlayer,316,196,512,42,10,Player A
245,PatternLearningPlayer,233,223,456,25,23,Player A
246,PatternLearningPlayer,321,196,517,50,11,Player A
247,PatternLearningPlayer,252,232,484,38,18,Player A
248,PatternLearningPlayer,244,214,458,27,23,Player A
249,PatternLearningPlayer,279,204,483,34,17,Player A
250,PatternLearningPlayer,261,211,472,23,17,Player A
251,PatternLearningPlayer,168,238,406,11,35,PatternLearningPlayer
252,PatternLearningPlayer,249,219,468,22,18,Player A
253,PatternLearningPlayer,288,188,476,36,20,Player A
254,PatternLearningPlayer,233,228,461,27,22,Player A
255,PatternLearningPlayer,258,203,461,24,21,Player A
256,PatternLearningPlayer,265,205,470,33,21,Player A
257,PatternLearningPlayer,325,200,525,40,5,Player A
258,PatternLearningPlayer,284,209,493,35,14,Player A
259,PatternLearningPlayer,346,201,547,56,3,Player A
260,PatternLearningPlayer,259,214,473,27,18,Player A
261,PatternLearningPlayer,306,196,502,41,13,Player A
262,PatternLearningPlayer,194,234,428,24,32,PatternLearningPlayer
263,PatternLearningPlayer,266,211,477,28,17,Player A
264,PatternLearningPlayer,263,193,456,22,22,Player A
265,PatternLearningPlayer,273,233,506,42,12,Player A
266,PatternLearningPlayer,293,208,501,37,12,Player A
267,PatternLearningPlayer,237,217,454,23,23,Player A
268,PatternLearningPlayer,251,226,477,34,19,Player A
269,PatternLearningPlayer,249,184,433,26,31,Player A
270,PatternLearningPlayer,247,197,444,22,26,Player A
271,PatternLearningPlayer,297,212,509,45,12,Player A
272,PatternLearningPlayer,250,220,470,27,19,Player A
273,PatternLearningPlayer,338,183,521,39,6,Player A
274,PatternLearningPlayer,189,234,423,19,32,PatternLearningPlayer
275,PatternLearningPlayer,311,201,512,42,10,Player A
276,PatternLearningPlayer,320,210,530,48,6,Player A
277,PatternLearningPlayer,262,202,464,33,23,Player A
278,PatternLearningPlayer,286,211,497,36,13,Player A
279,PatternLearningPlayer,234,229,463,26,21,Player A
280,PatternLearningPlayer,315,200,515,42,9,Player A
281,PatternLearningPlayer,307,192,499,44,15,Player A
282,PatternLearningPlayer,298,208,506,36,10,Player A
283,PatternLearningPlayer,273,238,511,38,9,Player A
284,PatternLearningPlayer,232,232,464,27,21,Tie
285,PatternLearningPlayer,296,201,497,33,12,Player A
286,PatternLearningPlayer,210,220,430,20,30,PatternLearningPlayer
287,PatternLearningPlayer,204,209,413,24,37,PatternLearningPlayer
288,PatternLearningPlayer,313,198,511,41,10,Player A
289,PatternLearningPlayer,239,209,448,26,26,Player A
290,PatternLearningPlayer,202,242,444,28,28,PatternLearningPlayer
291,PatternLearningPlayer,298,203,501,40,13,Player A
292,PatternLearningPlayer,214,214,428,18,30,Tie
293,PatternLearningPlayer,237,202,439,20,27,Player A
294,PatternLearningPlayer,295,225,520,41,7,Player A
295,PatternLearningPlayer,232,232,464,24,20,Tie
296,PatternLearningPlayer,277,202,479,27,16,Player A
297,PatternLearningPlayer,344,179,523,44,7,Player A
298,PatternLearningPlayer,285,220,505,41,12,Player A
299,PatternLearningPlayer,232,207,439,23,28,Player A
300,PatternLearningPlayer,245,195,440,30,30,Player A
301,PatternLearningPlayer,261,211,472,32,20,Player A
302,PatternLearningPlayer,286,201,487,38,17,Player A
303,PatternLearningPlayer,241,221,462,25,21,Player A
304,PatternLearningPlayer,248,213,461,27,22,Player A
305,PatternLearningPlayer,272,222,494,42,16,Player A
306,PatternLearningPlayer,274,199,473,30,19,Player A
307,PatternLearningPlayer,240,245,485,36,17,PatternLearningPlayer
308,PatternLearningPlayer,291,211,502,35,11,Player A
309,PatternLearningPlayer,300,195,495,34,13,Player A
310,PatternLearningPlayer,203,213,416,18,34,PatternLearningPlayer
311,PatternLearningPlayer,324,194,518,48,10,Player A
312,PatternLearningPlayer,261,201,462,25,21,Player A
313,PatternLearningPlayer,273,218,491,27,12,Player A
314,PatternLearningPlayer,242,212,454,26,24,Player A
315,PatternLearningPlayer,267,222,489,34,15,Player A
316,PatternLearningPlayer,304,209,513,43,10,Player A
317,PatternLearningPlayer,236,226,462,22,20,Player A
318,PatternLearningPlayer,300,205,505,35,10,Player A
319,PatternLearningPlayer,266,221,487,38,17,Player A
320,PatternLearningPlayer,280,220,500,30,10,Player A
321,PatternLearningPlayer,286,206,492,37,15,Player A
322,PatternLearningPlayer,249,234,483,31,16,Player A
323,PatternLearningPlayer,264,219,483,37,18,Player A
324,PatternLearningPlayer,265,200,465,31,22,Player A
325,PatternLearningPlayer,267,217,484,32,16,Player A
326,PatternLearningPlayer,277,202,479,27,16,Player A
327,PatternLearningPlayer,253,223,476,30,18,Player A
328,PatternLearningPlayer,334,209,543,52,3,Player A
329,PatternLearningPlayer,331,191,522,49,9,Player A
330,PatternLearningPlayer,347,187,534,49,5,Player A
331,PatternLearningPlayer,317,202,519,43,8,Player A
332,PatternLearningPlayer,295,210,505,41,12,Player A
333,PatternLearningPlayer,250,210,460,29,23,Player A
334,PatternLearningPlayer,342,167,509,45,12,Player A
335,PatternLearningPlayer,264,199,463,32,23,Player A
336,PatternLearningPlayer,222,217,439,23,28,Player A
337,PatternLearningPlayer,275,215,490,35,15,Player A
338,PatternLearningPlayer,234,219,453,19,22,Player A
339,PatternLearningPlayer,287,217,504,40,12,Player A
340,PatternLearningPlayer,229,219,448,20,24,Player A
341,PatternLearningPlayer,345,205,550,59,3,Player A
342,PatternLearningPlayer,237,227,464,27,21,Player A
343,PatternLearningPlayer,295,225,520,47,9,Player A
344,PatternLearningPlayer,225,235,460,26,22,PatternLearningPlayer
345,PatternLearningPlayer,278,198,476,33,19,Player A
346,PatternLearningPlayer,209,234,443,24,27,PatternLearningPlayer
347,PatternLearningPlayer,280,210,490,35,15,Player A
348,PatternLearningPlayer,257,192,449,27,26,Player A
349,PatternLearningPlayer,263,203,466,26,20,Player A
350,PatternLearningPlayer,298,198,496,38,14,Player A
351,PatternLearningPlayer,252,207,459,25,22,Player A
352,PatternLearningPlayer,259,194,453,25,24,Player A
353,PatternLearningPlayer,288,223,511,47,12,Player A
354,PatternLearningPlayer,235,235,470,33,21,Tie
355,PatternLearningPlayer,287,192,479,33,18,Player A
356,PatternLearningPlayer,279,214,493,32,13,Player A
357,PatternLearningPlayer,233,208,441,22,27,Player A
358,PatternLearningPlayer,292,222,514,41,9,Player A
359,PatternLearningPlayer,290,200,490,38,16,Player A
360,PatternLearningPlayer,297,202,499,32,11,Player A
361,PatternLearningPlayer,271,211,482,33,17,Player A
362,PatternLearningPlayer,229,219,448,26,26,Player A
363,PatternLearningPlayer,312,207,519,49,10,Player A
364,PatternLearningPlayer,298,203,501,43,14,Player A
365,PatternLearningPlayer,281,206,487,38,17,Player A
366,PatternLearningPlayer,266,216,482,33,17,Player A
367,PatternLearningPlayer,270,190,460,23,21,Player A
368,PatternLearningPlayer,284,224,508,38,10,Player A
369,PatternLearningPlayer,277,207,484,26,14,Player A
370,PatternLearningPlayer,242,227,469,26,19,Player A
371,PatternLearningPlayer,302,202,504,37,11,Player A
372,PatternLearningPlayer,264,204,468,28,20,Player A
373,PatternLearningPlayer,301,211,512,39,9,Player A
374,PatternLearningPlayer,241,216,457,23,22,Player A
375,PatternLearningPlayer,255,215,470,27,19,Player A
376,PatternLearningPlayer,302,227,529,50,7,Player A
377,PatternLearningPlayer,254,219,473,33,20,Player A
378,PatternLearningPlayer,235,220,455,33,26,Player A
379,PatternLearningPlayer,291,206,497,36,13,Player A
380,PatternLearningPlayer,292,192,484,35,17,Player A
381,PatternLearningPlayer,252,217,469,23,18,Player A
382,PatternLearningPlayer,294,204,498,34,12,Player A
383,PatternLearningPlayer,297,202,499,32,11,Player A
384,PatternLearningPlayer,293,218,511,44,11,Player A
385,PatternLearningPlayer,242,227,469,26,19,Player A
386,PatternLearningPlayer,318,218,536,51,5,Player A
387,PatternLearningPlayer,254,214,468,28,20,Player A
388,PatternLearningPlayer,260,205,465,31,22,Player A
389,PatternLearningPlayer,327,197,524,51,9,Player A
390,PatternLearningPlayer,244,224,468,28,20,Player A
391,PatternLearningPlayer,278,218,496,41,15,Player A
392,PatternLearningPlayer,255,215,470,33,21,Player A
393,PatternLearningPlayer,215,225,440,18,26,PatternLearningPlayer
394,PatternLearningPlayer,332,192,524,39,5,Player A
395,PatternLearningPlayer,187,242,429,25,32,PatternLearningPlayer
396,PatternLearningPlayer,328,208,536,48,4,Player A
397,PatternLearningPlayer,292,207,499,38,13,Player A
398,PatternLearningPlayer,251,211,462,25,21,Player A
399,PatternLearningPlayer,255,205,460,29,23,Player A
400,PatternLearningPlayer,323,213,536,54,6,Player A
401,PatternLearningPlayer,310,195,505,35,10,Player A
402,PatternLearningPlayer,264,219,483,31,16,Player A
403,PatternLearningPlayer,195,210,405,13,36,PatternLearningPlayer
404,PatternLearningPlayer,250,215,465,34,23,Player A
405,PatternLearningPlayer,289,204,493,35,14,Player A
406,PatternLearningPlayer,211,211,422,18,32,Tie
407,PatternLearningPlayer,251,216,467,24,19,Player A
408,PatternLearningPlayer,281,211,492,31,13,Player A
409,PatternLearningPlayer,268,208,476,30,18,Player A
410,PatternLearningPlayer,217,207,424,20,32,Player A
411,PatternLearningPlayer,264,234,498,34,12,Player A
412,PatternLearningPlayer,225,215,440,24,28,Player A
413,PatternLearningPlayer,330,205,535,50,5,Player A
414,PatternLearningPlayer,323,203,526,38,4,Player A
415,PatternLearningPlayer,258,208,466,29,21,Player A
416,PatternLearningPlayer,307,202,509,39,10,Player A
417,PatternLearningPlayer,306,206,512,39,9,Player A
418,PatternLearningPlayer,236,216,452,24,24,Player A
419,PatternLearningPlayer,282,222,504,40,12,Player A
420,PatternLearningPlayer,271,201,472,26,18,Player A
421,PatternLearningPlayer,312,192,504,34,10,Player A
422,PatternLearningPlayer,297,192,489,31,14,Player A
423,PatternLearningPlayer,292,207,499,38,13,Player A
424,PatternLearningPlayer,274,214,488,36,16,Player A
425,PatternLearningPlayer,231,216,447,22,25,Player A
426,PatternLearningPlayer,213,228,441,22,27,PatternLearningPlayer
427,PatternLearningPlayer,311,201,512,48,12,Player A
428,PatternLearningPlayer,305,205,510,37,9,Player A
429,PatternLearningPlayer,257,217,474,34,20,Player A
430,PatternLearningPlayer,291,191,482,30,16,Player A
431,PatternLearningPlayer,316,216,532,53,7,Player A
432,PatternLearningPlayer,235,205,440,21,27,Player A
433,PatternLearningPlayer,228,238,466,29,21,PatternLearningPlayer
434,PatternLearningPlayer,314,194,508,44,12,Player A
435,PatternLearningPlayer,207,227,434,18,28,PatternLearningPlayer
436,PatternLearningPlayer,269,224,493,32,13,Player A
437,PatternLearningPlayer,346,201,547,50,1,Player A
438,PatternLearningPlayer,292,227,519,49,10,Player A
439,PatternLearningPlayer,269,204,473,36,21,Player A
440,PatternLearningPlayer,261,211,472,29,19,Player A
441,PatternLearningPlayer,267,217,484,32,16,Player A
442,PatternLearningPlayer,265,220,485,36,17,Player A
443,PatternLearningPlayer,245,225,470,30,20,Player A
444,PatternLearningPlayer,272,217,489,40,17,Player A
445,PatternLearningPlayer,262,222,484,29,15,Player A
446,PatternLearningPlayer,291,221,512,45,11,Player A
447,PatternLearningPlayer,244,204,448,29,27,Player A
448,PatternLearningPlayer,253,208,461,27,22,Player A
449,PatternLearningPlayer,295,205,500,36,12,Player A
450,PatternLearningPlayer,317,207,524,48,8,Player A
451,PatternLearningPlayer,300,195,495,37,14,Player A
452,PatternLearningPlayer,289,214,503,36,11,Player A
453,PatternLearningPlayer,224,234,458,27,23,PatternLearningPlayer
454,PatternLearningPlayer,293,203,496,35,13,Player A
455,PatternLearningPlayer,308,218,526,44,6,Player A
456,PatternLearningPlayer,263,213,476,27,17,Player A
457,PatternLearningPlayer,301,206,507,37,10,Player A
458,PatternLearningPlayer,289,204,493,38,15,Player A
459,PatternLearningPlayer,210,215,425,24,33,PatternLearningPlayer
460,PatternLearningPlayer,321,206,527,48,7,Player A
461,PatternLearningPlayer,306,206,512,48,12,Player A
462,PatternLearningPlayer,223,223,446,21,25,Tie
463,PatternLearningPlayer,355,195,550,53,1,Player A
464,PatternLearningPlayer,262,222,484,38,18,Player A
465,PatternLearningPlayer,278,228,506,39,11,Player A
466,PatternLearningPlayer,325,190,515,42,9,Player A
467,PatternLearningPlayer,290,215,505,41,12,Player A
468,PatternLearningPlayer,262,212,474,31,19,Player A
469,PatternLearningPlayer,260,210,470,27,19,Player A
470,PatternLearningPlayer,286,196,482,33,17,Player A
471,PatternLearningPlayer,278,218,496,35,13,Player A
472,PatternLearningPlayer,278,223,501,40,13,Player A
473,PatternLearningPlayer,323,203,526,53,9,Player A
474,PatternLearningPlayer,243,213,456,25,23,Player A
475,PatternLearningPlayer,308,208,516,49,11,Player A
476,PatternLearningPlayer,271,206,477,31,18,Player A
477,PatternLearningPlayer,254,234,488,36,16,Player A
478,PatternLearningPlayer,334,189,523,50,9,Player A
479,PatternLearningPlayer,304,219,523,47,8,Player A
480,PatternLearningPlayer,280,205,485,33,16,Player A
481,PatternLearningPlayer,266,201,467,33,22,Player A
482,PatternLearningPlayer,315,200,515,39,8,Player A
483,PatternLearningPlayer,203,243,446,27,27,PatternLearningPlayer
484,PatternLearningPlayer,227,212,439,17,26,Player A
485,PatternLearningPlayer,259,224,483,40,19,Player A
486,PatternLearningPlayer,268,203,471,34,21,Player A
487,PatternLearningPlayer,246,201,447,28,27,Player A
488,PatternLearningPlayer,321,206,527,39,4,Player A
489,PatternLearningPlayer,309,204,513,46,11,Player A
490,PatternLearningPlayer,276,216,492,31,13,Player A
491,PatternLearningPlayer,276,211,487,32,15,Player A
492,PatternLearningPlayer,238,228,466,32,22,Player A
493,PatternLearningPlayer,256,206,462,34,24,Player A
494,PatternLearningPlayer,237,227,464,33,23,Player A
495,PatternLearningPlayer,287,217,504,43,13,Player A
496,PatternLearningPlayer,240,210,450,28,26,Player A
497,PatternLearningPlayer,270,210,480,37,19,Player A
498,PatternLearningPlayer,282,187,469,29,20,Player A
499,PatternLearningPlayer,318,198,516,46,10,Player A
500,PatternLearningPlayer,264,204,468,22,18,Player A
501,PatternLearningPlayer,252,217,469,26,19,Player A
502,PatternLearningPlayer,290,225,515,42,9,Player A
503,PatternLearningPlayer,326,201,527,45,6,Player A
504,PatternLearningPlayer,243,223,466,29,21,Player A
505,PatternLearningPlayer,286,221,507,37,10,Player A
506,PatternLearningPlayer,332,197,529,50,7,Player A
507,PatternLearningPlayer,272,212,484,32,16,Player A
508,PatternLearningPlayer,268,218,486,40,18,Player A
509,PatternLearningPlayer,271,216,487,32,15,Player A
510,PatternLearningPlayer,239,229,468,31,21,Player A
511,PatternLearningPlayer,336,221,557,60,1,Player A
512,PatternLearningPlayer,321,191,512,39,9,Player A
513,PatternLearningPlayer,306,191,497,36,13,Player A
514,PatternLearningPlayer,241,216,457,35,26,Player A
515,PatternLearningPlayer,264,229,493,41,16,Player A
516,PatternLearningPlayer,284,204,488,36,16,Player A
517,PatternLearningPlayer,315,205,520,44,8,Player A
518,PatternLearningPlayer,278,213,491,42,17,Player A
519,PatternLearningPlayer,263,223,486,31,15,Player A
520,PatternLearningPlayer,321,206,527,51,8,Player A
521,PatternLearningPlayer,242,227,469,32,21,Player A
522,PatternLearningPlayer,273,208,481,35,18,Player A
523,PatternLearningPlayer,315,210,525,43,6,Player A
524,PatternLearningPlayer,297,207,504,40,12,Player A
525,PatternLearningPlayer,274,219,493,41,16,Player A
526,PatternLearningPlayer,253,228,481,32,17,Player A
527,PatternLearningPlayer,211,226,437,27,30,PatternLearningPlayer
528,PatternLearningPlayer,259,219,478,29,17,Player A
529,PatternLearningPlayer,240,215,455,33,26,Player A
530,PatternLearningPlayer,321,196,517,47,10,Player A
531,PatternLearningPlayer,305,215,520,50,10,Player A
532,PatternLearningPlayer,293,218,511,47,12,Player A
533,PatternLearningPlayer,227,212,439,26,29,Player A
534,PatternLearningPlayer,284,204,488,33,15,Player A
535,PatternLearningPlayer,195,220,415,17,34,PatternLearningPlayer
536,PatternLearningPlayer,322,202,524,48,8,Player A
537,PatternLearningPlayer,266,216,482,36,18,Player A
538,PatternLearningPlayer,284,219,503,45,14,Player A
539,PatternLearningPlayer,267,227,494,33,13,Player A
540,PatternLearningPlayer,312,212,524,42,6,Player A
541,PatternLearningPlayer,343,198,541,53,4,Player A
542,PatternLearningPlayer,269,214,483,31,16,Player A
543,PatternLearningPlayer,300,205,505,44,13,Player A
544,PatternLearningPlayer,302,202,504,31,9,Player A
545,PatternLearningPlayer,268,213,481,41,20,Player A
546,PatternLearningPlayer,323,203,526,41,5,Player A
547,PatternLearningPlayer,243,218,461,30,23,Player A
548,PatternLearningPlayer,247,232,479,27,16,Player A
549,PatternLearningPlayer,249,209,458,27,23,Player A
550,PatternLearningPlayer,230,205,435,22,29,Player A
551,PatternLearningPlayer,289,214,503,39,12,Player A
552,PatternLearningPlayer,255,220,475,35,20,Player A
553,PatternLearningPlayer,249,229,478,35,19,Player A
554,PatternLearningPlayer,283,228,511,44,11,Player A
555,PatternLearningPlayer,207,227,434,21,29,PatternLearningPlayer
556,PatternLearningPlayer,314,209,523,47,8,Player A
557,PatternLearningPlayer,213,203,416,18,34,Player A
558,PatternLearningPlayer,266,201,467,27,20,Player A
559,PatternLearningPlayer,297,212,509,45,12,Player A
560,PatternLearningPlayer,290,210,500,33,11,Player A
561,PatternLearningPlayer,319,209,528,49,7,Player A
562,PatternLearningPlayer,290,195,485,36,17,Player A
563,PatternLearningPlayer,323,203,526,50,8,Player A
564,PatternLearningPlayer,296,221,517,47,10,Player A
565,PatternLearningPlayer,175,245,420,13,31,PatternLearningPlayer
566,PatternLearningPlayer,318,188,506,36,10,Player A
567,PatternLearningPlayer,253,223,476,27,17,Player A
568,PatternLearningPlayer,293,228,521,48,9,Player A
569,PatternLearningPlayer,333,193,526,44,6,Player A
570,PatternLearningPlayer,224,224,448,23,25,Tie
571,PatternLearningPlayer,293,208,501,40,13,Player A
572,PatternLearningPlayer,294,224,518,42,8,Player A
573,PatternLearningPlayer,273,223,496,35,13,Player A
574,PatternLearningPlayer,284,204,488,39,17,Player A
575,PatternLearningPlayer,270,225,495,34,13,Player A
576,PatternLearningPlayer,333,203,536,51,5,Player A
577,PatternLearningPlayer,323,218,541,47,2,Player A
578,PatternLearningPlayer,243,218,461,27,22,Player A
579,PatternLearningPlayer,276,201,477,28,17,Player A
580,PatternLearningPlayer,247,222,469,29,20,Player A
581,PatternLearningPlayer,350,205,555,58,1,Player A
582,PatternLearningPlayer,291,211,502,38,12,Player A
583,PatternLearningPlayer,279,214,493,38,15,Player A
584,PatternLearningPlayer,280,210,490,38,16,Player A
585,PatternLearningPlayer,339,204,543,52,3,Player A
586,PatternLearningPlayer,288,213,501,40,13,Player A
587,PatternLearningPlayer,274,214,488,33,15,Player A
588,PatternLearningPlayer,285,210,495,40,15,Player A
589,PatternLearningPlayer,209,219,428,15,29,PatternLearningPlayer
590,PatternLearningPlayer,283,213,496,38,14,Player A
591,PatternLearningPlayer,271,201,472,35,21,Player A
592,PatternLearningPlayer,320,210,530,51,7,Player A
593,PatternLearningPlayer,319,199,518,42,8,Player A
594,PatternLearningPlayer,249,219,468,34,22,Player A
595,PatternLearningPlayer,259,209,468,31,21,Player A
596,PatternLearningPlayer,274,214,488,30,14,Player A
597,PatternLearningPlayer,268,213,481,26,15,Player A
598,PatternLearningPlayer,312,197,509,36,9,Player A
599,PatternLearningPlayer,288,228,516,43,9,Player A
600,PatternLearningPlayer,252,217,469,29,20,Player A
601,PatternLearningPlayer,302,212,514,41,9,Player A
602,PatternLearningPlayer,229,224,453,31,26,Player A
603,PatternLearningPlayer,338,198,536,48,4,Player A
604,PatternLearningPlayer,267,217,484,35,17,Player A
605,PatternLearningPlayer,280,225,505,38,11,Player A
606,PatternLearningPlayer,258,233,491,33,14,Player A
607,PatternLearningPlayer,342,187,529,53,8,Player A
608,PatternLearningPlayer,317,207,524,57,11,Player A
609,PatternLearningPlayer,306,221,527,45,6,Player A
610,PatternLearningPlayer,277,222,499,35,12,Player A
611,PatternLearningPlayer,294,209,503,36,11,Player A
612,PatternLearningPlayer,268,228,496,41,15,Player A
613,PatternLearningPlayer,329,184,513,37,8,Player A
614,PatternLearningPlayer,351,206,557,60,1,Player A
615,PatternLearningPlayer,308,218,526,44,6,Player A
616,PatternLearningPlayer,265,230,495,37,14,Player A
617,PatternLearningPlayer,313,203,516,46,10,Player A
618,PatternLearningPlayer,302,232,534,58,8,Player A
619,PatternLearningPlayer,272,212,484,32,16,Player A
620,PatternLearningPlayer,283,203,486,37,17,Player A
621,PatternLearningPlayer,308,203,511,44,11,Player A
622,PatternLearningPlayer,236,221,457,26,23,Player A
623,PatternLearningPlayer,240,240,480,28,16,Tie
624,PatternLearningPlayer,216,211,427,17,30,Player A
625,PatternLearningPlayer,291,196,487,35,16,Player A
626,PatternLearningPlayer,267,212,479,36,19,Player A
627,PatternLearningPlayer,340,225,565,65,0,Player A
628,PatternLearningPlayer,262,232,494,39,15,Player A
629,PatternLearningPlayer,186,261,447,31,28,PatternLearningPlayer
630,PatternLearningPlayer,331,196,527,45,6,Player A
631,PatternLearningPlayer,278,228,506,39,11,Player A
632,PatternLearningPlayer,260,215,475,29,18,Player A
633,PatternLearningPlayer,361,201,562,62,0,Player A
634,PatternLearningPlayer,293,228,521,42,7,Player A
635,PatternLearningPlayer,331,201,532,53,7,Player A
636,PatternLearningPlayer,253,208,461,24,21,Player A
637,PatternLearningPlayer,309,199,508,41,11,Player A
638,PatternLearningPlayer,309,204,513,46,11,Player A
639,PatternLearningPlayer,285,235,520,50,10,Player A
640,PatternLearningPlayer,332,197,529,47,6,Player A
641,PatternLearningPlayer,189,234,423,19,32,PatternLearningPlayer
642,PatternLearningPlayer,326,206,532,50,6,Player A
643,PatternLearningPlayer,314,214,528,46,6,Player A
644,PatternLearningPlayer,254,229,483,34,17,Player A
645,PatternLearningPlayer,256,226,482,27,15,Player A
646,PatternLearningPlayer,241,231,472,29,19,Player A
647,PatternLearningPlayer,313,208,521,54,11,Player A
648,PatternLearningPlayer,279,234,513,43,10,Player A
649,PatternLearningPlayer,255,225,480,34,18,Player A
650,PatternLearningPlayer,367,192,559,62,1,Player A
651,PatternLearningPlayer,262,217,479,33,18,Player A
652,PatternLearningPlayer,281,236,517,44,9,Player A
653,PatternLearningPlayer,304,219,523,44,7,Player A
654,PatternLearningPlayer,217,227,444,28,28,PatternLearningPlayer
655,PatternLearningPlayer,346,196,542,51,3,Player A
656,PatternLearningPlayer,282,212,494,36,14,Player A
657,PatternLearningPlayer,303,213,516,40,8,Player A
658,PatternLearningPlayer,282,212,494,39,15,Player A
659,PatternLearningPlayer,270,220,490,38,16,Player A
660,PatternLearningPlayer,255,225,480,34,18,Player A
661,PatternLearningPlayer,348,203,551,51,0,Player A
662,PatternLearningPlayer,262,197,459,25,22,Player A
663,PatternLearningPlayer,154,239,393,10,39,PatternLearningPlayer
664,PatternLearningPlayer,321,176,497,42,15,Player A
665,PatternLearningPlayer,270,230,500,45,15,Player A
666,PatternLearningPlayer,228,228,456,31,25,Tie
667,PatternLearningPlayer,256,221,477,40,21,Player A
668,PatternLearningPlayer,284,209,493,35,14,Player A
669,PatternLearningPlayer,256,221,477,31,18,Player A
670,PatternLearningPlayer,283,213,496,41,15,Player A
671,PatternLearningPlayer,335,200,535,44,3,Player A
672,PatternLearningPlayer,315,205,520,44,8,Player A
673,PatternLearningPlayer,315,210,525,52,9,Player A
674,PatternLearningPlayer,284,229,513,46,11,Player A
675,PatternLearningPlayer,233,213,446,21,25,Player A
676,PatternLearningPlayer,299,194,493,35,14,Player A
677,PatternLearningPlayer,276,216,492,37,15,Player A
678,PatternLearningPlayer,338,188,526,44,6,Player A
679,PatternLearningPlayer,300,205,505,44,13,Player A
680,PatternLearningPlayer,293,213,506,42,12,Player A
681,PatternLearningPlayer,353,203,556,59,1,Player A
682,PatternLearningPlayer,272,207,479,33,18,Player A
683,PatternLearningPlayer,294,204,498,37,13,Player A
684,PatternLearningPlayer,316,196,512,42,10,Player A
685,PatternLearningPlayer,199,219,418,20,34,PatternLearningPlayer
686,PatternLearningPlayer,283,208,491,39,16,Player A
687,PatternLearningPlayer,312,212,524,48,8,Player A
688,PatternLearningPlayer,308,208,516,46,10,Player A
689,PatternLearningPlayer,309,209,518,42,8,Player A
690,PatternLearningPlayer,313,193,506,42,12,Player A
691,PatternLearningPlayer,293,233,526,53,9,Player A
692,PatternLearningPlayer,272,207,479,27,16,Player A
693,PatternLearningPlayer,233,233,466,23,19,Tie
694,PatternLearningPlayer,250,225,475,29,18,Player A
695,PatternLearningPlayer,260,245,505,41,12,Player A
696,PatternLearningPlayer,282,227,509,39,10,Player A
697,PatternLearningPlayer,331,216,547,56,3,Player A
698,PatternLearningPlayer,313,208,521,45,8,Player A
699,PatternLearningPlayer,225,220,445,23,26,Player A
700,PatternLearningPlayer,340,200,540,55,5,Player A
701,PatternLearningPlayer,310,205,515,45,10,Player A
702,PatternLearningPlayer,297,222,519,46,9,Player A
703,PatternLearningPlayer,372,187,559,62,1,Player A
704,PatternLearningPlayer,270,225,495,31,12,Player A
705,PatternLearningPlayer,295,200,495,37,14,Player A
706,PatternLearningPlayer,212,217,429,25,32,PatternLearningPlayer
707,PatternLearningPlayer,249,219,468,28,20,Player A
708,PatternLearningPlayer,332,217,549,61,4,Player A
709,PatternLearningPlayer,251,206,457,26,23,Player A
710,PatternLearningPlayer,283,218,501,40,13,Player A
711,PatternLearningPlayer,270,215,485,33,16,Player A
712,PatternLearningPlayer,342,192,534,52,6,Player A
713,PatternLearningPlayer,242,237,479,33,18,Player A
714,PatternLearningPlayer,312,222,534,49,5,Player A
715,PatternLearningPlayer,318,218,536,51,5,Player A
716,PatternLearningPlayer,245,225,470,30,20,Player A
717,PatternLearningPlayer,295,190,485,36,17,Player A
718,PatternLearningPlayer,274,204,478,32,18,Player A
719,PatternLearningPlayer,247,202,449,27,26,Player A
720,PatternLearningPlayer,284,204,488,33,15,Player A
721,PatternLearningPlayer,296,211,507,37,10,Player A
722,PatternLearningPlayer,272,212,484,38,18,Player A
723,PatternLearningPlayer,304,224,528,55,9,Player A
724,PatternLearningPlayer,295,205,500,39,13,Player A
725,PatternLearningPlayer,269,209,478,41,21,Player A
726,PatternLearningPlayer,318,208,526,47,7,Player A
727,PatternLearningPlayer,310,205,515,39,8,Player A
728,PatternLearningPlayer,265,220,485,33,16,Player A
729,PatternLearningPlayer,275,220,495,34,13,Player A
730,PatternLearningPlayer,310,210,520,44,8,Player A
731,PatternLearningPlayer,224,229,453,25,24,PatternLearningPlayer
732,PatternLearningPlayer,274,214,488,30,14,Player A
733,PatternLearningPlayer,276,201,477,25,16,Player A
734,PatternLearningPlayer,293,208,501,40,13,Player A
735,PatternLearningPlayer,258,218,476,36,20,Player A
736,PatternLearningPlayer,267,212,479,39,20,Player A
737,PatternLearningPlayer,333,198,531,46,5,Player A
738,PatternLearningPlayer,334,209,543,55,4,Player A
739,PatternLearningPlayer,286,221,507,43,12,Player A
740,PatternLearningPlayer,331,206,537,52,5,Player A
741,PatternLearningPlayer,290,225,515,45,10,Player A
742,PatternLearningPlayer,261,201,462,31,23,Player A
743,PatternLearningPlayer,310,220,530,48,6,Player A
744,PatternLearningPlayer,318,208,526,41,5,Player A
745,PatternLearningPlayer,258,228,486,31,15,Player A
746,PatternLearningPlayer,323,213,536,57,7,Player A
747,PatternLearningPlayer,289,219,508,38,10,Player A
748,PatternLearningPlayer,292,232,524,42,6,Player A
749,PatternLearningPlayer,257,212,469,29,20,Player A
750,PatternLearningPlayer,203,238,441,31,30,PatternLearningPlayer
751,PatternLearningPlayer,313,203,516,46,10,Player A
752,PatternLearningPlayer,288,203,491,36,15,Player A
753,PatternLearningPlayer,311,211,522,40,6,Player A
754,PatternLearningPlayer,326,206,532,50,6,Player A
755,PatternLearningPlayer,336,211,547,50,1,Player A
756,PatternLearningPlayer,368,183,551,54,1,Player A
757,PatternLearningPlayer,208,233,441,28,29,PatternLearningPlayer
758,PatternLearningPlayer,267,207,474,25,17,Player A
759,PatternLearningPlayer,301,206,507,37,10,Player A
760,PatternLearningPlayer,251,221,472,38,22,Player A
761,PatternLearningPlayer,286,206,492,40,16,Player A
762,PatternLearningPlayer,307,217,524,54,10,Player A
763,PatternLearningPlayer,322,192,514,47,11,Player A
764,PatternLearningPlayer,339,199,538,50,4,Player A
765,PatternLearningPlayer,264,244,508,44,12,Player A
766,PatternLearningPlayer,257,227,484,35,17,Player A
767,PatternLearningPlayer,263,213,476,24,16,Player A
768,PatternLearningPlayer,348,208,556,56,0,Player A
769,PatternLearningPlayer,209,234,443,21,26,PatternLearningPlayer
770,PatternLearningPlayer,292,212,504,34,10,Player A
771,PatternLearningPlayer,277,227,504,37,11,Player A
772,PatternLearningPlayer,277,247,524,48,8,Player A
773,PatternLearningPlayer,298,223,521,48,9,Player A
774,PatternLearningPlayer,211,221,432,22,30,PatternLearningPlayer
775,PatternLearningPlayer,292,217,509,36,9,Player A
776,PatternLearningPlayer,337,207,544,59,5,Player A
777,PatternLearningPlayer,268,208,476,33,19,Player A
778,PatternLearningPlayer,281,206,487,32,15,Player A
779,PatternLearningPlayer,298,218,516,43,9,Player A
780,PatternLearningPlayer,228,243,471,28,19,PatternLearningPlayer
781,PatternLearningPlayer,296,226,522,46,8,Player A
782,PatternLearningPlayer,319,219,538,50,4,Player A
783,PatternLearningPlayer,245,220,465,25,20,Player A
784,PatternLearningPlayer,306,216,522,40,6,Player A
785,PatternLearningPlayer,264,214,478,29,17,Player A
786,PatternLearningPlayer,319,199,518,45,9,Player A
787,PatternLearningPlayer,297,222,519,49,10,Player A
788,PatternLearningPlayer,319,204,523,53,10,Player A
789,PatternLearningPlayer,273,228,501,37,12,Player A
790,PatternLearningPlayer,287,197,484,35,17,Player A
791,PatternLearningPlayer,310,185,495,43,16,Player A
792,PatternLearningPlayer,307,227,534,49,5,Player A
793,PatternLearningPlayer,331,186,517,41,8,Player A
794,PatternLearningPlayer,235,230,465,28,21,Player A
795,PatternLearningPlayer,320,205,525,46,7,Player A
796,PatternLearningPlayer,320,210,530,48,6,Player A
797,PatternLearningPlayer,281,226,507,34,9,Player A
798,PatternLearningPlayer,285,220,505,44,13,Player A
799,PatternLearningPlayer,313,213,526,44,6,Player A
800,PatternLearningPlayer,334,194,528,46,6,Player A
801,PatternLearningPlayer,274,224,498,34,12,Player A
802,PatternLearningPlayer,312,207,519,55,12,Player A
803,PatternLearningPlayer,302,212,514,41,9,Player A
804,PatternLearningPlayer,286,216,502,38,12,Player A
805,PatternLearningPlayer,307,227,534,58,8,Player A
806,PatternLearningPlayer,261,221,482,33,17,Player A
807,PatternLearningPlayer,288,218,506,42,12,Player A
808,PatternLearningPlayer,308,203,511,38,9,Player A
809,PatternLearningPlayer,312,207,519,43,8,Player A
810,PatternLearningPlayer,281,226,507,40,11,Player A
811,PatternLearningPlayer,264,219,483,40,19,Player A
812,PatternLearningPlayer,329,209,538,53,5,Player A
813,PatternLearningPlayer,302,207,509,42,11,Player A
814,PatternLearningPlayer,295,205,500,45,15,Player A
815,PatternLearningPlayer,314,219,533,54,7,Player A
816,PatternLearningPlayer,308,203,511,44,11,Player A
817,PatternLearningPlayer,281,191,472,29,19,Player A
818,PatternLearningPlayer,331,206,537,49,4,Player A
819,PatternLearningPlayer,302,222,524,51,9,Player A
820,PatternLearningPlayer,307,207,514,44,10,Player A
821,PatternLearningPlayer,314,204,518,45,9,Player A
822,PatternLearningPlayer,280,225,505,44,13,Player A
823,PatternLearningPlayer,307,217,524,42,6,Player A
824,PatternLearningPlayer,271,231,502,35,11,Player A
825,PatternLearningPlayer,292,217,509,42,11,Player A
826,PatternLearningPlayer,308,203,511,44,11,Player A
827,PatternLearningPlayer,294,209,503,45,14,Player A
828,PatternLearningPlayer,303,208,511,38,9,Player A
829,PatternLearningPlayer,304,199,503,45,14,Player A
830,PatternLearningPlayer,237,232,469,35,22,Player A
831,PatternLearningPlayer,242,212,454,23,23,Player A
832,PatternLearningPlayer,287,217,504,37,11,Player A
833,PatternLearningPlayer,315,200,515,51,12,Player A
834,PatternLearningPlayer,323,213,536,48,4,Player A
835,PatternLearningPlayer,271,206,477,31,18,Player A
836,PatternLearningPlayer,284,214,498,37,13,Player A
837,PatternLearningPlayer,320,200,520,47,9,Player A
838,PatternLearningPlayer,249,229,478,35,19,Player A
839,PatternLearningPlayer,268,213,481,35,18,Player A
840,PatternLearningPlayer,273,213,486,37,17,Player A
841,PatternLearningPlayer,218,218,436,23,29,Tie
842,PatternLearningPlayer,278,208,486,40,18,Player A
843,PatternLearningPlayer,222,217,439,26,29,Player A
844,PatternLearningPlayer,310,200,510,40,10,Player A
845,PatternLearningPlayer,302,212,514,41,9,Player A
846,PatternLearningPlayer,276,231,507,37,10,Player A
847,PatternLearningPlayer,306,211,517,50,11,Player A
848,PatternLearningPlayer,291,206,497,36,13,Player A
849,PatternLearningPlayer,334,209,543,55,4,Player A
850,PatternLearningPlayer,287,217,504,43,13,Player A
851,PatternLearningPlayer,288,213,501,34,11,Player A
852,PatternLearningPlayer,311,201,512,42,10,Player A
853,PatternLearningPlayer,329,199,528,52,8,Player A
854,PatternLearningPlayer,315,210,525,43,6,Player A
855,PatternLearningPlayer,344,184,528,49,7,Player A
856,PatternLearningPlayer,307,197,504,37,11,Player A
857,PatternLearningPlayer,214,219,433,20,29,PatternLearningPlayer
858,PatternLearningPlayer,288,198,486,37,17,Player A
859,PatternLearningPlayer,281,206,487,38,17,Player A
860,PatternLearningPlayer,249,224,473,27,18,Player A
861,PatternLearningPlayer,253,218,471,31,20,Player A
862,PatternLearningPlayer,241,216,457,23,22,Player A
863,PatternLearningPlayer,310,220,530,45,5,Player A
864,PatternLearningPlayer,292,227,519,46,9,Player A
865,PatternLearningPlayer,290,230,520,47,9,Player A
866,PatternLearningPlayer,307,202,509,42,11,Player A
867,PatternLearningPlayer,324,214,538,53,5,Player A
868,PatternLearningPlayer,272,222,494,36,14,Player A
869,PatternLearningPlayer,337,192,529,50,7,Player A
870,PatternLearningPlayer,366,186,552,58,2,Player A
871,PatternLearningPlayer,306,206,512,48,12,Player A
872,PatternLearningPlayer,337,197,534,49,5,Player A
873,PatternLearningPlayer,259,229,488,39,17,Player A
874,PatternLearningPlayer,272,252,524,51,9,Player A
875,PatternLearningPlayer,315,210,525,46,7,Player A
876,PatternLearningPlayer,297,207,504,34,10,Player A
877,PatternLearningPlayer,263,203,466,29,21,Player A
878,PatternLearningPlayer,282,217,499,47,16,Player A
879,PatternLearningPlayer,278,223,501,43,14,Player A
880,PatternLearningPlayer,295,210,505,41,12,Player A
881,PatternLearningPlayer,238,228,466,29,21,Player A
882,PatternLearningPlayer,246,216,462,37,25,Player A
883,PatternLearningPlayer,231,236,467,27,20,PatternLearningPlayer
884,PatternLearningPlayer,274,229,503,39,12,Player A
885,PatternLearningPlayer,315,200,515,39,8,Player A
886,PatternLearningPlayer,299,224,523,44,7,Player A
887,PatternLearningPlayer,248,213,461,36,25,Player A
888,PatternLearningPlayer,269,219,488,33,15,Player A
889,PatternLearningPlayer,315,220,535,53,6,Player A
890,PatternLearningPlayer,336,196,532,47,5,Player A
891,PatternLearningPlayer,248,203,451,26,25,Player A
892,PatternLearningPlayer,215,220,435,25,30,PatternLearningPlayer
893,PatternLearningPlayer,312,207,519,55,12,Player A
894,PatternLearningPlayer,246,241,487,35,16,Player A
895,PatternLearningPlayer,287,212,499,44,15,Player A
896,PatternLearningPlayer,239,239,478,32,18,Tie
897,PatternLearningPlayer,305,205,510,40,10,Player A
898,PatternLearningPlayer,344,194,538,50,4,Player A
899,PatternLearningPlayer,313,198,511,47,12,Player A
900,PatternLearningPlayer,259,219,478,32,18,Player A
901,PatternLearningPlayer,204,229,433,26,31,PatternLearningPlayer
902,PatternLearningPlayer,300,210,510,46,12,Player A
903,PatternLearningPlayer,338,193,531,43,4,Player A
904,PatternLearningPlayer,294,214,508,41,11,Player A
905,PatternLearningPlayer,246,231,477,28,17,Player A
906,PatternLearningPlayer,327,202,529,50,7,Player A
907,PatternLearningPlayer,347,182,529,44,5,Player A
908,PatternLearningPlayer,290,220,510,37,9,Player A
909,PatternLearningPlayer,311,201,512,45,11,Player A
910,PatternLearningPlayer,323,208,531,46,5,Player A
911,PatternLearningPlayer,285,240,525,49,8,Player A
912,PatternLearningPlayer,359,189,548,54,2,Player A
913,PatternLearningPlayer,249,229,478,41,21,Player A
914,PatternLearningPlayer,311,211,522,46,8,Player A
915,PatternLearningPlayer,325,205,530,48,6,Player A
916,PatternLearningPlayer,245,225,470,33,21,Player A
917,PatternLearningPlayer,265,205,470,33,21,Player A
918,PatternLearningPlayer,258,208,466,29,21,Player A
919,PatternLearningPlayer,340,205,545,54,3,Player A
920,PatternLearningPlayer,233,213,446,24,26,Player A
921,PatternLearningPlayer,332,217,549,58,3,Player A
922,PatternLearningPlayer,268,233,501,40,13,Player A
923,PatternLearningPlayer,296,211,507,40,11,Player A
924,PatternLearningPlayer,333,198,531,49,6,Player A
925,PatternLearningPlayer,306,216,522,43,7,Player A
926,PatternLearningPlayer,282,217,499,32,11,Player A
927,PatternLearningPlayer,273,213,486,34,16,Player A
928,PatternLearningPlayer,302,227,529,47,6,Player A
929,PatternLearningPlayer,271,216,487,32,15,Player A
930,PatternLearningPlayer,346,191,537,52,5,Player A
931,PatternLearningPlayer,273,208,481,35,18,Player A
932,PatternLearningPlayer,284,214,498,37,13,Player A
933,PatternLearningPlayer,255,220,475,32,19,Player A
934,PatternLearningPlayer,278,223,501,40,13,Player A
935,PatternLearningPlayer,286,216,502,41,13,Player A
936,PatternLearningPlayer,277,222,499,38,13,Player A
937,PatternLearningPlayer,291,201,492,34,14,Player A
938,PatternLearningPlayer,336,196,532,47,5,Player A
939,PatternLearningPlayer,309,209,518,45,9,Player A
940,PatternLearningPlayer,350,195,545,51,2,Player A
941,PatternLearningPlayer,320,210,530,45,5,Player A
942,PatternLearningPlayer,287,202,489,37,16,Player A
943,PatternLearningPlayer,344,219,563,63,0,Player A
944,PatternLearningPlayer,321,201,522,43,7,Player A
945,PatternLearningPlayer,263,238,501,40,13,Player A
946,PatternLearningPlayer,315,230,545,63,6,Player A
947,PatternLearningPlayer,258,213,471,37,22,Player A
948,PatternLearningPlayer,291,201,492,34,14,Player A
949,PatternLearningPlayer,326,211,537,49,4,Player A
950,PatternLearningPlayer,330,210,540,52,4,Player A
951,PatternLearningPlayer,304,204,508,41,11,Player A
952,PatternLearningPlayer,306,221,527,54,9,Player A
953,PatternLearningPlayer,286,226,512,42,10,Player A
954,PatternLearningPlayer,297,222,519,43,8,Player A
955,PatternLearningPlayer,324,214,538,53,5,Player A
956,PatternLearningPlayer,339,214,553,59,2,Player A
957,PatternLearningPlayer,329,189,518,42,8,Player A
958,PatternLearningPlayer,283,213,496,41,15,Player A
959,PatternLearningPlayer,284,224,508,44,12,Player A
960,PatternLearningPlayer,323,203,526,41,5,Player A
961,PatternLearningPlayer,313,203,516,46,10,Player A
962,PatternLearningPlayer,335,200,535,50,5,Player A
963,PatternLearningPlayer,318,208,526,44,6,Player A
964,PatternLearningPlayer,305,220,525,52,9,Player A
965,PatternLearningPlayer,348,183,531,49,6,Player A
966,PatternLearningPlayer,237,212,449,21,24,Player A
967,PatternLearningPlayer,323,208,531,43,4,Player A
968,PatternLearningPlayer,288,218,506,45,13,Player A
969,PatternLearningPlayer,212,222,434,21,29,PatternLearningPlayer
970,PatternLearningPlayer,277,227,504,40,12,Player A
971,PatternLearningPlayer,233,223,456,31,25,Player A
972,PatternLearningPlayer,266,211,477,34,19,Player A
973,PatternLearningPlayer,302,217,519,37,6,Player A
974,PatternLearningPlayer,261,211,472,26,18,Player A
975,PatternLearningPlayer,362,197,559,59,0,Player A
976,PatternLearningPlayer,253,218,471,31,20,Player A
977,PatternLearningPlayer,301,196,497,42,15,Player A
978,PatternLearningPlayer,349,209,558,58,0,Player A
979,PatternLearningPlayer,240,230,470,30,20,Player A
980,PatternLearningPlayer,257,217,474,34,20,Player A
981,PatternLearningPlayer,289,219,508,44,12,Player A
982,PatternLearningPlayer,277,207,484,32,16,Player A
983,PatternLearningPlayer,223,228,451,26,25,PatternLearningPlayer
984,PatternLearningPlayer,265,215,480,37,19,Player A
985,PatternLearningPlayer,319,214,533,51,6,Player A
986,PatternLearningPlayer,299,214,513,43,10,Player A
987,PatternLearningPlayer,291,226,517,50,11,Player A
988,PatternLearningPlayer,301,216,517,41,8,Player A
989,PatternLearningPlayer,268,208,476,33,19,Player A
990,PatternLearningPlayer,312,212,524,48,8,Player A
991,PatternLearningPlayer,243,223,466,29,21,Player A
992,PatternLearningPlayer,298,198,496,41,15,Player A
993,PatternLearningPlayer,347,187,534,46,4,Player A
994,PatternLearningPlayer,336,211,547,56,3,Player A
995,PatternLearningPlayer,295,210,505,41,12,Player A
996,PatternLearningPlayer,306,206,512,39,9,Player A
997,PatternLearningPlayer,313,208,521,42,7,Player A
998,PatternLearningPlayer,261,216,477,28,17,Player A
999,PatternLearningPlayer,330,205,535,47,4,Player A
1000,PatternLearningPlayer,305,220,525,46,7,Player A
1001,PatternLearningPlayer,271,216,487,35,16,Player A
1002,PatternLearningPlayer,275,190,465,34,23,Player A
1003,PatternLearningPlayer,307,222,529,47,6,Player A
1004,PatternLearningPlayer,281,211,492,46,18,Player A
1005,PatternLearningPlayer,240,240,480,31,17,Tie
1006,PatternLearningPlayer,339,204,543,46,1,Player A
1007,PatternLearningPlayer,340,200,540,52,4,Player A
1008,PatternLearningPlayer,294,209,503,36,11,Player A
1009,PatternLearningPlayer,367,197,564,64,0,Player A
1010,PatternLearningPlayer,231,211,442,26,28,Player A
1011,PatternLearningPlayer,325,205,530,51,7,Player A
1012,PatternLearningPlayer,301,191,492,31,13,Player A
1013,PatternLearningPlayer,287,237,524,51,9,Player A
1014,PatternLearningPlayer,304,214,518,45,9,Player A
1015,PatternLearningPlayer,278,233,511,38,9,Player A
1016,PatternLearningPlayer,315,210,525,49,8,Player A
1017,PatternLearningPlayer,341,206,547,53,2,Player A
1018,PatternLearningPlayer,317,207,524,42,6,Player A
1019,PatternLearningPlayer,279,219,498,40,14,Player A
1020,PatternLearningPlayer,331,221,552,61,3,Player A
1021,PatternLearningPlayer,297,217,514,38,8,Player A
1022,PatternLearningPlayer,256,246,502,41,13,Player A
1023,PatternLearningPlayer,276,216,492,40,16,Player A
1024,PatternLearningPlayer,292,222,514,41,9,Player A
1025,PatternLearningPlayer,279,209,488,39,17,Player A
1026,PatternLearningPlayer,289,234,523,53,10,Player A
1027,PatternLearningPlayer,280,210,490,32,14,Player A
1028,PatternLearningPlayer,215,230,445,17,24,PatternLearningPlayer
1029,PatternLearningPlayer,342,202,544,53,3,Player A
1030,PatternLearningPlayer,334,199,533,48,5,Player A
1031,PatternLearningPlayer,282,222,504,31,9,Player A
1032,PatternLearningPlayer,328,198,526,47,7,Player A
1033,PatternLearningPlayer,316,221,537,55,6,Player A
1034,PatternLearningPlayer,331,186,517,38,7,Player A
1035,PatternLearningPlayer,306,196,502,44,14,Player A
1036,PatternLearningPlayer,315,215,530,51,7,Player A
1037,PatternLearningPlayer,308,218,526,47,7,Player A
1038,PatternLearningPlayer,318,223,541,56,5,Player A
1039,PatternLearningPlayer,295,195,490,38,16,Player A
1040,PatternLearningPlayer,340,205,545,54,3,Player A
1041,PatternLearningPlayer,269,229,498,34,12,Player A
1042,PatternLearningPlayer,279,219,498,34,12,Player A
1043,PatternLearningPlayer,316,221,537,58,7,Player A
1044,PatternLearningPlayer,315,220,535,50,5,Player A
1045,PatternLearningPlayer,299,219,518,48,10,Player A
1046,PatternLearningPlayer,284,234,518,42,8,Player A
1047,PatternLearningPlayer,264,234,498,31,11,Player A
1048,PatternLearningPlayer,280,230,510,49,13,Player A
1049,PatternLearningPlayer,279,224,503,45,14,Player A
1050,PatternLearningPlayer,345,195,540,52,4,Player A
1051,PatternLearningPlayer,275,220,495,37,14,Player A
1052,PatternLearningPlayer,277,212,489,43,18,Player A
1053,PatternLearningPlayer,342,217,559,65,2,Player A
1054,PatternLearningPlayer,279,234,513,40,9,Player A
1055,PatternLearningPlayer,316,186,502,35,11,Player A
1056,PatternLearningPlayer,348,203,551,57,2,Player A
1057,PatternLearningPlayer,232,222,454,29,25,Player A
1058,PatternLearningPlayer,332,217,549,58,3,Player A
1059,PatternLearningPlayer,333,213,546,52,2,Player A
1060,PatternLearningPlayer,274,214,488,33,15,Player A
1061,PatternLearningPlayer,294,204,498,40,14,Player A
1062,PatternLearningPlayer,302,217,519,43,8,Player A
1063,PatternLearningPlayer,249,219,468,22,18,Player A
1064,PatternLearningPlayer,280,210,490,26,12,Player A
1065,PatternLearningPlayer,329,204,533,45,4,Player A
1066,PatternLearningPlayer,331,206,537,58,7,Player A
1067,PatternLearningPlayer,305,215,520,38,6,Player A
1068,PatternLearningPlayer,326,211,537,46,3,Player A
1069,PatternLearningPlayer,291,216,507,40,11,Player A
1070,PatternLearningPlayer,320,205,525,46,7,Player A
1071,PatternLearningPlayer,271,226,497,39,14,Player A
1072,PatternLearningPlayer,307,217,524,48,8,Player A
1073,PatternLearningPlayer,327,212,539,48,3,Player A
1074,PatternLearningPlayer,289,214,503,42,13,Player A
1075,PatternLearningPlayer,258,228,486,31,15,Player A
1076,PatternLearningPlayer,334,204,538,47,3,Player A
1077,PatternLearningPlayer,326,216,542,54,4,Player A
1078,PatternLearningPlayer,342,197,539,54,5,Player A
1079,PatternLearningPlayer,264,254,518,51,11,Player A
1080,PatternLearningPlayer,323,218,541,56,5,Player A
1081,PatternLearningPlayer,324,194,518,48,10,Player A
1082,PatternLearningPlayer,319,194,513,37,8,Player A
1083,PatternLearningPlayer,309,199,508,41,11,Player A
1084,PatternLearningPlayer,292,207,499,38,13,Player A
1085,PatternLearningPlayer,240,225,465,34,23,Player A
1086,PatternLearningPlayer,259,229,488,36,16,Player A
1087,PatternLearningPlayer,250,220,470,24,18,Player A
1088,PatternLearningPlayer,314,214,528,43,5,Player A
1089,PatternLearningPlayer,275,230,505,44,13,Player A
1090,PatternLearningPlayer,286,201,487,41,18,Player A
1091,PatternLearningPlayer,282,202,484,35,17,Player A
1092,PatternLearningPlayer,303,223,526,50,8,Player A
1093,PatternLearningPlayer,342,207,549,58,3,Player A
1094,PatternLearningPlayer,329,199,528,52,8,Player A
1095,PatternLearningPlayer,273,223,496,35,13,Player A
1096,PatternLearningPlayer,340,190,530,48,6,Player A
1097,PatternLearningPlayer,233,233,466,35,23,Tie
1098,PatternLearningPlayer,261,231,492,37,15,Player A
1099,PatternLearningPlayer,346,211,557,60,1,Player A
1100,PatternLearningPlayer,319,219,538,53,5,Player A
1101,PatternLearningPlayer,236,231,467,30,21,Player A
1102,PatternLearningPlayer,263,233,496,35,13,Player A
1103,PatternLearningPlayer,325,210,535,56,7,Player A
1104,PatternLearningPlayer,237,217,454,32,26,Player A
1105,PatternLearningPlayer,345,205,550,62,4,Player A
1106,PatternLearningPlayer,309,214,523,44,7,Player A
1107,PatternLearningPlayer,300,220,520,44,8,Player A
1108,PatternLearningPlayer,326,216,542,57,5,Player A
1109,PatternLearningPlayer,239,234,473,27,18,Player A
1110,PatternLearningPlayer,271,226,497,42,15,Player A
1111,PatternLearningPlayer,277,222,499,41,14,Player A
1112,PatternLearningPlayer,284,209,493,44,17,Player A
1113,PatternLearningPlayer,289,224,513,43,10,Player A
1114,PatternLearningPlayer,291,221,512,45,11,Player A
1115,PatternLearningPlayer,283,203,486,34,16,Player A
1116,PatternLearningPlayer,331,211,542,54,4,Player A
1117,PatternLearningPlayer,279,214,493,35,14,Player A
1118,PatternLearningPlayer,333,203,536,48,4,Player A
1119,PatternLearningPlayer,316,201,517,41,8,Player A
1120,PatternLearningPlayer,334,194,528,49,7,Player A
1121,PatternLearningPlayer,251,216,467,24,19,Player A
1122,PatternLearningPlayer,298,208,506,39,11,Player A
1123,PatternLearningPlayer,345,210,555,61,2,Player A
1124,PatternLearningPlayer,309,209,518,48,10,Player A
1125,PatternLearningPlayer,355,200,555,58,1,Player A
1126,PatternLearningPlayer,229,194,423,19,32,Player A
1127,PatternLearningPlayer,287,207,494,39,15,Player A
1128,PatternLearningPlayer,331,196,527,48,7,Player A
1129,PatternLearningPlayer,372,182,554,57,1,Player A
1130,PatternLearningPlayer,309,199,508,38,10,Player A
1131,PatternLearningPlayer,257,222,479,36,19,Player A
1132,PatternLearningPlayer,304,214,518,48,10,Player A
1133,PatternLearningPlayer,287,212,499,38,13,Player A
1134,PatternLearningPlayer,264,214,478,32,18,Player A
1135,PatternLearningPlayer,337,207,544,56,4,Player A
1136,PatternLearningPlayer,287,227,514,44,10,Player A
1137,PatternLearningPlayer,340,195,535,50,5,Player A
1138,PatternLearningPlayer,292,202,494,39,15,Player A
1139,PatternLearningPlayer,317,222,539,57,6,Player A
1140,PatternLearningPlayer,329,229,558,64,2,Player A
1141,PatternLearningPlayer,285,235,520,44,8,Player A
1142,PatternLearningPlayer,251,221,472,29,19,Player A
1143,PatternLearningPlayer,253,213,466,35,23,Player A
1144,PatternLearningPlayer,274,234,508,47,13,Player A
1145,PatternLearningPlayer,305,200,505,41,12,Player A
1146,PatternLearningPlayer,312,232,544,59,5,Player A
1147,PatternLearningPlayer,305,210,515,39,8,Player A
1148,PatternLearningPlayer,282,242,524,51,9,Player A
1149,PatternLearningPlayer,258,223,481,35,18,Player A
1150,PatternLearningPlayer,291,226,517,47,10,Player A
1151,PatternLearningPlayer,338,213,551,57,2,Player A
1152,PatternLearningPlayer,277,237,514,47,11,Player A
1153,PatternLearningPlayer,292,207,499,41,14,Player A
1154,PatternLearningPlayer,334,199,533,51,6,Player A
1155,PatternLearningPlayer,345,215,560,63,1,Player A
1156,PatternLearningPlayer,282,237,519,43,8,Player A
1157,PatternLearningPlayer,282,217,499,29,10,Player A
1158,PatternLearningPlayer,329,214,543,55,4,Player A
1159,PatternLearningPlayer,322,207,529,50,7,Player A
1160,PatternLearningPlayer,245,245,490,35,15,Tie
1161,PatternLearningPlayer,305,210,515,42,9,Player A
1162,PatternLearningPlayer,312,212,524,45,7,Player A
1163,PatternLearningPlayer,290,215,505,50,15,Player A
1164,PatternLearningPlayer,352,212,564,64,0,Player A
1165,PatternLearningPlayer,326,206,532,53,7,Player A
1166,PatternLearningPlayer,312,212,524,48,8,Player A
1167,PatternLearningPlayer,292,227,519,49,10,Player A
1168,PatternLearningPlayer,311,211,522,43,7,Player A
1169,PatternLearningPlayer,294,209,503,39,12,Player A
1170,PatternLearningPlayer,341,201,542,51,3,Player A
1171,PatternLearningPlayer,302,217,519,43,8,Player A
1172,PatternLearningPlayer,311,226,537,49,4,Player A
1173,PatternLearningPlayer,337,207,544,53,3,Player A
1174,PatternLearningPlayer,270,210,480,31,17,Player A
1175,PatternLearningPlayer,328,208,536,54,6,Player A
1176,PatternLearningPlayer,319,199,518,45,9,Player A
1177,PatternLearningPlayer,244,209,453,28,25,Player A
1178,PatternLearningPlayer,244,239,483,37,18,Player A
1179,PatternLearningPlayer,286,246,532,53,7,Player A
1180,PatternLearningPlayer,305,220,525,43,6,Player A
1181,PatternLearningPlayer,292,217,509,48,13,Player A
1182,PatternLearningPlayer,314,209,523,44,7,Player A
1183,PatternLearningPlayer,275,215,490,38,16,Player A
1184,PatternLearningPlayer,290,200,490,35,15,Player A
1185,PatternLearningPlayer,289,224,513,40,9,Player A
1186,PatternLearningPlayer,247,217,464,27,21,Player A
1187,PatternLearningPlayer,332,232,564,67,1,Player A
1188,PatternLearningPlayer,247,237,484,38,18,Player A
1189,PatternLearningPlayer,290,230,520,56,12,Player A
1190,PatternLearningPlayer,312,207,519,46,9,Player A
1191,PatternLearningPlayer,282,222,504,40,12,Player A
1192,PatternLearningPlayer,273,233,506,36,10,Player A
1193,PatternLearningPlayer,249,229,478,32,18,Player A
1194,PatternLearningPlayer,294,224,518,51,11,Player A
1195,PatternLearningPlayer,330,210,540,49,3,Player A
1196,PatternLearningPlayer,276,231,507,43,12,Player A
1197,PatternLearningPlayer,282,222,504,40,12,Player A
1198,PatternLearningPlayer,204,244,448,26,26,PatternLearningPlayer
1199,PatternLearningPlayer,339,214,553,59,2,Player A
1200,PatternLearningPlayer,336,206,542,51,3,Player A
1201,PatternLearningPlayer,280,220,500,39,13,Player A
1202,PatternLearningPlayer,299,209,508,44,12,Player A
1203,PatternLearningPlayer,256,211,467,30,21,Player A
1204,PatternLearningPlayer,319,204,523,53,10,Player A
1205,PatternLearningPlayer,290,205,495,28,11,Player A
1206,PatternLearningPlayer,305,220,525,43,6,Player A
1207,PatternLearningPlayer,316,206,522,46,8,Player A
1208,PatternLearningPlayer,297,217,514,38,8,Player A
1209,PatternLearningPlayer,353,213,566,66,0,Player A
1210,PatternLearningPlayer,328,223,551,60,3,Player A
1211,PatternLearningPlayer,288,228,516,43,9,Player A
1212,PatternLearningPlayer,258,213,471,28,19,Player A
1213,PatternLearningPlayer,297,227,524,42,6,Player A
1214,PatternLearningPlayer,352,207,559,62,1,Player A
1215,PatternLearningPlayer,301,221,522,49,9,Player A
1216,PatternLearningPlayer,305,195,500,36,12,Player A
1217,PatternLearningPlayer,324,179,503,39,12,Player A
1218,PatternLearningPlayer,307,212,519,49,10,Player A
1219,PatternLearningPlayer,370,190,560,60,0,Player A
1220,PatternLearningPlayer,335,205,540,49,3,Player A
1221,PatternLearningPlayer,303,203,506,42,12,Player A
1222,PatternLearningPlayer,319,214,533,54,7,Player A
1223,PatternLearningPlayer,253,213,466,29,21,Player A
1224,PatternLearningPlayer,328,228,556,65,3,Player A
1225,PatternLearningPlayer,271,226,497,39,14,Player A
1226,PatternLearningPlayer,240,220,460,23,21,Player A
1227,PatternLearningPlayer,281,216,497,39,14,Player A
1228,PatternLearningPlayer,300,220,520,47,9,Player A
1229,PatternLearningPlayer,329,199,528,49,7,Player A
1230,PatternLearningPlayer,334,224,558,64,2,Player A
1231,PatternLearningPlayer,290,205,495,34,13,Player A
1232,PatternLearningPlayer,295,220,515,33,6,Player A
1233,PatternLearningPlayer,329,184,513,43,10,Player A
1234,PatternLearningPlayer,286,206,492,37,15,Player A
1235,PatternLearningPlayer,290,220,510,49,13,Player A
1236,PatternLearningPlayer,314,234,548,60,4,Player A
1237,PatternLearningPlayer,328,238,566,69,1,Player A
1238,PatternLearningPlayer,335,210,545,57,4,Player A
1239,PatternLearningPlayer,354,204,558,58,0,Player A
1240,PatternLearningPlayer,292,217,509,42,11,Player A
1241,PatternLearningPlayer,301,236,537,55,6,Player A
1242,PatternLearningPlayer,328,193,521,48,9,Player A
1243,PatternLearningPlayer,311,196,507,49,14,Player A
1244,PatternLearningPlayer,237,207,444,28,28,Player A
1245,PatternLearningPlayer,324,219,543,55,4,Player A
1246,PatternLearningPlayer,304,214,518,42,8,Player A
1247,PatternLearningPlayer,237,232,469,23,18,Player A
1248,PatternLearningPlayer,305,225,530,45,5,Player A
1249,PatternLearningPlayer,342,202,544,53,3,Player A
1250,PatternLearningPlayer,331,216,547,53,2,Player A
1251,PatternLearningPlayer,302,217,519,40,7,Player A
1252,PatternLearningPlayer,317,207,524,48,8,Player A
1253,PatternLearningPlayer,330,215,545,54,3,Player A
1254,PatternLearningPlayer,328,198,526,47,7,Player A
1255,PatternLearningPlayer,278,228,506,36,10,Player A
1256,PatternLearningPlayer,326,201,527,45,6,Player A
1257,PatternLearningPlayer,312,192,504,40,12,Player A
1258,PatternLearningPlayer,254,229,483,37,18,Player A
1259,PatternLearningPlayer,272,222,494,42,16,Player A
1260,PatternLearningPlayer,303,213,516,40,8,Player A
1261,PatternLearningPlayer,283,218,501,40,13,Player A
1262,PatternLearningPlayer,326,216,542,51,3,Player A
1263,PatternLearningPlayer,319,214,533,51,6,Player A
1264,PatternLearningPlayer,255,230,485,36,17,Player A
1265,PatternLearningPlayer,282,232,514,47,11,Player A
1266,PatternLearningPlayer,348,223,571,71,0,Player A
1267,PatternLearningPlayer,314,219,533,48,5,Player A
1268,PatternLearningPlayer,338,198,536,54,6,Player A
1269,PatternLearningPlayer,257,227,484,44,20,Player A
1270,PatternLearningPlayer,277,212,489,40,17,Player A
1271,PatternLearningPlayer,311,226,537,52,5,Player A
1272,PatternLearningPlayer,322,212,534,58,8,Player A
1273,PatternLearningPlayer,293,208,501,43,14,Player A
1274,PatternLearningPlayer,218,228,446,24,26,PatternLearningPlayer
1275,PatternLearningPlayer,293,233,526,44,6,Player A
1276,PatternLearningPlayer,276,216,492,37,15,Player A
1277,PatternLearningPlayer,309,219,528,52,8,Player A
1278,PatternLearningPlayer,308,213,521,48,9,Player A
1279,PatternLearningPlayer,255,225,480,37,19,Player A
1280,PatternLearningPlayer,371,186,557,57,0,Player A
1281,PatternLearningPlayer,321,206,527,48,7,Player A
1282,PatternLearningPlayer,318,203,521,48,9,Player A
1283,PatternLearningPlayer,288,208,496,29,11,Player A
1284,PatternLearningPlayer,354,199,553,59,2,Player A
1285,PatternLearningPlayer,272,232,504,37,11,Player A
1286,PatternLearningPlayer,274,214,488,36,16,Player A
1287,PatternLearningPlayer,298,213,511,44,11,Player A
1288,PatternLearningPlayer,289,214,503,39,12,Player A
1289,PatternLearningPlayer,316,231,547,53,2,Player A
1290,PatternLearningPlayer,289,199,488,39,17,Player A
1291,PatternLearningPlayer,276,231,507,46,13,Player A
1292,PatternLearningPlayer,318,218,536,51,5,Player A
1293,PatternLearningPlayer,325,220,545,57,4,Player A
1294,PatternLearningPlayer,292,217,509,39,10,Player A
1295,PatternLearningPlayer,297,232,529,50,7,Player A
1296,PatternLearningPlayer,270,220,490,38,16,Player A
1297,PatternLearningPlayer,260,225,485,42,19,Player A
1298,PatternLearningPlayer,289,234,523,47,8,Player A
1299,PatternLearningPlayer,258,218,476,36,20,Player A
1300,PatternLearningPlayer,319,214,533,51,6,Player A
1301,PatternLearningPlayer,290,225,515,39,8,Player A
1302,PatternLearningPlayer,360,195,555,61,2,Player A
1303,PatternLearningPlayer,311,216,527,42,5,Player A
1304,PatternLearningPlayer,257,232,489,37,16,Player A
1305,PatternLearningPlayer,234,234,468,28,20,Tie
1306,PatternLearningPlayer,294,219,513,43,10,Player A
1307,PatternLearningPlayer,319,209,528,43,5,Player A
1308,PatternLearningPlayer,301,211,512,39,9,Player A
1309,PatternLearningPlayer,245,240,485,36,17,Player A
1310,PatternLearningPlayer,308,208,516,46,10,Player A
1311,PatternLearningPlayer,329,204,533,45,4,Player A
1312,PatternLearningPlayer,288,223,511,47,12,Player A
1313,PatternLearningPlayer,279,224,503,42,13,Player A
1314,PatternLearningPlayer,268,213,481,29,16,Player A
1315,PatternLearningPlayer,296,226,522,52,10,Player A
1316,PatternLearningPlayer,274,239,513,52,13,Player A
1317,PatternLearningPlayer,314,199,513,43,10,Player A
1318,PatternLearningPlayer,269,234,503,39,12,Player A
1319,PatternLearningPlayer,284,229,513,46,11,Player A
1320,PatternLearningPlayer,335,185,520,41,7,Player A
1321,PatternLearningPlayer,282,222,504,43,13,Player A
1322,PatternLearningPlayer,325,210,535,53,6,Player A
1323,PatternLearningPlayer,271,231,502,38,12,Player A
1324,PatternLearningPlayer,238,238,476,39,21,Tie
1325,PatternLearningPlayer,286,211,497,39,14,Player A
1326,PatternLearningPlayer,309,204,513,46,11,Player A
1327,PatternLearningPlayer,322,212,534,49,5,Player A
1328,PatternLearningPlayer,262,237,499,38,13,Player A
1329,PatternLearningPlayer,344,209,553,56,1,Player A
1330,PatternLearningPlayer,305,220,525,52,9,Player A
1331,PatternLearningPlayer,243,233,476,33,19,Player A
1332,PatternLearningPlayer,266,216,482,30,16,Player A
1333,PatternLearningPlayer,243,213,456,28,24,Player A
1334,PatternLearningPlayer,314,229,543,55,4,Player A
1335,PatternLearningPlayer,334,199,533,51,6,Player A
1336,PatternLearningPlayer,334,214,548,54,2,Player A
1337,PatternLearningPlayer,295,220,515,42,9,Player A
1338,PatternLearningPlayer,308,218,526,47,7,Player A
1339,PatternLearningPlayer,311,211,522,40,6,Player A
1340,PatternLearningPlayer,313,238,551,57,2,Player A
1341,PatternLearningPlayer,303,198,501,43,14,Player A
1342,PatternLearningPlayer,325,220,545,60,5,Player A
1343,PatternLearningPlayer,332,222,554,60,2,Player A
1344,PatternLearningPlayer,345,220,565,65,0,Player A
1345,PatternLearningPlayer,319,209,528,52,8,Player A
1346,PatternLearningPlayer,357,197,554,57,1,Player A
1347,PatternLearningPlayer,350,210,560,63,1,Player A
1348,PatternLearningPlayer,268,233,501,43,14,Player A
1349,PatternLearningPlayer,313,223,536,57,7,Player A
1350,PatternLearningPlayer,244,234,478,32,18,Player A
1351,PatternLearningPlayer,263,253,516,49,11,Player A
1352,PatternLearningPlayer,325,215,540,58,6,Player A
1353,PatternLearningPlayer,257,222,479,27,16,Player A
1354,PatternLearningPlayer,330,225,555,61,2,Player A
1355,PatternLearningPlayer,269,239,508,50,14,Player A
1356,PatternLearningPlayer,318,223,541,53,4,Player A
1357,PatternLearningPlayer,291,221,512,48,12,Player A
1358,PatternLearningPlayer,293,223,516,40,8,Player A
1359,PatternLearningPlayer,346,206,552,58,2,Player A
1360,PatternLearningPlayer,328,238,566,69,1,Player A
1361,PatternLearningPlayer,302,237,539,57,6,Player A
1362,PatternLearningPlayer,315,220,535,53,6,Player A
1363,PatternLearningPlayer,288,218,506,45,13,Player A
1364,PatternLearningPlayer,338,198,536,45,3,Player A
1365,PatternLearningPlayer,284,219,503,36,11,Player A
1366,PatternLearningPlayer,300,210,510,40,10,Player A
1367,PatternLearningPlayer,321,201,522,49,9,Player A
1368,PatternLearningPlayer,342,227,569,69,0,Player A
1369,PatternLearningPlayer,309,219,528,46,6,Player A
1370,PatternLearningPlayer,351,211,562,65,1,Player A
1371,PatternLearningPlayer,293,218,511,38,9,Player A
1372,PatternLearningPlayer,289,224,513,43,10,Player A
1373,PatternLearningPlayer,303,228,531,55,8,Player A
1374,PatternLearningPlayer,291,206,497,39,14,Player A
1375,PatternLearningPlayer,309,214,523,44,7,Player A
1376,PatternLearningPlayer,276,231,507,46,13,Player A
1377,PatternLearningPlayer,311,211,522,43,7,Player A
1378,PatternLearningPlayer,325,195,520,47,9,Player A
1379,PatternLearningPlayer,296,216,512,45,11,Player A
1380,PatternLearningPlayer,304,219,523,53,10,Player A
1381,PatternLearningPlayer,318,208,526,47,7,Player A
1382,PatternLearningPlayer,318,218,536,57,7,Player A
1383,PatternLearningPlayer,299,229,528,58,10,Player A
1384,PatternLearningPlayer,299,229,528,52,8,Player A
1385,PatternLearningPlayer,276,231,507,43,12,Player A
1386,PatternLearningPlayer,324,204,528,46,6,Player A
1387,PatternLearningPlayer,290,225,515,45,10,Player A
1388,PatternLearningPlayer,275,240,515,48,11,Player A
1389,PatternLearningPlayer,309,204,513,40,9,Player A
1390,PatternLearningPlayer,343,208,551,60,3,Player A
1391,PatternLearningPlayer,250,245,495,37,14,Player A
1392,PatternLearningPlayer,347,212,559,62,1,Player A
1393,PatternLearningPlayer,324,219,543,58,5,Player A
1394,PatternLearningPlayer,317,222,539,54,5,Player A
1395,PatternLearningPlayer,341,216,557,60,1,Player A
1396,PatternLearningPlayer,252,222,474,34,20,Player A
1397,PatternLearningPlayer,241,221,462,22,20,Player A
1398,PatternLearningPlayer,354,209,563,66,1,Player A
1399,PatternLearningPlayer,359,184,543,49,2,Player A
1400,PatternLearningPlayer,298,203,501,43,14,Player A
1401,PatternLearningPlayer,282,227,509,45,12,Player A
1402,PatternLearningPlayer,312,202,514,38,8,Player A
1403,PatternLearningPlayer,309,224,533,51,6,Player A
1404,PatternLearningPlayer,309,234,543,52,3,Player A
1405,PatternLearningPlayer,234,239,473,30,19,PatternLearningPlayer
1406,PatternLearningPlayer,303,213,516,46,10,Player A
1407,PatternLearningPlayer,309,224,533,54,7,Player A
1408,PatternLearningPlayer,364,194,558,58,0,Player A
1409,PatternLearningPlayer,342,207,549,58,3,Player A
1410,PatternLearningPlayer,325,200,525,49,8,Player A
1411,PatternLearningPlayer,242,252,494,36,14,PatternLearningPlayer
1412,PatternLearningPlayer,226,241,467,30,21,PatternLearningPlayer
1413,PatternLearningPlayer,339,214,553,59,2,Player A
1414,PatternLearningPlayer,268,208,476,33,19,Player A
1415,PatternLearningPlayer,328,208,536,48,4,Player A
1416,PatternLearningPlayer,292,227,519,46,9,Player A
1417,PatternLearningPlayer,312,217,529,53,8,Player A
1418,PatternLearningPlayer,313,213,526,47,7,Player A
1419,PatternLearningPlayer,271,216,487,35,16,Player A
1420,PatternLearningPlayer,288,223,511,44,11,Player A
1421,PatternLearningPlayer,316,231,547,59,4,Player A
1422,PatternLearningPlayer,309,224,533,57,8,Player A
1423,PatternLearningPlayer,284,219,503,36,11,Player A
1424,PatternLearningPlayer,328,213,541,53,4,Player A
1425,PatternLearningPlayer,336,216,552,61,3,Player A
1426,PatternLearningPlayer,288,208,496,41,15,Player A
1427,PatternLearningPlayer,316,201,517,47,10,Player A
1428,PatternLearningPlayer,297,217,514,44,10,Player A
1429,PatternLearningPlayer,338,218,556,62,2,Player A
1430,PatternLearningPlayer,257,232,489,46,19,Player A
1431,PatternLearningPlayer,314,229,543,58,5,Player A
1432,PatternLearningPlayer,260,235,495,46,17,Player A
1433,PatternLearningPlayer,285,240,525,52,9,Player A
1434,PatternLearningPlayer,236,231,467,30,21,Player A
1435,PatternLearningPlayer,345,210,555,58,1,Player A
1436,PatternLearningPlayer,258,238,496,35,13,Player A
1437,PatternLearningPlayer,303,208,511,41,10,Player A
1438,PatternLearningPlayer,346,211,557,60,1,Player A
1439,PatternLearningPlayer,290,220,510,43,11,Player A
1440,PatternLearningPlayer,335,220,555,61,2,Player A
1441,PatternLearningPlayer,365,185,550,56,2,Player A
1442,PatternLearningPlayer,298,223,521,42,7,Player A
1443,PatternLearningPlayer,277,222,499,47,16,Player A
1444,PatternLearningPlayer,308,233,541,53,4,Player A
1445,PatternLearningPlayer,270,230,500,42,14,Player A
1446,PatternLearningPlayer,347,222,569,69,0,Player A
1447,PatternLearningPlayer,333,203,536,51,5,Player A
1448,PatternLearningPlayer,310,205,515,48,11,Player A
1449,PatternLearningPlayer,305,215,520,44,8,Player A
1450,PatternLearningPlayer,272,222,494,45,17,Player A
1451,PatternLearningPlayer,317,212,529,44,5,Player A
1452,PatternLearningPlayer,302,222,524,48,8,Player A
1453,PatternLearningPlayer,334,204,538,56,6,Player A
1454,PatternLearningPlayer,362,187,549,55,2,Player A
1455,PatternLearningPlayer,298,203,501,40,13,Player A
1456,PatternLearningPlayer,272,207,479,36,19,Player A
1457,PatternLearningPlayer,315,225,540,58,6,Player A
1458,PatternLearningPlayer,231,241,472,32,20,PatternLearningPlayer
1459,PatternLearningPlayer,302,212,514,38,8,Player A
1460,PatternLearningPlayer,325,210,535,50,5,Player A
1461,PatternLearningPlayer,347,182,529,44,5,Player A
1462,PatternLearningPlayer,327,212,539,57,6,Player A
1463,PatternLearningPlayer,246,246,492,43,17,Tie
1464,PatternLearningPlayer,325,190,515,45,10,Player A
1465,PatternLearningPlayer,314,199,513,43,10,Player A
1466,PatternLearningPlayer,320,200,520,41,7,Player A
1467,PatternLearningPlayer,269,219,488,36,16,Player A
1468,PatternLearningPlayer,287,212,499,32,11,Player A
1469,PatternLearningPlayer,252,232,484,29,15,Player A
1470,PatternLearningPlayer,279,234,513,52,13,Player A
1471,PatternLearningPlayer,341,211,552,58,2,Player A
1472,PatternLearningPlayer,287,232,519,49,10,Player A
1473,PatternLearningPlayer,272,232,504,37,11,Player A
1474,PatternLearningPlayer,319,209,528,46,6,Player A
1475,PatternLearningPlayer,326,211,537,52,5,Player A
1476,PatternLearningPlayer,293,203,496,41,15,Player A
1477,PatternLearningPlayer,328,218,546,55,3,Player A
1478,PatternLearningPlayer,293,218,511,47,12,Player A
1479,PatternLearningPlayer,333,208,541,59,6,Player A
1480,PatternLearningPlayer,320,205,525,46,7,Player A
1481,PatternLearningPlayer,300,225,525,58,11,Player A
1482,PatternLearningPlayer,347,197,544,50,2,Player A
1483,PatternLearningPlayer,327,212,539,54,5,Player A
1484,PatternLearningPlayer,275,235,510,46,12,Player A
1485,PatternLearningPlayer,285,215,500,42,14,Player A
1486,PatternLearningPlayer,264,224,488,27,13,Player A
1487,PatternLearningPlayer,329,219,548,57,3,Player A
1488,PatternLearningPlayer,353,208,561,61,0,Player A
1489,PatternLearningPlayer,339,209,548,60,4,Player A
1490,PatternLearningPlayer,335,205,540,58,6,Player A
1491,PatternLearningPlayer,314,214,528,43,5,Player A
1492,PatternLearningPlayer,324,219,543,55,4,Player A
1493,PatternLearningPlayer,298,188,486,40,18,Player A
1494,PatternLearningPlayer,312,202,514,47,11,Player A
1495,PatternLearningPlayer,282,212,494,39,15,Player A
1496,PatternLearningPlayer,270,230,500,36,12,Player A
1497,PatternLearningPlayer,334,219,553,56,1,Player A
1498,PatternLearningPlayer,242,242,484,38,18,Tie
1499,PatternLearningPlayer,336,211,547,62,5,Player A
1500,PatternLearningPlayer,296,221,517,47,10,Player A
1501,PatternLearningPlayer,342,227,569,69,0,Player A
1502,PatternLearningPlayer,309,219,528,52,8,Player A
1503,PatternLearningPlayer,344,209,553,62,3,Player A
1504,PatternLearningPlayer,253,243,496,41,15,Player A
1505,PatternLearningPlayer,280,205,485,36,17,Player A
1506,PatternLearningPlayer,303,233,536,57,7,Player A
1507,PatternLearningPlayer,300,220,520,50,10,Player A
1508,PatternLearningPlayer,331,216,547,50,1,Player A
1509,PatternLearningPlayer,279,214,493,35,14,Player A
1510,PatternLearningPlayer,315,235,550,56,2,Player A
1511,PatternLearningPlayer,306,211,517,47,10,Player A
1512,PatternLearningPlayer,294,214,508,47,13,Player A
1513,PatternLearningPlayer,321,216,537,52,5,Player A
1514,PatternLearningPlayer,342,227,569,69,0,Player A
1515,PatternLearningPlayer,361,201,562,65,1,Player A
1516,PatternLearningPlayer,283,218,501,31,10,Player A
1517,PatternLearningPlayer,344,214,558,61,1,Player A
1518,PatternLearningPlayer,305,250,555,67,4,Player A
1519,PatternLearningPlayer,298,228,526,47,7,Player A
1520,PatternLearningPlayer,303,223,526,47,7,Player A
1521,PatternLearningPlayer,321,206,527,54,9,Player A
1522,PatternLearningPlayer,269,234,503,39,12,Player A
1523,PatternLearningPlayer,318,218,536,51,5,Player A
1524,PatternLearningPlayer,296,191,487,38,17,Player A
1525,PatternLearningPlayer,341,206,547,56,3,Player A
1526,PatternLearningPlayer,311,196,507,37,10,Player A
1527,PatternLearningPlayer,347,217,564,67,1,Player A
1528,PatternLearningPlayer,344,214,558,58,0,Player A
1529,PatternLearningPlayer,318,203,521,51,10,Player A
1530,PatternLearningPlayer,328,213,541,53,4,Player A
1531,PatternLearningPlayer,321,216,537,52,5,Player A
1532,PatternLearningPlayer,248,248,496,41,15,Tie
1533,PatternLearningPlayer,300,225,525,46,7,Player A
1534,PatternLearningPlayer,338,213,551,60,3,Player A
1535,PatternLearningPlayer,348,218,566,69,1,Player A
1536,PatternLearningPlayer,256,216,472,38,22,Player A
1537,PatternLearningPlayer,300,205,505,44,13,Player A
1538,PatternLearningPlayer,334,199,533,51,6,Player A
1539,PatternLearningPlayer,319,224,543,58,5,Player A
1540,PatternLearningPlayer,339,209,548,51,1,Player A
1541,PatternLearningPlayer,309,239,548,60,4,Player A
1542,PatternLearningPlayer,305,215,520,44,8,Player A
1543,PatternLearningPlayer,276,226,502,35,11,Player A
1544,PatternLearningPlayer,331,221,552,61,3,Player A
1545,PatternLearningPlayer,318,213,531,43,4,Player A
1546,PatternLearningPlayer,302,227,529,50,7,Player A
1547,PatternLearningPlayer,313,218,531,52,7,Player A
1548,PatternLearningPlayer,341,201,542,57,5,Player A
1549,PatternLearningPlayer,285,250,535,59,8,Player A
1550,PatternLearningPlayer,374,174,548,54,2,Player A
1551,PatternLearningPlayer,294,224,518,48,10,Player A
1552,PatternLearningPlayer,302,217,519,43,8,Player A
1553,PatternLearningPlayer,285,220,505,47,14,Player A
1554,PatternLearningPlayer,326,226,552,58,2,Player A
1555,PatternLearningPlayer,330,210,540,58,6,Player A
1556,PatternLearningPlayer,247,242,489,37,16,Player A
1557,PatternLearningPlayer,233,238,471,34,21,PatternLearningPlayer
1558,PatternLearningPlayer,296,226,522,49,9,Player A
1559,PatternLearningPlayer,306,211,517,47,10,Player A
1560,PatternLearningPlayer,296,241,537,58,7,Player A
1561,PatternLearningPlayer,324,219,543,58,5,Player A
1562,PatternLearningPlayer,298,228,526,53,9,Player A
1563,PatternLearningPlayer,277,237,514,38,8,Player A
1564,PatternLearningPlayer,321,216,537,52,5,Player A
1565,PatternLearningPlayer,312,227,539,54,5,Player A
1566,PatternLearningPlayer,285,210,495,34,13,Player A
1567,PatternLearningPlayer,326,201,527,54,9,Player A
1568,PatternLearningPlayer,289,219,508,50,14,Player A
1569,PatternLearningPlayer,250,240,490,35,15,Player A
1570,PatternLearningPlayer,354,209,563,63,0,Player A
1571,PatternLearningPlayer,268,223,491,36,15,Player A
1572,PatternLearningPlayer,305,210,515,39,8,Player A
1573,PatternLearningPlayer,298,233,531,49,6,Player A
1574,PatternLearningPlayer,316,216,532,50,6,Player A
1575,PatternLearningPlayer,349,214,563,63,0,Player A
1576,PatternLearningPlayer,281,226,507,46,13,Player A
1577,PatternLearningPlayer,359,194,553,59,2,Player A
1578,PatternLearningPlayer,314,194,508,53,15,Player A
1579,PatternLearningPlayer,302,227,529,53,8,Player A
1580,PatternLearningPlayer,345,220,565,65,0,Player A
1581,PatternLearningPlayer,294,224,518,42,8,Player A
1582,PatternLearningPlayer,323,223,546,61,5,Player A
1583,PatternLearningPlayer,301,221,522,46,8,Player A
1584,PatternLearningPlayer,299,229,528,49,7,Player A
1585,PatternLearningPlayer,326,211,537,49,4,Player A
1586,PatternLearningPlayer,334,199,533,48,5,Player A
1587,PatternLearningPlayer,333,213,546,55,3,Player A
1588,PatternLearningPlayer,342,202,544,50,2,Player A
1589,PatternLearningPlayer,342,217,559,62,1,Player A
1590,PatternLearningPlayer,326,211,537,49,4,Player A
1591,PatternLearningPlayer,318,213,531,52,7,Player A
1592,PatternLearningPlayer,262,207,469,32,21,Player A
1593,PatternLearningPlayer,325,240,565,68,1,Player A
1594,PatternLearningPlayer,262,227,489,37,16,Player A
1595,PatternLearningPlayer,337,222,559,65,2,Player A
1596,PatternLearningPlayer,284,224,508,44,12,Player A
1597,PatternLearningPlayer,307,222,529,50,7,Player A
1598,PatternLearningPlayer,305,210,515,45,10,Player A
1599,PatternLearningPlayer,278,243,521,51,10,Player A
1600,PatternLearningPlayer,272,227,499,38,13,Player A
1601,PatternLearningPlayer,308,228,536,57,7,Player A
1602,PatternLearningPlayer,334,194,528,40,4,Player A
1603,PatternLearningPlayer,349,214,563,63,0,Player A
1604,PatternLearningPlayer,286,226,512,42,10,Player A
1605,PatternLearningPlayer,303,208,511,41,10,Player A
1606,PatternLearningPlayer,353,203,556,59,1,Player A
1607,PatternLearningPlayer,340,220,560,60,0,Player A
1608,PatternLearningPlayer,347,212,559,62,1,Player A
1609,PatternLearningPlayer,337,207,544,56,4,Player A
1610,PatternLearningPlayer,340,200,540,55,5,Player A
1611,PatternLearningPlayer,319,204,523,50,9,Player A
1612,PatternLearningPlayer,311,206,517,47,10,Player A
1613,PatternLearningPlayer,342,207,549,55,2,Player A
1614,PatternLearningPlayer,328,233,561,64,1,Player A
1615,PatternLearningPlayer,334,219,553,62,3,Player A
1616,PatternLearningPlayer,338,193,531,46,5,Player A
1617,PatternLearningPlayer,308,213,521,39,6,Player A
1618,PatternLearningPlayer,319,209,528,43,5,Player A
1619,PatternLearningPlayer,348,213,561,61,0,Player A
1620,PatternLearningPlayer,328,213,541,53,4,Player A
1621,PatternLearningPlayer,253,233,486,37,17,Player A
1622,PatternLearningPlayer,331,221,552,58,2,Player A
1623,PatternLearningPlayer,267,232,499,32,11,Player A
1624,PatternLearningPlayer,310,205,515,48,11,Player A
1625,PatternLearningPlayer,307,217,524,48,8,Player A
1626,PatternLearningPlayer,316,226,542,57,5,Player A
1627,PatternLearningPlayer,339,209,548,57,3,Player A
1628,PatternLearningPlayer,281,211,492,34,14,Player A
1629,PatternLearningPlayer,283,213,496,41,15,Player A
1630,PatternLearningPlayer,299,224,523,50,9,Player A
1631,PatternLearningPlayer,295,220,515,45,10,Player A
1632,PatternLearningPlayer,284,219,503,39,12,Player A
1633,PatternLearningPlayer,348,213,561,64,1,Player A
1634,PatternLearningPlayer,318,203,521,45,8,Player A
1635,PatternLearningPlayer,325,215,540,52,4,Player A
1636,PatternLearningPlayer,341,216,557,63,2,Player A
1637,PatternLearningPlayer,334,219,553,56,1,Player A
1638,PatternLearningPlayer,293,228,521,51,10,Player A
1639,PatternLearningPlayer,340,225,565,68,1,Player A
1640,PatternLearningPlayer,332,217,549,55,2,Player A
1641,PatternLearningPlayer,297,222,519,49,10,Player A
1642,PatternLearningPlayer,277,237,514,44,10,Player A
1643,PatternLearningPlayer,260,215,475,38,21,Player A
1644,PatternLearningPlayer,327,207,534,46,4,Player A
1645,PatternLearningPlayer,335,220,555,64,3,Player A
1646,PatternLearningPlayer,341,211,552,58,2,Player A
1647,PatternLearningPlayer,300,220,520,44,8,Player A
1648,PatternLearningPlayer,293,218,511,41,10,Player A
1649,PatternLearningPlayer,335,210,545,51,2,Player A
1650,PatternLearningPlayer,360,205,565,65,0,Player A
1651,PatternLearningPlayer,279,219,498,40,14,Player A
1652,PatternLearningPlayer,330,220,550,56,2,Player A
1653,PatternLearningPlayer,296,226,522,40,6,Player A
1654,PatternLearningPlayer,350,210,560,63,1,Player A
1655,PatternLearningPlayer,294,224,518,51,11,Player A
1656,PatternLearningPlayer,327,232,559,65,2,Player A
1657,PatternLearningPlayer,345,195,540,49,3,Player A
1658,PatternLearningPlayer,300,230,530,54,8,Player A
1659,PatternLearningPlayer,348,208,556,65,3,Player A
1660,PatternLearningPlayer,336,196,532,53,7,Player A
1661,PatternLearningPlayer,352,207,559,62,1,Player A
1662,PatternLearningPlayer,329,229,558,67,3,Player A
1663,PatternLearningPlayer,320,210,530,45,5,Player A
1664,PatternLearningPlayer,351,211,562,65,1,Player A
1665,PatternLearningPlayer,241,221,462,31,23,Player A
1666,PatternLearningPlayer,287,232,519,46,9,Player A
1667,PatternLearningPlayer,351,196,547,53,2,Player A
1668,PatternLearningPlayer,334,204,538,62,8,Player A
1669,PatternLearningPlayer,295,215,510,49,13,Player A
1670,PatternLearningPlayer,314,189,503,33,10,Player A
1671,PatternLearningPlayer,265,240,505,44,13,Player A
1672,PatternLearningPlayer,298,233,531,52,7,Player A
1673,PatternLearningPlayer,316,221,537,52,5,Player A
1674,PatternLearningPlayer,333,208,541,53,4,Player A
1675,PatternLearningPlayer,272,227,499,35,12,Player A
1676,PatternLearningPlayer,333,208,541,53,4,Player A
1677,PatternLearningPlayer,325,225,550,59,3,Player A
1678,PatternLearningPlayer,295,215,510,43,11,Player A
1679,PatternLearningPlayer,304,219,523,44,7,Player A
1680,PatternLearningPlayer,322,202,524,51,9,Player A
1681,PatternLearningPlayer,330,230,560,63,1,Player A
1682,PatternLearningPlayer,314,224,538,53,5,Player A
1683,PatternLearningPlayer,312,207,519,46,9,Player A
1684,PatternLearningPlayer,350,205,555,58,1,Player A
1685,PatternLearningPlayer,282,222,504,40,12,Player A
1686,PatternLearningPlayer,330,225,555,64,3,Player A
1687,PatternLearningPlayer,311,211,522,49,9,Player A
1688,PatternLearningPlayer,272,217,489,31,14,Player A
1689,PatternLearningPlayer,314,229,543,55,4,Player A
1690,PatternLearningPlayer,287,242,529,47,6,Player A
1691,PatternLearningPlayer,329,199,528,49,7,Player A
1692,PatternLearningPlayer,331,216,547,56,3,Player A
1693,PatternLearningPlayer,284,229,513,43,10,Player A
1694,PatternLearningPlayer,316,211,527,45,6,Player A
1695,PatternLearningPlayer,281,211,492,40,16,Player A
1696,PatternLearningPlayer,274,229,503,42,13,Player A
1697,PatternLearningPlayer,313,213,526,47,7,Player A
1698,PatternLearningPlayer,338,208,546,52,2,Player A
1699,PatternLearningPlayer,320,215,535,50,5,Player A
1700,PatternLearningPlayer,329,199,528,46,6,Player A
1701,PatternLearningPlayer,353,213,566,69,1,Player A
1702,PatternLearningPlayer,300,210,510,49,13,Player A
1703,PatternLearningPlayer,358,198,556,59,1,Player A
1704,PatternLearningPlayer,315,210,525,43,6,Player A
1705,PatternLearningPlayer,330,220,550,59,3,Player A
1706,PatternLearningPlayer,326,211,537,49,4,Player A
1707,PatternLearningPlayer,326,221,547,56,3,Player A
1708,PatternLearningPlayer,274,229,503,42,13,Player A
1709,PatternLearningPlayer,299,234,533,57,8,Player A
1710,PatternLearningPlayer,274,224,498,43,15,Player A
1711,PatternLearningPlayer,354,199,553,56,1,Player A
1712,PatternLearningPlayer,321,221,542,51,3,Player A
1713,PatternLearningPlayer,315,210,525,49,8,Player A
1714,PatternLearningPlayer,323,193,516,52,12,Player A
1715,PatternLearningPlayer,285,225,510,43,11,Player A
1716,PatternLearningPlayer,312,217,529,50,7,Player A
1717,PatternLearningPlayer,324,214,538,44,2,Player A
1718,PatternLearningPlayer,328,208,536,54,6,Player A
1719,PatternLearningPlayer,270,230,500,39,13,Player A
1720,PatternLearningPlayer,277,232,509,39,10,Player A
1721,PatternLearningPlayer,326,221,547,59,4,Player A
1722,PatternLearningPlayer,339,214,553,62,3,Player A
1723,PatternLearningPlayer,336,206,542,54,4,Player A
1724,PatternLearningPlayer,283,223,506,42,12,Player A
1725,PatternLearningPlayer,314,214,528,46,6,Player A
1726,PatternLearningPlayer,298,228,526,44,6,Player A
1727,PatternLearningPlayer,360,195,555,58,1,Player A
1728,PatternLearningPlayer,343,203,546,58,4,Player A
1729,PatternLearningPlayer,285,215,500,45,15,Player A
1730,PatternLearningPlayer,292,222,514,44,10,Player A
1731,PatternLearningPlayer,296,236,532,50,6,Player A
1732,PatternLearningPlayer,317,237,554,63,3,Player A
1733,PatternLearningPlayer,300,225,525,55,10,Player A
1734,PatternLearningPlayer,291,241,532,56,8,Player A
1735,PatternLearningPlayer,297,227,524,45,7,Player A
1736,PatternLearningPlayer,286,221,507,46,13,Player A
1737,PatternLearningPlayer,328,213,541,53,4,Player A
1738,PatternLearningPlayer,308,198,506,42,12,Player A
1739,PatternLearningPlayer,299,219,518,42,8,Player A
1740,PatternLearningPlayer,297,222,519,46,9,Player A
1741,PatternLearningPlayer,322,207,529,53,8,Player A
1742,PatternLearningPlayer,319,214,533,48,5,Player A
1743,PatternLearningPlayer,255,235,490,32,14,Player A
1744,PatternLearningPlayer,287,242,529,62,11,Player A
1745,PatternLearningPlayer,269,239,508,38,10,Player A
1746,PatternLearningPlayer,329,214,543,58,5,Player A
1747,PatternLearningPlayer,323,218,541,56,5,Player A
1748,PatternLearningPlayer,331,231,562,68,2,Player A
1749,PatternLearningPlayer,306,216,522,46,8,Player A
1750,PatternLearningPlayer,297,232,529,50,7,Player A
1751,PatternLearningPlayer,333,208,541,56,5,Player A
1752,PatternLearningPlayer,298,218,516,40,8,Player A
1753,PatternLearningPlayer,298,218,516,49,11,Player A
1754,PatternLearningPlayer,295,230,525,49,8,Player A
1755,PatternLearningPlayer,345,200,545,51,2,Player A
1756,PatternLearningPlayer,347,212,559,59,0,Player A
1757,PatternLearningPlayer,322,217,539,57,6,Player A
1758,PatternLearningPlayer,275,240,515,48,11,Player A
1759,PatternLearningPlayer,331,211,542,54,4,Player A
1760,PatternLearningPlayer,340,215,555,61,2,Player A
1761,PatternLearningPlayer,306,201,507,46,13,Player A
1762,PatternLearningPlayer,315,215,530,54,8,Player A
1763,PatternLearningPlayer,328,208,536,51,5,Player A
1764,PatternLearningPlayer,305,215,520,47,9,Player A
1765,PatternLearningPlayer,333,218,551,60,3,Player A
1766,PatternLearningPlayer,294,234,528,52,8,Player A
1767,PatternLearningPlayer,303,228,531,52,7,Player A
1768,PatternLearningPlayer,248,228,476,30,18,Player A
1769,PatternLearningPlayer,287,232,519,49,10,Player A
1770,PatternLearningPlayer,260,235,495,43,16,Player A
1771,PatternLearningPlayer,331,221,552,58,2,Player A
1772,PatternLearningPlayer,272,222,494,48,18,Player A
1773,PatternLearningPlayer,354,214,568,68,0,Player A
1774,PatternLearningPlayer,258,233,491,39,16,Player A
1775,PatternLearningPlayer,359,199,558,61,1,Player A
1776,PatternLearningPlayer,328,228,556,65,3,Player A
1777,PatternLearningPlayer,288,223,511,44,11,Player A
1778,PatternLearningPlayer,293,228,521,51,10,Player A
1779,PatternLearningPlayer,290,230,520,47,9,Player A
1780,PatternLearningPlayer,330,225,555,64,3,Player A
1781,PatternLearningPlayer,306,216,522,43,7,Player A
1782,PatternLearningPlayer,290,225,515,48,11,Player A
1783,PatternLearningPlayer,311,241,552,67,5,Player A
1784,PatternLearningPlayer,265,220,485,33,16,Player A
1785,PatternLearningPlayer,320,220,540,52,4,Player A
1786,PatternLearningPlayer,294,224,518,48,10,Player A
1787,PatternLearningPlayer,326,211,537,55,6,Player A
1788,PatternLearningPlayer,320,220,540,52,4,Player A
1789,PatternLearningPlayer,327,222,549,61,4,Player A
1790,PatternLearningPlayer,339,199,538,53,5,Player A
1791,PatternLearningPlayer,317,227,544,53,3,Player A
1792,PatternLearningPlayer,333,203,536,48,4,Player A
1793,PatternLearningPlayer,359,194,553,56,1,Player A
1794,PatternLearningPlayer,302,207,509,39,10,Player A
1795,PatternLearningPlayer,303,223,526,59,11,Player A
1796,PatternLearningPlayer,324,204,528,52,8,Player A
1797,PatternLearningPlayer,347,222,569,69,0,Player A
1798,PatternLearningPlayer,351,191,542,51,3,Player A
1799,PatternLearningPlayer,334,204,538,50,4,Player A
1800,PatternLearningPlayer,297,222,519,52,11,Player A
1801,PatternLearningPlayer,307,217,524,45,7,Player A
1802,PatternLearningPlayer,306,226,532,53,7,Player A
1803,PatternLearningPlayer,263,228,491,42,17,Player A
1804,PatternLearningPlayer,276,211,487,32,15,Player A
1805,PatternLearningPlayer,269,234,503,42,13,Player A
1806,PatternLearningPlayer,338,223,561,64,1,Player A
1807,PatternLearningPlayer,314,219,533,51,6,Player A
1808,PatternLearningPlayer,362,202,564,64,0,Player A
1809,PatternLearningPlayer,283,213,496,35,13,Player A
1810,PatternLearningPlayer,325,215,540,55,5,Player A
1811,PatternLearningPlayer,352,207,559,59,0,Player A
1812,PatternLearningPlayer,291,236,527,54,9,Player A
1813,PatternLearningPlayer,340,205,545,54,3,Player A
1814,PatternLearningPlayer,326,206,532,50,6,Player A
1815,PatternLearningPlayer,331,226,557,60,1,Player A
1816,PatternLearningPlayer,313,213,526,47,7,Player A
1817,PatternLearningPlayer,347,207,554,57,1,Player A
1818,PatternLearningPlayer,272,227,499,44,15,Player A
1819,PatternLearningPlayer,289,239,528,46,6,Player A
1820,PatternLearningPlayer,356,201,557,63,2,Player A
1821,PatternLearningPlayer,268,223,491,39,16,Player A
1822,PatternLearningPlayer,298,238,536,57,7,Player A
1823,PatternLearningPlayer,317,232,549,61,4,Player A
1824,PatternLearningPlayer,246,231,477,25,16,Player A
1825,PatternLearningPlayer,347,207,554,57,1,Player A
1826,PatternLearningPlayer,337,212,549,58,3,Player A
1827,PatternLearningPlayer,308,213,521,48,9,Player A
1828,PatternLearningPlayer,263,233,496,38,14,Player A
1829,PatternLearningPlayer,320,220,540,55,5,Player A
1830,PatternLearningPlayer,297,222,519,49,10,Player A
1831,PatternLearningPlayer,323,228,551,60,3,Player A
1832,PatternLearningPlayer,297,237,534,55,7,Player A
1833,PatternLearningPlayer,353,208,561,61,0,Player A
1834,PatternLearningPlayer,302,212,514,41,9,Player A
1835,PatternLearningPlayer,326,211,537,52,5,Player A
1836,PatternLearningPlayer,308,218,526,53,9,Player A
1837,PatternLearningPlayer,317,217,534,52,6,Player A
1838,PatternLearningPlayer,291,211,502,35,11,Player A
1839,PatternLearningPlayer,273,233,506,42,12,Player A
1840,PatternLearningPlayer,306,216,522,49,9,Player A
1841,PatternLearningPlayer,267,222,489,37,16,Player A
1842,PatternLearningPlayer,336,206,542,48,2,Player A
1843,PatternLearningPlayer,358,198,556,59,1,Player A
1844,PatternLearningPlayer,324,219,543,58,5,Player A
1845,PatternLearningPlayer,312,222,534,49,5,Player A
1846,PatternLearningPlayer,315,210,525,46,7,Player A
1847,PatternLearningPlayer,278,253,531,58,9,Player A
1848,PatternLearningPlayer,284,234,518,45,9,Player A
1849,PatternLearningPlayer,318,213,531,49,6,Player A
1850,PatternLearningPlayer,327,217,544,50,2,Player A
1851,PatternLearningPlayer,312,207,519,37,6,Player A
1852,PatternLearningPlayer,312,217,529,56,9,Player A
1853,PatternLearningPlayer,307,222,529,47,6,Player A
1854,PatternLearningPlayer,259,234,493,38,15,Player A
1855,PatternLearningPlayer,307,232,539,60,7,Player A
1856,PatternLearningPlayer,347,222,569,69,0,Player A
1857,PatternLearningPlayer,332,207,539,57,6,Player A
1858,PatternLearningPlayer,312,227,539,60,7,Player A
1859,PatternLearningPlayer,334,199,533,48,5,Player A
1860,PatternLearningPlayer,305,230,535,53,6,Player A
1861,PatternLearningPlayer,273,228,501,37,12,Player A
1862,PatternLearningPlayer,260,250,510,46,12,Player A
1863,PatternLearningPlayer,319,224,543,55,4,Player A
1864,PatternLearningPlayer,333,208,541,56,5,Player A
1865,PatternLearningPlayer,335,210,545,54,3,Player A
1866,PatternLearningPlayer,344,209,553,56,1,Player A
1867,PatternLearningPlayer,314,219,533,51,6,Player A
1868,PatternLearningPlayer,339,229,568,71,1,Player A
1869,PatternLearningPlayer,330,215,545,54,3,Player A
1870,PatternLearningPlayer,313,228,541,59,6,Player A
1871,PatternLearningPlayer,334,209,543,55,4,Player A
1872,PatternLearningPlayer,339,214,553,62,3,Player A
1873,PatternLearningPlayer,278,223,501,43,14,Player A
1874,PatternLearningPlayer,316,221,537,52,5,Player A
1875,PatternLearningPlayer,354,209,563,63,0,Player A
1876,PatternLearningPlayer,306,211,517,53,12,Player A
1877,PatternLearningPlayer,324,209,533,48,5,Player A
1878,PatternLearningPlayer,325,205,530,45,5,Player A
1879,PatternLearningPlayer,328,208,536,48,4,Player A
1880,PatternLearningPlayer,342,232,574,74,0,Player A
1881,PatternLearningPlayer,301,241,542,57,5,Player A
1882,PatternLearningPlayer,312,217,529,50,7,Player A
1883,PatternLearningPlayer,342,217,559,59,0,Player A
1884,PatternLearningPlayer,347,217,564,64,0,Player A
1885,PatternLearningPlayer,284,219,503,39,12,Player A
1886,PatternLearningPlayer,326,221,547,62,5,Player A
1887,PatternLearningPlayer,293,218,511,44,11,Player A
1888,PatternLearningPlayer,343,223,566,69,1,Player A
1889,PatternLearningPlayer,308,218,526,50,8,Player A
1890,PatternLearningPlayer,300,225,525,46,7,Player A
1891,PatternLearningPlayer,304,219,523,47,8,Player A
1892,PatternLearningPlayer,334,224,558,64,2,Player A
1893,PatternLearningPlayer,330,200,530,51,7,Player A
1894,PatternLearningPlayer,345,200,545,57,4,Player A
1895,PatternLearningPlayer,282,212,494,42,16,Player A
1896,PatternLearningPlayer,327,217,544,56,4,Player A
1897,PatternLearningPlayer,306,226,532,56,8,Player A
1898,PatternLearningPlayer,307,217,524,51,9,Player A
1899,PatternLearningPlayer,345,210,555,58,1,Player A
1900,PatternLearningPlayer,287,217,504,40,12,Player A
1901,PatternLearningPlayer,336,216,552,61,3,Player A
1902,PatternLearningPlayer,276,241,517,47,10,Player A
1903,PatternLearningPlayer,332,217,549,55,2,Player A
1904,PatternLearningPlayer,291,231,522,52,10,Player A
1905,PatternLearningPlayer,319,204,523,47,8,Player A
1906,PatternLearningPlayer,323,223,546,61,5,Player A
1907,PatternLearningPlayer,325,235,560,66,2,Player A
1908,PatternLearningPlayer,274,219,493,38,15,Player A
1909,PatternLearningPlayer,329,219,548,54,2,Player A
1910,PatternLearningPlayer,307,227,534,58,8,Player A
1911,PatternLearningPlayer,317,227,544,59,5,Player A
1912,PatternLearningPlayer,273,228,501,40,13,Player A
1913,PatternLearningPlayer,322,202,524,51,9,Player A
1914,PatternLearningPlayer,305,215,520,47,9,Player A
1915,PatternLearningPlayer,336,221,557,60,1,Player A
1916,PatternLearningPlayer,297,217,514,47,11,Player A
1917,PatternLearningPlayer,273,223,496,38,14,Player A
1918,PatternLearningPlayer,309,229,538,59,7,Player A
1919,PatternLearningPlayer,347,202,549,52,1,Player A
1920,PatternLearningPlayer,354,214,568,68,0,Player A
1921,PatternLearningPlayer,330,230,560,69,3,Player A
1922,PatternLearningPlayer,317,217,534,49,5,Player A
1923,PatternLearningPlayer,319,229,548,60,4,Player A
1924,PatternLearningPlayer,304,224,528,43,5,Player A
1925,PatternLearningPlayer,327,227,554,60,2,Player A
1926,PatternLearningPlayer,340,215,555,55,0,Player A
1927,PatternLearningPlayer,304,234,538,59,7,Player A
1928,PatternLearningPlayer,318,238,556,65,3,Player A
1929,PatternLearningPlayer,294,219,513,43,10,Player A
1930,PatternLearningPlayer,315,215,530,48,6,Player A
1931,PatternLearningPlayer,310,220,530,45,5,Player A
1932,PatternLearningPlayer,302,222,524,45,7,Player A
1933,PatternLearningPlayer,289,219,508,56,16,Player A
1934,PatternLearningPlayer,335,195,530,45,5,Player A
1935,PatternLearningPlayer,264,234,498,46,16,Player A
1936,PatternLearningPlayer,307,217,524,48,8,Player A
1937,PatternLearningPlayer,291,231,522,46,8,Player A
1938,PatternLearningPlayer,296,226,522,46,8,Player A
1939,PatternLearningPlayer,340,230,570,70,0,Player A
1940,PatternLearningPlayer,354,204,558,61,1,Player A
1941,PatternLearningPlayer,334,199,533,51,6,Player A
1942,PatternLearningPlayer,347,217,564,64,0,Player A
1943,PatternLearningPlayer,325,215,540,55,5,Player A
1944,PatternLearningPlayer,327,197,524,48,8,Player A
1945,PatternLearningPlayer,332,217,549,61,4,Player A
1946,PatternLearningPlayer,334,209,543,52,3,Player A
1947,PatternLearningPlayer,319,224,543,58,5,Player A
1948,PatternLearningPlayer,292,242,534,52,6,Player A
1949,PatternLearningPlayer,221,251,472,38,22,PatternLearningPlayer
1950,PatternLearningPlayer,277,222,499,41,14,Player A
1951,PatternLearningPlayer,291,216,507,46,13,Player A
1952,PatternLearningPlayer,317,232,549,58,3,Player A
1953,PatternLearningPlayer,335,215,550,56,2,Player A
1954,PatternLearningPlayer,337,212,549,55,2,Player A
1955,PatternLearningPlayer,347,212,559,59,0,Player A
1956,PatternLearningPlayer,311,231,542,54,4,Player A
1957,PatternLearningPlayer,349,214,563,66,1,Player A
1958,PatternLearningPlayer,324,239,563,69,2,Player A
1959,PatternLearningPlayer,247,242,489,34,15,Player A
1960,PatternLearningPlayer,301,211,512,39,9,Player A
1961,PatternLearningPlayer,289,234,523,50,9,Player A
1962,PatternLearningPlayer,331,211,542,51,3,Player A
1963,PatternLearningPlayer,325,230,555,64,3,Player A
1964,PatternLearningPlayer,321,221,542,57,5,Player A
1965,PatternLearningPlayer,297,217,514,47,11,Player A
1966,PatternLearningPlayer,285,240,525,49,8,Player A
1967,PatternLearningPlayer,318,208,526,41,5,Player A
1968,PatternLearningPlayer,358,188,546,46,0,Player A
1969,PatternLearningPlayer,357,202,559,62,1,Player A
1970,PatternLearningPlayer,295,225,520,53,11,Player A
1971,PatternLearningPlayer,281,246,527,54,9,Player A
1972,PatternLearningPlayer,335,220,555,61,2,Player A
1973,PatternLearningPlayer,336,216,552,61,3,Player A
1974,PatternLearningPlayer,321,226,547,59,4,Player A
1975,PatternLearningPlayer,317,217,534,52,6,Player A
1976,PatternLearningPlayer,241,241,482,33,17,Tie
1977,PatternLearningPlayer,329,229,558,64,2,Player A
1978,PatternLearningPlayer,304,229,533,51,6,Player A
1979,PatternLearningPlayer,342,207,549,58,3,Player A
1980,PatternLearningPlayer,347,212,559,62,1,Player A
1981,PatternLearningPlayer,334,229,563,66,1,Player A
1982,PatternLearningPlayer,296,216,512,45,11,Player A
1983,PatternLearningPlayer,352,207,559,65,2,Player A
1984,PatternLearningPlayer,326,206,532,50,6,Player A
1985,PatternLearningPlayer,276,241,517,50,11,Player A
1986,PatternLearningPlayer,288,243,531,58,9,Player A
1987,PatternLearningPlayer,318,228,546,55,3,Player A
1988,PatternLearningPlayer,306,216,522,52,10,Player A
1989,PatternLearningPlayer,329,229,558,64,2,Player A
1990,PatternLearningPlayer,305,215,520,44,8,Player A
1991,PatternLearningPlayer,296,226,522,43,7,Player A
1992,PatternLearningPlayer,298,233,531,52,7,Player A
1993,PatternLearningPlayer,305,215,520,44,8,Player A
1994,PatternLearningPlayer,321,221,542,54,4,Player A
1995,PatternLearningPlayer,323,218,541,53,4,Player A
1996,PatternLearningPlayer,288,218,506,42,12,Player A
1997,PatternLearningPlayer,353,218,571,71,0,Player A
1998,PatternLearningPlayer,293,243,536,54,6,Player A
1999,PatternLearningPlayer,299,229,528,55,9,Player A
2000,PatternLearningPlayer,335,215,550,62,4,Player A
2001,PatternLearningPlayer,353,208,561,64,1,Player A
2002,PatternLearningPlayer,293,228,521,57,12,Player A
2003,PatternLearningPlayer,323,223,546,55,3,Player A
2004,PatternLearningPlayer,316,206,522,43,7,Player A
2005,PatternLearningPlayer,299,209,508,47,13,Player A
2006,PatternLearningPlayer,347,207,554,60,2,Player A
2007,PatternLearningPlayer,260,225,485,39,18,Player A
2008,PatternLearningPlayer,322,232,554,63,3,Player A
2009,PatternLearningPlayer,330,235,565,68,1,Player A
2010,PatternLearningPlayer,303,213,516,46,10,Player A
2011,PatternLearningPlayer,311,211,522,46,8,Player A
2012,PatternLearningPlayer,249,239,488,42,18,Player A
2013,PatternLearningPlayer,310,230,540,58,6,Player A
2014,PatternLearningPlayer,297,222,519,43,8,Player A
2015,PatternLearningPlayer,334,219,553,56,1,Player A
2016,PatternLearningPlayer,308,218,526,50,8,Player A
2017,PatternLearningPlayer,314,209,523,44,7,Player A
2018,PatternLearningPlayer,347,212,559,62,1,Player A
2019,PatternLearningPlayer,295,215,510,49,13,Player A
2020,PatternLearningPlayer,270,225,495,43,16,Player A
2021,PatternLearningPlayer,352,212,564,67,1,Player A
2022,PatternLearningPlayer,334,209,543,55,4,Player A
2023,PatternLearningPlayer,355,210,565,65,0,Player A
2024,PatternLearningPlayer,318,223,541,59,6,Player A
2025,PatternLearningPlayer,326,211,537,52,5,Player A
2026,PatternLearningPlayer,353,198,551,60,3,Player A
2027,PatternLearningPlayer,302,237,539,54,5,Player A
2028,PatternLearningPlayer,295,240,535,53,6,Player A
2029,PatternLearningPlayer,311,196,507,43,12,Player A
2030,PatternLearningPlayer,316,211,527,51,8,Player A
2031,PatternLearningPlayer,348,198,546,55,3,Player A
2032,PatternLearningPlayer,292,217,509,42,11,Player A
2033,PatternLearningPlayer,320,230,550,59,3,Player A
2034,PatternLearningPlayer,326,226,552,64,4,Player A
2035,PatternLearningPlayer,342,227,569,69,0,Player A
2036,PatternLearningPlayer,336,216,552,61,3,Player A
2037,PatternLearningPlayer,352,207,559,59,0,Player A
2038,PatternLearningPlayer,306,236,542,57,5,Player A
2039,PatternLearningPlayer,339,229,568,71,1,Player A
2040,PatternLearningPlayer,317,232,549,61,4,Player A
2041,PatternLearningPlayer,341,216,557,63,2,Player A
2042,PatternLearningPlayer,346,216,562,65,1,Player A
2043,PatternLearningPlayer,335,200,535,50,5,Player A
2044,PatternLearningPlayer,343,208,551,60,3,Player A
2045,PatternLearningPlayer,265,230,495,43,16,Player A
2046,PatternLearningPlayer,330,195,525,52,9,Player A
2047,PatternLearningPlayer,354,209,563,66,1,Player A
2048,PatternLearningPlayer,319,219,538,50,4,Player A
2049,PatternLearningPlayer,338,208,546,58,4,Player A
2050,PatternLearningPlayer,292,227,519,49,10,Player A
2051,PatternLearningPlayer,327,227,554,63,3,Player A
2052,PatternLearningPlayer,248,228,476,33,19,Player A
2053,PatternLearningPlayer,322,222,544,53,3,Player A
2054,PatternLearningPlayer,296,236,532,56,8,Player A
2055,PatternLearningPlayer,305,215,520,44,8,Player A
2056,PatternLearningPlayer,324,214,538,59,7,Player A
2057,PatternLearningPlayer,356,186,542,54,4,Player A
2058,PatternLearningPlayer,306,236,542,60,6,Player A
2059,PatternLearningPlayer,358,203,561,61,0,Player A
2060,PatternLearningPlayer,303,223,526,47,7,Player A
2061,PatternLearningPlayer,327,207,534,55,7,Player A
2062,PatternLearningPlayer,292,217,509,48,13,Player A
2063,PatternLearningPlayer,307,232,539,51,4,Player A
2064,PatternLearningPlayer,312,222,534,55,7,Player A
2065,PatternLearningPlayer,250,240,490,35,15,Player A
2066,PatternLearningPlayer,343,188,531,52,7,Player A
2067,PatternLearningPlayer,347,217,564,64,0,Player A
2068,PatternLearningPlayer,305,220,525,52,9,Player A
2069,PatternLearningPlayer,346,221,567,70,1,Player A
2070,PatternLearningPlayer,323,213,536,48,4,Player A
2071,PatternLearningPlayer,350,210,560,63,1,Player A
2072,PatternLearningPlayer,351,206,557,57,0,Player A
2073,PatternLearningPlayer,280,235,515,45,10,Player A
2074,PatternLearningPlayer,343,228,571,74,1,Player A
2075,PatternLearningPlayer,332,222,554,63,3,Player A
2076,PatternLearningPlayer,317,237,554,60,2,Player A
2077,PatternLearningPlayer,365,200,565,65,0,Player A
2078,PatternLearningPlayer,318,208,526,41,5,Player A
2079,PatternLearningPlayer,306,216,522,52,10,Player A
2080,PatternLearningPlayer,309,234,543,61,6,Player A
2081,PatternLearningPlayer,288,223,511,44,11,Player A
2082,PatternLearningPlayer,295,235,530,51,7,Player A
2083,PatternLearningPlayer,311,226,537,52,5,Player A
2084,PatternLearningPlayer,334,224,558,61,1,Player A
2085,PatternLearningPlayer,310,220,530,54,8,Player A
2086,PatternLearningPlayer,331,221,552,58,2,Player A
2087,PatternLearningPlayer,309,224,533,57,8,Player A
2088,PatternLearningPlayer,345,210,555,61,2,Player A
2089,PatternLearningPlayer,343,218,561,64,1,Player A
2090,PatternLearningPlayer,293,238,531,58,9,Player A
2091,PatternLearningPlayer,353,213,566,66,0,Player A
2092,PatternLearningPlayer,291,216,507,46,13,Player A
2093,PatternLearningPlayer,308,228,536,51,5,Player A
2094,PatternLearningPlayer,344,214,558,61,1,Player A
2095,PatternLearningPlayer,326,226,552,61,3,Player A
2096,PatternLearningPlayer,327,212,539,57,6,Player A
2097,PatternLearningPlayer,285,215,500,30,10,Player A
2098,PatternLearningPlayer,305,225,530,54,8,Player A
2099,PatternLearningPlayer,304,214,518,48,10,Player A
2100,PatternLearningPlayer,340,215,555,55,0,Player A
2101,PatternLearningPlayer,353,203,556,59,1,Player A
2102,PatternLearningPlayer,307,207,514,44,10,Player A
2103,PatternLearningPlayer,288,218,506,45,13,Player A
2104,PatternLearningPlayer,281,241,522,46,8,Player A
2105,PatternLearningPlayer,311,211,522,46,8,Player A
2106,PatternLearningPlayer,327,232,559,65,2,Player A
2107,PatternLearningPlayer,273,228,501,43,14,Player A
2108,PatternLearningPlayer,279,229,508,38,10,Player A
2109,PatternLearningPlayer,325,225,550,56,2,Player A
2110,PatternLearningPlayer,308,218,526,44,6,Player A
2111,PatternLearningPlayer,285,215,500,36,12,Player A
2112,PatternLearningPlayer,306,231,537,58,7,Player A
2113,PatternLearningPlayer,275,240,515,48,11,Player A
2114,PatternLearningPlayer,334,199,533,48,5,Player A
2115,PatternLearningPlayer,295,235,530,48,6,Player A
2116,PatternLearningPlayer,302,232,534,52,6,Player A
2117,PatternLearningPlayer,338,213,551,60,3,Player A
2118,PatternLearningPlayer,347,207,554,57,1,Player A
2119,PatternLearningPlayer,305,220,525,52,9,Player A
2120,PatternLearningPlayer,320,230,550,59,3,Player A
2121,PatternLearningPlayer,303,223,526,53,9,Player A
2122,PatternLearningPlayer,286,246,532,53,7,Player A
2123,PatternLearningPlayer,295,215,510,46,12,Player A
2124,PatternLearningPlayer,320,215,535,56,7,Player A
2125,PatternLearningPlayer,335,225,560,63,1,Player A
2126,PatternLearningPlayer,281,221,502,41,13,Player A
2127,PatternLearningPlayer,292,232,524,54,10,Player A
2128,PatternLearningPlayer,351,201,552,55,1,Player A
2129,PatternLearningPlayer,354,204,558,61,1,Player A
2130,PatternLearningPlayer,285,220,505,41,12,Player A
2131,PatternLearningPlayer,294,219,513,40,9,Player A
2132,PatternLearningPlayer,277,217,494,36,14,Player A
2133,PatternLearningPlayer,314,214,528,55,9,Player A
2134,PatternLearningPlayer,259,219,478,38,20,Player A
2135,PatternLearningPlayer,276,221,497,39,14,Player A
2136,PatternLearningPlayer,337,227,564,70,2,Player A
2137,PatternLearningPlayer,284,219,503,42,13,Player A
2138,PatternLearningPlayer,325,220,545,54,3,Player A
2139,PatternLearningPlayer,326,236,562,65,1,Player A
2140,PatternLearningPlayer,276,226,502,41,13,Player A
2141,PatternLearningPlayer,334,219,553,59,2,Player A
2142,PatternLearningPlayer,337,217,554,60,2,Player A
2143,PatternLearningPlayer,335,220,555,64,3,Player A
2144,PatternLearningPlayer,302,227,529,53,8,Player A
2145,PatternLearningPlayer,295,235,530,51,7,Player A
2146,PatternLearningPlayer,337,212,549,61,4,Player A
2147,PatternLearningPlayer,272,227,499,41,14,Player A
2148,PatternLearningPlayer,301,226,527,48,7,Player A
2149,PatternLearningPlayer,301,211,512,57,15,Player A
2150,PatternLearningPlayer,233,233,466,35,23,Tie
2151,PatternLearningPlayer,343,208,551,60,3,Player A
2152,PatternLearningPlayer,285,225,510,37,9,Player A
2153,PatternLearningPlayer,301,226,527,51,8,Player A
2154,PatternLearningPlayer,280,230,510,43,11,Player A
2155,PatternLearningPlayer,316,216,532,47,5,Player A
2156,PatternLearningPlayer,312,222,534,52,6,Player A
2157,PatternLearningPlayer,341,211,552,64,4,Player A
2158,PatternLearningPlayer,335,220,555,58,1,Player A
2159,PatternLearningPlayer,333,233,566,69,1,Player A
2160,PatternLearningPlayer,302,232,534,52,6,Player A
2161,PatternLearningPlayer,327,222,549,61,4,Player A
2162,PatternLearningPlayer,290,240,530,51,7,Player A
2163,PatternLearningPlayer,340,220,560,63,1,Player A
2164,PatternLearningPlayer,293,228,521,54,11,Player A
2165,PatternLearningPlayer,342,212,554,54,0,Player A
2166,PatternLearningPlayer,354,209,563,63,0,Player A
2167,PatternLearningPlayer,334,209,543,52,3,Player A
2168,PatternLearningPlayer,339,214,553,56,1,Player A
2169,PatternLearningPlayer,296,226,522,52,10,Player A
2170,PatternLearningPlayer,322,222,544,56,4,Player A
2171,PatternLearningPlayer,252,247,499,38,13,Player A
2172,PatternLearningPlayer,325,210,535,50,5,Player A
2173,PatternLearningPlayer,346,211,557,60,1,Player A
2174,PatternLearningPlayer,329,224,553,62,3,Player A
2175,PatternLearningPlayer,282,237,519,49,10,Player A
2176,PatternLearningPlayer,313,248,561,70,3,Player A
2177,PatternLearningPlayer,336,221,557,63,2,Player A
2178,PatternLearningPlayer,324,229,553,59,2,Player A
2179,PatternLearningPlayer,319,214,533,51,6,Player A
2180,PatternLearningPlayer,327,222,549,55,2,Player A
2181,PatternLearningPlayer,356,206,562,62,0,Player A
2182,PatternLearningPlayer,341,226,567,70,1,Player A
2183,PatternLearningPlayer,321,226,547,56,3,Player A
2184,PatternLearningPlayer,308,213,521,45,8,Player A
2185,PatternLearningPlayer,310,230,540,52,4,Player A
2186,PatternLearningPlayer,326,221,547,59,4,Player A
2187,PatternLearningPlayer,345,210,555,61,2,Player A
2188,PatternLearningPlayer,336,221,557,60,1,Player A
2189,PatternLearningPlayer,286,216,502,38,12,Player A
2190,PatternLearningPlayer,290,225,515,39,8,Player A
2191,PatternLearningPlayer,351,211,562,68,2,Player A
2192,PatternLearningPlayer,316,246,562,68,2,Player A
2193,PatternLearningPlayer,345,215,560,66,2,Player A
2194,PatternLearningPlayer,337,217,554,63,3,Player A
2195,PatternLearningPlayer,355,205,560,66,2,Player A
2196,PatternLearningPlayer,294,224,518,48,10,Player A
2197,PatternLearningPlayer,329,219,548,54,2,Player A
2198,PatternLearningPlayer,319,214,533,57,8,Player A
2199,PatternLearningPlayer,297,222,519,52,11,Player A
2200,PatternLearningPlayer,309,239,548,60,4,Player A
2201,PatternLearningPlayer,357,202,559,62,1,Player A
2202,PatternLearningPlayer,350,205,555,58,1,Player A
2203,PatternLearningPlayer,312,217,529,47,6,Player A
2204,PatternLearningPlayer,310,225,535,53,6,Player A
2205,PatternLearningPlayer,332,227,559,62,1,Player A
2206,PatternLearningPlayer,354,214,568,68,0,Player A
2207,PatternLearningPlayer,310,210,520,44,8,Player A
2208,PatternLearningPlayer,321,246,567,70,1,Player A
2209,PatternLearningPlayer,324,219,543,58,5,Player A
2210,PatternLearningPlayer,318,223,541,56,5,Player A
2211,PatternLearningPlayer,309,239,548,57,3,Player A
2212,PatternLearningPlayer,331,221,552,58,2,Player A
2213,PatternLearningPlayer,324,219,543,55,4,Player A
2214,PatternLearningPlayer,317,222,539,57,6,Player A
2215,PatternLearningPlayer,337,222,559,65,2,Player A
2216,PatternLearningPlayer,357,202,559,62,1,Player A
2217,PatternLearningPlayer,304,224,528,52,8,Player A
2218,PatternLearningPlayer,315,230,545,57,4,Player A
2219,PatternLearningPlayer,334,204,538,53,5,Player A
2220,PatternLearningPlayer,293,218,511,44,11,Player A
2221,PatternLearningPlayer,346,216,562,65,1,Player A
2222,PatternLearningPlayer,316,216,532,53,7,Player A
2223,PatternLearningPlayer,249,224,473,24,17,Player A
2224,PatternLearningPlayer,348,218,566,69,1,Player A
2225,PatternLearningPlayer,308,228,536,51,5,Player A
2226,PatternLearningPlayer,313,228,541,59,6,Player A
2227,PatternLearningPlayer,350,205,555,64,3,Player A
2228,PatternLearningPlayer,321,231,552,61,3,Player A
2229,PatternLearningPlayer,327,217,544,53,3,Player A
2230,PatternLearningPlayer,341,216,557,60,1,Player A
2231,PatternLearningPlayer,340,210,550,59,3,Player A
2232,PatternLearningPlayer,338,208,546,52,2,Player A
2233,PatternLearningPlayer,328,228,556,59,1,Player A
2234,PatternLearningPlayer,321,226,547,56,3,Player A
2235,PatternLearningPlayer,301,236,537,55,6,Player A
2236,PatternLearningPlayer,332,212,544,50,2,Player A
2237,PatternLearningPlayer,352,212,564,64,0,Player A
2238,PatternLearningPlayer,320,215,535,53,6,Player A
2239,PatternLearningPlayer,295,230,525,52,9,Player A
2240,PatternLearningPlayer,278,228,506,39,11,Player A
2241,PatternLearningPlayer,351,216,567,67,0,Player A
2242,PatternLearningPlayer,341,216,557,60,1,Player A
2243,PatternLearningPlayer,357,207,564,64,0,Player A
2244,PatternLearningPlayer,299,229,528,52,8,Player A
2245,PatternLearningPlayer,333,228,561,67,2,Player A
2246,PatternLearningPlayer,301,221,522,46,8,Player A
2247,PatternLearningPlayer,337,227,564,67,1,Player A
2248,PatternLearningPlayer,285,230,515,45,10,Player A
2249,PatternLearningPlayer,301,246,547,62,5,Player A
2250,PatternLearningPlayer,307,232,539,54,5,Player A
2251,PatternLearningPlayer,322,237,559,68,3,Player A
2252,PatternLearningPlayer,313,228,541,56,5,Player A
2253,PatternLearningPlayer,343,213,556,56,0,Player A
2254,PatternLearningPlayer,329,199,528,46,6,Player A
2255,PatternLearningPlayer,351,206,557,60,1,Player A
2256,PatternLearningPlayer,342,217,559,62,1,Player A
2257,PatternLearningPlayer,309,229,538,53,5,Player A
2258,PatternLearningPlayer,357,207,564,64,0,Player A
2259,PatternLearningPlayer,287,232,519,43,8,Player A
2260,PatternLearningPlayer,343,228,571,74,1,Player A
2261,PatternLearningPlayer,324,214,538,50,4,Player A
2262,PatternLearningPlayer,292,242,534,58,8,Player A
2263,PatternLearningPlayer,343,213,556,59,1,Player A
2264,PatternLearningPlayer,323,228,551,60,3,Player A
2265,PatternLearningPlayer,286,236,522,49,9,Player A
2266,PatternLearningPlayer,294,214,508,38,10,Player A
2267,PatternLearningPlayer,342,197,539,54,5,Player A
2268,PatternLearningPlayer,299,224,523,53,10,Player A
2269,PatternLearningPlayer,317,222,539,48,3,Player A
2270,PatternLearningPlayer,328,218,546,58,4,Player A
2271,PatternLearningPlayer,313,218,531,58,9,Player A
2272,PatternLearningPlayer,339,229,568,68,0,Player A
2273,PatternLearningPlayer,229,234,463,32,23,PatternLearningPlayer
2274,PatternLearningPlayer,330,205,535,50,5,Player A
2275,PatternLearningPlayer,335,200,535,53,6,Player A
2276,PatternLearningPlayer,326,221,547,56,3,Player A
2277,PatternLearningPlayer,315,215,530,48,6,Player A
2278,PatternLearningPlayer,312,232,544,65,7,Player A
2279,PatternLearningPlayer,332,217,549,58,3,Player A
2280,PatternLearningPlayer,309,239,548,60,4,Player A
2281,PatternLearningPlayer,272,237,509,48,13,Player A
2282,PatternLearningPlayer,279,239,518,48,10,Player A
2283,PatternLearningPlayer,319,229,548,63,5,Player A
2284,PatternLearningPlayer,307,232,539,57,6,Player A
2285,PatternLearningPlayer,344,224,568,71,1,Player A
2286,PatternLearningPlayer,341,221,562,62,0,Player A
2287,PatternLearningPlayer,331,221,552,61,3,Player A
2288,PatternLearningPlayer,330,205,535,53,6,Player A
2289,PatternLearningPlayer,343,218,561,61,0,Player A
2290,PatternLearningPlayer,321,231,552,67,5,Player A
2291,PatternLearningPlayer,308,223,531,49,6,Player A
2292,PatternLearningPlayer,308,233,541,59,6,Player A
2293,PatternLearningPlayer,301,216,517,44,9,Player A
2294,PatternLearningPlayer,328,238,566,66,0,Player A
2295,PatternLearningPlayer,324,204,528,58,10,Player A
2296,PatternLearningPlayer,304,239,543,58,5,Player A
2297,PatternLearningPlayer,324,234,558,64,2,Player A
2298,PatternLearningPlayer,327,227,554,60,2,Player A
2299,PatternLearningPlayer,339,209,548,60,4,Player A
2300,PatternLearningPlayer,321,216,537,46,3,Player A
2301,PatternLearningPlayer,297,232,529,56,9,Player A
2302,PatternLearningPlayer,323,233,556,62,2,Player A
2303,PatternLearningPlayer,275,225,500,39,13,Player A
2304,PatternLearningPlayer,332,212,544,56,4,Player A
2305,PatternLearningPlayer,338,213,551,60,3,Player A
2306,PatternLearningPlayer,274,244,518,54,12,Player A
2307,PatternLearningPlayer,322,222,544,56,4,Player A
2308,PatternLearningPlayer,342,222,564,67,1,Player A
2309,PatternLearningPlayer,323,233,556,59,1,Player A
2310,PatternLearningPlayer,288,218,506,45,13,Player A
2311,PatternLearningPlayer,303,233,536,54,6,Player A
2312,PatternLearningPlayer,315,225,540,55,5,Player A
2313,PatternLearningPlayer,313,213,526,53,9,Player A
2314,PatternLearningPlayer,345,210,555,61,2,Player A
2315,PatternLearningPlayer,327,217,544,53,3,Player A
2316,PatternLearningPlayer,353,213,566,66,0,Player A
2317,PatternLearningPlayer,335,225,560,63,1,Player A
2318,PatternLearningPlayer,342,217,559,62,1,Player A
2319,PatternLearningPlayer,328,223,551,60,3,Player A
2320,PatternLearningPlayer,341,226,567,70,1,Player A
2321,PatternLearningPlayer,347,192,539,51,4,Player A
2322,PatternLearningPlayer,311,236,547,62,5,Player A
2323,PatternLearningPlayer,339,219,558,64,2,Player A
2324,PatternLearningPlayer,340,210,550,56,2,Player A
2325,PatternLearningPlayer,287,237,524,48,8,Player A
2326,PatternLearningPlayer,301,221,522,52,10,Player A
2327,PatternLearningPlayer,278,238,516,52,12,Player A
2328,PatternLearningPlayer,306,216,522,49,9,Player A
2329,PatternLearningPlayer,347,217,564,64,0,Player A
2330,PatternLearningPlayer,328,233,561,70,3,Player A
2331,PatternLearningPlayer,349,199,548,60,4,Player A
2332,PatternLearningPlayer,286,231,517,56,13,Player A
2333,PatternLearningPlayer,333,198,531,49,6,Player A
2334,PatternLearningPlayer,282,232,514,50,12,Player A
2335,PatternLearningPlayer,306,216,522,40,6,Player A
2336,PatternLearningPlayer,312,242,554,66,4,Player A
2337,PatternLearningPlayer,311,226,537,52,5,Player A
2338,PatternLearningPlayer,303,223,526,47,7,Player A
2339,PatternLearningPlayer,309,224,533,54,7,Player A
2340,PatternLearningPlayer,271,226,497,42,15,Player A
2341,PatternLearningPlayer,292,227,519,46,9,Player A
2342,PatternLearningPlayer,258,253,511,50,13,Player A
2343,PatternLearningPlayer,335,220,555,64,3,Player A
2344,PatternLearningPlayer,324,224,548,63,5,Player A
2345,PatternLearningPlayer,333,218,551,60,3,Player A
2346,PatternLearningPlayer,333,208,541,56,5,Player A
2347,PatternLearningPlayer,328,208,536,48,4,Player A
2348,PatternLearningPlayer,269,244,513,46,11,Player A
2349,PatternLearningPlayer,340,225,565,65,0,Player A
2350,PatternLearningPlayer,293,223,516,43,9,Player A
2351,PatternLearningPlayer,288,223,511,44,11,Player A
2352,PatternLearningPlayer,320,220,540,52,4,Player A
2353,PatternLearningPlayer,308,243,551,66,5,Player A
2354,PatternLearningPlayer,322,237,559,65,2,Player A
2355,PatternLearningPlayer,344,214,558,64,2,Player A
2356,PatternLearningPlayer,291,236,527,51,8,Player A
2357,PatternLearningPlayer,343,218,561,67,2,Player A
2358,PatternLearningPlayer,336,216,552,55,1,Player A
2359,PatternLearningPlayer,286,216,502,41,13,Player A
2360,PatternLearningPlayer,311,216,527,48,7,Player A
2361,PatternLearningPlayer,329,214,543,58,5,Player A
2362,PatternLearningPlayer,311,231,542,60,6,Player A
2363,PatternLearningPlayer,348,218,566,69,1,Player A
2364,PatternLearningPlayer,306,236,542,51,3,Player A
2365,PatternLearningPlayer,299,204,503,36,11,Player A
2366,PatternLearningPlayer,331,216,547,56,3,Player A
2367,PatternLearningPlayer,252,242,494,36,14,Player A
2368,PatternLearningPlayer,319,209,528,55,9,Player A
2369,PatternLearningPlayer,303,248,551,63,4,Player A
2370,PatternLearningPlayer,290,225,515,57,14,Player A
2371,PatternLearningPlayer,334,234,568,68,0,Player A
2372,PatternLearningPlayer,353,203,556,56,0,Player A
2373,PatternLearningPlayer,353,208,561,61,0,Player A
2374,PatternLearningPlayer,314,219,533,54,7,Player A
2375,PatternLearningPlayer,335,215,550,59,3,Player A
2376,PatternLearningPlayer,313,233,546,61,5,Player A
2377,PatternLearningPlayer,289,244,533,57,8,Player A
2378,PatternLearningPlayer,348,218,566,69,1,Player A
2379,PatternLearningPlayer,339,219,558,67,3,Player A
2380,PatternLearningPlayer,341,206,547,56,3,Player A
2381,PatternLearningPlayer,318,208,526,41,5,Player A
2382,PatternLearningPlayer,333,223,556,65,3,Player A
2383,PatternLearningPlayer,333,208,541,44,1,Player A
2384,PatternLearningPlayer,334,214,548,54,2,Player A
2385,PatternLearningPlayer,337,237,574,74,0,Player A
2386,PatternLearningPlayer,327,207,534,55,7,Player A
2387,PatternLearningPlayer,330,215,545,63,6,Player A
2388,PatternLearningPlayer,290,220,510,43,11,Player A
2389,PatternLearningPlayer,324,224,548,54,2,Player A
2390,PatternLearningPlayer,296,241,537,58,7,Player A
2391,PatternLearningPlayer,302,222,524,45,7,Player A
2392,PatternLearningPlayer,322,222,544,53,3,Player A
2393,PatternLearningPlayer,323,223,546,61,5,Player A
2394,PatternLearningPlayer,305,245,550,59,3,Player A
2395,PatternLearningPlayer,326,221,547,59,4,Player A
2396,PatternLearningPlayer,326,211,537,52,5,Player A
2397,PatternLearningPlayer,332,222,554,60,2,Player A
2398,PatternLearningPlayer,309,219,528,49,7,Player A
2399,PatternLearningPlayer,323,228,551,63,4,Player A
2400,PatternLearningPlayer,318,218,536,51,5,Player A
2401,PatternLearningPlayer,331,231,562,68,2,Player A
2402,PatternLearningPlayer,328,223,551,63,4,Player A
2403,PatternLearningPlayer,304,219,523,47,8,Player A
2404,PatternLearningPlayer,336,216,552,61,3,Player A
2405,PatternLearningPlayer,309,229,538,56,6,Player A
2406,PatternLearningPlayer,344,209,553,59,2,Player A
2407,PatternLearningPlayer,295,245,540,55,5,Player A
2408,PatternLearningPlayer,352,212,564,64,0,Player A
2409,PatternLearningPlayer,310,235,545,63,6,Player A
2410,PatternLearningPlayer,346,211,557,60,1,Player A
2411,PatternLearningPlayer,332,237,569,72,1,Player A
2412,PatternLearningPlayer,284,239,523,47,8,Player A
2413,PatternLearningPlayer,347,217,564,64,0,Player A
2414,PatternLearningPlayer,306,231,537,52,5,Player A
2415,PatternLearningPlayer,292,252,544,62,6,Player A
2416,PatternLearningPlayer,342,227,569,69,0,Player A
2417,PatternLearningPlayer,327,232,559,62,1,Player A
2418,PatternLearningPlayer,317,227,544,65,7,Player A
2419,PatternLearningPlayer,311,221,532,53,7,Player A
2420,PatternLearningPlayer,313,228,541,50,3,Player A
2421,PatternLearningPlayer,290,225,515,48,11,Player A
2422,PatternLearningPlayer,320,225,545,57,4,Player A
2423,PatternLearningPlayer,299,219,518,42,8,Player A
2424,PatternLearningPlayer,364,194,558,61,1,Player A
2425,PatternLearningPlayer,299,234,533,51,6,Player A
2426,PatternLearningPlayer,329,234,563,69,2,Player A
2427,PatternLearningPlayer,301,216,517,50,11,Player A
2428,PatternLearningPlayer,275,225,500,45,15,Player A
2429,PatternLearningPlayer,316,231,547,62,5,Player A
2430,PatternLearningPlayer,340,230,570,70,0,Player A
2431,PatternLearningPlayer,295,225,520,47,9,Player A
2432,PatternLearningPlayer,344,224,568,68,0,Player A
2433,PatternLearningPlayer,343,223,566,69,1,Player A
2434,PatternLearningPlayer,298,233,531,52,7,Player A
2435,PatternLearningPlayer,322,207,529,47,6,Player A
2436,PatternLearningPlayer,359,204,563,63,0,Player A
2437,PatternLearningPlayer,306,221,527,51,8,Player A
2438,PatternLearningPlayer,302,217,519,49,10,Player A
2439,PatternLearningPlayer,350,205,555,61,2,Player A
2440,PatternLearningPlayer,322,237,559,68,3,Player A
2441,PatternLearningPlayer,308,243,551,63,4,Player A
2442,PatternLearningPlayer,339,224,563,72,3,Player A
2443,PatternLearningPlayer,326,226,552,58,2,Player A
2444,PatternLearningPlayer,306,231,537,55,6,Player A
2445,PatternLearningPlayer,303,228,531,58,9,Player A
2446,PatternLearningPlayer,276,231,507,43,12,Player A
2447,PatternLearningPlayer,360,200,560,60,0,Player A
2448,PatternLearningPlayer,309,224,533,51,6,Player A
2449,PatternLearningPlayer,342,217,559,59,0,Player A
2450,PatternLearningPlayer,306,211,517,50,11,Player A
2451,PatternLearningPlayer,356,206,562,65,1,Player A
2452,PatternLearningPlayer,342,217,559,62,1,Player A
2453,PatternLearningPlayer,330,230,560,63,1,Player A
2454,PatternLearningPlayer,322,237,559,68,3,Player A
2455,PatternLearningPlayer,337,237,574,74,0,Player A
2456,PatternLearningPlayer,265,240,505,41,12,Player A
2457,PatternLearningPlayer,292,237,529,53,8,Player A
2458,PatternLearningPlayer,300,230,530,51,7,Player A
2459,PatternLearningPlayer,276,241,517,44,9,Player A
2460,PatternLearningPlayer,278,223,501,43,14,Player A
2461,PatternLearningPlayer,325,220,545,57,4,Player A
2462,PatternLearningPlayer,336,211,547,56,3,Player A
2463,PatternLearningPlayer,331,236,567,67,0,Player A
2464,PatternLearningPlayer,321,221,542,57,5,Player A
2465,PatternLearningPlayer,326,226,552,61,3,Player A
2466,PatternLearningPlayer,342,212,554,57,1,Player A
2467,PatternLearningPlayer,320,230,550,59,3,Player A
2468,PatternLearningPlayer,350,215,565,65,0,Player A
2469,PatternLearningPlayer,307,222,529,53,8,Player A
2470,PatternLearningPlayer,329,234,563,72,3,Player A
2471,PatternLearningPlayer,347,197,544,53,3,Player A
2472,PatternLearningPlayer,301,246,547,56,3,Player A
2473,PatternLearningPlayer,338,213,551,57,2,Player A
2474,PatternLearningPlayer,313,213,526,50,8,Player A
2475,PatternLearningPlayer,346,221,567,70,1,Player A
2476,PatternLearningPlayer,323,233,556,62,2,Player A
2477,PatternLearningPlayer,318,233,551,57,2,Player A
2478,PatternLearningPlayer,320,220,540,55,5,Player A
2479,PatternLearningPlayer,315,240,555,61,2,Player A
2480,PatternLearningPlayer,297,237,534,46,4,Player A
2481,PatternLearningPlayer,320,240,560,66,2,Player A
2482,PatternLearningPlayer,308,228,536,54,6,Player A
2483,PatternLearningPlayer,319,229,548,57,3,Player A
2484,PatternLearningPlayer,312,242,554,63,3,Player A
2485,PatternLearningPlayer,302,252,554,69,5,Player A
2486,PatternLearningPlayer,324,224,548,66,6,Player A
2487,PatternLearningPlayer,299,214,513,46,11,Player A
2488,PatternLearningPlayer,321,206,527,48,7,Player A
2489,PatternLearningPlayer,337,217,554,66,4,Player A
2490,PatternLearningPlayer,309,224,533,57,8,Player A
2491,PatternLearningPlayer,324,229,553,62,3,Player A
2492,PatternLearningPlayer,300,215,515,51,12,Player A
2493,PatternLearningPlayer,332,207,539,51,4,Player A
2494,PatternLearningPlayer,257,252,509,45,12,Player A
2495,PatternLearningPlayer,347,222,569,69,0,Player A
2496,PatternLearningPlayer,330,235,565,74,3,Player A
2497,PatternLearningPlayer,273,233,506,48,14,Player A
2498,PatternLearningPlayer,326,236,562,68,2,Player A
2499,PatternLearningPlayer,312,227,539,57,6,Player A
2500,PatternLearningPlayer,326,226,552,58,2,Player A
2501,PatternLearningPlayer,344,219,563,66,1,Player A
2502,PatternLearningPlayer,310,220,530,54,8,Player A
2503,PatternLearningPlayer,328,223,551,60,3,Player A
2504,PatternLearningPlayer,339,229,568,68,0,Player A
2505,PatternLearningPlayer,338,218,556,62,2,Player A
2506,PatternLearningPlayer,334,204,538,53,5,Player A
2507,PatternLearningPlayer,269,239,508,44,12,Player A
2508,PatternLearningPlayer,327,222,549,58,3,Player A
2509,PatternLearningPlayer,356,211,567,67,0,Player A
2510,PatternLearningPlayer,326,226,552,64,4,Player A
2511,PatternLearningPlayer,286,241,527,48,7,Player A
2512,PatternLearningPlayer,345,220,565,68,1,Player A
2513,PatternLearningPlayer,337,222,559,62,1,Player A
2514,PatternLearningPlayer,342,227,569,72,1,Player A
2515,PatternLearningPlayer,336,196,532,50,6,Player A
2516,PatternLearningPlayer,340,220,560,66,2,Player A
2517,PatternLearningPlayer,337,227,564,67,1,Player A
2518,PatternLearningPlayer,295,220,515,51,12,Player A
2519,PatternLearningPlayer,262,217,479,33,18,Player A
2520,PatternLearningPlayer,328,213,541,53,4,Player A
2521,PatternLearningPlayer,345,215,560,60,0,Player A
2522,PatternLearningPlayer,318,218,536,54,6,Player A
2523,PatternLearningPlayer,319,219,538,59,7,Player A
2524,PatternLearningPlayer,325,220,545,57,4,Player A
2525,PatternLearningPlayer,311,206,517,50,11,Player A
2526,PatternLearningPlayer,302,217,519,46,9,Player A
2527,PatternLearningPlayer,283,228,511,44,11,Player A
2528,PatternLearningPlayer,310,220,530,48,6,Player A
2529,PatternLearningPlayer,347,207,554,60,2,Player A
2530,PatternLearningPlayer,301,236,537,55,6,Player A
2531,PatternLearningPlayer,334,209,543,58,5,Player A
2532,PatternLearningPlayer,282,222,504,43,13,Player A
2533,PatternLearningPlayer,323,228,551,63,4,Player A
2534,PatternLearningPlayer,325,230,555,61,2,Player A
2535,PatternLearningPlayer,328,228,556,62,2,Player A
2536,PatternLearningPlayer,291,236,527,57,10,Player A
2537,PatternLearningPlayer,327,232,559,68,3,Player A
2538,PatternLearningPlayer,354,199,553,56,1,Player A
2539,PatternLearningPlayer,350,210,560,63,1,Player A
2540,PatternLearningPlayer,303,233,536,57,7,Player A
2541,PatternLearningPlayer,297,242,539,60,7,Player A
2542,PatternLearningPlayer,295,225,520,53,11,Player A
2543,PatternLearningPlayer,291,256,547,62,5,Player A
2544,PatternLearningPlayer,339,229,568,68,0,Player A
2545,PatternLearningPlayer,323,218,541,62,7,Player A
2546,PatternLearningPlayer,303,218,521,48,9,Player A
2547,PatternLearningPlayer,348,223,571,71,0,Player A
2548,PatternLearningPlayer,334,234,568,71,1,Player A
2549,PatternLearningPlayer,322,202,524,54,10,Player A
2550,PatternLearningPlayer,328,228,556,62,2,Player A
2551,PatternLearningPlayer,341,211,552,58,2,Player A
2552,PatternLearningPlayer,317,222,539,54,5,Player A
2553,PatternLearningPlayer,331,236,567,67,0,Player A
2554,PatternLearningPlayer,345,215,560,63,1,Player A
2555,PatternLearningPlayer,351,216,567,67,0,Player A
2556,PatternLearningPlayer,269,234,503,36,11,Player A
2557,PatternLearningPlayer,309,219,528,49,7,Player A
2558,PatternLearningPlayer,330,225,555,61,2,Player A
2559,PatternLearningPlayer,298,233,531,52,7,Player A
2560,PatternLearningPlayer,326,231,557,63,2,Player A
2561,PatternLearningPlayer,296,231,527,51,8,Player A
2562,PatternLearningPlayer,343,218,561,64,1,Player A
2563,PatternLearningPlayer,313,228,541,59,6,Player A
2564,PatternLearningPlayer,344,214,558,64,2,Player A
2565,PatternLearningPlayer,333,218,551,60,3,Player A
2566,PatternLearningPlayer,307,237,544,56,4,Player A
2567,PatternLearningPlayer,318,228,546,52,2,Player A
2568,PatternLearningPlayer,341,221,562,65,1,Player A
2569,PatternLearningPlayer,335,220,555,58,1,Player A
2570,PatternLearningPlayer,314,229,543,58,5,Player A
2571,PatternLearningPlayer,311,231,542,57,5,Player A
2572,PatternLearningPlayer,329,204,533,54,7,Player A
2573,PatternLearningPlayer,309,224,533,60,9,Player A
2574,PatternLearningPlayer,311,226,537,52,5,Player A
2575,PatternLearningPlayer,310,220,530,45,5,Player A
2576,PatternLearningPlayer,346,226,572,72,0,Player A
2577,PatternLearningPlayer,345,215,560,63,1,Player A
2578,PatternLearningPlayer,328,233,561,64,1,Player A
2579,PatternLearningPlayer,263,243,506,48,14,Player A
2580,PatternLearningPlayer,338,223,561,64,1,Player A
2581,PatternLearningPlayer,318,243,561,67,2,Player A
2582,PatternLearningPlayer,324,224,548,57,3,Player A
2583,PatternLearningPlayer,332,202,534,49,5,Player A
2584,PatternLearningPlayer,357,207,564,64,0,Player A
2585,PatternLearningPlayer,311,231,542,54,4,Player A
2586,PatternLearningPlayer,317,227,544,56,4,Player A
2587,PatternLearningPlayer,307,232,539,54,5,Player A
2588,PatternLearningPlayer,330,215,545,54,3,Player A
2589,PatternLearningPlayer,329,204,533,57,8,Player A
2590,PatternLearningPlayer,344,214,558,61,1,Player A
2591,PatternLearningPlayer,330,205,535,56,7,Player A
2592,PatternLearningPlayer,316,221,537,49,4,Player A
2593,PatternLearningPlayer,319,229,548,57,3,Player A
2594,PatternLearningPlayer,321,246,567,73,2,Player A
2595,PatternLearningPlayer,281,236,517,50,11,Player A
2596,PatternLearningPlayer,320,230,550,59,3,Player A
2597,PatternLearningPlayer,332,232,564,64,0,Player A
2598,PatternLearningPlayer,336,216,552,58,2,Player A
2599,PatternLearningPlayer,318,238,556,65,3,Player A
2600,PatternLearningPlayer,349,219,568,68,0,Player A
2601,PatternLearningPlayer,322,227,549,64,5,Player A
2602,PatternLearningPlayer,332,222,554,60,2,Player A
2603,PatternLearningPlayer,350,190,540,49,3,Player A
2604,PatternLearningPlayer,302,217,519,52,11,Player A
2605,PatternLearningPlayer,337,227,564,67,1,Player A
2606,PatternLearningPlayer,324,224,548,57,3,Player A
2607,PatternLearningPlayer,353,208,561,61,0,Player A
2608,PatternLearningPlayer,351,211,562,65,1,Player A
2609,PatternLearningPlayer,346,226,572,72,0,Player A
2610,PatternLearningPlayer,322,232,554,63,3,Player A
2611,PatternLearningPlayer,329,214,543,55,4,Player A
2612,PatternLearningPlayer,319,229,548,57,3,Player A
2613,PatternLearningPlayer,338,238,576,76,0,Player A
2614,PatternLearningPlayer,351,211,562,65,1,Player A
2615,PatternLearningPlayer,343,213,556,65,3,Player A
2616,PatternLearningPlayer,327,217,544,62,6,Player A
2617,PatternLearningPlayer,280,250,530,57,9,Player A
2618,PatternLearningPlayer,327,227,554,66,4,Player A
2619,PatternLearningPlayer,336,216,552,61,3,Player A
2620,PatternLearningPlayer,287,217,504,49,15,Player A
2621,PatternLearningPlayer,313,223,536,57,7,Player A
2622,PatternLearningPlayer,343,203,546,58,4,Player A
2623,PatternLearningPlayer,341,226,567,67,0,Player A
2624,PatternLearningPlayer,302,237,539,57,6,Player A
2625,PatternLearningPlayer,301,236,537,61,8,Player A
2626,PatternLearningPlayer,327,227,554,60,2,Player A
2627,PatternLearningPlayer,338,223,561,64,1,Player A
2628,PatternLearningPlayer,319,234,553,65,4,Player A
2629,PatternLearningPlayer,296,231,527,51,8,Player A
2630,PatternLearningPlayer,335,225,560,66,2,Player A
2631,PatternLearningPlayer,342,217,559,62,1,Player A
2632,PatternLearningPlayer,339,224,563,66,1,Player A
2633,PatternLearningPlayer,339,214,553,59,2,Player A
2634,PatternLearningPlayer,284,219,503,45,14,Player A
2635,PatternLearningPlayer,321,211,532,53,7,Player A
2636,PatternLearningPlayer,342,222,564,70,2,Player A
2637,PatternLearningPlayer,342,202,544,56,4,Player A
2638,PatternLearningPlayer,363,193,556,59,1,Player A
2639,PatternLearningPlayer,321,226,547,56,3,Player A
2640,PatternLearningPlayer,338,233,571,71,0,Player A
2641,PatternLearningPlayer,329,229,558,64,2,Player A
2642,PatternLearningPlayer,319,219,538,53,5,Player A
2643,PatternLearningPlayer,318,238,556,65,3,Player A
2644,PatternLearningPlayer,367,192,559,62,1,Player A
2645,PatternLearningPlayer,332,212,544,56,4,Player A
2646,PatternLearningPlayer,322,242,564,67,1,Player A
2647,PatternLearningPlayer,294,249,543,58,5,Player A
2648,PatternLearningPlayer,353,203,556,59,1,Player A
2649,PatternLearningPlayer,331,226,557,66,3,Player A
2650,PatternLearningPlayer,312,237,549,55,2,Player A
2651,PatternLearningPlayer,356,211,567,67,0,Player A
2652,PatternLearningPlayer,324,224,548,63,5,Player A
2653,PatternLearningPlayer,316,231,547,59,4,Player A
2654,PatternLearningPlayer,311,221,532,56,8,Player A
2655,PatternLearningPlayer,355,210,565,65,0,Player A
2656,PatternLearningPlayer,321,226,547,59,4,Player A
2657,PatternLearningPlayer,348,218,566,66,0,Player A
2658,PatternLearningPlayer,338,228,566,69,1,Player A
2659,PatternLearningPlayer,335,225,560,63,1,Player A
2660,PatternLearningPlayer,326,226,552,61,3,Player A
2661,PatternLearningPlayer,342,217,559,59,0,Player A
2662,PatternLearningPlayer,295,235,530,54,8,Player A
2663,PatternLearningPlayer,321,241,562,65,1,Player A
2664,PatternLearningPlayer,199,249,448,23,25,PatternLearningPlayer
2665,PatternLearningPlayer,322,232,554,66,4,Player A
2666,PatternLearningPlayer,318,233,551,60,3,Player A
2667,PatternLearningPlayer,311,231,542,60,6,Player A
2668,PatternLearningPlayer,315,235,550,65,5,Player A
2669,PatternLearningPlayer,338,223,561,64,1,Player A
2670,PatternLearningPlayer,312,227,539,66,9,Player A
2671,PatternLearningPlayer,343,208,551,60,3,Player A
2672,PatternLearningPlayer,355,205,560,63,1,Player A
2673,PatternLearningPlayer,324,224,548,57,3,Player A
2674,PatternLearningPlayer,327,227,554,60,2,Player A
2675,PatternLearningPlayer,286,236,522,49,9,Player A
2676,PatternLearningPlayer,349,219,568,68,0,Player A
2677,PatternLearningPlayer,330,240,570,73,1,Player A
2678,PatternLearningPlayer,361,201,562,65,1,Player A
2679,PatternLearningPlayer,309,229,538,53,5,Player A
2680,PatternLearningPlayer,278,243,521,51,10,Player A
2681,PatternLearningPlayer,331,231,562,71,3,Player A
2682,PatternLearningPlayer,349,214,563,66,1,Player A
2683,PatternLearningPlayer,322,202,524,45,7,Player A
2684,PatternLearningPlayer,316,226,542,57,5,Player A
2685,PatternLearningPlayer,311,231,542,54,4,Player A
2686,PatternLearningPlayer,294,224,518,39,7,Player A
2687,PatternLearningPlayer,336,226,562,65,1,Player A
2688,PatternLearningPlayer,306,206,512,48,12,Player A
2689,PatternLearningPlayer,336,241,577,77,0,Player A
2690,PatternLearningPlayer,321,211,532,56,8,Player A
2691,PatternLearningPlayer,345,205,550,59,3,Player A
2692,PatternLearningPlayer,293,228,521,51,10,Player A
2693,PatternLearningPlayer,338,218,556,65,3,Player A
2694,PatternLearningPlayer,337,217,554,60,2,Player A
2695,PatternLearningPlayer,333,223,556,62,2,Player A
2696,PatternLearningPlayer,327,227,554,63,3,Player A
2697,PatternLearningPlayer,319,229,548,63,5,Player A
2698,PatternLearningPlayer,329,209,538,50,4,Player A
2699,PatternLearningPlayer,326,216,542,54,4,Player A
2700,PatternLearningPlayer,306,236,542,63,7,Player A
2701,PatternLearningPlayer,276,231,507,46,13,Player A
2702,PatternLearningPlayer,345,195,540,49,3,Player A
2703,PatternLearningPlayer,352,207,559,62,1,Player A
2704,PatternLearningPlayer,352,212,564,67,1,Player A
2705,PatternLearningPlayer,337,222,559,65,2,Player A
2706,PatternLearningPlayer,312,237,549,55,2,Player A
2707,PatternLearningPlayer,299,224,523,56,11,Player A
2708,PatternLearningPlayer,334,239,573,73,0,Player A
2709,PatternLearningPlayer,333,218,551,57,2,Player A
2710,PatternLearningPlayer,350,210,560,60,0,Player A
2711,PatternLearningPlayer,337,197,534,52,6,Player A
2712,PatternLearningPlayer,341,216,557,63,2,Player A
2713,PatternLearningPlayer,334,219,553,62,3,Player A
2714,PatternLearningPlayer,332,222,554,57,1,Player A
2715,PatternLearningPlayer,344,209,553,59,2,Player A
2716,PatternLearningPlayer,325,215,540,58,6,Player A
2717,PatternLearningPlayer,297,222,519,46,9,Player A
2718,PatternLearningPlayer,348,218,566,66,0,Player A
2719,PatternLearningPlayer,320,240,560,63,1,Player A
2720,PatternLearningPlayer,321,226,547,53,2,Player A
2721,PatternLearningPlayer,338,233,571,74,1,Player A
2722,PatternLearningPlayer,319,234,553,62,3,Player A
2723,PatternLearningPlayer,337,217,554,63,3,Player A
2724,PatternLearningPlayer,340,210,550,62,4,Player A
2725,PatternLearningPlayer,315,235,550,62,4,Player A
2726,PatternLearningPlayer,337,227,564,64,0,Player A
2727,PatternLearningPlayer,317,237,554,60,2,Player A
2728,PatternLearningPlayer,319,214,533,51,6,Player A
2729,PatternLearningPlayer,322,227,549,61,4,Player A
2730,PatternLearningPlayer,333,218,551,57,2,Player A
2731,PatternLearningPlayer,328,233,561,67,2,Player A
2732,PatternLearningPlayer,340,210,550,59,3,Player A
2733,PatternLearningPlayer,279,244,523,47,8,Player A
2734,PatternLearningPlayer,334,234,568,71,1,Player A
2735,PatternLearningPlayer,352,212,564,67,1,Player A
2736,PatternLearningPlayer,321,221,542,54,4,Player A
2737,PatternLearningPlayer,335,225,560,60,0,Player A
2738,PatternLearningPlayer,318,233,551,60,3,Player A
2739,PatternLearningPlayer,333,223,556,62,2,Player A
2740,PatternLearningPlayer,330,240,570,73,1,Player A
2741,PatternLearningPlayer,354,209,563,66,1,Player A
2742,PatternLearningPlayer,310,240,550,59,3,Player A
2743,PatternLearningPlayer,331,211,542,54,4,Player A
2744,PatternLearningPlayer,320,225,545,57,4,Player A
2745,PatternLearningPlayer,332,232,564,70,2,Player A
2746,PatternLearningPlayer,302,222,524,48,8,Player A
2747,PatternLearningPlayer,329,224,553,56,1,Player A
2748,PatternLearningPlayer,323,243,566,69,1,Player A
2749,PatternLearningPlayer,301,221,522,55,11,Player A
2750,PatternLearningPlayer,295,230,525,46,7,Player A
2751,PatternLearningPlayer,331,236,567,70,1,Player A
2752,PatternLearningPlayer,291,236,527,54,9,Player A
2753,PatternLearningPlayer,318,218,536,54,6,Player A
2754,PatternLearningPlayer,330,215,545,54,3,Player A
2755,PatternLearningPlayer,335,210,545,51,2,Player A
2756,PatternLearningPlayer,313,223,536,60,8,Player A
2757,PatternLearningPlayer,353,218,571,71,0,Player A
2758,PatternLearningPlayer,313,228,541,56,5,Player A
2759,PatternLearningPlayer,304,234,538,62,8,Player A
2760,PatternLearningPlayer,315,220,535,56,7,Player A
2761,PatternLearningPlayer,309,239,548,63,5,Player A
2762,PatternLearningPlayer,312,232,544,59,5,Player A
2763,PatternLearningPlayer,278,218,496,41,15,Player A
2764,PatternLearningPlayer,336,221,557,63,2,Player A
2765,PatternLearningPlayer,311,236,547,59,4,Player A
2766,PatternLearningPlayer,308,218,526,44,6,Player A
2767,PatternLearningPlayer,316,231,547,53,2,Player A
2768,PatternLearningPlayer,330,225,555,64,3,Player A
2769,PatternLearningPlayer,325,230,555,61,2,Player A
2770,PatternLearningPlayer,332,207,539,54,5,Player A
2771,PatternLearningPlayer,324,229,553,59,2,Player A
2772,PatternLearningPlayer,320,220,540,52,4,Player A
2773,PatternLearningPlayer,285,240,525,49,8,Player A
2774,PatternLearningPlayer,356,216,572,72,0,Player A
2775,PatternLearningPlayer,333,213,546,55,3,Player A
2776,PatternLearningPlayer,274,244,518,48,10,Player A
2777,PatternLearningPlayer,331,231,562,65,1,Player A
2778,PatternLearningPlayer,305,245,550,62,4,Player A
2779,PatternLearningPlayer,345,220,565,65,0,Player A
2780,PatternLearningPlayer,308,228,536,57,7,Player A
2781,PatternLearningPlayer,301,211,512,45,11,Player A
2782,PatternLearningPlayer,336,211,547,62,5,Player A
2783,PatternLearningPlayer,310,250,560,69,3,Player A
2784,PatternLearningPlayer,293,233,526,47,7,Player A
2785,PatternLearningPlayer,324,229,553,59,2,Player A
2786,PatternLearningPlayer,337,222,559,65,2,Player A
2787,PatternLearningPlayer,330,225,555,58,1,Player A
2788,PatternLearningPlayer,347,212,559,62,1,Player A
2789,PatternLearningPlayer,340,225,565,68,1,Player A
2790,PatternLearningPlayer,332,227,559,68,3,Player A
2791,PatternLearningPlayer,330,230,560,63,1,Player A
2792,PatternLearningPlayer,322,222,544,56,4,Player A
2793,PatternLearningPlayer,302,217,519,46,9,Player A
2794,PatternLearningPlayer,336,226,562,65,1,Player A
2795,PatternLearningPlayer,344,224,568,68,0,Player A
2796,PatternLearningPlayer,335,240,575,78,1,Player A
2797,PatternLearningPlayer,346,216,562,65,1,Player A
2798,PatternLearningPlayer,305,225,530,54,8,Player A
2799,PatternLearningPlayer,344,219,563,66,1,Player A
2800,PatternLearningPlayer,311,241,552,64,4,Player A
2801,PatternLearningPlayer,324,219,543,58,5,Player A
2802,PatternLearningPlayer,325,230,555,67,4,Player A
2803,PatternLearningPlayer,327,232,559,65,2,Player A
2804,PatternLearningPlayer,332,217,549,55,2,Player A
2805,PatternLearningPlayer,267,227,494,42,16,Player A
2806,PatternLearningPlayer,284,234,518,48,10,Player A
2807,PatternLearningPlayer,334,224,558,64,2,Player A
2808,PatternLearningPlayer,334,234,568,68,0,Player A
2809,PatternLearningPlayer,342,222,564,70,2,Player A
2810,PatternLearningPlayer,340,220,560,66,2,Player A
2811,PatternLearningPlayer,346,211,557,63,2,Player A
2812,PatternLearningPlayer,332,212,544,56,4,Player A
2813,PatternLearningPlayer,322,227,549,61,4,Player A
2814,PatternLearningPlayer,350,220,570,70,0,Player A
2815,PatternLearningPlayer,328,223,551,60,3,Player A
2816,PatternLearningPlayer,330,215,545,57,4,Player A
2817,PatternLearningPlayer,274,234,508,50,14,Player A
2818,PatternLearningPlayer,318,223,541,53,4,Player A
2819,PatternLearningPlayer,325,220,545,57,4,Player A
2820,PatternLearningPlayer,327,242,569,75,2,Player A
2821,PatternLearningPlayer,328,228,556,62,2,Player A
2822,PatternLearningPlayer,340,225,565,65,0,Player A
2823,PatternLearningPlayer,339,219,558,61,1,Player A
2824,PatternLearningPlayer,295,230,525,40,5,Player A
2825,PatternLearningPlayer,304,229,533,48,5,Player A
2826,PatternLearningPlayer,329,224,553,62,3,Player A
2827,PatternLearningPlayer,337,232,569,69,0,Player A
2828,PatternLearningPlayer,339,214,553,59,2,Player A
2829,PatternLearningPlayer,316,246,562,71,3,Player A
2830,PatternLearningPlayer,305,225,530,45,5,Player A
2831,PatternLearningPlayer,331,231,562,65,1,Player A
2832,PatternLearningPlayer,338,223,561,64,1,Player A
2833,PatternLearningPlayer,352,217,569,69,0,Player A
2834,PatternLearningPlayer,283,228,511,44,11,Player A
2835,PatternLearningPlayer,332,237,569,72,1,Player A
2836,PatternLearningPlayer,324,224,548,60,4,Player A
2837,PatternLearningPlayer,329,224,553,59,2,Player A
2838,PatternLearningPlayer,320,245,565,71,2,Player A
2839,PatternLearningPlayer,343,228,571,71,0,Player A
2840,PatternLearningPlayer,352,207,559,62,1,Player A
2841,PatternLearningPlayer,344,224,568,71,1,Player A
2842,PatternLearningPlayer,343,223,566,66,0,Player A
2843,PatternLearningPlayer,290,240,530,57,9,Player A
2844,PatternLearningPlayer,303,223,526,47,7,Player A
2845,PatternLearningPlayer,349,214,563,66,1,Player A
2846,PatternLearningPlayer,338,228,566,69,1,Player A
2847,PatternLearningPlayer,315,225,540,55,5,Player A
2848,PatternLearningPlayer,348,208,556,59,1,Player A
2849,PatternLearningPlayer,314,234,548,57,3,Player A
2850,PatternLearningPlayer,317,227,544,53,3,Player A
2851,PatternLearningPlayer,350,215,565,65,0,Player A
2852,PatternLearningPlayer,305,230,535,56,7,Player A
2853,PatternLearningPlayer,331,236,567,73,2,Player A
2854,PatternLearningPlayer,343,208,551,60,3,Player A
2855,PatternLearningPlayer,271,246,517,53,12,Player A
2856,PatternLearningPlayer,345,215,560,63,1,Player A
2857,PatternLearningPlayer,340,225,565,68,1,Player A
2858,PatternLearningPlayer,345,210,555,61,2,Player A
2859,PatternLearningPlayer,306,236,542,57,5,Player A
2860,PatternLearningPlayer,311,231,542,54,4,Player A
2861,PatternLearningPlayer,345,220,565,68,1,Player A
2862,PatternLearningPlayer,312,227,539,51,4,Player A
2863,PatternLearningPlayer,352,212,564,67,1,Player A
2864,PatternLearningPlayer,321,221,542,54,4,Player A
2865,PatternLearningPlayer,272,237,509,45,12,Player A
2866,PatternLearningPlayer,300,210,510,46,12,Player A
2867,PatternLearningPlayer,334,224,558,67,3,Player A
2868,PatternLearningPlayer,288,233,521,48,9,Player A
2869,PatternLearningPlayer,314,249,563,72,3,Player A
2870,PatternLearningPlayer,320,215,535,53,6,Player A
2871,PatternLearningPlayer,319,224,543,61,6,Player A
2872,PatternLearningPlayer,338,223,561,64,1,Player A
2873,PatternLearningPlayer,311,236,547,56,3,Player A
2874,PatternLearningPlayer,326,236,562,65,1,Player A
2875,PatternLearningPlayer,318,238,556,65,3,Player A
2876,PatternLearningPlayer,325,230,555,61,2,Player A
2877,PatternLearningPlayer,316,221,537,52,5,Player A
2878,PatternLearningPlayer,297,217,514,44,10,Player A
2879,PatternLearningPlayer,337,227,564,67,1,Player A
2880,PatternLearningPlayer,327,227,554,60,2,Player A
2881,PatternLearningPlayer,302,227,529,50,7,Player A
2882,PatternLearningPlayer,353,218,571,71,0,Player A
2883,PatternLearningPlayer,308,228,536,63,9,Player A
2884,PatternLearningPlayer,297,237,534,55,7,Player A
2885,PatternLearningPlayer,330,235,565,68,1,Player A
2886,PatternLearningPlayer,343,228,571,71,0,Player A
2887,PatternLearningPlayer,327,232,559,65,2,Player A
2888,PatternLearningPlayer,340,215,555,61,2,Player A
2889,PatternLearningPlayer,353,213,566,66,0,Player A
2890,PatternLearningPlayer,335,235,570,73,1,Player A
2891,PatternLearningPlayer,351,211,562,62,0,Player A
2892,PatternLearningPlayer,313,233,546,61,5,Player A
2893,PatternLearningPlayer,350,210,560,60,0,Player A
2894,PatternLearningPlayer,317,242,559,68,3,Player A
2895,PatternLearningPlayer,308,233,541,56,5,Player A
2896,PatternLearningPlayer,335,215,550,62,4,Player A
2897,PatternLearningPlayer,343,218,561,64,1,Player A
2898,PatternLearningPlayer,330,225,555,58,1,Player A
2899,PatternLearningPlayer,346,226,572,75,1,Player A
2900,PatternLearningPlayer,343,223,566,69,1,Player A
2901,PatternLearningPlayer,337,242,579,79,0,Player A
2902,PatternLearningPlayer,347,222,569,72,1,Player A
2903,PatternLearningPlayer,319,234,553,62,3,Player A
2904,PatternLearningPlayer,322,227,549,58,3,Player A
2905,PatternLearningPlayer,311,241,552,64,4,Player A
2906,PatternLearningPlayer,317,252,569,75,2,Player A
2907,PatternLearningPlayer,334,219,553,62,3,Player A
2908,PatternLearningPlayer,331,216,547,56,3,Player A
2909,PatternLearningPlayer,294,234,528,58,10,Player A
2910,PatternLearningPlayer,272,232,504,43,13,Player A
2911,PatternLearningPlayer,306,236,542,51,3,Player A
2912,PatternLearningPlayer,324,224,548,60,4,Player A
2913,PatternLearningPlayer,354,204,558,58,0,Player A
2914,PatternLearningPlayer,327,237,564,64,0,Player A
2915,PatternLearningPlayer,349,219,568,68,0,Player A
2916,PatternLearningPlayer,343,223,566,66,0,Player A
2917,PatternLearningPlayer,300,240,540,55,5,Player A
2918,PatternLearningPlayer,329,214,543,58,5,Player A
2919,PatternLearningPlayer,317,242,559,62,1,Player A
2920,PatternLearningPlayer,352,217,569,72,1,Player A
2921,PatternLearningPlayer,319,234,553,65,4,Player A
2922,PatternLearningPlayer,311,231,542,57,5,Player A
2923,PatternLearningPlayer,336,226,562,65,1,Player A
2924,PatternLearningPlayer,335,230,565,68,1,Player A
2925,PatternLearningPlayer,318,223,541,56,5,Player A
2926,PatternLearningPlayer,311,231,542,60,6,Player A
2927,PatternLearningPlayer,291,236,527,57,10,Player A
2928,PatternLearningPlayer,336,231,567,70,1,Player A
2929,PatternLearningPlayer,290,250,540,55,5,Player A
2930,PatternLearningPlayer,299,229,528,52,8,Player A
2931,PatternLearningPlayer,328,208,536,54,6,Player A
2932,PatternLearningPlayer,296,241,537,61,8,Player A
2933,PatternLearningPlayer,316,236,552,67,5,Player A
2934,PatternLearningPlayer,319,239,558,64,2,Player A
2935,PatternLearningPlayer,326,226,552,61,3,Player A
2936,PatternLearningPlayer,300,230,530,51,7,Player A
2937,PatternLearningPlayer,329,229,558,67,3,Player A
2938,PatternLearningPlayer,339,224,563,66,1,Player A
2939,PatternLearningPlayer,346,221,567,67,0,Player A
2940,PatternLearningPlayer,275,230,505,44,13,Player A
2941,PatternLearningPlayer,296,246,542,60,6,Player A
2942,PatternLearningPlayer,335,210,545,54,3,Player A
2943,PatternLearningPlayer,342,212,554,60,2,Player A
2944,PatternLearningPlayer,292,232,524,48,8,Player A
2945,PatternLearningPlayer,309,224,533,54,7,Player A
2946,PatternLearningPlayer,326,246,572,72,0,Player A
2947,PatternLearningPlayer,323,233,556,65,3,Player A
2948,PatternLearningPlayer,344,219,563,69,2,Player A
2949,PatternLearningPlayer,304,244,548,63,5,Player A
2950,PatternLearningPlayer,321,226,547,59,4,Player A
2951,PatternLearningPlayer,291,241,532,59,9,Player A
2952,PatternLearningPlayer,347,222,569,72,1,Player A
2953,PatternLearningPlayer,296,231,527,51,8,Player A
2954,PatternLearningPlayer,324,234,558,64,2,Player A
2955,PatternLearningPlayer,335,205,540,55,5,Player A
2956,PatternLearningPlayer,326,226,552,61,3,Player A
2957,PatternLearningPlayer,318,213,531,46,5,Player A
2958,PatternLearningPlayer,332,217,549,58,3,Player A
2959,PatternLearningPlayer,332,222,554,63,3,Player A
2960,PatternLearningPlayer,350,210,560,63,1,Player A
2961,PatternLearningPlayer,332,237,569,72,1,Player A
2962,PatternLearningPlayer,345,210,555,61,2,Player A
2963,PatternLearningPlayer,312,242,554,69,5,Player A
2964,PatternLearningPlayer,338,218,556,59,1,Player A
2965,PatternLearningPlayer,298,243,541,59,6,Player A
2966,PatternLearningPlayer,315,235,550,65,5,Player A
2967,PatternLearningPlayer,332,217,549,58,3,Player A
2968,PatternLearningPlayer,326,251,577,80,1,Player A
2969,PatternLearningPlayer,337,227,564,64,0,Player A
2970,PatternLearningPlayer,313,243,556,68,4,Player A
2971,PatternLearningPlayer,309,244,553,59,2,Player A
2972,PatternLearningPlayer,335,215,550,59,3,Player A
2973,PatternLearningPlayer,332,232,564,70,2,Player A
2974,PatternLearningPlayer,324,234,558,67,3,Player A
2975,PatternLearningPlayer,314,244,558,67,3,Player A
2976,PatternLearningPlayer,332,212,544,56,4,Player A
2977,PatternLearningPlayer,325,230,555,61,2,Player A
2978,PatternLearningPlayer,312,217,529,50,7,Player A
2979,PatternLearningPlayer,312,242,554,63,3,Player A
2980,PatternLearningPlayer,337,232,569,72,1,Player A
2981,PatternLearningPlayer,327,252,579,82,1,Player A
2982,PatternLearningPlayer,341,231,572,72,0,Player A
2983,PatternLearningPlayer,323,233,556,62,2,Player A
2984,PatternLearningPlayer,354,219,573,73,0,Player A
2985,PatternLearningPlayer,316,241,557,69,4,Player A
2986,PatternLearningPlayer,317,242,559,65,2,Player A
2987,PatternLearningPlayer,344,219,563,63,0,Player A
2988,PatternLearningPlayer,330,225,555,64,3,Player A
2989,PatternLearningPlayer,284,244,528,52,8,Player A
2990,PatternLearningPlayer,323,218,541,50,3,Player A
2991,PatternLearningPlayer,322,242,564,70,2,Player A
2992,PatternLearningPlayer,337,227,564,70,2,Player A
2993,PatternLearningPlayer,298,213,511,47,12,Player A
2994,PatternLearningPlayer,344,219,563,66,1,Player A
2995,PatternLearningPlayer,328,208,536,48,4,Player A
2996,PatternLearningPlayer,334,234,568,74,2,Player A
2997,PatternLearningPlayer,346,211,557,63,2,Player A
2998,PatternLearningPlayer,346,211,557,63,2,Player A
2999,PatternLearningPlayer,346,216,562,65,1,Player A
3000,PatternLearningPlayer,344,214,558,64,2,Player A
3001,PatternLearningPlayer,307,217,524,45,7,Player A
3002,PatternLearningPlayer,302,232,534,49,5,Player A
3003,PatternLearningPlayer,333,243,576,76,0,Player A
3004,PatternLearningPlayer,322,232,554,57,1,Player A
3005,PatternLearningPlayer,343,228,571,71,0,Player A
3006,PatternLearningPlayer,338,223,561,67,2,Player A
3007,PatternLearningPlayer,263,238,501,37,12,Player A
3008,PatternLearningPlayer,343,208,551,60,3,Player A
3009,PatternLearningPlayer,343,218,561,64,1,Player A
3010,PatternLearningPlayer,358,208,566,66,0,Player A
3011,PatternLearningPlayer,317,232,549,58,3,Player A
3012,PatternLearningPlayer,341,216,557,60,1,Player A
3013,PatternLearningPlayer,320,245,565,71,2,Player A
3014,PatternLearningPlayer,355,210,565,65,0,Player A
3015,PatternLearningPlayer,347,227,574,74,0,Player A
3016,PatternLearningPlayer,324,214,538,53,5,Player A
3017,PatternLearningPlayer,350,210,560,60,0,Player A
3018,PatternLearningPlayer,336,236,572,72,0,Player A
3019,PatternLearningPlayer,347,222,569,72,1,Player A
3020,PatternLearningPlayer,320,230,550,65,5,Player A
3021,PatternLearningPlayer,345,215,560,66,2,Player A
3022,PatternLearningPlayer,332,222,554,60,2,Player A
3023,PatternLearningPlayer,350,220,570,70,0,Player A
3024,PatternLearningPlayer,292,257,549,67,6,Player A
3025,PatternLearningPlayer,325,225,550,62,4,Player A
3026,PatternLearningPlayer,326,221,547,53,2,Player A
3027,PatternLearningPlayer,335,225,560,60,0,Player A
3028,PatternLearningPlayer,328,238,566,72,2,Player A
3029,PatternLearningPlayer,341,221,562,65,1,Player A
3030,PatternLearningPlayer,327,232,559,62,1,Player A
3031,PatternLearningPlayer,307,242,549,58,3,Player A
3032,PatternLearningPlayer,336,221,557,66,3,Player A
3033,PatternLearningPlayer,309,234,543,55,4,Player A
3034,PatternLearningPlayer,336,231,567,70,1,Player A
3035,PatternLearningPlayer,325,235,560,66,2,Player A
3036,PatternLearningPlayer,347,212,559,65,2,Player A
3037,PatternLearningPlayer,309,229,538,53,5,Player A
3038,PatternLearningPlayer,327,217,544,59,5,Player A
3039,PatternLearningPlayer,332,222,554,60,2,Player A
3040,PatternLearningPlayer,344,229,573,73,0,Player A
3041,PatternLearningPlayer,332,217,549,55,2,Player A
3042,PatternLearningPlayer,346,221,567,67,0,Player A
3043,PatternLearningPlayer,325,230,555,67,4,Player A
3044,PatternLearningPlayer,313,233,546,58,4,Player A
3045,PatternLearningPlayer,280,240,520,56,12,Player A
3046,PatternLearningPlayer,327,227,554,66,4,Player A
3047,PatternLearningPlayer,338,218,556,59,1,Player A
3048,PatternLearningPlayer,334,234,568,68,0,Player A
3049,PatternLearningPlayer,338,233,571,71,0,Player A
3050,PatternLearningPlayer,350,220,570,70,0,Player A
3051,PatternLearningPlayer,319,239,558,67,3,Player A
3052,PatternLearningPlayer,331,216,547,53,2,Player A
3053,PatternLearningPlayer,313,243,556,65,3,Player A
3054,PatternLearningPlayer,338,233,571,74,1,Player A
3055,PatternLearningPlayer,284,259,543,67,8,Player A
3056,PatternLearningPlayer,311,216,527,48,7,Player A
3057,PatternLearningPlayer,335,220,555,64,3,Player A
3058,PatternLearningPlayer,341,231,572,72,0,Player A
3059,PatternLearningPlayer,321,221,542,63,7,Player A
3060,PatternLearningPlayer,339,234,573,73,0,Player A
3061,PatternLearningPlayer,326,236,562,68,2,Player A
3062,PatternLearningPlayer,302,232,534,52,6,Player A
3063,PatternLearningPlayer,323,218,541,56,5,Player A
3064,PatternLearningPlayer,322,227,549,55,2,Player A
3065,PatternLearningPlayer,338,218,556,62,2,Player A
3066,PatternLearningPlayer,302,237,539,60,7,Player A
3067,PatternLearningPlayer,320,230,550,59,3,Player A
3068,PatternLearningPlayer,332,232,564,70,2,Player A
3069,PatternLearningPlayer,316,241,557,66,3,Player A
3070,PatternLearningPlayer,265,255,520,50,10,Player A
3071,PatternLearningPlayer,336,226,562,68,2,Player A
3072,PatternLearningPlayer,343,218,561,67,2,Player A
3073,PatternLearningPlayer,335,225,560,66,2,Player A
3074,PatternLearningPlayer,306,226,532,47,5,Player A
3075,PatternLearningPlayer,342,222,564,67,1,Player A
3076,PatternLearningPlayer,322,227,549,61,4,Player A
3077,PatternLearningPlayer,318,223,541,62,7,Player A
3078,PatternLearningPlayer,297,237,534,55,7,Player A
3079,PatternLearningPlayer,328,238,566,69,1,Player A
3080,PatternLearningPlayer,340,205,545,51,2,Player A
3081,PatternLearningPlayer,299,234,533,54,7,Player A
3082,PatternLearningPlayer,303,233,536,51,5,Player A
3083,PatternLearningPlayer,342,217,559,62,1,Player A
3084,PatternLearningPlayer,332,212,544,56,4,Player A
3085,PatternLearningPlayer,330,225,555,64,3,Player A
3086,PatternLearningPlayer,333,248,581,81,0,Player A
3087,PatternLearningPlayer,333,228,561,67,2,Player A
3088,PatternLearningPlayer,327,217,544,59,5,Player A
3089,PatternLearningPlayer,329,229,558,64,2,Player A
3090,PatternLearningPlayer,327,247,574,77,1,Player A
3091,PatternLearningPlayer,338,238,576,76,0,Player A
3092,PatternLearningPlayer,342,217,559,65,2,Player A
3093,PatternLearningPlayer,330,230,560,66,2,Player A
3094,PatternLearningPlayer,344,229,573,73,0,Player A
3095,PatternLearningPlayer,314,224,538,56,6,Player A
3096,PatternLearningPlayer,334,219,553,59,2,Player A
3097,PatternLearningPlayer,340,225,565,68,1,Player A
3098,PatternLearningPlayer,324,234,558,67,3,Player A
3099,PatternLearningPlayer,319,234,553,62,3,Player A
3100,PatternLearningPlayer,341,221,562,68,2,Player A
3101,PatternLearningPlayer,340,220,560,60,0,Player A
3102,PatternLearningPlayer,350,215,565,65,0,Player A
3103,PatternLearningPlayer,335,235,570,73,1,Player A
3104,PatternLearningPlayer,329,209,538,53,5,Player A
3105,PatternLearningPlayer,330,235,565,68,1,Player A
3106,PatternLearningPlayer,350,210,560,63,1,Player A
3107,PatternLearningPlayer,332,242,574,77,1,Player A
3108,PatternLearningPlayer,317,222,539,51,4,Player A
3109,PatternLearningPlayer,328,238,566,69,1,Player A
3110,PatternLearningPlayer,336,226,562,68,2,Player A
3111,PatternLearningPlayer,299,224,523,47,8,Player A
3112,PatternLearningPlayer,321,221,542,54,4,Player A
3113,PatternLearningPlayer,328,233,561,67,2,Player A
3114,PatternLearningPlayer,339,224,563,63,0,Player A
3115,PatternLearningPlayer,331,226,557,63,2,Player A
3116,PatternLearningPlayer,316,231,547,59,4,Player A
3117,PatternLearningPlayer,339,234,573,73,0,Player A
3118,PatternLearningPlayer,342,207,549,58,3,Player A
3119,PatternLearningPlayer,336,216,552,58,2,Player A
3120,PatternLearningPlayer,335,235,570,70,0,Player A
3121,PatternLearningPlayer,348,213,561,61,0,Player A
3122,PatternLearningPlayer,304,234,538,59,7,Player A
3123,PatternLearningPlayer,345,215,560,66,2,Player A
3124,PatternLearningPlayer,326,221,547,59,4,Player A
3125,PatternLearningPlayer,299,234,533,60,9,Player A
3126,PatternLearningPlayer,327,237,564,70,2,Player A
3127,PatternLearningPlayer,333,233,566,66,0,Player A
3128,PatternLearningPlayer,335,230,565,65,0,Player A
3129,PatternLearningPlayer,339,224,563,66,1,Player A
3130,PatternLearningPlayer,299,224,523,41,6,Player A
3131,PatternLearningPlayer,317,242,559,68,3,Player A
3132,PatternLearningPlayer,351,216,567,70,1,Player A
3133,PatternLearningPlayer,319,229,548,57,3,Player A
3134,PatternLearningPlayer,327,227,554,63,3,Player A
3135,PatternLearningPlayer,342,227,569,69,0,Player A
3136,PatternLearningPlayer,322,227,549,61,4,Player A
3137,PatternLearningPlayer,284,239,523,53,10,Player A
3138,PatternLearningPlayer,303,233,536,54,6,Player A
3139,PatternLearningPlayer,347,222,569,69,0,Player A
3140,PatternLearningPlayer,317,237,554,66,4,Player A
3141,PatternLearningPlayer,311,246,557,60,1,Player A
3142,PatternLearningPlayer,325,235,560,60,0,Player A
3143,PatternLearningPlayer,331,231,562,65,1,Player A
3144,PatternLearningPlayer,345,225,570,70,0,Player A
3145,PatternLearningPlayer,337,227,564,67,1,Player A
3146,PatternLearningPlayer,336,221,557,60,1,Player A
3147,PatternLearningPlayer,291,251,542,66,8,Player A
3148,PatternLearningPlayer,320,245,565,74,3,Player A
3149,PatternLearningPlayer,307,242,549,61,4,Player A
3150,PatternLearningPlayer,318,228,546,61,5,Player A
3151,PatternLearningPlayer,338,233,571,71,0,Player A
3152,PatternLearningPlayer,337,222,559,62,1,Player A
3153,PatternLearningPlayer,332,217,549,58,3,Player A
3154,PatternLearningPlayer,336,226,562,65,1,Player A
3155,PatternLearningPlayer,336,226,562,65,1,Player A
3156,PatternLearningPlayer,328,213,541,50,3,Player A
3157,PatternLearningPlayer,326,226,552,61,3,Player A
3158,PatternLearningPlayer,318,228,546,64,6,Player A
3159,PatternLearningPlayer,334,244,578,81,1,Player A
3160,PatternLearningPlayer,345,215,560,66,2,Player A
3161,PatternLearningPlayer,345,215,560,60,0,Player A
3162,PatternLearningPlayer,323,233,556,62,2,Player A
3163,PatternLearningPlayer,347,217,564,67,1,Player A
3164,PatternLearningPlayer,323,228,551,57,2,Player A
3165,PatternLearningPlayer,350,220,570,70,0,Player A
3166,PatternLearningPlayer,338,228,566,66,0,Player A
3167,PatternLearningPlayer,328,238,566,72,2,Player A
3168,PatternLearningPlayer,364,199,563,63,0,Player A
3169,PatternLearningPlayer,342,222,564,70,2,Player A
3170,PatternLearningPlayer,335,225,560,63,1,Player A
3171,PatternLearningPlayer,313,238,551,63,4,Player A
3172,PatternLearningPlayer,324,234,558,67,3,Player A
3173,PatternLearningPlayer,332,232,564,67,1,Player A
3174,PatternLearningPlayer,319,234,553,62,3,Player A
3175,PatternLearningPlayer,318,253,571,74,1,Player A
3176,PatternLearningPlayer,331,246,577,77,0,Player A
3177,PatternLearningPlayer,342,227,569,72,1,Player A
3178,PatternLearningPlayer,343,228,571,74,1,Player A
3179,PatternLearningPlayer,336,231,567,70,1,Player A
3180,PatternLearningPlayer,336,236,572,72,0,Player A
3181,PatternLearningPlayer,321,221,542,54,4,Player A
3182,PatternLearningPlayer,342,232,574,74,0,Player A
3183,PatternLearningPlayer,292,222,514,47,11,Player A
3184,PatternLearningPlayer,346,221,567,67,0,Player A
3185,PatternLearningPlayer,347,227,574,74,0,Player A
3186,PatternLearningPlayer,335,225,560,63,1,Player A
3187,PatternLearningPlayer,319,254,573,79,2,Player A
3188,PatternLearningPlayer,318,248,566,72,2,Player A
3189,PatternLearningPlayer,311,231,542,54,4,Player A
3190,PatternLearningPlayer,346,216,562,62,0,Player A
3191,PatternLearningPlayer,321,226,547,59,4,Player A
3192,PatternLearningPlayer,343,218,561,67,2,Player A
3193,PatternLearningPlayer,330,225,555,64,3,Player A
3194,PatternLearningPlayer,279,244,523,56,11,Player A
3195,PatternLearningPlayer,344,214,558,58,0,Player A
3196,PatternLearningPlayer,350,215,565,68,1,Player A
3197,PatternLearningPlayer,322,222,544,56,4,Player A
3198,PatternLearningPlayer,338,223,561,70,3,Player A
3199,PatternLearningPlayer,334,234,568,71,1,Player A
3200,PatternLearningPlayer,323,218,541,50,3,Player A
3201,PatternLearningPlayer,287,242,529,56,9,Player A
3202,PatternLearningPlayer,326,216,542,57,5,Player A
3203,PatternLearningPlayer,343,223,566,66,0,Player A
3204,PatternLearningPlayer,299,244,543,61,6,Player A
3205,PatternLearningPlayer,322,232,554,63,3,Player A
3206,PatternLearningPlayer,353,208,561,64,1,Player A
0,TitForTat,261,256,517,44,9,Player A
1,TitForTat,256,256,512,48,12,Tie
2,TitForTat,265,265,530,54,8,Tie
3,TitForTat,259,264,523,44,7,TitForTat
4,TitForTat,260,255,515,48,11,Player A
5,TitForTat,272,272,544,56,4,Tie
6,TitForTat,268,268,536,51,5,Tie
7,TitForTat,272,272,544,59,5,Tie
8,TitForTat,252,257,509,39,10,TitForTat
9,TitForTat,265,260,525,49,8,Player A
10,TitForTat,264,269,533,48,5,TitForTat
11,TitForTat,270,265,535,53,6,Player A
12,TitForTat,259,264,523,44,7,TitForTat
13,TitForTat,269,269,538,56,6,Tie
14,TitForTat,268,268,536,54,6,Tie
15,TitForTat,254,254,508,41,11,Tie
16,TitForTat,256,256,512,45,11,Tie
17,TitForTat,271,266,537,52,5,Player A
18,TitForTat,263,263,526,50,8,Tie
19,TitForTat,252,257,509,45,12,TitForTat
20,TitForTat,265,265,530,54,8,Tie
21,TitForTat,260,260,520,50,10,Tie
22,TitForTat,267,262,529,53,8,Player A
23,TitForTat,254,259,513,49,12,TitForTat
24,TitForTat,261,261,522,52,10,Tie
25,TitForTat,258,258,516,43,9,Tie
26,TitForTat,256,251,507,43,12,Player A
27,TitForTat,248,253,501,46,15,TitForTat
28,TitForTat,252,252,504,46,14,Tie
29,TitForTat,249,249,498,40,14,Tie
30,TitForTat,271,266,537,52,5,Player A
31,TitForTat,248,253,501,40,13,TitForTat
32,TitForTat,260,260,520,50,10,Tie
33,TitForTat,264,264,528,49,7,Tie
34,TitForTat,273,268,541,53,4,Player A
35,TitForTat,263,263,526,47,7,Tie
36,TitForTat,257,262,519,49,10,TitForTat
37,TitForTat,265,265,530,51,7,Tie
38,TitForTat,265,265,530,57,9,Tie
39,TitForTat,257,252,509,45,12,Player A
40,TitForTat,258,263,521,51,10,TitForTat
41,TitForTat,253,248,501,40,13,Player A
42,TitForTat,261,266,527,48,7,TitForTat
43,TitForTat,256,256,512,42,10,Tie
44,TitForTat,251,251,502,38,12,Tie
45,TitForTat,239,239,478,38,20,Tie
46,TitForTat,275,270,545,66,7,Player A
47,TitForTat,259,264,523,47,8,TitForTat
48,TitForTat,271,266,537,58,7,Player A
49,TitForTat,262,267,529,53,8,TitForTat
50,TitForTat,253,253,506,45,13,Tie
51,TitForTat,279,279,558,64,2,Tie
52,TitForTat,266,261,527,54,9,Player A
53,TitForTat,263,263,526,53,9,Tie
54,TitForTat,267,272,539,60,7,TitForTat
55,TitForTat,266,266,532,53,7,Tie
56,TitForTat,250,245,495,34,13,Player A
57,TitForTat,252,257,509,45,12,TitForTat
58,TitForTat,267,267,534,61,9,Tie
59,TitForTat,261,261,522,46,8,Tie
60,TitForTat,261,261,522,49,9,Tie
61,TitForTat,257,257,514,47,11,Tie
62,TitForTat,259,259,518,54,12,Tie
63,TitForTat,270,270,540,55,5,Tie
64,TitForTat,262,257,519,55,12,Player A
65,TitForTat,247,252,499,41,14,TitForTat
66,TitForTat,252,252,504,43,13,Tie
67,TitForTat,262,262,524,48,8,Tie
68,TitForTat,262,262,524,48,8,Tie
69,TitForTat,249,249,498,40,14,Tie
70,TitForTat,271,266,537,52,5,Player A
71,TitForTat,249,249,498,49,17,Tie
72,TitForTat,254,254,508,44,12,Tie
73,TitForTat,266,266,532,53,7,Tie
74,TitForTat,246,251,497,36,13,TitForTat
75,TitForTat,254,254,508,41,11,Tie
76,TitForTat,265,260,525,52,9,Player A
77,TitForTat,270,275,545,60,5,TitForTat
78,TitForTat,259,254,513,55,14,Player A
79,TitForTat,261,261,522,52,10,Tie
80,TitForTat,258,258,516,55,13,Tie
81,TitForTat,257,262,519,43,8,TitForTat
82,TitForTat,251,251,502,41,13,Tie
83,TitForTat,257,257,514,50,12,Tie
84,TitForTat,265,265,530,57,9,Tie
85,TitForTat,275,275,550,65,5,Tie
86,TitForTat,261,261,522,49,9,Tie
87,TitForTat,268,263,531,49,6,Player A
88,TitForTat,270,270,540,52,4,Tie
89,TitForTat,261,266,527,48,7,TitForTat
90,TitForTat,244,239,483,43,20,Player A
91,TitForTat,253,253,506,45,13,Tie
92,TitForTat,257,257,514,50,12,Tie
93,TitForTat,254,254,508,35,9,Tie
94,TitForTat,264,269,533,54,7,TitForTat
95,TitForTat,263,263,526,53,9,Tie
96,TitForTat,264,264,528,49,7,Tie
97,TitForTat,272,272,544,56,4,Tie
98,TitForTat,268,268,536,54,6,Tie
99,TitForTat,268,268,536,54,6,Tie
100,TitForTat,275,275,550,62,4,Tie
101,TitForTat,256,256,512,36,8,Tie
102,TitForTat,276,271,547,62,5,Player A
103,TitForTat,256,256,512,48,12,Tie
104,TitForTat,264,264,528,58,10,Tie
105,TitForTat,265,270,535,50,5,TitForTat
106,TitForTat,253,253,506,45,13,Tie
107,TitForTat,261,261,522,40,6,Tie
108,TitForTat,267,262,529,47,6,Player A
109,TitForTat,260,260,520,53,11,Tie
110,TitForTat,270,275,545,57,4,TitForTat
111,TitForTat,261,256,517,47,10,Player A
112,TitForTat,250,250,500,42,14,Tie
113,TitForTat,259,264,523,50,9,TitForTat
114,TitForTat,265,260,525,52,9,Player A
115,TitForTat,258,263,521,48,9,TitForTat
116,TitForTat,244,244,488,42,18,Tie
117,TitForTat,269,269,538,50,4,Tie
118,TitForTat,260,255,515,45,10,Player A
119,TitForTat,245,250,495,43,16,TitForTat
120,TitForTat,246,241,487,38,17,Player A
121,TitForTat,270,275,545,54,3,TitForTat
122,TitForTat,274,274,548,57,3,Tie
123,TitForTat,260,260,520,41,7,Tie
124,TitForTat,265,265,530,51,7,Tie
125,TitForTat,276,276,552,58,2,Tie
126,TitForTat,266,266,532,56,8,Tie
127,TitForTat,257,257,514,47,11,Tie
128,TitForTat,265,265,530,48,6,Tie
129,TitForTat,271,266,537,55,6,Player A
130,TitForTat,272,277,549,58,3,TitForTat
131,TitForTat,245,240,485,39,18,Player A
132,TitForTat,262,267,529,59,10,TitForTat
133,TitForTat,251,251,502,41,13,Tie
134,TitForTat,243,243,486,31,15,Tie
135,TitForTat,265,265,530,54,8,Tie
136,TitForTat,262,257,519,49,10,Player A
137,TitForTat,279,284,563,72,3,TitForTat
138,TitForTat,266,266,532,50,6,Tie
139,TitForTat,268,263,531,52,7,Player A
140,TitForTat,248,253,501,46,15,TitForTat
141,TitForTat,254,254,508,38,10,Tie
142,TitForTat,244,244,488,33,15,Tie
143,TitForTat,263,263,526,53,9,Tie
144,TitForTat,261,261,522,43,7,Tie
145,TitForTat,262,262,524,51,9,Tie
146,TitForTat,263,263,526,53,9,Tie
147,TitForTat,268,263,531,58,9,Player A
148,TitForTat,258,258,516,46,10,Tie
149,TitForTat,257,262,519,43,8,TitForTat
150,TitForTat,263,258,521,45,8,Player A
151,TitForTat,256,261,517,44,9,TitForTat
152,TitForTat,259,259,518,51,11,Tie
153,TitForTat,258,258,516,52,12,Tie
154,TitForTat,264,264,528,55,9,Tie
155,TitForTat,265,265,530,51,7,Tie
156,TitForTat,257,257,514,53,13,Tie
157,TitForTat,261,256,517,41,8,Player A
158,TitForTat,260,265,525,46,7,TitForTat
159,TitForTat,269,269,538,53,5,Tie
160,TitForTat,263,263,526,47,7,Tie
161,TitForTat,256,256,512,45,11,Tie
162,TitForTat,259,259,518,45,9,Tie
163,TitForTat,246,246,492,43,17,Tie
164,TitForTat,246,246,492,43,17,Tie
165,TitForTat,255,255,510,49,13,Tie
166,TitForTat,244,244,488,39,17,Tie
167,TitForTat,270,270,540,58,6,Tie
168,TitForTat,264,264,528,49,7,Tie
169,TitForTat,279,274,553,62,3,Player A
170,TitForTat,262,267,529,50,7,TitForTat
171,TitForTat,270,265,535,50,5,Player A
172,TitForTat,260,265,525,58,11,TitForTat
173,TitForTat,262,262,524,51,9,Tie
174,TitForTat,265,265,530,54,8,Tie
175,TitForTat,257,257,514,41,9,Tie
176,TitForTat,260,260,520,44,8,Tie
177,TitForTat,259,259,518,51,11,Tie
178,TitForTat,260,260,520,47,9,Tie
179,TitForTat,266,266,532,53,7,Tie
180,TitForTat,262,257,519,55,12,Player A
181,TitForTat,264,264,528,43,5,Tie
182,TitForTat,263,268,531,52,7,TitForTat
183,TitForTat,264,259,523,53,10,Player A
184,TitForTat,262,267,529,50,7,TitForTat
185,TitForTat,267,267,534,52,6,Tie
186,TitForTat,266,266,532,47,5,Tie
187,TitForTat,269,269,538,56,6,Tie
188,TitForTat,260,260,520,44,8,Tie
189,TitForTat,236,231,467,33,22,Player A
190,TitForTat,269,274,543,58,5,TitForTat
191,TitForTat,264,264,528,49,7,Tie
192,TitForTat,258,253,511,41,10,Player A
193,TitForTat,250,250,500,42,14,Tie
194,TitForTat,262,262,524,42,6,Tie
195,TitForTat,256,261,517,53,12,TitForTat
196,TitForTat,274,274,548,57,3,Tie
197,TitForTat,247,247,494,36,14,Tie
198,TitForTat,254,249,503,42,13,Player A
199,TitForTat,246,251,497,42,15,TitForTat
200,TitForTat,265,265,530,48,6,Tie
201,TitForTat,258,253,511,44,11,Player A
202,TitForTat,254,259,513,49,12,TitForTat
203,TitForTat,262,262,524,57,11,Tie
204,TitForTat,258,253,511,47,12,Player A
205,TitForTat,252,252,504,43,13,Tie
206,TitForTat,262,267,529,47,6,TitForTat
207,TitForTat,257,257,514,44,10,Tie
208,TitForTat,262,262,524,54,10,Tie
209,TitForTat,266,261,527,54,9,Player A
210,TitForTat,253,258,511,41,10,TitForTat
211,TitForTat,266,266,532,59,9,Tie
212,TitForTat,275,275,550,59,3,Tie
213,TitForTat,261,256,517,47,10,Player A
214,TitForTat,246,251,497,36,13,TitForTat
215,TitForTat,267,267,534,55,7,Tie
216,TitForTat,261,261,522,40,6,Tie
217,TitForTat,275,275,550,59,3,Tie
218,TitForTat,258,258,516,49,11,Tie
219,TitForTat,259,254,513,43,10,Player A
220,TitForTat,268,273,541,50,3,TitForTat
221,TitForTat,262,262,524,45,7,Tie
222,TitForTat,262,262,524,45,7,Tie
223,TitForTat,266,261,527,48,7,Player A
224,TitForTat,255,260,515,45,10,TitForTat
225,TitForTat,262,262,524,48,8,Tie
226,TitForTat,266,266,532,50,6,Tie
227,TitForTat,260,260,520,47,9,Tie
228,TitForTat,264,259,523,56,11,Player A
229,TitForTat,259,264,523,50,9,TitForTat
230,TitForTat,248,248,496,38,14,Tie
231,TitForTat,254,254,508,47,13,Tie
232,TitForTat,253,248,501,40,13,Player A
233,TitForTat,265,265,530,54,8,Tie
234,TitForTat,263,268,531,55,8,TitForTat
235,TitForTat,265,260,525,49,8,Player A
236,TitForTat,248,253,501,46,15,TitForTat
237,TitForTat,261,261,522,49,9,Tie
238,TitForTat,259,254,513,52,13,Player A
239,TitForTat,265,265,530,51,7,Tie
240,TitForTat,271,276,547,56,3,TitForTat
241,TitForTat,262,262,524,48,8,Tie
242,TitForTat,265,265,530,57,9,Tie
243,TitForTat,251,251,502,38,12,Tie
244,TitForTat,253,253,506,48,14,Tie
245,TitForTat,259,254,513,43,10,Player A
246,TitForTat,269,269,538,53,5,Tie
247,TitForTat,268,273,541,59,6,TitForTat
248,TitForTat,269,269,538,56,6,Tie
249,TitForTat,266,266,532,44,4,Tie
250,TitForTat,268,263,531,46,5,Player A
251,TitForTat,261,266,527,54,9,TitForTat
252,TitForTat,266,261,527,57,10,Player A
253,TitForTat,257,257,514,41,9,Tie
254,TitForTat,266,271,537,55,6,TitForTat
255,TitForTat,271,271,542,57,5,Tie
256,TitForTat,255,255,510,52,14,Tie
257,TitForTat,266,266,532,53,7,Tie
258,TitForTat,271,266,537,55,6,Player A
259,TitForTat,264,264,528,46,6,Tie
260,TitForTat,254,259,513,52,13,TitForTat
261,TitForTat,259,254,513,46,11,Player A
262,TitForTat,256,256,512,39,9,Tie
263,TitForTat,266,266,532,50,6,Tie
264,TitForTat,257,262,519,49,10,TitForTat
265,TitForTat,267,267,534,55,7,Tie
266,TitForTat,255,255,510,40,10,Tie
267,TitForTat,253,248,501,40,13,Player A
268,TitForTat,249,254,503,39,12,TitForTat
269,TitForTat,266,266,532,50,6,Tie
270,TitForTat,257,257,514,53,13,Tie
271,TitForTat,271,266,537,55,6,Player A
272,TitForTat,266,266,532,56,8,Tie
273,TitForTat,250,255,505,41,12,TitForTat
274,TitForTat,267,262,529,56,9,Player A
275,TitForTat,269,269,538,59,7,Tie
276,TitForTat,261,266,527,51,8,TitForTat
277,TitForTat,253,253,506,45,13,Tie
278,TitForTat,265,265,530,45,5,Tie
279,TitForTat,269,269,538,53,5,Tie
280,TitForTat,254,254,508,38,10,Tie
281,TitForTat,260,260,520,44,8,Tie
282,TitForTat,259,259,518,48,10,Tie
283,TitForTat,263,258,521,54,11,Player A
284,TitForTat,256,256,512,51,13,Tie
285,TitForTat,243,248,491,36,15,TitForTat
286,TitForTat,267,267,534,49,5,Tie
287,TitForTat,271,266,537,61,8,Player A
288,TitForTat,260,265,525,49,8,TitForTat
289,TitForTat,270,270,540,58,6,Tie
290,TitForTat,267,262,529,53,8,Player A
291,TitForTat,260,260,520,50,10,Tie
292,TitForTat,259,264,523,53,10,TitForTat
293,TitForTat,267,267,534,46,4,Tie
294,TitForTat,255,250,505,41,12,Player A
295,TitForTat,252,252,504,49,15,Tie
296,TitForTat,259,264,523,50,9,TitForTat
297,TitForTat,258,258,516,46,10,Tie
298,TitForTat,267,267,534,49,5,Tie
299,TitForTat,267,267,534,52,6,Tie
300,TitForTat,252,252,504,40,12,Tie
301,TitForTat,261,261,522,49,9,Tie
302,TitForTat,252,252,504,46,14,Tie
303,TitForTat,264,264,528,49,7,Tie
304,TitForTat,258,258,516,49,11,Tie
305,TitForTat,268,263,531,58,9,Player A
306,TitForTat,263,268,531,52,7,TitForTat
307,TitForTat,257,252,509,42,11,Player A
308,TitForTat,256,261,517,47,10,TitForTat
309,TitForTat,250,250,500,39,13,Tie
310,TitForTat,265,265,530,54,8,Tie
311,TitForTat,268,268,536,54,6,Tie
312,TitForTat,252,247,499,44,15,Player A
313,TitForTat,261,266,527,51,8,TitForTat
314,TitForTat,263,263,526,53,9,Tie
315,TitForTat,270,270,540,52,4,Tie
316,TitForTat,264,264,528,46,6,Tie
317,TitForTat,263,263,526,47,7,Tie
318,TitForTat,271,266,537,52,5,Player A
319,TitForTat,262,267,529,50,7,TitForTat
320,TitForTat,257,257,514,53,13,Tie
321,TitForTat,262,262,524,48,8,Tie
322,TitForTat,258,258,516,52,12,Tie
323,TitForTat,262,262,524,51,9,Tie
324,TitForTat,257,257,514,53,13,Tie
325,TitForTat,281,276,557,60,1,Player A
326,TitForTat,236,241,477,37,20,TitForTat
327,TitForTat,267,267,534,58,8,Tie
328,TitForTat,246,246,492,37,15,Tie
329,TitForTat,251,251,502,44,14,Tie
330,TitForTat,270,270,540,49,3,Tie
331,TitForTat,269,269,538,59,7,Tie
332,TitForTat,277,272,549,61,4,Player A
333,TitForTat,260,265,525,52,9,TitForTat
334,TitForTat,256,251,507,46,13,Player A
335,TitForTat,267,272,539,57,6,TitForTat
336,TitForTat,260,260,520,50,10,Tie
337,TitForTat,261,261,522,46,8,Tie
338,TitForTat,268,263,531,49,6,Player A
339,TitForTat,260,265,525,49,8,TitForTat
340,TitForTat,273,273,546,61,5,Tie
341,TitForTat,259,259,518,54,12,Tie
342,TitForTat,258,258,516,49,11,Tie
343,TitForTat,258,258,516,46,10,Tie
344,TitForTat,256,256,512,39,9,Tie
345,TitForTat,276,276,552,58,2,Tie
346,TitForTat,261,261,522,46,8,Tie
347,TitForTat,266,261,527,51,8,Player A
348,TitForTat,254,254,508,50,14,Tie
349,TitForTat,260,260,520,50,10,Tie
350,TitForTat,263,263,526,56,10,Tie
351,TitForTat,250,250,500,42,14,Tie
352,TitForTat,259,264,523,50,9,TitForTat
353,TitForTat,258,258,516,43,9,Tie
354,TitForTat,262,262,524,48,8,Tie
355,TitForTat,261,261,522,52,10,Tie
356,TitForTat,260,260,520,44,8,Tie
357,TitForTat,249,249,498,40,14,Tie
358,TitForTat,267,267,534,55,7,Tie
359,TitForTat,269,269,538,53,5,Tie
360,TitForTat,266,261,527,48,7,Player A
361,TitForTat,270,270,540,58,6,Tie
362,TitForTat,261,266,527,48,7,TitForTat
363,TitForTat,257,257,514,50,12,Tie
364,TitForTat,264,264,528,55,9,Tie
365,TitForTat,266,266,532,50,6,Tie
366,TitForTat,261,256,517,44,9,Player A
367,TitForTat,257,262,519,52,11,TitForTat
368,TitForTat,267,267,534,55,7,Tie
369,TitForTat,255,255,510,40,10,Tie
370,TitForTat,260,255,515,42,9,Player A
371,TitForTat,269,269,538,53,5,Tie
372,TitForTat,275,280,555,67,4,TitForTat
373,TitForTat,257,257,514,47,11,Tie
374,TitForTat,270,270,540,58,6,Tie
375,TitForTat,253,248,501,40,13,Player A
376,TitForTat,245,250,495,34,13,TitForTat
377,TitForTat,260,260,520,47,9,Tie
378,TitForTat,255,250,505,41,12,Player A
379,TitForTat,250,255,505,41,12,TitForTat
380,TitForTat,264,259,523,53,10,Player A
381,TitForTat,252,257,509,42,11,TitForTat
382,TitForTat,257,252,509,42,11,Player A
383,TitForTat,255,255,510,43,11,Tie
384,TitForTat,259,264,523,50,9,TitForTat
385,TitForTat,275,275,550,59,3,Tie
386,TitForTat,261,261,522,43,7,Tie
387,TitForTat,271,271,542,60,6,Tie
388,TitForTat,261,261,522,49,9,Tie
389,TitForTat,248,248,496,50,18,Tie
390,TitForTat,270,270,540,58,6,Tie
391,TitForTat,260,255,515,42,9,Player A
392,TitForTat,268,273,541,59,6,TitForTat
393,TitForTat,250,250,500,45,15,Tie
394,TitForTat,265,260,525,52,9,Player A
395,TitForTat,235,235,470,36,22,Tie
396,TitForTat,269,274,543,55,4,TitForTat
397,TitForTat,261,261,522,52,10,Tie
398,TitForTat,267,267,534,55,7,Tie
399,TitForTat,263,258,521,45,8,Player A
400,TitForTat,253,258,511,47,12,TitForTat
401,TitForTat,265,265,530,51,7,Tie
402,TitForTat,265,265,530,51,7,Tie
403,TitForTat,260,255,515,45,10,Player A
404,TitForTat,259,264,523,47,8,TitForTat
405,TitForTat,266,266,532,53,7,Tie
406,TitForTat,261,261,522,52,10,Tie
407,TitForTat,259,259,518,51,11,Tie
408,TitForTat,267,262,529,44,5,Player A
409,TitForTat,263,268,531,58,9,TitForTat
410,TitForTat,266,266,532,50,6,Tie
411,TitForTat,264,259,523,47,8,Player A
412,TitForTat,265,270,535,56,7,TitForTat
413,TitForTat,262,262,524,54,10,Tie
414,TitForTat,260,260,520,50,10,Tie
415,TitForTat,262,262,524,51,9,Tie
416,TitForTat,263,263,526,50,8,Tie
417,TitForTat,270,265,535,53,6,Player A
418,TitForTat,265,270,535,53,6,TitForTat
419,TitForTat,261,261,522,46,8,Tie
420,TitForTat,271,271,542,54,4,Tie
421,TitForTat,255,255,510,49,13,Tie
422,TitForTat,263,258,521,51,10,Player A
423,TitForTat,254,254,508,44,12,Tie
424,TitForTat,259,264,523,47,8,TitForTat
425,TitForTat,253,253,506,42,12,Tie
426,TitForTat,270,270,540,61,7,Tie
427,TitForTat,253,253,506,45,13,Tie
428,TitForTat,254,254,508,50,14,Tie
429,TitForTat,258,253,511,47,12,Player A
430,TitForTat,267,267,534,55,7,Tie
431,TitForTat,261,266,527,48,7,TitForTat
432,TitForTat,263,263,526,53,9,Tie
433,TitForTat,266,266,532,56,8,Tie
434,TitForTat,264,264,528,49,7,Tie
435,TitForTat,268,268,536,57,7,Tie
436,TitForTat,254,254,508,47,13,Tie
437,TitForTat,264,259,523,47,8,Player A
438,TitForTat,252,257,509,39,10,TitForTat
439,TitForTat,263,258,521,54,11,Player A
440,TitForTat,241,246,487,35,16,TitForTat
441,TitForTat,262,262,524,51,9,Tie
442,TitForTat,279,279,558,67,3,Tie
443,TitForTat,265,265,530,54,8,Tie
444,TitForTat,267,267,534,52,6,Tie
445,TitForTat,274,274,548,60,4,Tie
446,TitForTat,265,265,530,51,7,Tie
447,TitForTat,263,263,526,44,6,Tie
448,TitForTat,274,269,543,55,4,Player A
449,TitForTat,256,261,517,41,8,TitForTat
450,TitForTat,276,276,552,61,3,Tie
451,TitForTat,266,266,532,53,7,Tie
452,TitForTat,260,255,515,48,11,Player A
453,TitForTat,246,251,497,36,13,TitForTat
454,TitForTat,274,274,548,60,4,Tie
455,TitForTat,271,271,542,54,4,Tie
456,TitForTat,276,276,552,61,3,Tie
457,TitForTat,275,275,550,59,3,Tie
458,TitForTat,276,276,552,61,3,Tie
459,TitForTat,268,263,531,55,8,Player A
460,TitForTat,257,262,519,46,9,TitForTat
461,TitForTat,264,264,528,55,9,Tie
462,TitForTat,267,267,534,52,6,Tie
463,TitForTat,271,266,537,52,5,Player A
464,TitForTat,262,262,524,48,8,Tie
465,TitForTat,272,272,544,59,5,Tie
466,TitForTat,270,275,545,54,3,TitForTat
467,TitForTat,263,258,521,51,10,Player A
468,TitForTat,262,262,524,48,8,Tie
469,TitForTat,266,271,537,55,6,TitForTat
470,TitForTat,255,250,505,47,14,Player A
471,TitForTat,250,255,505,47,14,TitForTat
472,TitForTat,274,269,543,49,2,Player A
473,TitForTat,247,252,499,35,12,TitForTat
474,TitForTat,266,261,527,51,8,Player A
475,TitForTat,253,258,511,41,10,TitForTat
476,TitForTat,244,244,488,36,16,Tie
477,TitForTat,264,264,528,55,9,Tie
478,TitForTat,258,253,511,47,12,Player A
479,TitForTat,251,251,502,41,13,Tie
480,TitForTat,260,265,525,46,7,TitForTat
481,TitForTat,263,263,526,47,7,Tie
482,TitForTat,274,269,543,58,5,Player A
483,TitForTat,253,258,511,41,10,TitForTat
484,TitForTat,261,261,522,52,10,Tie
485,TitForTat,255,250,505,44,13,Player A
486,TitForTat,255,260,515,36,7,TitForTat
487,TitForTat,277,272,549,58,3,Player A
488,TitForTat,254,259,513,52,13,TitForTat
489,TitForTat,247,247,494,42,16,Tie
490,TitForTat,259,259,518,45,9,Tie
491,TitForTat,260,260,520,44,8,Tie
492,TitForTat,263,258,521,45,8,Player A
493,TitForTat,262,262,524,51,9,Tie
494,TitForTat,249,254,503,39,12,TitForTat
495,TitForTat,249,244,493,44,17,Player A
496,TitForTat,267,267,534,52,6,Tie
497,TitForTat,254,254,508,41,11,Tie
498,TitForTat,260,265,525,49,8,TitForTat
499,TitForTat,265,265,530,54,8,Tie
500,TitForTat,269,264,533,54,7,Player A
501,TitForTat,270,275,545,57,4,TitForTat
502,TitForTat,263,263,526,50,8,Tie
503,TitForTat,273,273,546,58,4,Tie
504,TitForTat,256,256,512,45,11,Tie
505,TitForTat,263,263,526,50,8,Tie
506,TitForTat,263,258,521,48,9,Player A
507,TitForTat,268,273,541,59,6,TitForTat
508,TitForTat,261,261,522,49,9,Tie
509,TitForTat,263,258,521,48,9,Player A
510,TitForTat,245,250,495,37,14,TitForTat
511,TitForTat,271,271,542,57,5,Tie
512,TitForTat,270,270,540,52,4,Tie
513,TitForTat,270,270,540,55,5,Tie
514,TitForTat,260,260,520,50,10,Tie
515,TitForTat,259,259,518,48,10,Tie
516,TitForTat,263,263,526,50,8,Tie
517,TitForTat,271,266,537,52,5,Player A
518,TitForTat,271,276,547,59,4,TitForTat
519,TitForTat,270,265,535,53,6,Player A
520,TitForTat,235,235,470,27,19,Tie
521,TitForTat,263,263,526,56,10,Tie
522,TitForTat,253,258,511,47,12,TitForTat
523,TitForTat,265,265,530,48,6,Tie
524,TitForTat,257,257,514,35,7,Tie
525,TitForTat,253,253,506,39,11,Tie
526,TitForTat,263,263,526,47,7,Tie
527,TitForTat,261,261,522,46,8,Tie
528,TitForTat,260,260,520,50,10,Tie
529,TitForTat,273,268,541,53,4,Player A
530,TitForTat,258,258,516,46,10,Tie
531,TitForTat,258,258,516,46,10,Tie
532,TitForTat,262,262,524,51,9,Tie
533,TitForTat,252,257,509,42,11,TitForTat
534,TitForTat,267,267,534,58,8,Tie
535,TitForTat,274,274,548,63,5,Tie
536,TitForTat,262,262,524,54,10,Tie
537,TitForTat,245,245,490,38,16,Tie
538,TitForTat,264,264,528,55,9,Tie
539,TitForTat,246,246,492,37,15,Tie
540,TitForTat,266,261,527,48,7,Player A
541,TitForTat,268,273,541,53,4,TitForTat
542,TitForTat,261,261,522,49,9,Tie
543,TitForTat,261,261,522,46,8,Tie
544,TitForTat,251,251,502,41,13,Tie
545,TitForTat,256,256,512,45,11,Tie
546,TitForTat,253,253,506,39,11,Tie
547,TitForTat,262,262,524,60,12,Tie
548,TitForTat,276,271,547,56,3,Player A
549,TitForTat,267,272,539,57,6,TitForTat
550,TitForTat,268,268,536,57,7,Tie
551,TitForTat,264,264,528,49,7,Tie
552,TitForTat,265,265,530,57,9,Tie
553,TitForTat,269,264,533,51,6,Player A
554,TitForTat,258,263,521,45,8,TitForTat
555,TitForTat,256,256,512,42,10,Tie
556,TitForTat,261,261,522,52,10,Tie
557,TitForTat,262,262,524,48,8,Tie
558,TitForTat,254,249,503,48,15,Player A
559,TitForTat,257,262,519,49,10,TitForTat
560,TitForTat,255,255,510,46,12,Tie
561,TitForTat,266,261,527,45,6,Player A
562,TitForTat,257,262,519,46,9,TitForTat
563,TitForTat,271,271,542,51,3,Tie
564,TitForTat,260,260,520,53,11,Tie
565,TitForTat,276,271,547,53,2,Player A
566,TitForTat,260,260,520,53,11,Tie
567,TitForTat,254,259,513,52,13,TitForTat
568,TitForTat,259,259,518,54,12,Tie
569,TitForTat,252,252,504,46,14,Tie
570,TitForTat,274,274,548,60,4,Tie
571,TitForTat,260,260,520,59,13,Tie
572,TitForTat,265,265,530,45,5,Tie
573,TitForTat,259,259,518,51,11,Tie
574,TitForTat,269,269,538,62,8,Tie
575,TitForTat,259,259,518,51,11,Tie
576,TitForTat,251,251,502,41,13,Tie
577,TitForTat,266,261,527,48,7,Player A
578,TitForTat,265,270,535,53,6,TitForTat
579,TitForTat,259,259,518,51,11,Tie
580,TitForTat,267,267,534,55,7,Tie
581,TitForTat,257,257,514,50,12,Tie
582,TitForTat,261,261,522,43,7,Tie
583,TitForTat,267,267,534,58,8,Tie
584,TitForTat,259,254,513,49,12,Player A
585,TitForTat,256,261,517,50,11,TitForTat
586,TitForTat,249,249,498,43,15,Tie
587,TitForTat,271,266,537,58,7,Player A
588,TitForTat,243,248,491,39,16,TitForTat
589,TitForTat,268,268,536,48,4,Tie
590,TitForTat,268,268,536,51,5,Tie
591,TitForTat,276,271,547,59,4,Player A
592,TitForTat,268,273,541,62,7,TitForTat
593,TitForTat,242,242,484,32,16,Tie
594,TitForTat,271,271,542,48,2,Tie
595,TitForTat,272,272,544,59,5,Tie
596,TitForTat,265,260,525,46,7,Player A
597,TitForTat,261,266,527,51,8,TitForTat
598,TitForTat,266,266,532,50,6,Tie
599,TitForTat,257,257,514,47,11,Tie
600,TitForTat,263,263,526,53,9,Tie
601,TitForTat,265,265,530,45,5,Tie
602,TitForTat,246,241,487,38,17,Player A
603,TitForTat,250,250,500,42,14,Tie
604,TitForTat,266,266,532,50,6,Tie
605,TitForTat,273,278,551,63,4,TitForTat
606,TitForTat,264,264,528,52,8,Tie
607,TitForTat,248,248,496,44,16,Tie
608,TitForTat,269,269,538,53,5,Tie
609,TitForTat,259,254,513,43,10,Player A
610,TitForTat,273,278,551,60,3,TitForTat
611,TitForTat,268,268,536,60,8,Tie
612,TitForTat,252,252,504,40,12,Tie
613,TitForTat,277,277,554,63,3,Tie
614,TitForTat,269,264,533,57,8,Player A
615,TitForTat,262,262,524,45,7,Tie
616,TitForTat,256,261,517,47,10,TitForTat
617,TitForTat,267,262,529,53,8,Player A
618,TitForTat,263,263,526,47,7,Tie
619,TitForTat,246,251,497,39,14,TitForTat
620,TitForTat,265,265,530,51,7,Tie
621,TitForTat,266,266,532,56,8,Tie
622,TitForTat,261,261,522,46,8,Tie
0,Bayesian,253,253,506,45,13,Tie
1,Bayesian,238,298,536,57,7,Bayesian
2,Bayesian,278,248,526,50,8,Player A
3,Bayesian,265,265,530,48,6,Tie
4,Bayesian,224,299,523,53,10,Bayesian
5,Bayesian,245,290,535,53,6,Bayesian
6,Bayesian,269,254,523,53,10,Player A
7,Bayesian,233,273,506,51,15,Bayesian
8,Bayesian,266,266,532,50,6,Tie
9,Bayesian,242,272,514,47,11,Bayesian
10,Bayesian,252,287,539,57,6,Bayesian
11,Bayesian,276,246,522,52,10,Player A
12,Bayesian,269,259,528,46,6,Player A
13,Bayesian,272,267,539,54,5,Player A
14,Bayesian,286,236,522,52,10,Player A
15,Bayesian,275,240,515,51,12,Player A
16,Bayesian,268,258,526,59,11,Player A
17,Bayesian,281,251,532,56,8,Player A
18,Bayesian,250,285,535,50,5,Bayesian
19,Bayesian,233,273,506,48,14,Bayesian
20,Bayesian,264,274,538,56,6,Bayesian
21,Bayesian,268,253,521,54,11,Player A
22,Bayesian,275,250,525,46,7,Player A
23,Bayesian,277,252,529,53,8,Player A
24,Bayesian,265,255,520,47,9,Player A
25,Bayesian,238,278,516,43,9,Bayesian
26,Bayesian,254,269,523,50,9,Bayesian
27,Bayesian,264,274,538,56,6,Bayesian
28,Bayesian,261,256,517,56,13,Player A
29,Bayesian,258,263,521,39,6,Bayesian
30,Bayesian,280,250,530,51,7,Player A
31,Bayesian,284,239,523,44,7,Player A
32,Bayesian,275,260,535,50,5,Player A
33,Bayesian,287,237,524,57,11,Player A
34,Bayesian,259,279,538,53,5,Bayesian
35,Bayesian,267,257,524,45,7,Player A
36,Bayesian,265,270,535,59,8,Bayesian
37,Bayesian,246,291,537,55,6,Bayesian
38,Bayesian,274,264,538,59,7,Player A
39,Bayesian,274,249,523,53,10,Player A
40,Bayesian,275,245,520,53,11,Player A
41,Bayesian,263,248,511,44,11,Player A
42,Bayesian,253,268,521,48,9,Bayesian
43,Bayesian,259,259,518,48,10,Tie
44,Bayesian,251,246,497,39,14,Player A
45,Bayesian,262,247,509,45,12,Player A
46,Bayesian,290,235,525,52,9,Player A
47,Bayesian,253,258,511,47,12,Bayesian
48,Bayesian,266,266,532,53,7,Tie
49,Bayesian,278,258,536,54,6,Player A
50,Bayesian,210,310,520,47,9,Bayesian
51,Bayesian,262,272,534,52,6,Bayesian
52,Bayesian,273,243,516,43,9,Player A
53,Bayesian,283,243,526,50,8,Player A
54,Bayesian,253,268,521,48,9,Bayesian
55,Bayesian,253,293,546,61,5,Bayesian
56,Bayesian,273,233,506,48,14,Player A
57,Bayesian,253,258,511,41,10,Bayesian
58,Bayesian,253,268,521,48,9,Bayesian
59,Bayesian,251,276,527,48,7,Bayesian
60,Bayesian,289,249,538,53,5,Player A
61,Bayesian,281,246,527,48,7,Player A
62,Bayesian,262,277,539,54,5,Bayesian
63,Bayesian,262,267,529,53,8,Bayesian
64,Bayesian,265,245,510,43,11,Player A
65,Bayesian,261,271,532,53,7,Bayesian
66,Bayesian,266,271,537,52,5,Bayesian
67,Bayesian,269,269,538,59,7,Tie
68,Bayesian,302,242,544,59,5,Player A
69,Bayesian,263,278,541,50,3,Bayesian
70,Bayesian,290,225,515,51,12,Player A
71,Bayesian,240,285,525,46,7,Bayesian
72,Bayesian,269,264,533,51,6,Player A
73,Bayesian,261,266,527,48,7,Bayesian
74,Bayesian,279,249,528,52,8,Player A
75,Bayesian,245,275,520,50,10,Bayesian
76,Bayesian,265,265,530,51,7,Tie
77,Bayesian,248,263,511,50,13,Bayesian
78,Bayesian,270,265,535,53,6,Player A
79,Bayesian,245,295,540,55,5,Bayesian
80,Bayesian,242,267,509,48,13,Bayesian
81,Bayesian,285,225,510,37,9,Player A
82,Bayesian,230,265,495,37,14,Bayesian
83,Bayesian,273,243,516,52,12,Player A
84,Bayesian,278,238,516,49,11,Player A
85,Bayesian,260,255,515,48,11,Player A
86,Bayesian,272,257,529,50,7,Player A
87,Bayesian,279,254,533,51,6,Player A
88,Bayesian,269,259,528,52,8,Player A
89,Bayesian,258,258,516,52,12,Tie
90,Bayesian,255,270,525,49,8,Bayesian
91,Bayesian,286,221,507,43,12,Player A
92,Bayesian,243,293,536,51,5,Bayesian
93,Bayesian,278,258,536,54,6,Player A
94,Bayesian,276,261,537,61,8,Player A
95,Bayesian,288,248,536,51,5,Player A
96,Bayesian,261,256,517,50,11,Player A
97,Bayesian,276,236,512,51,13,Player A
98,Bayesian,290,250,540,58,6,Player A
99,Bayesian,280,235,515,54,13,Player A
100,Bayesian,264,269,533,51,6,Bayesian
101,Bayesian,282,242,524,48,8,Player A
102,Bayesian,248,288,536,57,7,Bayesian
103,Bayesian,288,248,536,54,6,Player A
104,Bayesian,291,226,517,44,9,Player A
105,Bayesian,269,259,528,55,9,Player A
106,Bayesian,262,272,534,46,4,Bayesian
107,Bayesian,244,264,508,38,10,Bayesian
108,Bayesian,253,268,521,51,10,Bayesian
109,Bayesian,257,262,519,49,10,Bayesian
110,Bayesian,253,258,511,50,13,Bayesian
111,Bayesian,239,289,528,52,8,Bayesian
112,Bayesian,269,254,523,44,7,Player A
113,Bayesian,286,241,527,54,9,Player A
114,Bayesian,256,281,537,52,5,Bayesian
115,Bayesian,239,274,513,43,10,Bayesian
116,Bayesian,263,258,521,48,9,Player A
117,Bayesian,252,272,524,48,8,Bayesian
118,Bayesian,252,282,534,52,6,Bayesian
119,Bayesian,303,213,516,49,11,Player A
120,Bayesian,276,256,532,53,7,Player A
121,Bayesian,262,262,524,48,8,Tie
122,Bayesian,251,266,517,47,10,Bayesian
123,Bayesian,264,259,523,53,10,Player A
124,Bayesian,254,279,533,54,7,Bayesian
125,Bayesian,262,232,494,42,16,Player A
126,Bayesian,248,258,506,48,14,Bayesian
127,Bayesian,284,264,548,57,3,Player A
128,Bayesian,262,252,514,41,9,Player A
129,Bayesian,248,273,521,48,9,Bayesian
130,Bayesian,283,248,531,49,6,Player A
131,Bayesian,283,253,536,57,7,Player A
132,Bayesian,271,271,542,54,4,Tie
133,Bayesian,251,261,512,45,11,Bayesian
134,Bayesian,241,271,512,45,11,Bayesian
135,Bayesian,267,252,519,52,11,Player A
136,Bayesian,279,254,533,57,8,Player A
137,Bayesian,278,238,516,49,11,Player A
138,Bayesian,273,253,526,47,7,Player A
139,Bayesian,264,259,523,41,6,Player A
140,Bayesian,267,252,519,49,10,Player A
141,Bayesian,252,272,524,51,9,Bayesian
142,Bayesian,239,274,513,49,12,Bayesian
143,Bayesian,274,249,523,50,9,Player A
144,Bayesian,249,259,508,44,12,Bayesian
145,Bayesian,249,279,528,52,8,Bayesian
146,Bayesian,231,296,527,51,8,Bayesian
147,Bayesian,255,270,525,49,8,Bayesian
148,Bayesian,287,237,524,45,7,Player A
149,Bayesian,279,254,533,54,7,Player A
150,Bayesian,231,286,517,44,9,Bayesian
151,Bayesian,271,266,537,46,3,Player A
152,Bayesian,221,286,507,40,11,Bayesian
153,Bayesian,261,246,507,52,15,Player A
154,Bayesian,265,275,540,55,5,Bayesian
155,Bayesian,257,277,534,58,8,Bayesian
156,Bayesian,274,264,538,53,5,Player A
157,Bayesian,282,257,539,57,6,Player A
158,Bayesian,277,262,539,51,4,Player A
159,Bayesian,281,221,502,44,14,Player A
160,Bayesian,246,281,527,51,8,Bayesian
161,Bayesian,238,278,516,40,8,Bayesian
162,Bayesian,255,270,525,55,10,Bayesian
163,Bayesian,241,276,517,47,10,Bayesian
164,Bayesian,262,257,519,49,10,Player A
165,Bayesian,281,251,532,56,8,Player A
166,Bayesian,268,268,536,57,7,Tie
167,Bayesian,256,271,527,54,9,Bayesian
168,Bayesian,262,262,524,48,8,Tie
169,Bayesian,266,256,522,46,8,Player A
170,Bayesian,252,282,534,52,6,Bayesian
171,Bayesian,245,275,520,50,10,Bayesian
172,Bayesian,260,280,540,55,5,Bayesian
173,Bayesian,258,278,536,60,8,Bayesian
174,Bayesian,263,268,531,52,7,Bayesian
175,Bayesian,269,264,533,48,5,Player A
176,Bayesian,260,275,535,56,7,Bayesian
177,Bayesian,268,268,536,60,8,Tie
178,Bayesian,236,281,517,56,13,Bayesian
179,Bayesian,255,265,520,53,11,Bayesian
180,Bayesian,250,275,525,49,8,Bayesian
181,Bayesian,226,296,522,46,8,Bayesian
182,Bayesian,225,290,515,45,10,Bayesian
183,Bayesian,240,280,520,50,10,Bayesian
184,Bayesian,251,276,527,57,10,Bayesian
185,Bayesian,269,254,523,44,7,Player A
186,Bayesian,267,262,529,47,6,Player A
187,Bayesian,250,270,520,44,8,Bayesian
188,Bayesian,287,242,529,53,8,Player A
189,Bayesian,256,266,522,40,6,Bayesian
190,Bayesian,282,252,534,61,9,Player A
191,Bayesian,262,267,529,53,8,Bayesian
192,Bayesian,284,244,528,46,6,Player A
193,Bayesian,298,253,551,60,3,Player A
194,Bayesian,245,265,510,40,10,Bayesian
195,Bayesian,255,280,535,56,7,Bayesian
196,Bayesian,276,261,537,61,8,Player A
197,Bayesian,277,252,529,59,10,Player A
198,Bayesian,254,254,508,50,14,Tie
199,Bayesian,276,246,522,49,9,Player A
200,Bayesian,270,220,490,41,17,Player A
201,Bayesian,275,245,520,47,9,Player A
202,Bayesian,232,302,534,52,6,Bayesian
203,Bayesian,276,226,502,44,14,Player A
204,Bayesian,292,252,544,56,4,Player A
205,Bayesian,258,258,516,43,9,Tie
206,Bayesian,303,238,541,56,5,Player A
207,Bayesian,267,257,524,48,8,Player A
208,Bayesian,276,246,522,52,10,Player A
209,Bayesian,264,254,518,51,11,Player A
210,Bayesian,287,237,524,48,8,Player A
211,Bayesian,278,248,526,50,8,Player A
212,Bayesian,258,263,521,51,10,Bayesian
213,Bayesian,247,272,519,55,12,Bayesian
214,Bayesian,279,239,518,51,11,Player A
215,Bayesian,240,285,525,49,8,Bayesian
216,Bayesian,255,245,500,42,14,Player A
217,Bayesian,288,233,521,48,9,Player A
218,Bayesian,277,242,519,46,9,Player A
219,Bayesian,271,266,537,58,7,Player A
220,Bayesian,255,265,520,47,9,Bayesian
221,Bayesian,277,252,529,56,9,Player A
222,Bayesian,269,254,523,47,8,Player A
223,Bayesian,261,271,532,53,7,Bayesian
224,Bayesian,250,275,525,49,8,Bayesian
225,Bayesian,276,251,527,60,11,Player A
226,Bayesian,272,242,514,47,11,Player A
227,Bayesian,259,264,523,47,8,Bayesian
228,Bayesian,239,269,508,41,11,Bayesian
229,Bayesian,292,242,534,46,4,Player A
230,Bayesian,251,276,527,51,8,Bayesian
231,Bayesian,254,259,513,46,11,Bayesian
232,Bayesian,250,255,505,44,13,Bayesian
233,Bayesian,276,236,512,45,11,Player A
234,Bayesian,270,250,520,47,9,Player A
235,Bayesian,282,262,544,53,3,Player A
236,Bayesian,252,262,514,44,10,Bayesian
237,Bayesian,259,264,523,47,8,Bayesian
238,Bayesian,255,270,525,49,8,Bayesian
239,Bayesian,269,264,533,48,5,Player A
240,Bayesian,285,255,540,55,5,Player A
241,Bayesian,243,288,531,52,7,Bayesian
242,Bayesian,252,277,529,59,10,Bayesian
243,Bayesian,263,258,521,51,10,Player A
244,Bayesian,291,236,527,45,6,Player A
245,Bayesian,249,279,528,49,7,Bayesian
246,Bayesian,288,248,536,54,6,Player A
247,Bayesian,241,276,517,44,9,Bayesian
248,Bayesian,267,237,504,37,11,Player A
249,Bayesian,250,275,525,52,9,Bayesian
250,Bayesian,263,243,506,48,14,Player A
251,Bayesian,270,270,540,52,4,Tie
252,Bayesian,294,214,508,44,12,Player A
253,Bayesian,280,255,535,53,6,Player A
254,Bayesian,269,244,513,52,13,Player A
255,Bayesian,266,246,512,39,9,Player A
256,Bayesian,251,276,527,54,9,Bayesian
257,Bayesian,287,252,539,54,5,Player A
258,Bayesian,262,272,534,55,7,Bayesian
259,Bayesian,250,270,520,47,9,Bayesian
260,Bayesian,288,243,531,58,9,Player A
261,Bayesian,246,276,522,55,11,Bayesian
262,Bayesian,229,259,488,42,18,Bayesian
263,Bayesian,251,261,512,54,14,Bayesian
264,Bayesian,285,255,540,55,5,Player A
265,Bayesian,286,231,517,47,10,Player A
266,Bayesian,215,295,510,40,10,Bayesian
267,Bayesian,273,238,511,38,9,Player A
268,Bayesian,273,233,506,36,10,Player A
269,Bayesian,269,239,508,47,13,Player A
270,Bayesian,275,245,520,47,9,Player A
271,Bayesian,251,276,527,48,7,Bayesian
272,Bayesian,256,256,512,48,12,Tie
273,Bayesian,231,296,527,48,7,Bayesian
274,Bayesian,291,256,547,56,3,Player A
275,Bayesian,268,258,526,47,7,Player A
276,Bayesian,270,265,535,56,7,Player A
277,Bayesian,282,252,534,49,5,Player A
278,Bayesian,241,276,517,44,9,Bayesian
279,Bayesian,252,272,524,48,8,Bayesian
280,Bayesian,255,270,525,52,9,Bayesian
281,Bayesian,266,251,517,47,10,Player A
282,Bayesian,242,257,499,47,16,Bayesian
283,Bayesian,242,267,509,45,12,Bayesian
284,Bayesian,247,272,519,49,10,Bayesian
285,Bayesian,265,255,520,50,10,Player A
286,Bayesian,295,245,540,55,5,Player A
287,Bayesian,251,276,527,54,9,Bayesian
288,Bayesian,275,250,525,49,8,Player A
289,Bayesian,241,286,527,51,8,Bayesian
290,Bayesian,277,247,524,51,9,Player A
291,Bayesian,262,272,534,49,5,Bayesian
292,Bayesian,252,287,539,54,5,Bayesian
293,Bayesian,220,295,515,48,11,Bayesian
294,Bayesian,284,239,523,59,12,Player A
295,Bayesian,257,247,504,43,13,Player A
296,Bayesian,259,269,528,58,10,Bayesian
297,Bayesian,253,258,511,47,12,Bayesian
298,Bayesian,271,276,547,62,5,Bayesian
299,Bayesian,271,246,517,44,9,Player A
300,Bayesian,269,264,533,54,7,Player A
301,Bayesian,283,258,541,53,4,Player A
302,Bayesian,267,272,539,51,4,Bayesian
303,Bayesian,271,241,512,51,13,Player A
304,Bayesian,272,267,539,57,6,Player A
305,Bayesian,226,286,512,51,13,Bayesian
306,Bayesian,294,234,528,46,6,Player A
307,Bayesian,269,259,528,49,7,Player A
308,Bayesian,287,247,534,49,5,Player A
309,Bayesian,265,265,530,54,8,Tie
310,Bayesian,267,272,539,54,5,Bayesian
311,Bayesian,226,306,532,50,6,Bayesian
312,Bayesian,280,245,525,43,6,Player A
313,Bayesian,273,263,536,51,5,Player A
314,Bayesian,235,285,520,50,10,Bayesian
315,Bayesian,257,262,519,55,12,Bayesian
316,Bayesian,256,261,517,50,11,Bayesian
317,Bayesian,275,255,530,54,8,Player A
318,Bayesian,235,305,540,58,6,Bayesian
319,Bayesian,242,262,504,43,13,Bayesian
320,Bayesian,251,286,537,52,5,Bayesian
321,Bayesian,272,257,529,50,7,Player A
322,Bayesian,250,270,520,50,10,Bayesian
323,Bayesian,273,243,516,46,10,Player A
324,Bayesian,245,270,515,45,10,Bayesian
325,Bayesian,240,275,515,48,11,Bayesian
326,Bayesian,241,286,527,51,8,Bayesian
327,Bayesian,244,259,503,39,12,Bayesian
328,Bayesian,272,267,539,57,6,Player A
329,Bayesian,228,298,526,53,9,Bayesian
330,Bayesian,254,269,523,50,9,Bayesian
331,Bayesian,292,232,524,48,8,Player A
332,Bayesian,276,261,537,55,6,Player A
333,Bayesian,274,259,533,48,5,Player A
334,Bayesian,263,263,526,56,10,Tie
335,Bayesian,251,271,522,52,10,Bayesian
336,Bayesian,291,231,522,43,7,Player A
337,Bayesian,257,252,509,42,11,Player A
338,Bayesian,267,272,539,57,6,Bayesian
339,Bayesian,263,258,521,45,8,Player A
340,Bayesian,270,255,525,46,7,Player A
341,Bayesian,243,283,526,47,7,Bayesian
342,Bayesian,261,271,532,56,8,Bayesian
343,Bayesian,260,270,530,51,7,Bayesian
344,Bayesian,284,239,523,44,7,Player A
345,Bayesian,277,257,534,52,6,Player A
346,Bayesian,257,252,509,54,15,Player A
347,Bayesian,275,255,530,51,7,Player A
348,Bayesian,260,270,530,57,9,Bayesian
349,Bayesian,262,272,534,52,6,Bayesian
350,Bayesian,259,269,528,52,8,Bayesian
351,Bayesian,276,236,512,45,11,Player A
352,Bayesian,288,228,516,43,9,Player A
353,Bayesian,269,254,523,50,9,Player A
354,Bayesian,239,284,523,50,9,Bayesian
355,Bayesian,235,305,540,58,6,Bayesian
356,Bayesian,278,243,521,48,9,Player A
357,Bayesian,273,238,511,50,13,Player A
358,Bayesian,253,258,511,44,11,Bayesian
359,Bayesian,241,276,517,47,10,Bayesian
360,Bayesian,280,240,520,50,10,Player A
361,Bayesian,274,249,523,47,8,Player A
362,Bayesian,272,257,529,56,9,Player A
363,Bayesian,235,300,535,56,7,Bayesian
364,Bayesian,274,249,523,53,10,Player A
365,Bayesian,257,262,519,49,10,Bayesian
366,Bayesian,257,252,509,39,10,Player A
367,Bayesian,265,270,535,50,5,Bayesian
368,Bayesian,280,245,525,55,10,Player A
369,Bayesian,243,278,521,45,8,Bayesian
370,Bayesian,307,227,534,58,8,Player A
371,Bayesian,275,240,515,48,11,Player A
372,Bayesian,248,278,526,50,8,Bayesian
373,Bayesian,265,260,525,49,8,Player A
374,Bayesian,248,288,536,51,5,Bayesian
375,Bayesian,255,260,515,48,11,Bayesian
376,Bayesian,240,275,515,45,10,Bayesian
377,Bayesian,289,244,533,54,7,Player A
378,Bayesian,278,248,526,53,9,Player A
379,Bayesian,249,264,513,46,11,Bayesian
380,Bayesian,262,262,524,51,9,Tie
381,Bayesian,266,276,542,51,3,Bayesian
382,Bayesian,243,278,521,48,9,Bayesian
383,Bayesian,264,259,523,44,7,Player A
384,Bayesian,262,267,529,53,8,Bayesian
385,Bayesian,258,268,526,47,7,Bayesian
386,Bayesian,251,281,532,56,8,Bayesian
387,Bayesian,261,266,527,51,8,Bayesian
388,Bayesian,288,243,531,46,5,Player A
389,Bayesian,256,276,532,50,6,Bayesian
390,Bayesian,280,240,520,41,7,Player A
391,Bayesian,263,238,501,43,14,Player A
392,Bayesian,267,267,534,49,5,Tie
393,Bayesian,263,263,526,53,9,Tie
394,Bayesian,276,266,542,60,6,Player A
395,Bayesian,279,249,528,49,7,Player A
396,Bayesian,277,242,519,55,12,Player A
397,Bayesian,236,256,492,46,18,Bayesian
398,Bayesian,266,256,522,49,9,Player A
399,Bayesian,267,262,529,56,9,Player A
400,Bayesian,246,261,507,49,14,Bayesian
401,Bayesian,254,259,513,52,13,Bayesian
402,Bayesian,273,248,521,51,10,Player A
403,Bayesian,262,267,529,53,8,Bayesian
404,Bayesian,280,240,520,50,10,Player A
405,Bayesian,237,292,529,50,7,Bayesian
406,Bayesian,280,265,545,60,5,Player A
407,Bayesian,258,253,511,47,12,Player A
408,Bayesian,267,242,509,42,11,Player A
409,Bayesian,260,255,515,45,10,Player A
410,Bayesian,240,275,515,51,12,Bayesian
411,Bayesian,261,246,507,43,12,Player A
412,Bayesian,263,268,531,52,7,Bayesian
413,Bayesian,241,271,512,39,9,Bayesian
414,Bayesian,252,272,524,51,9,Bayesian
415,Bayesian,284,249,533,51,6,Player A
416,Bayesian,261,256,517,44,9,Player A
417,Bayesian,254,279,533,42,3,Bayesian
418,Bayesian,262,277,539,57,6,Bayesian
419,Bayesian,275,250,525,49,8,Player A
420,Bayesian,262,262,524,51,9,Tie
421,Bayesian,279,269,548,63,5,Player A
422,Bayesian,269,269,538,56,6,Tie
423,Bayesian,227,282,509,39,10,Bayesian
424,Bayesian,273,253,526,56,10,Player A
425,Bayesian,248,248,496,35,13,Tie
426,Bayesian,215,305,520,53,11,Bayesian
427,Bayesian,264,254,518,45,9,Player A
428,Bayesian,257,252,509,51,14,Player A
429,Bayesian,237,287,524,42,6,Bayesian
430,Bayesian,274,269,543,58,5,Player A
431,Bayesian,247,282,529,53,8,Bayesian
432,Bayesian,250,270,520,47,9,Bayesian
433,Bayesian,241,266,507,52,15,Bayesian
434,Bayesian,253,268,521,48,9,Bayesian
435,Bayesian,273,258,531,55,8,Player A
436,Bayesian,256,266,522,49,9,Bayesian
437,Bayesian,256,276,532,53,7,Bayesian
438,Bayesian,251,256,507,37,10,Bayesian
439,Bayesian,275,255,530,48,6,Player A
440,Bayesian,276,246,522,43,7,Player A
441,Bayesian,266,276,542,54,4,Bayesian
442,Bayesian,272,237,509,42,11,Player A
443,Bayesian,279,254,533,54,7,Player A
444,Bayesian,246,296,542,57,5,Bayesian
445,Bayesian,316,221,537,52,5,Player A
446,Bayesian,282,247,529,56,9,Player A
447,Bayesian,267,272,539,60,7,Bayesian
448,Bayesian,287,242,529,47,6,Player A
449,Bayesian,227,287,514,44,10,Bayesian
450,Bayesian,307,222,529,47,6,Player A
451,Bayesian,293,258,551,60,3,Player A
452,Bayesian,244,264,508,44,12,Bayesian
453,Bayesian,263,258,521,51,10,Player A
454,Bayesian,285,260,545,60,5,Player A
455,Bayesian,259,259,518,45,9,Tie
456,Bayesian,261,246,507,49,14,Player A
457,Bayesian,266,256,522,40,6,Player A
458,Bayesian,262,252,514,44,10,Player A
459,Bayesian,272,257,529,56,9,Player A
460,Bayesian,260,270,530,51,7,Bayesian
461,Bayesian,256,276,532,53,7,Bayesian
462,Bayesian,282,252,534,49,5,Player A
463,Bayesian,249,259,508,50,14,Bayesian
464,Bayesian,257,262,519,46,9,Bayesian
465,Bayesian,269,249,518,45,9,Player A
466,Bayesian,241,286,527,48,7,Bayesian
467,Bayesian,255,270,525,55,10,Bayesian
468,Bayesian,269,244,513,55,14,Player A
469,Bayesian,247,287,534,52,6,Bayesian
470,Bayesian,277,247,524,48,8,Player A
471,Bayesian,255,270,525,49,8,Bayesian
472,Bayesian,263,273,536,54,6,Bayesian
473,Bayesian,258,258,516,43,9,Tie
474,Bayesian,283,233,516,43,9,Player A
0,UCBPlayer,37,367,404,0,32,UCBPlayer
1,UCBPlayer,71,361,432,10,26,UCBPlayer
2,UCBPlayer,41,351,392,0,36,UCBPlayer
3,UCBPlayer,123,323,446,21,25,UCBPlayer
4,UCBPlayer,53,348,401,3,34,UCBPlayer
5,UCBPlayer,69,359,428,6,26,UCBPlayer
6,UCBPlayer,32,397,429,1,24,UCBPlayer
7,UCBPlayer,37,367,404,0,32,UCBPlayer
8,UCBPlayer,33,383,416,0,28,UCBPlayer
9,UCBPlayer,87,327,414,10,32,UCBPlayer
10,UCBPlayer,27,407,434,0,22,UCBPlayer
11,UCBPlayer,35,375,410,0,30,UCBPlayer
12,UCBPlayer,38,383,421,2,27,UCBPlayer
13,UCBPlayer,59,374,433,11,26,UCBPlayer
14,UCBPlayer,36,381,417,1,28,UCBPlayer
15,UCBPlayer,48,353,401,3,34,UCBPlayer
16,UCBPlayer,48,348,396,1,35,UCBPlayer
17,UCBPlayer,45,355,400,2,34,UCBPlayer
18,UCBPlayer,50,345,395,3,36,UCBPlayer
19,UCBPlayer,28,403,431,0,23,UCBPlayer
20,UCBPlayer,37,377,414,1,29,UCBPlayer
21,UCBPlayer,38,383,421,2,27,UCBPlayer
22,UCBPlayer,48,383,431,6,25,UCBPlayer
23,UCBPlayer,50,370,420,7,29,UCBPlayer
24,UCBPlayer,43,383,426,4,26,UCBPlayer
25,UCBPlayer,34,389,423,1,26,UCBPlayer
26,UCBPlayer,40,355,395,0,35,UCBPlayer
27,UCBPlayer,34,389,423,1,26,UCBPlayer
28,UCBPlayer,37,377,414,1,29,UCBPlayer
29,UCBPlayer,57,367,424,8,28,UCBPlayer
30,UCBPlayer,37,367,404,0,32,UCBPlayer
31,UCBPlayer,40,375,415,2,29,UCBPlayer
32,UCBPlayer,35,375,410,0,30,UCBPlayer
33,UCBPlayer,39,369,408,1,31,UCBPlayer
34,UCBPlayer,32,407,439,2,21,UCBPlayer
35,UCBPlayer,28,403,431,0,23,UCBPlayer
36,UCBPlayer,43,383,426,4,26,UCBPlayer
37,UCBPlayer,48,363,411,4,31,UCBPlayer
38,UCBPlayer,43,363,406,2,32,UCBPlayer
39,UCBPlayer,97,322,419,12,31,UCBPlayer
40,UCBPlayer,36,381,417,1,28,UCBPlayer
41,UCBPlayer,39,359,398,0,34,UCBPlayer
42,UCBPlayer,37,382,419,3,28,UCBPlayer
43,UCBPlayer,50,380,430,5,25,UCBPlayer
44,UCBPlayer,36,376,412,2,30,UCBPlayer
45,UCBPlayer,38,388,426,1,25,UCBPlayer
46,UCBPlayer,41,376,417,4,29,UCBPlayer
47,UCBPlayer,44,389,433,5,24,UCBPlayer
48,UCBPlayer,42,387,429,4,25,UCBPlayer
49,UCBPlayer,54,359,413,6,31,UCBPlayer
50,UCBPlayer,318,248,566,75,3,Player A
51,UCBPlayer,167,312,479,30,17,UCBPlayer
52,UCBPlayer,38,393,431,3,24,UCBPlayer
53,UCBPlayer,39,369,408,1,31,UCBPlayer
54,UCBPlayer,33,383,416,0,28,UCBPlayer
55,UCBPlayer,37,402,439,5,22,UCBPlayer
56,UCBPlayer,34,379,413,0,29,UCBPlayer
57,UCBPlayer,42,357,399,1,34,UCBPlayer
58,UCBPlayer,40,355,395,0,35,UCBPlayer
59,UCBPlayer,97,337,434,18,28,UCBPlayer
60,UCBPlayer,27,407,434,0,22,UCBPlayer
61,UCBPlayer,48,363,411,4,31,UCBPlayer
62,UCBPlayer,31,391,422,0,26,UCBPlayer
63,UCBPlayer,35,385,420,1,27,UCBPlayer
64,UCBPlayer,41,391,432,4,24,UCBPlayer
65,UCBPlayer,120,310,430,11,27,UCBPlayer
66,UCBPlayer,41,351,392,0,36,UCBPlayer
67,UCBPlayer,36,371,407,0,31,UCBPlayer
68,UCBPlayer,39,379,418,2,28,UCBPlayer
69,UCBPlayer,54,364,418,5,29,UCBPlayer
70,UCBPlayer,48,373,421,5,28,UCBPlayer
71,UCBPlayer,31,401,432,1,23,UCBPlayer
72,UCBPlayer,28,403,431,0,23,UCBPlayer
73,UCBPlayer,34,389,423,1,26,UCBPlayer
74,UCBPlayer,44,379,423,4,27,UCBPlayer
75,UCBPlayer,36,381,417,1,28,UCBPlayer
76,UCBPlayer,32,387,419,0,27,UCBPlayer
77,UCBPlayer,35,385,420,1,27,UCBPlayer
78,UCBPlayer,40,355,395,0,35,UCBPlayer
79,UCBPlayer,36,371,407,0,31,UCBPlayer
80,UCBPlayer,36,391,427,2,25,UCBPlayer
81,UCBPlayer,49,344,393,1,36,UCBPlayer
82,UCBPlayer,44,349,393,1,36,UCBPlayer
83,UCBPlayer,30,405,435,1,22,UCBPlayer
84,UCBPlayer,37,377,414,1,29,UCBPlayer
85,UCBPlayer,100,350,450,13,21,UCBPlayer
86,UCBPlayer,53,378,431,6,25,UCBPlayer
87,UCBPlayer,39,359,398,0,34,UCBPlayer
88,UCBPlayer,39,369,408,1,31,UCBPlayer
89,UCBPlayer,40,355,395,0,35,UCBPlayer
90,UCBPlayer,33,383,416,0,28,UCBPlayer
91,UCBPlayer,29,399,428,0,24,UCBPlayer
92,UCBPlayer,45,350,395,3,36,UCBPlayer
93,UCBPlayer,75,365,440,12,24,UCBPlayer
94,UCBPlayer,218,278,496,35,13,UCBPlayer
95,UCBPlayer,28,403,431,0,23,UCBPlayer
96,UCBPlayer,47,347,394,2,36,UCBPlayer
97,UCBPlayer,34,394,428,3,25,UCBPlayer
98,UCBPlayer,36,396,432,1,23,UCBPlayer
99,UCBPlayer,36,376,412,2,30,UCBPlayer
100,UCBPlayer,42,387,429,4,25,UCBPlayer
101,UCBPlayer,34,364,398,0,34,UCBPlayer
102,UCBPlayer,33,383,416,0,28,UCBPlayer
103,UCBPlayer,33,383,416,0,28,UCBPlayer
104,UCBPlayer,55,365,420,7,29,UCBPlayer
105,UCBPlayer,34,389,423,1,26,UCBPlayer
106,UCBPlayer,32,387,419,0,27,UCBPlayer
107,UCBPlayer,41,361,402,1,33,UCBPlayer
108,UCBPlayer,32,397,429,1,24,UCBPlayer
109,UCBPlayer,43,383,426,4,26,UCBPlayer
110,UCBPlayer,39,359,398,0,34,UCBPlayer
111,UCBPlayer,30,395,425,0,25,UCBPlayer
112,UCBPlayer,38,373,411,1,30,UCBPlayer
113,UCBPlayer,33,383,416,0,28,UCBPlayer
114,UCBPlayer,50,355,405,4,33,UCBPlayer
115,UCBPlayer,34,389,423,1,26,UCBPlayer
116,UCBPlayer,36,371,407,0,31,UCBPlayer
117,UCBPlayer,30,395,425,0,25,UCBPlayer
118,UCBPlayer,42,357,399,1,34,UCBPlayer
119,UCBPlayer,39,359,398,0,34,UCBPlayer
120,UCBPlayer,27,407,434,0,22,UCBPlayer
121,UCBPlayer,34,389,423,1,26,UCBPlayer
122,UCBPlayer,34,379,413,0,29,UCBPlayer
123,UCBPlayer,27,407,434,0,22,UCBPlayer
124,UCBPlayer,29,399,428,0,24,UCBPlayer
125,UCBPlayer,110,340,450,19,23,UCBPlayer
126,UCBPlayer,35,405,440,3,21,UCBPlayer
127,UCBPlayer,56,351,407,3,32,UCBPlayer
128,UCBPlayer,40,365,405,1,32,UCBPlayer
129,UCBPlayer,37,367,404,0,32,UCBPlayer
130,UCBPlayer,37,377,414,1,29,UCBPlayer
131,UCBPlayer,39,379,418,2,28,UCBPlayer
132,UCBPlayer,32,402,434,3,23,UCBPlayer
133,UCBPlayer,40,380,420,1,27,UCBPlayer
134,UCBPlayer,42,347,389,0,37,UCBPlayer
135,UCBPlayer,33,383,416,0,28,UCBPlayer
136,UCBPlayer,39,369,408,1,31,UCBPlayer
137,UCBPlayer,52,357,409,5,32,UCBPlayer
138,UCBPlayer,34,379,413,0,29,UCBPlayer
139,UCBPlayer,52,332,384,1,39,UCBPlayer
140,UCBPlayer,58,393,451,11,20,UCBPlayer
141,UCBPlayer,43,388,431,6,25,UCBPlayer
142,UCBPlayer,60,365,425,6,27,UCBPlayer
143,UCBPlayer,31,391,422,0,26,UCBPlayer
144,UCBPlayer,50,350,400,5,35,UCBPlayer
145,UCBPlayer,73,343,416,12,32,UCBPlayer
146,UCBPlayer,47,362,409,2,31,UCBPlayer
147,UCBPlayer,34,379,413,0,29,UCBPlayer
148,UCBPlayer,36,366,402,1,33,UCBPlayer
149,UCBPlayer,51,371,422,6,28,UCBPlayer
150,UCBPlayer,36,396,432,4,24,UCBPlayer
151,UCBPlayer,41,381,422,3,27,UCBPlayer
152,UCBPlayer,51,376,427,8,27,UCBPlayer
153,UCBPlayer,41,351,392,0,36,UCBPlayer
154,UCBPlayer,36,391,427,2,25,UCBPlayer
155,UCBPlayer,34,389,423,1,26,UCBPlayer
156,UCBPlayer,40,355,395,0,35,UCBPlayer
157,UCBPlayer,43,373,416,3,29,UCBPlayer
158,UCBPlayer,39,399,438,4,22,UCBPlayer
159,UCBPlayer,40,355,395,0,35,UCBPlayer
160,UCBPlayer,42,357,399,1,34,UCBPlayer
161,UCBPlayer,43,363,406,2,32,UCBPlayer
162,UCBPlayer,40,375,415,2,29,UCBPlayer
163,UCBPlayer,268,263,531,64,11,Player A
164,UCBPlayer,118,323,441,16,25,UCBPlayer
165,UCBPlayer,49,359,408,4,32,UCBPlayer
166,UCBPlayer,36,371,407,0,31,UCBPlayer
167,UCBPlayer,35,375,410,0,30,UCBPlayer
168,UCBPlayer,45,365,410,3,31,UCBPlayer
169,UCBPlayer,30,395,425,0,25,UCBPlayer
170,UCBPlayer,50,370,420,4,28,UCBPlayer
171,UCBPlayer,32,387,419,0,27,UCBPlayer
172,UCBPlayer,51,351,402,4,34,UCBPlayer
173,UCBPlayer,32,407,439,2,21,UCBPlayer
174,UCBPlayer,45,375,420,4,28,UCBPlayer
175,UCBPlayer,35,375,410,0,30,UCBPlayer
176,UCBPlayer,40,375,415,2,29,UCBPlayer
177,UCBPlayer,43,343,386,0,38,UCBPlayer
178,UCBPlayer,36,406,442,5,21,UCBPlayer
179,UCBPlayer,51,361,412,5,31,UCBPlayer
180,UCBPlayer,31,416,447,4,19,UCBPlayer
181,UCBPlayer,68,323,391,5,38,UCBPlayer
182,UCBPlayer,32,387,419,0,27,UCBPlayer
183,UCBPlayer,40,375,415,2,29,UCBPlayer
184,UCBPlayer,35,375,410,0,30,UCBPlayer
185,UCBPlayer,37,387,424,2,26,UCBPlayer
186,UCBPlayer,36,371,407,0,31,UCBPlayer
187,UCBPlayer,41,361,402,1,33,UCBPlayer
188,UCBPlayer,37,377,414,1,29,UCBPlayer
189,UCBPlayer,49,349,398,3,35,UCBPlayer
190,UCBPlayer,51,371,422,6,28,UCBPlayer
191,UCBPlayer,47,377,424,5,27,UCBPlayer
192,UCBPlayer,33,383,416,0,28,UCBPlayer
193,UCBPlayer,37,377,414,1,29,UCBPlayer
194,UCBPlayer,58,343,401,6,35,UCBPlayer
195,UCBPlayer,41,351,392,0,36,UCBPlayer
196,UCBPlayer,33,383,416,0,28,UCBPlayer
197,UCBPlayer,67,347,414,7,31,UCBPlayer
198,UCBPlayer,71,346,417,7,30,UCBPlayer
199,UCBPlayer,39,379,418,2,28,UCBPlayer
200,UCBPlayer,47,352,399,4,35,UCBPlayer
201,UCBPlayer,78,333,411,7,32,UCBPlayer
202,UCBPlayer,41,366,407,0,31,UCBPlayer
203,UCBPlayer,32,372,404,0,32,UCBPlayer
204,UCBPlayer,56,346,402,4,34,UCBPlayer
205,UCBPlayer,44,374,418,2,28,UCBPlayer
206,UCBPlayer,38,363,401,0,33,UCBPlayer
207,UCBPlayer,53,368,421,5,28,UCBPlayer
208,UCBPlayer,40,365,405,1,32,UCBPlayer
209,UCBPlayer,57,357,414,7,31,UCBPlayer
210,UCBPlayer,34,379,413,0,29,UCBPlayer
211,UCBPlayer,83,318,401,6,35,UCBPlayer
212,UCBPlayer,46,361,407,3,32,UCBPlayer
213,UCBPlayer,110,325,435,19,28,UCBPlayer
214,UCBPlayer,38,363,401,0,33,UCBPlayer
215,UCBPlayer,43,363,406,2,32,UCBPlayer
216,UCBPlayer,35,395,430,2,24,UCBPlayer
217,UCBPlayer,38,363,401,0,33,UCBPlayer
218,UCBPlayer,46,361,407,3,32,UCBPlayer
219,UCBPlayer,39,369,408,1,31,UCBPlayer
220,UCBPlayer,37,367,404,0,32,UCBPlayer
221,UCBPlayer,37,367,404,0,32,UCBPlayer
222,UCBPlayer,39,359,398,0,34,UCBPlayer
223,UCBPlayer,56,366,422,6,28,UCBPlayer
224,UCBPlayer,40,365,405,1,32,UCBPlayer
225,UCBPlayer,35,385,420,1,27,UCBPlayer
226,UCBPlayer,138,308,446,21,25,UCBPlayer
227,UCBPlayer,33,383,416,0,28,UCBPlayer
228,UCBPlayer,35,405,440,3,21,UCBPlayer
229,UCBPlayer,44,379,423,4,27,UCBPlayer
230,UCBPlayer,71,351,422,9,29,UCBPlayer
231,UCBPlayer,38,383,421,2,27,UCBPlayer
232,UCBPlayer,98,318,416,12,32,UCBPlayer
233,UCBPlayer,41,361,402,1,33,UCBPlayer
234,UCBPlayer,39,359,398,0,34,UCBPlayer
235,UCBPlayer,38,363,401,0,33,UCBPlayer
236,UCBPlayer,41,361,402,1,33,UCBPlayer
237,UCBPlayer,43,378,421,5,28,UCBPlayer
238,UCBPlayer,97,327,424,17,31,UCBPlayer
239,UCBPlayer,41,351,392,0,36,UCBPlayer
240,UCBPlayer,49,359,408,4,32,UCBPlayer
241,UCBPlayer,38,373,411,1,30,UCBPlayer
242,UCBPlayer,50,355,405,4,33,UCBPlayer
243,UCBPlayer,73,363,436,8,24,UCBPlayer
244,UCBPlayer,43,343,386,0,38,UCBPlayer
245,UCBPlayer,62,337,399,7,36,UCBPlayer
246,UCBPlayer,29,399,428,0,24,UCBPlayer
247,UCBPlayer,59,354,413,6,31,UCBPlayer
248,UCBPlayer,46,386,432,4,24,UCBPlayer
249,UCBPlayer,49,364,413,3,30,UCBPlayer
250,UCBPlayer,33,393,426,1,25,UCBPlayer
251,UCBPlayer,31,386,417,1,28,UCBPlayer
252,UCBPlayer,42,372,414,1,29,UCBPlayer
253,UCBPlayer,29,394,423,1,26,UCBPlayer
254,UCBPlayer,43,363,406,2,32,UCBPlayer
255,UCBPlayer,43,353,396,1,35,UCBPlayer
256,UCBPlayer,45,335,380,0,40,UCBPlayer
257,UCBPlayer,48,353,401,3,34,UCBPlayer
258,UCBPlayer,48,363,411,4,31,UCBPlayer
259,UCBPlayer,42,347,389,0,37,UCBPlayer
260,UCBPlayer,40,355,395,0,35,UCBPlayer
261,UCBPlayer,35,385,420,1,27,UCBPlayer
262,UCBPlayer,30,395,425,0,25,UCBPlayer
263,UCBPlayer,41,371,412,2,30,UCBPlayer
264,UCBPlayer,113,328,441,19,26,UCBPlayer
265,UCBPlayer,40,385,425,3,26,UCBPlayer
266,UCBPlayer,42,347,389,0,37,UCBPlayer
267,UCBPlayer,41,351,392,0,36,UCBPlayer
268,UCBPlayer,42,387,429,4,25,UCBPlayer
269,UCBPlayer,40,375,415,2,29,UCBPlayer
270,UCBPlayer,35,385,420,1,27,UCBPlayer
271,UCBPlayer,50,375,425,3,26,UCBPlayer
272,UCBPlayer,50,380,430,8,26,UCBPlayer
273,UCBPlayer,45,375,420,4,28,UCBPlayer
274,UCBPlayer,42,377,419,3,28,UCBPlayer
275,UCBPlayer,37,377,414,1,29,UCBPlayer
276,UCBPlayer,43,388,431,6,25,UCBPlayer
277,UCBPlayer,46,356,402,1,33,UCBPlayer
278,UCBPlayer,47,327,374,0,42,UCBPlayer
279,UCBPlayer,34,389,423,1,26,UCBPlayer
280,UCBPlayer,39,369,408,1,31,UCBPlayer
281,UCBPlayer,44,359,403,2,33,UCBPlayer
282,UCBPlayer,39,369,408,1,31,UCBPlayer
283,UCBPlayer,39,369,408,1,31,UCBPlayer
284,UCBPlayer,45,335,380,0,40,UCBPlayer
285,UCBPlayer,33,383,416,0,28,UCBPlayer
286,UCBPlayer,50,370,420,7,29,UCBPlayer
287,UCBPlayer,50,355,405,4,33,UCBPlayer
288,UCBPlayer,33,403,436,2,22,UCBPlayer
289,UCBPlayer,45,355,400,2,34,UCBPlayer
290,UCBPlayer,81,351,432,10,26,UCBPlayer
291,UCBPlayer,42,347,389,0,37,UCBPlayer
292,UCBPlayer,91,326,417,13,32,UCBPlayer
293,UCBPlayer,111,331,442,17,25,UCBPlayer
294,UCBPlayer,65,320,385,5,40,UCBPlayer
295,UCBPlayer,48,343,391,2,37,UCBPlayer
296,UCBPlayer,35,405,440,3,21,UCBPlayer
297,UCBPlayer,39,364,403,2,33,UCBPlayer
298,UCBPlayer,39,384,423,1,26,UCBPlayer
299,UCBPlayer,35,375,410,0,30,UCBPlayer
300,UCBPlayer,40,375,415,2,29,UCBPlayer
301,UCBPlayer,35,385,420,1,27,UCBPlayer
302,UCBPlayer,41,366,407,3,32,UCBPlayer
303,UCBPlayer,48,348,396,1,35,UCBPlayer
304,UCBPlayer,40,380,420,1,27,UCBPlayer
305,UCBPlayer,28,388,416,0,28,UCBPlayer
306,UCBPlayer,47,352,399,1,34,UCBPlayer
307,UCBPlayer,36,371,407,0,31,UCBPlayer
308,UCBPlayer,45,375,420,4,28,UCBPlayer
309,UCBPlayer,35,375,410,0,30,UCBPlayer
310,UCBPlayer,37,367,404,0,32,UCBPlayer
311,UCBPlayer,34,379,413,0,29,UCBPlayer
312,UCBPlayer,29,399,428,0,24,UCBPlayer
313,UCBPlayer,43,363,406,2,32,UCBPlayer
314,UCBPlayer,56,341,397,5,36,UCBPlayer
315,UCBPlayer,36,391,427,2,25,UCBPlayer
316,UCBPlayer,36,381,417,1,28,UCBPlayer
317,UCBPlayer,36,371,407,0,31,UCBPlayer
318,UCBPlayer,39,359,398,0,34,UCBPlayer
319,UCBPlayer,39,394,433,5,24,UCBPlayer
320,UCBPlayer,47,347,394,2,36,UCBPlayer
321,UCBPlayer,44,369,413,3,30,UCBPlayer
322,UCBPlayer,53,363,416,6,30,UCBPlayer
323,UCBPlayer,37,387,424,2,26,UCBPlayer
324,UCBPlayer,44,339,383,0,39,UCBPlayer
325,UCBPlayer,47,337,384,1,39,UCBPlayer
326,UCBPlayer,34,379,413,0,29,UCBPlayer
327,UCBPlayer,57,312,369,1,44,UCBPlayer
328,UCBPlayer,157,297,454,26,24,UCBPlayer
329,UCBPlayer,46,341,387,1,38,UCBPlayer
330,UCBPlayer,41,351,392,0,36,UCBPlayer
331,UCBPlayer,41,351,392,0,36,UCBPlayer
332,UCBPlayer,36,371,407,0,31,UCBPlayer
333,UCBPlayer,38,363,401,0,33,UCBPlayer
334,UCBPlayer,71,341,412,11,33,UCBPlayer
335,UCBPlayer,38,373,411,1,30,UCBPlayer
336,UCBPlayer,158,293,451,23,24,UCBPlayer
337,UCBPlayer,49,344,393,1,36,UCBPlayer
338,UCBPlayer,39,359,398,0,34,UCBPlayer
339,UCBPlayer,37,382,419,3,28,UCBPlayer
340,UCBPlayer,45,360,405,1,32,UCBPlayer
341,UCBPlayer,45,350,395,3,36,UCBPlayer
342,UCBPlayer,113,353,466,26,20,UCBPlayer
343,UCBPlayer,126,326,452,24,24,UCBPlayer
344,UCBPlayer,47,347,394,2,36,UCBPlayer
345,UCBPlayer,65,330,395,6,37,UCBPlayer
346,UCBPlayer,58,328,386,3,39,UCBPlayer
347,UCBPlayer,39,374,413,3,30,UCBPlayer
348,UCBPlayer,54,359,413,6,31,UCBPlayer
349,UCBPlayer,50,345,395,0,35,UCBPlayer
350,UCBPlayer,65,350,415,5,30,UCBPlayer
351,UCBPlayer,123,333,456,22,22,UCBPlayer
352,UCBPlayer,41,361,402,1,33,UCBPlayer
353,UCBPlayer,58,338,396,4,36,UCBPlayer
354,UCBPlayer,33,383,416,0,28,UCBPlayer
355,UCBPlayer,35,375,410,0,30,UCBPlayer
356,UCBPlayer,34,364,398,0,34,UCBPlayer
357,UCBPlayer,43,363,406,2,32,UCBPlayer
358,UCBPlayer,42,347,389,0,37,UCBPlayer
359,UCBPlayer,61,346,407,6,33,UCBPlayer
360,UCBPlayer,36,371,407,0,31,UCBPlayer
361,UCBPlayer,42,347,389,0,37,UCBPlayer
362,UCBPlayer,43,373,416,3,29,UCBPlayer
363,UCBPlayer,61,346,407,6,33,UCBPlayer
364,UCBPlayer,45,360,405,1,32,UCBPlayer
365,UCBPlayer,44,364,408,1,31,UCBPlayer
366,UCBPlayer,44,359,403,2,33,UCBPlayer
367,UCBPlayer,41,361,402,1,33,UCBPlayer
368,UCBPlayer,213,278,491,42,17,UCBPlayer
369,UCBPlayer,80,330,410,9,33,UCBPlayer
370,UCBPlayer,40,385,425,3,26,UCBPlayer
371,UCBPlayer,79,354,433,17,28,UCBPlayer
372,UCBPlayer,41,361,402,1,33,UCBPlayer
373,UCBPlayer,59,344,403,5,34,UCBPlayer
374,UCBPlayer,48,363,411,4,31,UCBPlayer
375,UCBPlayer,38,363,401,0,33,UCBPlayer
376,UCBPlayer,49,369,418,5,29,UCBPlayer
377,UCBPlayer,34,379,413,0,29,UCBPlayer
378,UCBPlayer,31,401,432,1,23,UCBPlayer
379,UCBPlayer,45,365,410,3,31,UCBPlayer
380,UCBPlayer,45,365,410,3,31,UCBPlayer
381,UCBPlayer,35,405,440,3,21,UCBPlayer
382,UCBPlayer,37,367,404,0,32,UCBPlayer
383,UCBPlayer,42,367,409,2,31,UCBPlayer
384,UCBPlayer,35,375,410,0,30,UCBPlayer
385,UCBPlayer,53,353,406,5,33,UCBPlayer
386,UCBPlayer,50,340,390,1,37,UCBPlayer
387,UCBPlayer,41,371,412,2,30,UCBPlayer
388,UCBPlayer,46,371,417,4,29,UCBPlayer
389,UCBPlayer,48,373,421,5,28,UCBPlayer
390,UCBPlayer,39,359,398,0,34,UCBPlayer
391,UCBPlayer,38,373,411,1,30,UCBPlayer
392,UCBPlayer,46,356,402,1,33,UCBPlayer
393,UCBPlayer,43,368,411,4,31,UCBPlayer
394,UCBPlayer,49,354,403,2,33,UCBPlayer
395,UCBPlayer,57,342,399,4,35,UCBPlayer
396,UCBPlayer,93,338,431,18,29,UCBPlayer
397,UCBPlayer,134,314,448,26,26,UCBPlayer
398,UCBPlayer,66,386,452,12,20,UCBPlayer
399,UCBPlayer,55,330,385,2,39,UCBPlayer
400,UCBPlayer,30,390,420,1,27,UCBPlayer
401,UCBPlayer,37,397,434,3,23,UCBPlayer
402,UCBPlayer,53,353,406,5,33,UCBPlayer
403,UCBPlayer,48,348,396,1,35,UCBPlayer
404,UCBPlayer,36,391,427,2,25,UCBPlayer
405,UCBPlayer,33,383,416,0,28,UCBPlayer
406,UCBPlayer,40,350,390,1,37,UCBPlayer
407,UCBPlayer,111,326,437,18,27,UCBPlayer
408,UCBPlayer,50,345,395,3,36,UCBPlayer
409,UCBPlayer,35,375,410,0,30,UCBPlayer
410,UCBPlayer,69,344,413,6,31,UCBPlayer
411,UCBPlayer,63,328,391,5,38,UCBPlayer
412,UCBPlayer,122,317,439,17,26,UCBPlayer
413,UCBPlayer,54,344,398,3,35,UCBPlayer
414,UCBPlayer,39,359,398,0,34,UCBPlayer
415,UCBPlayer,43,363,406,2,32,UCBPlayer
416,UCBPlayer,38,383,421,2,27,UCBPlayer
417,UCBPlayer,50,370,420,7,29,UCBPlayer
418,UCBPlayer,46,341,387,1,38,UCBPlayer
419,UCBPlayer,33,383,416,0,28,UCBPlayer
420,UCBPlayer,38,363,401,0,33,UCBPlayer
421,UCBPlayer,50,350,400,2,34,UCBPlayer
422,UCBPlayer,65,345,410,9,33,UCBPlayer
423,UCBPlayer,40,365,405,1,32,UCBPlayer
424,UCBPlayer,43,373,416,3,29,UCBPlayer
425,UCBPlayer,41,351,392,0,36,UCBPlayer
426,UCBPlayer,37,367,404,0,32,UCBPlayer
427,UCBPlayer,65,355,420,10,30,UCBPlayer
428,UCBPlayer,40,355,395,0,35,UCBPlayer
429,UCBPlayer,64,349,413,3,30,UCBPlayer
430,UCBPlayer,30,395,425,0,25,UCBPlayer
431,UCBPlayer,49,339,388,2,38,UCBPlayer
432,UCBPlayer,48,353,401,3,34,UCBPlayer
433,UCBPlayer,42,347,389,0,37,UCBPlayer
434,UCBPlayer,43,363,406,2,32,UCBPlayer
435,UCBPlayer,76,346,422,15,31,UCBPlayer
436,UCBPlayer,44,354,398,0,34,UCBPlayer
437,UCBPlayer,53,358,411,4,31,UCBPlayer
438,UCBPlayer,72,357,429,10,27,UCBPlayer
439,UCBPlayer,43,343,386,0,38,UCBPlayer
440,UCBPlayer,38,363,401,0,33,UCBPlayer
441,UCBPlayer,45,365,410,3,31,UCBPlayer
442,UCBPlayer,46,346,392,0,36,UCBPlayer
443,UCBPlayer,43,343,386,0,38,UCBPlayer
444,UCBPlayer,42,347,389,0,37,UCBPlayer
445,UCBPlayer,44,374,418,5,29,UCBPlayer
446,UCBPlayer,64,334,398,6,36,UCBPlayer
447,UCBPlayer,46,356,402,1,33,UCBPlayer
448,UCBPlayer,44,339,383,0,39,UCBPlayer
449,UCBPlayer,45,335,380,0,40,UCBPlayer
450,UCBPlayer,34,379,413,0,29,UCBPlayer
451,UCBPlayer,38,393,431,3,24,UCBPlayer
452,UCBPlayer,32,387,419,0,27,UCBPlayer
453,UCBPlayer,32,387,419,0,27,UCBPlayer
454,UCBPlayer,39,359,398,0,34,UCBPlayer
455,UCBPlayer,40,355,395,0,35,UCBPlayer
456,UCBPlayer,27,407,434,0,22,UCBPlayer
457,UCBPlayer,39,354,393,1,36,UCBPlayer
458,UCBPlayer,59,334,393,4,37,UCBPlayer
459,UCBPlayer,33,383,416,0,28,UCBPlayer
460,UCBPlayer,35,375,410,0,30,UCBPlayer
461,UCBPlayer,37,367,404,0,32,UCBPlayer
462,UCBPlayer,65,330,395,6,37,UCBPlayer
463,UCBPlayer,41,361,402,1,33,UCBPlayer
464,UCBPlayer,53,358,411,4,31,UCBPlayer
465,UCBPlayer,43,393,436,5,23,UCBPlayer
466,UCBPlayer,41,371,412,2,30,UCBPlayer
467,UCBPlayer,37,367,404,0,32,UCBPlayer
468,UCBPlayer,52,357,409,5,32,UCBPlayer
469,UCBPlayer,60,360,420,7,29,UCBPlayer
470,UCBPlayer,40,365,405,1,32,UCBPlayer
471,UCBPlayer,42,357,399,1,34,UCBPlayer
472,UCBPlayer,49,344,393,1,36,UCBPlayer
473,UCBPlayer,37,367,404,0,32,UCBPlayer
474,UCBPlayer,39,359,398,0,34,UCBPlayer
475,UCBPlayer,52,337,389,3,38,UCBPlayer
476,UCBPlayer,240,250,490,41,17,UCBPlayer
477,UCBPlayer,74,374,448,8,20,UCBPlayer
478,UCBPlayer,42,387,429,4,25,UCBPlayer
479,UCBPlayer,44,339,383,0,39,UCBPlayer
480,UCBPlayer,43,363,406,2,32,UCBPlayer
481,UCBPlayer,43,363,406,2,32,UCBPlayer
482,UCBPlayer,47,357,404,3,33,UCBPlayer
483,UCBPlayer,86,301,387,7,40,UCBPlayer
484,UCBPlayer,51,311,362,0,46,UCBPlayer
485,UCBPlayer,47,357,404,3,33,UCBPlayer
486,UCBPlayer,39,359,398,0,34,UCBPlayer
487,UCBPlayer,76,341,417,7,30,UCBPlayer
488,UCBPlayer,154,309,463,32,23,UCBPlayer
489,UCBPlayer,34,379,413,0,29,UCBPlayer
490,UCBPlayer,40,355,395,0,35,UCBPlayer
491,UCBPlayer,53,343,396,4,36,UCBPlayer
492,UCBPlayer,43,343,386,0,38,UCBPlayer
493,UCBPlayer,41,351,392,0,36,UCBPlayer
494,UCBPlayer,36,371,407,0,31,UCBPlayer
495,UCBPlayer,119,304,423,19,32,UCBPlayer
496,UCBPlayer,94,319,413,12,33,UCBPlayer
497,UCBPlayer,61,351,412,5,31,UCBPlayer
498,UCBPlayer,41,351,392,0,36,UCBPlayer
499,UCBPlayer,40,355,395,0,35,UCBPlayer
500,UCBPlayer,44,359,403,2,33,UCBPlayer
501,UCBPlayer,40,365,405,1,32,UCBPlayer
502,UCBPlayer,53,368,421,5,28,UCBPlayer
503,UCBPlayer,39,359,398,0,34,UCBPlayer
504,UCBPlayer,39,359,398,0,34,UCBPlayer
505,UCBPlayer,47,362,409,5,32,UCBPlayer
506,UCBPlayer,59,349,408,4,32,UCBPlayer
507,UCBPlayer,50,390,440,6,22,UCBPlayer
508,UCBPlayer,44,369,413,3,30,UCBPlayer
509,UCBPlayer,41,361,402,1,33,UCBPlayer
510,UCBPlayer,55,345,400,5,35,UCBPlayer
511,UCBPlayer,33,383,416,0,28,UCBPlayer
512,UCBPlayer,77,312,389,9,40,UCBPlayer
513,UCBPlayer,63,328,391,5,38,UCBPlayer
514,UCBPlayer,36,371,407,0,31,UCBPlayer
515,UCBPlayer,38,363,401,0,33,UCBPlayer
516,UCBPlayer,42,347,389,0,37,UCBPlayer
517,UCBPlayer,42,347,389,0,37,UCBPlayer
518,UCBPlayer,49,344,393,1,36,UCBPlayer
519,UCBPlayer,48,343,391,2,37,UCBPlayer
520,UCBPlayer,56,331,387,4,39,UCBPlayer
521,UCBPlayer,41,361,402,1,33,UCBPlayer
522,UCBPlayer,64,349,413,9,32,UCBPlayer
523,UCBPlayer,27,407,434,0,22,UCBPlayer
524,UCBPlayer,36,381,417,1,28,UCBPlayer
525,UCBPlayer,60,345,405,7,34,UCBPlayer
526,UCBPlayer,86,346,432,13,27,UCBPlayer
527,UCBPlayer,34,379,413,0,29,UCBPlayer
528,UCBPlayer,56,361,417,7,30,UCBPlayer
529,UCBPlayer,44,349,393,1,36,UCBPlayer
530,UCBPlayer,44,339,383,0,39,UCBPlayer
531,UCBPlayer,40,355,395,0,35,UCBPlayer
532,UCBPlayer,42,357,399,1,34,UCBPlayer
533,UCBPlayer,33,393,426,1,25,UCBPlayer
534,UCBPlayer,44,349,393,1,36,UCBPlayer
535,UCBPlayer,40,355,395,0,35,UCBPlayer
536,UCBPlayer,63,363,426,7,27,UCBPlayer
537,UCBPlayer,37,367,404,0,32,UCBPlayer
538,UCBPlayer,53,328,381,1,40,UCBPlayer
539,UCBPlayer,41,351,392,0,36,UCBPlayer
540,UCBPlayer,43,363,406,2,32,UCBPlayer
541,UCBPlayer,48,363,411,4,31,UCBPlayer
542,UCBPlayer,51,326,377,0,41,UCBPlayer
543,UCBPlayer,43,343,386,0,38,UCBPlayer
544,UCBPlayer,44,349,393,1,36,UCBPlayer
545,UCBPlayer,53,328,381,1,40,UCBPlayer
546,UCBPlayer,70,370,440,12,24,UCBPlayer
547,UCBPlayer,45,345,390,1,37,UCBPlayer
548,UCBPlayer,30,395,425,0,25,UCBPlayer
549,UCBPlayer,43,343,386,0,38,UCBPlayer
550,UCBPlayer,38,363,401,0,33,UCBPlayer
551,UCBPlayer,83,338,421,8,29,UCBPlayer
552,UCBPlayer,103,348,451,14,21,UCBPlayer
553,UCBPlayer,43,343,386,0,38,UCBPlayer
554,UCBPlayer,43,348,391,2,37,UCBPlayer
555,UCBPlayer,74,349,423,7,28,UCBPlayer
556,UCBPlayer,43,343,386,0,38,UCBPlayer
557,UCBPlayer,41,351,392,0,36,UCBPlayer
558,UCBPlayer,41,346,387,1,38,UCBPlayer
559,UCBPlayer,52,367,419,6,29,UCBPlayer
560,UCBPlayer,40,355,395,0,35,UCBPlayer
561,UCBPlayer,35,375,410,0,30,UCBPlayer
562,UCBPlayer,35,375,410,0,30,UCBPlayer
563,UCBPlayer,43,343,386,0,38,UCBPlayer
564,UCBPlayer,43,343,386,0,38,UCBPlayer
565,UCBPlayer,119,339,458,21,21,UCBPlayer
566,UCBPlayer,44,339,383,0,39,UCBPlayer
567,UCBPlayer,52,342,394,2,36,UCBPlayer
568,UCBPlayer,48,333,381,1,40,UCBPlayer
569,UCBPlayer,44,354,398,0,34,UCBPlayer
570,UCBPlayer,49,349,398,3,35,UCBPlayer
571,UCBPlayer,38,363,401,0,33,UCBPlayer
572,UCBPlayer,42,357,399,1,34,UCBPlayer
573,UCBPlayer,37,367,404,0,32,UCBPlayer
574,UCBPlayer,169,274,443,24,27,UCBPlayer
575,UCBPlayer,39,379,418,2,28,UCBPlayer
576,UCBPlayer,40,365,405,1,32,UCBPlayer
577,UCBPlayer,64,329,393,7,38,UCBPlayer
578,UCBPlayer,62,332,394,5,37,UCBPlayer
579,UCBPlayer,37,377,414,1,29,UCBPlayer
580,UCBPlayer,37,377,414,1,29,UCBPlayer
581,UCBPlayer,43,363,406,2,32,UCBPlayer
582,UCBPlayer,44,359,403,2,33,UCBPlayer
583,UCBPlayer,34,379,413,0,29,UCBPlayer
584,UCBPlayer,49,344,393,1,36,UCBPlayer
585,UCBPlayer,43,343,386,0,38,UCBPlayer
586,UCBPlayer,40,355,395,0,35,UCBPlayer
587,UCBPlayer,42,347,389,0,37,UCBPlayer
588,UCBPlayer,39,359,398,0,34,UCBPlayer
589,UCBPlayer,40,355,395,0,35,UCBPlayer
590,UCBPlayer,42,347,389,0,37,UCBPlayer
591,UCBPlayer,36,371,407,0,31,UCBPlayer
592,UCBPlayer,52,347,399,4,35,UCBPlayer
593,UCBPlayer,98,338,436,11,25,UCBPlayer
594,UCBPlayer,47,337,384,1,39,UCBPlayer
595,UCBPlayer,40,355,395,0,35,UCBPlayer
596,UCBPlayer,53,333,386,3,39,UCBPlayer
597,UCBPlayer,52,337,389,3,38,UCBPlayer
598,UCBPlayer,39,369,408,1,31,UCBPlayer
599,UCBPlayer,43,353,396,1,35,UCBPlayer
600,UCBPlayer,63,318,381,4,41,UCBPlayer
601,UCBPlayer,39,359,398,0,34,UCBPlayer
602,UCBPlayer,71,356,427,11,28,UCBPlayer
603,UCBPlayer,44,384,428,3,25,UCBPlayer
604,UCBPlayer,49,389,438,7,23,UCBPlayer
605,UCBPlayer,41,356,397,2,35,UCBPlayer
606,UCBPlayer,47,372,419,3,28,UCBPlayer
607,UCBPlayer,53,353,406,5,33,UCBPlayer
608,UCBPlayer,74,309,383,3,40,UCBPlayer
609,UCBPlayer,36,376,412,2,30,UCBPlayer
610,UCBPlayer,51,351,402,1,33,UCBPlayer
611,UCBPlayer,37,352,389,0,37,UCBPlayer
612,UCBPlayer,65,340,405,7,34,UCBPlayer
613,UCBPlayer,45,335,380,0,40,UCBPlayer
614,UCBPlayer,44,339,383,0,39,UCBPlayer
615,UCBPlayer,60,320,380,3,41,UCBPlayer
616,UCBPlayer,60,335,395,3,36,UCBPlayer
617,UCBPlayer,49,329,378,1,41,UCBPlayer
618,UCBPlayer,66,311,377,3,42,UCBPlayer
619,UCBPlayer,44,339,383,0,39,UCBPlayer
620,UCBPlayer,41,351,392,0,36,UCBPlayer
621,UCBPlayer,45,335,380,0,40,UCBPlayer
622,UCBPlayer,45,335,380,0,40,UCBPlayer
623,UCBPlayer,45,365,410,3,31,UCBPlayer
624,UCBPlayer,55,345,400,5,35,UCBPlayer
625,UCBPlayer,38,378,416,0,28,UCBPlayer
626,UCBPlayer,42,347,389,0,37,UCBPlayer
627,UCBPlayer,100,340,440,15,25,UCBPlayer
628,UCBPlayer,82,322,404,9,35,UCBPlayer
629,UCBPlayer,38,373,411,1,30,UCBPlayer
630,UCBPlayer,36,371,407,0,31,UCBPlayer
631,UCBPlayer,38,363,401,0,33,UCBPlayer
632,UCBPlayer,34,379,413,0,29,UCBPlayer
633,UCBPlayer,39,359,398,0,34,UCBPlayer
634,UCBPlayer,46,341,387,1,38,UCBPlayer
635,UCBPlayer,41,361,402,1,33,UCBPlayer
636,UCBPlayer,43,343,386,0,38,UCBPlayer
637,UCBPlayer,41,351,392,0,36,UCBPlayer
638,UCBPlayer,36,371,407,0,31,UCBPlayer
639,UCBPlayer,45,335,380,0,40,UCBPlayer
640,UCBPlayer,36,371,407,0,31,UCBPlayer
641,UCBPlayer,68,313,381,7,42,UCBPlayer
642,UCBPlayer,44,339,383,0,39,UCBPlayer
643,UCBPlayer,74,324,398,9,37,UCBPlayer
644,UCBPlayer,41,371,412,2,30,UCBPlayer
645,UCBPlayer,49,354,403,2,33,UCBPlayer
646,UCBPlayer,48,348,396,1,35,UCBPlayer
647,UCBPlayer,53,303,356,0,48,UCBPlayer
648,UCBPlayer,45,345,390,1,37,UCBPlayer
649,UCBPlayer,44,349,393,1,36,UCBPlayer
650,UCBPlayer,40,370,410,3,31,UCBPlayer
651,UCBPlayer,38,393,431,3,24,UCBPlayer
652,UCBPlayer,57,327,384,4,40,UCBPlayer
653,UCBPlayer,37,367,404,0,32,UCBPlayer
654,UCBPlayer,43,343,386,0,38,UCBPlayer
655,UCBPlayer,38,363,401,0,33,UCBPlayer
656,UCBPlayer,30,395,425,0,25,UCBPlayer
657,UCBPlayer,41,351,392,0,36,UCBPlayer
658,UCBPlayer,45,335,380,0,40,UCBPlayer
659,UCBPlayer,37,367,404,0,32,UCBPlayer
660,UCBPlayer,44,334,378,1,41,UCBPlayer
661,UCBPlayer,39,369,408,1,31,UCBPlayer
662,UCBPlayer,36,371,407,0,31,UCBPlayer
663,UCBPlayer,44,349,393,1,36,UCBPlayer
664,UCBPlayer,53,343,396,4,36,UCBPlayer
665,UCBPlayer,74,324,398,6,36,UCBPlayer
666,UCBPlayer,46,361,407,3,32,UCBPlayer
667,UCBPlayer,40,395,435,4,23,UCBPlayer
668,UCBPlayer,34,379,413,0,29,UCBPlayer
669,UCBPlayer,42,347,389,0,37,UCBPlayer
670,UCBPlayer,36,371,407,0,31,UCBPlayer
671,UCBPlayer,41,371,412,2,30,UCBPlayer
672,UCBPlayer,43,343,386,0,38,UCBPlayer
673,UCBPlayer,64,344,408,7,33,UCBPlayer
674,UCBPlayer,40,365,405,1,32,UCBPlayer
675,UCBPlayer,44,339,383,0,39,UCBPlayer
676,UCBPlayer,61,326,387,4,39,UCBPlayer
677,UCBPlayer,37,377,414,1,29,UCBPlayer
678,UCBPlayer,46,341,387,1,38,UCBPlayer
679,UCBPlayer,45,335,380,0,40,UCBPlayer
680,UCBPlayer,238,248,486,46,20,UCBPlayer
681,UCBPlayer,153,308,461,18,19,UCBPlayer
682,UCBPlayer,58,318,376,2,42,UCBPlayer
683,UCBPlayer,117,312,429,19,30,UCBPlayer
684,UCBPlayer,38,363,401,0,33,UCBPlayer
685,UCBPlayer,45,355,400,2,34,UCBPlayer
686,UCBPlayer,50,340,390,1,37,UCBPlayer
687,UCBPlayer,40,355,395,0,35,UCBPlayer
688,UCBPlayer,102,307,409,14,35,UCBPlayer
689,UCBPlayer,46,331,377,0,41,UCBPlayer
690,UCBPlayer,40,355,395,0,35,UCBPlayer
691,UCBPlayer,43,353,396,1,35,UCBPlayer
692,UCBPlayer,36,371,407,0,31,UCBPlayer
693,UCBPlayer,42,377,419,3,28,UCBPlayer
694,UCBPlayer,47,327,374,0,42,UCBPlayer
695,UCBPlayer,49,349,398,3,35,UCBPlayer
696,UCBPlayer,36,371,407,0,31,UCBPlayer
697,UCBPlayer,40,365,405,1,32,UCBPlayer
698,UCBPlayer,36,371,407,0,31,UCBPlayer
699,UCBPlayer,57,337,394,5,37,UCBPlayer
700,UCBPlayer,62,282,344,0,52,UCBPlayer
701,UCBPlayer,50,345,395,3,36,UCBPlayer
702,UCBPlayer,50,345,395,3,36,UCBPlayer
703,UCBPlayer,38,363,401,0,33,UCBPlayer
704,UCBPlayer,40,355,395,0,35,UCBPlayer
705,UCBPlayer,49,339,388,2,38,UCBPlayer
706,UCBPlayer,86,321,407,12,35,UCBPlayer
707,UCBPlayer,90,305,395,9,38,UCBPlayer
708,UCBPlayer,100,330,430,14,28,UCBPlayer
709,UCBPlayer,38,363,401,0,33,UCBPlayer
710,UCBPlayer,36,366,402,1,33,UCBPlayer
711,UCBPlayer,56,331,387,4,39,UCBPlayer
712,UCBPlayer,55,350,405,4,33,UCBPlayer
713,UCBPlayer,135,300,435,19,28,UCBPlayer
714,UCBPlayer,50,365,415,5,30,UCBPlayer
715,UCBPlayer,40,355,395,0,35,UCBPlayer
716,UCBPlayer,45,355,400,2,34,UCBPlayer
717,UCBPlayer,42,367,409,2,31,UCBPlayer
718,UCBPlayer,33,393,426,1,25,UCBPlayer
719,UCBPlayer,56,316,372,1,43,UCBPlayer
720,UCBPlayer,44,394,438,7,23,UCBPlayer
721,UCBPlayer,59,314,373,2,43,UCBPlayer
722,UCBPlayer,35,375,410,0,30,UCBPlayer
723,UCBPlayer,50,315,365,0,45,UCBPlayer
724,UCBPlayer,40,355,395,0,35,UCBPlayer
725,UCBPlayer,60,365,425,9,28,UCBPlayer
726,UCBPlayer,54,344,398,3,35,UCBPlayer
727,UCBPlayer,65,330,395,6,37,UCBPlayer
728,UCBPlayer,35,395,430,2,24,UCBPlayer
729,UCBPlayer,36,371,407,0,31,UCBPlayer
730,UCBPlayer,40,365,405,1,32,UCBPlayer
731,UCBPlayer,109,334,443,18,25,UCBPlayer
732,UCBPlayer,42,347,389,0,37,UCBPlayer
733,UCBPlayer,44,339,383,0,39,UCBPlayer
734,UCBPlayer,43,343,386,0,38,UCBPlayer
735,UCBPlayer,51,311,362,0,46,UCBPlayer
736,UCBPlayer,39,359,398,0,34,UCBPlayer
737,UCBPlayer,48,343,391,2,37,UCBPlayer
738,UCBPlayer,49,349,398,3,35,UCBPlayer
739,UCBPlayer,88,343,431,15,28,UCBPlayer
740,UCBPlayer,41,351,392,0,36,UCBPlayer
741,UCBPlayer,140,300,440,18,26,UCBPlayer
742,UCBPlayer,45,345,390,1,37,UCBPlayer
743,UCBPlayer,108,328,436,17,27,UCBPlayer
744,UCBPlayer,50,335,385,2,39,UCBPlayer
745,UCBPlayer,56,336,392,3,37,UCBPlayer
746,UCBPlayer,37,367,404,0,32,UCBPlayer
747,UCBPlayer,111,286,397,14,39,UCBPlayer
748,UCBPlayer,43,353,396,1,35,UCBPlayer
749,UCBPlayer,65,320,385,5,40,UCBPlayer
750,UCBPlayer,47,337,384,1,39,UCBPlayer
751,UCBPlayer,109,324,433,17,28,UCBPlayer
752,UCBPlayer,42,347,389,0,37,UCBPlayer
753,UCBPlayer,92,287,379,8,43,UCBPlayer
754,UCBPlayer,37,367,404,0,32,UCBPlayer
755,UCBPlayer,43,353,396,1,35,UCBPlayer
756,UCBPlayer,47,337,384,1,39,UCBPlayer
757,UCBPlayer,40,355,395,0,35,UCBPlayer
758,UCBPlayer,42,357,399,1,34,UCBPlayer
759,UCBPlayer,52,347,399,4,35,UCBPlayer
760,UCBPlayer,39,359,398,0,34,UCBPlayer
761,UCBPlayer,46,331,377,0,41,UCBPlayer
762,UCBPlayer,42,357,399,1,34,UCBPlayer
763,UCBPlayer,43,338,381,1,40,UCBPlayer
764,UCBPlayer,69,324,393,7,38,UCBPlayer
765,UCBPlayer,45,345,390,1,37,UCBPlayer
766,UCBPlayer,43,343,386,0,38,UCBPlayer
767,UCBPlayer,39,379,418,2,28,UCBPlayer
768,UCBPlayer,47,347,394,2,36,UCBPlayer
769,UCBPlayer,49,319,368,0,44,UCBPlayer
770,UCBPlayer,44,339,383,0,39,UCBPlayer
771,UCBPlayer,41,351,392,0,36,UCBPlayer
772,UCBPlayer,47,327,374,0,42,UCBPlayer
773,UCBPlayer,205,275,480,34,18,UCBPlayer
774,UCBPlayer,45,355,400,2,34,UCBPlayer
775,UCBPlayer,65,330,395,6,37,UCBPlayer
776,UCBPlayer,50,315,365,0,45,UCBPlayer
777,UCBPlayer,65,330,395,6,37,UCBPlayer
778,UCBPlayer,52,342,394,2,36,UCBPlayer
779,UCBPlayer,61,351,412,5,31,UCBPlayer
780,UCBPlayer,51,311,362,0,46,UCBPlayer
781,UCBPlayer,47,327,374,0,42,UCBPlayer
782,UCBPlayer,39,359,398,0,34,UCBPlayer
783,UCBPlayer,48,353,401,3,34,UCBPlayer
784,UCBPlayer,41,351,392,0,36,UCBPlayer
785,UCBPlayer,49,329,378,1,41,UCBPlayer
786,UCBPlayer,40,365,405,1,32,UCBPlayer
787,UCBPlayer,46,371,417,4,29,UCBPlayer
788,UCBPlayer,99,304,403,11,36,UCBPlayer
789,UCBPlayer,33,383,416,0,28,UCBPlayer
790,UCBPlayer,46,331,377,0,41,UCBPlayer
791,UCBPlayer,59,324,383,3,40,UCBPlayer
792,UCBPlayer,50,325,375,1,42,UCBPlayer
793,UCBPlayer,58,338,396,4,36,UCBPlayer
794,UCBPlayer,48,333,381,1,40,UCBPlayer
795,UCBPlayer,43,343,386,0,38,UCBPlayer
796,UCBPlayer,58,333,391,2,37,UCBPlayer
797,UCBPlayer,42,347,389,0,37,UCBPlayer
798,UCBPlayer,32,387,419,0,27,UCBPlayer
799,UCBPlayer,50,325,375,1,42,UCBPlayer
800,UCBPlayer,46,341,387,1,38,UCBPlayer
801,UCBPlayer,116,321,437,15,26,UCBPlayer
802,UCBPlayer,65,330,395,3,36,UCBPlayer
803,UCBPlayer,57,307,364,2,46,UCBPlayer
804,UCBPlayer,53,358,411,4,31,UCBPlayer
805,UCBPlayer,42,347,389,0,37,UCBPlayer
806,UCBPlayer,44,359,403,2,33,UCBPlayer
807,UCBPlayer,53,343,396,4,36,UCBPlayer
808,UCBPlayer,52,347,399,4,35,UCBPlayer
809,UCBPlayer,69,324,393,7,38,UCBPlayer
810,UCBPlayer,86,326,412,14,34,UCBPlayer
811,UCBPlayer,63,358,421,5,28,UCBPlayer
812,UCBPlayer,42,342,384,1,39,UCBPlayer
813,UCBPlayer,65,290,355,2,49,UCBPlayer
814,UCBPlayer,40,365,405,1,32,UCBPlayer
815,UCBPlayer,40,365,405,1,32,UCBPlayer
816,UCBPlayer,66,326,392,6,38,UCBPlayer
817,UCBPlayer,39,359,398,0,34,UCBPlayer
818,UCBPlayer,31,391,422,0,26,UCBPlayer
819,UCBPlayer,59,334,393,4,37,UCBPlayer
820,UCBPlayer,44,339,383,0,39,UCBPlayer
821,UCBPlayer,62,347,409,8,33,UCBPlayer
822,UCBPlayer,41,351,392,0,36,UCBPlayer
823,UCBPlayer,42,347,389,0,37,UCBPlayer
824,UCBPlayer,41,371,412,2,30,UCBPlayer
825,UCBPlayer,45,345,390,1,37,UCBPlayer
826,UCBPlayer,40,355,395,0,35,UCBPlayer
827,UCBPlayer,41,361,402,1,33,UCBPlayer
828,UCBPlayer,36,381,417,1,28,UCBPlayer
829,UCBPlayer,42,347,389,0,37,UCBPlayer
830,UCBPlayer,36,371,407,0,31,UCBPlayer
831,UCBPlayer,54,334,388,2,38,UCBPlayer
832,UCBPlayer,42,347,389,0,37,UCBPlayer
833,UCBPlayer,55,330,385,2,39,UCBPlayer
834,UCBPlayer,36,381,417,1,28,UCBPlayer
835,UCBPlayer,47,337,384,1,39,UCBPlayer
836,UCBPlayer,53,333,386,3,39,UCBPlayer
837,UCBPlayer,47,362,409,2,31,UCBPlayer
838,UCBPlayer,54,299,353,0,49,UCBPlayer
839,UCBPlayer,53,328,381,1,40,UCBPlayer
840,UCBPlayer,41,361,402,1,33,UCBPlayer
841,UCBPlayer,57,332,389,3,38,UCBPlayer
842,UCBPlayer,42,372,414,4,30,UCBPlayer
843,UCBPlayer,44,354,398,0,34,UCBPlayer
844,UCBPlayer,43,343,386,0,38,UCBPlayer
845,UCBPlayer,49,379,428,3,25,UCBPlayer
846,UCBPlayer,46,341,387,1,38,UCBPlayer
847,UCBPlayer,71,321,392,6,38,UCBPlayer
848,UCBPlayer,44,349,393,1,36,UCBPlayer
849,UCBPlayer,74,289,363,4,47,UCBPlayer
850,UCBPlayer,45,335,380,0,40,UCBPlayer
851,UCBPlayer,44,339,383,0,39,UCBPlayer
852,UCBPlayer,40,355,395,0,35,UCBPlayer
853,UCBPlayer,46,331,377,0,41,UCBPlayer
854,UCBPlayer,49,349,398,3,35,UCBPlayer
855,UCBPlayer,130,255,385,14,43,UCBPlayer
856,UCBPlayer,90,290,380,6,42,UCBPlayer
857,UCBPlayer,46,351,397,2,35,UCBPlayer
858,UCBPlayer,61,336,397,5,36,UCBPlayer
859,UCBPlayer,77,332,409,8,33,UCBPlayer
860,UCBPlayer,275,230,505,47,14,Player A
861,UCBPlayer,63,338,401,6,35,UCBPlayer
862,UCBPlayer,50,330,380,0,40,UCBPlayer
863,UCBPlayer,43,338,381,1,40,UCBPlayer
864,UCBPlayer,61,316,377,3,42,UCBPlayer
865,UCBPlayer,56,331,387,1,38,UCBPlayer
866,UCBPlayer,32,372,404,0,32,UCBPlayer
867,UCBPlayer,49,329,378,1,41,UCBPlayer
868,UCBPlayer,54,324,378,1,41,UCBPlayer
869,UCBPlayer,52,307,359,0,47,UCBPlayer
870,UCBPlayer,45,335,380,0,40,UCBPlayer
871,UCBPlayer,64,344,408,7,33,UCBPlayer
872,UCBPlayer,60,340,400,5,35,UCBPlayer
873,UCBPlayer,41,361,402,1,33,UCBPlayer
874,UCBPlayer,291,211,502,53,17,Player A
875,UCBPlayer,85,290,375,4,43,UCBPlayer
876,UCBPlayer,65,365,430,11,27,UCBPlayer
877,UCBPlayer,75,310,385,5,40,UCBPlayer
878,UCBPlayer,95,310,405,13,36,UCBPlayer
879,UCBPlayer,76,311,387,4,39,UCBPlayer
880,UCBPlayer,37,367,404,0,32,UCBPlayer
881,UCBPlayer,47,337,384,1,39,UCBPlayer
882,UCBPlayer,78,298,376,8,44,UCBPlayer
883,UCBPlayer,44,349,393,1,36,UCBPlayer
884,UCBPlayer,42,347,389,0,37,UCBPlayer
885,UCBPlayer,64,294,358,2,48,UCBPlayer
886,UCBPlayer,41,361,402,1,33,UCBPlayer
887,UCBPlayer,90,325,415,11,32,UCBPlayer
888,UCBPlayer,57,322,379,2,41,UCBPlayer
889,UCBPlayer,50,340,390,1,37,UCBPlayer
890,UCBPlayer,49,319,368,0,44,UCBPlayer
891,UCBPlayer,51,351,402,4,34,UCBPlayer
892,UCBPlayer,44,339,383,0,39,UCBPlayer
893,UCBPlayer,46,351,397,2,35,UCBPlayer
894,UCBPlayer,65,315,380,3,41,UCBPlayer
895,UCBPlayer,41,351,392,0,36,UCBPlayer
896,UCBPlayer,42,347,389,0,37,UCBPlayer
897,UCBPlayer,43,363,406,2,32,UCBPlayer
898,UCBPlayer,36,371,407,0,31,UCBPlayer
899,UCBPlayer,63,318,381,4,41,UCBPlayer
900,UCBPlayer,42,372,414,1,29,UCBPlayer
901,UCBPlayer,43,363,406,2,32,UCBPlayer
902,UCBPlayer,55,330,385,2,39,UCBPlayer
903,UCBPlayer,48,333,381,1,40,UCBPlayer
904,UCBPlayer,48,353,401,3,34,UCBPlayer
905,UCBPlayer,62,302,364,2,46,UCBPlayer
906,UCBPlayer,48,353,401,3,34,UCBPlayer
907,UCBPlayer,62,327,389,6,39,UCBPlayer
908,UCBPlayer,63,318,381,4,41,UCBPlayer
909,UCBPlayer,40,355,395,0,35,UCBPlayer
910,UCBPlayer,49,334,383,3,40,UCBPlayer
911,UCBPlayer,59,319,378,1,41,UCBPlayer
912,UCBPlayer,49,329,378,1,41,UCBPlayer
913,UCBPlayer,52,337,389,3,38,UCBPlayer
914,UCBPlayer,43,363,406,2,32,UCBPlayer
915,UCBPlayer,54,334,388,2,38,UCBPlayer
916,UCBPlayer,55,320,375,1,42,UCBPlayer
917,UCBPlayer,65,310,375,4,43,UCBPlayer
918,UCBPlayer,52,347,399,4,35,UCBPlayer
919,UCBPlayer,53,338,391,2,37,UCBPlayer
920,UCBPlayer,49,319,368,0,44,UCBPlayer
921,UCBPlayer,55,330,385,2,39,UCBPlayer
922,UCBPlayer,48,323,371,0,43,UCBPlayer
923,UCBPlayer,38,373,411,1,30,UCBPlayer
924,UCBPlayer,45,345,390,1,37,UCBPlayer
925,UCBPlayer,130,335,465,25,20,UCBPlayer
926,UCBPlayer,45,335,380,0,40,UCBPlayer
927,UCBPlayer,62,347,409,8,33,UCBPlayer
928,UCBPlayer,52,337,389,3,38,UCBPlayer
929,UCBPlayer,51,326,377,0,41,UCBPlayer
930,UCBPlayer,57,372,429,10,27,UCBPlayer
931,UCBPlayer,50,340,390,1,37,UCBPlayer
932,UCBPlayer,41,351,392,0,36,UCBPlayer
933,UCBPlayer,53,328,381,1,40,UCBPlayer
934,UCBPlayer,50,315,365,0,45,UCBPlayer
935,UCBPlayer,45,345,390,1,37,UCBPlayer
936,UCBPlayer,39,359,398,0,34,UCBPlayer
937,UCBPlayer,74,349,423,7,28,UCBPlayer
938,UCBPlayer,66,306,372,4,44,UCBPlayer
939,UCBPlayer,59,334,393,4,37,UCBPlayer
940,UCBPlayer,35,375,410,0,30,UCBPlayer
941,UCBPlayer,52,357,409,5,32,UCBPlayer
942,UCBPlayer,40,365,405,1,32,UCBPlayer
943,UCBPlayer,69,304,373,5,44,UCBPlayer
944,UCBPlayer,39,359,398,0,34,UCBPlayer
945,UCBPlayer,45,335,380,0,40,UCBPlayer
946,UCBPlayer,45,335,380,0,40,UCBPlayer
947,UCBPlayer,58,318,376,2,42,UCBPlayer
948,UCBPlayer,37,367,404,0,32,UCBPlayer
949,UCBPlayer,68,338,406,8,34,UCBPlayer
950,UCBPlayer,63,313,376,2,42,UCBPlayer
951,UCBPlayer,101,296,397,17,40,UCBPlayer
952,UCBPlayer,59,349,408,7,33,UCBPlayer
953,UCBPlayer,49,344,393,1,36,UCBPlayer
954,UCBPlayer,40,365,405,1,32,UCBPlayer
955,UCBPlayer,78,353,431,9,26,UCBPlayer
956,UCBPlayer,43,343,386,0,38,UCBPlayer
957,UCBPlayer,46,331,377,0,41,UCBPlayer
958,UCBPlayer,63,328,391,5,38,UCBPlayer
959,UCBPlayer,44,339,383,0,39,UCBPlayer
960,UCBPlayer,54,334,388,2,38,UCBPlayer
961,UCBPlayer,47,327,374,0,42,UCBPlayer
962,UCBPlayer,49,329,378,1,41,UCBPlayer
963,UCBPlayer,61,321,382,2,40,UCBPlayer
964,UCBPlayer,39,374,413,3,30,UCBPlayer
965,UCBPlayer,44,364,408,1,31,UCBPlayer
966,UCBPlayer,52,312,364,2,46,UCBPlayer
967,UCBPlayer,42,367,409,2,31,UCBPlayer
968,UCBPlayer,58,328,386,3,39,UCBPlayer
969,UCBPlayer,73,318,391,8,39,UCBPlayer
970,UCBPlayer,47,327,374,0,42,UCBPlayer
971,UCBPlayer,42,347,389,0,37,UCBPlayer
972,UCBPlayer,53,303,356,0,48,UCBPlayer
973,UCBPlayer,43,363,406,2,32,UCBPlayer
974,UCBPlayer,84,324,408,10,34,UCBPlayer
975,UCBPlayer,36,371,407,0,31,UCBPlayer
976,UCBPlayer,88,333,421,11,30,UCBPlayer
977,UCBPlayer,37,367,404,0,32,UCBPlayer
978,UCBPlayer,49,319,368,0,44,UCBPlayer
979,UCBPlayer,42,347,389,0,37,UCBPlayer
980,UCBPlayer,38,363,401,0,33,UCBPlayer
981,UCBPlayer,86,331,417,10,31,UCBPlayer
982,UCBPlayer,48,343,391,2,37,UCBPlayer
983,UCBPlayer,50,330,380,0,40,UCBPlayer
984,UCBPlayer,43,353,396,1,35,UCBPlayer
985,UCBPlayer,44,349,393,1,36,UCBPlayer
986,UCBPlayer,65,325,390,4,38,UCBPlayer
987,UCBPlayer,36,381,417,1,28,UCBPlayer
988,UCBPlayer,63,328,391,5,38,UCBPlayer
989,UCBPlayer,38,363,401,0,33,UCBPlayer
990,UCBPlayer,51,331,382,2,40,UCBPlayer
991,UCBPlayer,55,330,385,2,39,UCBPlayer
992,UCBPlayer,51,336,387,1,38,UCBPlayer
993,UCBPlayer,61,331,392,6,38,UCBPlayer
994,UCBPlayer,44,339,383,0,39,UCBPlayer
995,UCBPlayer,38,363,401,0,33,UCBPlayer
996,UCBPlayer,46,331,377,0,41,UCBPlayer
997,UCBPlayer,54,309,363,1,46,UCBPlayer
998,UCBPlayer,56,346,402,4,34,UCBPlayer
999,UCBPlayer,47,327,374,0,42,UCBPlayer
1000,UCBPlayer,56,331,387,4,39,UCBPlayer
1001,UCBPlayer,49,339,388,2,38,UCBPlayer
1002,UCBPlayer,65,330,395,6,37,UCBPlayer
1003,UCBPlayer,63,348,411,7,32,UCBPlayer
1004,UCBPlayer,46,331,377,0,41,UCBPlayer
1005,UCBPlayer,50,325,375,1,42,UCBPlayer
1006,UCBPlayer,84,299,383,6,41,UCBPlayer
1007,UCBPlayer,66,336,402,4,34,UCBPlayer
1008,UCBPlayer,56,341,397,5,36,UCBPlayer
1009,UCBPlayer,51,326,377,0,41,UCBPlayer
1010,UCBPlayer,45,345,390,1,37,UCBPlayer
1011,UCBPlayer,50,330,380,0,40,UCBPlayer
1012,UCBPlayer,66,306,372,4,44,UCBPlayer
1013,UCBPlayer,42,347,389,0,37,UCBPlayer
1014,UCBPlayer,45,340,385,2,39,UCBPlayer
1015,UCBPlayer,58,353,411,7,32,UCBPlayer
1016,UCBPlayer,79,304,383,9,42,UCBPlayer
1017,UCBPlayer,67,327,394,2,36,UCBPlayer
1018,UCBPlayer,38,358,396,1,35,UCBPlayer
1019,UCBPlayer,43,343,386,0,38,UCBPlayer
1020,UCBPlayer,70,305,375,4,43,UCBPlayer
1021,UCBPlayer,345,195,540,61,7,Player A
1022,UCBPlayer,60,330,390,4,38,UCBPlayer
1023,UCBPlayer,47,327,374,0,42,UCBPlayer
1024,UCBPlayer,41,351,392,0,36,UCBPlayer
1025,UCBPlayer,42,347,389,0,37,UCBPlayer
1026,UCBPlayer,54,329,383,3,40,UCBPlayer
1027,UCBPlayer,52,322,374,0,42,UCBPlayer
1028,UCBPlayer,47,337,384,1,39,UCBPlayer
1029,UCBPlayer,32,387,419,0,27,UCBPlayer
1030,UCBPlayer,40,375,415,2,29,UCBPlayer
1031,UCBPlayer,72,292,364,5,47,UCBPlayer
1032,UCBPlayer,83,333,416,9,31,UCBPlayer
1033,UCBPlayer,51,351,402,4,34,UCBPlayer
1034,UCBPlayer,35,375,410,0,30,UCBPlayer
1035,UCBPlayer,38,363,401,0,33,UCBPlayer
1036,UCBPlayer,45,345,390,1,37,UCBPlayer
1037,UCBPlayer,49,319,368,0,44,UCBPlayer
1038,UCBPlayer,66,306,372,4,44,UCBPlayer
1039,UCBPlayer,94,289,383,6,41,UCBPlayer
1040,UCBPlayer,60,320,380,3,41,UCBPlayer
1041,UCBPlayer,32,387,419,0,27,UCBPlayer
1042,UCBPlayer,47,337,384,1,39,UCBPlayer
1043,UCBPlayer,34,389,423,1,26,UCBPlayer
1044,UCBPlayer,61,341,402,7,35,UCBPlayer
1045,UCBPlayer,46,371,417,4,29,UCBPlayer
1046,UCBPlayer,43,353,396,1,35,UCBPlayer
1047,UCBPlayer,55,330,385,2,39,UCBPlayer
1048,UCBPlayer,43,343,386,0,38,UCBPlayer
1049,UCBPlayer,53,323,376,2,42,UCBPlayer
1050,UCBPlayer,58,318,376,2,42,UCBPlayer
1051,UCBPlayer,47,327,374,0,42,UCBPlayer
1052,UCBPlayer,54,359,413,6,31,UCBPlayer
1053,UCBPlayer,54,319,373,2,43,UCBPlayer
1054,UCBPlayer,56,316,372,1,43,UCBPlayer
1055,UCBPlayer,60,315,375,4,43,UCBPlayer
1056,UCBPlayer,62,352,414,7,31,UCBPlayer
1057,UCBPlayer,54,299,353,0,49,UCBPlayer
1058,UCBPlayer,58,293,351,1,50,UCBPlayer
1059,UCBPlayer,56,341,397,5,36,UCBPlayer
1060,UCBPlayer,103,283,386,12,42,UCBPlayer
1061,UCBPlayer,50,335,385,2,39,UCBPlayer
1062,UCBPlayer,71,316,387,7,40,UCBPlayer
1063,UCBPlayer,43,343,386,0,38,UCBPlayer
1064,UCBPlayer,48,323,371,0,43,UCBPlayer
1065,UCBPlayer,38,363,401,0,33,UCBPlayer
1066,UCBPlayer,44,354,398,3,35,UCBPlayer
1067,UCBPlayer,58,338,396,4,36,UCBPlayer
1068,UCBPlayer,57,312,369,1,44,UCBPlayer
1069,UCBPlayer,43,338,381,1,40,UCBPlayer
1070,UCBPlayer,72,327,399,7,36,UCBPlayer
1071,UCBPlayer,49,319,368,0,44,UCBPlayer
1072,UCBPlayer,68,308,376,5,43,UCBPlayer
1073,UCBPlayer,43,353,396,1,35,UCBPlayer
1074,UCBPlayer,131,311,442,23,27,UCBPlayer
1075,UCBPlayer,46,331,377,0,41,UCBPlayer
1076,UCBPlayer,52,347,399,4,35,UCBPlayer
1077,UCBPlayer,54,324,378,1,41,UCBPlayer
1078,UCBPlayer,62,302,364,2,46,UCBPlayer
1079,UCBPlayer,49,369,418,2,28,UCBPlayer
1080,UCBPlayer,44,339,383,0,39,UCBPlayer
1081,UCBPlayer,44,339,383,0,39,UCBPlayer
1082,UCBPlayer,66,316,382,5,41,UCBPlayer
1083,UCBPlayer,68,328,396,7,37,UCBPlayer
1084,UCBPlayer,71,281,352,2,50,UCBPlayer
1085,UCBPlayer,48,363,411,4,31,UCBPlayer
1086,UCBPlayer,39,359,398,0,34,UCBPlayer
1087,UCBPlayer,46,331,377,0,41,UCBPlayer
1088,UCBPlayer,48,323,371,0,43,UCBPlayer
1089,UCBPlayer,50,340,390,1,37,UCBPlayer
1090,UCBPlayer,54,339,393,4,37,UCBPlayer
1091,UCBPlayer,67,307,374,3,43,UCBPlayer
1092,UCBPlayer,43,343,386,0,38,UCBPlayer
0,JointPQPlayer,181,266,447,22,25,JointPQPlayer
1,JointPQPlayer,133,313,446,12,22,JointPQPlayer
2,JointPQPlayer,298,178,476,36,20,Player A
3,JointPQPlayer,256,231,487,32,15,Player A
4,JointPQPlayer,251,246,497,36,13,Player A
5,JointPQPlayer,126,321,447,16,23,JointPQPlayer
6,JointPQPlayer,113,303,416,12,32,JointPQPlayer
7,JointPQPlayer,253,258,511,50,13,JointPQPlayer
8,JointPQPlayer,271,226,497,30,11,Player A
9,JointPQPlayer,252,247,499,35,12,Player A
10,JointPQPlayer,287,222,509,39,10,Player A
11,JointPQPlayer,272,237,509,42,11,Player A
12,JointPQPlayer,244,254,498,37,13,JointPQPlayer
13,JointPQPlayer,270,220,490,38,16,Player A
14,JointPQPlayer,294,184,478,29,17,Player A
15,JointPQPlayer,303,213,516,40,8,Player A
16,JointPQPlayer,252,257,509,39,10,JointPQPlayer
17,JointPQPlayer,277,217,494,36,14,Player A
18,JointPQPlayer,161,296,457,29,24,JointPQPlayer
19,JointPQPlayer,147,262,409,17,36,JointPQPlayer
20,JointPQPlayer,278,188,466,29,21,Player A
21,JointPQPlayer,115,315,430,11,27,JointPQPlayer
22,JointPQPlayer,272,242,514,41,9,Player A
23,JointPQPlayer,268,243,511,44,11,Player A
24,JointPQPlayer,122,307,429,13,28,JointPQPlayer
25,JointPQPlayer,277,227,504,43,13,Player A
26,JointPQPlayer,128,323,451,20,23,JointPQPlayer
27,JointPQPlayer,255,255,510,43,11,Tie
28,JointPQPlayer,274,229,503,45,14,Player A
29,JointPQPlayer,280,200,480,34,18,Player A
30,JointPQPlayer,269,224,493,35,14,Player A
31,JointPQPlayer,165,290,455,21,22,JointPQPlayer
32,JointPQPlayer,257,252,509,42,11,Player A
33,JointPQPlayer,276,211,487,35,16,Player A
34,JointPQPlayer,314,209,523,44,7,Player A
35,JointPQPlayer,187,272,459,22,21,JointPQPlayer
36,JointPQPlayer,270,225,495,40,15,Player A
37,JointPQPlayer,297,197,494,42,16,Player A
38,JointPQPlayer,253,228,481,32,17,Player A
39,JointPQPlayer,266,236,502,41,13,Player A
40,JointPQPlayer,264,239,503,42,13,Player A
41,JointPQPlayer,278,223,501,40,13,Player A
42,JointPQPlayer,128,288,416,15,33,JointPQPlayer
43,JointPQPlayer,263,238,501,31,10,Player A
44,JointPQPlayer,267,232,499,41,14,Player A
45,JointPQPlayer,257,222,479,39,20,Player A
46,JointPQPlayer,131,306,437,18,27,JointPQPlayer
47,JointPQPlayer,289,214,503,42,13,Player A
48,JointPQPlayer,138,293,431,15,28,JointPQPlayer
49,JointPQPlayer,250,230,480,34,18,Player A
50,JointPQPlayer,260,240,500,33,11,Player A
51,JointPQPlayer,239,229,468,31,21,Player A
52,JointPQPlayer,269,219,488,39,17,Player A
53,JointPQPlayer,249,254,503,42,13,JointPQPlayer
54,JointPQPlayer,259,239,498,43,15,Player A
55,JointPQPlayer,294,229,523,50,9,Player A
56,JointPQPlayer,262,242,504,40,12,Player A
57,JointPQPlayer,193,273,466,29,21,JointPQPlayer
58,JointPQPlayer,146,321,467,27,20,JointPQPlayer
59,JointPQPlayer,179,279,458,30,24,JointPQPlayer
60,JointPQPlayer,253,243,496,38,14,Player A
61,JointPQPlayer,275,240,515,45,10,Player A
62,JointPQPlayer,136,311,447,19,24,JointPQPlayer
63,JointPQPlayer,301,201,502,38,12,Player A
64,JointPQPlayer,118,308,426,13,29,JointPQPlayer
65,JointPQPlayer,266,246,512,45,11,Player A
66,JointPQPlayer,280,220,500,42,14,Player A
67,JointPQPlayer,276,236,512,48,12,Player A
68,JointPQPlayer,131,291,422,15,31,JointPQPlayer
69,JointPQPlayer,253,223,476,36,20,Player A
70,JointPQPlayer,276,216,492,37,15,Player A
71,JointPQPlayer,279,229,508,50,14,Player A
72,JointPQPlayer,301,206,507,46,13,Player A
73,JointPQPlayer,149,309,458,18,20,JointPQPlayer
74,JointPQPlayer,281,221,502,35,11,Player A
75,JointPQPlayer,260,240,500,36,12,Player A
76,JointPQPlayer,124,304,428,12,28,JointPQPlayer
77,JointPQPlayer,256,241,497,33,12,Player A
78,JointPQPlayer,244,279,523,50,9,JointPQPlayer
79,JointPQPlayer,161,276,437,12,25,JointPQPlayer
80,JointPQPlayer,280,245,525,52,9,Player A
81,JointPQPlayer,257,237,494,42,16,Player A
82,JointPQPlayer,280,215,495,40,15,Player A
83,JointPQPlayer,265,230,495,40,15,Player A
84,JointPQPlayer,242,252,494,39,15,JointPQPlayer
85,JointPQPlayer,271,231,502,41,13,Player A
86,JointPQPlayer,275,210,485,36,17,Player A
87,JointPQPlayer,243,248,491,27,12,JointPQPlayer
88,JointPQPlayer,233,248,481,41,20,JointPQPlayer
89,JointPQPlayer,281,226,507,43,12,Player A
90,JointPQPlayer,155,295,450,22,24,JointPQPlayer
91,JointPQPlayer,201,261,462,22,20,JointPQPlayer
92,JointPQPlayer,174,239,413,12,33,JointPQPlayer
93,JointPQPlayer,263,213,476,36,20,Player A
94,JointPQPlayer,275,225,500,42,14,Player A
95,JointPQPlayer,282,227,509,42,11,Player A
96,JointPQPlayer,262,237,499,38,13,Player A
97,JointPQPlayer,263,248,511,41,10,Player A
98,JointPQPlayer,263,223,486,43,19,Player A
99,JointPQPlayer,234,254,488,36,16,JointPQPlayer
100,JointPQPlayer,286,236,522,52,10,Player A
101,JointPQPlayer,263,233,496,41,15,Player A
102,JointPQPlayer,286,236,522,49,9,Player A
103,JointPQPlayer,215,255,470,30,20,JointPQPlayer
104,JointPQPlayer,119,344,463,20,19,JointPQPlayer
105,JointPQPlayer,294,204,498,37,13,Player A
106,JointPQPlayer,175,295,470,27,19,JointPQPlayer
107,JointPQPlayer,275,235,510,37,9,Player A
108,JointPQPlayer,194,249,443,30,29,JointPQPlayer
109,JointPQPlayer,257,257,514,38,8,Tie
110,JointPQPlayer,128,293,421,14,31,JointPQPlayer
111,JointPQPlayer,302,192,494,33,13,Player A
112,JointPQPlayer,310,200,510,40,10,Player A
113,JointPQPlayer,277,237,514,44,10,Player A
114,JointPQPlayer,255,240,495,34,13,Player A
115,JointPQPlayer,284,219,503,36,11,Player A
116,JointPQPlayer,260,230,490,35,15,Player A
117,JointPQPlayer,263,233,496,41,15,Player A
118,JointPQPlayer,259,244,503,42,13,Player A
119,JointPQPlayer,139,264,403,14,37,JointPQPlayer
120,JointPQPlayer,246,241,487,47,20,Player A
121,JointPQPlayer,237,272,509,42,11,JointPQPlayer
122,JointPQPlayer,248,263,511,50,13,JointPQPlayer
123,JointPQPlayer,316,201,517,41,8,Player A
124,JointPQPlayer,268,228,496,44,16,Player A
125,JointPQPlayer,277,252,529,44,5,Player A
126,JointPQPlayer,216,286,502,32,10,JointPQPlayer
127,JointPQPlayer,257,202,459,28,23,Player A
128,JointPQPlayer,135,310,445,20,25,JointPQPlayer
129,JointPQPlayer,289,204,493,35,14,Player A
130,JointPQPlayer,279,204,483,37,18,Player A
131,JointPQPlayer,244,239,483,34,17,Player A
132,JointPQPlayer,261,271,532,53,7,JointPQPlayer
133,JointPQPlayer,254,244,498,40,14,Player A
134,JointPQPlayer,271,246,517,47,10,Player A
135,JointPQPlayer,284,239,523,44,7,Player A
136,JointPQPlayer,273,253,526,47,7,Player A
137,JointPQPlayer,304,209,513,40,9,Player A
138,JointPQPlayer,276,221,497,39,14,Player A
139,JointPQPlayer,288,233,521,45,8,Player A
140,JointPQPlayer,267,252,519,43,8,Player A
141,JointPQPlayer,300,215,515,45,10,Player A
142,JointPQPlayer,153,283,436,26,30,JointPQPlayer
143,JointPQPlayer,283,213,496,38,14,Player A
144,JointPQPlayer,239,234,473,33,20,Player A
145,JointPQPlayer,259,249,508,41,11,Player A
146,JointPQPlayer,223,268,491,39,16,JointPQPlayer
147,JointPQPlayer,235,230,465,34,23,Player A
148,JointPQPlayer,254,249,503,45,14,Player A
149,JointPQPlayer,271,246,517,47,10,Player A
150,JointPQPlayer,291,211,502,44,14,Player A
151,JointPQPlayer,127,312,439,17,26,JointPQPlayer
152,JointPQPlayer,147,262,409,14,35,JointPQPlayer
153,JointPQPlayer,150,290,440,18,26,JointPQPlayer
154,JointPQPlayer,247,242,489,37,16,Player A
155,JointPQPlayer,251,251,502,41,13,Tie
156,JointPQPlayer,158,283,441,19,26,JointPQPlayer
157,JointPQPlayer,221,266,487,26,13,JointPQPlayer
158,JointPQPlayer,255,245,500,39,13,Player A
159,JointPQPlayer,266,261,527,48,7,Player A
160,JointPQPlayer,300,210,510,43,11,Player A
161,JointPQPlayer,290,215,505,41,12,Player A
162,JointPQPlayer,147,302,449,21,24,JointPQPlayer
163,JointPQPlayer,125,310,435,22,29,JointPQPlayer
164,JointPQPlayer,297,212,509,42,11,Player A
165,JointPQPlayer,223,248,471,28,19,JointPQPlayer
166,JointPQPlayer,306,201,507,40,11,Player A
167,JointPQPlayer,308,208,516,43,9,Player A
168,JointPQPlayer,199,264,463,29,22,JointPQPlayer
169,JointPQPlayer,277,222,499,41,14,Player A
170,JointPQPlayer,281,221,502,44,14,Player A
171,JointPQPlayer,250,255,505,38,11,JointPQPlayer
172,JointPQPlayer,113,308,421,11,30,JointPQPlayer
173,JointPQPlayer,131,286,417,16,33,JointPQPlayer
174,JointPQPlayer,146,321,467,24,19,JointPQPlayer
175,JointPQPlayer,119,309,428,15,29,JointPQPlayer
176,JointPQPlayer,267,232,499,38,13,Player A
177,JointPQPlayer,143,278,421,20,33,JointPQPlayer
178,JointPQPlayer,303,218,521,48,9,Player A
179,JointPQPlayer,290,220,510,49,13,Player A
180,JointPQPlayer,104,329,433,11,26,JointPQPlayer
181,JointPQPlayer,275,235,510,43,11,Player A
182,JointPQPlayer,146,276,422,12,30,JointPQPlayer
183,JointPQPlayer,280,225,505,41,12,Player A
184,JointPQPlayer,250,230,480,28,16,Player A
185,JointPQPlayer,239,224,463,35,24,Player A
186,JointPQPlayer,275,235,510,40,10,Player A
187,JointPQPlayer,237,232,469,32,21,Player A
188,JointPQPlayer,141,296,437,21,28,JointPQPlayer
189,JointPQPlayer,288,223,511,35,8,Player A
190,JointPQPlayer,167,267,434,21,29,JointPQPlayer
191,JointPQPlayer,255,240,495,37,14,Player A
192,JointPQPlayer,119,319,438,16,26,JointPQPlayer
193,JointPQPlayer,117,302,419,12,31,JointPQPlayer
194,JointPQPlayer,211,276,487,35,16,JointPQPlayer
195,JointPQPlayer,131,291,422,15,31,JointPQPlayer
196,JointPQPlayer,156,266,422,15,31,JointPQPlayer
197,JointPQPlayer,279,234,513,40,9,Player A
198,JointPQPlayer,281,226,507,46,13,Player A
199,JointPQPlayer,266,231,497,36,13,Player A
200,JointPQPlayer,282,222,504,40,12,Player A
201,JointPQPlayer,283,208,491,39,16,Player A
202,JointPQPlayer,278,223,501,40,13,Player A
203,JointPQPlayer,279,224,503,42,13,Player A
204,JointPQPlayer,272,222,494,39,15,Player A
205,JointPQPlayer,118,308,426,13,29,JointPQPlayer
206,JointPQPlayer,251,246,497,45,16,Player A
207,JointPQPlayer,130,315,445,20,25,JointPQPlayer
208,JointPQPlayer,142,322,464,21,19,JointPQPlayer
209,JointPQPlayer,222,267,489,37,16,JointPQPlayer
210,JointPQPlayer,123,308,431,15,28,JointPQPlayer
211,JointPQPlayer,253,243,496,38,14,Player A
212,JointPQPlayer,286,221,507,43,12,Player A
213,JointPQPlayer,168,248,416,15,33,JointPQPlayer
214,JointPQPlayer,117,292,409,14,35,JointPQPlayer
215,JointPQPlayer,294,224,518,48,10,Player A
216,JointPQPlayer,289,244,533,48,5,Player A
217,JointPQPlayer,143,293,436,20,28,JointPQPlayer
218,JointPQPlayer,289,224,513,40,9,Player A
219,JointPQPlayer,282,212,494,42,16,Player A
220,JointPQPlayer,253,253,506,48,14,Tie
221,JointPQPlayer,211,261,472,32,20,JointPQPlayer
222,JointPQPlayer,273,223,496,47,17,Player A
223,JointPQPlayer,291,211,502,41,13,Player A
224,JointPQPlayer,299,219,518,45,9,Player A
225,JointPQPlayer,153,278,431,15,28,JointPQPlayer
226,JointPQPlayer,257,227,484,41,19,Player A
227,JointPQPlayer,273,228,501,34,11,Player A
228,JointPQPlayer,248,233,481,35,18,Player A
229,JointPQPlayer,273,238,511,38,9,Player A
230,JointPQPlayer,149,284,433,14,27,JointPQPlayer
231,JointPQPlayer,164,274,438,22,28,JointPQPlayer
232,JointPQPlayer,294,234,528,46,6,Player A
233,JointPQPlayer,298,218,516,34,6,Player A
234,JointPQPlayer,129,314,443,18,25,JointPQPlayer
235,JointPQPlayer,179,284,463,17,18,JointPQPlayer
236,JointPQPlayer,240,230,470,42,24,Player A
237,JointPQPlayer,126,306,432,16,28,JointPQPlayer
238,JointPQPlayer,270,205,475,32,19,Player A
239,JointPQPlayer,285,200,485,36,17,Player A
240,JointPQPlayer,301,221,522,43,7,Player A
241,JointPQPlayer,275,220,495,37,14,Player A
242,JointPQPlayer,259,244,503,42,13,Player A
243,JointPQPlayer,300,210,510,43,11,Player A
244,JointPQPlayer,244,259,503,42,13,JointPQPlayer
245,JointPQPlayer,259,244,503,36,11,Player A
246,JointPQPlayer,250,265,515,42,9,JointPQPlayer
247,JointPQPlayer,290,210,500,39,13,Player A
248,JointPQPlayer,298,213,511,47,12,Player A
249,JointPQPlayer,284,239,523,41,6,Player A
250,JointPQPlayer,275,230,505,38,11,Player A
251,JointPQPlayer,280,230,510,40,10,Player A
252,JointPQPlayer,178,293,471,22,17,JointPQPlayer
253,JointPQPlayer,316,196,512,42,10,Player A
254,JointPQPlayer,267,232,499,41,14,Player A
255,JointPQPlayer,139,289,428,15,29,JointPQPlayer
256,JointPQPlayer,249,224,473,33,20,Player A
257,JointPQPlayer,276,226,502,35,11,Player A
258,JointPQPlayer,261,236,497,36,13,Player A
259,JointPQPlayer,276,221,497,39,14,Player A
260,JointPQPlayer,120,320,440,18,26,JointPQPlayer
261,JointPQPlayer,246,231,477,37,20,Player A
262,JointPQPlayer,234,254,488,30,14,JointPQPlayer
263,JointPQPlayer,135,275,410,21,37,JointPQPlayer
264,JointPQPlayer,297,217,514,41,9,Player A
265,JointPQPlayer,311,191,502,41,13,Player A
266,JointPQPlayer,250,270,520,44,8,JointPQPlayer
267,JointPQPlayer,291,221,512,42,10,Player A
268,JointPQPlayer,282,217,499,38,13,Player A
269,JointPQPlayer,138,293,431,18,29,JointPQPlayer
270,JointPQPlayer,266,211,477,34,19,Player A
271,JointPQPlayer,278,208,486,37,17,Player A
272,JointPQPlayer,226,246,472,32,20,JointPQPlayer
273,JointPQPlayer,314,199,513,40,9,Player A
274,JointPQPlayer,296,206,502,38,12,Player A
275,JointPQPlayer,282,217,499,38,13,Player A
276,JointPQPlayer,280,220,500,33,11,Player A
277,JointPQPlayer,288,213,501,40,13,Player A
278,JointPQPlayer,260,225,485,36,17,Player A
279,JointPQPlayer,250,245,495,40,15,Player A
280,JointPQPlayer,267,232,499,38,13,Player A
281,JointPQPlayer,137,307,444,22,26,JointPQPlayer
282,JointPQPlayer,150,265,415,14,33,JointPQPlayer
283,JointPQPlayer,278,223,501,37,12,Player A
284,JointPQPlayer,267,242,509,48,13,Player A
285,JointPQPlayer,224,259,483,31,16,JointPQPlayer
286,JointPQPlayer,257,237,494,48,18,Player A
287,JointPQPlayer,294,219,513,46,11,Player A
288,JointPQPlayer,131,276,407,18,37,JointPQPlayer
289,JointPQPlayer,137,297,434,21,29,JointPQPlayer
290,JointPQPlayer,267,237,504,40,12,Player A
291,JointPQPlayer,273,253,526,38,4,Player A
292,JointPQPlayer,288,218,506,42,12,Player A
293,JointPQPlayer,286,211,497,39,14,Player A
294,JointPQPlayer,283,223,506,33,9,Player A
295,JointPQPlayer,143,318,461,18,19,JointPQPlayer
296,JointPQPlayer,125,310,435,19,28,JointPQPlayer
297,JointPQPlayer,269,249,518,48,10,Player A
298,JointPQPlayer,290,230,520,44,8,Player A
299,JointPQPlayer,263,228,491,33,14,Player A
300,JointPQPlayer,228,263,491,42,17,JointPQPlayer
301,JointPQPlayer,262,217,479,36,19,Player A
302,JointPQPlayer,284,219,503,36,11,Player A
303,JointPQPlayer,116,281,397,14,39,JointPQPlayer
304,JointPQPlayer,258,253,511,44,11,Player A
305,JointPQPlayer,214,269,483,22,13,JointPQPlayer
306,JointPQPlayer,145,305,450,13,21,JointPQPlayer
307,JointPQPlayer,281,241,522,49,9,Player A
308,JointPQPlayer,128,318,446,18,24,JointPQPlayer
309,JointPQPlayer,288,213,501,40,13,Player A
310,JointPQPlayer,140,255,395,9,38,JointPQPlayer
311,JointPQPlayer,247,252,499,38,13,JointPQPlayer
312,JointPQPlayer,151,291,442,20,26,JointPQPlayer
313,JointPQPlayer,295,205,500,39,13,Player A
314,JointPQPlayer,267,227,494,36,14,Player A
315,JointPQPlayer,169,274,443,27,28,JointPQPlayer
316,JointPQPlayer,263,233,496,44,16,Player A
317,JointPQPlayer,288,213,501,43,14,Player A
318,JointPQPlayer,238,258,496,35,13,JointPQPlayer
319,JointPQPlayer,270,240,510,46,12,Player A
320,JointPQPlayer,216,266,482,36,18,JointPQPlayer
321,JointPQPlayer,239,244,483,37,18,JointPQPlayer
322,JointPQPlayer,243,248,491,42,17,JointPQPlayer
323,JointPQPlayer,294,209,503,39,12,Player A
324,JointPQPlayer,296,226,522,40,6,Player A
325,JointPQPlayer,285,210,495,34,13,Player A
326,JointPQPlayer,242,262,504,40,12,JointPQPlayer
327,JointPQPlayer,247,237,484,29,15,Player A
328,JointPQPlayer,243,243,486,34,16,Tie
329,JointPQPlayer,270,225,495,37,14,Player A
330,JointPQPlayer,284,214,498,37,13,Player A
331,JointPQPlayer,292,227,519,43,8,Player A
332,JointPQPlayer,284,244,528,52,8,Player A
333,JointPQPlayer,269,229,498,40,14,Player A
334,JointPQPlayer,274,224,498,43,15,Player A
335,JointPQPlayer,225,235,460,29,23,JointPQPlayer
336,JointPQPlayer,119,294,413,15,34,JointPQPlayer
337,JointPQPlayer,285,235,520,44,8,Player A
338,JointPQPlayer,263,223,486,34,16,Player A
339,JointPQPlayer,256,211,467,36,23,Player A
340,JointPQPlayer,265,245,510,43,11,Player A
341,JointPQPlayer,289,234,523,47,8,Player A
342,JointPQPlayer,152,272,424,14,30,JointPQPlayer
343,JointPQPlayer,242,252,494,36,14,JointPQPlayer
344,JointPQPlayer,116,316,432,13,27,JointPQPlayer
345,JointPQPlayer,149,319,468,22,18,JointPQPlayer
346,JointPQPlayer,129,304,433,17,28,JointPQPlayer
347,JointPQPlayer,282,252,534,49,5,Player A
348,JointPQPlayer,170,270,440,21,27,JointPQPlayer
349,JointPQPlayer,275,230,505,47,14,Player A
350,JointPQPlayer,120,285,405,16,37,JointPQPlayer
351,JointPQPlayer,269,254,523,47,8,Player A
352,JointPQPlayer,260,235,495,40,15,Player A
353,JointPQPlayer,274,224,498,34,12,Player A
354,JointPQPlayer,261,246,507,43,12,Player A
355,JointPQPlayer,152,287,439,17,26,JointPQPlayer
356,JointPQPlayer,269,239,508,47,13,Player A
357,JointPQPlayer,248,253,501,43,14,JointPQPlayer
358,JointPQPlayer,272,242,514,41,9,Player A
359,JointPQPlayer,150,280,430,20,30,JointPQPlayer
360,JointPQPlayer,282,202,484,26,14,Player A
361,JointPQPlayer,159,264,423,19,32,JointPQPlayer
362,JointPQPlayer,266,231,497,39,14,Player A
363,JointPQPlayer,161,256,417,16,33,JointPQPlayer
364,JointPQPlayer,249,249,498,40,14,Tie
365,JointPQPlayer,288,228,516,43,9,Player A
366,JointPQPlayer,178,298,476,24,16,JointPQPlayer
367,JointPQPlayer,233,268,501,37,12,JointPQPlayer
368,JointPQPlayer,104,314,418,17,33,JointPQPlayer
369,JointPQPlayer,157,272,429,19,30,JointPQPlayer
370,JointPQPlayer,263,253,516,46,10,Player A
371,JointPQPlayer,269,234,503,39,12,Player A
372,JointPQPlayer,308,208,516,34,6,Player A
373,JointPQPlayer,185,265,450,22,24,JointPQPlayer
374,JointPQPlayer,138,293,431,21,30,JointPQPlayer
375,JointPQPlayer,264,259,523,50,9,Player A
376,JointPQPlayer,259,229,488,33,15,Player A
377,JointPQPlayer,277,217,494,39,15,Player A
378,JointPQPlayer,291,211,502,44,14,Player A
379,JointPQPlayer,123,328,451,17,22,JointPQPlayer
380,JointPQPlayer,308,193,501,37,12,Player A
381,JointPQPlayer,279,229,508,44,12,Player A
382,JointPQPlayer,229,254,483,34,17,JointPQPlayer
383,JointPQPlayer,278,243,521,51,10,Player A
384,JointPQPlayer,238,248,486,40,18,JointPQPlayer
385,JointPQPlayer,262,237,499,44,15,Player A
386,JointPQPlayer,284,229,513,40,9,Player A
387,JointPQPlayer,278,238,516,49,11,Player A
388,JointPQPlayer,267,237,504,40,12,Player A
389,JointPQPlayer,276,226,502,44,14,Player A
390,JointPQPlayer,262,217,479,30,17,Player A
391,JointPQPlayer,276,231,507,40,11,Player A
392,JointPQPlayer,292,232,524,54,10,Player A
393,JointPQPlayer,287,202,489,34,15,Player A
394,JointPQPlayer,250,255,505,41,12,JointPQPlayer
395,JointPQPlayer,299,204,503,42,13,Player A
396,JointPQPlayer,236,236,472,35,21,Tie
397,JointPQPlayer,259,219,478,29,17,Player A
398,JointPQPlayer,293,208,501,43,14,Player A
399,JointPQPlayer,152,272,424,17,31,JointPQPlayer
400,JointPQPlayer,123,288,411,10,33,JointPQPlayer
401,JointPQPlayer,284,224,508,44,12,Player A
402,JointPQPlayer,303,228,531,49,6,Player A
403,JointPQPlayer,243,263,506,39,11,JointPQPlayer
404,JointPQPlayer,119,284,403,14,37,JointPQPlayer
405,JointPQPlayer,279,229,508,44,12,Player A
406,JointPQPlayer,279,229,508,35,9,Player A
407,JointPQPlayer,153,253,406,17,37,JointPQPlayer
408,JointPQPlayer,252,232,484,38,18,Player A
409,JointPQPlayer,95,340,435,13,26,JointPQPlayer
410,JointPQPlayer,287,222,509,39,10,Player A
411,JointPQPlayer,268,228,496,38,14,Player A
412,JointPQPlayer,120,335,455,15,20,JointPQPlayer
413,JointPQPlayer,289,224,513,49,12,Player A
414,JointPQPlayer,290,215,505,41,12,Player A
415,JointPQPlayer,293,218,511,47,12,Player A
416,JointPQPlayer,276,236,512,45,11,Player A
417,JointPQPlayer,277,202,479,33,18,Player A
418,JointPQPlayer,167,272,439,20,27,JointPQPlayer
419,JointPQPlayer,276,246,522,52,10,Player A
420,JointPQPlayer,271,241,512,45,11,Player A
421,JointPQPlayer,244,249,493,35,14,JointPQPlayer
422,JointPQPlayer,138,263,401,12,37,JointPQPlayer
423,JointPQPlayer,253,253,506,48,14,Tie
424,JointPQPlayer,158,298,456,19,21,JointPQPlayer
425,JointPQPlayer,160,285,445,20,25,JointPQPlayer
426,JointPQPlayer,259,249,508,38,10,Player A
427,JointPQPlayer,263,213,476,36,20,Player A
428,JointPQPlayer,291,226,517,44,9,Player A
429,JointPQPlayer,293,208,501,46,15,Player A
430,JointPQPlayer,257,222,479,36,19,Player A
431,JointPQPlayer,277,242,519,49,10,Player A
432,JointPQPlayer,252,242,494,39,15,Player A
433,JointPQPlayer,279,224,503,36,11,Player A
434,JointPQPlayer,147,297,444,16,24,JointPQPlayer
435,JointPQPlayer,234,239,473,42,23,JointPQPlayer
436,JointPQPlayer,163,258,421,20,33,JointPQPlayer
437,JointPQPlayer,137,307,444,22,26,JointPQPlayer
438,JointPQPlayer,282,227,509,39,10,Player A
439,JointPQPlayer,129,279,408,16,36,JointPQPlayer
440,JointPQPlayer,249,249,498,40,14,Tie
441,JointPQPlayer,154,269,423,16,31,JointPQPlayer
442,JointPQPlayer,152,277,429,19,30,JointPQPlayer
443,JointPQPlayer,125,310,435,16,27,JointPQPlayer
444,JointPQPlayer,266,231,497,39,14,Player A
445,JointPQPlayer,304,204,508,44,12,Player A
446,JointPQPlayer,281,216,497,39,14,Player A
447,JointPQPlayer,261,236,497,42,15,Player A
448,JointPQPlayer,269,239,508,41,11,Player A
449,JointPQPlayer,130,305,435,13,26,JointPQPlayer
450,JointPQPlayer,148,273,421,17,32,JointPQPlayer
451,JointPQPlayer,274,219,493,38,15,Player A
452,JointPQPlayer,260,255,515,39,8,Player A
453,JointPQPlayer,131,296,427,20,31,JointPQPlayer
454,JointPQPlayer,321,186,507,40,11,Player A
455,JointPQPlayer,270,235,505,38,11,Player A
456,JointPQPlayer,281,241,522,49,9,Player A
457,JointPQPlayer,257,242,499,41,14,Player A
458,JointPQPlayer,204,224,428,21,31,JointPQPlayer
459,JointPQPlayer,108,318,426,16,30,JointPQPlayer
460,JointPQPlayer,300,220,520,44,8,Player A
461,JointPQPlayer,287,227,514,44,10,Player A
462,JointPQPlayer,125,300,425,12,29,JointPQPlayer
463,JointPQPlayer,291,201,492,40,16,Player A
464,JointPQPlayer,129,304,433,14,27,JointPQPlayer
465,JointPQPlayer,265,220,485,36,17,Player A
466,JointPQPlayer,264,244,508,50,14,Player A
467,JointPQPlayer,126,306,432,19,29,JointPQPlayer
468,JointPQPlayer,238,253,491,36,15,JointPQPlayer
469,JointPQPlayer,134,284,418,20,34,JointPQPlayer
470,JointPQPlayer,275,210,485,30,15,Player A
471,JointPQPlayer,237,252,489,31,14,JointPQPlayer
472,JointPQPlayer,277,232,509,48,13,Player A
473,JointPQPlayer,253,248,501,43,14,Player A
474,JointPQPlayer,233,218,451,29,26,Player A
475,JointPQPlayer,257,257,514,44,10,Tie
476,JointPQPlayer,315,200,515,45,10,Player A
477,JointPQPlayer,279,234,513,46,11,Player A
478,JointPQPlayer,156,276,432,19,29,JointPQPlayer
479,JointPQPlayer,270,250,520,47,9,Player A
480,JointPQPlayer,265,240,505,38,11,Player A
481,JointPQPlayer,306,191,497,36,13,Player A
482,JointPQPlayer,218,273,491,27,12,JointPQPlayer
483,JointPQPlayer,280,210,490,41,17,Player A
484,JointPQPlayer,292,207,499,38,13,Player A
485,JointPQPlayer,290,220,510,43,11,Player A
486,JointPQPlayer,275,230,505,41,12,Player A
487,JointPQPlayer,278,228,506,39,11,Player A
488,JointPQPlayer,279,209,488,33,15,Player A
489,JointPQPlayer,137,292,429,13,28,JointPQPlayer
490,JointPQPlayer,313,223,536,48,4,Player A
491,JointPQPlayer,133,293,426,13,29,JointPQPlayer
492,JointPQPlayer,295,205,500,42,14,Player A
493,JointPQPlayer,205,260,465,31,22,JointPQPlayer
494,JointPQPlayer,263,248,511,44,11,Player A
495,JointPQPlayer,265,245,510,46,12,Player A
496,JointPQPlayer,284,214,498,43,15,Player A
497,JointPQPlayer,286,231,517,47,10,Player A
498,JointPQPlayer,149,299,448,14,22,JointPQPlayer
499,JointPQPlayer,261,256,517,44,9,Player A
500,JointPQPlayer,262,252,514,35,7,Player A
501,JointPQPlayer,302,217,519,43,8,Player A
502,JointPQPlayer,255,230,485,36,17,Player A
503,JointPQPlayer,252,237,489,43,18,Player A
504,JointPQPlayer,185,270,455,21,22,JointPQPlayer
505,JointPQPlayer,272,247,519,43,8,Player A
506,JointPQPlayer,234,224,458,30,24,Player A
507,JointPQPlayer,287,227,514,44,10,Player A
508,JointPQPlayer,261,221,482,39,19,Player A
509,JointPQPlayer,290,215,505,44,13,Player A
510,JointPQPlayer,234,264,498,43,15,JointPQPlayer
511,JointPQPlayer,271,201,472,32,20,Player A
512,JointPQPlayer,119,299,418,14,32,JointPQPlayer
513,JointPQPlayer,261,231,492,37,15,Player A
514,JointPQPlayer,290,215,505,41,12,Player A
515,JointPQPlayer,298,228,526,47,7,Player A
516,JointPQPlayer,257,232,489,40,17,Player A
517,JointPQPlayer,132,302,434,18,28,JointPQPlayer
518,JointPQPlayer,281,221,502,41,13,Player A
519,JointPQPlayer,292,222,514,44,10,Player A
520,JointPQPlayer,272,227,499,41,14,Player A
521,JointPQPlayer,311,201,512,48,12,Player A
522,JointPQPlayer,215,265,480,40,20,JointPQPlayer
523,JointPQPlayer,250,245,495,46,17,Player A
524,JointPQPlayer,228,248,476,30,18,JointPQPlayer
525,JointPQPlayer,148,273,421,20,33,JointPQPlayer
526,JointPQPlayer,283,208,491,39,16,Player A
527,JointPQPlayer,269,244,513,43,10,Player A
528,JointPQPlayer,143,283,426,19,31,JointPQPlayer
529,JointPQPlayer,122,292,414,13,33,JointPQPlayer
530,JointPQPlayer,284,209,493,35,14,Player A
531,JointPQPlayer,287,217,504,37,11,Player A
532,JointPQPlayer,260,220,480,34,18,Player A
533,JointPQPlayer,155,280,435,19,28,JointPQPlayer
534,JointPQPlayer,138,313,451,14,21,JointPQPlayer
535,JointPQPlayer,120,335,455,12,19,JointPQPlayer
536,JointPQPlayer,171,281,452,21,23,JointPQPlayer
537,JointPQPlayer,296,191,487,41,18,Player A
538,JointPQPlayer,266,241,507,37,10,Player A
539,JointPQPlayer,283,238,521,39,6,Player A
540,JointPQPlayer,283,233,516,46,10,Player A
541,JointPQPlayer,299,214,513,43,10,Player A
542,JointPQPlayer,161,276,437,24,29,JointPQPlayer
543,JointPQPlayer,124,294,418,17,33,JointPQPlayer
544,JointPQPlayer,117,302,419,12,31,JointPQPlayer
545,JointPQPlayer,136,296,432,13,27,JointPQPlayer
546,JointPQPlayer,313,218,531,52,7,Player A
547,JointPQPlayer,288,228,516,52,12,Player A
548,JointPQPlayer,253,243,496,41,15,Player A
549,JointPQPlayer,257,242,499,38,13,Player A
550,JointPQPlayer,297,207,504,43,13,Player A
551,JointPQPlayer,282,222,504,37,11,Player A
552,JointPQPlayer,195,260,455,27,24,JointPQPlayer
553,JointPQPlayer,141,276,417,19,34,JointPQPlayer
554,JointPQPlayer,137,282,419,18,33,JointPQPlayer
555,JointPQPlayer,273,243,516,43,9,Player A
556,JointPQPlayer,275,235,510,43,11,Player A
557,JointPQPlayer,316,176,492,37,15,Player A
558,JointPQPlayer,140,275,415,14,33,JointPQPlayer
559,JointPQPlayer,278,233,511,44,11,Player A
560,JointPQPlayer,275,225,500,45,15,Player A
561,JointPQPlayer,269,239,508,41,11,Player A
562,JointPQPlayer,263,238,501,37,12,Player A
563,JointPQPlayer,266,236,502,44,14,Player A
564,JointPQPlayer,306,216,522,43,7,Player A
565,JointPQPlayer,272,222,494,33,13,Player A
566,JointPQPlayer,289,224,513,40,9,Player A
567,JointPQPlayer,281,236,517,38,7,Player A
568,JointPQPlayer,288,218,506,42,12,Player A
569,JointPQPlayer,284,189,473,30,19,Player A
570,JointPQPlayer,285,225,510,40,10,Player A
571,JointPQPlayer,298,203,501,43,14,Player A
572,JointPQPlayer,201,246,447,25,26,JointPQPlayer
573,JointPQPlayer,293,203,496,41,15,Player A
574,JointPQPlayer,230,245,475,38,21,JointPQPlayer
575,JointPQPlayer,278,223,501,43,14,Player A
576,JointPQPlayer,304,209,513,43,10,Player A
577,JointPQPlayer,263,243,506,39,11,Player A
578,JointPQPlayer,290,210,500,42,14,Player A
579,JointPQPlayer,112,317,429,7,26,JointPQPlayer
580,JointPQPlayer,279,234,513,43,10,Player A
581,JointPQPlayer,275,220,495,34,13,Player A
582,JointPQPlayer,156,291,447,19,24,JointPQPlayer
583,JointPQPlayer,279,234,513,46,11,Player A
584,JointPQPlayer,246,256,502,47,15,JointPQPlayer
585,JointPQPlayer,141,266,407,15,36,JointPQPlayer
586,JointPQPlayer,302,192,494,42,16,Player A
587,JointPQPlayer,267,237,504,43,13,Player A
588,JointPQPlayer,268,223,491,39,16,Player A
589,JointPQPlayer,252,252,504,37,11,Tie
590,JointPQPlayer,291,196,487,35,16,Player A
591,JointPQPlayer,274,224,498,40,14,Player A
592,JointPQPlayer,300,200,500,51,17,Player A
593,JointPQPlayer,283,223,506,36,10,Player A
594,JointPQPlayer,112,312,424,17,31,JointPQPlayer
595,JointPQPlayer,286,236,522,46,8,Player A
596,JointPQPlayer,265,205,470,30,20,Player A
597,JointPQPlayer,292,207,499,38,13,Player A
598,JointPQPlayer,270,250,520,50,10,Player A
599,JointPQPlayer,168,248,416,18,34,JointPQPlayer
600,JointPQPlayer,275,190,465,31,22,Player A
601,JointPQPlayer,253,258,511,50,13,JointPQPlayer
602,JointPQPlayer,248,233,481,32,17,Player A
603,JointPQPlayer,145,275,420,19,33,JointPQPlayer
604,JointPQPlayer,114,299,413,15,34,JointPQPlayer
605,JointPQPlayer,121,331,452,18,22,JointPQPlayer
606,JointPQPlayer,268,253,521,45,8,Player A
607,JointPQPlayer,137,277,414,10,32,JointPQPlayer
608,JointPQPlayer,233,258,491,42,17,JointPQPlayer
609,JointPQPlayer,283,208,491,36,15,Player A
610,JointPQPlayer,127,297,424,17,31,JointPQPlayer
611,JointPQPlayer,264,264,528,46,6,Tie
612,JointPQPlayer,287,212,499,47,16,Player A
613,JointPQPlayer,257,252,509,48,13,Player A
614,JointPQPlayer,278,218,496,32,12,Player A
615,JointPQPlayer,249,254,503,39,12,JointPQPlayer
616,JointPQPlayer,152,282,434,15,27,JointPQPlayer
617,JointPQPlayer,137,302,439,20,27,JointPQPlayer
618,JointPQPlayer,192,252,444,28,28,JointPQPlayer
619,JointPQPlayer,263,228,491,39,16,Player A
620,JointPQPlayer,282,247,529,53,8,Player A
621,JointPQPlayer,283,203,486,37,17,Player A
622,JointPQPlayer,269,244,513,46,11,Player A
623,JointPQPlayer,284,219,503,39,12,Player A
624,JointPQPlayer,153,293,446,24,26,JointPQPlayer
625,JointPQPlayer,142,292,434,15,27,JointPQPlayer
626,JointPQPlayer,287,212,499,38,13,Player A
627,JointPQPlayer,136,311,447,16,23,JointPQPlayer
628,JointPQPlayer,260,245,505,47,14,Player A
629,JointPQPlayer,287,232,519,49,10,Player A
630,JointPQPlayer,170,265,435,22,29,JointPQPlayer
631,JointPQPlayer,276,216,492,46,18,Player A
632,JointPQPlayer,156,276,432,28,32,JointPQPlayer
633,JointPQPlayer,269,229,498,43,15,Player A
634,JointPQPlayer,157,282,439,14,25,JointPQPlayer
635,JointPQPlayer,136,296,432,19,29,JointPQPlayer
636,JointPQPlayer,263,243,506,39,11,Player A
637,JointPQPlayer,145,300,445,23,26,JointPQPlayer
638,JointPQPlayer,275,215,490,38,16,Player A
639,JointPQPlayer,273,263,536,48,4,Player A
640,JointPQPlayer,281,221,502,32,10,Player A
641,JointPQPlayer,303,208,511,35,8,Player A
642,JointPQPlayer,177,267,444,22,26,JointPQPlayer
643,JointPQPlayer,279,244,523,50,9,Player A
644,JointPQPlayer,282,237,519,43,8,Player A
645,JointPQPlayer,127,317,444,19,25,JointPQPlayer
646,JointPQPlayer,298,188,486,37,17,Player A
647,JointPQPlayer,264,239,503,42,13,Player A
648,JointPQPlayer,114,304,418,14,32,JointPQPlayer
649,JointPQPlayer,311,191,502,44,14,Player A
650,JointPQPlayer,286,246,532,47,5,Player A
651,JointPQPlayer,293,213,506,36,10,Player A
652,JointPQPlayer,254,244,498,43,15,Player A
653,JointPQPlayer,131,306,437,12,25,JointPQPlayer
654,JointPQPlayer,302,217,519,46,9,Player A
655,JointPQPlayer,301,226,527,45,6,Player A
656,JointPQPlayer,280,205,485,36,17,Player A
657,JointPQPlayer,190,270,460,29,23,JointPQPlayer
658,JointPQPlayer,258,223,481,35,18,Player A
659,JointPQPlayer,135,290,425,18,31,JointPQPlayer
660,JointPQPlayer,277,242,519,43,8,Player A
661,JointPQPlayer,325,195,520,47,9,Player A
662,JointPQPlayer,282,222,504,40,12,Player A
663,JointPQPlayer,259,259,518,45,9,Tie
664,JointPQPlayer,235,245,480,34,18,JointPQPlayer
665,JointPQPlayer,291,231,522,46,8,Player A
666,JointPQPlayer,266,221,487,32,15,Player A
667,JointPQPlayer,148,293,441,19,26,JointPQPlayer
668,JointPQPlayer,243,243,486,40,18,Tie
669,JointPQPlayer,156,286,442,11,23,JointPQPlayer
670,JointPQPlayer,284,204,488,33,15,Player A
671,JointPQPlayer,276,211,487,41,18,Player A
672,JointPQPlayer,302,217,519,49,10,Player A
673,JointPQPlayer,264,264,528,55,9,Tie
674,JointPQPlayer,265,235,500,39,13,Player A
675,JointPQPlayer,212,267,479,30,17,JointPQPlayer
676,JointPQPlayer,264,249,513,52,13,Player A
677,JointPQPlayer,265,235,500,39,13,Player A
678,JointPQPlayer,275,220,495,34,13,Player A
679,JointPQPlayer,115,300,415,11,32,JointPQPlayer
680,JointPQPlayer,180,270,450,25,25,JointPQPlayer
681,JointPQPlayer,285,235,520,47,9,Player A
682,JointPQPlayer,211,271,482,30,16,JointPQPlayer
683,JointPQPlayer,285,230,515,42,9,Player A
684,JointPQPlayer,128,298,426,19,31,JointPQPlayer
685,JointPQPlayer,287,217,504,34,10,Player A
686,JointPQPlayer,265,235,500,39,13,Player A
687,JointPQPlayer,259,249,508,56,16,Player A
688,JointPQPlayer,272,202,474,40,22,Player A
689,JointPQPlayer,291,231,522,43,7,Player A
690,JointPQPlayer,146,301,447,19,24,JointPQPlayer
691,JointPQPlayer,157,297,454,26,24,JointPQPlayer
692,JointPQPlayer,275,215,490,38,16,Player A
693,JointPQPlayer,262,242,504,43,13,Player A
694,JointPQPlayer,134,294,428,15,29,JointPQPlayer
695,JointPQPlayer,231,236,467,27,20,JointPQPlayer
696,JointPQPlayer,307,202,509,39,10,Player A
697,JointPQPlayer,130,290,420,13,31,JointPQPlayer
698,JointPQPlayer,295,215,510,49,13,Player A
699,JointPQPlayer,278,223,501,40,13,Player A
700,JointPQPlayer,251,231,482,39,19,Player A
701,JointPQPlayer,131,286,417,13,32,JointPQPlayer
702,JointPQPlayer,259,249,508,35,9,Player A
703,JointPQPlayer,201,266,467,30,21,JointPQPlayer
704,JointPQPlayer,284,234,518,45,9,Player A
705,JointPQPlayer,135,310,445,17,24,JointPQPlayer
706,JointPQPlayer,271,231,502,41,13,Player A
707,JointPQPlayer,155,285,440,18,26,JointPQPlayer
708,JointPQPlayer,228,238,466,32,22,JointPQPlayer
709,JointPQPlayer,115,325,440,12,24,JointPQPlayer
710,JointPQPlayer,296,216,512,39,9,Player A
711,JointPQPlayer,263,243,506,51,15,Player A
712,JointPQPlayer,279,229,508,41,11,Player A
713,JointPQPlayer,276,231,507,43,12,Player A
714,JointPQPlayer,204,249,453,28,25,JointPQPlayer
715,JointPQPlayer,149,264,413,9,32,JointPQPlayer
716,JointPQPlayer,301,191,492,43,17,Player A
717,JointPQPlayer,304,184,488,33,15,Player A
718,JointPQPlayer,266,231,497,39,14,Player A
719,JointPQPlayer,145,285,430,17,29,JointPQPlayer
720,JointPQPlayer,109,314,423,13,30,JointPQPlayer
721,JointPQPlayer,134,299,433,14,27,JointPQPlayer
722,JointPQPlayer,276,226,502,41,13,Player A
723,JointPQPlayer,289,229,518,45,9,Player A
724,JointPQPlayer,283,223,506,39,11,Player A
725,JointPQPlayer,139,284,423,10,29,JointPQPlayer
726,JointPQPlayer,119,299,418,11,31,JointPQPlayer
727,JointPQPlayer,168,273,441,22,27,JointPQPlayer
728,JointPQPlayer,244,234,478,32,18,Player A
729,JointPQPlayer,114,319,433,11,26,JointPQPlayer
730,JointPQPlayer,121,301,422,12,30,JointPQPlayer
731,JointPQPlayer,296,196,492,40,16,Player A
732,JointPQPlayer,265,230,495,34,13,Player A
733,JointPQPlayer,275,220,495,40,15,Player A
734,JointPQPlayer,284,214,498,43,15,Player A
735,JointPQPlayer,302,197,499,32,11,Player A
736,JointPQPlayer,318,213,531,52,7,Player A
737,JointPQPlayer,289,229,518,45,9,Player A
738,JointPQPlayer,267,257,524,42,6,Player A
739,JointPQPlayer,230,235,465,31,22,JointPQPlayer
740,JointPQPlayer,227,272,499,35,12,JointPQPlayer
741,JointPQPlayer,220,260,480,34,18,JointPQPlayer
742,JointPQPlayer,261,221,482,33,17,Player A
743,JointPQPlayer,226,246,472,32,20,JointPQPlayer
744,JointPQPlayer,265,240,505,38,11,Player A
745,JointPQPlayer,158,283,441,22,27,JointPQPlayer
746,JointPQPlayer,143,283,426,16,30,JointPQPlayer
747,JointPQPlayer,266,241,507,43,12,Player A
748,JointPQPlayer,285,230,515,45,10,Player A
749,JointPQPlayer,244,254,498,43,15,JointPQPlayer
750,JointPQPlayer,249,239,488,27,13,Player A
751,JointPQPlayer,128,298,426,16,30,JointPQPlayer
752,JointPQPlayer,296,201,497,42,15,Player A
753,JointPQPlayer,176,281,457,32,25,JointPQPlayer
754,JointPQPlayer,232,252,484,35,17,JointPQPlayer
755,JointPQPlayer,275,240,515,54,13,Player A
756,JointPQPlayer,228,238,466,35,23,JointPQPlayer
757,JointPQPlayer,275,230,505,38,11,Player A
758,JointPQPlayer,252,262,514,50,12,JointPQPlayer
759,JointPQPlayer,256,251,507,40,11,Player A
760,JointPQPlayer,125,295,420,13,31,JointPQPlayer
761,JointPQPlayer,281,221,502,41,13,Player A
762,JointPQPlayer,305,200,505,41,12,Player A
763,JointPQPlayer,278,243,521,48,9,Player A
764,JointPQPlayer,277,197,474,28,18,Player A
765,JointPQPlayer,275,220,495,37,14,Player A
766,JointPQPlayer,142,282,424,20,32,JointPQPlayer
767,JointPQPlayer,273,223,496,35,13,Player A
768,JointPQPlayer,248,238,486,31,15,Player A
769,JointPQPlayer,158,258,416,18,34,JointPQPlayer
770,JointPQPlayer,130,300,430,14,28,JointPQPlayer
771,JointPQPlayer,260,245,505,38,11,Player A
772,JointPQPlayer,269,234,503,39,12,Player A
773,JointPQPlayer,259,229,488,39,17,Player A
774,JointPQPlayer,203,273,476,30,18,JointPQPlayer
775,JointPQPlayer,261,241,502,38,12,Player A
776,JointPQPlayer,308,203,511,41,10,Player A
777,JointPQPlayer,245,245,490,35,15,Tie
778,JointPQPlayer,143,283,426,16,30,JointPQPlayer
779,JointPQPlayer,266,216,482,33,17,Player A
780,JointPQPlayer,306,211,517,41,8,Player A
781,JointPQPlayer,267,237,504,43,13,Player A
782,JointPQPlayer,251,246,497,36,13,Player A
783,JointPQPlayer,312,202,514,47,11,Player A
784,JointPQPlayer,258,243,501,40,13,Player A
785,JointPQPlayer,139,299,438,19,27,JointPQPlayer
786,JointPQPlayer,100,310,410,15,35,JointPQPlayer
787,JointPQPlayer,287,222,509,42,11,Player A
788,JointPQPlayer,169,269,438,31,31,JointPQPlayer
789,JointPQPlayer,242,237,479,42,21,Player A
790,JointPQPlayer,123,298,421,20,33,JointPQPlayer
791,JointPQPlayer,131,296,427,17,30,JointPQPlayer
792,JointPQPlayer,248,268,516,46,10,JointPQPlayer
793,JointPQPlayer,306,201,507,43,12,Player A
794,JointPQPlayer,278,223,501,37,12,Player A
795,JointPQPlayer,125,290,415,11,32,JointPQPlayer
796,JointPQPlayer,260,240,500,42,14,Player A
797,JointPQPlayer,296,231,527,48,7,Player A
798,JointPQPlayer,302,207,509,45,12,Player A
799,JointPQPlayer,283,233,516,49,11,Player A
800,JointPQPlayer,299,214,513,40,9,Player A
801,JointPQPlayer,294,209,503,42,13,Player A
802,JointPQPlayer,275,230,505,41,12,Player A
803,JointPQPlayer,278,218,496,44,16,Player A
804,JointPQPlayer,242,222,464,30,22,Player A
805,JointPQPlayer,261,256,517,47,10,Player A
806,JointPQPlayer,285,235,520,47,9,Player A
807,JointPQPlayer,149,274,423,22,33,JointPQPlayer
808,JointPQPlayer,145,300,445,20,25,JointPQPlayer
809,JointPQPlayer,283,213,496,38,14,Player A
810,JointPQPlayer,287,232,519,52,11,Player A
811,JointPQPlayer,303,213,516,49,11,Player A
812,JointPQPlayer,289,209,498,40,14,Player A
813,JointPQPlayer,230,245,475,41,22,JointPQPlayer
814,JointPQPlayer,226,241,467,30,21,JointPQPlayer
815,JointPQPlayer,278,233,511,38,9,Player A
816,JointPQPlayer,302,207,509,36,9,Player A
817,JointPQPlayer,294,199,493,41,16,Player A
818,JointPQPlayer,251,241,492,40,16,Player A
819,JointPQPlayer,143,308,451,20,23,JointPQPlayer
820,JointPQPlayer,264,244,508,38,10,Player A
821,JointPQPlayer,156,276,432,22,30,JointPQPlayer
822,JointPQPlayer,153,288,441,13,24,JointPQPlayer
823,JointPQPlayer,280,240,520,44,8,Player A
824,JointPQPlayer,281,226,507,37,10,Player A
825,JointPQPlayer,289,209,498,40,14,Player A
826,JointPQPlayer,286,211,497,33,12,Player A
827,JointPQPlayer,148,273,421,14,31,JointPQPlayer
828,JointPQPlayer,149,284,433,20,29,JointPQPlayer
829,JointPQPlayer,252,257,509,45,12,JointPQPlayer
830,JointPQPlayer,265,235,500,39,13,Player A
831,JointPQPlayer,261,236,497,45,16,Player A
832,JointPQPlayer,282,227,509,39,10,Player A
833,JointPQPlayer,269,234,503,36,11,Player A
834,JointPQPlayer,289,199,488,36,16,Player A
835,JointPQPlayer,137,312,449,18,23,JointPQPlayer
836,JointPQPlayer,262,237,499,41,14,Player A
837,JointPQPlayer,300,205,505,44,13,Player A
838,JointPQPlayer,273,213,486,40,18,Player A
839,JointPQPlayer,275,240,515,42,9,Player A
840,JointPQPlayer,288,203,491,36,15,Player A
841,JointPQPlayer,235,265,500,39,13,JointPQPlayer
842,JointPQPlayer,260,230,490,29,13,Player A
843,JointPQPlayer,287,197,484,38,18,Player A
844,JointPQPlayer,249,239,488,39,17,Player A
845,JointPQPlayer,295,230,525,43,6,Player A
846,JointPQPlayer,253,228,481,29,16,Player A
847,JointPQPlayer,265,220,485,36,17,Player A
848,JointPQPlayer,126,296,422,18,32,JointPQPlayer
849,JointPQPlayer,276,221,497,42,15,Player A
850,JointPQPlayer,241,266,507,40,11,JointPQPlayer
851,JointPQPlayer,287,212,499,41,14,Player A
852,JointPQPlayer,148,263,411,16,35,JointPQPlayer
853,JointPQPlayer,237,247,484,41,19,JointPQPlayer
854,JointPQPlayer,256,256,512,48,12,Tie
855,JointPQPlayer,262,217,479,36,19,Player A
856,JointPQPlayer,247,222,469,38,23,Player A
857,JointPQPlayer,177,287,464,21,19,JointPQPlayer
858,JointPQPlayer,297,207,504,40,12,Player A
859,JointPQPlayer,227,282,509,39,10,JointPQPlayer
860,JointPQPlayer,247,247,494,42,16,Tie
861,JointPQPlayer,271,236,507,40,11,Player A
862,JointPQPlayer,283,218,501,43,14,Player A
863,JointPQPlayer,223,253,476,30,18,JointPQPlayer
864,JointPQPlayer,316,196,512,45,11,Player A
865,JointPQPlayer,253,243,496,38,14,Player A
866,JointPQPlayer,120,310,430,17,29,JointPQPlayer
867,JointPQPlayer,278,238,516,43,9,Player A
868,JointPQPlayer,126,316,442,20,26,JointPQPlayer
869,JointPQPlayer,277,222,499,41,14,Player A
870,JointPQPlayer,148,293,441,25,28,JointPQPlayer
871,JointPQPlayer,305,235,540,55,5,Player A
872,JointPQPlayer,256,236,492,43,17,Player A
873,JointPQPlayer,286,211,497,39,14,Player A
874,JointPQPlayer,268,228,496,44,16,Player A
875,JointPQPlayer,243,243,486,43,19,Tie
876,JointPQPlayer,259,249,508,41,11,Player A
877,JointPQPlayer,278,233,511,32,7,Player A
878,JointPQPlayer,129,299,428,18,30,JointPQPlayer
879,JointPQPlayer,275,250,525,49,8,Player A
880,JointPQPlayer,282,217,499,38,13,Player A
881,JointPQPlayer,273,203,476,36,20,Player A
882,JointPQPlayer,272,242,514,38,8,Player A
883,JointPQPlayer,291,211,502,32,10,Player A
884,JointPQPlayer,141,296,437,12,25,JointPQPlayer
885,JointPQPlayer,258,263,521,57,12,JointPQPlayer
886,JointPQPlayer,253,233,486,40,18,Player A
887,JointPQPlayer,248,243,491,30,13,Player A
888,JointPQPlayer,302,207,509,42,11,Player A
889,JointPQPlayer,164,274,438,22,28,JointPQPlayer
890,JointPQPlayer,271,251,522,43,7,Player A
891,JointPQPlayer,252,242,494,36,14,Player A
892,JointPQPlayer,148,303,451,17,22,JointPQPlayer
893,JointPQPlayer,295,210,505,44,13,Player A
894,JointPQPlayer,153,278,431,21,30,JointPQPlayer
895,JointPQPlayer,292,212,504,43,13,Player A
896,JointPQPlayer,280,235,515,39,8,Player A
897,JointPQPlayer,296,226,522,40,6,Player A
898,JointPQPlayer,153,288,441,19,26,JointPQPlayer
899,JointPQPlayer,265,220,485,42,19,Player A
900,JointPQPlayer,277,227,504,43,13,Player A
901,JointPQPlayer,248,238,486,40,18,Player A
902,JointPQPlayer,249,249,498,37,13,Tie
903,JointPQPlayer,284,229,513,34,7,Player A
904,JointPQPlayer,151,296,447,16,23,JointPQPlayer
905,JointPQPlayer,154,264,418,14,32,JointPQPlayer
906,JointPQPlayer,276,231,507,49,14,Player A
907,JointPQPlayer,284,219,503,42,13,Player A
908,JointPQPlayer,262,227,489,31,14,Player A
909,JointPQPlayer,294,209,503,33,10,Player A
910,JointPQPlayer,276,221,497,42,15,Player A
911,JointPQPlayer,261,236,497,42,15,Player A
912,JointPQPlayer,295,230,525,46,7,Player A
913,JointPQPlayer,167,252,419,15,32,JointPQPlayer
914,JointPQPlayer,284,209,493,44,17,Player A
915,JointPQPlayer,224,259,483,34,17,JointPQPlayer
916,JointPQPlayer,280,225,505,38,11,Player A
917,JointPQPlayer,280,230,510,40,10,Player A
918,JointPQPlayer,234,269,503,39,12,JointPQPlayer
919,JointPQPlayer,182,262,444,25,27,JointPQPlayer
920,JointPQPlayer,282,237,519,49,10,Player A
921,JointPQPlayer,219,269,488,36,16,JointPQPlayer
922,JointPQPlayer,315,200,515,45,10,Player A
923,JointPQPlayer,288,203,491,36,15,Player A
924,JointPQPlayer,282,202,484,35,17,Player A
925,JointPQPlayer,152,277,429,16,29,JointPQPlayer
926,JointPQPlayer,271,226,497,42,15,Player A
927,JointPQPlayer,264,234,498,34,12,Player A
928,JointPQPlayer,261,231,492,43,17,Player A
929,JointPQPlayer,286,221,507,40,11,Player A
930,JointPQPlayer,287,222,509,42,11,Player A
931,JointPQPlayer,241,246,487,35,16,JointPQPlayer
932,JointPQPlayer,258,223,481,29,16,Player A
933,JointPQPlayer,264,229,493,38,15,Player A
934,JointPQPlayer,277,242,519,46,9,Player A
935,JointPQPlayer,277,217,494,39,15,Player A
936,JointPQPlayer,295,235,530,48,6,Player A
937,JointPQPlayer,323,183,506,42,12,Player A
938,JointPQPlayer,129,279,408,13,35,JointPQPlayer
939,JointPQPlayer,279,234,513,46,11,Player A
940,JointPQPlayer,147,287,434,15,27,JointPQPlayer
941,JointPQPlayer,245,235,480,37,19,Player A
942,JointPQPlayer,249,244,493,35,14,Player A
943,JointPQPlayer,151,251,402,16,38,JointPQPlayer
944,JointPQPlayer,325,180,505,41,12,Player A
945,JointPQPlayer,285,240,525,43,6,Player A
946,JointPQPlayer,304,194,498,40,14,Player A
947,JointPQPlayer,296,216,512,39,9,Player A
948,JointPQPlayer,275,225,500,45,15,Player A
949,JointPQPlayer,260,225,485,30,15,Player A
950,JointPQPlayer,117,297,414,16,34,JointPQPlayer
951,JointPQPlayer,266,236,502,47,15,Player A
952,JointPQPlayer,277,232,509,39,10,Player A
953,JointPQPlayer,254,249,503,45,14,Player A
954,JointPQPlayer,264,229,493,41,16,Player A
955,JointPQPlayer,114,329,443,18,25,JointPQPlayer
956,JointPQPlayer,115,330,445,23,26,JointPQPlayer
957,JointPQPlayer,262,232,494,48,18,Player A
958,JointPQPlayer,286,211,497,39,14,Player A
959,JointPQPlayer,268,233,501,40,13,Player A
960,JointPQPlayer,185,290,475,35,20,JointPQPlayer
961,JointPQPlayer,283,238,521,42,7,Player A
962,JointPQPlayer,271,241,512,39,9,Player A
963,JointPQPlayer,238,243,481,41,20,JointPQPlayer
964,JointPQPlayer,269,214,483,40,19,Player A
965,JointPQPlayer,144,309,453,22,23,JointPQPlayer
966,JointPQPlayer,154,279,433,14,27,JointPQPlayer
967,JointPQPlayer,241,241,482,36,18,Tie
968,JointPQPlayer,169,274,443,15,24,JointPQPlayer
969,JointPQPlayer,284,239,523,47,8,Player A
970,JointPQPlayer,249,249,498,34,12,Tie
971,JointPQPlayer,275,250,525,49,8,Player A
972,JointPQPlayer,267,242,509,39,10,Player A
973,JointPQPlayer,221,246,467,33,22,JointPQPlayer
974,JointPQPlayer,156,306,462,28,22,JointPQPlayer
975,JointPQPlayer,109,319,428,15,29,JointPQPlayer
976,JointPQPlayer,266,231,497,45,16,Player A
977,JointPQPlayer,123,298,421,17,32,JointPQPlayer
978,JointPQPlayer,267,227,494,36,14,Player A
979,JointPQPlayer,280,225,505,41,12,Player A
980,JointPQPlayer,314,184,498,40,14,Player A
981,JointPQPlayer,239,254,493,38,15,JointPQPlayer
982,JointPQPlayer,283,218,501,43,14,Player A
983,JointPQPlayer,290,220,510,40,10,Player A
984,JointPQPlayer,274,234,508,44,12,Player A
985,JointPQPlayer,306,216,522,40,6,Player A
986,JointPQPlayer,242,242,484,35,17,Tie
987,JointPQPlayer,174,274,448,20,24,JointPQPlayer
988,JointPQPlayer,147,312,459,28,23,JointPQPlayer
989,JointPQPlayer,160,295,455,18,21,JointPQPlayer
990,JointPQPlayer,271,216,487,35,16,Player A
991,JointPQPlayer,286,216,502,41,13,Player A
992,JointPQPlayer,273,253,526,41,5,Player A
993,JointPQPlayer,285,210,495,37,14,Player A
994,JointPQPlayer,174,279,453,22,23,JointPQPlayer
995,JointPQPlayer,146,311,457,23,22,JointPQPlayer
996,JointPQPlayer,263,228,491,33,14,Player A
997,JointPQPlayer,307,192,499,35,12,Player A
998,JointPQPlayer,270,225,495,34,13,Player A
999,JointPQPlayer,266,221,487,41,18,Player A
1000,JointPQPlayer,167,272,439,20,27,JointPQPlayer
1001,JointPQPlayer,126,316,442,17,25,JointPQPlayer
1002,JointPQPlayer,121,296,417,13,32,JointPQPlayer
1003,JointPQPlayer,138,288,426,16,30,JointPQPlayer
1004,JointPQPlayer,283,238,521,45,8,Player A
1005,JointPQPlayer,105,310,415,14,33,JointPQPlayer
1006,JointPQPlayer,269,249,518,48,10,Player A
1007,JointPQPlayer,301,231,532,50,6,Player A
1008,JointPQPlayer,270,225,495,43,16,Player A
1009,JointPQPlayer,216,256,472,35,21,JointPQPlayer
1010,JointPQPlayer,295,205,500,36,12,Player A
1011,JointPQPlayer,268,218,486,28,14,Player A
1012,JointPQPlayer,194,249,443,21,26,JointPQPlayer
1013,JointPQPlayer,288,223,511,44,11,Player A
1014,JointPQPlayer,239,244,483,31,16,JointPQPlayer
1015,JointPQPlayer,314,179,493,32,13,Player A
1016,JointPQPlayer,301,226,527,42,5,Player A
1017,JointPQPlayer,296,201,497,36,13,Player A
1018,JointPQPlayer,278,228,506,39,11,Player A
1019,JointPQPlayer,311,196,507,40,11,Player A
1020,JointPQPlayer,278,243,521,51,10,Player A
1021,JointPQPlayer,272,207,479,39,20,Player A
1022,JointPQPlayer,128,298,426,16,30,JointPQPlayer
1023,JointPQPlayer,272,227,499,38,13,Player A
1024,JointPQPlayer,284,209,493,44,17,Player A
1025,JointPQPlayer,261,241,502,41,13,Player A
1026,JointPQPlayer,142,287,429,19,30,JointPQPlayer
1027,JointPQPlayer,245,255,500,45,15,JointPQPlayer
1028,JointPQPlayer,291,216,507,37,10,Player A
1029,JointPQPlayer,210,240,450,25,25,JointPQPlayer
1030,JointPQPlayer,277,207,484,32,16,Player A
1031,JointPQPlayer,285,225,510,46,12,Player A
1032,JointPQPlayer,269,244,513,40,9,Player A
1033,JointPQPlayer,285,210,495,34,13,Player A
1034,JointPQPlayer,252,247,499,38,13,Player A
1035,JointPQPlayer,276,221,497,42,15,Player A
1036,JointPQPlayer,259,219,478,44,22,Player A
1037,JointPQPlayer,296,226,522,55,11,Player A
1038,JointPQPlayer,122,317,439,17,26,JointPQPlayer
1039,JointPQPlayer,253,243,496,26,10,Player A
1040,JointPQPlayer,260,255,515,48,11,Player A
1041,JointPQPlayer,198,263,461,24,21,JointPQPlayer
1042,JointPQPlayer,281,226,507,40,11,Player A
1043,JointPQPlayer,152,292,444,16,24,JointPQPlayer
1044,JointPQPlayer,258,223,481,29,16,Player A
1045,JointPQPlayer,185,260,445,23,26,JointPQPlayer
1046,JointPQPlayer,261,241,502,35,11,Player A
1047,JointPQPlayer,110,300,410,12,34,JointPQPlayer
1048,JointPQPlayer,266,226,492,49,19,Player A
1049,JointPQPlayer,130,280,410,15,35,JointPQPlayer
1050,JointPQPlayer,306,206,512,36,8,Player A
1051,JointPQPlayer,283,213,496,41,15,Player A
1052,JointPQPlayer,269,234,503,39,12,Player A
1053,JointPQPlayer,286,216,502,41,13,Player A
1054,JointPQPlayer,287,212,499,35,12,Player A
1055,JointPQPlayer,207,257,464,27,21,JointPQPlayer
1056,JointPQPlayer,255,230,485,33,16,Player A
1057,JointPQPlayer,126,306,432,19,29,JointPQPlayer
1058,JointPQPlayer,266,221,487,38,17,Player A
1059,JointPQPlayer,131,301,432,16,28,JointPQPlayer
1060,JointPQPlayer,164,274,438,22,28,JointPQPlayer
1061,JointPQPlayer,135,280,415,11,32,JointPQPlayer
1062,JointPQPlayer,296,216,512,42,10,Player A
1063,JointPQPlayer,122,297,419,15,32,JointPQPlayer
1064,JointPQPlayer,310,205,515,42,9,Player A
1065,JointPQPlayer,298,208,506,39,11,Player A
1066,JointPQPlayer,182,287,469,23,18,JointPQPlayer
1067,JointPQPlayer,279,219,498,37,13,Player A
1068,JointPQPlayer,300,220,520,44,8,Player A
1069,JointPQPlayer,290,215,505,38,11,Player A
1070,JointPQPlayer,272,222,494,30,12,Player A
1071,JointPQPlayer,320,190,510,40,10,Player A
1072,JointPQPlayer,286,216,502,38,12,Player A
1073,JointPQPlayer,266,231,497,42,15,Player A
1074,JointPQPlayer,221,266,487,35,16,JointPQPlayer
1075,JointPQPlayer,198,238,436,23,29,JointPQPlayer
1076,JointPQPlayer,282,222,504,37,11,Player A
1077,JointPQPlayer,191,286,477,28,17,JointPQPlayer
1078,JointPQPlayer,127,322,449,15,22,JointPQPlayer
1079,JointPQPlayer,195,240,435,19,28,JointPQPlayer
1080,JointPQPlayer,145,330,475,29,18,JointPQPlayer
1081,JointPQPlayer,265,215,480,31,17,Player A
1082,JointPQPlayer,268,208,476,39,21,Player A
1083,JointPQPlayer,284,224,508,44,12,Player A
1084,JointPQPlayer,268,233,501,40,13,Player A
1085,JointPQPlayer,254,244,498,37,13,Player A
1086,JointPQPlayer,239,229,468,31,21,Player A
1087,JointPQPlayer,282,207,489,40,17,Player A
1088,JointPQPlayer,142,277,419,9,30,JointPQPlayer
1089,JointPQPlayer,294,204,498,43,15,Player A
1090,JointPQPlayer,135,310,445,26,27,JointPQPlayer
1091,JointPQPlayer,221,261,482,42,20,JointPQPlayer
1092,JointPQPlayer,294,214,508,44,12,Player A
1093,JointPQPlayer,269,239,508,44,12,Player A
1094,JointPQPlayer,275,230,505,38,11,Player A
1095,JointPQPlayer,276,236,512,45,11,Player A
1096,JointPQPlayer,294,214,508,32,8,Player A
1097,JointPQPlayer,159,279,438,22,28,JointPQPlayer
1098,JointPQPlayer,91,321,412,11,33,JointPQPlayer
1099,JointPQPlayer,278,233,511,47,12,Player A
1100,JointPQPlayer,219,254,473,33,20,JointPQPlayer
1101,JointPQPlayer,211,256,467,33,22,JointPQPlayer
1102,JointPQPlayer,304,204,508,47,13,Player A
1103,JointPQPlayer,242,247,489,34,15,JointPQPlayer
1104,JointPQPlayer,161,276,437,27,30,JointPQPlayer
1105,JointPQPlayer,288,218,506,36,10,Player A
1106,JointPQPlayer,190,260,450,25,25,JointPQPlayer
1107,JointPQPlayer,326,176,502,41,13,Player A
1108,JointPQPlayer,324,204,528,46,6,Player A
1109,JointPQPlayer,260,245,505,38,11,Player A
1110,JointPQPlayer,284,219,503,42,13,Player A
1111,JointPQPlayer,151,291,442,23,27,JointPQPlayer
1112,JointPQPlayer,125,300,425,15,30,JointPQPlayer
1113,JointPQPlayer,285,225,510,40,10,Player A
1114,JointPQPlayer,138,293,431,18,29,JointPQPlayer
1115,JointPQPlayer,275,225,500,45,15,Player A
1116,JointPQPlayer,290,215,505,41,12,Player A
1117,JointPQPlayer,142,292,434,21,29,JointPQPlayer
1118,JointPQPlayer,266,231,497,33,12,Player A
1119,JointPQPlayer,270,225,495,40,15,Player A
1120,JointPQPlayer,277,222,499,44,15,Player A
1121,JointPQPlayer,260,250,510,46,12,Player A
1122,JointPQPlayer,249,259,508,32,8,JointPQPlayer
1123,JointPQPlayer,278,218,496,35,13,Player A
1124,JointPQPlayer,242,237,479,39,20,Player A
1125,JointPQPlayer,156,286,442,29,29,JointPQPlayer
1126,JointPQPlayer,255,255,510,43,11,Tie
1127,JointPQPlayer,277,242,519,43,8,Player A
1128,JointPQPlayer,251,231,482,39,19,Player A
1129,JointPQPlayer,302,217,519,43,8,Player A
1130,JointPQPlayer,276,241,517,41,8,Player A
1131,JointPQPlayer,286,226,512,42,10,Player A
1132,JointPQPlayer,248,233,481,38,19,Player A
1133,JointPQPlayer,271,206,477,31,18,Player A
1134,JointPQPlayer,278,213,491,30,13,Player A
1135,JointPQPlayer,173,248,421,20,33,JointPQPlayer
1136,JointPQPlayer,161,281,442,20,26,JointPQPlayer
1137,JointPQPlayer,203,263,466,26,20,JointPQPlayer
1138,JointPQPlayer,224,274,498,40,14,JointPQPlayer
1139,JointPQPlayer,253,253,506,42,12,Tie
1140,JointPQPlayer,307,192,499,38,13,Player A
1141,JointPQPlayer,169,264,433,14,27,JointPQPlayer
1142,JointPQPlayer,279,204,483,31,16,Player A
1143,JointPQPlayer,137,272,409,11,34,JointPQPlayer
1144,JointPQPlayer,163,283,446,18,24,JointPQPlayer
1145,JointPQPlayer,119,339,458,18,20,JointPQPlayer
1146,JointPQPlayer,290,220,510,46,12,Player A
1147,JointPQPlayer,114,319,433,17,28,JointPQPlayer
1148,JointPQPlayer,131,311,442,20,26,JointPQPlayer
1149,JointPQPlayer,285,220,505,41,12,Player A
1150,JointPQPlayer,272,232,504,40,12,Player A
1151,JointPQPlayer,275,240,515,39,8,Player A
1152,JointPQPlayer,288,218,506,42,12,Player A
1153,JointPQPlayer,260,265,525,49,8,JointPQPlayer
1154,JointPQPlayer,137,307,444,22,26,JointPQPlayer
1155,JointPQPlayer,290,230,520,41,7,Player A
1156,JointPQPlayer,237,237,474,31,19,Tie
1157,JointPQPlayer,259,249,508,44,12,Player A
1158,JointPQPlayer,277,232,509,48,13,Player A
1159,JointPQPlayer,279,214,493,38,15,Player A
1160,JointPQPlayer,303,223,526,47,7,Player A
1161,JointPQPlayer,239,249,488,36,16,JointPQPlayer
1162,JointPQPlayer,283,228,511,44,11,Player A
1163,JointPQPlayer,278,238,516,52,12,Player A
1164,JointPQPlayer,231,281,512,45,11,JointPQPlayer
1165,JointPQPlayer,288,238,526,53,9,Player A
1166,JointPQPlayer,294,219,513,43,10,Player A
1167,JointPQPlayer,178,253,431,24,31,JointPQPlayer
1168,JointPQPlayer,192,272,464,24,20,JointPQPlayer
1169,JointPQPlayer,289,224,513,43,10,Player A
1170,JointPQPlayer,270,230,500,39,13,Player A
1171,JointPQPlayer,283,228,511,38,9,Player A
1172,JointPQPlayer,250,230,480,40,20,Player A
1173,JointPQPlayer,269,239,508,38,10,Player A
1174,JointPQPlayer,252,257,509,45,12,JointPQPlayer
1175,JointPQPlayer,248,248,496,38,14,Tie
1176,JointPQPlayer,289,204,493,38,15,Player A
1177,JointPQPlayer,235,275,510,43,11,JointPQPlayer
1178,JointPQPlayer,137,297,434,18,28,JointPQPlayer
1179,JointPQPlayer,151,241,392,12,40,JointPQPlayer
1180,JointPQPlayer,240,260,500,33,11,JointPQPlayer
1181,JointPQPlayer,133,283,416,15,33,JointPQPlayer
1182,JointPQPlayer,157,287,444,28,28,JointPQPlayer
1183,JointPQPlayer,265,255,520,50,10,Player A
1184,JointPQPlayer,298,208,506,39,11,Player A
1185,JointPQPlayer,265,225,490,35,15,Player A
1186,JointPQPlayer,120,300,420,16,32,JointPQPlayer
1187,JointPQPlayer,294,219,513,43,10,Player A
1188,JointPQPlayer,129,309,438,13,25,JointPQPlayer
1189,JointPQPlayer,284,199,483,28,15,Player A
1190,JointPQPlayer,284,219,503,42,13,Player A
1191,JointPQPlayer,245,245,490,38,16,Tie
1192,JointPQPlayer,283,228,511,47,12,Player A
1193,JointPQPlayer,268,208,476,36,20,Player A
1194,JointPQPlayer,275,215,490,41,17,Player A
1195,JointPQPlayer,268,248,516,46,10,Player A
1196,JointPQPlayer,122,297,419,15,32,JointPQPlayer
1197,JointPQPlayer,197,247,444,28,28,JointPQPlayer
1198,JointPQPlayer,250,230,480,34,18,Player A
1199,JointPQPlayer,270,225,495,37,14,Player A
1200,JointPQPlayer,284,209,493,35,14,Player A
1201,JointPQPlayer,266,226,492,43,17,Player A
1202,JointPQPlayer,299,244,543,52,3,Player A
1203,JointPQPlayer,168,258,426,22,32,JointPQPlayer
1204,JointPQPlayer,245,255,500,42,14,JointPQPlayer
1205,JointPQPlayer,283,213,496,38,14,Player A
1206,JointPQPlayer,144,304,448,20,24,JointPQPlayer
1207,JointPQPlayer,295,210,505,32,9,Player A
1208,JointPQPlayer,281,201,482,36,18,Player A
1209,JointPQPlayer,233,258,491,36,15,JointPQPlayer
1210,JointPQPlayer,279,224,503,42,13,Player A
1211,JointPQPlayer,240,240,480,43,21,Tie
1212,JointPQPlayer,245,235,480,37,19,Player A
1213,JointPQPlayer,163,268,431,15,28,JointPQPlayer
1214,JointPQPlayer,211,256,467,30,21,JointPQPlayer
1215,JointPQPlayer,285,240,525,43,6,Player A
1216,JointPQPlayer,258,243,501,40,13,Player A
1217,JointPQPlayer,159,294,453,25,24,JointPQPlayer
1218,JointPQPlayer,118,333,451,17,22,JointPQPlayer
1219,JointPQPlayer,198,248,446,30,28,JointPQPlayer
1220,JointPQPlayer,301,201,502,38,12,Player A
1221,JointPQPlayer,279,209,488,30,14,Player A
1222,JointPQPlayer,104,339,443,18,25,JointPQPlayer
1223,JointPQPlayer,194,239,433,20,29,JointPQPlayer
1224,JointPQPlayer,280,215,495,37,14,Player A
1225,JointPQPlayer,252,232,484,38,18,Player A
1226,JointPQPlayer,272,237,509,39,10,Player A
1227,JointPQPlayer,335,185,520,47,9,Player A
1228,JointPQPlayer,269,209,478,32,18,Player A
1229,JointPQPlayer,296,206,502,38,12,Player A
1230,JointPQPlayer,319,184,503,36,11,Player A
1231,JointPQPlayer,300,200,500,39,13,Player A
1232,JointPQPlayer,273,243,516,43,9,Player A
1233,JointPQPlayer,159,269,428,18,30,JointPQPlayer
1234,JointPQPlayer,270,215,485,39,18,Player A
1235,JointPQPlayer,250,250,500,42,14,Tie
1236,JointPQPlayer,156,266,422,15,31,JointPQPlayer
1237,JointPQPlayer,252,282,534,46,4,JointPQPlayer
1238,JointPQPlayer,263,238,501,43,14,Player A
1239,JointPQPlayer,249,244,493,44,17,Player A
1240,JointPQPlayer,270,235,505,44,13,Player A
1241,JointPQPlayer,277,242,519,43,8,Player A
1242,JointPQPlayer,276,236,512,39,9,Player A
1243,JointPQPlayer,296,191,487,41,18,Player A
1244,JointPQPlayer,167,262,429,19,30,JointPQPlayer
1245,JointPQPlayer,256,241,497,39,14,Player A
1246,JointPQPlayer,281,221,502,38,12,Player A
1247,JointPQPlayer,278,213,491,33,14,Player A
1248,JointPQPlayer,275,235,510,46,12,Player A
1249,JointPQPlayer,267,257,524,51,9,Player A
1250,JointPQPlayer,241,251,492,40,16,JointPQPlayer
1251,JointPQPlayer,272,242,514,41,9,Player A
1252,JointPQPlayer,289,239,528,49,7,Player A
1253,JointPQPlayer,218,278,496,38,14,JointPQPlayer
1254,JointPQPlayer,290,200,490,35,15,Player A
1255,JointPQPlayer,272,222,494,42,16,Player A
1256,JointPQPlayer,309,204,513,40,9,Player A
1257,JointPQPlayer,147,317,464,12,16,JointPQPlayer
1258,JointPQPlayer,278,228,506,36,10,Player A
1259,JointPQPlayer,225,240,465,22,19,JointPQPlayer
1260,JointPQPlayer,239,224,463,32,23,Player A
1261,JointPQPlayer,303,213,516,40,8,Player A
1262,JointPQPlayer,243,283,526,38,4,JointPQPlayer
1263,JointPQPlayer,253,233,486,37,17,Player A
1264,JointPQPlayer,228,243,471,37,22,JointPQPlayer
1265,JointPQPlayer,294,229,523,44,7,Player A
1266,JointPQPlayer,245,215,460,29,23,Player A
1267,JointPQPlayer,188,258,446,24,26,JointPQPlayer
1268,JointPQPlayer,148,278,426,19,31,JointPQPlayer
1269,JointPQPlayer,205,265,470,30,20,JointPQPlayer
1270,JointPQPlayer,269,249,518,45,9,Player A
1271,JointPQPlayer,246,236,482,39,19,Player A
1272,JointPQPlayer,281,211,492,37,15,Player A
1273,JointPQPlayer,154,309,463,20,19,JointPQPlayer
1274,JointPQPlayer,127,292,419,18,33,JointPQPlayer
1275,JointPQPlayer,292,212,504,37,11,Player A
1276,JointPQPlayer,264,249,513,43,10,Player A
1277,JointPQPlayer,216,281,497,36,13,JointPQPlayer
1278,JointPQPlayer,279,199,478,32,18,Player A
1279,JointPQPlayer,98,358,456,16,20,JointPQPlayer
1280,JointPQPlayer,301,211,512,36,8,Player A
1281,JointPQPlayer,126,276,402,13,37,JointPQPlayer
1282,JointPQPlayer,253,233,486,40,18,Player A
1283,JointPQPlayer,143,283,426,16,30,JointPQPlayer
1284,JointPQPlayer,279,219,498,43,15,Player A
1285,JointPQPlayer,266,251,517,47,10,Player A
1286,JointPQPlayer,287,212,499,44,15,Player A
1287,JointPQPlayer,287,232,519,43,8,Player A
1288,JointPQPlayer,277,227,504,43,13,Player A
1289,JointPQPlayer,243,258,501,31,10,JointPQPlayer
1290,JointPQPlayer,138,318,456,22,22,JointPQPlayer
1291,JointPQPlayer,230,260,490,38,16,JointPQPlayer
1292,JointPQPlayer,184,279,463,26,21,JointPQPlayer
1293,JointPQPlayer,298,223,521,48,9,Player A
1294,JointPQPlayer,169,249,418,23,35,JointPQPlayer
1295,JointPQPlayer,315,200,515,42,9,Player A
1296,JointPQPlayer,231,271,502,32,10,JointPQPlayer
1297,JointPQPlayer,294,224,518,45,9,Player A
1298,JointPQPlayer,246,256,502,41,13,JointPQPlayer
1299,JointPQPlayer,264,229,493,41,16,Player A
1300,JointPQPlayer,116,306,422,15,31,JointPQPlayer
1301,JointPQPlayer,269,219,488,39,17,Player A
1302,JointPQPlayer,248,223,471,31,20,Player A
1303,JointPQPlayer,178,278,456,22,22,JointPQPlayer
1304,JointPQPlayer,276,231,507,34,9,Player A
1305,JointPQPlayer,284,239,523,50,9,Player A
1306,JointPQPlayer,316,206,522,49,9,Player A
1307,JointPQPlayer,153,278,431,18,29,JointPQPlayer
1308,JointPQPlayer,253,238,491,33,14,Player A
1309,JointPQPlayer,265,255,520,44,8,Player A
1310,JointPQPlayer,280,230,510,37,9,Player A
1311,JointPQPlayer,170,270,440,24,28,JointPQPlayer
1312,JointPQPlayer,209,264,473,24,17,JointPQPlayer
1313,JointPQPlayer,257,242,499,41,14,Player A
1314,JointPQPlayer,273,228,501,31,10,Player A
1315,JointPQPlayer,301,216,517,44,9,Player A
1316,JointPQPlayer,284,219,503,36,11,Player A
1317,JointPQPlayer,143,283,426,13,29,JointPQPlayer
1318,JointPQPlayer,272,207,479,36,19,Player A
1319,JointPQPlayer,292,202,494,36,14,Player A
1320,JointPQPlayer,169,269,438,16,26,JointPQPlayer
1321,JointPQPlayer,251,241,492,40,16,Player A
1322,JointPQPlayer,260,235,495,40,15,Player A
1323,JointPQPlayer,268,218,486,34,16,Player A
1324,JointPQPlayer,277,227,504,46,14,Player A
1325,JointPQPlayer,265,245,510,49,13,Player A
1326,JointPQPlayer,223,238,461,27,22,JointPQPlayer
1327,JointPQPlayer,289,219,508,44,12,Player A
1328,JointPQPlayer,261,231,492,40,16,Player A
1329,JointPQPlayer,292,227,519,52,11,Player A
1330,JointPQPlayer,125,300,425,15,30,JointPQPlayer
1331,JointPQPlayer,266,256,522,46,8,Player A
1332,JointPQPlayer,284,229,513,46,11,Player A
1333,JointPQPlayer,274,219,493,32,13,Player A
1334,JointPQPlayer,226,261,487,32,15,JointPQPlayer
1335,JointPQPlayer,105,330,435,16,27,JointPQPlayer
1336,JointPQPlayer,250,240,490,38,16,Player A
1337,JointPQPlayer,271,221,492,34,14,Player A
1338,JointPQPlayer,161,286,447,22,25,JointPQPlayer
1339,JointPQPlayer,158,268,426,19,31,JointPQPlayer
1340,JointPQPlayer,288,213,501,40,13,Player A
1341,JointPQPlayer,326,201,527,42,5,Player A
1342,JointPQPlayer,298,178,476,33,19,Player A
1343,JointPQPlayer,274,234,508,41,11,Player A
1344,JointPQPlayer,146,281,427,17,30,JointPQPlayer
1345,JointPQPlayer,148,283,431,18,29,JointPQPlayer
1346,JointPQPlayer,265,225,490,35,15,Player A
1347,JointPQPlayer,272,212,484,38,18,Player A
1348,JointPQPlayer,238,238,476,33,19,Tie
1349,JointPQPlayer,144,289,433,14,27,JointPQPlayer
1350,JointPQPlayer,269,239,508,50,14,Player A
1351,JointPQPlayer,283,223,506,45,13,Player A
1352,JointPQPlayer,283,213,496,41,15,Player A
1353,JointPQPlayer,161,276,437,18,27,JointPQPlayer
1354,JointPQPlayer,255,255,510,43,11,Tie
1355,JointPQPlayer,126,286,412,11,33,JointPQPlayer
1356,JointPQPlayer,287,192,479,33,18,Player A
1357,JointPQPlayer,152,267,419,18,33,JointPQPlayer
1358,JointPQPlayer,256,236,492,40,16,Player A
1359,JointPQPlayer,261,236,497,48,17,Player A
1360,JointPQPlayer,290,200,490,38,16,Player A
1361,JointPQPlayer,303,213,516,37,7,Player A
1362,JointPQPlayer,291,231,522,46,8,Player A
1363,JointPQPlayer,153,293,446,18,24,JointPQPlayer
1364,JointPQPlayer,252,247,499,35,12,Player A
1365,JointPQPlayer,142,267,409,17,36,JointPQPlayer
1366,JointPQPlayer,297,202,499,41,14,Player A
1367,JointPQPlayer,295,225,520,47,9,Player A
1368,JointPQPlayer,265,225,490,44,18,Player A
1369,JointPQPlayer,138,283,421,20,33,JointPQPlayer
1370,JointPQPlayer,167,272,439,17,26,JointPQPlayer
1371,JointPQPlayer,299,214,513,43,10,Player A
1372,JointPQPlayer,251,246,497,39,14,Player A
1373,JointPQPlayer,294,224,518,48,10,Player A
1374,JointPQPlayer,145,290,435,13,26,JointPQPlayer
1375,JointPQPlayer,249,259,508,44,12,JointPQPlayer
1376,JointPQPlayer,208,273,481,35,18,JointPQPlayer
1377,JointPQPlayer,253,228,481,29,16,Player A
1378,JointPQPlayer,277,227,504,46,14,Player A
1379,JointPQPlayer,318,193,511,38,9,Player A
1380,JointPQPlayer,259,234,493,44,17,Player A
1381,JointPQPlayer,313,183,496,41,15,Player A
1382,JointPQPlayer,141,271,412,20,36,JointPQPlayer
1383,JointPQPlayer,276,211,487,38,17,Player A
1384,JointPQPlayer,128,278,406,14,36,JointPQPlayer
1385,JointPQPlayer,299,199,498,40,14,Player A
1386,JointPQPlayer,213,248,461,21,20,JointPQPlayer
1387,JointPQPlayer,271,236,507,43,12,Player A
1388,JointPQPlayer,210,270,480,31,17,JointPQPlayer
1389,JointPQPlayer,289,224,513,43,10,Player A
1390,JointPQPlayer,239,239,478,35,19,Tie
1391,JointPQPlayer,275,230,505,38,11,Player A
1392,JointPQPlayer,244,234,478,35,19,Player A
1393,JointPQPlayer,283,238,521,48,9,Player A
1394,JointPQPlayer,262,227,489,34,15,Player A
1395,JointPQPlayer,280,235,515,48,11,Player A
1396,JointPQPlayer,163,263,426,19,31,JointPQPlayer
1397,JointPQPlayer,173,233,406,14,36,JointPQPlayer
1398,JointPQPlayer,150,280,430,23,31,JointPQPlayer
1399,JointPQPlayer,253,253,506,48,14,Tie
1400,JointPQPlayer,291,201,492,34,14,Player A
1401,JointPQPlayer,275,250,525,46,7,Player A
1402,JointPQPlayer,290,225,515,51,12,Player A
1403,JointPQPlayer,133,308,441,19,26,JointPQPlayer
1404,JointPQPlayer,190,265,455,24,23,JointPQPlayer
1405,JointPQPlayer,275,200,475,38,21,Player A
1406,JointPQPlayer,285,210,495,34,13,Player A
1407,JointPQPlayer,130,295,425,21,32,JointPQPlayer
1408,JointPQPlayer,294,234,528,49,7,Player A
1409,JointPQPlayer,263,233,496,50,18,Player A
1410,JointPQPlayer,299,214,513,46,11,Player A
1411,JointPQPlayer,183,273,456,28,24,JointPQPlayer
1412,JointPQPlayer,226,281,507,40,11,JointPQPlayer
1413,JointPQPlayer,247,242,489,40,17,Player A
1414,JointPQPlayer,186,266,452,21,23,JointPQPlayer
1415,JointPQPlayer,264,224,488,36,16,Player A
1416,JointPQPlayer,263,243,506,33,9,Player A
1417,JointPQPlayer,272,232,504,37,11,Player A
1418,JointPQPlayer,282,212,494,36,14,Player A
1419,JointPQPlayer,281,196,477,34,19,Player A
1420,JointPQPlayer,313,188,501,40,13,Player A
1421,JointPQPlayer,274,224,498,43,15,Player A
1422,JointPQPlayer,289,224,513,43,10,Player A
1423,JointPQPlayer,237,262,499,44,15,JointPQPlayer
1424,JointPQPlayer,213,273,486,40,18,JointPQPlayer
1425,JointPQPlayer,278,233,511,44,11,Player A
1426,JointPQPlayer,265,245,510,40,10,Player A
1427,JointPQPlayer,228,238,466,32,22,JointPQPlayer
1428,JointPQPlayer,119,299,418,14,32,JointPQPlayer
1429,JointPQPlayer,308,208,516,43,9,Player A
1430,JointPQPlayer,278,233,511,41,10,Player A
1431,JointPQPlayer,288,193,481,35,18,Player A
1432,JointPQPlayer,163,288,451,23,24,JointPQPlayer
1433,JointPQPlayer,180,270,450,19,23,JointPQPlayer
1434,JointPQPlayer,147,292,439,14,25,JointPQPlayer
1435,JointPQPlayer,298,213,511,38,9,Player A
1436,JointPQPlayer,264,239,503,36,11,Player A
1437,JointPQPlayer,104,339,443,9,22,JointPQPlayer
1438,JointPQPlayer,273,218,491,39,16,Player A
1439,JointPQPlayer,134,294,428,18,30,JointPQPlayer
1440,JointPQPlayer,308,188,496,38,14,Player A
1441,JointPQPlayer,266,216,482,39,19,Player A
1442,JointPQPlayer,286,221,507,46,13,Player A
1443,JointPQPlayer,270,230,500,39,13,Player A
1444,JointPQPlayer,117,322,439,14,25,JointPQPlayer
1445,JointPQPlayer,299,209,508,44,12,Player A
1446,JointPQPlayer,271,241,512,39,9,Player A
1447,JointPQPlayer,279,219,498,43,15,Player A
1448,JointPQPlayer,186,271,457,26,23,JointPQPlayer
1449,JointPQPlayer,247,242,489,31,14,Player A
1450,JointPQPlayer,282,222,504,37,11,Player A
1451,JointPQPlayer,236,251,487,38,17,JointPQPlayer
1452,JointPQPlayer,144,284,428,15,29,JointPQPlayer
1453,JointPQPlayer,140,295,435,19,28,JointPQPlayer
1454,JointPQPlayer,242,227,469,32,21,Player A
1455,JointPQPlayer,279,234,513,43,10,Player A
1456,JointPQPlayer,138,303,441,19,26,JointPQPlayer
1457,JointPQPlayer,122,312,434,18,28,JointPQPlayer
1458,JointPQPlayer,257,257,514,44,10,Tie
1459,JointPQPlayer,295,215,510,46,12,Player A
1460,JointPQPlayer,285,220,505,50,15,Player A
1461,JointPQPlayer,266,236,502,38,12,Player A
1462,JointPQPlayer,247,242,489,34,15,Player A
1463,JointPQPlayer,265,230,495,43,16,Player A
1464,JointPQPlayer,267,232,499,35,12,Player A
1465,JointPQPlayer,279,244,523,47,8,Player A
1466,JointPQPlayer,268,243,511,44,11,Player A
1467,JointPQPlayer,230,210,440,24,28,Player A
1468,JointPQPlayer,275,230,505,38,11,Player A
1469,JointPQPlayer,279,229,508,41,11,Player A
1470,JointPQPlayer,291,216,507,40,11,Player A
1471,JointPQPlayer,225,280,505,38,11,JointPQPlayer
1472,JointPQPlayer,258,238,496,41,15,Player A
1473,JointPQPlayer,263,203,466,29,21,Player A
1474,JointPQPlayer,292,227,519,46,9,Player A
1475,JointPQPlayer,275,215,490,38,16,Player A
1476,JointPQPlayer,327,172,499,35,12,Player A
1477,JointPQPlayer,261,236,497,39,14,Player A
1478,JointPQPlayer,252,247,499,38,13,Player A
1479,JointPQPlayer,280,235,515,39,8,Player A
1480,JointPQPlayer,123,303,426,19,31,JointPQPlayer
1481,JointPQPlayer,236,266,502,44,14,JointPQPlayer
1482,JointPQPlayer,296,186,482,30,16,Player A
1483,JointPQPlayer,300,210,510,43,11,Player A
1484,JointPQPlayer,172,287,459,19,20,JointPQPlayer
1485,JointPQPlayer,224,234,458,33,25,JointPQPlayer
1486,JointPQPlayer,109,339,448,14,22,JointPQPlayer
1487,JointPQPlayer,295,210,505,47,14,Player A
1488,JointPQPlayer,298,213,511,44,11,Player A
1489,JointPQPlayer,303,213,516,46,10,Player A
1490,JointPQPlayer,240,265,505,38,11,JointPQPlayer
1491,JointPQPlayer,140,285,425,18,31,JointPQPlayer
1492,JointPQPlayer,124,319,443,15,24,JointPQPlayer
1493,JointPQPlayer,125,305,430,17,29,JointPQPlayer
1494,JointPQPlayer,108,333,441,19,26,JointPQPlayer
1495,JointPQPlayer,308,198,506,42,12,Player A
1496,JointPQPlayer,289,229,518,42,8,Player A
1497,JointPQPlayer,120,320,440,12,24,JointPQPlayer
1498,JointPQPlayer,323,183,506,39,11,Player A
1499,JointPQPlayer,268,228,496,38,14,Player A
1500,JointPQPlayer,291,216,507,46,13,Player A
1501,JointPQPlayer,157,262,419,18,33,JointPQPlayer
1502,JointPQPlayer,299,219,518,36,6,Player A
1503,JointPQPlayer,269,249,518,42,8,Player A
1504,JointPQPlayer,271,231,502,41,13,Player A
1505,JointPQPlayer,279,224,503,36,11,Player A
1506,JointPQPlayer,277,232,509,42,11,Player A
1507,JointPQPlayer,301,206,507,40,11,Player A
1508,JointPQPlayer,206,266,472,26,18,JointPQPlayer
1509,JointPQPlayer,220,255,475,26,17,JointPQPlayer
1510,JointPQPlayer,283,238,521,45,8,Player A
1511,JointPQPlayer,104,299,403,14,37,JointPQPlayer
1512,JointPQPlayer,270,225,495,34,13,Player A
1513,JointPQPlayer,150,300,450,19,23,JointPQPlayer
1514,JointPQPlayer,272,242,514,41,9,Player A
1515,JointPQPlayer,151,286,437,21,28,JointPQPlayer
1516,JointPQPlayer,250,260,510,40,10,JointPQPlayer
1517,JointPQPlayer,290,230,520,47,9,Player A
1518,JointPQPlayer,293,203,496,44,16,Player A
1519,JointPQPlayer,151,306,457,29,24,JointPQPlayer
1520,JointPQPlayer,262,217,479,33,18,Player A
1521,JointPQPlayer,275,250,525,49,8,Player A
1522,JointPQPlayer,156,286,442,20,26,JointPQPlayer
1523,JointPQPlayer,286,216,502,41,13,Player A
1524,JointPQPlayer,286,221,507,43,12,Player A
1525,JointPQPlayer,122,287,409,14,35,JointPQPlayer
1526,JointPQPlayer,261,226,487,35,16,Player A
1527,JointPQPlayer,253,233,486,34,16,Player A
1528,JointPQPlayer,188,278,466,35,23,JointPQPlayer
1529,JointPQPlayer,255,230,485,39,18,Player A
1530,JointPQPlayer,141,306,447,22,25,JointPQPlayer
1531,JointPQPlayer,274,224,498,46,16,Player A
1532,JointPQPlayer,261,226,487,29,14,Player A
1533,JointPQPlayer,275,260,535,47,4,Player A
1534,JointPQPlayer,202,257,459,25,22,JointPQPlayer
1535,JointPQPlayer,292,212,504,43,13,Player A
1536,JointPQPlayer,163,268,431,18,29,JointPQPlayer
1537,JointPQPlayer,122,312,434,15,27,JointPQPlayer
1538,JointPQPlayer,245,250,495,40,15,JointPQPlayer
1539,JointPQPlayer,238,268,506,45,13,JointPQPlayer
1540,JointPQPlayer,129,284,413,15,34,JointPQPlayer
1541,JointPQPlayer,230,255,485,36,17,JointPQPlayer
1542,JointPQPlayer,235,215,450,31,27,Player A
1543,JointPQPlayer,133,313,446,21,25,JointPQPlayer
1544,JointPQPlayer,268,238,506,45,13,Player A
1545,JointPQPlayer,282,207,489,40,17,Player A
1546,JointPQPlayer,120,305,425,18,31,JointPQPlayer
1547,JointPQPlayer,209,259,468,31,21,JointPQPlayer
1548,JointPQPlayer,259,259,518,45,9,Tie
1549,JointPQPlayer,246,241,487,38,17,Player A
1550,JointPQPlayer,233,268,501,43,14,JointPQPlayer
1551,JointPQPlayer,223,253,476,30,18,JointPQPlayer
1552,JointPQPlayer,321,181,502,41,13,Player A
1553,JointPQPlayer,134,279,413,15,34,JointPQPlayer
1554,JointPQPlayer,291,206,497,33,12,Player A
1555,JointPQPlayer,120,300,420,10,30,JointPQPlayer
1556,JointPQPlayer,283,203,486,40,18,Player A
1557,JointPQPlayer,124,309,433,17,28,JointPQPlayer
1558,JointPQPlayer,282,242,524,54,10,Player A
1559,JointPQPlayer,266,231,497,42,15,Player A
1560,JointPQPlayer,287,217,504,37,11,Player A
1561,JointPQPlayer,291,226,517,41,8,Player A
1562,JointPQPlayer,136,291,427,17,30,JointPQPlayer
1563,JointPQPlayer,280,220,500,45,15,Player A
1564,JointPQPlayer,261,246,507,34,9,Player A
1565,JointPQPlayer,281,206,487,41,18,Player A
1566,JointPQPlayer,218,263,481,32,17,JointPQPlayer
1567,JointPQPlayer,245,240,485,30,15,Player A
1568,JointPQPlayer,264,254,518,42,8,Player A
1569,JointPQPlayer,154,259,413,18,35,JointPQPlayer
1570,JointPQPlayer,200,280,480,31,17,JointPQPlayer
1571,JointPQPlayer,278,223,501,40,13,Player A
1572,JointPQPlayer,300,205,505,35,10,Player A
1573,JointPQPlayer,286,226,512,39,9,Player A
1574,JointPQPlayer,276,211,487,29,14,Player A
1575,JointPQPlayer,213,258,471,31,20,JointPQPlayer
1576,JointPQPlayer,246,276,522,46,8,JointPQPlayer
1577,JointPQPlayer,285,225,510,37,9,Player A
1578,JointPQPlayer,299,234,533,51,6,Player A
1579,JointPQPlayer,267,227,494,39,15,Player A
1580,JointPQPlayer,181,281,462,25,21,JointPQPlayer
1581,JointPQPlayer,291,201,492,34,14,Player A
1582,JointPQPlayer,106,331,437,15,26,JointPQPlayer
1583,JointPQPlayer,149,279,428,18,30,JointPQPlayer
1584,JointPQPlayer,277,252,529,44,5,Player A
1585,JointPQPlayer,126,291,417,19,34,JointPQPlayer
1586,JointPQPlayer,257,232,489,34,15,Player A
1587,JointPQPlayer,120,290,410,12,34,JointPQPlayer
1588,JointPQPlayer,243,258,501,46,15,JointPQPlayer
1589,JointPQPlayer,149,304,453,22,23,JointPQPlayer
1590,JointPQPlayer,270,240,510,46,12,Player A
1591,JointPQPlayer,154,264,418,17,33,JointPQPlayer
1592,JointPQPlayer,248,238,486,40,18,Player A
1593,JointPQPlayer,210,250,460,26,22,JointPQPlayer
1594,JointPQPlayer,283,218,501,34,11,Player A
1595,JointPQPlayer,148,313,461,24,21,JointPQPlayer
1596,JointPQPlayer,289,224,513,43,10,Player A
1597,JointPQPlayer,295,205,500,39,13,Player A
1598,JointPQPlayer,276,236,512,42,10,Player A
1599,JointPQPlayer,261,241,502,41,13,Player A
1600,JointPQPlayer,160,260,420,19,33,JointPQPlayer
1601,JointPQPlayer,268,218,486,37,17,Player A
1602,JointPQPlayer,274,209,483,31,16,Player A
1603,JointPQPlayer,288,223,511,44,11,Player A
1604,JointPQPlayer,273,233,506,45,13,Player A
1605,JointPQPlayer,299,209,508,47,13,Player A
1606,JointPQPlayer,142,282,424,17,31,JointPQPlayer
1607,JointPQPlayer,280,235,515,48,11,Player A
1608,JointPQPlayer,244,259,503,39,12,JointPQPlayer
1609,JointPQPlayer,137,312,449,27,26,JointPQPlayer
1610,JointPQPlayer,204,254,458,30,24,JointPQPlayer
1611,JointPQPlayer,297,212,509,36,9,Player A
1612,JointPQPlayer,266,221,487,38,17,Player A
1613,JointPQPlayer,163,278,441,22,27,JointPQPlayer
1614,JointPQPlayer,136,286,422,18,32,JointPQPlayer
1615,JointPQPlayer,140,300,440,15,25,JointPQPlayer
1616,JointPQPlayer,261,206,467,33,22,Player A
1617,JointPQPlayer,266,226,492,46,18,Player A
1618,JointPQPlayer,247,262,509,45,12,JointPQPlayer
1619,JointPQPlayer,135,280,415,11,32,JointPQPlayer
1620,JointPQPlayer,126,316,442,23,27,JointPQPlayer
1621,JointPQPlayer,232,262,494,33,13,JointPQPlayer
1622,JointPQPlayer,281,221,502,41,13,Player A
1623,JointPQPlayer,284,219,503,36,11,Player A
1624,JointPQPlayer,111,291,402,16,38,JointPQPlayer
1625,JointPQPlayer,240,265,505,38,11,JointPQPlayer
1626,JointPQPlayer,291,206,497,42,15,Player A
1627,JointPQPlayer,273,213,486,34,16,Player A
1628,JointPQPlayer,282,242,524,45,7,Player A
1629,JointPQPlayer,259,214,473,39,22,Player A
1630,JointPQPlayer,133,268,401,12,37,JointPQPlayer
1631,JointPQPlayer,249,229,478,35,19,Player A
1632,JointPQPlayer,261,226,487,38,17,Player A
1633,JointPQPlayer,230,245,475,35,20,JointPQPlayer
1634,JointPQPlayer,270,245,515,45,10,Player A
1635,JointPQPlayer,128,273,401,12,37,JointPQPlayer
1636,JointPQPlayer,155,285,440,18,26,JointPQPlayer
1637,JointPQPlayer,285,225,510,43,11,Player A
1638,JointPQPlayer,129,314,443,15,24,JointPQPlayer
1639,JointPQPlayer,238,233,471,37,22,Player A
1640,JointPQPlayer,279,209,488,36,16,Player A
1641,JointPQPlayer,251,246,497,42,15,Player A
1642,JointPQPlayer,154,294,448,23,25,JointPQPlayer
1643,JointPQPlayer,191,266,457,17,20,JointPQPlayer
1644,JointPQPlayer,256,236,492,46,18,Player A
1645,JointPQPlayer,198,268,466,32,22,JointPQPlayer
1646,JointPQPlayer,246,246,492,31,13,Tie
1647,JointPQPlayer,286,221,507,40,11,Player A
1648,JointPQPlayer,305,195,500,42,14,Player A
1649,JointPQPlayer,272,232,504,49,15,Player A
1650,JointPQPlayer,129,299,428,18,30,JointPQPlayer
1651,JointPQPlayer,244,244,488,36,16,Tie
1652,JointPQPlayer,218,268,486,34,16,JointPQPlayer
1653,JointPQPlayer,259,239,498,40,14,Player A
1654,JointPQPlayer,319,174,493,35,14,Player A
1655,JointPQPlayer,154,274,428,12,28,JointPQPlayer
1656,JointPQPlayer,113,303,416,12,32,JointPQPlayer
1657,JointPQPlayer,168,263,431,27,32,JointPQPlayer
1658,JointPQPlayer,157,292,449,21,24,JointPQPlayer
1659,JointPQPlayer,295,195,490,41,17,Player A
1660,JointPQPlayer,299,214,513,46,11,Player A
1661,JointPQPlayer,248,243,491,36,15,Player A
1662,JointPQPlayer,209,274,483,34,17,JointPQPlayer
1663,JointPQPlayer,270,235,505,44,13,Player A
1664,JointPQPlayer,132,272,404,15,37,JointPQPlayer
1665,JointPQPlayer,124,309,433,14,27,JointPQPlayer
1666,JointPQPlayer,273,218,491,39,16,Player A
1667,JointPQPlayer,156,306,462,25,21,JointPQPlayer
1668,JointPQPlayer,229,249,478,32,18,JointPQPlayer
1669,JointPQPlayer,291,201,492,31,13,Player A
1670,JointPQPlayer,297,222,519,40,7,Player A
1671,JointPQPlayer,242,257,499,41,14,JointPQPlayer
1672,JointPQPlayer,128,318,446,21,25,JointPQPlayer
1673,JointPQPlayer,256,256,512,48,12,Tie
1674,JointPQPlayer,129,294,423,16,31,JointPQPlayer
1675,JointPQPlayer,274,259,533,45,4,Player A
1676,JointPQPlayer,274,234,508,47,13,Player A
1677,JointPQPlayer,257,232,489,40,17,Player A
1678,JointPQPlayer,240,260,500,42,14,JointPQPlayer
1679,JointPQPlayer,129,294,423,13,30,JointPQPlayer
1680,JointPQPlayer,278,218,496,41,15,Player A
1681,JointPQPlayer,284,234,518,39,7,Player A
1682,JointPQPlayer,194,244,438,25,29,JointPQPlayer
1683,JointPQPlayer,259,214,473,39,22,Player A
1684,JointPQPlayer,288,218,506,45,13,Player A
1685,JointPQPlayer,282,227,509,45,12,Player A
1686,JointPQPlayer,243,233,476,36,20,Player A
1687,JointPQPlayer,296,231,527,48,7,Player A
1688,JointPQPlayer,282,192,474,34,20,Player A
1689,JointPQPlayer,285,220,505,41,12,Player A
1690,JointPQPlayer,134,304,438,16,26,JointPQPlayer
1691,JointPQPlayer,216,286,502,35,11,JointPQPlayer
1692,JointPQPlayer,273,228,501,34,11,Player A
1693,JointPQPlayer,299,229,528,49,7,Player A
1694,JointPQPlayer,171,266,437,21,28,JointPQPlayer
1695,JointPQPlayer,252,242,494,39,15,Player A
1696,JointPQPlayer,301,211,512,42,10,Player A
1697,JointPQPlayer,136,296,432,13,27,JointPQPlayer
1698,JointPQPlayer,271,231,502,38,12,Player A
1699,JointPQPlayer,243,243,486,34,16,Tie
1700,JointPQPlayer,276,231,507,43,12,Player A
1701,JointPQPlayer,309,194,503,42,13,Player A
1702,JointPQPlayer,206,236,442,29,29,JointPQPlayer
1703,JointPQPlayer,297,202,499,41,14,Player A
1704,JointPQPlayer,178,263,441,22,27,JointPQPlayer
1705,JointPQPlayer,263,243,506,36,10,Player A
1706,JointPQPlayer,265,240,505,41,12,Player A
1707,JointPQPlayer,279,214,493,41,16,Player A
1708,JointPQPlayer,226,271,497,45,16,JointPQPlayer
1709,JointPQPlayer,296,211,507,37,10,Player A
1710,JointPQPlayer,136,301,437,21,28,JointPQPlayer
1711,JointPQPlayer,162,267,429,16,29,JointPQPlayer
1712,JointPQPlayer,186,256,442,26,28,JointPQPlayer
1713,JointPQPlayer,136,316,452,18,22,JointPQPlayer
1714,JointPQPlayer,291,196,487,38,17,Player A
1715,JointPQPlayer,264,239,503,36,11,Player A
1716,JointPQPlayer,240,245,485,39,18,JointPQPlayer
1717,JointPQPlayer,287,217,504,43,13,Player A
1718,JointPQPlayer,273,228,501,40,13,Player A
1719,JointPQPlayer,239,249,488,39,17,JointPQPlayer
1720,JointPQPlayer,276,221,497,39,14,Player A
1721,JointPQPlayer,171,276,447,22,25,JointPQPlayer
1722,JointPQPlayer,263,258,521,48,9,Player A
1723,JointPQPlayer,265,225,490,38,16,Player A
1724,JointPQPlayer,283,213,496,38,14,Player A
1725,JointPQPlayer,259,254,513,43,10,Player A
1726,JointPQPlayer,317,177,494,30,12,Player A
1727,JointPQPlayer,159,264,423,16,31,JointPQPlayer
1728,JointPQPlayer,250,260,510,40,10,JointPQPlayer
1729,JointPQPlayer,139,279,418,17,33,JointPQPlayer
1730,JointPQPlayer,277,222,499,41,14,Player A
1731,JointPQPlayer,283,223,506,39,11,Player A
1732,JointPQPlayer,294,204,498,40,14,Player A
1733,JointPQPlayer,285,225,510,40,10,Player A
1734,JointPQPlayer,251,241,492,37,15,Player A
1735,JointPQPlayer,225,255,480,40,20,JointPQPlayer
1736,JointPQPlayer,133,313,446,21,25,JointPQPlayer
1737,JointPQPlayer,265,230,495,40,15,Player A
1738,JointPQPlayer,256,256,512,42,10,Tie
1739,JointPQPlayer,143,293,436,11,25,JointPQPlayer
1740,JointPQPlayer,140,290,430,14,28,JointPQPlayer
1741,JointPQPlayer,303,198,501,37,12,Player A
1742,JointPQPlayer,243,253,496,41,15,JointPQPlayer
1743,JointPQPlayer,253,248,501,40,13,Player A
1744,JointPQPlayer,291,216,507,46,13,Player A
1745,JointPQPlayer,142,262,404,18,38,JointPQPlayer
1746,JointPQPlayer,256,231,487,35,16,Player A
1747,JointPQPlayer,272,222,494,36,14,Player A
1748,JointPQPlayer,312,207,519,40,7,Player A
1749,JointPQPlayer,158,263,421,14,31,JointPQPlayer
1750,JointPQPlayer,139,319,458,18,20,JointPQPlayer
1751,JointPQPlayer,291,201,492,37,15,Player A
1752,JointPQPlayer,154,274,428,15,29,JointPQPlayer
1753,JointPQPlayer,260,250,510,40,10,Player A
1754,JointPQPlayer,277,227,504,40,12,Player A
1755,JointPQPlayer,173,258,431,21,30,JointPQPlayer
1756,JointPQPlayer,166,246,412,17,35,JointPQPlayer
1757,JointPQPlayer,246,241,487,38,17,Player A
1758,JointPQPlayer,117,317,434,18,28,JointPQPlayer
1759,JointPQPlayer,143,303,446,21,25,JointPQPlayer
1760,JointPQPlayer,306,191,497,36,13,Player A
1761,JointPQPlayer,225,230,455,24,23,JointPQPlayer
1762,JointPQPlayer,246,266,512,42,10,JointPQPlayer
1763,JointPQPlayer,257,227,484,35,17,Player A
1764,JointPQPlayer,250,260,510,40,10,JointPQPlayer
1765,JointPQPlayer,133,303,436,20,28,JointPQPlayer
1766,JointPQPlayer,230,250,480,34,18,JointPQPlayer
1767,JointPQPlayer,292,192,484,32,16,Player A
1768,JointPQPlayer,153,278,431,18,29,JointPQPlayer
1769,JointPQPlayer,214,274,488,42,18,JointPQPlayer
1770,JointPQPlayer,221,246,467,36,23,JointPQPlayer
1771,JointPQPlayer,140,280,420,19,33,JointPQPlayer
1772,JointPQPlayer,175,270,445,26,27,JointPQPlayer
1773,JointPQPlayer,296,206,502,44,14,Player A
1774,JointPQPlayer,140,300,440,21,27,JointPQPlayer
1775,JointPQPlayer,290,220,510,46,12,Player A
1776,JointPQPlayer,132,292,424,17,31,JointPQPlayer
1777,JointPQPlayer,297,207,504,37,11,Player A
1778,JointPQPlayer,287,217,504,43,13,Player A
1779,JointPQPlayer,271,206,477,31,18,Player A
1780,JointPQPlayer,302,222,524,48,8,Player A
1781,JointPQPlayer,250,245,495,40,15,Player A
1782,JointPQPlayer,185,270,455,30,25,JointPQPlayer
1783,JointPQPlayer,278,218,496,32,12,Player A
1784,JointPQPlayer,261,246,507,43,12,Player A
1785,JointPQPlayer,310,205,515,45,10,Player A
1786,JointPQPlayer,273,213,486,40,18,Player A
1787,JointPQPlayer,278,243,521,42,7,Player A
1788,JointPQPlayer,248,258,506,51,15,JointPQPlayer
1789,JointPQPlayer,299,199,498,34,12,Player A
1790,JointPQPlayer,109,324,433,14,27,JointPQPlayer
1791,JointPQPlayer,272,232,504,43,13,Player A
1792,JointPQPlayer,257,237,494,36,14,Player A
1793,JointPQPlayer,259,239,498,40,14,Player A
1794,JointPQPlayer,136,296,432,22,30,JointPQPlayer
1795,JointPQPlayer,167,287,454,20,22,JointPQPlayer
1796,JointPQPlayer,167,282,449,21,24,JointPQPlayer
1797,JointPQPlayer,311,191,502,38,12,Player A
1798,JointPQPlayer,274,244,518,51,11,Player A
1799,JointPQPlayer,182,267,449,21,24,JointPQPlayer
1800,JointPQPlayer,284,234,518,48,10,Player A
1801,JointPQPlayer,290,220,510,43,11,Player A
1802,JointPQPlayer,212,277,489,31,14,JointPQPlayer
1803,JointPQPlayer,262,222,484,32,16,Player A
1804,JointPQPlayer,155,305,460,23,21,JointPQPlayer
1805,JointPQPlayer,239,269,508,38,10,JointPQPlayer
1806,JointPQPlayer,275,255,530,54,8,Player A
1807,JointPQPlayer,298,203,501,40,13,Player A
1808,JointPQPlayer,135,275,410,15,35,JointPQPlayer
1809,JointPQPlayer,111,326,437,18,27,JointPQPlayer
1810,JointPQPlayer,265,230,495,40,15,Player A
1811,JointPQPlayer,155,270,425,21,32,JointPQPlayer
1812,JointPQPlayer,296,211,507,40,11,Player A
1813,JointPQPlayer,280,215,495,37,14,Player A
1814,JointPQPlayer,233,273,506,42,12,JointPQPlayer
1815,JointPQPlayer,255,245,500,39,13,Player A
1816,JointPQPlayer,290,210,500,48,16,Player A
1817,JointPQPlayer,148,288,436,23,29,JointPQPlayer
1818,JointPQPlayer,304,214,518,48,10,Player A
1819,JointPQPlayer,214,269,483,37,18,JointPQPlayer
1820,JointPQPlayer,291,231,522,43,7,Player A
1821,JointPQPlayer,296,211,507,43,12,Player A
1822,JointPQPlayer,132,302,434,18,28,JointPQPlayer
1823,JointPQPlayer,259,214,473,39,22,Player A
1824,JointPQPlayer,279,229,508,41,11,Player A
1825,JointPQPlayer,280,220,500,39,13,Player A
1826,JointPQPlayer,280,210,490,44,18,Player A
1827,JointPQPlayer,282,222,504,40,12,Player A
1828,JointPQPlayer,188,283,471,28,19,JointPQPlayer
1829,JointPQPlayer,292,217,509,48,13,Player A
1830,JointPQPlayer,287,212,499,44,15,Player A
1831,JointPQPlayer,257,247,504,40,12,Player A
1832,JointPQPlayer,256,256,512,42,10,Tie
1833,JointPQPlayer,273,233,506,39,11,Player A
1834,JointPQPlayer,258,208,466,29,21,Player A
1835,JointPQPlayer,291,211,502,41,13,Player A
1836,JointPQPlayer,177,282,459,25,22,JointPQPlayer
1837,JointPQPlayer,150,280,430,23,31,JointPQPlayer
1838,JointPQPlayer,276,226,502,47,15,Player A
1839,JointPQPlayer,159,274,433,17,28,JointPQPlayer
1840,JointPQPlayer,291,231,522,46,8,Player A
1841,JointPQPlayer,245,255,500,42,14,JointPQPlayer
1842,JointPQPlayer,297,187,484,29,15,Player A
1843,JointPQPlayer,233,278,511,44,11,JointPQPlayer
1844,JointPQPlayer,156,266,422,18,32,JointPQPlayer
1845,JointPQPlayer,272,242,514,41,9,Player A
1846,JointPQPlayer,143,288,431,18,29,JointPQPlayer
1847,JointPQPlayer,147,292,439,20,27,JointPQPlayer
1848,JointPQPlayer,267,237,504,46,14,Player A
1849,JointPQPlayer,276,231,507,46,13,Player A
1850,JointPQPlayer,124,299,423,16,31,JointPQPlayer
1851,JointPQPlayer,265,235,500,39,13,Player A
1852,JointPQPlayer,288,228,516,46,10,Player A
1853,JointPQPlayer,267,227,494,39,15,Player A
1854,JointPQPlayer,280,210,490,44,18,Player A
1855,JointPQPlayer,274,219,493,44,17,Player A
1856,JointPQPlayer,111,316,427,17,30,JointPQPlayer
1857,JointPQPlayer,277,227,504,43,13,Player A
1858,JointPQPlayer,267,222,489,37,16,Player A
1859,JointPQPlayer,124,304,428,18,30,JointPQPlayer
1860,JointPQPlayer,126,301,427,20,31,JointPQPlayer
1861,JointPQPlayer,178,248,426,13,29,JointPQPlayer
1862,JointPQPlayer,249,244,493,44,17,Player A
1863,JointPQPlayer,259,239,498,37,13,Player A
1864,JointPQPlayer,255,240,495,37,14,Player A
1865,JointPQPlayer,260,235,495,43,16,Player A
1866,JointPQPlayer,297,212,509,42,11,Player A
1867,JointPQPlayer,271,241,512,42,10,Player A
1868,JointPQPlayer,286,231,517,47,10,Player A
1869,JointPQPlayer,199,274,473,33,20,JointPQPlayer
1870,JointPQPlayer,275,230,505,41,12,Player A
1871,JointPQPlayer,140,280,420,10,30,JointPQPlayer
1872,JointPQPlayer,290,210,500,42,14,Player A
1873,JointPQPlayer,260,225,485,33,16,Player A
1874,JointPQPlayer,182,267,449,24,25,JointPQPlayer
1875,JointPQPlayer,268,228,496,41,15,Player A
1876,JointPQPlayer,274,229,503,42,13,Player A
1877,JointPQPlayer,123,293,416,12,32,JointPQPlayer
1878,JointPQPlayer,248,253,501,40,13,JointPQPlayer
1879,JointPQPlayer,296,206,502,41,13,Player A
1880,JointPQPlayer,280,195,475,41,22,Player A
1881,JointPQPlayer,279,224,503,39,12,Player A
1882,JointPQPlayer,296,211,507,40,11,Player A
1883,JointPQPlayer,256,236,492,40,16,Player A
1884,JointPQPlayer,267,222,489,43,18,Player A
1885,JointPQPlayer,290,235,525,49,8,Player A
1886,JointPQPlayer,259,244,503,42,13,Player A
1887,JointPQPlayer,140,295,435,16,27,JointPQPlayer
1888,JointPQPlayer,252,217,469,35,22,Player A
1889,JointPQPlayer,125,295,420,19,33,JointPQPlayer
1890,JointPQPlayer,122,297,419,15,32,JointPQPlayer
1891,JointPQPlayer,119,294,413,15,34,JointPQPlayer
1892,JointPQPlayer,158,293,451,17,22,JointPQPlayer
1893,JointPQPlayer,244,264,508,47,13,JointPQPlayer
1894,JointPQPlayer,278,223,501,37,12,Player A
1895,JointPQPlayer,255,245,500,33,11,Player A
1896,JointPQPlayer,298,243,541,56,5,Player A
1897,JointPQPlayer,266,216,482,36,18,Player A
1898,JointPQPlayer,276,201,477,31,18,Player A
1899,JointPQPlayer,261,251,512,45,11,Player A
1900,JointPQPlayer,283,228,511,41,10,Player A
1901,JointPQPlayer,279,219,498,40,14,Player A
1902,JointPQPlayer,278,208,486,34,16,Player A
1903,JointPQPlayer,261,236,497,42,15,Player A
1904,JointPQPlayer,250,245,495,43,16,Player A
1905,JointPQPlayer,147,257,404,15,37,JointPQPlayer
1906,JointPQPlayer,290,230,520,44,8,Player A
1907,JointPQPlayer,281,211,492,40,16,Player A
1908,JointPQPlayer,127,322,449,18,23,JointPQPlayer
1909,JointPQPlayer,307,207,514,41,9,Player A
1910,JointPQPlayer,274,239,513,43,10,Player A
1911,JointPQPlayer,138,313,451,20,23,JointPQPlayer
1912,JointPQPlayer,242,242,484,35,17,Tie
1913,JointPQPlayer,292,217,509,45,12,Player A
1914,JointPQPlayer,131,291,422,18,32,JointPQPlayer
1915,JointPQPlayer,252,222,474,28,18,Player A
1916,JointPQPlayer,300,225,525,49,8,Player A
1917,JointPQPlayer,300,220,520,41,7,Player A
1918,JointPQPlayer,167,287,454,29,25,JointPQPlayer
1919,JointPQPlayer,139,294,433,20,29,JointPQPlayer
1920,JointPQPlayer,276,216,492,43,17,Player A
1921,JointPQPlayer,279,239,518,48,10,Player A
1922,JointPQPlayer,285,220,505,41,12,Player A
1923,JointPQPlayer,277,212,489,34,15,Player A
1924,JointPQPlayer,131,296,427,14,29,JointPQPlayer
1925,JointPQPlayer,295,235,530,51,7,Player A
1926,JointPQPlayer,310,195,505,38,11,Player A
1927,JointPQPlayer,255,255,510,46,12,Tie
1928,JointPQPlayer,284,214,498,37,13,Player A
1929,JointPQPlayer,279,204,483,34,17,Player A
1930,JointPQPlayer,289,209,498,40,14,Player A
1931,JointPQPlayer,266,231,497,45,16,Player A
1932,JointPQPlayer,260,220,480,37,19,Player A
1933,JointPQPlayer,264,239,503,36,11,Player A
1934,JointPQPlayer,158,278,436,17,27,JointPQPlayer
1935,JointPQPlayer,232,232,464,27,21,Tie
1936,JointPQPlayer,255,235,490,38,16,Player A
1937,JointPQPlayer,157,272,429,19,30,JointPQPlayer
1938,JointPQPlayer,180,290,470,24,18,JointPQPlayer
1939,JointPQPlayer,299,204,503,42,13,Player A
1940,JointPQPlayer,123,293,416,15,33,JointPQPlayer
1941,JointPQPlayer,260,235,495,37,14,Player A
1942,JointPQPlayer,142,287,429,25,32,JointPQPlayer
1943,JointPQPlayer,256,241,497,51,18,Player A
1944,JointPQPlayer,218,258,476,33,19,JointPQPlayer
1945,JointPQPlayer,262,242,504,43,13,Player A
1946,JointPQPlayer,306,221,527,45,6,Player A
1947,JointPQPlayer,316,201,517,41,8,Player A
1948,JointPQPlayer,167,277,444,16,24,JointPQPlayer
1949,JointPQPlayer,285,230,515,45,10,Player A
1950,JointPQPlayer,272,232,504,34,10,Player A
1951,JointPQPlayer,251,236,487,29,14,Player A
1952,JointPQPlayer,282,222,504,43,13,Player A
1953,JointPQPlayer,270,225,495,37,14,Player A
1954,JointPQPlayer,147,317,464,18,18,JointPQPlayer
1955,JointPQPlayer,284,219,503,36,11,Player A
1956,JointPQPlayer,214,279,493,35,14,JointPQPlayer
1957,JointPQPlayer,120,295,415,17,34,JointPQPlayer
1958,JointPQPlayer,254,244,498,34,12,Player A
1959,JointPQPlayer,309,214,523,38,5,Player A
1960,JointPQPlayer,266,241,507,34,9,Player A
1961,JointPQPlayer,259,259,518,48,10,Tie
1962,JointPQPlayer,299,204,503,39,12,Player A
1963,JointPQPlayer,244,244,488,33,15,Tie
1964,JointPQPlayer,282,207,489,46,19,Player A
1965,JointPQPlayer,144,274,418,17,33,JointPQPlayer
1966,JointPQPlayer,271,226,497,33,12,Player A
1967,JointPQPlayer,269,229,498,37,13,Player A
1968,JointPQPlayer,102,322,424,11,29,JointPQPlayer
1969,JointPQPlayer,292,217,509,48,13,Player A
1970,JointPQPlayer,305,195,500,42,14,Player A
1971,JointPQPlayer,287,212,499,44,15,Player A
1972,JointPQPlayer,274,219,493,35,14,Player A
1973,JointPQPlayer,264,229,493,41,16,Player A
1974,JointPQPlayer,147,282,429,25,32,JointPQPlayer
1975,JointPQPlayer,266,236,502,41,13,Player A
1976,JointPQPlayer,282,247,529,50,7,Player A
1977,JointPQPlayer,297,202,499,35,12,Player A
1978,JointPQPlayer,269,244,513,46,11,Player A
1979,JointPQPlayer,280,240,520,41,7,Player A
1980,JointPQPlayer,313,193,506,48,14,Player A
1981,JointPQPlayer,263,248,511,35,8,Player A
1982,JointPQPlayer,280,235,515,45,10,Player A
1983,JointPQPlayer,270,230,500,45,15,Player A
1984,JointPQPlayer,163,273,436,20,28,JointPQPlayer
1985,JointPQPlayer,145,285,430,14,28,JointPQPlayer
1986,JointPQPlayer,284,229,513,40,9,Player A
1987,JointPQPlayer,143,298,441,16,25,JointPQPlayer
1988,JointPQPlayer,283,208,491,36,15,Player A
1989,JointPQPlayer,305,210,515,45,10,Player A
1990,JointPQPlayer,308,208,516,49,11,Player A
1991,JointPQPlayer,281,206,487,32,15,Player A
1992,JointPQPlayer,238,233,471,31,20,Player A
1993,JointPQPlayer,262,232,494,45,17,Player A
1994,JointPQPlayer,259,244,503,36,11,Player A
1995,JointPQPlayer,229,269,498,34,12,JointPQPlayer
1996,JointPQPlayer,134,294,428,21,31,JointPQPlayer
1997,JointPQPlayer,272,252,524,48,8,Player A
1998,JointPQPlayer,258,228,486,43,19,Player A
1999,JointPQPlayer,291,211,502,38,12,Player A
2000,JointPQPlayer,263,248,511,50,13,Player A
2001,JointPQPlayer,244,244,488,39,17,Tie
2002,JointPQPlayer,146,296,442,17,25,JointPQPlayer
2003,JointPQPlayer,266,231,497,45,16,Player A
2004,JointPQPlayer,214,254,468,28,20,JointPQPlayer
2005,JointPQPlayer,285,220,505,38,11,Player A
2006,JointPQPlayer,282,227,509,42,11,Player A
2007,JointPQPlayer,138,268,406,8,34,JointPQPlayer
2008,JointPQPlayer,124,324,448,23,25,JointPQPlayer
2009,JointPQPlayer,202,302,504,40,12,JointPQPlayer
2010,JointPQPlayer,244,259,503,39,12,JointPQPlayer
2011,JointPQPlayer,185,275,460,26,22,JointPQPlayer
2012,JointPQPlayer,279,234,513,40,9,Player A
2013,JointPQPlayer,163,253,416,12,32,JointPQPlayer
2014,JointPQPlayer,294,194,488,36,16,Player A
2015,JointPQPlayer,124,279,403,14,37,JointPQPlayer
2016,JointPQPlayer,173,278,451,26,25,JointPQPlayer
2017,JointPQPlayer,308,223,531,46,5,Player A
2018,JointPQPlayer,111,301,412,11,33,JointPQPlayer
2019,JointPQPlayer,187,277,464,30,22,JointPQPlayer
2020,JointPQPlayer,294,214,508,47,13,Player A
2021,JointPQPlayer,285,220,505,35,10,Player A
2022,JointPQPlayer,110,300,410,12,34,JointPQPlayer
2023,JointPQPlayer,253,223,476,36,20,Player A
2024,JointPQPlayer,240,240,480,34,18,Tie
2025,JointPQPlayer,269,229,498,40,14,Player A
2026,JointPQPlayer,270,225,495,37,14,Player A
2027,JointPQPlayer,142,282,424,14,30,JointPQPlayer
2028,JointPQPlayer,136,296,432,16,28,JointPQPlayer
2029,JointPQPlayer,131,291,422,18,32,JointPQPlayer
2030,JointPQPlayer,246,246,492,37,15,Tie
2031,JointPQPlayer,230,235,465,28,21,JointPQPlayer
2032,JointPQPlayer,283,213,496,41,15,Player A
2033,JointPQPlayer,281,221,502,41,13,Player A
2034,JointPQPlayer,271,231,502,41,13,Player A
2035,JointPQPlayer,262,222,484,35,17,Player A
2036,JointPQPlayer,284,219,503,45,14,Player A
2037,JointPQPlayer,269,219,488,30,14,Player A
2038,JointPQPlayer,203,258,461,33,24,JointPQPlayer
2039,JointPQPlayer,179,274,453,28,25,JointPQPlayer
2040,JointPQPlayer,267,232,499,38,13,Player A
2041,JointPQPlayer,302,202,504,37,11,Player A
2042,JointPQPlayer,288,228,516,43,9,Player A
2043,JointPQPlayer,281,236,517,44,9,Player A
2044,JointPQPlayer,196,296,492,37,15,JointPQPlayer
2045,JointPQPlayer,266,241,507,37,10,Player A
2046,JointPQPlayer,279,254,533,51,6,Player A
2047,JointPQPlayer,289,214,503,39,12,Player A
2048,JointPQPlayer,132,292,424,20,32,JointPQPlayer
2049,JointPQPlayer,281,231,512,45,11,Player A
2050,JointPQPlayer,107,327,434,15,27,JointPQPlayer
2051,JointPQPlayer,288,223,511,41,10,Player A
2052,JointPQPlayer,137,292,429,19,30,JointPQPlayer
2053,JointPQPlayer,245,225,470,33,21,Player A
2054,JointPQPlayer,120,320,440,15,25,JointPQPlayer
2055,JointPQPlayer,148,268,416,15,33,JointPQPlayer
2056,JointPQPlayer,281,221,502,44,14,Player A
2057,JointPQPlayer,133,308,441,19,26,JointPQPlayer
2058,JointPQPlayer,156,266,422,21,33,JointPQPlayer
2059,JointPQPlayer,297,202,499,41,14,Player A
2060,JointPQPlayer,140,310,450,13,21,JointPQPlayer
2061,JointPQPlayer,143,293,436,14,26,JointPQPlayer
2062,JointPQPlayer,310,200,510,40,10,Player A
2063,JointPQPlayer,286,226,512,48,12,Player A
2064,JointPQPlayer,125,305,430,17,29,JointPQPlayer
2065,JointPQPlayer,268,228,496,44,16,Player A
2066,JointPQPlayer,280,225,505,41,12,Player A
2067,JointPQPlayer,180,265,445,26,27,JointPQPlayer
2068,JointPQPlayer,175,260,435,28,31,JointPQPlayer
2069,JointPQPlayer,278,223,501,46,15,Player A
2070,JointPQPlayer,254,249,503,42,13,Player A
2071,JointPQPlayer,245,230,475,38,21,Player A
2072,JointPQPlayer,262,232,494,33,13,Player A
2073,JointPQPlayer,269,199,468,37,23,Player A
2074,JointPQPlayer,290,220,510,34,8,Player A
2075,JointPQPlayer,270,220,490,41,17,Player A
2076,JointPQPlayer,298,223,521,42,7,Player A
2077,JointPQPlayer,135,300,435,16,27,JointPQPlayer
2078,JointPQPlayer,254,249,503,45,14,Player A
2079,JointPQPlayer,290,220,510,40,10,Player A
2080,JointPQPlayer,274,234,508,38,10,Player A
2081,JointPQPlayer,312,217,529,47,6,Player A
2082,JointPQPlayer,266,211,477,31,18,Player A
2083,JointPQPlayer,134,299,433,17,28,JointPQPlayer
2084,JointPQPlayer,267,222,489,40,17,Player A
2085,JointPQPlayer,274,234,508,44,12,Player A
2086,JointPQPlayer,126,316,442,17,25,JointPQPlayer
2087,JointPQPlayer,162,287,449,27,26,JointPQPlayer
2088,JointPQPlayer,138,298,436,17,27,JointPQPlayer
2089,JointPQPlayer,288,233,521,42,7,Player A
2090,JointPQPlayer,259,229,488,33,15,Player A
2091,JointPQPlayer,122,292,414,13,33,JointPQPlayer
2092,JointPQPlayer,280,235,515,42,9,Player A
2093,JointPQPlayer,273,218,491,33,14,Player A
2094,JointPQPlayer,284,219,503,39,12,Player A
2095,JointPQPlayer,282,242,524,42,6,Player A
2096,JointPQPlayer,288,223,511,35,8,Player A
2097,JointPQPlayer,278,228,506,36,10,Player A
2098,JointPQPlayer,128,308,436,17,27,JointPQPlayer
2099,JointPQPlayer,217,287,504,43,13,JointPQPlayer
2100,JointPQPlayer,283,213,496,35,13,Player A
2101,JointPQPlayer,120,310,430,14,28,JointPQPlayer
2102,JointPQPlayer,300,220,520,44,8,Player A
2103,JointPQPlayer,153,293,446,27,27,JointPQPlayer
2104,JointPQPlayer,299,199,498,37,13,Player A
2105,JointPQPlayer,287,197,484,29,15,Player A
2106,JointPQPlayer,264,239,503,42,13,Player A
2107,JointPQPlayer,269,224,493,35,14,Player A
2108,JointPQPlayer,284,229,513,46,11,Player A
2109,JointPQPlayer,266,251,517,44,9,Player A
2110,JointPQPlayer,265,215,480,34,18,Player A
2111,JointPQPlayer,248,253,501,40,13,JointPQPlayer
2112,JointPQPlayer,252,237,489,37,16,Player A
2113,JointPQPlayer,133,273,406,20,38,JointPQPlayer
2114,JointPQPlayer,284,224,508,47,13,Player A
2115,JointPQPlayer,149,309,458,21,21,JointPQPlayer
2116,JointPQPlayer,260,235,495,31,12,Player A
2117,JointPQPlayer,274,244,518,42,8,Player A
2118,JointPQPlayer,149,279,428,12,28,JointPQPlayer
2119,JointPQPlayer,244,244,488,39,17,Tie
2120,JointPQPlayer,98,288,386,6,40,JointPQPlayer
2121,JointPQPlayer,301,216,517,53,12,Player A
2122,JointPQPlayer,136,311,447,22,25,JointPQPlayer
2123,JointPQPlayer,125,295,420,19,33,JointPQPlayer
2124,JointPQPlayer,230,265,495,40,15,JointPQPlayer
2125,JointPQPlayer,135,295,430,14,28,JointPQPlayer
2126,JointPQPlayer,252,227,479,33,18,Player A
2127,JointPQPlayer,219,259,478,32,18,JointPQPlayer
2128,JointPQPlayer,264,219,483,37,18,Player A
2129,JointPQPlayer,295,205,500,39,13,Player A
2130,JointPQPlayer,259,239,498,37,13,Player A
2131,JointPQPlayer,302,207,509,36,9,Player A
2132,JointPQPlayer,277,242,519,43,8,Player A
2133,JointPQPlayer,237,247,484,38,18,JointPQPlayer
2134,JointPQPlayer,154,294,448,17,23,JointPQPlayer
2135,JointPQPlayer,275,245,520,47,9,Player A
2136,JointPQPlayer,305,195,500,39,13,Player A
2137,JointPQPlayer,282,232,514,47,11,Player A
2138,JointPQPlayer,276,226,502,41,13,Player A
2139,JointPQPlayer,210,280,490,32,14,JointPQPlayer
2140,JointPQPlayer,290,210,500,39,13,Player A
2141,JointPQPlayer,157,282,439,20,27,JointPQPlayer
2142,JointPQPlayer,159,304,463,26,21,JointPQPlayer
2143,JointPQPlayer,283,223,506,42,12,Player A
2144,JointPQPlayer,288,213,501,46,15,Player A
2145,JointPQPlayer,295,220,515,45,10,Player A
2146,JointPQPlayer,141,301,442,20,26,JointPQPlayer
2147,JointPQPlayer,298,213,511,44,11,Player A
2148,JointPQPlayer,141,321,462,25,21,JointPQPlayer
2149,JointPQPlayer,293,228,521,45,8,Player A
2150,JointPQPlayer,280,225,505,44,13,Player A
2151,JointPQPlayer,118,303,421,14,31,JointPQPlayer
2152,JointPQPlayer,261,256,517,41,8,Player A
2153,JointPQPlayer,136,301,437,21,28,JointPQPlayer
2154,JointPQPlayer,286,211,497,39,14,Player A
2155,JointPQPlayer,275,230,505,41,12,Player A
2156,JointPQPlayer,129,304,433,17,28,JointPQPlayer
2157,JointPQPlayer,259,249,508,41,11,Player A
2158,JointPQPlayer,280,225,505,41,12,Player A
2159,JointPQPlayer,274,229,503,36,11,Player A
2160,JointPQPlayer,117,282,399,10,37,JointPQPlayer
2161,JointPQPlayer,280,210,490,38,16,Player A
2162,JointPQPlayer,284,219,503,42,13,Player A
2163,JointPQPlayer,172,282,454,26,24,JointPQPlayer
2164,JointPQPlayer,267,242,509,39,10,Player A
2165,JointPQPlayer,217,267,484,35,17,JointPQPlayer
2166,JointPQPlayer,258,243,501,37,12,Player A
2167,JointPQPlayer,134,289,423,16,31,JointPQPlayer
2168,JointPQPlayer,257,242,499,41,14,Player A
2169,JointPQPlayer,279,199,478,35,19,Player A
2170,JointPQPlayer,179,274,453,22,23,JointPQPlayer
2171,JointPQPlayer,148,288,436,17,27,JointPQPlayer
2172,JointPQPlayer,276,216,492,43,17,Player A
2173,JointPQPlayer,156,301,457,20,21,JointPQPlayer
2174,JointPQPlayer,272,242,514,47,11,Player A
2175,JointPQPlayer,269,239,508,35,9,Player A
2176,JointPQPlayer,149,294,443,21,26,JointPQPlayer
2177,JointPQPlayer,277,212,489,40,17,Player A
2178,JointPQPlayer,281,236,517,44,9,Player A
2179,JointPQPlayer,240,245,485,33,16,JointPQPlayer
2180,JointPQPlayer,274,244,518,42,8,Player A
2181,JointPQPlayer,253,253,506,42,12,Tie
2182,JointPQPlayer,267,212,479,33,18,Player A
2183,JointPQPlayer,276,236,512,45,11,Player A
2184,JointPQPlayer,293,233,526,50,8,Player A
2185,JointPQPlayer,278,228,506,45,13,Player A
2186,JointPQPlayer,228,263,491,30,13,JointPQPlayer
2187,JointPQPlayer,127,327,454,17,21,JointPQPlayer
2188,JointPQPlayer,262,247,509,45,12,Player A
2189,JointPQPlayer,111,316,427,8,27,JointPQPlayer
2190,JointPQPlayer,166,276,442,14,24,JointPQPlayer
2191,JointPQPlayer,181,271,452,24,24,JointPQPlayer
2192,JointPQPlayer,277,217,494,39,15,Player A
2193,JointPQPlayer,134,259,393,10,39,JointPQPlayer
2194,JointPQPlayer,295,225,520,53,11,Player A
2195,JointPQPlayer,263,218,481,32,17,Player A
2196,JointPQPlayer,259,244,503,36,11,Player A
2197,JointPQPlayer,242,257,499,38,13,JointPQPlayer
2198,JointPQPlayer,286,226,512,39,9,Player A
2199,JointPQPlayer,257,242,499,44,15,Player A
2200,JointPQPlayer,278,238,516,46,10,Player A
2201,JointPQPlayer,210,240,450,25,25,JointPQPlayer
2202,JointPQPlayer,309,214,523,50,9,Player A
2203,JointPQPlayer,280,230,510,46,12,Player A
2204,JointPQPlayer,315,200,515,42,9,Player A
2205,JointPQPlayer,284,224,508,44,12,Player A
2206,JointPQPlayer,272,227,499,38,13,Player A
2207,JointPQPlayer,297,207,504,43,13,Player A
2208,JointPQPlayer,136,291,427,17,30,JointPQPlayer
2209,JointPQPlayer,293,203,496,38,14,Player A
2210,JointPQPlayer,214,254,468,34,22,JointPQPlayer
2211,JointPQPlayer,250,225,475,35,20,Player A
2212,JointPQPlayer,293,218,511,41,10,Player A
2213,JointPQPlayer,152,292,444,16,24,JointPQPlayer
2214,JointPQPlayer,153,268,421,20,33,JointPQPlayer
2215,JointPQPlayer,256,231,487,35,16,Player A
2216,JointPQPlayer,261,236,497,45,16,Player A
2217,JointPQPlayer,129,299,428,18,30,JointPQPlayer
2218,JointPQPlayer,291,211,502,38,12,Player A
2219,JointPQPlayer,266,216,482,33,17,Player A
2220,JointPQPlayer,242,277,519,46,9,JointPQPlayer
2221,JointPQPlayer,263,238,501,40,13,Player A
2222,JointPQPlayer,251,241,492,40,16,Player A
2223,JointPQPlayer,140,275,415,14,33,JointPQPlayer
2224,JointPQPlayer,257,272,529,50,7,JointPQPlayer
2225,JointPQPlayer,298,218,516,46,10,Player A
2226,JointPQPlayer,292,202,494,33,13,Player A
2227,JointPQPlayer,289,214,503,36,11,Player A
2228,JointPQPlayer,293,218,511,44,11,Player A
2229,JointPQPlayer,298,198,496,38,14,Player A
2230,JointPQPlayer,286,221,507,37,10,Player A
2231,JointPQPlayer,267,197,464,36,24,Player A
2232,JointPQPlayer,148,298,446,18,24,JointPQPlayer
2233,JointPQPlayer,252,252,504,40,12,Tie
2234,JointPQPlayer,262,232,494,36,14,Player A
2235,JointPQPlayer,278,223,501,40,13,Player A
2236,JointPQPlayer,292,217,509,42,11,Player A
2237,JointPQPlayer,250,250,500,39,13,Tie
2238,JointPQPlayer,118,303,421,17,32,JointPQPlayer
2239,JointPQPlayer,279,239,518,48,10,Player A
2240,JointPQPlayer,279,214,493,41,16,Player A
2241,JointPQPlayer,266,226,492,37,15,Player A
2242,JointPQPlayer,261,246,507,46,13,Player A
2243,JointPQPlayer,260,270,530,48,6,JointPQPlayer
2244,JointPQPlayer,276,231,507,49,14,Player A
2245,JointPQPlayer,161,266,427,20,31,JointPQPlayer
2246,JointPQPlayer,253,238,491,42,17,Player A
2247,JointPQPlayer,289,224,513,43,10,Player A
2248,JointPQPlayer,140,295,435,22,29,JointPQPlayer
2249,JointPQPlayer,278,238,516,46,10,Player A
2250,JointPQPlayer,268,223,491,42,17,Player A
2251,JointPQPlayer,215,255,470,27,19,JointPQPlayer
2252,JointPQPlayer,302,207,509,45,12,Player A
2253,JointPQPlayer,294,204,498,43,15,Player A
2254,JointPQPlayer,263,253,516,52,12,Player A
2255,JointPQPlayer,147,277,424,14,30,JointPQPlayer
2256,JointPQPlayer,280,225,505,44,13,Player A
2257,JointPQPlayer,279,239,518,45,9,Player A
2258,JointPQPlayer,272,217,489,43,18,Player A
2259,JointPQPlayer,137,287,424,17,31,JointPQPlayer
2260,JointPQPlayer,264,244,508,44,12,Player A
2261,JointPQPlayer,160,260,420,16,32,JointPQPlayer
2262,JointPQPlayer,299,204,503,39,12,Player A
2263,JointPQPlayer,263,228,491,39,16,Player A
2264,JointPQPlayer,231,251,482,30,16,JointPQPlayer
2265,JointPQPlayer,263,243,506,39,11,Player A
2266,JointPQPlayer,274,209,483,37,18,Player A
2267,JointPQPlayer,246,236,482,30,16,Player A
2268,JointPQPlayer,298,218,516,40,8,Player A
2269,JointPQPlayer,287,212,499,41,14,Player A
2270,JointPQPlayer,283,238,521,48,9,Player A
2271,JointPQPlayer,300,215,515,48,11,Player A
2272,JointPQPlayer,133,293,426,16,30,JointPQPlayer
2273,JointPQPlayer,257,252,509,42,11,Player A
2274,JointPQPlayer,257,242,499,41,14,Player A
2275,JointPQPlayer,256,226,482,36,18,Player A
2276,JointPQPlayer,285,225,510,43,11,Player A
2277,JointPQPlayer,160,295,455,21,22,JointPQPlayer
2278,JointPQPlayer,281,226,507,52,15,Player A
2279,JointPQPlayer,265,230,495,43,16,Player A
2280,JointPQPlayer,265,250,515,48,11,Player A
2281,JointPQPlayer,276,236,512,45,11,Player A
2282,JointPQPlayer,232,227,459,28,23,Player A
2283,JointPQPlayer,285,210,495,34,13,Player A
2284,JointPQPlayer,137,292,429,19,30,JointPQPlayer
2285,JointPQPlayer,195,260,455,33,26,JointPQPlayer
2286,JointPQPlayer,273,218,491,36,15,Player A
2287,JointPQPlayer,293,213,506,42,12,Player A
2288,JointPQPlayer,309,204,513,40,9,Player A
2289,JointPQPlayer,272,222,494,36,14,Player A
2290,JointPQPlayer,264,239,503,33,10,Player A
2291,JointPQPlayer,259,209,468,40,24,Player A
2292,JointPQPlayer,157,282,439,20,27,JointPQPlayer
2293,JointPQPlayer,303,203,506,39,11,Player A
2294,JointPQPlayer,287,212,499,47,16,Player A
2295,JointPQPlayer,282,227,509,42,11,Player A
2296,JointPQPlayer,252,252,504,46,14,Tie
2297,JointPQPlayer,279,224,503,39,12,Player A
2298,JointPQPlayer,288,218,506,42,12,Player A
2299,JointPQPlayer,202,262,464,27,21,JointPQPlayer
2300,JointPQPlayer,299,209,508,38,10,Player A
2301,JointPQPlayer,165,275,440,21,27,JointPQPlayer
2302,JointPQPlayer,150,265,415,17,34,JointPQPlayer
2303,JointPQPlayer,289,199,488,33,15,Player A
2304,JointPQPlayer,291,191,482,30,16,Player A
2305,JointPQPlayer,253,243,496,38,14,Player A
2306,JointPQPlayer,153,273,426,16,30,JointPQPlayer
2307,JointPQPlayer,299,229,528,49,7,Player A
2308,JointPQPlayer,142,287,429,19,30,JointPQPlayer
2309,JointPQPlayer,124,314,438,16,26,JointPQPlayer
2310,JointPQPlayer,259,229,488,36,16,Player A
2311,JointPQPlayer,279,219,498,43,15,Player A
2312,JointPQPlayer,163,283,446,18,24,JointPQPlayer
2313,JointPQPlayer,132,297,429,10,27,JointPQPlayer
2314,JointPQPlayer,293,208,501,37,12,Player A
2315,JointPQPlayer,237,257,494,39,15,JointPQPlayer
2316,JointPQPlayer,265,240,505,41,12,Player A
2317,JointPQPlayer,130,330,460,20,20,JointPQPlayer
2318,JointPQPlayer,187,267,454,23,23,JointPQPlayer
2319,JointPQPlayer,271,231,502,41,13,Player A
2320,JointPQPlayer,193,258,451,17,22,JointPQPlayer
2321,JointPQPlayer,176,271,447,25,26,JointPQPlayer
2322,JointPQPlayer,289,229,518,51,11,Player A
2323,JointPQPlayer,208,258,466,35,23,JointPQPlayer
2324,JointPQPlayer,258,258,516,43,9,Tie
2325,JointPQPlayer,267,222,489,43,18,Player A
2326,JointPQPlayer,152,262,414,19,35,JointPQPlayer
2327,JointPQPlayer,257,237,494,42,16,Player A
2328,JointPQPlayer,283,228,511,41,10,Player A
2329,JointPQPlayer,288,203,491,39,16,Player A
2330,JointPQPlayer,119,329,448,17,23,JointPQPlayer
2331,JointPQPlayer,290,220,510,43,11,Player A
2332,JointPQPlayer,310,210,520,53,11,Player A
2333,JointPQPlayer,137,287,424,17,31,JointPQPlayer
2334,JointPQPlayer,185,270,455,27,24,JointPQPlayer
2335,JointPQPlayer,307,177,484,41,19,Player A
2336,JointPQPlayer,283,223,506,39,11,Player A
2337,JointPQPlayer,138,308,446,24,26,JointPQPlayer
2338,JointPQPlayer,253,253,506,36,10,Tie
2339,JointPQPlayer,152,297,449,18,23,JointPQPlayer
2340,JointPQPlayer,277,222,499,38,13,Player A
2341,JointPQPlayer,278,228,506,45,13,Player A
2342,JointPQPlayer,234,244,478,32,18,JointPQPlayer
2343,JointPQPlayer,307,192,499,38,13,Player A
2344,JointPQPlayer,276,206,482,33,17,Player A
2345,JointPQPlayer,272,217,489,37,16,Player A
2346,JointPQPlayer,300,215,515,48,11,Player A
2347,JointPQPlayer,285,215,500,45,15,Player A
2348,JointPQPlayer,170,295,465,22,19,JointPQPlayer
2349,JointPQPlayer,265,225,490,38,16,Player A
2350,JointPQPlayer,261,251,512,51,13,Player A
2351,JointPQPlayer,308,203,511,44,11,Player A
2352,JointPQPlayer,129,284,413,12,33,JointPQPlayer
2353,JointPQPlayer,280,225,505,41,12,Player A
2354,JointPQPlayer,278,238,516,46,10,Player A
2355,JointPQPlayer,265,235,500,39,13,Player A
2356,JointPQPlayer,310,205,515,48,11,Player A
2357,JointPQPlayer,294,214,508,38,10,Player A
2358,JointPQPlayer,140,310,450,19,23,JointPQPlayer
2359,JointPQPlayer,293,238,531,52,7,Player A
2360,JointPQPlayer,263,233,496,38,14,Player A
2361,JointPQPlayer,278,218,496,41,15,Player A
2362,JointPQPlayer,165,280,445,20,25,JointPQPlayer
2363,JointPQPlayer,260,235,495,31,12,Player A
2364,JointPQPlayer,266,231,497,39,14,Player A
2365,JointPQPlayer,227,252,479,30,17,JointPQPlayer
2366,JointPQPlayer,240,225,465,34,23,Player A
2367,JointPQPlayer,169,284,453,25,24,JointPQPlayer
2368,JointPQPlayer,256,251,507,46,13,Player A
2369,JointPQPlayer,152,282,434,24,30,JointPQPlayer
2370,JointPQPlayer,133,273,406,17,37,JointPQPlayer
2371,JointPQPlayer,285,205,490,38,16,Player A
2372,JointPQPlayer,218,253,471,37,22,JointPQPlayer
2373,JointPQPlayer,252,252,504,46,14,Tie
2374,JointPQPlayer,142,277,419,15,32,JointPQPlayer
2375,JointPQPlayer,266,216,482,39,19,Player A
2376,JointPQPlayer,137,272,409,17,36,JointPQPlayer
2377,JointPQPlayer,197,262,459,31,24,JointPQPlayer
2378,JointPQPlayer,131,281,412,20,36,JointPQPlayer
2379,JointPQPlayer,212,267,479,30,17,JointPQPlayer
2380,JointPQPlayer,279,204,483,34,17,Player A
2381,JointPQPlayer,264,239,503,42,13,Player A
2382,JointPQPlayer,317,207,524,45,7,Player A
2383,JointPQPlayer,320,175,495,37,14,Player A
2384,JointPQPlayer,263,238,501,40,13,Player A
2385,JointPQPlayer,251,231,482,30,16,Player A
2386,JointPQPlayer,289,219,508,41,11,Player A
2387,JointPQPlayer,122,307,429,16,29,JointPQPlayer
2388,JointPQPlayer,287,197,484,41,19,Player A
2389,JointPQPlayer,188,268,456,25,23,JointPQPlayer
2390,JointPQPlayer,262,257,519,49,10,Player A
2391,JointPQPlayer,146,296,442,14,24,JointPQPlayer
2392,JointPQPlayer,252,242,494,45,17,Player A
2393,JointPQPlayer,250,240,490,35,15,Player A
2394,JointPQPlayer,282,217,499,38,13,Player A
2395,JointPQPlayer,283,223,506,48,14,Player A
2396,JointPQPlayer,273,233,506,39,11,Player A
2397,JointPQPlayer,135,280,415,11,32,JointPQPlayer
2398,JointPQPlayer,272,247,519,46,9,Player A
2399,JointPQPlayer,250,255,505,41,12,JointPQPlayer
2400,JointPQPlayer,265,240,505,41,12,Player A
2401,JointPQPlayer,313,183,496,38,14,Player A
2402,JointPQPlayer,257,247,504,46,14,Player A
2403,JointPQPlayer,296,201,497,42,15,Player A
2404,JointPQPlayer,177,277,454,29,25,JointPQPlayer
2405,JointPQPlayer,277,247,524,51,9,Player A
2406,JointPQPlayer,244,244,488,36,16,Tie
2407,JointPQPlayer,307,222,529,50,7,Player A
2408,JointPQPlayer,287,217,504,37,11,Player A
2409,JointPQPlayer,282,222,504,43,13,Player A
2410,JointPQPlayer,287,217,504,37,11,Player A
2411,JointPQPlayer,166,286,452,21,23,JointPQPlayer
2412,JointPQPlayer,260,245,505,41,12,Player A
2413,JointPQPlayer,254,259,513,43,10,JointPQPlayer
2414,JointPQPlayer,157,282,439,23,28,JointPQPlayer
2415,JointPQPlayer,258,238,496,41,15,Player A
2416,JointPQPlayer,259,244,503,36,11,Player A
2417,JointPQPlayer,162,287,449,21,24,JointPQPlayer
2418,JointPQPlayer,302,202,504,43,13,Player A
2419,JointPQPlayer,257,212,469,35,22,Player A
2420,JointPQPlayer,283,203,486,37,17,Player A
2421,JointPQPlayer,138,308,446,12,22,JointPQPlayer
2422,JointPQPlayer,215,260,475,32,19,JointPQPlayer
2423,JointPQPlayer,285,205,490,35,15,Player A
2424,JointPQPlayer,277,227,504,40,12,Player A
2425,JointPQPlayer,254,239,493,38,15,Player A
2426,JointPQPlayer,282,222,504,43,13,Player A
2427,JointPQPlayer,172,282,454,29,25,JointPQPlayer
2428,JointPQPlayer,249,254,503,42,13,JointPQPlayer
2429,JointPQPlayer,142,292,434,12,26,JointPQPlayer
2430,JointPQPlayer,305,220,525,49,8,Player A
2431,JointPQPlayer,158,283,441,16,25,JointPQPlayer
2432,JointPQPlayer,301,226,527,48,7,Player A
2433,JointPQPlayer,299,229,528,52,8,Player A
2434,JointPQPlayer,150,290,440,12,24,JointPQPlayer
2435,JointPQPlayer,214,249,463,26,21,JointPQPlayer
2436,JointPQPlayer,298,203,501,40,13,Player A
2437,JointPQPlayer,259,219,478,32,18,Player A
2438,JointPQPlayer,292,217,509,42,11,Player A
2439,JointPQPlayer,269,214,483,37,18,Player A
2440,JointPQPlayer,155,265,420,22,34,JointPQPlayer
2441,JointPQPlayer,306,196,502,44,14,Player A
2442,JointPQPlayer,124,314,438,19,27,JointPQPlayer
2443,JointPQPlayer,163,273,436,17,27,JointPQPlayer
2444,JointPQPlayer,278,223,501,40,13,Player A
2445,JointPQPlayer,292,212,504,40,12,Player A
2446,JointPQPlayer,253,248,501,40,13,Player A
2447,JointPQPlayer,178,258,436,17,27,JointPQPlayer
2448,JointPQPlayer,275,230,505,41,12,Player A
2449,JointPQPlayer,229,274,503,39,12,JointPQPlayer
2450,JointPQPlayer,293,223,516,49,11,Player A
2451,JointPQPlayer,257,247,504,37,11,Player A
2452,JointPQPlayer,285,200,485,39,18,Player A
2453,JointPQPlayer,164,274,438,22,28,JointPQPlayer
2454,JointPQPlayer,188,238,426,19,31,JointPQPlayer
2455,JointPQPlayer,169,289,458,30,24,JointPQPlayer
2456,JointPQPlayer,177,292,469,29,20,JointPQPlayer
2457,JointPQPlayer,279,234,513,46,11,Player A
2458,JointPQPlayer,113,323,436,17,27,JointPQPlayer
2459,JointPQPlayer,269,254,523,47,8,Player A
2460,JointPQPlayer,282,207,489,37,16,Player A
2461,JointPQPlayer,274,229,503,42,13,Player A
2462,JointPQPlayer,249,249,498,43,15,Tie
2463,JointPQPlayer,146,271,417,19,34,JointPQPlayer
2464,JointPQPlayer,117,297,414,10,32,JointPQPlayer
2465,JointPQPlayer,289,209,498,40,14,Player A
2466,JointPQPlayer,124,299,423,13,30,JointPQPlayer
2467,JointPQPlayer,298,203,501,43,14,Player A
2468,JointPQPlayer,277,222,499,38,13,Player A
2469,JointPQPlayer,305,215,520,41,7,Player A
2470,JointPQPlayer,249,239,488,33,15,Player A
2471,JointPQPlayer,196,251,447,25,26,JointPQPlayer
2472,JointPQPlayer,267,227,494,36,14,Player A
2473,JointPQPlayer,289,209,498,46,16,Player A
2474,JointPQPlayer,253,233,486,40,18,Player A
2475,JointPQPlayer,129,304,433,17,28,JointPQPlayer
2476,JointPQPlayer,302,202,504,40,12,Player A
2477,JointPQPlayer,236,251,487,38,17,JointPQPlayer
2478,JointPQPlayer,129,299,428,15,29,JointPQPlayer
2479,JointPQPlayer,249,239,488,39,17,Player A
2480,JointPQPlayer,292,202,494,42,16,Player A
2481,JointPQPlayer,151,301,452,12,20,JointPQPlayer
2482,JointPQPlayer,230,245,475,38,21,JointPQPlayer
2483,JointPQPlayer,303,223,526,47,7,Player A
2484,JointPQPlayer,291,221,512,36,8,Player A
2485,JointPQPlayer,128,308,436,17,27,JointPQPlayer
2486,JointPQPlayer,283,228,511,50,13,Player A
2487,JointPQPlayer,294,219,513,46,11,Player A
2488,JointPQPlayer,315,200,515,42,9,Player A
2489,JointPQPlayer,140,290,430,20,30,JointPQPlayer
2490,JointPQPlayer,292,217,509,42,11,Player A
2491,JointPQPlayer,287,227,514,44,10,Player A
2492,JointPQPlayer,119,314,433,20,29,JointPQPlayer
2493,JointPQPlayer,323,183,506,36,10,Player A
2494,JointPQPlayer,191,246,437,30,31,JointPQPlayer
2495,JointPQPlayer,282,232,514,44,10,Player A
2496,JointPQPlayer,154,264,418,17,33,JointPQPlayer
2497,JointPQPlayer,277,212,489,31,14,Player A
2498,JointPQPlayer,120,295,415,11,32,JointPQPlayer
2499,JointPQPlayer,125,325,450,22,24,JointPQPlayer
2500,JointPQPlayer,237,242,479,36,19,JointPQPlayer
2501,JointPQPlayer,167,287,454,26,24,JointPQPlayer
2502,JointPQPlayer,220,290,510,46,12,JointPQPlayer
2503,JointPQPlayer,142,297,439,20,27,JointPQPlayer
2504,JointPQPlayer,274,209,483,37,18,Player A
2505,JointPQPlayer,131,321,452,15,21,JointPQPlayer
2506,JointPQPlayer,211,251,462,28,22,JointPQPlayer
2507,JointPQPlayer,291,216,507,46,13,Player A
2508,JointPQPlayer,175,260,435,19,28,JointPQPlayer
2509,JointPQPlayer,295,195,490,38,16,Player A
2510,JointPQPlayer,260,235,495,37,14,Player A
2511,JointPQPlayer,292,212,504,40,12,Player A
2512,JointPQPlayer,136,266,402,13,37,JointPQPlayer
2513,JointPQPlayer,311,206,517,50,11,Player A
2514,JointPQPlayer,143,293,436,17,27,JointPQPlayer
2515,JointPQPlayer,316,196,512,48,12,Player A
2516,JointPQPlayer,284,199,483,37,18,Player A
2517,JointPQPlayer,223,268,491,33,14,JointPQPlayer
2518,JointPQPlayer,199,284,483,31,16,JointPQPlayer
2519,JointPQPlayer,222,262,484,32,16,JointPQPlayer
2520,JointPQPlayer,179,294,473,27,18,JointPQPlayer
2521,JointPQPlayer,161,276,437,18,27,JointPQPlayer
2522,JointPQPlayer,129,314,443,15,24,JointPQPlayer
2523,JointPQPlayer,120,330,450,19,23,JointPQPlayer
2524,JointPQPlayer,121,316,437,18,27,JointPQPlayer
2525,JointPQPlayer,276,231,507,37,10,Player A
2526,JointPQPlayer,306,216,522,43,7,Player A
2527,JointPQPlayer,289,214,503,42,13,Player A
2528,JointPQPlayer,177,267,444,16,24,JointPQPlayer
2529,JointPQPlayer,247,252,499,41,14,JointPQPlayer
2530,JointPQPlayer,275,230,505,41,12,Player A
2531,JointPQPlayer,256,246,502,44,14,Player A
2532,JointPQPlayer,282,227,509,42,11,Player A
2533,JointPQPlayer,139,304,443,18,25,JointPQPlayer
2534,JointPQPlayer,255,255,510,40,10,Tie
2535,JointPQPlayer,278,248,526,44,6,Player A
2536,JointPQPlayer,271,206,477,40,21,Player A
2537,JointPQPlayer,121,301,422,15,31,JointPQPlayer
2538,JointPQPlayer,295,215,510,46,12,Player A
2539,JointPQPlayer,288,238,526,47,7,Player A
2540,JointPQPlayer,127,317,444,16,24,JointPQPlayer
2541,JointPQPlayer,298,193,491,33,14,Player A
2542,JointPQPlayer,121,326,447,13,22,JointPQPlayer
2543,JointPQPlayer,148,303,451,23,24,JointPQPlayer
2544,JointPQPlayer,138,293,431,21,30,JointPQPlayer
2545,JointPQPlayer,309,214,523,47,8,Player A
2546,JointPQPlayer,280,200,480,43,21,Player A
2547,JointPQPlayer,284,234,518,45,9,Player A
2548,JointPQPlayer,119,339,458,15,19,JointPQPlayer
2549,JointPQPlayer,123,308,431,18,29,JointPQPlayer
2550,JointPQPlayer,316,206,522,46,8,Player A
2551,JointPQPlayer,274,229,503,36,11,Player A
2552,JointPQPlayer,207,262,469,32,21,JointPQPlayer
2553,JointPQPlayer,266,246,512,42,10,Player A
2554,JointPQPlayer,261,231,492,40,16,Player A
2555,JointPQPlayer,290,235,525,49,8,Player A
2556,JointPQPlayer,267,232,499,38,13,Player A
2557,JointPQPlayer,294,209,503,48,15,Player A
2558,JointPQPlayer,288,233,521,48,9,Player A
2559,JointPQPlayer,185,265,450,28,26,JointPQPlayer
2560,JointPQPlayer,260,245,505,44,13,Player A
2561,JointPQPlayer,240,240,480,40,20,Tie
2562,JointPQPlayer,254,249,503,39,12,Player A
2563,JointPQPlayer,152,262,414,16,34,JointPQPlayer
2564,JointPQPlayer,275,245,520,41,7,Player A
2565,JointPQPlayer,287,202,489,40,17,Player A
2566,JointPQPlayer,258,248,506,42,12,Player A
2567,JointPQPlayer,278,238,516,46,10,Player A
2568,JointPQPlayer,252,242,494,39,15,Player A
2569,JointPQPlayer,162,267,429,19,30,JointPQPlayer
2570,JointPQPlayer,262,237,499,41,14,Player A
2571,JointPQPlayer,264,239,503,42,13,Player A
2572,JointPQPlayer,299,199,498,37,13,Player A
2573,JointPQPlayer,132,317,449,18,23,JointPQPlayer
2574,JointPQPlayer,258,243,501,40,13,Player A
2575,JointPQPlayer,270,205,475,35,20,Player A
2576,JointPQPlayer,290,210,500,33,11,Player A
2577,JointPQPlayer,304,199,503,39,12,Player A
2578,JointPQPlayer,281,231,512,45,11,Player A
2579,JointPQPlayer,274,244,518,42,8,Player A
2580,JointPQPlayer,267,242,509,48,13,Player A
2581,JointPQPlayer,227,262,489,37,16,JointPQPlayer
2582,JointPQPlayer,305,200,505,44,13,Player A
2583,JointPQPlayer,121,316,437,15,26,JointPQPlayer
2584,JointPQPlayer,169,264,433,17,28,JointPQPlayer
2585,JointPQPlayer,164,259,423,19,32,JointPQPlayer
2586,JointPQPlayer,276,221,497,36,13,Player A
2587,JointPQPlayer,275,225,500,39,13,Player A
2588,JointPQPlayer,184,269,453,22,23,JointPQPlayer
2589,JointPQPlayer,137,267,404,15,37,JointPQPlayer
2590,JointPQPlayer,258,233,491,36,15,Player A
2591,JointPQPlayer,278,223,501,43,14,Player A
2592,JointPQPlayer,151,301,452,21,23,JointPQPlayer
2593,JointPQPlayer,137,297,434,18,28,JointPQPlayer
2594,JointPQPlayer,142,302,444,16,24,JointPQPlayer
2595,JointPQPlayer,276,216,492,43,17,Player A
2596,JointPQPlayer,284,214,498,34,12,Player A
2597,JointPQPlayer,123,308,431,18,29,JointPQPlayer
2598,JointPQPlayer,116,286,402,13,37,JointPQPlayer
2599,JointPQPlayer,269,219,488,48,20,Player A
2600,JointPQPlayer,204,259,463,35,24,JointPQPlayer
2601,JointPQPlayer,262,242,504,40,12,Player A
2602,JointPQPlayer,138,298,436,17,27,JointPQPlayer
2603,JointPQPlayer,264,224,488,39,17,Player A
2604,JointPQPlayer,185,285,470,33,21,JointPQPlayer
2605,JointPQPlayer,286,226,512,42,10,Player A
2606,JointPQPlayer,298,218,516,40,8,Player A
2607,JointPQPlayer,250,235,485,36,17,Player A
2608,JointPQPlayer,284,239,523,47,8,Player A
2609,JointPQPlayer,252,252,504,43,13,Tie
2610,JointPQPlayer,315,205,520,47,9,Player A
2611,JointPQPlayer,166,276,442,17,25,JointPQPlayer
2612,JointPQPlayer,298,203,501,40,13,Player A
2613,JointPQPlayer,278,208,486,25,13,Player A
2614,JointPQPlayer,243,243,486,37,17,Tie
2615,JointPQPlayer,267,202,469,32,21,Player A
2616,JointPQPlayer,276,201,477,34,19,Player A
2617,JointPQPlayer,306,201,507,43,12,Player A
2618,JointPQPlayer,293,233,526,50,8,Player A
2619,JointPQPlayer,246,231,477,28,17,Player A
2620,JointPQPlayer,163,273,436,26,30,JointPQPlayer
2621,JointPQPlayer,257,257,514,47,11,Tie
2622,JointPQPlayer,128,298,426,19,31,JointPQPlayer
2623,JointPQPlayer,284,239,523,44,7,Player A
2624,JointPQPlayer,253,218,471,22,17,Player A
2625,JointPQPlayer,258,233,491,42,17,Player A
2626,JointPQPlayer,277,207,484,35,17,Player A
2627,JointPQPlayer,155,275,430,20,30,JointPQPlayer
2628,JointPQPlayer,101,311,412,17,35,JointPQPlayer
2629,JointPQPlayer,147,257,404,18,38,JointPQPlayer
2630,JointPQPlayer,132,292,424,14,30,JointPQPlayer
2631,JointPQPlayer,279,224,503,45,14,Player A
2632,JointPQPlayer,137,292,429,16,29,JointPQPlayer
2633,JointPQPlayer,268,228,496,38,14,Player A
2634,JointPQPlayer,280,195,475,35,20,Player A
2635,JointPQPlayer,125,300,425,12,29,JointPQPlayer
2636,JointPQPlayer,292,207,499,41,14,Player A
2637,JointPQPlayer,299,229,528,52,8,Player A
2638,JointPQPlayer,204,249,453,28,25,JointPQPlayer
2639,JointPQPlayer,154,289,443,18,25,JointPQPlayer
2640,JointPQPlayer,152,302,454,20,22,JointPQPlayer
2641,JointPQPlayer,273,218,491,30,13,Player A
2642,JointPQPlayer,162,297,459,25,22,JointPQPlayer
2643,JointPQPlayer,280,225,505,41,12,Player A
2644,JointPQPlayer,144,274,418,14,32,JointPQPlayer
2645,JointPQPlayer,139,299,438,22,28,JointPQPlayer
2646,JointPQPlayer,261,251,512,45,11,Player A
2647,JointPQPlayer,276,236,512,45,11,Player A
2648,JointPQPlayer,142,287,429,19,30,JointPQPlayer
2649,JointPQPlayer,259,234,493,41,16,Player A
2650,JointPQPlayer,259,254,513,40,9,Player A
2651,JointPQPlayer,266,236,502,41,13,Player A
2652,JointPQPlayer,130,290,420,16,32,JointPQPlayer
2653,JointPQPlayer,271,216,487,35,16,Player A
2654,JointPQPlayer,294,214,508,41,11,Player A
2655,JointPQPlayer,292,212,504,37,11,Player A
2656,JointPQPlayer,227,242,469,35,22,JointPQPlayer
2657,JointPQPlayer,297,222,519,46,9,Player A
2658,JointPQPlayer,149,284,433,20,29,JointPQPlayer
2659,JointPQPlayer,270,230,500,39,13,Player A
2660,JointPQPlayer,239,234,473,36,21,Player A
2661,JointPQPlayer,132,302,434,18,28,JointPQPlayer
2662,JointPQPlayer,264,229,493,41,16,Player A
2663,JointPQPlayer,163,313,476,27,17,JointPQPlayer
2664,JointPQPlayer,292,212,504,40,12,Player A
2665,JointPQPlayer,261,251,512,36,8,Player A
2666,JointPQPlayer,250,245,495,40,15,Player A
2667,JointPQPlayer,262,222,484,38,18,Player A
2668,JointPQPlayer,273,248,521,48,9,Player A
2669,JointPQPlayer,278,243,521,48,9,Player A
2670,JointPQPlayer,285,210,495,40,15,Player A
2671,JointPQPlayer,276,211,487,38,17,Player A
2672,JointPQPlayer,288,203,491,39,16,Player A
2673,JointPQPlayer,246,256,502,38,12,JointPQPlayer
2674,JointPQPlayer,274,229,503,42,13,Player A
2675,JointPQPlayer,274,229,503,48,15,Player A
2676,JointPQPlayer,287,227,514,47,11,Player A
2677,JointPQPlayer,261,246,507,37,10,Player A
2678,JointPQPlayer,136,291,427,17,30,JointPQPlayer
2679,JointPQPlayer,216,206,422,24,34,Player A
2680,JointPQPlayer,126,291,417,13,32,JointPQPlayer
2681,JointPQPlayer,177,287,464,27,21,JointPQPlayer
2682,JointPQPlayer,278,223,501,43,14,Player A
2683,JointPQPlayer,298,213,511,44,11,Player A
2684,JointPQPlayer,264,219,483,37,18,Player A
2685,JointPQPlayer,294,194,488,27,13,Player A
2686,JointPQPlayer,193,278,471,34,21,JointPQPlayer
2687,JointPQPlayer,245,275,520,41,7,JointPQPlayer
2688,JointPQPlayer,298,198,496,35,13,Player A
2689,JointPQPlayer,150,300,450,16,22,JointPQPlayer
2690,JointPQPlayer,299,229,528,46,6,Player A
2691,JointPQPlayer,144,299,443,9,22,JointPQPlayer
2692,JointPQPlayer,258,243,501,34,11,Player A
2693,JointPQPlayer,262,247,509,39,10,Player A
2694,JointPQPlayer,293,233,526,50,8,Player A
2695,JointPQPlayer,257,242,499,41,14,Player A
2696,JointPQPlayer,122,302,424,14,30,JointPQPlayer
2697,JointPQPlayer,274,224,498,34,12,Player A
2698,JointPQPlayer,123,308,431,18,29,JointPQPlayer
2699,JointPQPlayer,129,249,378,10,44,JointPQPlayer
2700,JointPQPlayer,293,213,506,45,13,Player A
2701,JointPQPlayer,259,234,493,38,15,Player A
2702,JointPQPlayer,140,265,405,13,36,JointPQPlayer
2703,JointPQPlayer,251,236,487,35,16,Player A
2704,JointPQPlayer,281,216,497,39,14,Player A
2705,JointPQPlayer,284,204,488,39,17,Player A
2706,JointPQPlayer,150,265,415,17,34,JointPQPlayer
2707,JointPQPlayer,311,201,512,36,8,Player A
2708,JointPQPlayer,309,219,528,46,6,Player A
2709,JointPQPlayer,239,264,503,36,11,JointPQPlayer
2710,JointPQPlayer,236,256,492,40,16,JointPQPlayer
2711,JointPQPlayer,312,197,509,39,10,Player A
2712,JointPQPlayer,304,199,503,48,15,Player A
2713,JointPQPlayer,145,315,460,17,19,JointPQPlayer
2714,JointPQPlayer,277,217,494,42,16,Player A
2715,JointPQPlayer,260,225,485,36,17,Player A
2716,JointPQPlayer,225,270,495,34,13,JointPQPlayer
2717,JointPQPlayer,267,252,519,43,8,Player A
2718,JointPQPlayer,132,297,429,19,30,JointPQPlayer
2719,JointPQPlayer,282,222,504,40,12,Player A
2720,JointPQPlayer,297,217,514,44,10,Player A
2721,JointPQPlayer,259,229,488,36,16,Player A
2722,JointPQPlayer,301,196,497,42,15,Player A
2723,JointPQPlayer,134,289,423,16,31,JointPQPlayer
2724,JointPQPlayer,286,211,497,36,13,Player A
2725,JointPQPlayer,119,324,443,12,23,JointPQPlayer
2726,JointPQPlayer,254,259,513,40,9,JointPQPlayer
2727,JointPQPlayer,260,225,485,36,17,Player A
2728,JointPQPlayer,128,313,441,19,26,JointPQPlayer
2729,JointPQPlayer,268,243,511,50,13,Player A
2730,JointPQPlayer,268,238,506,42,12,Player A
2731,JointPQPlayer,281,221,502,38,12,Player A
2732,JointPQPlayer,255,210,465,37,24,Player A
2733,JointPQPlayer,272,217,489,34,15,Player A
2734,JointPQPlayer,133,293,426,10,28,JointPQPlayer
2735,JointPQPlayer,261,206,467,30,21,Player A
2736,JointPQPlayer,275,230,505,41,12,Player A
2737,JointPQPlayer,287,202,489,40,17,Player A
2738,JointPQPlayer,209,264,473,27,18,JointPQPlayer
2739,JointPQPlayer,278,233,511,38,9,Player A
2740,JointPQPlayer,286,186,472,32,20,Player A
2741,JointPQPlayer,273,218,491,39,16,Player A
2742,JointPQPlayer,253,253,506,42,12,Tie
2743,JointPQPlayer,278,203,481,35,18,Player A
2744,JointPQPlayer,136,311,447,16,23,JointPQPlayer
2745,JointPQPlayer,276,241,517,41,8,Player A
2746,JointPQPlayer,275,245,520,47,9,Player A
2747,JointPQPlayer,139,289,428,18,30,JointPQPlayer
2748,JointPQPlayer,265,245,510,46,12,Player A
2749,JointPQPlayer,137,297,434,24,30,JointPQPlayer
2750,JointPQPlayer,302,212,514,41,9,Player A
2751,JointPQPlayer,257,262,519,43,8,JointPQPlayer
2752,JointPQPlayer,110,325,435,13,26,JointPQPlayer
2753,JointPQPlayer,266,211,477,31,18,Player A
2754,JointPQPlayer,134,289,423,19,32,JointPQPlayer
2755,JointPQPlayer,141,286,427,20,31,JointPQPlayer
2756,JointPQPlayer,234,229,463,35,24,Player A
2757,JointPQPlayer,289,219,508,44,12,Player A
2758,JointPQPlayer,268,228,496,35,13,Player A
2759,JointPQPlayer,249,239,488,33,15,Player A
2760,JointPQPlayer,252,237,489,37,16,Player A
2761,JointPQPlayer,291,216,507,43,12,Player A
2762,JointPQPlayer,277,237,514,38,8,Player A
2763,JointPQPlayer,263,218,481,38,19,Player A
2764,JointPQPlayer,281,231,512,48,12,Player A
2765,JointPQPlayer,268,248,516,40,8,Player A
2766,JointPQPlayer,277,217,494,36,14,Player A
2767,JointPQPlayer,263,238,501,40,13,Player A
2768,JointPQPlayer,278,218,496,32,12,Player A
2769,JointPQPlayer,289,199,488,39,17,Player A
2770,JointPQPlayer,225,235,460,26,22,JointPQPlayer
2771,JointPQPlayer,138,288,426,16,30,JointPQPlayer
2772,JointPQPlayer,278,213,491,36,15,Player A
2773,JointPQPlayer,263,238,501,34,11,Player A
2774,JointPQPlayer,261,236,497,42,15,Player A
2775,JointPQPlayer,289,229,518,57,13,Player A
2776,JointPQPlayer,286,211,497,45,16,Player A
2777,JointPQPlayer,139,284,423,19,32,JointPQPlayer
2778,JointPQPlayer,292,217,509,45,12,Player A
2779,JointPQPlayer,253,238,491,39,16,Player A
2780,JointPQPlayer,239,244,483,34,17,JointPQPlayer
2781,JointPQPlayer,288,218,506,42,12,Player A
2782,JointPQPlayer,125,310,435,16,27,JointPQPlayer
2783,JointPQPlayer,264,224,488,24,12,Player A
2784,JointPQPlayer,287,192,479,24,15,Player A
2785,JointPQPlayer,261,231,492,37,15,Player A
2786,JointPQPlayer,146,281,427,14,29,JointPQPlayer
2787,JointPQPlayer,287,242,529,56,9,Player A
2788,JointPQPlayer,267,232,499,47,16,Player A
2789,JointPQPlayer,300,210,510,40,10,Player A
2790,JointPQPlayer,282,212,494,36,14,Player A
2791,JointPQPlayer,255,225,480,31,17,Player A
2792,JointPQPlayer,185,255,440,21,27,JointPQPlayer
2793,JointPQPlayer,266,231,497,42,15,Player A
2794,JointPQPlayer,311,186,497,33,12,Player A
2795,JointPQPlayer,254,229,483,40,19,Player A
2796,JointPQPlayer,164,289,453,25,24,JointPQPlayer
2797,JointPQPlayer,126,286,412,14,34,JointPQPlayer
2798,JointPQPlayer,297,212,509,39,10,Player A
2799,JointPQPlayer,133,298,431,18,29,JointPQPlayer
2800,JointPQPlayer,138,298,436,23,29,JointPQPlayer
2801,JointPQPlayer,275,245,520,41,7,Player A
2802,JointPQPlayer,286,211,497,33,12,Player A
2803,JointPQPlayer,298,218,516,40,8,Player A
2804,JointPQPlayer,307,197,504,37,11,Player A
2805,JointPQPlayer,287,222,509,48,13,Player A
2806,JointPQPlayer,264,239,503,36,11,Player A
2807,JointPQPlayer,296,201,497,39,14,Player A
2808,JointPQPlayer,133,313,446,18,24,JointPQPlayer
2809,JointPQPlayer,275,215,490,32,14,Player A
2810,JointPQPlayer,278,218,496,32,12,Player A
2811,JointPQPlayer,296,216,512,45,11,Player A
2812,JointPQPlayer,280,210,490,38,16,Player A
2813,JointPQPlayer,282,197,479,39,20,Player A
2814,JointPQPlayer,274,229,503,42,13,Player A
2815,JointPQPlayer,259,254,513,46,11,Player A
2816,JointPQPlayer,263,223,486,34,16,Player A
2817,JointPQPlayer,259,239,498,40,14,Player A
2818,JointPQPlayer,283,223,506,36,10,Player A
2819,JointPQPlayer,211,281,492,34,14,JointPQPlayer
2820,JointPQPlayer,269,239,508,38,10,Player A
2821,JointPQPlayer,288,218,506,42,12,Player A
2822,JointPQPlayer,264,249,513,49,12,Player A
2823,JointPQPlayer,275,235,510,40,10,Player A
2824,JointPQPlayer,282,212,494,36,14,Player A
2825,JointPQPlayer,263,248,511,44,11,Player A
2826,JointPQPlayer,147,297,444,19,25,JointPQPlayer
2827,JointPQPlayer,278,223,501,40,13,Player A
2828,JointPQPlayer,286,231,517,47,10,Player A
2829,JointPQPlayer,233,258,491,45,18,JointPQPlayer
2830,JointPQPlayer,261,226,487,38,17,Player A
2831,JointPQPlayer,121,296,417,13,32,JointPQPlayer
2832,JointPQPlayer,313,218,531,43,4,Player A
2833,JointPQPlayer,237,267,504,40,12,JointPQPlayer
2834,JointPQPlayer,270,230,500,39,13,Player A
2835,JointPQPlayer,132,287,419,12,31,JointPQPlayer
2836,JointPQPlayer,288,203,491,45,18,Player A
2837,JointPQPlayer,192,282,474,31,19,JointPQPlayer
2838,JointPQPlayer,164,279,443,24,27,JointPQPlayer
2839,JointPQPlayer,118,308,426,16,30,JointPQPlayer
2840,JointPQPlayer,281,231,512,39,9,Player A
2841,JointPQPlayer,287,212,499,41,14,Player A
2842,JointPQPlayer,292,192,484,32,16,Player A
2843,JointPQPlayer,281,221,502,41,13,Player A
2844,JointPQPlayer,159,299,458,21,21,JointPQPlayer
2845,JointPQPlayer,217,267,484,35,17,JointPQPlayer
2846,JointPQPlayer,285,210,495,49,18,Player A
2847,JointPQPlayer,280,215,495,40,15,Player A
2848,JointPQPlayer,304,209,513,46,11,Player A
2849,JointPQPlayer,171,241,412,26,38,JointPQPlayer
2850,JointPQPlayer,246,256,502,44,14,JointPQPlayer
2851,JointPQPlayer,280,235,515,45,10,Player A
2852,JointPQPlayer,288,218,506,42,12,Player A
2853,JointPQPlayer,285,220,505,41,12,Player A
2854,JointPQPlayer,247,282,529,44,5,JointPQPlayer
2855,JointPQPlayer,286,211,497,39,14,Player A
2856,JointPQPlayer,275,230,505,41,12,Player A
2857,JointPQPlayer,299,204,503,36,11,Player A
2858,JointPQPlayer,128,293,421,20,33,JointPQPlayer
2859,JointPQPlayer,165,290,455,21,22,JointPQPlayer
2860,JointPQPlayer,198,253,451,26,25,JointPQPlayer
2861,JointPQPlayer,263,228,491,33,14,Player A
2862,JointPQPlayer,140,305,445,23,26,JointPQPlayer
2863,JointPQPlayer,286,216,502,41,13,Player A
2864,JointPQPlayer,299,209,508,44,12,Player A
2865,JointPQPlayer,305,210,515,48,11,Player A
2866,JointPQPlayer,128,278,406,14,36,JointPQPlayer
2867,JointPQPlayer,253,228,481,38,19,Player A
2868,JointPQPlayer,287,207,494,33,13,Player A
2869,JointPQPlayer,269,229,498,43,15,Player A
2870,JointPQPlayer,147,272,419,24,35,JointPQPlayer
2871,JointPQPlayer,260,240,500,42,14,Player A
2872,JointPQPlayer,245,255,500,42,14,JointPQPlayer
2873,JointPQPlayer,248,223,471,28,19,Player A
2874,JointPQPlayer,290,215,505,35,10,Player A
2875,JointPQPlayer,300,210,510,43,11,Player A
2876,JointPQPlayer,266,246,512,51,13,Player A
2877,JointPQPlayer,297,202,499,38,13,Player A
2878,JointPQPlayer,247,277,524,45,7,JointPQPlayer
2879,JointPQPlayer,179,264,443,24,27,JointPQPlayer
2880,JointPQPlayer,295,200,495,43,16,Player A
2881,JointPQPlayer,294,219,513,49,12,Player A
2882,JointPQPlayer,267,252,519,49,10,Player A
2883,JointPQPlayer,143,278,421,20,33,JointPQPlayer
2884,JointPQPlayer,279,229,508,47,13,Player A
2885,JointPQPlayer,271,241,512,45,11,Player A
2886,JointPQPlayer,161,291,452,24,24,JointPQPlayer
2887,JointPQPlayer,250,240,490,38,16,Player A
2888,JointPQPlayer,266,251,517,41,8,Player A
2889,JointPQPlayer,273,203,476,36,20,Player A
2890,JointPQPlayer,278,243,521,42,7,Player A
2891,JointPQPlayer,131,321,452,24,24,JointPQPlayer
2892,JointPQPlayer,135,340,475,23,16,JointPQPlayer
2893,JointPQPlayer,312,197,509,42,11,Player A
2894,JointPQPlayer,258,238,496,47,17,Player A
2895,JointPQPlayer,246,241,487,35,16,Player A
2896,JointPQPlayer,240,245,485,45,20,JointPQPlayer
2897,JointPQPlayer,306,206,512,42,10,Player A
2898,JointPQPlayer,270,225,495,40,15,Player A
2899,JointPQPlayer,280,235,515,42,9,Player A
2900,JointPQPlayer,294,199,493,41,16,Player A
2901,JointPQPlayer,289,214,503,42,13,Player A
2902,JointPQPlayer,171,301,472,29,19,JointPQPlayer
2903,JointPQPlayer,251,266,517,41,8,JointPQPlayer
2904,JointPQPlayer,246,256,502,38,12,JointPQPlayer
2905,JointPQPlayer,277,237,514,41,9,Player A
2906,JointPQPlayer,277,237,514,44,10,Player A
2907,JointPQPlayer,158,293,451,20,23,JointPQPlayer
2908,JointPQPlayer,306,201,507,46,13,Player A
2909,JointPQPlayer,142,272,414,16,34,JointPQPlayer
2910,JointPQPlayer,166,281,447,19,24,JointPQPlayer
2911,JointPQPlayer,143,273,416,18,34,JointPQPlayer
2912,JointPQPlayer,288,218,506,36,10,Player A
2913,JointPQPlayer,138,308,446,18,24,JointPQPlayer
2914,JointPQPlayer,271,226,497,39,14,Player A
2915,JointPQPlayer,249,239,488,42,18,Player A
2916,JointPQPlayer,297,227,524,42,6,Player A
2917,JointPQPlayer,256,236,492,37,15,Player A
2918,JointPQPlayer,307,182,489,34,15,Player A
2919,JointPQPlayer,302,192,494,36,14,Player A
2920,JointPQPlayer,147,277,424,17,31,JointPQPlayer
2921,JointPQPlayer,282,217,499,32,11,Player A
2922,JointPQPlayer,293,203,496,38,14,Player A
2923,JointPQPlayer,238,238,476,30,18,Tie
2924,JointPQPlayer,257,247,504,43,13,Player A
2925,JointPQPlayer,283,223,506,39,11,Player A
2926,JointPQPlayer,278,238,516,46,10,Player A
2927,JointPQPlayer,252,232,484,32,16,Player A
2928,JointPQPlayer,276,221,497,36,13,Player A
2929,JointPQPlayer,135,275,410,15,35,JointPQPlayer
2930,JointPQPlayer,270,235,505,38,11,Player A
2931,JointPQPlayer,269,244,513,40,9,Player A
2932,JointPQPlayer,137,302,439,20,27,JointPQPlayer
2933,JointPQPlayer,247,252,499,41,14,JointPQPlayer
2934,JointPQPlayer,138,298,436,20,28,JointPQPlayer
2935,JointPQPlayer,138,283,421,20,33,JointPQPlayer
2936,JointPQPlayer,153,283,436,20,28,JointPQPlayer
2937,JointPQPlayer,321,196,517,44,9,Player A
2938,JointPQPlayer,249,229,478,41,21,Player A
2939,JointPQPlayer,137,282,419,9,30,JointPQPlayer
2940,JointPQPlayer,249,244,493,32,13,Player A
2941,JointPQPlayer,298,208,506,39,11,Player A
2942,JointPQPlayer,290,215,505,41,12,Player A
2943,JointPQPlayer,263,228,491,30,13,Player A
2944,JointPQPlayer,272,237,509,39,10,Player A
2945,JointPQPlayer,163,268,431,15,28,JointPQPlayer
2946,JointPQPlayer,246,221,467,33,22,Player A
2947,JointPQPlayer,285,230,515,39,8,Player A
2948,JointPQPlayer,270,235,505,44,13,Player A
2949,JointPQPlayer,289,219,508,44,12,Player A
2950,JointPQPlayer,164,284,448,20,24,JointPQPlayer
2951,JointPQPlayer,116,311,427,17,30,JointPQPlayer
2952,JointPQPlayer,306,211,517,47,10,Player A
2953,JointPQPlayer,307,192,499,41,14,Player A
2954,JointPQPlayer,253,233,486,25,13,Player A
2955,JointPQPlayer,264,234,498,40,14,Player A
2956,JointPQPlayer,237,252,489,34,15,JointPQPlayer
2957,JointPQPlayer,239,244,483,40,19,JointPQPlayer
2958,JointPQPlayer,298,213,511,38,9,Player A
2959,JointPQPlayer,282,202,484,41,19,Player A
2960,JointPQPlayer,145,275,420,13,31,JointPQPlayer
2961,JointPQPlayer,289,214,503,39,12,Player A
2962,JointPQPlayer,301,201,502,41,13,Player A
2963,JointPQPlayer,143,273,416,18,34,JointPQPlayer
2964,JointPQPlayer,131,276,407,12,35,JointPQPlayer
2965,JointPQPlayer,269,234,503,42,13,Player A
2966,JointPQPlayer,128,293,421,11,30,JointPQPlayer
2967,JointPQPlayer,268,238,506,48,14,Player A
2968,JointPQPlayer,129,284,413,15,34,JointPQPlayer
2969,JointPQPlayer,134,304,438,19,27,JointPQPlayer
2970,JointPQPlayer,278,198,476,33,19,Player A
2971,JointPQPlayer,308,193,501,37,12,Player A
2972,JointPQPlayer,302,197,499,38,13,Player A
2973,JointPQPlayer,208,268,476,30,18,JointPQPlayer
2974,JointPQPlayer,276,231,507,40,11,Player A
2975,JointPQPlayer,297,207,504,43,13,Player A
2976,JointPQPlayer,139,294,433,17,28,JointPQPlayer
2977,JointPQPlayer,166,276,442,23,27,JointPQPlayer
2978,JointPQPlayer,260,240,500,36,12,Player A
2979,JointPQPlayer,312,217,529,44,5,Player A
2980,JointPQPlayer,131,311,442,17,25,JointPQPlayer
2981,JointPQPlayer,264,204,468,34,22,Player A
2982,JointPQPlayer,262,222,484,35,17,Player A
2983,JointPQPlayer,124,299,423,13,30,JointPQPlayer
2984,JointPQPlayer,177,262,439,23,28,JointPQPlayer
2985,JointPQPlayer,271,216,487,35,16,Player A
2986,JointPQPlayer,278,228,506,36,10,Player A
2987,JointPQPlayer,136,281,417,13,32,JointPQPlayer
2988,JointPQPlayer,129,289,418,11,31,JointPQPlayer
2989,JointPQPlayer,279,219,498,37,13,Player A
2990,JointPQPlayer,281,231,512,51,13,Player A
2991,JointPQPlayer,255,255,510,43,11,Tie
2992,JointPQPlayer,286,201,487,41,18,Player A
2993,JointPQPlayer,260,230,490,35,15,Player A
2994,JointPQPlayer,262,227,489,40,17,Player A
2995,JointPQPlayer,273,233,506,42,12,Player A
2996,JointPQPlayer,269,229,498,37,13,Player A
2997,JointPQPlayer,269,249,518,39,7,Player A
2998,JointPQPlayer,250,250,500,42,14,Tie
2999,JointPQPlayer,226,261,487,38,17,JointPQPlayer
3000,JointPQPlayer,300,210,510,40,10,Player A
3001,JointPQPlayer,293,203,496,35,13,Player A
3002,JointPQPlayer,265,245,510,37,9,Player A
3003,JointPQPlayer,287,227,514,47,11,Player A
3004,JointPQPlayer,180,250,430,20,30,JointPQPlayer
3005,JointPQPlayer,268,228,496,38,14,Player A
3006,JointPQPlayer,267,252,519,49,10,Player A
3007,JointPQPlayer,288,218,506,45,13,Player A
3008,JointPQPlayer,201,266,467,24,19,JointPQPlayer
3009,JointPQPlayer,157,282,439,23,28,JointPQPlayer
3010,JointPQPlayer,267,222,489,37,16,Player A
3011,JointPQPlayer,119,289,408,16,36,JointPQPlayer
3012,JointPQPlayer,282,222,504,37,11,Player A
3013,JointPQPlayer,266,251,517,44,9,Player A
3014,JointPQPlayer,129,299,428,9,27,JointPQPlayer
3015,JointPQPlayer,142,292,434,18,28,JointPQPlayer
3016,JointPQPlayer,256,221,477,37,20,Player A
3017,JointPQPlayer,265,230,495,31,12,Player A
3018,JointPQPlayer,300,225,525,52,9,Player A
3019,JointPQPlayer,274,239,513,40,9,Player A
3020,JointPQPlayer,292,187,479,36,19,Player A
3021,JointPQPlayer,165,275,440,24,28,JointPQPlayer
3022,JointPQPlayer,300,215,515,39,8,Player A
3023,JointPQPlayer,286,241,527,51,8,Player A
3024,JointPQPlayer,261,246,507,40,11,Player A
3025,JointPQPlayer,151,281,432,19,29,JointPQPlayer
3026,JointPQPlayer,323,188,511,38,9,Player A
3027,JointPQPlayer,298,233,531,49,6,Player A
3028,JointPQPlayer,253,218,471,34,21,Player A
3029,JointPQPlayer,288,213,501,43,14,Player A
3030,JointPQPlayer,259,249,508,35,9,Player A
3031,JointPQPlayer,293,208,501,43,14,Player A
3032,JointPQPlayer,271,201,472,35,21,Player A
3033,JointPQPlayer,151,316,467,18,17,JointPQPlayer
3034,JointPQPlayer,263,253,516,52,12,Player A
3035,JointPQPlayer,262,252,514,47,11,Player A
3036,JointPQPlayer,226,266,492,46,18,JointPQPlayer
3037,JointPQPlayer,253,233,486,37,17,Player A
3038,JointPQPlayer,139,299,438,13,25,JointPQPlayer
3039,JointPQPlayer,255,235,490,41,17,Player A
3040,JointPQPlayer,251,226,477,34,19,Player A
3041,JointPQPlayer,125,310,435,16,27,JointPQPlayer
3042,JointPQPlayer,271,236,507,43,12,Player A
3043,JointPQPlayer,282,207,489,34,15,Player A
3044,JointPQPlayer,142,302,444,22,26,JointPQPlayer
3045,JointPQPlayer,297,212,509,45,12,Player A
3046,JointPQPlayer,279,239,518,48,10,Player A
3047,JointPQPlayer,150,270,420,16,32,JointPQPlayer
3048,JointPQPlayer,245,255,500,42,14,JointPQPlayer
3049,JointPQPlayer,267,232,499,38,13,Player A
3050,JointPQPlayer,227,257,484,38,18,JointPQPlayer
3051,JointPQPlayer,298,238,536,48,4,Player A
3052,JointPQPlayer,239,234,473,33,20,Player A
3053,JointPQPlayer,156,286,442,20,26,JointPQPlayer
3054,JointPQPlayer,128,283,411,16,35,JointPQPlayer
3055,JointPQPlayer,129,279,408,13,35,JointPQPlayer
3056,JointPQPlayer,207,257,464,30,22,JointPQPlayer
3057,JointPQPlayer,265,240,505,41,12,Player A
3058,JointPQPlayer,175,285,460,29,23,JointPQPlayer
3059,JointPQPlayer,317,202,519,46,9,Player A
3060,JointPQPlayer,282,202,484,35,17,Player A
3061,JointPQPlayer,136,301,437,15,26,JointPQPlayer
3062,JointPQPlayer,274,209,483,34,17,Player A
3063,JointPQPlayer,271,226,497,39,14,Player A
3064,JointPQPlayer,155,260,415,23,36,JointPQPlayer
3065,JointPQPlayer,269,229,498,34,12,Player A
3066,JointPQPlayer,273,213,486,31,15,Player A
3067,JointPQPlayer,283,203,486,43,19,Player A
3068,JointPQPlayer,282,222,504,43,13,Player A
3069,JointPQPlayer,261,251,512,45,11,Player A
3070,JointPQPlayer,292,202,494,30,12,Player A
3071,JointPQPlayer,246,241,487,35,16,Player A
3072,JointPQPlayer,262,247,509,39,10,Player A
3073,JointPQPlayer,181,281,462,25,21,JointPQPlayer
3074,JointPQPlayer,300,215,515,42,9,Player A
3075,JointPQPlayer,223,233,456,25,23,JointPQPlayer
3076,JointPQPlayer,290,215,505,44,13,Player A
3077,JointPQPlayer,261,231,492,40,16,Player A
3078,JointPQPlayer,109,324,433,14,27,JointPQPlayer
3079,JointPQPlayer,257,247,504,40,12,Player A
3080,JointPQPlayer,294,199,493,41,16,Player A
3081,JointPQPlayer,137,282,419,15,32,JointPQPlayer
3082,JointPQPlayer,257,257,514,44,10,Tie
3083,JointPQPlayer,271,231,502,44,14,Player A
3084,JointPQPlayer,288,213,501,40,13,Player A
3085,JointPQPlayer,291,206,497,36,13,Player A
3086,JointPQPlayer,244,264,508,44,12,JointPQPlayer
3087,JointPQPlayer,285,225,510,46,12,Player A
3088,JointPQPlayer,266,241,507,43,12,Player A
3089,JointPQPlayer,128,308,436,14,26,JointPQPlayer
3090,JointPQPlayer,226,256,482,36,18,JointPQPlayer
3091,JointPQPlayer,215,270,485,48,21,JointPQPlayer
3092,JointPQPlayer,240,235,475,35,20,Player A
3093,JointPQPlayer,106,316,422,18,32,JointPQPlayer
3094,JointPQPlayer,150,290,440,21,27,JointPQPlayer
3095,JointPQPlayer,258,238,496,32,12,Player A
3096,JointPQPlayer,265,210,475,26,17,Player A
3097,JointPQPlayer,278,238,516,46,10,Player A
3098,JointPQPlayer,267,257,524,39,5,Player A
3099,JointPQPlayer,275,230,505,41,12,Player A
3100,JointPQPlayer,151,286,437,18,27,JointPQPlayer
3101,JointPQPlayer,286,226,512,45,11,Player A
3102,JointPQPlayer,154,284,438,22,28,JointPQPlayer
3103,JointPQPlayer,278,253,531,43,4,Player A
3104,JointPQPlayer,149,319,468,25,19,JointPQPlayer
3105,JointPQPlayer,233,243,476,39,21,JointPQPlayer
3106,JointPQPlayer,277,192,469,26,19,Player A
3107,JointPQPlayer,279,229,508,44,12,Player A
3108,JointPQPlayer,274,234,508,41,11,Player A
3109,JointPQPlayer,150,275,425,18,31,JointPQPlayer
3110,JointPQPlayer,262,227,489,40,17,Player A
3111,JointPQPlayer,127,307,434,21,29,JointPQPlayer
3112,JointPQPlayer,277,217,494,42,16,Player A
3113,JointPQPlayer,138,323,461,24,21,JointPQPlayer
3114,JointPQPlayer,111,316,427,14,29,JointPQPlayer
3115,JointPQPlayer,278,228,506,45,13,Player A
3116,JointPQPlayer,267,242,509,51,14,Player A
3117,JointPQPlayer,222,262,484,32,16,JointPQPlayer
3118,JointPQPlayer,292,212,504,40,12,Player A
3119,JointPQPlayer,295,205,500,39,13,Player A
3120,JointPQPlayer,143,298,441,19,26,JointPQPlayer
3121,JointPQPlayer,291,201,492,34,14,Player A
3122,JointPQPlayer,277,232,509,39,10,Player A
3123,JointPQPlayer,151,291,442,17,25,JointPQPlayer
3124,JointPQPlayer,287,237,524,42,6,Player A
3125,JointPQPlayer,260,245,505,44,13,Player A
3126,JointPQPlayer,316,191,507,37,10,Player A
3127,JointPQPlayer,150,295,445,17,24,JointPQPlayer
3128,JointPQPlayer,274,214,488,39,17,Player A
3129,JointPQPlayer,126,321,447,25,26,JointPQPlayer
3130,JointPQPlayer,158,283,441,16,25,JointPQPlayer
3131,JointPQPlayer,153,268,421,17,32,JointPQPlayer
3132,JointPQPlayer,169,289,458,21,21,JointPQPlayer
3133,JointPQPlayer,105,335,440,18,26,JointPQPlayer
3134,JointPQPlayer,290,225,515,51,12,Player A
3135,JointPQPlayer,271,236,507,46,13,Player A
3136,JointPQPlayer,292,222,514,41,9,Player A
3137,JointPQPlayer,244,229,473,36,21,Player A
3138,JointPQPlayer,275,240,515,48,11,Player A
3139,JointPQPlayer,253,238,491,36,15,Player A
3140,JointPQPlayer,258,218,476,33,19,Player A
3141,JointPQPlayer,263,228,491,36,15,Player A
3142,JointPQPlayer,127,312,439,17,26,JointPQPlayer
3143,JointPQPlayer,266,216,482,39,19,Player A
3144,JointPQPlayer,150,290,440,15,25,JointPQPlayer
3145,JointPQPlayer,168,258,426,19,31,JointPQPlayer
3146,JointPQPlayer,258,243,501,43,14,Player A
3147,JointPQPlayer,283,243,526,50,8,Player A
3148,JointPQPlayer,119,299,418,11,31,JointPQPlayer
3149,JointPQPlayer,148,273,421,17,32,JointPQPlayer
3150,JointPQPlayer,280,225,505,41,12,Player A
3151,JointPQPlayer,147,272,419,15,32,JointPQPlayer
3152,JointPQPlayer,229,289,518,42,8,JointPQPlayer
3153,JointPQPlayer,274,239,513,46,11,Player A
3154,JointPQPlayer,289,209,498,31,11,Player A
3155,JointPQPlayer,281,231,512,42,10,Player A
3156,JointPQPlayer,304,224,528,49,7,Player A
3157,JointPQPlayer,275,225,500,45,15,Player A
3158,JointPQPlayer,296,216,512,48,12,Player A
3159,JointPQPlayer,299,214,513,43,10,Player A
3160,JointPQPlayer,116,331,447,19,24,JointPQPlayer
3161,JointPQPlayer,274,234,508,41,11,Player A
3162,JointPQPlayer,282,227,509,42,11,Player A
3163,JointPQPlayer,271,226,497,36,13,Player A
3164,JointPQPlayer,258,233,491,39,16,Player A
3165,JointPQPlayer,262,227,489,40,17,Player A
3166,JointPQPlayer,296,201,497,45,16,Player A
3167,JointPQPlayer,141,296,437,24,29,JointPQPlayer
3168,JointPQPlayer,313,193,506,39,11,Player A
3169,JointPQPlayer,144,284,428,15,29,JointPQPlayer
3170,JointPQPlayer,304,199,503,33,10,Player A
3171,JointPQPlayer,293,208,501,43,14,Player A
3172,JointPQPlayer,170,265,435,13,26,JointPQPlayer
3173,JointPQPlayer,302,217,519,37,6,Player A
3174,JointPQPlayer,302,197,499,38,13,Player A
3175,JointPQPlayer,141,286,427,14,29,JointPQPlayer
3176,JointPQPlayer,121,301,422,18,32,JointPQPlayer
3177,JointPQPlayer,277,217,494,39,15,Player A
3178,JointPQPlayer,246,246,492,43,17,Tie
3179,JointPQPlayer,271,231,502,44,14,Player A
3180,JointPQPlayer,252,252,504,43,13,Tie
3181,JointPQPlayer,271,221,492,40,16,Player A
3182,JointPQPlayer,264,229,493,38,15,Player A
3183,JointPQPlayer,158,278,436,26,30,JointPQPlayer
3184,JointPQPlayer,242,237,479,33,18,Player A
3185,JointPQPlayer,276,211,487,35,16,Player A
3186,JointPQPlayer,118,298,416,12,32,JointPQPlayer
3187,JointPQPlayer,241,251,492,40,16,JointPQPlayer
3188,JointPQPlayer,150,275,425,24,33,JointPQPlayer
3189,JointPQPlayer,163,263,426,28,34,JointPQPlayer
3190,JointPQPlayer,245,265,510,46,12,JointPQPlayer
3191,JointPQPlayer,109,294,403,11,36,JointPQPlayer
3192,JointPQPlayer,244,219,463,35,24,Player A
3193,JointPQPlayer,153,298,451,20,23,JointPQPlayer
3194,JointPQPlayer,152,272,424,20,32,JointPQPlayer
3195,JointPQPlayer,264,224,488,36,16,Player A
3196,JointPQPlayer,237,232,469,32,21,Player A
3197,JointPQPlayer,246,241,487,38,17,Player A
3198,JointPQPlayer,278,228,506,48,14,Player A
3199,JointPQPlayer,290,205,495,34,13,Player A
3200,JointPQPlayer,273,243,516,49,11,Player A
3201,JointPQPlayer,286,236,522,43,7,Player A
3202,JointPQPlayer,295,225,520,44,8,Player A
3203,JointPQPlayer,298,203,501,37,12,Player A
3204,JointPQPlayer,272,237,509,45,12,Player A
3205,JointPQPlayer,245,255,500,42,14,JointPQPlayer
3206,JointPQPlayer,161,251,412,20,36,JointPQPlayer
3207,JointPQPlayer,290,210,500,39,13,Player A
3208,JointPQPlayer,273,233,506,42,12,Player A
3209,JointPQPlayer,125,310,435,16,27,JointPQPlayer
3210,JointPQPlayer,300,215,515,42,9,Player A
3211,JointPQPlayer,255,230,485,33,16,Player A
3212,JointPQPlayer,272,207,479,39,20,Player A
3213,JointPQPlayer,277,222,499,38,13,Player A
3214,JointPQPlayer,255,240,495,34,13,Player A
3215,JointPQPlayer,127,287,414,13,33,JointPQPlayer
3216,JointPQPlayer,275,225,500,45,15,Player A
3217,JointPQPlayer,268,248,516,43,9,Player A
3218,JointPQPlayer,157,267,424,14,30,JointPQPlayer
3219,JointPQPlayer,267,242,509,48,13,Player A
3220,JointPQPlayer,278,208,486,37,17,Player A
3221,JointPQPlayer,311,191,502,35,11,Player A
3222,JointPQPlayer,302,232,534,49,5,Player A
3223,JointPQPlayer,144,284,428,21,31,JointPQPlayer
3224,JointPQPlayer,299,214,513,46,11,Player A
3225,JointPQPlayer,231,241,472,35,21,JointPQPlayer
3226,JointPQPlayer,282,222,504,37,11,Player A
3227,JointPQPlayer,274,204,478,26,16,Player A
3228,JointPQPlayer,127,317,444,16,24,JointPQPlayer
3229,JointPQPlayer,272,232,504,40,12,Player A
3230,JointPQPlayer,264,224,488,42,18,Player A
3231,JointPQPlayer,201,271,472,29,19,JointPQPlayer
3232,JointPQPlayer,149,289,438,25,29,JointPQPlayer
3233,JointPQPlayer,222,272,494,39,15,JointPQPlayer
3234,JointPQPlayer,265,230,495,43,16,Player A
3235,JointPQPlayer,283,213,496,44,16,Player A
3236,JointPQPlayer,258,258,516,46,10,Tie
3237,JointPQPlayer,309,214,523,47,8,Player A
3238,JointPQPlayer,319,209,528,43,5,Player A
3239,JointPQPlayer,206,286,492,28,12,JointPQPlayer
3240,JointPQPlayer,259,239,498,37,13,Player A
3241,JointPQPlayer,155,285,440,24,28,JointPQPlayer
3242,JointPQPlayer,246,261,507,43,12,JointPQPlayer
3243,JointPQPlayer,256,256,512,48,12,Tie
3244,JointPQPlayer,168,288,456,28,24,JointPQPlayer
3245,JointPQPlayer,279,229,508,35,9,Player A
3246,JointPQPlayer,296,206,502,41,13,Player A
3247,JointPQPlayer,284,209,493,32,13,Player A
3248,JointPQPlayer,291,231,522,40,6,Player A
3249,JointPQPlayer,242,272,514,47,11,JointPQPlayer
3250,JointPQPlayer,288,233,521,45,8,Player A
3251,JointPQPlayer,164,269,433,17,28,JointPQPlayer
3252,JointPQPlayer,135,280,415,14,33,JointPQPlayer
3253,JointPQPlayer,267,217,484,41,19,Player A
3254,JointPQPlayer,252,217,469,29,20,Player A
3255,JointPQPlayer,227,257,484,29,15,JointPQPlayer
3256,JointPQPlayer,318,203,521,42,7,Player A
3257,JointPQPlayer,265,225,490,32,14,Player A
3258,JointPQPlayer,119,289,408,13,35,JointPQPlayer
3259,JointPQPlayer,281,216,497,51,18,Player A
3260,JointPQPlayer,303,203,506,42,12,Player A
3261,JointPQPlayer,262,237,499,41,14,Player A
3262,JointPQPlayer,119,329,448,17,23,JointPQPlayer
3263,JointPQPlayer,211,271,482,21,13,JointPQPlayer
3264,JointPQPlayer,290,210,500,48,16,Player A
3265,JointPQPlayer,257,257,514,41,9,Tie
3266,JointPQPlayer,258,218,476,36,20,Player A
3267,JointPQPlayer,303,198,501,37,12,Player A
3268,JointPQPlayer,151,301,452,21,23,JointPQPlayer
3269,JointPQPlayer,251,246,497,39,14,Player A
3270,JointPQPlayer,301,206,507,46,13,Player A
3271,JointPQPlayer,287,237,524,48,8,Player A
3272,JointPQPlayer,130,325,455,18,21,JointPQPlayer
3273,JointPQPlayer,284,239,523,50,9,Player A
3274,JointPQPlayer,258,243,501,46,15,Player A
3275,JointPQPlayer,276,226,502,35,11,Player A
3276,JointPQPlayer,295,240,535,50,5,Player A
3277,JointPQPlayer,106,321,427,14,29,JointPQPlayer
3278,JointPQPlayer,253,258,511,44,11,JointPQPlayer
3279,JointPQPlayer,284,234,518,45,9,Player A
3280,JointPQPlayer,278,218,496,41,15,Player A
3281,JointPQPlayer,138,283,421,17,32,JointPQPlayer
3282,JointPQPlayer,261,256,517,47,10,Player A
3283,JointPQPlayer,268,238,506,42,12,Player A
3284,JointPQPlayer,289,234,523,47,8,Player A
3285,JointPQPlayer,256,241,497,42,15,Player A
3286,JointPQPlayer,225,265,490,35,15,JointPQPlayer
3287,JointPQPlayer,304,204,508,38,10,Player A
3288,JointPQPlayer,284,229,513,43,10,Player A
3289,JointPQPlayer,272,222,494,39,15,Player A
3290,JointPQPlayer,289,234,523,47,8,Player A
3291,JointPQPlayer,138,283,421,20,33,JointPQPlayer
3292,JointPQPlayer,259,234,493,35,14,Player A
3293,JointPQPlayer,234,269,503,39,12,JointPQPlayer
3294,JointPQPlayer,138,298,436,20,28,JointPQPlayer
3295,JointPQPlayer,255,235,490,38,16,Player A
3296,JointPQPlayer,248,258,506,42,12,JointPQPlayer
3297,JointPQPlayer,129,294,423,16,31,JointPQPlayer
3298,JointPQPlayer,262,242,504,43,13,Player A
3299,JointPQPlayer,290,220,510,40,10,Player A
3300,JointPQPlayer,298,208,506,45,13,Player A
3301,JointPQPlayer,297,227,524,45,7,Player A
3302,JointPQPlayer,186,276,462,28,22,JointPQPlayer
3303,JointPQPlayer,281,221,502,35,11,Player A
3304,JointPQPlayer,285,195,480,34,18,Player A
3305,JointPQPlayer,289,224,513,43,10,Player A
3306,JointPQPlayer,263,228,491,33,14,Player A
3307,JointPQPlayer,240,270,510,49,13,JointPQPlayer
3308,JointPQPlayer,150,270,420,19,33,JointPQPlayer
3309,JointPQPlayer,279,224,503,42,13,Player A
3310,JointPQPlayer,275,230,505,47,14,Player A
3311,JointPQPlayer,311,206,517,38,7,Player A
3312,JointPQPlayer,260,225,485,27,14,Player A
3313,JointPQPlayer,268,238,506,45,13,Player A
3314,JointPQPlayer,268,243,511,38,9,Player A
3315,JointPQPlayer,277,227,504,40,12,Player A
3316,JointPQPlayer,247,257,504,43,13,JointPQPlayer
3317,JointPQPlayer,165,255,420,16,32,JointPQPlayer
3318,JointPQPlayer,194,264,458,21,21,JointPQPlayer
3319,JointPQPlayer,263,243,506,39,11,Player A
3320,JointPQPlayer,172,272,444,25,27,JointPQPlayer
3321,JointPQPlayer,242,277,519,43,8,JointPQPlayer
3322,JointPQPlayer,283,188,471,25,18,Player A
3323,JointPQPlayer,289,209,498,40,14,Player A
3324,JointPQPlayer,103,323,426,13,29,JointPQPlayer
3325,JointPQPlayer,260,235,495,43,16,Player A
3326,JointPQPlayer,145,305,450,22,24,JointPQPlayer
3327,JointPQPlayer,144,294,438,22,28,JointPQPlayer
3328,JointPQPlayer,294,209,503,39,12,Player A
3329,JointPQPlayer,296,181,477,31,18,Player A
3330,JointPQPlayer,268,248,516,43,9,Player A
3331,JointPQPlayer,106,336,442,20,26,JointPQPlayer
3332,JointPQPlayer,297,217,514,44,10,Player A
3333,JointPQPlayer,271,206,477,31,18,Player A
3334,JointPQPlayer,288,198,486,31,15,Player A
3335,JointPQPlayer,223,253,476,30,18,JointPQPlayer
3336,JointPQPlayer,293,218,511,44,11,Player A
3337,JointPQPlayer,305,205,510,43,11,Player A
3338,JointPQPlayer,276,226,502,41,13,Player A
3339,JointPQPlayer,196,261,457,23,22,JointPQPlayer
3340,JointPQPlayer,255,245,500,39,13,Player A
3341,JointPQPlayer,228,288,516,49,11,JointPQPlayer
3342,JointPQPlayer,179,294,473,27,18,JointPQPlayer
3343,JointPQPlayer,222,267,489,37,16,JointPQPlayer
3344,JointPQPlayer,261,251,512,45,11,Player A
3345,JointPQPlayer,277,222,499,38,13,Player A
3346,JointPQPlayer,131,301,432,16,28,JointPQPlayer
3347,JointPQPlayer,296,186,482,33,17,Player A
3348,JointPQPlayer,272,207,479,36,19,Player A
3349,JointPQPlayer,256,241,497,42,15,Player A
3350,JointPQPlayer,140,285,425,18,31,JointPQPlayer
3351,JointPQPlayer,275,245,520,47,9,Player A
3352,JointPQPlayer,262,252,514,47,11,Player A
3353,JointPQPlayer,263,258,521,42,7,Player A
3354,JointPQPlayer,308,198,506,45,13,Player A
3355,JointPQPlayer,277,207,484,47,21,Player A
3356,JointPQPlayer,270,235,505,44,13,Player A
3357,JointPQPlayer,300,205,505,44,13,Player A
3358,JointPQPlayer,144,284,428,12,28,JointPQPlayer
3359,JointPQPlayer,273,218,491,36,15,Player A
3360,JointPQPlayer,239,254,493,41,16,JointPQPlayer
3361,JointPQPlayer,252,247,499,44,15,Player A
3362,JointPQPlayer,261,236,497,45,16,Player A
3363,JointPQPlayer,157,272,429,16,29,JointPQPlayer
3364,JointPQPlayer,273,223,496,38,14,Player A
3365,JointPQPlayer,297,202,499,38,13,Player A
3366,JointPQPlayer,275,225,500,39,13,Player A
3367,JointPQPlayer,269,249,518,39,7,Player A
3368,JointPQPlayer,294,199,493,35,14,Player A
3369,JointPQPlayer,296,241,537,55,6,Player A
3370,JointPQPlayer,287,207,494,39,15,Player A
3371,JointPQPlayer,279,234,513,37,8,Player A
3372,JointPQPlayer,316,206,522,43,7,Player A
3373,JointPQPlayer,293,208,501,40,13,Player A
3374,JointPQPlayer,158,283,441,16,25,JointPQPlayer
3375,JointPQPlayer,297,227,524,51,9,Player A
3376,JointPQPlayer,285,225,510,43,11,Player A
3377,JointPQPlayer,148,278,426,16,30,JointPQPlayer
3378,JointPQPlayer,146,281,427,20,31,JointPQPlayer
3379,JointPQPlayer,165,290,455,18,21,JointPQPlayer
3380,JointPQPlayer,224,249,473,24,17,JointPQPlayer
3381,JointPQPlayer,202,242,444,25,27,JointPQPlayer
3382,JointPQPlayer,257,252,509,42,11,Player A
3383,JointPQPlayer,280,230,510,43,11,Player A
3384,JointPQPlayer,276,226,502,50,16,Player A
3385,JointPQPlayer,228,268,496,35,13,JointPQPlayer
3386,JointPQPlayer,260,245,505,47,14,Player A
3387,JointPQPlayer,156,291,447,22,25,JointPQPlayer
3388,JointPQPlayer,288,208,496,38,14,Player A
3389,JointPQPlayer,159,299,458,24,22,JointPQPlayer
3390,JointPQPlayer,291,221,512,45,11,Player A
3391,JointPQPlayer,273,218,491,39,16,Player A
3392,JointPQPlayer,299,209,508,44,12,Player A
3393,JointPQPlayer,279,224,503,42,13,Player A
3394,JointPQPlayer,273,238,511,41,10,Player A
3395,JointPQPlayer,262,257,519,55,12,Player A
3396,JointPQPlayer,279,219,498,43,15,Player A
3397,JointPQPlayer,280,230,510,46,12,Player A
3398,JointPQPlayer,152,282,434,21,29,JointPQPlayer
3399,JointPQPlayer,272,217,489,40,17,Player A
3400,JointPQPlayer,278,228,506,39,11,Player A
3401,JointPQPlayer,297,207,504,40,12,Player A
3402,JointPQPlayer,286,216,502,32,10,Player A
3403,JointPQPlayer,259,259,518,51,11,Tie
3404,JointPQPlayer,158,278,436,17,27,JointPQPlayer
3405,JointPQPlayer,261,261,522,43,7,Tie
3406,JointPQPlayer,212,262,474,37,21,JointPQPlayer
3407,JointPQPlayer,245,245,490,38,16,Tie
3408,JointPQPlayer,130,285,415,11,32,JointPQPlayer
3409,JointPQPlayer,296,241,537,52,5,Player A
3410,JointPQPlayer,114,324,438,13,25,JointPQPlayer
3411,JointPQPlayer,161,301,462,25,21,JointPQPlayer
3412,JointPQPlayer,299,194,493,26,11,Player A
3413,JointPQPlayer,253,228,481,32,17,Player A
3414,JointPQPlayer,228,248,476,30,18,JointPQPlayer
3415,JointPQPlayer,134,264,398,15,39,JointPQPlayer
3416,JointPQPlayer,267,237,504,40,12,Player A
3417,JointPQPlayer,212,267,479,27,16,JointPQPlayer
3418,JointPQPlayer,283,213,496,41,15,Player A
3419,JointPQPlayer,290,205,495,34,13,Player A
3420,JointPQPlayer,259,259,518,48,10,Tie
3421,JointPQPlayer,292,207,499,38,13,Player A
3422,JointPQPlayer,258,238,496,38,14,Player A
3423,JointPQPlayer,265,215,480,34,18,Player A
3424,JointPQPlayer,255,220,475,32,19,Player A
3425,JointPQPlayer,264,249,513,46,11,Player A
3426,JointPQPlayer,286,201,487,32,15,Player A
3427,JointPQPlayer,139,299,438,10,24,JointPQPlayer
3428,JointPQPlayer,281,231,512,39,9,Player A
3429,JointPQPlayer,250,205,455,33,26,Player A
3430,JointPQPlayer,293,223,516,43,9,Player A
3431,JointPQPlayer,245,240,485,33,16,Player A
3432,JointPQPlayer,281,226,507,40,11,Player A
3433,JointPQPlayer,256,236,492,46,18,Player A
3434,JointPQPlayer,311,211,522,37,5,Player A
3435,JointPQPlayer,240,255,495,37,14,JointPQPlayer
3436,JointPQPlayer,257,222,479,36,19,Player A
3437,JointPQPlayer,275,235,510,37,9,Player A
3438,JointPQPlayer,221,256,477,34,19,JointPQPlayer
3439,JointPQPlayer,294,214,508,41,11,Player A
3440,JointPQPlayer,260,230,490,32,14,Player A
3441,JointPQPlayer,292,222,514,41,9,Player A
3442,JointPQPlayer,262,242,504,40,12,Player A
3443,JointPQPlayer,292,192,484,38,18,Player A
3444,JointPQPlayer,285,220,505,41,12,Player A
3445,JointPQPlayer,289,204,493,35,14,Player A
3446,JointPQPlayer,105,325,430,17,29,JointPQPlayer
3447,JointPQPlayer,262,242,504,43,13,Player A
3448,JointPQPlayer,302,202,504,40,12,Player A
3449,JointPQPlayer,269,239,508,44,12,Player A
3450,JointPQPlayer,278,213,491,36,15,Player A
3451,JointPQPlayer,259,234,493,35,14,Player A
3452,JointPQPlayer,244,264,508,44,12,JointPQPlayer
3453,JointPQPlayer,287,202,489,37,16,Player A
3454,JointPQPlayer,264,269,533,51,6,JointPQPlayer
3455,JointPQPlayer,288,198,486,34,16,Player A
3456,JointPQPlayer,298,228,526,47,7,Player A
3457,JointPQPlayer,238,243,481,41,20,JointPQPlayer
3458,JointPQPlayer,187,237,424,23,33,JointPQPlayer
3459,JointPQPlayer,211,241,452,21,23,JointPQPlayer
3460,JointPQPlayer,227,232,459,34,25,JointPQPlayer
3461,JointPQPlayer,262,247,509,48,13,Player A
3462,JointPQPlayer,256,226,482,36,18,Player A
3463,JointPQPlayer,115,335,450,19,23,JointPQPlayer
3464,JointPQPlayer,284,214,498,37,13,Player A
3465,JointPQPlayer,111,311,422,9,29,JointPQPlayer
3466,JointPQPlayer,256,241,497,39,14,Player A
3467,JointPQPlayer,295,210,505,41,12,Player A
3468,JointPQPlayer,252,242,494,42,16,Player A
3469,JointPQPlayer,278,218,496,44,16,Player A
3470,JointPQPlayer,217,267,484,29,15,JointPQPlayer
3471,JointPQPlayer,247,252,499,41,14,JointPQPlayer
3472,JointPQPlayer,131,316,447,19,24,JointPQPlayer
3473,JointPQPlayer,276,221,497,42,15,Player A
3474,JointPQPlayer,133,298,431,24,31,JointPQPlayer
3475,JointPQPlayer,146,281,427,20,31,JointPQPlayer
3476,JointPQPlayer,208,253,461,24,21,JointPQPlayer
3477,JointPQPlayer,286,211,497,39,14,Player A
3478,JointPQPlayer,132,282,414,16,34,JointPQPlayer
3479,JointPQPlayer,283,213,496,41,15,Player A
3480,JointPQPlayer,287,227,514,41,9,Player A
3481,JointPQPlayer,125,295,420,19,33,JointPQPlayer
3482,JointPQPlayer,98,323,421,14,31,JointPQPlayer
3483,JointPQPlayer,143,288,431,21,30,JointPQPlayer
3484,JointPQPlayer,273,238,511,50,13,Player A
3485,JointPQPlayer,299,194,493,38,15,Player A
3486,JointPQPlayer,295,220,515,39,8,Player A
3487,JointPQPlayer,283,203,486,34,16,Player A
3488,JointPQPlayer,278,223,501,40,13,Player A
3489,JointPQPlayer,201,296,497,39,14,JointPQPlayer
3490,JointPQPlayer,231,261,492,40,16,JointPQPlayer
3491,JointPQPlayer,234,239,473,36,21,JointPQPlayer
3492,JointPQPlayer,310,190,500,45,15,Player A
3493,JointPQPlayer,265,230,495,40,15,Player A
3494,JointPQPlayer,275,235,510,49,13,Player A
3495,JointPQPlayer,289,209,498,34,12,Player A
3496,JointPQPlayer,267,227,494,42,16,Player A
3497,JointPQPlayer,305,210,515,42,9,Player A
3498,JointPQPlayer,263,228,491,39,16,Player A
3499,JointPQPlayer,141,301,442,26,28,JointPQPlayer
3500,JointPQPlayer,150,290,440,21,27,JointPQPlayer
3501,JointPQPlayer,291,191,482,36,18,Player A
3502,JointPQPlayer,123,318,441,13,24,JointPQPlayer
3503,JointPQPlayer,196,261,457,20,21,JointPQPlayer
3504,JointPQPlayer,303,198,501,37,12,Player A
3505,JointPQPlayer,261,231,492,43,17,Player A
3506,JointPQPlayer,292,222,514,44,10,Player A
3507,JointPQPlayer,150,270,420,16,32,JointPQPlayer
3508,JointPQPlayer,241,261,502,41,13,JointPQPlayer
3509,JointPQPlayer,293,213,506,42,12,Player A
3510,JointPQPlayer,144,314,458,21,21,JointPQPlayer
3511,JointPQPlayer,251,256,507,46,13,JointPQPlayer
3512,JointPQPlayer,186,286,472,23,17,JointPQPlayer
3513,JointPQPlayer,117,317,434,18,28,JointPQPlayer
3514,JointPQPlayer,138,293,431,18,29,JointPQPlayer
3515,JointPQPlayer,290,210,500,48,16,Player A
3516,JointPQPlayer,284,204,488,42,18,Player A
3517,JointPQPlayer,270,220,490,35,15,Player A
3518,JointPQPlayer,254,219,473,33,20,Player A
3519,JointPQPlayer,287,217,504,40,12,Player A
3520,JointPQPlayer,285,225,510,43,11,Player A
3521,JointPQPlayer,264,239,503,45,14,Player A
3522,JointPQPlayer,299,204,503,36,11,Player A
3523,JointPQPlayer,267,237,504,43,13,Player A
3524,JointPQPlayer,264,219,483,28,15,Player A
3525,JointPQPlayer,267,242,509,42,11,Player A
3526,JointPQPlayer,237,257,494,33,13,JointPQPlayer
3527,JointPQPlayer,232,277,509,36,9,JointPQPlayer
3528,JointPQPlayer,220,280,500,36,12,JointPQPlayer
3529,JointPQPlayer,302,207,509,42,11,Player A
3530,JointPQPlayer,222,272,494,33,13,JointPQPlayer
3531,JointPQPlayer,287,217,504,37,11,Player A
3532,JointPQPlayer,151,286,437,15,26,JointPQPlayer
3533,JointPQPlayer,225,245,470,27,19,JointPQPlayer
3534,JointPQPlayer,303,213,516,40,8,Player A
3535,JointPQPlayer,329,174,503,33,10,Player A
3536,JointPQPlayer,288,208,496,44,16,Player A
3537,JointPQPlayer,144,294,438,16,26,JointPQPlayer
3538,JointPQPlayer,267,222,489,34,15,Player A
3539,JointPQPlayer,161,296,457,26,23,JointPQPlayer
3540,JointPQPlayer,294,224,518,48,10,Player A
3541,JointPQPlayer,302,192,494,39,15,Player A
3542,JointPQPlayer,277,242,519,43,8,Player A
3543,JointPQPlayer,274,244,518,42,8,Player A
3544,JointPQPlayer,261,236,497,39,14,Player A
3545,JointPQPlayer,283,203,486,31,15,Player A
3546,JointPQPlayer,249,254,503,39,12,JointPQPlayer
3547,JointPQPlayer,236,261,497,36,13,JointPQPlayer
3548,JointPQPlayer,233,243,476,30,18,JointPQPlayer
3549,JointPQPlayer,263,228,491,36,15,Player A
3550,JointPQPlayer,295,190,485,39,18,Player A
3551,JointPQPlayer,285,240,525,46,7,Player A
3552,JointPQPlayer,252,232,484,35,17,Player A
3553,JointPQPlayer,325,200,525,49,8,Player A
3554,JointPQPlayer,249,249,498,46,16,Tie
3555,JointPQPlayer,225,245,470,39,23,JointPQPlayer
3556,JointPQPlayer,163,293,456,22,22,JointPQPlayer
3557,JointPQPlayer,289,204,493,44,17,Player A
3558,JointPQPlayer,163,273,436,23,29,JointPQPlayer
3559,JointPQPlayer,140,290,430,17,29,JointPQPlayer
3560,JointPQPlayer,148,298,446,21,25,JointPQPlayer
3561,JointPQPlayer,270,255,525,49,8,Player A
3562,JointPQPlayer,168,268,436,20,28,JointPQPlayer
3563,JointPQPlayer,281,241,522,46,8,Player A
3564,JointPQPlayer,270,235,505,41,12,Player A
3565,JointPQPlayer,304,189,493,41,16,Player A
3566,JointPQPlayer,278,218,496,44,16,Player A
3567,JointPQPlayer,227,267,494,36,14,JointPQPlayer
3568,JointPQPlayer,275,245,520,47,9,Player A
3569,JointPQPlayer,154,294,448,23,25,JointPQPlayer
3570,JointPQPlayer,230,235,465,37,24,JointPQPlayer
3571,JointPQPlayer,273,238,511,47,12,Player A
3572,JointPQPlayer,260,255,515,42,9,Player A
3573,JointPQPlayer,265,235,500,39,13,Player A
3574,JointPQPlayer,278,228,506,39,11,Player A
3575,JointPQPlayer,290,220,510,46,12,Player A
3576,JointPQPlayer,305,220,525,46,7,Player A
3577,JointPQPlayer,291,206,497,39,14,Player A
3578,JointPQPlayer,283,218,501,37,12,Player A
3579,JointPQPlayer,242,237,479,42,21,Player A
3580,JointPQPlayer,277,232,509,48,13,Player A
3581,JointPQPlayer,173,263,436,23,29,JointPQPlayer
3582,JointPQPlayer,236,226,462,28,22,Player A
3583,JointPQPlayer,267,242,509,42,11,Player A
3584,JointPQPlayer,260,225,485,39,18,Player A
3585,JointPQPlayer,288,218,506,39,11,Player A
3586,JointPQPlayer,253,238,491,45,18,Player A
3587,JointPQPlayer,260,230,490,41,17,Player A
3588,JointPQPlayer,138,293,431,21,30,JointPQPlayer
3589,JointPQPlayer,268,248,516,52,12,Player A
3590,JointPQPlayer,152,267,419,18,33,JointPQPlayer
3591,JointPQPlayer,276,216,492,37,15,Player A
3592,JointPQPlayer,259,224,483,28,15,Player A
3593,JointPQPlayer,297,207,504,46,14,Player A
3594,JointPQPlayer,242,227,469,35,22,Player A
3595,JointPQPlayer,234,219,453,34,27,Player A
3596,JointPQPlayer,260,235,495,37,14,Player A
3597,JointPQPlayer,134,309,443,12,23,JointPQPlayer
3598,JointPQPlayer,285,195,480,37,19,Player A
3599,JointPQPlayer,141,286,427,20,31,JointPQPlayer
3600,JointPQPlayer,273,233,506,42,12,Player A
3601,JointPQPlayer,256,216,472,29,19,Player A
3602,JointPQPlayer,235,240,475,32,19,JointPQPlayer
3603,JointPQPlayer,160,280,440,21,27,JointPQPlayer
3604,JointPQPlayer,278,238,516,43,9,Player A
3605,JointPQPlayer,295,230,525,46,7,Player A
3606,JointPQPlayer,269,224,493,35,14,Player A
3607,JointPQPlayer,238,243,481,35,18,JointPQPlayer
3608,JointPQPlayer,302,212,514,35,7,Player A
3609,JointPQPlayer,294,204,498,34,12,Player A
3610,JointPQPlayer,245,235,480,34,18,Player A
3611,JointPQPlayer,274,229,503,42,13,Player A
3612,JointPQPlayer,265,235,500,39,13,Player A
3613,JointPQPlayer,120,330,450,16,22,JointPQPlayer
3614,JointPQPlayer,282,212,494,36,14,Player A
3615,JointPQPlayer,252,237,489,37,16,Player A
3616,JointPQPlayer,251,226,477,34,19,Player A
3617,JointPQPlayer,294,199,493,38,15,Player A
3618,JointPQPlayer,257,232,489,34,15,Player A
3619,JointPQPlayer,291,211,502,47,15,Player A
3620,JointPQPlayer,296,196,492,37,15,Player A
3621,JointPQPlayer,289,234,523,44,7,Player A
3622,JointPQPlayer,133,303,436,14,26,JointPQPlayer
3623,JointPQPlayer,269,244,513,43,10,Player A
3624,JointPQPlayer,306,221,527,51,8,Player A
3625,JointPQPlayer,289,224,513,43,10,Player A
3626,JointPQPlayer,175,270,445,20,25,JointPQPlayer
3627,JointPQPlayer,272,227,499,38,13,Player A
3628,JointPQPlayer,274,229,503,45,14,Player A
3629,JointPQPlayer,262,232,494,39,15,Player A
3630,JointPQPlayer,122,297,419,12,31,JointPQPlayer
3631,JointPQPlayer,149,284,433,17,28,JointPQPlayer
3632,JointPQPlayer,275,250,525,46,7,Player A
3633,JointPQPlayer,136,291,427,14,29,JointPQPlayer
3634,JointPQPlayer,257,227,484,38,18,Player A
3635,JointPQPlayer,275,235,510,43,11,Player A
3636,JointPQPlayer,287,227,514,41,9,Player A
3637,JointPQPlayer,266,211,477,31,18,Player A
3638,JointPQPlayer,263,243,506,42,12,Player A
3639,JointPQPlayer,286,216,502,41,13,Player A
3640,JointPQPlayer,314,209,523,41,6,Player A
3641,JointPQPlayer,167,267,434,18,28,JointPQPlayer
3642,JointPQPlayer,270,220,490,44,18,Player A
3643,JointPQPlayer,123,288,411,16,35,JointPQPlayer
3644,JointPQPlayer,129,324,453,16,21,JointPQPlayer
3645,JointPQPlayer,263,238,501,43,14,Player A
3646,JointPQPlayer,293,223,516,49,11,Player A
3647,JointPQPlayer,286,231,517,47,10,Player A
3648,JointPQPlayer,283,238,521,45,8,Player A
3649,JointPQPlayer,224,249,473,33,20,JointPQPlayer
3650,JointPQPlayer,130,305,435,19,28,JointPQPlayer
3651,JointPQPlayer,258,253,511,44,11,Player A
3652,JointPQPlayer,188,288,476,30,18,JointPQPlayer
3653,JointPQPlayer,184,264,448,23,25,JointPQPlayer
3654,JointPQPlayer,325,190,515,36,7,Player A
3655,JointPQPlayer,281,231,512,45,11,Player A
3656,JointPQPlayer,306,216,522,43,7,Player A
3657,JointPQPlayer,282,202,484,44,20,Player A
3658,JointPQPlayer,289,219,508,44,12,Player A
3659,JointPQPlayer,131,301,432,19,29,JointPQPlayer
3660,JointPQPlayer,301,191,492,34,14,Player A
3661,JointPQPlayer,232,267,499,38,13,JointPQPlayer
3662,JointPQPlayer,128,303,431,15,28,JointPQPlayer
3663,JointPQPlayer,278,238,516,46,10,Player A
3664,JointPQPlayer,271,256,527,45,6,Player A
3665,JointPQPlayer,263,233,496,35,13,Player A
3666,JointPQPlayer,268,223,491,36,15,Player A
3667,JointPQPlayer,281,231,512,48,12,Player A
3668,JointPQPlayer,167,272,439,20,27,JointPQPlayer
3669,JointPQPlayer,280,235,515,42,9,Player A
3670,JointPQPlayer,278,243,521,51,10,Player A
3671,JointPQPlayer,298,208,506,39,11,Player A
3672,JointPQPlayer,166,296,462,22,20,JointPQPlayer
3673,JointPQPlayer,159,284,443,21,26,JointPQPlayer
3674,JointPQPlayer,260,225,485,39,18,Player A
3675,JointPQPlayer,292,232,524,42,6,Player A
3676,JointPQPlayer,289,219,508,47,13,Player A
3677,JointPQPlayer,296,206,502,41,13,Player A
3678,JointPQPlayer,281,226,507,49,14,Player A
3679,JointPQPlayer,257,242,499,44,15,Player A
3680,JointPQPlayer,280,205,485,33,16,Player A
3681,JointPQPlayer,288,218,506,42,12,Player A
3682,JointPQPlayer,126,291,417,10,31,JointPQPlayer
3683,JointPQPlayer,261,246,507,40,11,Player A
3684,JointPQPlayer,275,230,505,44,13,Player A
3685,JointPQPlayer,303,203,506,36,10,Player A
3686,JointPQPlayer,126,311,437,18,27,JointPQPlayer
3687,JointPQPlayer,139,294,433,14,27,JointPQPlayer
3688,JointPQPlayer,136,276,412,14,34,JointPQPlayer
3689,JointPQPlayer,291,221,512,39,9,Player A
3690,JointPQPlayer,149,274,423,19,32,JointPQPlayer
3691,JointPQPlayer,275,245,520,44,8,Player A
3692,JointPQPlayer,149,299,448,23,25,JointPQPlayer
3693,JointPQPlayer,283,228,511,47,12,Player A
3694,JointPQPlayer,140,300,440,24,28,JointPQPlayer
3695,JointPQPlayer,261,246,507,43,12,Player A
3696,JointPQPlayer,297,197,494,39,15,Player A
3697,JointPQPlayer,269,229,498,40,14,Player A
3698,JointPQPlayer,271,216,487,38,17,Player A
3699,JointPQPlayer,275,230,505,41,12,Player A
3700,JointPQPlayer,125,290,415,11,32,JointPQPlayer
3701,JointPQPlayer,247,232,479,27,16,Player A
3702,JointPQPlayer,267,237,504,37,11,Player A
3703,JointPQPlayer,290,225,515,39,8,Player A
3704,JointPQPlayer,277,227,504,43,13,Player A
3705,JointPQPlayer,293,198,491,42,17,Player A
3706,JointPQPlayer,261,241,502,41,13,Player A
3707,JointPQPlayer,137,302,439,23,28,JointPQPlayer
3708,JointPQPlayer,145,280,425,15,30,JointPQPlayer
3709,JointPQPlayer,145,290,435,16,27,JointPQPlayer
3710,JointPQPlayer,137,312,449,21,24,JointPQPlayer
3711,JointPQPlayer,286,226,512,48,12,Player A
3712,JointPQPlayer,155,270,425,15,30,JointPQPlayer
3713,JointPQPlayer,142,297,439,20,27,JointPQPlayer
3714,JointPQPlayer,264,234,498,40,14,Player A
3715,JointPQPlayer,122,297,419,12,31,JointPQPlayer
3716,JointPQPlayer,254,234,488,39,17,Player A
3717,JointPQPlayer,133,303,436,20,28,JointPQPlayer
3718,JointPQPlayer,247,262,509,42,11,JointPQPlayer
3719,JointPQPlayer,129,289,418,14,32,JointPQPlayer
3720,JointPQPlayer,279,229,508,38,10,Player A
3721,JointPQPlayer,245,250,495,46,17,JointPQPlayer
3722,JointPQPlayer,223,263,486,25,13,JointPQPlayer
3723,JointPQPlayer,275,235,510,43,11,Player A
3724,JointPQPlayer,284,224,508,35,9,Player A
3725,JointPQPlayer,127,317,444,22,26,JointPQPlayer
3726,JointPQPlayer,296,191,487,35,16,Player A
3727,JointPQPlayer,257,227,484,38,18,Player A
3728,JointPQPlayer,304,214,518,48,10,Player A
3729,JointPQPlayer,247,257,504,34,10,JointPQPlayer
3730,JointPQPlayer,269,219,488,30,14,Player A
3731,JointPQPlayer,248,258,506,42,12,JointPQPlayer
3732,JointPQPlayer,289,209,498,37,13,Player A
3733,JointPQPlayer,261,226,487,26,13,Player A
3734,JointPQPlayer,279,209,488,39,17,Player A
3735,JointPQPlayer,142,262,404,9,35,JointPQPlayer
3736,JointPQPlayer,197,282,479,36,19,JointPQPlayer
3737,JointPQPlayer,245,255,500,45,15,JointPQPlayer
3738,JointPQPlayer,291,226,517,47,10,Player A
3739,JointPQPlayer,295,230,525,43,6,Player A
3740,JointPQPlayer,215,265,480,31,17,JointPQPlayer
3741,JointPQPlayer,163,273,436,17,27,JointPQPlayer
3742,JointPQPlayer,289,229,518,42,8,Player A
3743,JointPQPlayer,301,206,507,37,10,Player A
3744,JointPQPlayer,284,214,498,43,15,Player A
3745,JointPQPlayer,289,214,503,45,14,Player A
3746,JointPQPlayer,152,317,469,26,19,JointPQPlayer
3747,JointPQPlayer,259,244,503,36,11,Player A
3748,JointPQPlayer,130,310,440,18,26,JointPQPlayer
3749,JointPQPlayer,268,223,491,36,15,Player A
3750,JointPQPlayer,254,249,503,39,12,Player A
3751,JointPQPlayer,133,283,416,18,34,JointPQPlayer
3752,JointPQPlayer,252,242,494,45,17,Player A
3753,JointPQPlayer,281,226,507,40,11,Player A
3754,JointPQPlayer,268,248,516,49,11,Player A
3755,JointPQPlayer,275,240,515,39,8,Player A
3756,JointPQPlayer,275,235,510,46,12,Player A
3757,JointPQPlayer,273,233,506,42,12,Player A
0,revTitforTat,191,261,452,24,24,revTitforTat
1,revTitforTat,192,267,459,22,21,revTitforTat
2,revTitforTat,172,267,439,29,30,revTitforTat
3,revTitforTat,149,304,453,25,24,revTitforTat
4,revTitforTat,194,259,453,22,23,revTitforTat
5,revTitforTat,164,289,453,25,24,revTitforTat
6,revTitforTat,159,299,458,21,21,revTitforTat
7,revTitforTat,191,271,462,19,19,revTitforTat
8,revTitforTat,168,278,446,27,27,revTitforTat
9,revTitforTat,155,305,460,20,20,revTitforTat
10,revTitforTat,201,251,452,24,24,revTitforTat
11,revTitforTat,143,303,446,27,27,revTitforTat
12,revTitforTat,165,285,450,25,25,revTitforTat
13,revTitforTat,138,313,451,23,24,revTitforTat
14,revTitforTat,214,234,448,26,26,revTitforTat
15,revTitforTat,189,269,458,21,21,revTitforTat
16,revTitforTat,148,303,451,26,25,revTitforTat
17,revTitforTat,171,281,452,24,24,revTitforTat
18,revTitforTat,183,268,451,23,24,revTitforTat
19,revTitforTat,170,285,455,24,23,revTitforTat
20,revTitforTat,154,304,458,21,21,revTitforTat
21,revTitforTat,194,264,458,21,21,revTitforTat
22,revTitforTat,164,289,453,22,23,revTitforTat
23,revTitforTat,197,247,444,28,28,revTitforTat
24,revTitforTat,184,269,453,25,24,revTitforTat
25,revTitforTat,174,279,453,22,23,revTitforTat
26,revTitforTat,186,261,447,28,27,revTitforTat
27,revTitforTat,168,278,446,27,27,revTitforTat
28,revTitforTat,199,244,443,27,28,revTitforTat
29,revTitforTat,186,271,457,23,22,revTitforTat
30,revTitforTat,199,249,448,26,26,revTitforTat
31,revTitforTat,198,253,451,23,24,revTitforTat
32,revTitforTat,147,312,459,22,21,revTitforTat
33,revTitforTat,195,255,450,25,25,revTitforTat
34,revTitforTat,160,295,455,21,22,revTitforTat
35,revTitforTat,175,275,450,25,25,revTitforTat
36,revTitforTat,196,266,462,19,19,revTitforTat
37,revTitforTat,181,276,457,23,22,revTitforTat
38,revTitforTat,178,268,446,27,27,revTitforTat
39,revTitforTat,143,308,451,23,24,revTitforTat
40,revTitforTat,151,301,452,24,24,revTitforTat
41,revTitforTat,175,280,455,24,23,revTitforTat
42,revTitforTat,154,294,448,26,26,revTitforTat
43,revTitforTat,209,239,448,26,26,revTitforTat
44,revTitforTat,228,228,456,22,22,Tie
45,revTitforTat,165,275,440,30,30,revTitforTat
46,revTitforTat,172,282,454,23,23,revTitforTat
47,revTitforTat,193,263,456,22,22,revTitforTat
48,revTitforTat,165,280,445,26,27,revTitforTat
49,revTitforTat,208,243,451,26,25,revTitforTat
50,revTitforTat,121,341,462,19,19,revTitforTat
51,revTitforTat,141,321,462,19,19,revTitforTat
52,revTitforTat,167,277,444,28,28,revTitforTat
53,revTitforTat,188,263,451,23,24,revTitforTat
54,revTitforTat,189,264,453,25,24,revTitforTat
55,revTitforTat,167,287,454,23,23,revTitforTat
56,revTitforTat,186,266,452,24,24,revTitforTat
57,revTitforTat,210,235,445,26,27,revTitforTat
58,revTitforTat,185,270,455,24,23,revTitforTat
59,revTitforTat,153,303,456,22,22,revTitforTat
60,revTitforTat,168,288,456,22,22,revTitforTat
61,revTitforTat,140,305,445,26,27,revTitforTat
62,revTitforTat,170,280,450,25,25,revTitforTat
63,revTitforTat,169,289,458,21,21,revTitforTat
64,revTitforTat,151,306,457,23,22,revTitforTat
65,revTitforTat,200,245,445,26,27,revTitforTat
66,revTitforTat,133,318,451,26,25,revTitforTat
67,revTitforTat,167,282,449,24,25,revTitforTat
68,revTitforTat,185,270,455,24,23,revTitforTat
69,revTitforTat,186,266,452,24,24,revTitforTat
70,revTitforTat,203,243,446,27,27,revTitforTat
71,revTitforTat,191,256,447,25,26,revTitforTat
72,revTitforTat,206,246,452,24,24,revTitforTat
73,revTitforTat,198,253,451,26,25,revTitforTat
74,revTitforTat,214,229,443,27,28,revTitforTat
75,revTitforTat,185,265,450,25,25,revTitforTat
76,revTitforTat,190,265,455,24,23,revTitforTat
77,revTitforTat,184,269,453,22,23,revTitforTat
78,revTitforTat,175,280,455,24,23,revTitforTat
79,revTitforTat,170,280,450,25,25,revTitforTat
80,revTitforTat,201,251,452,24,24,revTitforTat
81,revTitforTat,160,300,460,20,20,revTitforTat
82,revTitforTat,180,270,450,25,25,revTitforTat
83,revTitforTat,163,293,456,22,22,revTitforTat
84,revTitforTat,144,304,448,26,26,revTitforTat
85,revTitforTat,206,256,462,19,19,revTitforTat
86,revTitforTat,180,270,450,25,25,revTitforTat
87,revTitforTat,196,256,452,24,24,revTitforTat
88,revTitforTat,170,285,455,21,22,revTitforTat
89,revTitforTat,218,233,451,26,25,revTitforTat
90,revTitforTat,192,257,449,24,25,revTitforTat
91,revTitforTat,165,285,450,25,25,revTitforTat
92,revTitforTat,194,259,453,25,24,revTitforTat
93,revTitforTat,213,238,451,23,24,revTitforTat
94,revTitforTat,194,254,448,26,26,revTitforTat
95,revTitforTat,170,285,455,24,23,revTitforTat
96,revTitforTat,178,273,451,23,24,revTitforTat
97,revTitforTat,193,263,456,22,22,revTitforTat
98,revTitforTat,184,274,458,21,21,revTitforTat
99,revTitforTat,166,291,457,23,22,revTitforTat
100,revTitforTat,204,254,458,21,21,revTitforTat
101,revTitforTat,175,275,450,25,25,revTitforTat
102,revTitforTat,211,241,452,24,24,revTitforTat
103,revTitforTat,191,261,452,24,24,revTitforTat
104,revTitforTat,236,216,452,24,24,Player A
105,revTitforTat,156,301,457,20,21,revTitforTat
106,revTitforTat,191,261,452,24,24,revTitforTat
107,revTitforTat,198,248,446,27,27,revTitforTat
108,revTitforTat,152,297,449,27,26,revTitforTat
109,revTitforTat,176,276,452,24,24,revTitforTat
110,revTitforTat,180,260,440,30,30,revTitforTat
111,revTitforTat,116,346,462,19,19,revTitforTat
112,revTitforTat,193,258,451,23,24,revTitforTat
113,revTitforTat,155,290,445,29,28,revTitforTat
114,revTitforTat,195,260,455,21,22,revTitforTat
115,revTitforTat,137,322,459,22,21,revTitforTat
116,revTitforTat,164,279,443,27,28,revTitforTat
117,revTitforTat,184,269,453,25,24,revTitforTat
118,revTitforTat,211,241,452,24,24,revTitforTat
119,revTitforTat,182,262,444,28,28,revTitforTat
120,revTitforTat,225,220,445,26,27,Player A
121,revTitforTat,177,272,449,27,26,revTitforTat
122,revTitforTat,199,249,448,26,26,revTitforTat
123,revTitforTat,205,245,450,25,25,revTitforTat
124,revTitforTat,166,291,457,20,21,revTitforTat
125,revTitforTat,158,303,461,21,20,revTitforTat
126,revTitforTat,220,230,450,25,25,revTitforTat
127,revTitforTat,190,260,450,25,25,revTitforTat
128,revTitforTat,202,252,454,23,23,revTitforTat
129,revTitforTat,174,279,453,22,23,revTitforTat
130,revTitforTat,159,299,458,21,21,revTitforTat
131,revTitforTat,214,239,453,25,24,revTitforTat
132,revTitforTat,178,273,451,23,24,revTitforTat
133,revTitforTat,192,257,449,27,26,revTitforTat
134,revTitforTat,163,298,461,18,19,revTitforTat
135,revTitforTat,188,253,441,31,30,revTitforTat
136,revTitforTat,238,213,451,23,24,Player A
137,revTitforTat,212,242,454,23,23,revTitforTat
138,revTitforTat,194,259,453,25,24,revTitforTat
139,revTitforTat,148,303,451,23,24,revTitforTat
140,revTitforTat,174,279,453,25,24,revTitforTat
141,revTitforTat,154,304,458,21,21,revTitforTat
142,revTitforTat,228,228,456,22,22,Tie
143,revTitforTat,180,275,455,21,22,revTitforTat
144,revTitforTat,222,227,449,27,26,revTitforTat
145,revTitforTat,181,271,452,24,24,revTitforTat
146,revTitforTat,170,280,450,25,25,revTitforTat
147,revTitforTat,186,261,447,25,26,revTitforTat
148,revTitforTat,204,249,453,25,24,revTitforTat
149,revTitforTat,212,227,439,29,30,revTitforTat
150,revTitforTat,172,277,449,27,26,revTitforTat
151,revTitforTat,188,253,441,28,29,revTitforTat
152,revTitforTat,165,280,445,29,28,revTitforTat
153,revTitforTat,181,271,452,24,24,revTitforTat
154,revTitforTat,143,313,456,22,22,revTitforTat
155,revTitforTat,180,265,445,26,27,revTitforTat
156,revTitforTat,172,287,459,22,21,revTitforTat
157,revTitforTat,198,253,451,23,24,revTitforTat
158,revTitforTat,185,275,460,20,20,revTitforTat
159,revTitforTat,181,271,452,24,24,revTitforTat
160,revTitforTat,198,258,456,22,22,revTitforTat
161,revTitforTat,149,304,453,25,24,revTitforTat
162,revTitforTat,187,262,449,24,25,revTitforTat
163,revTitforTat,159,299,458,21,21,revTitforTat
164,revTitforTat,175,275,450,25,25,revTitforTat
165,revTitforTat,171,286,457,23,22,revTitforTat
166,revTitforTat,207,242,449,24,25,revTitforTat
167,revTitforTat,158,298,456,22,22,revTitforTat
168,revTitforTat,210,250,460,20,20,revTitforTat
169,revTitforTat,183,268,451,26,25,revTitforTat
170,revTitforTat,172,277,449,24,25,revTitforTat
171,revTitforTat,212,242,454,23,23,revTitforTat
172,revTitforTat,164,284,448,26,26,revTitforTat
173,revTitforTat,181,286,467,18,17,revTitforTat
174,revTitforTat,140,310,450,25,25,revTitforTat
175,revTitforTat,217,232,449,24,25,revTitforTat
176,revTitforTat,156,301,457,23,22,revTitforTat
177,revTitforTat,153,293,446,27,27,revTitforTat
178,revTitforTat,142,312,454,23,23,revTitforTat
179,revTitforTat,176,266,442,29,29,revTitforTat
180,revTitforTat,179,264,443,27,28,revTitforTat
181,revTitforTat,182,277,459,22,21,revTitforTat
182,revTitforTat,179,284,463,17,18,revTitforTat
183,revTitforTat,192,257,449,27,26,revTitforTat
184,revTitforTat,156,291,447,25,26,revTitforTat
185,revTitforTat,176,276,452,24,24,revTitforTat
0,PatternPlayer,201,276,477,34,19,PatternPlayer
1,PatternPlayer,217,242,459,28,23,PatternPlayer
2,PatternPlayer,218,233,451,29,26,PatternPlayer
3,PatternPlayer,200,280,480,34,18,PatternPlayer
4,PatternPlayer,200,300,500,30,10,PatternPlayer
5,PatternPlayer,211,251,462,31,23,PatternPlayer
6,PatternPlayer,208,263,471,31,20,PatternPlayer
7,PatternPlayer,202,272,474,34,20,PatternPlayer
8,PatternPlayer,209,254,463,32,23,PatternPlayer
9,PatternPlayer,196,276,472,38,22,PatternPlayer
10,PatternPlayer,215,240,455,30,25,PatternPlayer
11,PatternPlayer,213,253,466,29,21,PatternPlayer
12,PatternPlayer,203,268,471,34,21,PatternPlayer
13,PatternPlayer,213,258,471,28,19,PatternPlayer
14,PatternPlayer,219,244,463,26,21,PatternPlayer
15,PatternPlayer,201,281,482,33,17,PatternPlayer
16,PatternPlayer,229,219,448,23,25,Player A
17,PatternPlayer,211,251,462,31,23,PatternPlayer
18,PatternPlayer,200,275,475,35,20,PatternPlayer
19,PatternPlayer,201,271,472,35,21,PatternPlayer
20,PatternPlayer,220,230,450,28,26,PatternPlayer
21,PatternPlayer,213,258,471,28,19,PatternPlayer
22,PatternPlayer,206,271,477,31,18,PatternPlayer
23,PatternPlayer,209,259,468,31,21,PatternPlayer
24,PatternPlayer,222,237,459,25,22,PatternPlayer
25,PatternPlayer,210,250,460,32,24,PatternPlayer
26,PatternPlayer,207,267,474,31,19,PatternPlayer
27,PatternPlayer,198,273,471,37,22,PatternPlayer
28,PatternPlayer,216,241,457,29,24,PatternPlayer
29,PatternPlayer,209,274,483,28,15,PatternPlayer
30,PatternPlayer,220,240,460,26,22,PatternPlayer
31,PatternPlayer,213,238,451,32,27,PatternPlayer
32,PatternPlayer,201,271,472,35,21,PatternPlayer
33,PatternPlayer,219,244,463,26,21,PatternPlayer
34,PatternPlayer,198,288,486,34,16,PatternPlayer
35,PatternPlayer,218,263,481,23,14,PatternPlayer
36,PatternPlayer,204,264,468,34,22,PatternPlayer
37,PatternPlayer,202,287,489,31,14,PatternPlayer
38,PatternPlayer,209,259,468,31,21,PatternPlayer
39,PatternPlayer,202,267,469,35,22,PatternPlayer
40,PatternPlayer,201,276,477,34,19,PatternPlayer
41,PatternPlayer,213,258,471,28,19,PatternPlayer
42,PatternPlayer,210,255,465,31,22,PatternPlayer
43,PatternPlayer,214,239,453,31,26,PatternPlayer
44,PatternPlayer,202,277,479,33,18,PatternPlayer
45,PatternPlayer,224,229,453,25,24,PatternPlayer
46,PatternPlayer,209,269,478,29,17,PatternPlayer
47,PatternPlayer,218,243,461,27,22,PatternPlayer
48,PatternPlayer,208,268,476,30,18,PatternPlayer
49,PatternPlayer,212,252,464,30,22,PatternPlayer
50,PatternPlayer,212,252,464,30,22,PatternPlayer
51,PatternPlayer,207,257,464,33,23,PatternPlayer
52,PatternPlayer,220,245,465,25,20,PatternPlayer
53,PatternPlayer,217,237,454,29,25,PatternPlayer
54,PatternPlayer,225,230,455,24,23,PatternPlayer
55,PatternPlayer,217,237,454,29,25,PatternPlayer
56,PatternPlayer,215,265,480,25,15,PatternPlayer
57,PatternPlayer,202,272,474,34,20,PatternPlayer
58,PatternPlayer,207,267,474,31,19,PatternPlayer
59,PatternPlayer,217,257,474,25,17,PatternPlayer
60,PatternPlayer,211,251,462,31,23,PatternPlayer
61,PatternPlayer,219,234,453,28,25,PatternPlayer
62,PatternPlayer,210,265,475,29,18,PatternPlayer
63,PatternPlayer,205,250,455,36,27,PatternPlayer
64,PatternPlayer,201,271,472,35,21,PatternPlayer
65,PatternPlayer,225,225,450,25,25,Tie
66,PatternPlayer,218,258,476,24,16,PatternPlayer
67,PatternPlayer,206,271,477,31,18,PatternPlayer
68,PatternPlayer,216,256,472,26,18,PatternPlayer
69,PatternPlayer,220,245,465,25,20,PatternPlayer
70,PatternPlayer,218,243,461,27,22,PatternPlayer
71,PatternPlayer,218,253,471,25,18,PatternPlayer
72,PatternPlayer,212,272,484,26,14,PatternPlayer
73,PatternPlayer,214,259,473,27,18,PatternPlayer
74,PatternPlayer,208,263,471,31,20,PatternPlayer
75,PatternPlayer,206,266,472,32,20,PatternPlayer
76,PatternPlayer,192,312,504,34,10,PatternPlayer
77,PatternPlayer,202,267,469,35,22,PatternPlayer
78,PatternPlayer,224,229,453,25,24,PatternPlayer
79,PatternPlayer,226,226,452,24,24,Tie
80,PatternPlayer,212,252,464,30,22,PatternPlayer
81,PatternPlayer,226,236,462,22,20,PatternPlayer
82,PatternPlayer,213,273,486,25,13,PatternPlayer
83,PatternPlayer,207,262,469,32,21,PatternPlayer
84,PatternPlayer,208,258,466,32,22,PatternPlayer
85,PatternPlayer,198,288,486,34,16,PatternPlayer
86,PatternPlayer,203,273,476,33,19,PatternPlayer
87,PatternPlayer,218,243,461,27,22,PatternPlayer
88,PatternPlayer,204,264,468,34,22,PatternPlayer
89,PatternPlayer,214,254,468,28,20,PatternPlayer
90,PatternPlayer,220,245,465,25,20,PatternPlayer
91,PatternPlayer,212,242,454,32,26,PatternPlayer
92,PatternPlayer,208,268,476,30,18,PatternPlayer
93,PatternPlayer,227,222,449,24,25,Player A
94,PatternPlayer,211,256,467,30,21,PatternPlayer
95,PatternPlayer,230,220,450,22,24,Player A
96,PatternPlayer,213,263,476,27,17,PatternPlayer
97,PatternPlayer,215,245,460,29,23,PatternPlayer
98,PatternPlayer,209,259,468,31,21,PatternPlayer
99,PatternPlayer,209,264,473,30,19,PatternPlayer
100,PatternPlayer,208,253,461,33,24,PatternPlayer
101,PatternPlayer,206,271,477,31,18,PatternPlayer
102,PatternPlayer,213,263,476,27,17,PatternPlayer
103,PatternPlayer,222,242,464,24,20,PatternPlayer
104,PatternPlayer,210,265,475,29,18,PatternPlayer
105,PatternPlayer,210,260,470,30,20,PatternPlayer
106,PatternPlayer,200,280,480,34,18,PatternPlayer
107,PatternPlayer,231,211,442,23,27,Player A
108,PatternPlayer,209,269,478,29,17,PatternPlayer
109,PatternPlayer,207,272,479,30,17,PatternPlayer
110,PatternPlayer,214,259,473,27,18,PatternPlayer
111,PatternPlayer,204,274,478,32,18,PatternPlayer
112,PatternPlayer,216,246,462,28,22,PatternPlayer
113,PatternPlayer,222,237,459,25,22,PatternPlayer
114,PatternPlayer,209,259,468,31,21,PatternPlayer
115,PatternPlayer,206,266,472,32,20,PatternPlayer
116,PatternPlayer,214,249,463,29,22,PatternPlayer
117,PatternPlayer,206,276,482,30,16,PatternPlayer
118,PatternPlayer,221,246,467,24,19,PatternPlayer
119,PatternPlayer,211,266,477,28,17,PatternPlayer
120,PatternPlayer,211,256,467,30,21,PatternPlayer
121,PatternPlayer,213,243,456,31,25,PatternPlayer
122,PatternPlayer,233,213,446,21,25,Player A
123,PatternPlayer,221,231,452,27,25,PatternPlayer
124,PatternPlayer,212,247,459,31,24,PatternPlayer
125,PatternPlayer,207,262,469,32,21,PatternPlayer
126,PatternPlayer,215,240,455,30,25,PatternPlayer
127,PatternPlayer,223,223,446,27,27,Tie
128,PatternPlayer,212,242,454,32,26,PatternPlayer
129,PatternPlayer,204,279,483,31,16,PatternPlayer
130,PatternPlayer,224,244,468,22,18,PatternPlayer
131,PatternPlayer,205,265,470,33,21,PatternPlayer
132,PatternPlayer,221,236,457,26,23,PatternPlayer
133,PatternPlayer,221,236,457,26,23,PatternPlayer
134,PatternPlayer,218,238,456,28,24,PatternPlayer
135,PatternPlayer,204,264,468,34,22,PatternPlayer
136,PatternPlayer,204,274,478,32,18,PatternPlayer
137,PatternPlayer,207,272,479,30,17,PatternPlayer
138,PatternPlayer,197,287,484,35,17,PatternPlayer
139,PatternPlayer,218,258,476,24,16,PatternPlayer
140,PatternPlayer,224,234,458,24,22,PatternPlayer
141,PatternPlayer,207,252,459,34,25,PatternPlayer
142,PatternPlayer,209,264,473,30,19,PatternPlayer
143,PatternPlayer,208,263,471,31,20,PatternPlayer
144,PatternPlayer,229,224,453,22,23,Player A
145,PatternPlayer,218,243,461,27,22,PatternPlayer
146,PatternPlayer,218,258,476,24,16,PatternPlayer
147,PatternPlayer,212,242,454,32,26,PatternPlayer
148,PatternPlayer,216,231,447,31,28,PatternPlayer
149,PatternPlayer,200,275,475,35,20,PatternPlayer
150,PatternPlayer,213,248,461,30,23,PatternPlayer
151,PatternPlayer,195,290,485,36,17,PatternPlayer
152,PatternPlayer,210,255,465,31,22,PatternPlayer
153,PatternPlayer,218,253,471,25,18,PatternPlayer
154,PatternPlayer,210,265,475,29,18,PatternPlayer
155,PatternPlayer,218,233,451,29,26,PatternPlayer
156,PatternPlayer,199,294,493,32,13,PatternPlayer
157,PatternPlayer,218,258,476,24,16,PatternPlayer
158,PatternPlayer,195,290,485,36,17,PatternPlayer
159,PatternPlayer,209,264,473,30,19,PatternPlayer
160,PatternPlayer,224,229,453,25,24,PatternPlayer
161,PatternPlayer,222,237,459,25,22,PatternPlayer
162,PatternPlayer,213,228,441,34,31,PatternPlayer
163,PatternPlayer,208,258,466,32,22,PatternPlayer
164,PatternPlayer,211,266,477,28,17,PatternPlayer
165,PatternPlayer,219,219,438,31,31,Tie
166,PatternPlayer,204,254,458,36,26,PatternPlayer
167,PatternPlayer,203,273,476,33,19,PatternPlayer
168,PatternPlayer,196,301,497,33,12,PatternPlayer
169,PatternPlayer,218,248,466,26,20,PatternPlayer
170,PatternPlayer,224,239,463,23,20,PatternPlayer
171,PatternPlayer,213,278,491,24,11,PatternPlayer
172,PatternPlayer,204,274,478,32,18,PatternPlayer
173,PatternPlayer,213,268,481,26,15,PatternPlayer
174,PatternPlayer,209,259,468,31,21,PatternPlayer
175,PatternPlayer,209,259,468,31,21,PatternPlayer
176,PatternPlayer,205,260,465,34,23,PatternPlayer
177,PatternPlayer,209,269,478,29,17,PatternPlayer
178,PatternPlayer,211,251,462,31,23,PatternPlayer
179,PatternPlayer,214,254,468,28,20,PatternPlayer
180,PatternPlayer,201,276,477,34,19,PatternPlayer
181,PatternPlayer,213,243,456,31,25,PatternPlayer
182,PatternPlayer,213,248,461,30,23,PatternPlayer
183,PatternPlayer,207,257,464,33,23,PatternPlayer
184,PatternPlayer,212,252,464,30,22,PatternPlayer
185,PatternPlayer,223,228,451,26,25,PatternPlayer
186,PatternPlayer,209,264,473,30,19,PatternPlayer
187,PatternPlayer,213,248,461,30,23,PatternPlayer
188,PatternPlayer,212,262,474,28,18,PatternPlayer
189,PatternPlayer,204,279,483,31,16,PatternPlayer
190,PatternPlayer,208,268,476,30,18,PatternPlayer
191,PatternPlayer,212,252,464,30,22,PatternPlayer
192,PatternPlayer,212,252,464,30,22,PatternPlayer
193,PatternPlayer,214,264,478,26,16,PatternPlayer
194,PatternPlayer,210,260,470,30,20,PatternPlayer
195,PatternPlayer,214,249,463,29,22,PatternPlayer
196,PatternPlayer,211,261,472,29,19,PatternPlayer
197,PatternPlayer,202,272,474,34,20,PatternPlayer
198,PatternPlayer,222,252,474,22,16,PatternPlayer
199,PatternPlayer,215,255,470,27,19,PatternPlayer
200,PatternPlayer,221,251,472,23,17,PatternPlayer
201,PatternPlayer,209,259,468,31,21,PatternPlayer
202,PatternPlayer,209,249,458,33,25,PatternPlayer
203,PatternPlayer,218,258,476,24,16,PatternPlayer
204,PatternPlayer,215,235,450,31,27,PatternPlayer
205,PatternPlayer,204,279,483,31,16,PatternPlayer
206,PatternPlayer,200,285,485,33,16,PatternPlayer
207,PatternPlayer,208,263,471,31,20,PatternPlayer
208,PatternPlayer,223,213,436,29,31,Player A
209,PatternPlayer,206,256,462,34,24,PatternPlayer
210,PatternPlayer,203,278,481,32,17,PatternPlayer
211,PatternPlayer,220,260,480,22,14,PatternPlayer
212,PatternPlayer,214,254,468,28,20,PatternPlayer
213,PatternPlayer,214,244,458,30,24,PatternPlayer
214,PatternPlayer,213,258,471,28,19,PatternPlayer
215,PatternPlayer,213,248,461,30,23,PatternPlayer
216,PatternPlayer,211,251,462,31,23,PatternPlayer
217,PatternPlayer,210,255,465,31,22,PatternPlayer
218,PatternPlayer,217,252,469,26,19,PatternPlayer
219,PatternPlayer,226,221,447,25,26,Player A
220,PatternPlayer,233,218,451,20,23,Player A
221,PatternPlayer,206,266,472,32,20,PatternPlayer
222,PatternPlayer,197,292,489,34,15,PatternPlayer
223,PatternPlayer,208,268,476,30,18,PatternPlayer
224,PatternPlayer,206,266,472,32,20,PatternPlayer
225,PatternPlayer,224,229,453,25,24,PatternPlayer
226,PatternPlayer,194,294,488,36,16,PatternPlayer
227,PatternPlayer,216,241,457,29,24,PatternPlayer
228,PatternPlayer,216,251,467,27,20,PatternPlayer
229,PatternPlayer,204,249,453,37,28,PatternPlayer
230,PatternPlayer,231,211,442,23,27,Player A
231,PatternPlayer,208,273,481,29,16,PatternPlayer
232,PatternPlayer,222,237,459,25,22,PatternPlayer
233,PatternPlayer,222,232,454,26,24,PatternPlayer
234,PatternPlayer,211,256,467,30,21,PatternPlayer
235,PatternPlayer,198,283,481,35,18,PatternPlayer
236,PatternPlayer,206,256,462,34,24,PatternPlayer
237,PatternPlayer,207,252,459,34,25,PatternPlayer
238,PatternPlayer,203,278,481,32,17,PatternPlayer
239,PatternPlayer,207,277,484,29,15,PatternPlayer
240,PatternPlayer,200,280,480,34,18,PatternPlayer
241,PatternPlayer,216,251,467,27,20,PatternPlayer
242,PatternPlayer,217,237,454,29,25,PatternPlayer
243,PatternPlayer,218,248,466,26,20,PatternPlayer
244,PatternPlayer,206,281,487,29,14,PatternPlayer
245,PatternPlayer,207,272,479,30,17,PatternPlayer
246,PatternPlayer,221,231,452,27,25,PatternPlayer
247,PatternPlayer,209,279,488,27,13,PatternPlayer
248,PatternPlayer,201,271,472,35,21,PatternPlayer
249,PatternPlayer,207,257,464,33,23,PatternPlayer
250,PatternPlayer,216,241,457,29,24,PatternPlayer
251,PatternPlayer,199,289,488,33,15,PatternPlayer
252,PatternPlayer,211,251,462,31,23,PatternPlayer
253,PatternPlayer,208,268,476,30,18,PatternPlayer
254,PatternPlayer,208,268,476,30,18,PatternPlayer
255,PatternPlayer,209,259,468,31,21,PatternPlayer
256,PatternPlayer,221,246,467,24,19,PatternPlayer
257,PatternPlayer,206,266,472,32,20,PatternPlayer
258,PatternPlayer,206,266,472,32,20,PatternPlayer
259,PatternPlayer,215,250,465,28,21,PatternPlayer
260,PatternPlayer,215,225,440,33,31,PatternPlayer
261,PatternPlayer,212,252,464,30,22,PatternPlayer
262,PatternPlayer,216,241,457,29,24,PatternPlayer
263,PatternPlayer,197,282,479,36,19,PatternPlayer
264,PatternPlayer,212,252,464,30,22,PatternPlayer
265,PatternPlayer,191,306,497,36,13,PatternPlayer
266,PatternPlayer,199,274,473,36,21,PatternPlayer
267,PatternPlayer,198,283,481,35,18,PatternPlayer
268,PatternPlayer,227,222,449,24,25,Player A
269,PatternPlayer,213,248,461,30,23,PatternPlayer
270,PatternPlayer,206,276,482,30,16,PatternPlayer
271,PatternPlayer,203,268,471,34,21,PatternPlayer
272,PatternPlayer,203,273,476,33,19,PatternPlayer
273,PatternPlayer,219,244,463,26,21,PatternPlayer
274,PatternPlayer,201,281,482,33,17,PatternPlayer
275,PatternPlayer,211,261,472,29,19,PatternPlayer
276,PatternPlayer,203,273,476,33,19,PatternPlayer
277,PatternPlayer,225,225,450,25,25,Tie
278,PatternPlayer,216,241,457,29,24,PatternPlayer
279,PatternPlayer,234,204,438,22,28,Player A
280,PatternPlayer,209,259,468,31,21,PatternPlayer
281,PatternPlayer,213,248,461,30,23,PatternPlayer
282,PatternPlayer,211,256,467,30,21,PatternPlayer
283,PatternPlayer,216,236,452,30,26,PatternPlayer
284,PatternPlayer,221,241,462,25,21,PatternPlayer
285,PatternPlayer,208,258,466,32,22,PatternPlayer
286,PatternPlayer,211,256,467,30,21,PatternPlayer
287,PatternPlayer,206,271,477,31,18,PatternPlayer
288,PatternPlayer,223,238,461,24,21,PatternPlayer
289,PatternPlayer,213,258,471,28,19,PatternPlayer
290,PatternPlayer,218,248,466,26,20,PatternPlayer
291,PatternPlayer,214,249,463,29,22,PatternPlayer
292,PatternPlayer,218,263,481,23,14,PatternPlayer
293,PatternPlayer,222,227,449,27,26,PatternPlayer
294,PatternPlayer,204,269,473,33,20,PatternPlayer
295,PatternPlayer,218,243,461,27,22,PatternPlayer
296,PatternPlayer,219,234,453,28,25,PatternPlayer
297,PatternPlayer,225,225,450,25,25,Tie
298,PatternPlayer,203,268,471,34,21,PatternPlayer
299,PatternPlayer,224,239,463,23,20,PatternPlayer
300,PatternPlayer,217,247,464,27,21,PatternPlayer
301,PatternPlayer,217,252,469,26,19,PatternPlayer
302,PatternPlayer,228,233,461,21,20,PatternPlayer
303,PatternPlayer,222,222,444,28,28,Tie
304,PatternPlayer,208,258,466,32,22,PatternPlayer
305,PatternPlayer,202,287,489,31,14,PatternPlayer
306,PatternPlayer,201,281,482,33,17,PatternPlayer
307,PatternPlayer,220,235,455,27,24,PatternPlayer
308,PatternPlayer,212,257,469,29,20,PatternPlayer
309,PatternPlayer,205,275,480,31,17,PatternPlayer
310,PatternPlayer,222,237,459,25,22,PatternPlayer
311,PatternPlayer,216,256,472,26,18,PatternPlayer
312,PatternPlayer,207,282,489,28,13,PatternPlayer
313,PatternPlayer,208,253,461,33,24,PatternPlayer
314,PatternPlayer,214,244,458,30,24,PatternPlayer
315,PatternPlayer,202,272,474,34,20,PatternPlayer
316,PatternPlayer,214,264,478,26,16,PatternPlayer
317,PatternPlayer,217,242,459,28,23,PatternPlayer
318,PatternPlayer,196,286,482,36,18,PatternPlayer
319,PatternPlayer,196,281,477,37,20,PatternPlayer
320,PatternPlayer,207,257,464,33,23,PatternPlayer
321,PatternPlayer,226,226,452,24,24,Tie
322,PatternPlayer,223,238,461,24,21,PatternPlayer
323,PatternPlayer,225,230,455,24,23,PatternPlayer
324,PatternPlayer,217,247,464,27,21,PatternPlayer
325,PatternPlayer,221,241,462,25,21,PatternPlayer
326,PatternPlayer,230,215,445,23,26,Player A
327,PatternPlayer,215,245,460,29,23,PatternPlayer
328,PatternPlayer,216,241,457,29,24,PatternPlayer
329,PatternPlayer,213,243,456,31,25,PatternPlayer
330,PatternPlayer,224,229,453,25,24,PatternPlayer
331,PatternPlayer,210,250,460,32,24,PatternPlayer
332,PatternPlayer,214,254,468,28,20,PatternPlayer
333,PatternPlayer,197,292,489,34,15,PatternPlayer
334,PatternPlayer,213,253,466,29,21,PatternPlayer
335,PatternPlayer,208,263,471,31,20,PatternPlayer
336,PatternPlayer,219,229,448,29,27,PatternPlayer
337,PatternPlayer,225,240,465,22,19,PatternPlayer
338,PatternPlayer,216,246,462,28,22,PatternPlayer
339,PatternPlayer,208,258,466,32,22,PatternPlayer
340,PatternPlayer,214,244,458,30,24,PatternPlayer
341,PatternPlayer,212,252,464,30,22,PatternPlayer
342,PatternPlayer,217,232,449,30,27,PatternPlayer
343,PatternPlayer,195,300,495,34,13,PatternPlayer
344,PatternPlayer,212,262,474,28,18,PatternPlayer
345,PatternPlayer,204,259,463,35,24,PatternPlayer
346,PatternPlayer,193,298,491,36,15,PatternPlayer
347,PatternPlayer,208,263,471,31,20,PatternPlayer
348,PatternPlayer,209,274,483,28,15,PatternPlayer
349,PatternPlayer,220,245,465,25,20,PatternPlayer
350,PatternPlayer,220,230,450,28,26,PatternPlayer
351,PatternPlayer,216,241,457,29,24,PatternPlayer
352,PatternPlayer,211,256,467,30,21,PatternPlayer
353,PatternPlayer,214,244,458,30,24,PatternPlayer
354,PatternPlayer,215,250,465,28,21,PatternPlayer
355,PatternPlayer,194,294,488,36,16,PatternPlayer
356,PatternPlayer,213,253,466,29,21,PatternPlayer
357,PatternPlayer,209,259,468,31,21,PatternPlayer
358,PatternPlayer,202,272,474,34,20,PatternPlayer
359,PatternPlayer,216,251,467,27,20,PatternPlayer
360,PatternPlayer,217,242,459,28,23,PatternPlayer
361,PatternPlayer,216,251,467,27,20,PatternPlayer
362,PatternPlayer,213,248,461,30,23,PatternPlayer
363,PatternPlayer,215,250,465,28,21,PatternPlayer
364,PatternPlayer,214,254,468,28,20,PatternPlayer
365,PatternPlayer,219,239,458,27,23,PatternPlayer
366,PatternPlayer,218,243,461,27,22,PatternPlayer
367,PatternPlayer,218,228,446,30,28,PatternPlayer
368,PatternPlayer,214,264,478,26,16,PatternPlayer
369,PatternPlayer,210,250,460,32,24,PatternPlayer
370,PatternPlayer,219,229,448,29,27,PatternPlayer
371,PatternPlayer,209,264,473,30,19,PatternPlayer
372,PatternPlayer,211,266,477,28,17,PatternPlayer
373,PatternPlayer,224,209,433,29,32,Player A
374,PatternPlayer,217,237,454,29,25,PatternPlayer
375,PatternPlayer,216,246,462,28,22,PatternPlayer
376,PatternPlayer,209,259,468,31,21,PatternPlayer
377,PatternPlayer,224,234,458,24,22,PatternPlayer
378,PatternPlayer,206,281,487,29,14,PatternPlayer
379,PatternPlayer,224,244,468,22,18,PatternPlayer
380,PatternPlayer,204,279,483,31,16,PatternPlayer
381,PatternPlayer,211,261,472,29,19,PatternPlayer
382,PatternPlayer,218,238,456,28,24,PatternPlayer
383,PatternPlayer,205,260,465,34,23,PatternPlayer
384,PatternPlayer,217,252,469,26,19,PatternPlayer
385,PatternPlayer,215,250,465,28,21,PatternPlayer
386,PatternPlayer,210,260,470,30,20,PatternPlayer
387,PatternPlayer,209,259,468,31,21,PatternPlayer
388,PatternPlayer,207,267,474,31,19,PatternPlayer
389,PatternPlayer,201,286,487,32,15,PatternPlayer
390,PatternPlayer,215,240,455,30,25,PatternPlayer
391,PatternPlayer,216,261,477,25,16,PatternPlayer
392,PatternPlayer,203,283,486,31,15,PatternPlayer
393,PatternPlayer,208,273,481,29,16,PatternPlayer
394,PatternPlayer,224,224,448,26,26,Tie
395,PatternPlayer,224,214,438,28,30,Player A
396,PatternPlayer,202,267,469,35,22,PatternPlayer
397,PatternPlayer,220,235,455,27,24,PatternPlayer
398,PatternPlayer,219,249,468,25,19,PatternPlayer
399,PatternPlayer,213,253,466,29,21,PatternPlayer
400,PatternPlayer,199,284,483,34,17,PatternPlayer
401,PatternPlayer,217,247,464,27,21,PatternPlayer
402,PatternPlayer,221,256,477,22,15,PatternPlayer
403,PatternPlayer,202,272,474,34,20,PatternPlayer
404,PatternPlayer,224,229,453,25,24,PatternPlayer
405,PatternPlayer,203,273,476,33,19,PatternPlayer
406,PatternPlayer,218,243,461,27,22,PatternPlayer
407,PatternPlayer,210,245,455,33,26,PatternPlayer
408,PatternPlayer,213,268,481,26,15,PatternPlayer
409,PatternPlayer,216,251,467,27,20,PatternPlayer
410,PatternPlayer,217,252,469,26,19,PatternPlayer
411,PatternPlayer,211,246,457,32,25,PatternPlayer
412,PatternPlayer,211,261,472,29,19,PatternPlayer
413,PatternPlayer,203,278,481,32,17,PatternPlayer
414,PatternPlayer,223,233,456,25,23,PatternPlayer
415,PatternPlayer,219,249,468,25,19,PatternPlayer
416,PatternPlayer,215,230,445,32,29,PatternPlayer
417,PatternPlayer,214,254,468,28,20,PatternPlayer
418,PatternPlayer,203,278,481,32,17,PatternPlayer
419,PatternPlayer,215,245,460,29,23,PatternPlayer
420,PatternPlayer,212,247,459,31,24,PatternPlayer
421,PatternPlayer,197,277,474,37,21,PatternPlayer
422,PatternPlayer,211,251,462,31,23,PatternPlayer
423,PatternPlayer,209,264,473,30,19,PatternPlayer
424,PatternPlayer,222,247,469,23,18,PatternPlayer
425,PatternPlayer,227,222,449,24,25,Player A
426,PatternPlayer,206,281,487,29,14,PatternPlayer
427,PatternPlayer,204,264,468,34,22,PatternPlayer
428,PatternPlayer,203,258,461,36,25,PatternPlayer
429,PatternPlayer,208,268,476,30,18,PatternPlayer
430,PatternPlayer,223,233,456,25,23,PatternPlayer
431,PatternPlayer,213,258,471,28,19,PatternPlayer
432,PatternPlayer,223,223,446,27,27,Tie
433,PatternPlayer,209,274,483,28,15,PatternPlayer
434,PatternPlayer,200,270,470,36,22,PatternPlayer
435,PatternPlayer,208,263,471,31,20,PatternPlayer
436,PatternPlayer,212,232,444,34,30,PatternPlayer
437,PatternPlayer,207,252,459,34,25,PatternPlayer
438,PatternPlayer,217,262,479,24,15,PatternPlayer
439,PatternPlayer,218,243,461,27,22,PatternPlayer
440,PatternPlayer,218,253,471,25,18,PatternPlayer
441,PatternPlayer,209,264,473,30,19,PatternPlayer
442,PatternPlayer,215,255,470,27,19,PatternPlayer
443,PatternPlayer,228,228,456,22,22,Tie
444,PatternPlayer,217,242,459,28,23,PatternPlayer
445,PatternPlayer,200,275,475,35,20,PatternPlayer
446,PatternPlayer,208,258,466,32,22,PatternPlayer
447,PatternPlayer,214,259,473,27,18,PatternPlayer
448,PatternPlayer,216,271,487,23,12,PatternPlayer
449,PatternPlayer,196,281,477,37,20,PatternPlayer
450,PatternPlayer,221,236,457,26,23,PatternPlayer
451,PatternPlayer,215,255,470,27,19,PatternPlayer
452,PatternPlayer,218,228,446,30,28,PatternPlayer
453,PatternPlayer,217,252,469,26,19,PatternPlayer
454,PatternPlayer,203,278,481,32,17,PatternPlayer
455,PatternPlayer,218,253,471,25,18,PatternPlayer
456,PatternPlayer,208,273,481,29,16,PatternPlayer
457,PatternPlayer,210,250,460,32,24,PatternPlayer
458,PatternPlayer,221,241,462,25,21,PatternPlayer
459,PatternPlayer,196,291,487,35,16,PatternPlayer
460,PatternPlayer,233,223,456,19,21,Player A
461,PatternPlayer,203,283,486,31,15,PatternPlayer
462,PatternPlayer,209,269,478,29,17,PatternPlayer
463,PatternPlayer,218,238,456,28,24,PatternPlayer
464,PatternPlayer,217,252,469,26,19,PatternPlayer
465,PatternPlayer,206,261,467,33,22,PatternPlayer
466,PatternPlayer,203,278,481,32,17,PatternPlayer
467,PatternPlayer,207,267,474,31,19,PatternPlayer
468,PatternPlayer,213,253,466,29,21,PatternPlayer
469,PatternPlayer,213,263,476,27,17,PatternPlayer
470,PatternPlayer,222,232,454,26,24,PatternPlayer
471,PatternPlayer,210,250,460,32,24,PatternPlayer
472,PatternPlayer,214,249,463,29,22,PatternPlayer
473,PatternPlayer,216,241,457,29,24,PatternPlayer
474,PatternPlayer,228,213,441,25,28,Player A
475,PatternPlayer,217,247,464,27,21,PatternPlayer
476,PatternPlayer,215,260,475,26,17,PatternPlayer
477,PatternPlayer,223,238,461,24,21,PatternPlayer
478,PatternPlayer,211,261,472,29,19,PatternPlayer
479,PatternPlayer,200,280,480,34,18,PatternPlayer
480,PatternPlayer,218,253,471,25,18,PatternPlayer
481,PatternPlayer,225,225,450,25,25,Tie
482,PatternPlayer,214,249,463,29,22,PatternPlayer
483,PatternPlayer,204,274,478,32,18,PatternPlayer
484,PatternPlayer,220,225,445,29,28,PatternPlayer
485,PatternPlayer,202,272,474,34,20,PatternPlayer
486,PatternPlayer,215,240,455,30,25,PatternPlayer
487,PatternPlayer,212,257,469,29,20,PatternPlayer
488,PatternPlayer,221,231,452,27,25,PatternPlayer
489,PatternPlayer,215,245,460,29,23,PatternPlayer
490,PatternPlayer,202,287,489,31,14,PatternPlayer
491,PatternPlayer,219,239,458,27,23,PatternPlayer
492,PatternPlayer,206,271,477,31,18,PatternPlayer
493,PatternPlayer,222,242,464,24,20,PatternPlayer
494,PatternPlayer,218,243,461,27,22,PatternPlayer
495,PatternPlayer,200,285,485,33,16,PatternPlayer
496,PatternPlayer,215,240,455,30,25,PatternPlayer
497,PatternPlayer,223,233,456,25,23,PatternPlayer
498,PatternPlayer,211,256,467,30,21,PatternPlayer
499,PatternPlayer,222,242,464,24,20,PatternPlayer
500,PatternPlayer,209,259,468,31,21,PatternPlayer
501,PatternPlayer,209,259,468,31,21,PatternPlayer
502,PatternPlayer,217,247,464,27,21,PatternPlayer
503,PatternPlayer,210,250,460,32,24,PatternPlayer
504,PatternPlayer,206,271,477,31,18,PatternPlayer
505,PatternPlayer,218,238,456,28,24,PatternPlayer
506,PatternPlayer,216,246,462,28,22,PatternPlayer
507,PatternPlayer,210,260,470,30,20,PatternPlayer
508,PatternPlayer,207,267,474,31,19,PatternPlayer
509,PatternPlayer,211,261,472,29,19,PatternPlayer
510,PatternPlayer,221,246,467,24,19,PatternPlayer
511,PatternPlayer,209,274,483,28,15,PatternPlayer
512,PatternPlayer,216,241,457,29,24,PatternPlayer
513,PatternPlayer,222,232,454,26,24,PatternPlayer
514,PatternPlayer,218,248,466,26,20,PatternPlayer
515,PatternPlayer,221,236,457,26,23,PatternPlayer
516,PatternPlayer,218,248,466,26,20,PatternPlayer
517,PatternPlayer,219,249,468,25,19,PatternPlayer
518,PatternPlayer,211,256,467,30,21,PatternPlayer
519,PatternPlayer,213,248,461,30,23,PatternPlayer
520,PatternPlayer,216,231,447,31,28,PatternPlayer
521,PatternPlayer,210,250,460,32,24,PatternPlayer
522,PatternPlayer,201,291,492,31,13,PatternPlayer
523,PatternPlayer,211,271,482,27,15,PatternPlayer
524,PatternPlayer,204,279,483,31,16,PatternPlayer
525,PatternPlayer,198,283,481,35,18,PatternPlayer
526,PatternPlayer,209,259,468,31,21,PatternPlayer
527,PatternPlayer,216,236,452,30,26,PatternPlayer
528,PatternPlayer,220,245,465,25,20,PatternPlayer
529,PatternPlayer,213,258,471,28,19,PatternPlayer
530,PatternPlayer,221,231,452,27,25,PatternPlayer
531,PatternPlayer,212,257,469,29,20,PatternPlayer
532,PatternPlayer,199,284,483,34,17,PatternPlayer
533,PatternPlayer,213,258,471,28,19,PatternPlayer
534,PatternPlayer,208,243,451,35,28,PatternPlayer
535,PatternPlayer,206,276,482,30,16,PatternPlayer
536,PatternPlayer,211,271,482,27,15,PatternPlayer
537,PatternPlayer,230,225,455,21,22,Player A
538,PatternPlayer,211,256,467,30,21,PatternPlayer
539,PatternPlayer,199,279,478,35,19,PatternPlayer
540,PatternPlayer,229,224,453,22,23,Player A
541,PatternPlayer,212,262,474,28,18,PatternPlayer
542,PatternPlayer,228,223,451,23,24,Player A
543,PatternPlayer,213,248,461,30,23,PatternPlayer
544,PatternPlayer,215,250,465,28,21,PatternPlayer
545,PatternPlayer,216,246,462,28,22,PatternPlayer
546,PatternPlayer,198,293,491,33,14,PatternPlayer
547,PatternPlayer,213,258,471,28,19,PatternPlayer
548,PatternPlayer,217,252,469,26,19,PatternPlayer
549,PatternPlayer,199,284,483,34,17,PatternPlayer
550,PatternPlayer,224,239,463,23,20,PatternPlayer
551,PatternPlayer,225,225,450,25,25,Tie
552,PatternPlayer,215,250,465,28,21,PatternPlayer
553,PatternPlayer,213,263,476,27,17,PatternPlayer
554,PatternPlayer,217,242,459,28,23,PatternPlayer
555,PatternPlayer,216,241,457,29,24,PatternPlayer
556,PatternPlayer,222,237,459,25,22,PatternPlayer
557,PatternPlayer,216,256,472,26,18,PatternPlayer
558,PatternPlayer,210,250,460,32,24,PatternPlayer
559,PatternPlayer,216,246,462,28,22,PatternPlayer
560,PatternPlayer,225,220,445,26,27,Player A
561,PatternPlayer,214,254,468,28,20,PatternPlayer
562,PatternPlayer,220,240,460,26,22,PatternPlayer
563,PatternPlayer,224,234,458,24,22,PatternPlayer
564,PatternPlayer,221,241,462,25,21,PatternPlayer
565,PatternPlayer,193,298,491,36,15,PatternPlayer
566,PatternPlayer,206,261,467,33,22,PatternPlayer
567,PatternPlayer,224,214,438,28,30,Player A
568,PatternPlayer,214,249,463,29,22,PatternPlayer
569,PatternPlayer,224,239,463,23,20,PatternPlayer
570,PatternPlayer,211,266,477,28,17,PatternPlayer
571,PatternPlayer,208,258,466,32,22,PatternPlayer
572,PatternPlayer,213,258,471,28,19,PatternPlayer
573,PatternPlayer,214,259,473,27,18,PatternPlayer
574,PatternPlayer,212,262,474,28,18,PatternPlayer
575,PatternPlayer,219,229,448,29,27,PatternPlayer
576,PatternPlayer,209,274,483,28,15,PatternPlayer
577,PatternPlayer,211,256,467,30,21,PatternPlayer
578,PatternPlayer,217,247,464,27,21,PatternPlayer
579,PatternPlayer,213,248,461,30,23,PatternPlayer
580,PatternPlayer,216,246,462,28,22,PatternPlayer
581,PatternPlayer,208,268,476,30,18,PatternPlayer
582,PatternPlayer,208,263,471,31,20,PatternPlayer
583,PatternPlayer,202,287,489,31,14,PatternPlayer
584,PatternPlayer,217,262,479,24,15,PatternPlayer
585,PatternPlayer,199,294,493,32,13,PatternPlayer
586,PatternPlayer,209,249,458,33,25,PatternPlayer
587,PatternPlayer,207,272,479,30,17,PatternPlayer
588,PatternPlayer,203,273,476,33,19,PatternPlayer
589,PatternPlayer,209,269,478,29,17,PatternPlayer
590,PatternPlayer,206,271,477,31,18,PatternPlayer
591,PatternPlayer,213,253,466,29,21,PatternPlayer
592,PatternPlayer,221,231,452,27,25,PatternPlayer
593,PatternPlayer,205,280,485,30,15,PatternPlayer
594,PatternPlayer,210,255,465,31,22,PatternPlayer
595,PatternPlayer,199,284,483,34,17,PatternPlayer
596,PatternPlayer,207,262,469,32,21,PatternPlayer
597,PatternPlayer,212,257,469,29,20,PatternPlayer
598,PatternPlayer,223,223,446,27,27,Tie
599,PatternPlayer,226,221,447,25,26,Player A
600,PatternPlayer,214,244,458,30,24,PatternPlayer
601,PatternPlayer,218,238,456,28,24,PatternPlayer
602,PatternPlayer,219,234,453,28,25,PatternPlayer
603,PatternPlayer,229,219,448,23,25,Player A
604,PatternPlayer,208,268,476,30,18,PatternPlayer
605,PatternPlayer,222,232,454,26,24,PatternPlayer
606,PatternPlayer,203,253,456,37,27,PatternPlayer
607,PatternPlayer,208,258,466,32,22,PatternPlayer
608,PatternPlayer,205,265,470,33,21,PatternPlayer
609,PatternPlayer,223,243,466,23,19,PatternPlayer
610,PatternPlayer,215,250,465,28,21,PatternPlayer
611,PatternPlayer,203,283,486,31,15,PatternPlayer
612,PatternPlayer,210,265,475,29,18,PatternPlayer
613,PatternPlayer,206,281,487,29,14,PatternPlayer
614,PatternPlayer,215,250,465,28,21,PatternPlayer
615,PatternPlayer,214,244,458,30,24,PatternPlayer
616,PatternPlayer,196,301,497,33,12,PatternPlayer
617,PatternPlayer,200,280,480,34,18,PatternPlayer
618,PatternPlayer,217,242,459,28,23,PatternPlayer
619,PatternPlayer,197,267,464,39,25,PatternPlayer
620,PatternPlayer,217,247,464,27,21,PatternPlayer
621,PatternPlayer,213,263,476,27,17,PatternPlayer
622,PatternPlayer,204,274,478,32,18,PatternPlayer
623,PatternPlayer,213,258,471,28,19,PatternPlayer
624,PatternPlayer,195,300,495,34,13,PatternPlayer
625,PatternPlayer,214,244,458,30,24,PatternPlayer
626,PatternPlayer,213,248,461,30,23,PatternPlayer
627,PatternPlayer,202,282,484,32,16,PatternPlayer
628,PatternPlayer,206,266,472,32,20,PatternPlayer
629,PatternPlayer,202,267,469,35,22,PatternPlayer
630,PatternPlayer,213,248,461,30,23,PatternPlayer
631,PatternPlayer,214,244,458,30,24,PatternPlayer
632,PatternPlayer,195,285,480,37,19,PatternPlayer
633,PatternPlayer,223,233,456,25,23,PatternPlayer
634,PatternPlayer,213,258,471,28,19,PatternPlayer
635,PatternPlayer,207,257,464,33,23,PatternPlayer
636,PatternPlayer,210,255,465,31,22,PatternPlayer
637,PatternPlayer,212,252,464,30,22,PatternPlayer
638,PatternPlayer,228,228,456,22,22,Tie
639,PatternPlayer,203,273,476,33,19,PatternPlayer
640,PatternPlayer,215,245,460,29,23,PatternPlayer
641,PatternPlayer,210,250,460,32,24,PatternPlayer
642,PatternPlayer,224,229,453,25,24,PatternPlayer
643,PatternPlayer,225,215,440,27,29,Player A
644,PatternPlayer,219,244,463,26,21,PatternPlayer
645,PatternPlayer,225,225,450,25,25,Tie
646,PatternPlayer,210,255,465,31,22,PatternPlayer
647,PatternPlayer,215,255,470,27,19,PatternPlayer
648,PatternPlayer,216,256,472,26,18,PatternPlayer
649,PatternPlayer,217,252,469,26,19,PatternPlayer
650,PatternPlayer,210,265,475,29,18,PatternPlayer
651,PatternPlayer,211,261,472,29,19,PatternPlayer
652,PatternPlayer,210,255,465,31,22,PatternPlayer
653,PatternPlayer,227,227,454,23,23,Tie
654,PatternPlayer,206,276,482,30,16,PatternPlayer
655,PatternPlayer,212,252,464,30,22,PatternPlayer
656,PatternPlayer,216,251,467,27,20,PatternPlayer
657,PatternPlayer,205,275,480,31,17,PatternPlayer
658,PatternPlayer,207,267,474,31,19,PatternPlayer
659,PatternPlayer,207,277,484,29,15,PatternPlayer
660,PatternPlayer,215,250,465,28,21,PatternPlayer
661,PatternPlayer,221,236,457,26,23,PatternPlayer
662,PatternPlayer,213,248,461,30,23,PatternPlayer
663,PatternPlayer,213,248,461,30,23,PatternPlayer
664,PatternPlayer,206,266,472,32,20,PatternPlayer
665,PatternPlayer,211,261,472,29,19,PatternPlayer
666,PatternPlayer,217,247,464,27,21,PatternPlayer
667,PatternPlayer,209,264,473,30,19,PatternPlayer
668,PatternPlayer,220,245,465,25,20,PatternPlayer
669,PatternPlayer,219,249,468,25,19,PatternPlayer
670,PatternPlayer,207,262,469,32,21,PatternPlayer
671,PatternPlayer,223,243,466,23,19,PatternPlayer
672,PatternPlayer,209,259,468,31,21,PatternPlayer
673,PatternPlayer,218,258,476,24,16,PatternPlayer
674,PatternPlayer,231,221,452,21,23,Player A
675,PatternPlayer,201,276,477,34,19,PatternPlayer
676,PatternPlayer,205,270,475,32,19,PatternPlayer
677,PatternPlayer,216,266,482,24,14,PatternPlayer
678,PatternPlayer,218,243,461,27,22,PatternPlayer
679,PatternPlayer,213,253,466,29,21,PatternPlayer
680,PatternPlayer,212,267,479,27,16,PatternPlayer
681,PatternPlayer,231,216,447,22,25,Player A
682,PatternPlayer,207,267,474,31,19,PatternPlayer
683,PatternPlayer,209,249,458,33,25,PatternPlayer
684,PatternPlayer,219,229,448,29,27,PatternPlayer
685,PatternPlayer,225,235,460,23,21,PatternPlayer
686,PatternPlayer,215,250,465,28,21,PatternPlayer
687,PatternPlayer,206,251,457,35,26,PatternPlayer
688,PatternPlayer,213,253,466,29,21,PatternPlayer
689,PatternPlayer,208,258,466,32,22,PatternPlayer
690,PatternPlayer,207,257,464,33,23,PatternPlayer
691,PatternPlayer,209,264,473,30,19,PatternPlayer
692,PatternPlayer,213,253,466,29,21,PatternPlayer
693,PatternPlayer,207,267,474,31,19,PatternPlayer
694,PatternPlayer,209,269,478,29,17,PatternPlayer
695,PatternPlayer,211,251,462,31,23,PatternPlayer
696,PatternPlayer,216,246,462,28,22,PatternPlayer
697,PatternPlayer,213,248,461,30,23,PatternPlayer
698,PatternPlayer,211,261,472,29,19,PatternPlayer
699,PatternPlayer,220,245,465,25,20,PatternPlayer
700,PatternPlayer,217,252,469,26,19,PatternPlayer
701,PatternPlayer,223,243,466,23,19,PatternPlayer
702,PatternPlayer,220,240,460,26,22,PatternPlayer
703,PatternPlayer,213,248,461,30,23,PatternPlayer
704,PatternPlayer,207,257,464,33,23,PatternPlayer
705,PatternPlayer,209,269,478,29,17,PatternPlayer
706,PatternPlayer,213,253,466,29,21,PatternPlayer
707,PatternPlayer,207,252,459,34,25,PatternPlayer
0,GrudgePlayer,184,274,458,30,24,GrudgePlayer
1,GrudgePlayer,136,281,417,13,32,GrudgePlayer
2,GrudgePlayer,147,282,429,13,28,GrudgePlayer
3,GrudgePlayer,191,306,497,30,11,GrudgePlayer
4,GrudgePlayer,136,266,402,10,36,GrudgePlayer
5,GrudgePlayer,147,272,419,15,32,GrudgePlayer
6,GrudgePlayer,165,280,445,23,26,GrudgePlayer
7,GrudgePlayer,139,269,408,10,34,GrudgePlayer
8,GrudgePlayer,155,275,430,17,29,GrudgePlayer
9,GrudgePlayer,134,269,403,14,37,GrudgePlayer
10,GrudgePlayer,149,279,428,21,31,GrudgePlayer
11,GrudgePlayer,158,283,441,16,25,GrudgePlayer
12,GrudgePlayer,145,270,415,17,34,GrudgePlayer
13,GrudgePlayer,135,265,400,14,38,GrudgePlayer
14,GrudgePlayer,182,282,464,30,22,GrudgePlayer
15,GrudgePlayer,130,265,395,12,39,GrudgePlayer
16,GrudgePlayer,163,268,431,21,30,GrudgePlayer
17,GrudgePlayer,173,283,456,28,24,GrudgePlayer
18,GrudgePlayer,188,293,481,32,17,GrudgePlayer
19,GrudgePlayer,175,275,450,22,24,GrudgePlayer
20,GrudgePlayer,156,276,432,22,30,GrudgePlayer
21,GrudgePlayer,151,291,442,20,26,GrudgePlayer
22,GrudgePlayer,140,270,410,12,34,GrudgePlayer
23,GrudgePlayer,166,296,462,25,21,GrudgePlayer
24,GrudgePlayer,161,286,447,19,24,GrudgePlayer
25,GrudgePlayer,176,296,472,26,18,GrudgePlayer
26,GrudgePlayer,170,280,450,25,25,GrudgePlayer
27,GrudgePlayer,158,258,416,24,36,GrudgePlayer
28,GrudgePlayer,147,272,419,12,31,GrudgePlayer
29,GrudgePlayer,141,266,407,12,35,GrudgePlayer
30,GrudgePlayer,166,286,452,24,24,GrudgePlayer
31,GrudgePlayer,158,298,456,19,21,GrudgePlayer
32,GrudgePlayer,180,285,465,25,20,GrudgePlayer
33,GrudgePlayer,129,264,393,10,39,GrudgePlayer
34,GrudgePlayer,134,284,418,11,31,GrudgePlayer
35,GrudgePlayer,140,280,420,13,31,GrudgePlayer
36,GrudgePlayer,178,283,461,27,22,GrudgePlayer
37,GrudgePlayer,154,269,423,19,32,GrudgePlayer
38,GrudgePlayer,139,279,418,14,32,GrudgePlayer
39,GrudgePlayer,161,281,442,20,26,GrudgePlayer
40,GrudgePlayer,172,282,454,23,23,GrudgePlayer
41,GrudgePlayer,151,286,437,18,27,GrudgePlayer
42,GrudgePlayer,149,279,428,15,29,GrudgePlayer
43,GrudgePlayer,172,292,464,24,20,GrudgePlayer
44,GrudgePlayer,141,271,412,17,35,GrudgePlayer
45,GrudgePlayer,180,285,465,28,21,GrudgePlayer
46,GrudgePlayer,181,291,472,23,17,GrudgePlayer
47,GrudgePlayer,148,263,411,16,35,GrudgePlayer
48,GrudgePlayer,145,270,415,11,32,GrudgePlayer
49,GrudgePlayer,164,274,438,22,28,GrudgePlayer
50,GrudgePlayer,182,287,469,29,20,GrudgePlayer
51,GrudgePlayer,193,303,496,35,13,GrudgePlayer
52,GrudgePlayer,166,276,442,23,27,GrudgePlayer
53,GrudgePlayer,180,290,470,33,21,GrudgePlayer
54,GrudgePlayer,166,281,447,22,25,GrudgePlayer
55,GrudgePlayer,164,294,458,21,21,GrudgePlayer
56,GrudgePlayer,183,288,471,34,21,GrudgePlayer
57,GrudgePlayer,148,278,426,16,30,GrudgePlayer
58,GrudgePlayer,169,294,463,23,20,GrudgePlayer
59,GrudgePlayer,144,284,428,15,29,GrudgePlayer
60,GrudgePlayer,133,263,396,16,40,GrudgePlayer
61,GrudgePlayer,147,277,424,17,31,GrudgePlayer
62,GrudgePlayer,170,280,450,28,26,GrudgePlayer
63,GrudgePlayer,156,286,442,17,25,GrudgePlayer
64,GrudgePlayer,160,285,445,26,27,GrudgePlayer
65,GrudgePlayer,182,287,469,32,21,GrudgePlayer
66,GrudgePlayer,135,280,415,11,32,GrudgePlayer
67,GrudgePlayer,142,262,404,12,36,GrudgePlayer
68,GrudgePlayer,159,289,448,17,23,GrudgePlayer
69,GrudgePlayer,169,289,458,21,21,GrudgePlayer
70,GrudgePlayer,147,282,429,16,29,GrudgePlayer
71,GrudgePlayer,163,278,441,25,28,GrudgePlayer
72,GrudgePlayer,175,275,450,28,26,GrudgePlayer
73,GrudgePlayer,143,253,396,13,39,GrudgePlayer
74,GrudgePlayer,174,289,463,23,20,GrudgePlayer
75,GrudgePlayer,149,274,423,13,30,GrudgePlayer
76,GrudgePlayer,173,273,446,27,27,GrudgePlayer
77,GrudgePlayer,163,288,451,17,22,GrudgePlayer
78,GrudgePlayer,144,284,428,15,29,GrudgePlayer
79,GrudgePlayer,160,285,445,17,24,GrudgePlayer
80,GrudgePlayer,154,279,433,20,29,GrudgePlayer
81,GrudgePlayer,158,268,426,19,31,GrudgePlayer
82,GrudgePlayer,165,275,440,24,28,GrudgePlayer
83,GrudgePlayer,145,275,420,19,33,GrudgePlayer
84,GrudgePlayer,165,275,440,24,28,GrudgePlayer
85,GrudgePlayer,180,285,465,28,21,GrudgePlayer
86,GrudgePlayer,166,271,437,18,27,GrudgePlayer
87,GrudgePlayer,167,302,469,23,18,GrudgePlayer
88,GrudgePlayer,177,292,469,26,19,GrudgePlayer
89,GrudgePlayer,162,277,439,20,27,GrudgePlayer
90,GrudgePlayer,151,276,427,14,29,GrudgePlayer
91,GrudgePlayer,159,284,443,24,27,GrudgePlayer
92,GrudgePlayer,163,283,446,24,26,GrudgePlayer
93,GrudgePlayer,159,279,438,19,27,GrudgePlayer
94,GrudgePlayer,135,265,400,11,37,GrudgePlayer
95,GrudgePlayer,160,290,450,22,24,GrudgePlayer
96,GrudgePlayer,174,284,458,27,23,GrudgePlayer
97,GrudgePlayer,157,292,449,18,23,GrudgePlayer
98,GrudgePlayer,164,289,453,22,23,GrudgePlayer
99,GrudgePlayer,142,282,424,11,29,GrudgePlayer
100,GrudgePlayer,175,285,460,29,23,GrudgePlayer
101,GrudgePlayer,154,284,438,16,26,GrudgePlayer
102,GrudgePlayer,145,250,395,15,40,GrudgePlayer
103,GrudgePlayer,166,281,447,28,27,GrudgePlayer
104,GrudgePlayer,160,280,440,21,27,GrudgePlayer
105,GrudgePlayer,150,275,425,18,31,GrudgePlayer
106,GrudgePlayer,168,283,451,23,24,GrudgePlayer
107,GrudgePlayer,189,289,478,35,19,GrudgePlayer
108,GrudgePlayer,166,296,462,22,20,GrudgePlayer
109,GrudgePlayer,129,274,403,11,36,GrudgePlayer
110,GrudgePlayer,140,270,410,12,34,GrudgePlayer
111,GrudgePlayer,167,282,449,27,26,GrudgePlayer
112,GrudgePlayer,175,285,460,26,22,GrudgePlayer
113,GrudgePlayer,156,276,432,25,31,GrudgePlayer
114,GrudgePlayer,177,262,439,32,31,GrudgePlayer
115,GrudgePlayer,151,281,432,19,29,GrudgePlayer
116,GrudgePlayer,146,291,437,15,26,GrudgePlayer
117,GrudgePlayer,152,267,419,21,34,GrudgePlayer
118,GrudgePlayer,164,304,468,19,17,GrudgePlayer
119,GrudgePlayer,159,294,453,16,21,GrudgePlayer
120,GrudgePlayer,154,274,428,18,30,GrudgePlayer
121,GrudgePlayer,162,272,434,21,29,GrudgePlayer
122,GrudgePlayer,146,271,417,13,32,GrudgePlayer
123,GrudgePlayer,157,282,439,20,27,GrudgePlayer
124,GrudgePlayer,176,266,442,26,28,GrudgePlayer
125,GrudgePlayer,156,271,427,17,30,GrudgePlayer
126,GrudgePlayer,188,303,491,33,14,GrudgePlayer
127,GrudgePlayer,151,296,447,19,24,GrudgePlayer
128,GrudgePlayer,156,276,432,16,28,GrudgePlayer
129,GrudgePlayer,153,253,406,17,37,GrudgePlayer
130,GrudgePlayer,139,259,398,15,39,GrudgePlayer
131,GrudgePlayer,147,272,419,18,33,GrudgePlayer
132,GrudgePlayer,163,288,451,23,24,GrudgePlayer
133,GrudgePlayer,160,285,445,20,25,GrudgePlayer
134,GrudgePlayer,164,274,438,16,26,GrudgePlayer
135,GrudgePlayer,165,285,450,25,25,GrudgePlayer
136,GrudgePlayer,160,275,435,22,29,GrudgePlayer
137,GrudgePlayer,144,269,413,12,33,GrudgePlayer
138,GrudgePlayer,139,264,403,17,38,GrudgePlayer
139,GrudgePlayer,189,289,478,29,17,GrudgePlayer
140,GrudgePlayer,161,271,432,22,30,GrudgePlayer
141,GrudgePlayer,152,282,434,21,29,GrudgePlayer
142,GrudgePlayer,187,277,464,33,23,GrudgePlayer
143,GrudgePlayer,148,263,411,13,34,GrudgePlayer
144,GrudgePlayer,152,282,434,18,28,GrudgePlayer
145,GrudgePlayer,149,269,418,14,32,GrudgePlayer
146,GrudgePlayer,171,276,447,25,26,GrudgePlayer
147,GrudgePlayer,152,277,429,16,29,GrudgePlayer
148,GrudgePlayer,188,293,481,32,17,GrudgePlayer
149,GrudgePlayer,141,281,422,9,29,GrudgePlayer
150,GrudgePlayer,138,278,416,12,32,GrudgePlayer
151,GrudgePlayer,160,265,425,18,31,GrudgePlayer
152,GrudgePlayer,155,285,440,15,25,GrudgePlayer
153,GrudgePlayer,182,287,469,29,20,GrudgePlayer
154,GrudgePlayer,146,281,427,17,30,GrudgePlayer
155,GrudgePlayer,156,286,442,23,27,GrudgePlayer
156,GrudgePlayer,159,294,453,16,21,GrudgePlayer
157,GrudgePlayer,151,276,427,20,31,GrudgePlayer
158,GrudgePlayer,179,294,473,30,19,GrudgePlayer
159,GrudgePlayer,164,259,423,25,34,GrudgePlayer
160,GrudgePlayer,194,284,478,35,19,GrudgePlayer
161,GrudgePlayer,186,296,482,36,18,GrudgePlayer
162,GrudgePlayer,175,265,440,27,29,GrudgePlayer
163,GrudgePlayer,149,274,423,16,31,GrudgePlayer
164,GrudgePlayer,142,282,424,14,30,GrudgePlayer
165,GrudgePlayer,154,264,418,20,34,GrudgePlayer
166,GrudgePlayer,185,290,475,29,18,GrudgePlayer
167,GrudgePlayer,131,271,402,10,36,GrudgePlayer
168,GrudgePlayer,175,295,470,27,19,GrudgePlayer
169,GrudgePlayer,191,296,487,35,16,GrudgePlayer
170,GrudgePlayer,154,264,418,14,32,GrudgePlayer
171,GrudgePlayer,168,268,436,23,29,GrudgePlayer
172,GrudgePlayer,165,280,445,20,25,GrudgePlayer
173,GrudgePlayer,163,278,441,19,26,GrudgePlayer
174,GrudgePlayer,146,276,422,15,31,GrudgePlayer
175,GrudgePlayer,136,261,397,17,40,GrudgePlayer
176,GrudgePlayer,155,270,425,21,32,GrudgePlayer
177,GrudgePlayer,163,283,446,24,26,GrudgePlayer
178,GrudgePlayer,155,285,440,12,24,GrudgePlayer
179,GrudgePlayer,155,310,465,19,18,GrudgePlayer
180,GrudgePlayer,157,272,429,19,30,GrudgePlayer
181,GrudgePlayer,144,289,433,17,28,GrudgePlayer
182,GrudgePlayer,135,275,410,6,32,GrudgePlayer
183,GrudgePlayer,164,274,438,25,29,GrudgePlayer
184,GrudgePlayer,156,286,442,23,27,GrudgePlayer
185,GrudgePlayer,178,288,466,29,21,GrudgePlayer
186,GrudgePlayer,158,263,421,17,32,GrudgePlayer
187,GrudgePlayer,151,276,427,14,29,GrudgePlayer
188,GrudgePlayer,141,266,407,15,36,GrudgePlayer
189,GrudgePlayer,160,285,445,20,25,GrudgePlayer
190,GrudgePlayer,117,272,389,9,40,GrudgePlayer
191,GrudgePlayer,173,283,456,25,23,GrudgePlayer
192,GrudgePlayer,154,269,423,19,32,GrudgePlayer
193,GrudgePlayer,176,276,452,30,26,GrudgePlayer
194,GrudgePlayer,139,254,393,16,41,GrudgePlayer
195,GrudgePlayer,152,292,444,13,23,GrudgePlayer
196,GrudgePlayer,147,262,409,14,35,GrudgePlayer
197,GrudgePlayer,149,294,443,18,25,GrudgePlayer
198,GrudgePlayer,144,279,423,13,30,GrudgePlayer
199,GrudgePlayer,155,290,445,17,24,GrudgePlayer
200,GrudgePlayer,143,263,406,17,37,GrudgePlayer
201,GrudgePlayer,161,291,452,21,23,GrudgePlayer
202,GrudgePlayer,170,290,460,23,21,GrudgePlayer
203,GrudgePlayer,137,272,409,11,34,GrudgePlayer
204,GrudgePlayer,125,260,385,11,42,GrudgePlayer
205,GrudgePlayer,161,266,427,23,32,GrudgePlayer
206,GrudgePlayer,159,284,443,15,24,GrudgePlayer
207,GrudgePlayer,155,290,445,17,24,GrudgePlayer
208,GrudgePlayer,151,276,427,17,30,GrudgePlayer
209,GrudgePlayer,169,274,443,27,28,GrudgePlayer
210,GrudgePlayer,142,282,424,11,29,GrudgePlayer
211,GrudgePlayer,155,245,400,20,40,GrudgePlayer
212,GrudgePlayer,148,288,436,20,28,GrudgePlayer
213,GrudgePlayer,185,285,470,30,20,GrudgePlayer
214,GrudgePlayer,144,264,408,16,36,GrudgePlayer
215,GrudgePlayer,140,265,405,16,37,GrudgePlayer
216,GrudgePlayer,168,278,446,27,27,GrudgePlayer
217,GrudgePlayer,157,272,429,19,30,GrudgePlayer
218,GrudgePlayer,166,291,457,29,24,GrudgePlayer
219,GrudgePlayer,166,276,442,23,27,GrudgePlayer
220,GrudgePlayer,169,284,453,25,24,GrudgePlayer
221,GrudgePlayer,168,283,451,26,25,GrudgePlayer
222,GrudgePlayer,129,259,388,11,41,GrudgePlayer
223,GrudgePlayer,129,279,408,10,34,GrudgePlayer
224,GrudgePlayer,160,270,430,20,30,GrudgePlayer
225,GrudgePlayer,147,292,439,14,25,GrudgePlayer
226,GrudgePlayer,146,271,417,16,33,GrudgePlayer
227,GrudgePlayer,168,268,436,26,30,GrudgePlayer
228,GrudgePlayer,149,269,418,17,33,GrudgePlayer
229,GrudgePlayer,166,281,447,19,24,GrudgePlayer
230,GrudgePlayer,150,260,410,18,36,GrudgePlayer
231,GrudgePlayer,152,277,429,19,30,GrudgePlayer
232,GrudgePlayer,158,278,436,23,29,GrudgePlayer
233,GrudgePlayer,135,280,415,8,31,GrudgePlayer
234,GrudgePlayer,200,295,495,34,13,GrudgePlayer
235,GrudgePlayer,125,270,395,9,38,GrudgePlayer
236,GrudgePlayer,148,268,416,15,33,GrudgePlayer
237,GrudgePlayer,159,279,438,22,28,GrudgePlayer
238,GrudgePlayer,168,283,451,26,25,GrudgePlayer
239,GrudgePlayer,155,290,445,20,25,GrudgePlayer
240,GrudgePlayer,162,277,439,17,26,GrudgePlayer
241,GrudgePlayer,150,275,425,18,31,GrudgePlayer
242,GrudgePlayer,126,266,392,6,38,GrudgePlayer
243,GrudgePlayer,145,270,415,14,33,GrudgePlayer
244,GrudgePlayer,131,276,407,12,35,GrudgePlayer
245,GrudgePlayer,147,277,424,11,29,GrudgePlayer
246,GrudgePlayer,159,289,448,23,25,GrudgePlayer
247,GrudgePlayer,180,265,445,29,28,GrudgePlayer
248,GrudgePlayer,153,288,441,22,27,GrudgePlayer
249,GrudgePlayer,168,293,461,24,21,GrudgePlayer
250,GrudgePlayer,174,289,463,29,22,GrudgePlayer
251,GrudgePlayer,165,295,460,17,19,GrudgePlayer
252,GrudgePlayer,149,279,428,18,30,GrudgePlayer
253,GrudgePlayer,173,283,456,22,22,GrudgePlayer
254,GrudgePlayer,144,284,428,18,30,GrudgePlayer
255,GrudgePlayer,149,284,433,17,28,GrudgePlayer
256,GrudgePlayer,158,283,441,19,26,GrudgePlayer
257,GrudgePlayer,169,294,463,20,19,GrudgePlayer
258,GrudgePlayer,150,265,415,20,35,GrudgePlayer
259,GrudgePlayer,144,274,418,14,32,GrudgePlayer
260,GrudgePlayer,171,301,472,23,17,GrudgePlayer
261,GrudgePlayer,171,276,447,22,25,GrudgePlayer
262,GrudgePlayer,151,276,427,20,31,GrudgePlayer
263,GrudgePlayer,155,265,420,19,33,GrudgePlayer
264,GrudgePlayer,128,278,406,8,34,GrudgePlayer
265,GrudgePlayer,170,285,455,24,23,GrudgePlayer
266,GrudgePlayer,141,266,407,12,35,GrudgePlayer
267,GrudgePlayer,156,291,447,16,23,GrudgePlayer
268,GrudgePlayer,159,279,438,22,28,GrudgePlayer
269,GrudgePlayer,146,271,417,16,33,GrudgePlayer
270,GrudgePlayer,161,286,447,19,24,GrudgePlayer
271,GrudgePlayer,141,276,417,13,32,GrudgePlayer
272,GrudgePlayer,150,280,430,17,29,GrudgePlayer
273,GrudgePlayer,148,278,426,19,31,GrudgePlayer
274,GrudgePlayer,161,301,462,19,19,GrudgePlayer
275,GrudgePlayer,159,294,453,16,21,GrudgePlayer
276,GrudgePlayer,168,293,461,30,23,GrudgePlayer
277,GrudgePlayer,165,285,450,16,22,GrudgePlayer
278,GrudgePlayer,177,277,454,29,25,GrudgePlayer
279,GrudgePlayer,165,295,460,26,22,GrudgePlayer
280,GrudgePlayer,119,264,383,9,42,GrudgePlayer
281,GrudgePlayer,149,279,428,12,28,GrudgePlayer
282,GrudgePlayer,173,273,446,27,27,GrudgePlayer
283,GrudgePlayer,186,296,482,36,18,GrudgePlayer
284,GrudgePlayer,149,279,428,12,28,GrudgePlayer
285,GrudgePlayer,194,269,463,35,24,GrudgePlayer
286,GrudgePlayer,147,257,404,15,37,GrudgePlayer
287,GrudgePlayer,127,277,404,12,36,GrudgePlayer
288,GrudgePlayer,166,266,432,16,28,GrudgePlayer
289,GrudgePlayer,161,261,422,24,34,GrudgePlayer
290,GrudgePlayer,156,276,432,22,30,GrudgePlayer
291,GrudgePlayer,191,276,467,36,23,GrudgePlayer
292,GrudgePlayer,151,266,417,16,33,GrudgePlayer
293,GrudgePlayer,162,282,444,22,26,GrudgePlayer
294,GrudgePlayer,166,276,442,20,26,GrudgePlayer
295,GrudgePlayer,160,300,460,20,20,GrudgePlayer
296,GrudgePlayer,154,294,448,14,22,GrudgePlayer
297,GrudgePlayer,160,280,440,21,27,GrudgePlayer
298,GrudgePlayer,149,279,428,18,30,GrudgePlayer
299,GrudgePlayer,188,298,486,31,15,GrudgePlayer
300,GrudgePlayer,168,303,471,22,17,GrudgePlayer
301,GrudgePlayer,159,279,438,19,27,GrudgePlayer
302,GrudgePlayer,148,278,426,16,30,GrudgePlayer
303,GrudgePlayer,168,278,446,21,25,GrudgePlayer
304,GrudgePlayer,181,291,472,35,21,GrudgePlayer
305,GrudgePlayer,145,275,420,22,34,GrudgePlayer
306,GrudgePlayer,154,274,428,15,29,GrudgePlayer
307,GrudgePlayer,144,279,423,19,32,GrudgePlayer
308,GrudgePlayer,183,278,461,27,22,GrudgePlayer
309,GrudgePlayer,151,276,427,17,30,GrudgePlayer
310,GrudgePlayer,145,270,415,17,34,GrudgePlayer
311,GrudgePlayer,140,265,405,16,37,GrudgePlayer
312,GrudgePlayer,141,281,422,15,31,GrudgePlayer
313,GrudgePlayer,163,283,446,18,24,GrudgePlayer
314,GrudgePlayer,150,285,435,22,29,GrudgePlayer
315,GrudgePlayer,183,283,466,29,21,GrudgePlayer
316,GrudgePlayer,147,277,424,14,30,GrudgePlayer
317,GrudgePlayer,154,279,433,17,28,GrudgePlayer
318,GrudgePlayer,152,277,429,16,29,GrudgePlayer
319,GrudgePlayer,155,275,430,17,29,GrudgePlayer
320,GrudgePlayer,190,290,480,37,19,GrudgePlayer
321,GrudgePlayer,164,284,448,23,25,GrudgePlayer
322,GrudgePlayer,132,257,389,12,41,GrudgePlayer
323,GrudgePlayer,160,290,450,19,23,GrudgePlayer
324,GrudgePlayer,187,287,474,34,20,GrudgePlayer
325,GrudgePlayer,170,280,450,22,24,GrudgePlayer
326,GrudgePlayer,146,281,427,20,31,GrudgePlayer
327,GrudgePlayer,176,286,462,25,21,GrudgePlayer
328,GrudgePlayer,151,276,427,20,31,GrudgePlayer
329,GrudgePlayer,158,268,426,19,31,GrudgePlayer
330,GrudgePlayer,157,297,454,17,21,GrudgePlayer
331,GrudgePlayer,130,275,405,10,35,GrudgePlayer
332,GrudgePlayer,168,278,446,24,26,GrudgePlayer
333,GrudgePlayer,171,281,452,24,24,GrudgePlayer
334,GrudgePlayer,174,294,468,22,18,GrudgePlayer
335,GrudgePlayer,142,257,399,13,38,GrudgePlayer
336,GrudgePlayer,139,279,418,14,32,GrudgePlayer
337,GrudgePlayer,168,283,451,23,24,GrudgePlayer
338,GrudgePlayer,148,268,416,18,34,GrudgePlayer
339,GrudgePlayer,166,276,442,20,26,GrudgePlayer
340,GrudgePlayer,158,263,421,17,32,GrudgePlayer
341,GrudgePlayer,167,292,459,22,21,GrudgePlayer
342,GrudgePlayer,166,276,442,20,26,GrudgePlayer
343,GrudgePlayer,145,285,430,20,30,GrudgePlayer
344,GrudgePlayer,157,282,439,17,26,GrudgePlayer
345,GrudgePlayer,162,292,454,20,22,GrudgePlayer
346,GrudgePlayer,144,259,403,14,37,GrudgePlayer
347,GrudgePlayer,183,288,471,28,19,GrudgePlayer
348,GrudgePlayer,135,255,390,10,40,GrudgePlayer
349,GrudgePlayer,154,284,438,19,27,GrudgePlayer
350,GrudgePlayer,150,275,425,15,30,GrudgePlayer
351,GrudgePlayer,161,286,447,16,23,GrudgePlayer
352,GrudgePlayer,137,267,404,12,36,GrudgePlayer
353,GrudgePlayer,133,283,416,15,33,GrudgePlayer
354,GrudgePlayer,190,285,475,29,18,GrudgePlayer
355,GrudgePlayer,172,292,464,27,21,GrudgePlayer
356,GrudgePlayer,141,266,407,9,34,GrudgePlayer
357,GrudgePlayer,187,292,479,27,16,GrudgePlayer
358,GrudgePlayer,150,275,425,15,30,GrudgePlayer
359,GrudgePlayer,132,252,384,13,43,GrudgePlayer
360,GrudgePlayer,143,293,436,14,26,GrudgePlayer
361,GrudgePlayer,156,276,432,19,29,GrudgePlayer
362,GrudgePlayer,145,270,415,14,33,GrudgePlayer
363,GrudgePlayer,134,249,383,12,43,GrudgePlayer
364,GrudgePlayer,140,270,410,12,34,GrudgePlayer
365,GrudgePlayer,165,280,445,23,26,GrudgePlayer
366,GrudgePlayer,160,280,440,18,26,GrudgePlayer
367,GrudgePlayer,159,274,433,20,29,GrudgePlayer
368,GrudgePlayer,151,276,427,14,29,GrudgePlayer
369,GrudgePlayer,154,269,423,19,32,GrudgePlayer
370,GrudgePlayer,147,257,404,12,36,GrudgePlayer
371,GrudgePlayer,146,271,417,13,32,GrudgePlayer
372,GrudgePlayer,161,291,452,21,23,GrudgePlayer
373,GrudgePlayer,164,279,443,21,26,GrudgePlayer
374,GrudgePlayer,142,297,439,8,23,GrudgePlayer
375,GrudgePlayer,168,268,436,23,29,GrudgePlayer
376,GrudgePlayer,168,278,446,24,26,GrudgePlayer
377,GrudgePlayer,172,297,469,26,19,GrudgePlayer
378,GrudgePlayer,144,274,418,17,33,GrudgePlayer
379,GrudgePlayer,172,292,464,27,21,GrudgePlayer
380,GrudgePlayer,152,277,429,16,29,GrudgePlayer
381,GrudgePlayer,127,277,404,9,35,GrudgePlayer
382,GrudgePlayer,161,291,452,21,23,GrudgePlayer
383,GrudgePlayer,170,280,450,25,25,GrudgePlayer
384,GrudgePlayer,137,267,404,15,37,GrudgePlayer
385,GrudgePlayer,175,290,465,28,21,GrudgePlayer
386,GrudgePlayer,159,279,438,22,28,GrudgePlayer
387,GrudgePlayer,162,277,439,29,30,GrudgePlayer
388,GrudgePlayer,158,278,436,20,28,GrudgePlayer
389,GrudgePlayer,145,270,415,14,33,GrudgePlayer
390,GrudgePlayer,141,286,427,17,30,GrudgePlayer
391,GrudgePlayer,157,282,439,20,27,GrudgePlayer
392,GrudgePlayer,157,282,439,17,26,GrudgePlayer
393,GrudgePlayer,127,272,399,13,38,GrudgePlayer
394,GrudgePlayer,148,268,416,15,33,GrudgePlayer
395,GrudgePlayer,151,281,432,16,28,GrudgePlayer
396,GrudgePlayer,153,278,431,21,30,GrudgePlayer
397,GrudgePlayer,146,276,422,12,30,GrudgePlayer
398,GrudgePlayer,153,283,436,17,27,GrudgePlayer
399,GrudgePlayer,118,248,366,4,46,GrudgePlayer
400,GrudgePlayer,162,267,429,19,30,GrudgePlayer
401,GrudgePlayer,150,265,415,17,34,GrudgePlayer
402,GrudgePlayer,150,260,410,18,36,GrudgePlayer
403,GrudgePlayer,137,267,404,9,35,GrudgePlayer
404,GrudgePlayer,154,279,433,23,30,GrudgePlayer
405,GrudgePlayer,166,271,437,18,27,GrudgePlayer
406,GrudgePlayer,140,270,410,12,34,GrudgePlayer
407,GrudgePlayer,142,262,404,9,35,GrudgePlayer
408,GrudgePlayer,164,294,458,24,22,GrudgePlayer
409,GrudgePlayer,168,298,466,23,19,GrudgePlayer
410,GrudgePlayer,153,268,421,20,33,GrudgePlayer
411,GrudgePlayer,154,284,438,16,26,GrudgePlayer
412,GrudgePlayer,151,271,422,15,31,GrudgePlayer
413,GrudgePlayer,159,289,448,17,23,GrudgePlayer
414,GrudgePlayer,168,278,446,24,26,GrudgePlayer
415,GrudgePlayer,154,274,428,18,30,GrudgePlayer
416,GrudgePlayer,146,276,422,15,31,GrudgePlayer
417,GrudgePlayer,158,283,441,16,25,GrudgePlayer
418,GrudgePlayer,161,276,437,18,27,GrudgePlayer
419,GrudgePlayer,130,275,405,13,36,GrudgePlayer
420,GrudgePlayer,189,279,468,31,21,GrudgePlayer
421,GrudgePlayer,165,280,445,20,25,GrudgePlayer
422,GrudgePlayer,129,264,393,10,39,GrudgePlayer
423,GrudgePlayer,138,268,406,14,36,GrudgePlayer
424,GrudgePlayer,154,289,443,12,23,GrudgePlayer
425,GrudgePlayer,151,271,422,18,32,GrudgePlayer
426,GrudgePlayer,162,277,439,20,27,GrudgePlayer
427,GrudgePlayer,162,277,439,23,28,GrudgePlayer
428,GrudgePlayer,144,274,418,11,31,GrudgePlayer
429,GrudgePlayer,163,283,446,24,26,GrudgePlayer
430,GrudgePlayer,183,303,486,31,15,GrudgePlayer
431,GrudgePlayer,169,274,443,18,25,GrudgePlayer
432,GrudgePlayer,185,295,480,28,16,GrudgePlayer
433,GrudgePlayer,147,282,429,16,29,GrudgePlayer
434,GrudgePlayer,174,299,473,24,17,GrudgePlayer
435,GrudgePlayer,131,246,377,12,45,GrudgePlayer
436,GrudgePlayer,158,278,436,20,28,GrudgePlayer
437,GrudgePlayer,174,279,453,28,25,GrudgePlayer
438,GrudgePlayer,150,275,425,21,32,GrudgePlayer
439,GrudgePlayer,157,272,429,22,31,GrudgePlayer
440,GrudgePlayer,158,288,446,18,24,GrudgePlayer
441,GrudgePlayer,155,265,420,16,32,GrudgePlayer
442,GrudgePlayer,134,279,413,12,33,GrudgePlayer
443,GrudgePlayer,146,276,422,12,30,GrudgePlayer
444,GrudgePlayer,163,283,446,18,24,GrudgePlayer
445,GrudgePlayer,177,292,469,29,20,GrudgePlayer
446,GrudgePlayer,155,300,455,18,21,GrudgePlayer
447,GrudgePlayer,146,261,407,18,37,GrudgePlayer
448,GrudgePlayer,147,247,394,17,41,GrudgePlayer
449,GrudgePlayer,155,280,435,19,28,GrudgePlayer
450,GrudgePlayer,179,294,473,27,18,GrudgePlayer
451,GrudgePlayer,160,285,445,20,25,GrudgePlayer
452,GrudgePlayer,151,281,432,16,28,GrudgePlayer
453,GrudgePlayer,164,264,428,21,31,GrudgePlayer
454,GrudgePlayer,154,289,443,21,26,GrudgePlayer
455,GrudgePlayer,146,256,402,16,38,GrudgePlayer
456,GrudgePlayer,155,275,430,14,28,GrudgePlayer
457,GrudgePlayer,150,285,435,13,26,GrudgePlayer
458,GrudgePlayer,166,291,457,23,22,GrudgePlayer
459,GrudgePlayer,162,282,444,19,25,GrudgePlayer
460,GrudgePlayer,153,288,441,16,25,GrudgePlayer
461,GrudgePlayer,166,296,462,25,21,GrudgePlayer
462,GrudgePlayer,159,274,433,20,29,GrudgePlayer
463,GrudgePlayer,157,277,434,21,29,GrudgePlayer
464,GrudgePlayer,157,287,444,19,25,GrudgePlayer
465,GrudgePlayer,154,294,448,20,24,GrudgePlayer
466,GrudgePlayer,164,279,443,24,27,GrudgePlayer
467,GrudgePlayer,171,276,447,25,26,GrudgePlayer
468,GrudgePlayer,143,278,421,14,31,GrudgePlayer
469,GrudgePlayer,138,268,406,11,35,GrudgePlayer
470,GrudgePlayer,140,270,410,12,34,GrudgePlayer
471,GrudgePlayer,151,291,442,20,26,GrudgePlayer
472,GrudgePlayer,153,273,426,19,31,GrudgePlayer
473,GrudgePlayer,141,266,407,9,34,GrudgePlayer
474,GrudgePlayer,142,272,414,13,33,GrudgePlayer
475,GrudgePlayer,148,273,421,14,31,GrudgePlayer
476,GrudgePlayer,175,290,465,25,20,GrudgePlayer
477,GrudgePlayer,181,296,477,34,19,GrudgePlayer
478,GrudgePlayer,145,270,415,14,33,GrudgePlayer
479,GrudgePlayer,145,270,415,14,33,GrudgePlayer
480,GrudgePlayer,142,282,424,14,30,GrudgePlayer
481,GrudgePlayer,150,265,415,23,36,GrudgePlayer
482,GrudgePlayer,169,294,463,17,18,GrudgePlayer
483,GrudgePlayer,152,267,419,24,35,GrudgePlayer
484,GrudgePlayer,155,295,450,16,22,GrudgePlayer
485,GrudgePlayer,164,279,443,24,27,GrudgePlayer
486,GrudgePlayer,164,279,443,24,27,GrudgePlayer
487,GrudgePlayer,162,277,439,23,28,GrudgePlayer
488,GrudgePlayer,131,266,397,11,38,GrudgePlayer
489,GrudgePlayer,124,264,388,11,41,GrudgePlayer
490,GrudgePlayer,182,287,469,32,21,GrudgePlayer
491,GrudgePlayer,135,270,405,10,35,GrudgePlayer
492,GrudgePlayer,153,283,436,17,27,GrudgePlayer
493,GrudgePlayer,150,250,400,17,39,GrudgePlayer
494,GrudgePlayer,159,279,438,16,26,GrudgePlayer
495,GrudgePlayer,144,289,433,14,27,GrudgePlayer
496,GrudgePlayer,183,278,461,30,23,GrudgePlayer
497,GrudgePlayer,151,256,407,18,37,GrudgePlayer
498,GrudgePlayer,156,271,427,17,30,GrudgePlayer
499,GrudgePlayer,152,282,434,15,27,GrudgePlayer
500,GrudgePlayer,166,286,452,21,23,GrudgePlayer
501,GrudgePlayer,156,281,437,21,28,GrudgePlayer
502,GrudgePlayer,158,288,446,12,22,GrudgePlayer
503,GrudgePlayer,156,286,442,20,26,GrudgePlayer
504,GrudgePlayer,172,267,439,26,29,GrudgePlayer
505,GrudgePlayer,135,265,400,11,37,GrudgePlayer
506,GrudgePlayer,181,286,467,30,21,GrudgePlayer
507,GrudgePlayer,155,260,415,20,35,GrudgePlayer
508,GrudgePlayer,158,283,441,16,25,GrudgePlayer
509,GrudgePlayer,143,268,411,10,33,GrudgePlayer
510,GrudgePlayer,142,252,394,14,40,GrudgePlayer
511,GrudgePlayer,145,270,415,14,33,GrudgePlayer
512,GrudgePlayer,164,274,438,22,28,GrudgePlayer
513,GrudgePlayer,163,303,466,17,17,GrudgePlayer
514,GrudgePlayer,140,260,400,17,39,GrudgePlayer
515,GrudgePlayer,133,278,411,10,33,GrudgePlayer
516,GrudgePlayer,153,273,426,22,32,GrudgePlayer
517,GrudgePlayer,162,297,459,25,22,GrudgePlayer
518,GrudgePlayer,149,289,438,16,26,GrudgePlayer
519,GrudgePlayer,164,269,433,20,29,GrudgePlayer
520,GrudgePlayer,141,266,407,15,36,GrudgePlayer
521,GrudgePlayer,168,268,436,23,29,GrudgePlayer
522,GrudgePlayer,163,288,451,20,23,GrudgePlayer
523,GrudgePlayer,137,287,424,11,29,GrudgePlayer
524,GrudgePlayer,144,264,408,13,35,GrudgePlayer
525,GrudgePlayer,168,283,451,23,24,GrudgePlayer
526,GrudgePlayer,156,281,437,24,29,GrudgePlayer
527,GrudgePlayer,142,272,414,16,34,GrudgePlayer
528,GrudgePlayer,177,297,474,34,20,GrudgePlayer
529,GrudgePlayer,176,301,477,25,16,GrudgePlayer
530,GrudgePlayer,148,283,431,18,29,GrudgePlayer
531,GrudgePlayer,165,275,440,21,27,GrudgePlayer
532,GrudgePlayer,140,270,410,15,35,GrudgePlayer
533,GrudgePlayer,144,279,423,13,30,GrudgePlayer
534,GrudgePlayer,119,269,388,11,41,GrudgePlayer
535,GrudgePlayer,141,271,412,17,35,GrudgePlayer
536,GrudgePlayer,147,282,429,16,29,GrudgePlayer
537,GrudgePlayer,147,252,399,13,38,GrudgePlayer
538,GrudgePlayer,158,283,441,13,24,GrudgePlayer
539,GrudgePlayer,168,283,451,20,23,GrudgePlayer
540,GrudgePlayer,153,278,431,21,30,GrudgePlayer
541,GrudgePlayer,153,288,441,16,25,GrudgePlayer
542,GrudgePlayer,144,279,423,10,29,GrudgePlayer
543,GrudgePlayer,160,270,430,26,32,GrudgePlayer
544,GrudgePlayer,151,276,427,17,30,GrudgePlayer
545,GrudgePlayer,153,268,421,20,33,GrudgePlayer
546,GrudgePlayer,173,273,446,27,27,GrudgePlayer
547,GrudgePlayer,140,255,395,12,39,GrudgePlayer
548,GrudgePlayer,164,284,448,20,24,GrudgePlayer
549,GrudgePlayer,133,258,391,11,40,GrudgePlayer
550,GrudgePlayer,129,274,403,8,35,GrudgePlayer
551,GrudgePlayer,162,267,429,22,31,GrudgePlayer
552,GrudgePlayer,152,267,419,21,34,GrudgePlayer
553,GrudgePlayer,177,277,454,26,24,GrudgePlayer
554,GrudgePlayer,151,286,437,18,27,GrudgePlayer
555,GrudgePlayer,144,279,423,13,30,GrudgePlayer
556,GrudgePlayer,130,275,405,16,37,GrudgePlayer
557,GrudgePlayer,154,269,423,19,32,GrudgePlayer
558,GrudgePlayer,160,275,435,22,29,GrudgePlayer
559,GrudgePlayer,153,283,436,14,26,GrudgePlayer
560,GrudgePlayer,123,268,391,11,40,GrudgePlayer
561,GrudgePlayer,154,284,438,16,26,GrudgePlayer
562,GrudgePlayer,176,301,477,22,15,GrudgePlayer
563,GrudgePlayer,150,285,435,13,26,GrudgePlayer
564,GrudgePlayer,168,283,451,26,25,GrudgePlayer
565,GrudgePlayer,172,292,464,24,20,GrudgePlayer
566,GrudgePlayer,160,270,430,20,30,GrudgePlayer
567,GrudgePlayer,132,257,389,6,39,GrudgePlayer
568,GrudgePlayer,156,281,437,21,28,GrudgePlayer
569,GrudgePlayer,145,275,420,16,32,GrudgePlayer
570,GrudgePlayer,141,271,412,14,34,GrudgePlayer
571,GrudgePlayer,134,279,413,15,34,GrudgePlayer
572,GrudgePlayer,153,283,436,14,26,GrudgePlayer
573,GrudgePlayer,139,279,418,11,31,GrudgePlayer
574,GrudgePlayer,122,267,389,9,40,GrudgePlayer
575,GrudgePlayer,150,275,425,18,31,GrudgePlayer
576,GrudgePlayer,167,292,459,22,21,GrudgePlayer
577,GrudgePlayer,143,273,416,15,33,GrudgePlayer
578,GrudgePlayer,154,274,428,24,32,GrudgePlayer
579,GrudgePlayer,162,292,454,17,21,GrudgePlayer
580,GrudgePlayer,171,281,452,21,23,GrudgePlayer
581,GrudgePlayer,155,280,435,19,28,GrudgePlayer
582,GrudgePlayer,174,289,463,26,21,GrudgePlayer
583,GrudgePlayer,162,277,439,20,27,GrudgePlayer
584,GrudgePlayer,174,289,463,23,20,GrudgePlayer
585,GrudgePlayer,160,270,430,20,30,GrudgePlayer
586,GrudgePlayer,148,278,426,13,29,GrudgePlayer
587,GrudgePlayer,169,299,468,22,18,GrudgePlayer
588,GrudgePlayer,192,297,489,34,15,GrudgePlayer
589,GrudgePlayer,147,277,424,14,30,GrudgePlayer
590,GrudgePlayer,151,266,417,16,33,GrudgePlayer
591,GrudgePlayer,157,277,434,18,28,GrudgePlayer
592,GrudgePlayer,124,264,388,11,41,GrudgePlayer
593,GrudgePlayer,141,271,412,17,35,GrudgePlayer
594,GrudgePlayer,161,281,442,20,26,GrudgePlayer
595,GrudgePlayer,143,283,426,16,30,GrudgePlayer
596,GrudgePlayer,156,286,442,20,26,GrudgePlayer
597,GrudgePlayer,144,294,438,13,25,GrudgePlayer
598,GrudgePlayer,128,253,381,13,44,GrudgePlayer
599,GrudgePlayer,166,276,442,20,26,GrudgePlayer
600,GrudgePlayer,129,264,393,13,40,GrudgePlayer
601,GrudgePlayer,141,271,412,17,35,GrudgePlayer
602,GrudgePlayer,140,280,420,13,31,GrudgePlayer
603,GrudgePlayer,166,276,442,26,28,GrudgePlayer
604,GrudgePlayer,150,265,415,17,34,GrudgePlayer
605,GrudgePlayer,133,258,391,11,40,GrudgePlayer
606,GrudgePlayer,150,270,420,16,32,GrudgePlayer
607,GrudgePlayer,142,297,439,14,25,GrudgePlayer
608,GrudgePlayer,161,276,437,18,27,GrudgePlayer
609,GrudgePlayer,142,272,414,13,33,GrudgePlayer
610,GrudgePlayer,139,264,403,17,38,GrudgePlayer
611,GrudgePlayer,183,278,461,30,23,GrudgePlayer
612,GrudgePlayer,146,261,407,15,36,GrudgePlayer
613,GrudgePlayer,165,270,435,19,28,GrudgePlayer
614,GrudgePlayer,141,256,397,11,38,GrudgePlayer
615,GrudgePlayer,160,260,420,19,33,GrudgePlayer
616,GrudgePlayer,168,283,451,26,25,GrudgePlayer
617,GrudgePlayer,167,277,444,25,27,GrudgePlayer
618,GrudgePlayer,180,290,470,30,20,GrudgePlayer
619,GrudgePlayer,161,276,437,18,27,GrudgePlayer
620,GrudgePlayer,166,286,452,21,23,GrudgePlayer
621,GrudgePlayer,135,275,410,12,34,GrudgePlayer
622,GrudgePlayer,153,268,421,14,31,GrudgePlayer
623,GrudgePlayer,131,261,392,9,39,GrudgePlayer
624,GrudgePlayer,140,275,415,11,32,GrudgePlayer
625,GrudgePlayer,151,281,432,16,28,GrudgePlayer
626,GrudgePlayer,169,279,448,23,25,GrudgePlayer
627,GrudgePlayer,181,286,467,30,21,GrudgePlayer
628,GrudgePlayer,158,283,441,16,25,GrudgePlayer
629,GrudgePlayer,139,259,398,12,38,GrudgePlayer
630,GrudgePlayer,210,295,505,44,13,GrudgePlayer
631,GrudgePlayer,153,293,446,15,23,GrudgePlayer
632,GrudgePlayer,136,266,402,10,36,GrudgePlayer
633,GrudgePlayer,185,295,480,28,16,GrudgePlayer
634,GrudgePlayer,140,260,400,11,37,GrudgePlayer
635,GrudgePlayer,178,298,476,27,17,GrudgePlayer
636,GrudgePlayer,142,272,414,13,33,GrudgePlayer
637,GrudgePlayer,138,278,416,12,32,GrudgePlayer
638,GrudgePlayer,135,270,405,13,36,GrudgePlayer
639,GrudgePlayer,163,278,441,25,28,GrudgePlayer
640,GrudgePlayer,154,294,448,17,23,GrudgePlayer
641,GrudgePlayer,156,271,427,17,30,GrudgePlayer
642,GrudgePlayer,127,282,409,11,34,GrudgePlayer
643,GrudgePlayer,139,279,418,11,31,GrudgePlayer
644,GrudgePlayer,167,282,449,21,24,GrudgePlayer
645,GrudgePlayer,150,290,440,12,24,GrudgePlayer
646,GrudgePlayer,186,291,477,31,18,GrudgePlayer
647,GrudgePlayer,148,278,426,16,30,GrudgePlayer
648,GrudgePlayer,150,270,420,13,31,GrudgePlayer
649,GrudgePlayer,144,274,418,17,33,GrudgePlayer
650,GrudgePlayer,170,290,460,23,21,GrudgePlayer
651,GrudgePlayer,144,269,413,18,35,GrudgePlayer
652,GrudgePlayer,173,283,456,25,23,GrudgePlayer
653,GrudgePlayer,153,283,436,17,27,GrudgePlayer
654,GrudgePlayer,163,278,441,22,27,GrudgePlayer
655,GrudgePlayer,160,285,445,20,25,GrudgePlayer
656,GrudgePlayer,178,278,456,25,23,GrudgePlayer
657,GrudgePlayer,135,270,405,13,36,GrudgePlayer
658,GrudgePlayer,148,278,426,16,30,GrudgePlayer
659,GrudgePlayer,140,270,410,12,34,GrudgePlayer
660,GrudgePlayer,145,265,410,15,35,GrudgePlayer
661,GrudgePlayer,176,286,462,22,20,GrudgePlayer
662,GrudgePlayer,142,277,419,15,32,GrudgePlayer
663,GrudgePlayer,147,277,424,11,29,GrudgePlayer
664,GrudgePlayer,151,286,437,15,26,GrudgePlayer
665,GrudgePlayer,126,271,397,14,39,GrudgePlayer
666,GrudgePlayer,185,295,480,28,16,GrudgePlayer
667,GrudgePlayer,165,280,445,29,28,GrudgePlayer
668,GrudgePlayer,137,257,394,14,40,GrudgePlayer
669,GrudgePlayer,148,273,421,17,32,GrudgePlayer
670,GrudgePlayer,155,290,445,17,24,GrudgePlayer
671,GrudgePlayer,155,295,450,22,24,GrudgePlayer
672,GrudgePlayer,138,278,416,12,32,GrudgePlayer
673,GrudgePlayer,156,266,422,18,32,GrudgePlayer
674,GrudgePlayer,172,272,444,28,28,GrudgePlayer
675,GrudgePlayer,141,251,392,18,42,GrudgePlayer
676,GrudgePlayer,132,282,414,10,32,GrudgePlayer
677,GrudgePlayer,140,280,420,13,31,GrudgePlayer
678,GrudgePlayer,162,267,429,22,31,GrudgePlayer
679,GrudgePlayer,149,279,428,12,28,GrudgePlayer
680,GrudgePlayer,139,264,403,14,37,GrudgePlayer
681,GrudgePlayer,154,289,443,18,25,GrudgePlayer
682,GrudgePlayer,135,270,405,16,37,GrudgePlayer
683,GrudgePlayer,153,278,431,18,29,GrudgePlayer
684,GrudgePlayer,169,274,443,24,27,GrudgePlayer
685,GrudgePlayer,153,283,436,26,30,GrudgePlayer
686,GrudgePlayer,121,256,377,12,45,GrudgePlayer
687,GrudgePlayer,154,274,428,15,29,GrudgePlayer
688,GrudgePlayer,156,271,427,23,32,GrudgePlayer
689,GrudgePlayer,144,279,423,16,31,GrudgePlayer
690,GrudgePlayer,173,283,456,25,23,GrudgePlayer
691,GrudgePlayer,158,273,431,21,30,GrudgePlayer
692,GrudgePlayer,140,275,415,14,33,GrudgePlayer
693,GrudgePlayer,144,279,423,13,30,GrudgePlayer
694,GrudgePlayer,162,272,434,24,30,GrudgePlayer
695,GrudgePlayer,183,298,481,29,16,GrudgePlayer
696,GrudgePlayer,166,281,447,19,24,GrudgePlayer
697,GrudgePlayer,133,278,411,10,33,GrudgePlayer
698,GrudgePlayer,148,268,416,18,34,GrudgePlayer
699,GrudgePlayer,153,268,421,20,33,GrudgePlayer
700,GrudgePlayer,147,287,434,15,27,GrudgePlayer
701,GrudgePlayer,152,282,434,18,28,GrudgePlayer
702,GrudgePlayer,163,273,436,17,27,GrudgePlayer
703,GrudgePlayer,155,280,435,19,28,GrudgePlayer
704,GrudgePlayer,157,287,444,19,25,GrudgePlayer
705,GrudgePlayer,149,274,423,10,29,GrudgePlayer
706,GrudgePlayer,158,278,436,20,28,GrudgePlayer
707,GrudgePlayer,166,286,452,21,23,GrudgePlayer
708,GrudgePlayer,158,268,426,19,31,GrudgePlayer
709,GrudgePlayer,138,278,416,12,32,GrudgePlayer
710,GrudgePlayer,165,285,450,19,23,GrudgePlayer
711,GrudgePlayer,162,297,459,19,20,GrudgePlayer
712,GrudgePlayer,150,270,420,19,33,GrudgePlayer
713,GrudgePlayer,148,263,411,19,36,GrudgePlayer
714,GrudgePlayer,173,283,456,22,22,GrudgePlayer
715,GrudgePlayer,146,266,412,17,35,GrudgePlayer
716,GrudgePlayer,149,279,428,15,29,GrudgePlayer
717,GrudgePlayer,171,276,447,22,25,GrudgePlayer
718,GrudgePlayer,151,291,442,17,25,GrudgePlayer
719,GrudgePlayer,190,290,480,31,17,GrudgePlayer
720,GrudgePlayer,168,288,456,22,22,GrudgePlayer
721,GrudgePlayer,164,304,468,19,17,GrudgePlayer
722,GrudgePlayer,168,293,461,21,20,GrudgePlayer
723,GrudgePlayer,150,265,415,17,34,GrudgePlayer
724,GrudgePlayer,152,287,439,11,24,GrudgePlayer
725,GrudgePlayer,167,272,439,23,28,GrudgePlayer
726,GrudgePlayer,155,265,420,19,33,GrudgePlayer
727,GrudgePlayer,156,281,437,18,27,GrudgePlayer
728,GrudgePlayer,155,280,435,16,27,GrudgePlayer
729,GrudgePlayer,132,257,389,9,40,GrudgePlayer
730,GrudgePlayer,146,276,422,15,31,GrudgePlayer
731,GrudgePlayer,167,287,454,20,22,GrudgePlayer
732,GrudgePlayer,154,289,443,24,27,GrudgePlayer
733,GrudgePlayer,148,263,411,13,34,GrudgePlayer
734,GrudgePlayer,154,289,443,12,23,GrudgePlayer
735,GrudgePlayer,141,261,402,13,37,GrudgePlayer
736,GrudgePlayer,148,273,421,14,31,GrudgePlayer
737,GrudgePlayer,144,294,438,13,25,GrudgePlayer
738,GrudgePlayer,136,281,417,10,31,GrudgePlayer
739,GrudgePlayer,143,273,416,18,34,GrudgePlayer
740,GrudgePlayer,171,276,447,28,27,GrudgePlayer
741,GrudgePlayer,164,289,453,25,24,GrudgePlayer
742,GrudgePlayer,170,265,435,25,30,GrudgePlayer
743,GrudgePlayer,136,266,402,13,37,GrudgePlayer
744,GrudgePlayer,162,272,434,24,30,GrudgePlayer
745,GrudgePlayer,152,282,434,18,28,GrudgePlayer
746,GrudgePlayer,138,248,386,9,41,GrudgePlayer
747,GrudgePlayer,148,278,426,16,30,GrudgePlayer
748,GrudgePlayer,142,252,394,17,41,GrudgePlayer
749,GrudgePlayer,145,275,420,13,31,GrudgePlayer
750,GrudgePlayer,159,289,448,20,24,GrudgePlayer
751,GrudgePlayer,131,276,407,12,35,GrudgePlayer
752,GrudgePlayer,141,281,422,12,30,GrudgePlayer
753,GrudgePlayer,173,288,461,24,21,GrudgePlayer
754,GrudgePlayer,157,282,439,17,26,GrudgePlayer
755,GrudgePlayer,181,276,457,26,23,GrudgePlayer
756,GrudgePlayer,160,280,440,21,27,GrudgePlayer
757,GrudgePlayer,135,270,405,13,36,GrudgePlayer
758,GrudgePlayer,146,291,437,18,27,GrudgePlayer
759,GrudgePlayer,167,282,449,18,23,GrudgePlayer
760,GrudgePlayer,152,287,439,14,25,GrudgePlayer
761,GrudgePlayer,149,269,418,14,32,GrudgePlayer
762,GrudgePlayer,163,283,446,24,26,GrudgePlayer
763,GrudgePlayer,141,276,417,16,33,GrudgePlayer
764,GrudgePlayer,151,286,437,18,27,GrudgePlayer
765,GrudgePlayer,164,289,453,19,22,GrudgePlayer
766,GrudgePlayer,139,284,423,16,31,GrudgePlayer
767,GrudgePlayer,167,277,444,28,28,GrudgePlayer
768,GrudgePlayer,120,245,365,6,47,GrudgePlayer
769,GrudgePlayer,137,272,409,11,34,GrudgePlayer
770,GrudgePlayer,154,289,443,18,25,GrudgePlayer
771,GrudgePlayer,164,284,448,20,24,GrudgePlayer
772,GrudgePlayer,140,265,405,10,35,GrudgePlayer
773,GrudgePlayer,140,275,415,17,34,GrudgePlayer
774,GrudgePlayer,166,276,442,20,26,GrudgePlayer
775,GrudgePlayer,156,291,447,22,25,GrudgePlayer
776,GrudgePlayer,154,279,433,17,28,GrudgePlayer
777,GrudgePlayer,145,255,400,14,38,GrudgePlayer
778,GrudgePlayer,155,275,430,17,29,GrudgePlayer
779,GrudgePlayer,152,292,444,19,25,GrudgePlayer
780,GrudgePlayer,151,286,437,15,26,GrudgePlayer
781,GrudgePlayer,150,275,425,18,31,GrudgePlayer
782,GrudgePlayer,158,273,431,15,28,GrudgePlayer
783,GrudgePlayer,141,261,402,16,38,GrudgePlayer
784,GrudgePlayer,142,277,419,12,31,GrudgePlayer
785,GrudgePlayer,144,284,428,15,29,GrudgePlayer
786,GrudgePlayer,171,276,447,22,25,GrudgePlayer
787,GrudgePlayer,117,272,389,6,39,GrudgePlayer
788,GrudgePlayer,180,280,460,26,22,GrudgePlayer
789,GrudgePlayer,200,290,490,35,15,GrudgePlayer
790,GrudgePlayer,170,290,460,26,22,GrudgePlayer
791,GrudgePlayer,140,285,425,15,30,GrudgePlayer
792,GrudgePlayer,145,265,410,18,36,GrudgePlayer
793,GrudgePlayer,173,293,466,29,21,GrudgePlayer
794,GrudgePlayer,160,260,420,19,33,GrudgePlayer
795,GrudgePlayer,162,282,444,22,26,GrudgePlayer
796,GrudgePlayer,146,266,412,17,35,GrudgePlayer
797,GrudgePlayer,143,278,421,14,31,GrudgePlayer
798,GrudgePlayer,155,265,420,19,33,GrudgePlayer
799,GrudgePlayer,156,291,447,19,24,GrudgePlayer
800,GrudgePlayer,158,268,426,19,31,GrudgePlayer
801,GrudgePlayer,139,289,428,12,28,GrudgePlayer
802,GrudgePlayer,143,278,421,14,31,GrudgePlayer
803,GrudgePlayer,161,261,422,21,33,GrudgePlayer
804,GrudgePlayer,159,269,428,15,29,GrudgePlayer
805,GrudgePlayer,158,293,451,17,22,GrudgePlayer
806,GrudgePlayer,134,264,398,12,38,GrudgePlayer
807,GrudgePlayer,160,290,450,19,23,GrudgePlayer
808,GrudgePlayer,140,265,405,7,34,GrudgePlayer
809,GrudgePlayer,160,290,450,19,23,GrudgePlayer
810,GrudgePlayer,160,260,420,22,34,GrudgePlayer
811,GrudgePlayer,165,280,445,20,25,GrudgePlayer
812,GrudgePlayer,117,262,379,11,44,GrudgePlayer
813,GrudgePlayer,160,290,450,13,21,GrudgePlayer
814,GrudgePlayer,174,274,448,29,27,GrudgePlayer
815,GrudgePlayer,168,288,456,25,23,GrudgePlayer
816,GrudgePlayer,188,298,486,28,14,GrudgePlayer
817,GrudgePlayer,157,277,434,24,30,GrudgePlayer
818,GrudgePlayer,169,274,443,24,27,GrudgePlayer
819,GrudgePlayer,139,274,413,18,35,GrudgePlayer
820,GrudgePlayer,158,283,441,16,25,GrudgePlayer
821,GrudgePlayer,155,280,435,19,28,GrudgePlayer
822,GrudgePlayer,158,293,451,20,23,GrudgePlayer
823,GrudgePlayer,164,294,458,21,21,GrudgePlayer
824,GrudgePlayer,158,258,416,24,36,GrudgePlayer
825,GrudgePlayer,133,263,396,13,39,GrudgePlayer
826,GrudgePlayer,158,288,446,15,23,GrudgePlayer
827,GrudgePlayer,160,275,435,25,30,GrudgePlayer
828,GrudgePlayer,178,298,476,27,17,GrudgePlayer
829,GrudgePlayer,187,267,454,32,26,GrudgePlayer
830,GrudgePlayer,166,286,452,21,23,GrudgePlayer
831,GrudgePlayer,157,272,429,22,31,GrudgePlayer
832,GrudgePlayer,173,273,446,27,27,GrudgePlayer
833,GrudgePlayer,163,278,441,25,28,GrudgePlayer
834,GrudgePlayer,157,272,429,16,29,GrudgePlayer
835,GrudgePlayer,150,285,435,16,27,GrudgePlayer
836,GrudgePlayer,160,290,450,22,24,GrudgePlayer
837,GrudgePlayer,160,290,450,19,23,GrudgePlayer
838,GrudgePlayer,159,269,428,15,29,GrudgePlayer
839,GrudgePlayer,140,275,415,14,33,GrudgePlayer
840,GrudgePlayer,172,257,429,28,33,GrudgePlayer
841,GrudgePlayer,186,291,477,31,18,GrudgePlayer
842,GrudgePlayer,162,287,449,21,24,GrudgePlayer
843,GrudgePlayer,128,258,386,12,42,GrudgePlayer
844,GrudgePlayer,153,283,436,17,27,GrudgePlayer
845,GrudgePlayer,160,275,435,19,28,GrudgePlayer
846,GrudgePlayer,163,283,446,21,25,GrudgePlayer
847,GrudgePlayer,146,276,422,12,30,GrudgePlayer
848,GrudgePlayer,147,292,439,20,27,GrudgePlayer
849,GrudgePlayer,137,267,404,9,35,GrudgePlayer
850,GrudgePlayer,151,281,432,19,29,GrudgePlayer
851,GrudgePlayer,161,271,432,22,30,GrudgePlayer
852,GrudgePlayer,147,257,404,15,37,GrudgePlayer
853,GrudgePlayer,112,267,379,8,43,GrudgePlayer
854,GrudgePlayer,150,265,415,20,35,GrudgePlayer
855,GrudgePlayer,143,278,421,11,30,GrudgePlayer
856,GrudgePlayer,126,256,382,8,42,GrudgePlayer
857,GrudgePlayer,136,251,387,13,42,GrudgePlayer
858,GrudgePlayer,145,265,410,12,34,GrudgePlayer
859,GrudgePlayer,163,283,446,27,27,GrudgePlayer
860,GrudgePlayer,143,263,406,11,35,GrudgePlayer
861,GrudgePlayer,123,253,376,8,44,GrudgePlayer
862,GrudgePlayer,138,268,406,14,36,GrudgePlayer
863,GrudgePlayer,138,273,411,13,34,GrudgePlayer
864,GrudgePlayer,170,290,460,23,21,GrudgePlayer
865,GrudgePlayer,150,280,430,17,29,GrudgePlayer
866,GrudgePlayer,140,270,410,15,35,GrudgePlayer
867,GrudgePlayer,164,279,443,21,26,GrudgePlayer
868,GrudgePlayer,169,289,458,27,23,GrudgePlayer
869,GrudgePlayer,145,265,410,12,34,GrudgePlayer
870,GrudgePlayer,151,276,427,20,31,GrudgePlayer
871,GrudgePlayer,173,288,461,24,21,GrudgePlayer
872,GrudgePlayer,173,283,456,25,23,GrudgePlayer
873,GrudgePlayer,168,268,436,23,29,GrudgePlayer
874,GrudgePlayer,151,271,422,21,33,GrudgePlayer
875,GrudgePlayer,156,296,452,21,23,GrudgePlayer
876,GrudgePlayer,163,273,436,20,28,GrudgePlayer
877,GrudgePlayer,150,280,430,17,29,GrudgePlayer
878,GrudgePlayer,143,263,406,14,36,GrudgePlayer
879,GrudgePlayer,164,284,448,17,23,GrudgePlayer
880,GrudgePlayer,154,269,423,19,32,GrudgePlayer
881,GrudgePlayer,163,278,441,25,28,GrudgePlayer
882,GrudgePlayer,154,274,428,15,29,GrudgePlayer
883,GrudgePlayer,125,275,400,11,37,GrudgePlayer
884,GrudgePlayer,144,264,408,16,36,GrudgePlayer
885,GrudgePlayer,145,280,425,15,30,GrudgePlayer
886,GrudgePlayer,156,276,432,22,30,GrudgePlayer
887,GrudgePlayer,160,280,440,21,27,GrudgePlayer
888,GrudgePlayer,148,273,421,14,31,GrudgePlayer
889,GrudgePlayer,159,264,423,16,31,GrudgePlayer
890,GrudgePlayer,177,292,469,32,21,GrudgePlayer
891,GrudgePlayer,161,281,442,23,27,GrudgePlayer
892,GrudgePlayer,160,290,450,19,23,GrudgePlayer
893,GrudgePlayer,151,256,407,18,37,GrudgePlayer
894,GrudgePlayer,136,276,412,11,33,GrudgePlayer
895,GrudgePlayer,140,270,410,12,34,GrudgePlayer
896,GrudgePlayer,140,270,410,18,36,GrudgePlayer
897,GrudgePlayer,136,281,417,10,31,GrudgePlayer
898,GrudgePlayer,137,262,399,13,38,GrudgePlayer
899,GrudgePlayer,141,261,402,13,37,GrudgePlayer
900,GrudgePlayer,150,280,430,17,29,GrudgePlayer
901,GrudgePlayer,133,283,416,9,31,GrudgePlayer
902,GrudgePlayer,162,282,444,16,24,GrudgePlayer
903,GrudgePlayer,154,269,423,19,32,GrudgePlayer
904,GrudgePlayer,132,282,414,13,33,GrudgePlayer
905,GrudgePlayer,157,282,439,20,27,GrudgePlayer
906,GrudgePlayer,125,270,395,9,38,GrudgePlayer
907,GrudgePlayer,159,279,438,16,26,GrudgePlayer
908,GrudgePlayer,148,278,426,16,30,GrudgePlayer
909,GrudgePlayer,168,283,451,23,24,GrudgePlayer
910,GrudgePlayer,157,272,429,10,27,GrudgePlayer
911,GrudgePlayer,167,292,459,22,21,GrudgePlayer
912,GrudgePlayer,123,268,391,8,39,GrudgePlayer
913,GrudgePlayer,139,254,393,16,41,GrudgePlayer
914,GrudgePlayer,164,274,438,22,28,GrudgePlayer
915,GrudgePlayer,153,273,426,16,30,GrudgePlayer
916,GrudgePlayer,175,300,475,23,16,GrudgePlayer
917,GrudgePlayer,168,283,451,23,24,GrudgePlayer
918,GrudgePlayer,146,276,422,15,31,GrudgePlayer
919,GrudgePlayer,144,254,398,18,40,GrudgePlayer
920,GrudgePlayer,149,279,428,21,31,GrudgePlayer
921,GrudgePlayer,147,282,429,19,30,GrudgePlayer
922,GrudgePlayer,165,290,455,24,23,GrudgePlayer
923,GrudgePlayer,171,286,457,23,22,GrudgePlayer
924,GrudgePlayer,157,277,434,21,29,GrudgePlayer
925,GrudgePlayer,159,284,443,18,25,GrudgePlayer
926,GrudgePlayer,130,260,390,10,40,GrudgePlayer
927,GrudgePlayer,170,290,460,23,21,GrudgePlayer
928,GrudgePlayer,149,289,438,16,26,GrudgePlayer
929,GrudgePlayer,144,274,418,17,33,GrudgePlayer
930,GrudgePlayer,133,273,406,11,35,GrudgePlayer
931,GrudgePlayer,197,302,499,32,11,GrudgePlayer
932,GrudgePlayer,136,276,412,11,33,GrudgePlayer
933,GrudgePlayer,134,269,403,14,37,GrudgePlayer
934,GrudgePlayer,123,268,391,11,40,GrudgePlayer
935,GrudgePlayer,120,265,385,5,40,GrudgePlayer
936,GrudgePlayer,151,271,422,21,33,GrudgePlayer
937,GrudgePlayer,150,270,420,16,32,GrudgePlayer
938,GrudgePlayer,149,254,403,14,37,GrudgePlayer
939,GrudgePlayer,183,288,471,31,20,GrudgePlayer
940,GrudgePlayer,154,289,443,15,24,GrudgePlayer
941,GrudgePlayer,152,262,414,13,33,GrudgePlayer
942,GrudgePlayer,158,278,436,17,27,GrudgePlayer
943,GrudgePlayer,166,301,467,15,16,GrudgePlayer
944,GrudgePlayer,137,287,424,11,29,GrudgePlayer
945,GrudgePlayer,159,264,423,19,32,GrudgePlayer
946,GrudgePlayer,138,258,396,16,40,GrudgePlayer
947,GrudgePlayer,145,265,410,15,35,GrudgePlayer
948,GrudgePlayer,154,289,443,18,25,GrudgePlayer
949,GrudgePlayer,125,275,400,5,35,GrudgePlayer
950,GrudgePlayer,159,279,438,16,26,GrudgePlayer
951,GrudgePlayer,160,275,435,19,28,GrudgePlayer
952,GrudgePlayer,139,249,388,14,42,GrudgePlayer
953,GrudgePlayer,148,273,421,14,31,GrudgePlayer
954,GrudgePlayer,134,264,398,9,37,GrudgePlayer
955,GrudgePlayer,148,293,441,16,25,GrudgePlayer
956,GrudgePlayer,142,257,399,16,39,GrudgePlayer
957,GrudgePlayer,166,276,442,23,27,GrudgePlayer
958,GrudgePlayer,137,267,404,15,37,GrudgePlayer
959,GrudgePlayer,143,263,406,11,35,GrudgePlayer
960,GrudgePlayer,178,303,481,29,16,GrudgePlayer
961,GrudgePlayer,168,273,441,19,26,GrudgePlayer
962,GrudgePlayer,138,273,411,19,36,GrudgePlayer
963,GrudgePlayer,157,287,444,16,24,GrudgePlayer
964,GrudgePlayer,161,291,452,18,22,GrudgePlayer
965,GrudgePlayer,167,277,444,22,26,GrudgePlayer
966,GrudgePlayer,144,279,423,16,31,GrudgePlayer
967,GrudgePlayer,184,284,468,34,22,GrudgePlayer
968,GrudgePlayer,137,282,419,12,31,GrudgePlayer
969,GrudgePlayer,141,266,407,12,35,GrudgePlayer
970,GrudgePlayer,153,288,441,19,26,GrudgePlayer
971,GrudgePlayer,153,273,426,16,30,GrudgePlayer
972,GrudgePlayer,161,266,427,26,33,GrudgePlayer
973,GrudgePlayer,166,286,452,15,21,GrudgePlayer
974,GrudgePlayer,145,275,420,19,33,GrudgePlayer
975,GrudgePlayer,169,294,463,23,20,GrudgePlayer
976,GrudgePlayer,155,280,435,19,28,GrudgePlayer
977,GrudgePlayer,135,280,415,14,33,GrudgePlayer
978,GrudgePlayer,155,275,430,26,32,GrudgePlayer
979,GrudgePlayer,142,282,424,11,29,GrudgePlayer
980,GrudgePlayer,151,281,432,16,28,GrudgePlayer
981,GrudgePlayer,142,292,434,12,26,GrudgePlayer
982,GrudgePlayer,163,283,446,21,25,GrudgePlayer
983,GrudgePlayer,145,280,425,15,30,GrudgePlayer
984,GrudgePlayer,135,260,395,12,39,GrudgePlayer
985,GrudgePlayer,153,273,426,16,30,GrudgePlayer
986,GrudgePlayer,156,271,427,23,32,GrudgePlayer
987,GrudgePlayer,170,275,445,20,25,GrudgePlayer
988,GrudgePlayer,168,278,446,24,26,GrudgePlayer
989,GrudgePlayer,165,260,425,24,33,GrudgePlayer
990,GrudgePlayer,161,296,457,20,21,GrudgePlayer
991,GrudgePlayer,166,271,437,24,29,GrudgePlayer
992,GrudgePlayer,139,269,408,13,35,GrudgePlayer
993,GrudgePlayer,142,277,419,12,31,GrudgePlayer
994,GrudgePlayer,148,278,426,16,30,GrudgePlayer
995,GrudgePlayer,123,263,386,9,41,GrudgePlayer
996,GrudgePlayer,162,282,444,19,25,GrudgePlayer
997,GrudgePlayer,160,295,455,21,22,GrudgePlayer
998,GrudgePlayer,168,283,451,20,23,GrudgePlayer
999,GrudgePlayer,171,291,462,25,21,GrudgePlayer
1000,GrudgePlayer,166,276,442,23,27,GrudgePlayer
1001,GrudgePlayer,148,283,431,15,28,GrudgePlayer
1002,GrudgePlayer,164,279,443,27,28,GrudgePlayer
1003,GrudgePlayer,159,284,443,21,26,GrudgePlayer
1004,GrudgePlayer,158,278,436,20,28,GrudgePlayer
1005,GrudgePlayer,142,277,419,12,31,GrudgePlayer
1006,GrudgePlayer,151,261,412,17,35,GrudgePlayer
1007,GrudgePlayer,144,264,408,16,36,GrudgePlayer
1008,GrudgePlayer,154,269,423,19,32,GrudgePlayer
1009,GrudgePlayer,163,283,446,21,25,GrudgePlayer
1010,GrudgePlayer,155,260,415,23,36,GrudgePlayer
1011,GrudgePlayer,173,278,451,26,25,GrudgePlayer
1012,GrudgePlayer,178,278,456,28,24,GrudgePlayer
1013,GrudgePlayer,142,252,394,11,39,GrudgePlayer
1014,GrudgePlayer,175,275,450,31,27,GrudgePlayer
1015,GrudgePlayer,141,266,407,15,36,GrudgePlayer
1016,GrudgePlayer,139,289,428,12,28,GrudgePlayer
1017,GrudgePlayer,143,263,406,14,36,GrudgePlayer
1018,GrudgePlayer,130,270,400,14,38,GrudgePlayer
1019,GrudgePlayer,146,301,447,10,21,GrudgePlayer
1020,GrudgePlayer,178,293,471,28,19,GrudgePlayer
1021,GrudgePlayer,129,254,383,12,43,GrudgePlayer
1022,GrudgePlayer,162,267,429,19,30,GrudgePlayer
1023,GrudgePlayer,156,281,437,18,27,GrudgePlayer
1024,GrudgePlayer,157,282,439,20,27,GrudgePlayer
1025,GrudgePlayer,169,294,463,26,21,GrudgePlayer
1026,GrudgePlayer,161,281,442,20,26,GrudgePlayer
1027,GrudgePlayer,146,266,412,14,34,GrudgePlayer
1028,GrudgePlayer,163,268,431,24,31,GrudgePlayer
1029,GrudgePlayer,167,267,434,24,30,GrudgePlayer
1030,GrudgePlayer,159,269,428,18,30,GrudgePlayer
1031,GrudgePlayer,151,276,427,20,31,GrudgePlayer
1032,GrudgePlayer,185,290,475,29,18,GrudgePlayer
1033,GrudgePlayer,138,278,416,15,33,GrudgePlayer
1034,GrudgePlayer,155,265,420,22,34,GrudgePlayer
1035,GrudgePlayer,160,265,425,21,32,GrudgePlayer
1036,GrudgePlayer,142,267,409,14,35,GrudgePlayer
1037,GrudgePlayer,139,244,383,15,44,GrudgePlayer
1038,GrudgePlayer,163,273,436,23,29,GrudgePlayer
1039,GrudgePlayer,161,271,432,19,29,GrudgePlayer
1040,GrudgePlayer,166,296,462,19,19,GrudgePlayer
1041,GrudgePlayer,154,269,423,19,32,GrudgePlayer
1042,GrudgePlayer,171,291,462,25,21,GrudgePlayer
1043,GrudgePlayer,131,276,407,12,35,GrudgePlayer
1044,GrudgePlayer,158,283,441,19,26,GrudgePlayer
1045,GrudgePlayer,179,294,473,30,19,GrudgePlayer
1046,GrudgePlayer,142,267,409,14,35,GrudgePlayer
1047,GrudgePlayer,137,257,394,14,40,GrudgePlayer
1048,GrudgePlayer,149,284,433,14,27,GrudgePlayer
1049,GrudgePlayer,142,282,424,14,30,GrudgePlayer
1050,GrudgePlayer,162,287,449,21,24,GrudgePlayer
1051,GrudgePlayer,133,278,411,7,32,GrudgePlayer
1052,GrudgePlayer,160,265,425,21,32,GrudgePlayer
1053,GrudgePlayer,137,257,394,11,39,GrudgePlayer
1054,GrudgePlayer,148,283,431,18,29,GrudgePlayer
1055,GrudgePlayer,162,262,424,26,34,GrudgePlayer
1056,GrudgePlayer,173,283,456,28,24,GrudgePlayer
1057,GrudgePlayer,138,253,391,14,41,GrudgePlayer
1058,GrudgePlayer,173,293,466,29,21,GrudgePlayer
1059,GrudgePlayer,138,258,396,13,39,GrudgePlayer
1060,GrudgePlayer,145,270,415,17,34,GrudgePlayer
1061,GrudgePlayer,156,276,432,16,28,GrudgePlayer
1062,GrudgePlayer,141,281,422,12,30,GrudgePlayer
1063,GrudgePlayer,172,277,449,24,25,GrudgePlayer
1064,GrudgePlayer,138,288,426,19,31,GrudgePlayer
1065,GrudgePlayer,166,271,437,27,30,GrudgePlayer
1066,GrudgePlayer,161,266,427,17,30,GrudgePlayer
1067,GrudgePlayer,159,274,433,20,29,GrudgePlayer
1068,GrudgePlayer,135,275,410,15,35,GrudgePlayer
1069,GrudgePlayer,153,283,436,11,25,GrudgePlayer
1070,GrudgePlayer,148,268,416,15,33,GrudgePlayer
1071,GrudgePlayer,129,289,418,14,32,GrudgePlayer
1072,GrudgePlayer,164,284,448,20,24,GrudgePlayer
1073,GrudgePlayer,140,285,425,15,30,GrudgePlayer
1074,GrudgePlayer,128,273,401,9,36,GrudgePlayer
1075,GrudgePlayer,139,279,418,11,31,GrudgePlayer
1076,GrudgePlayer,143,278,421,11,30,GrudgePlayer
1077,GrudgePlayer,153,278,431,15,28,GrudgePlayer
1078,GrudgePlayer,175,290,465,25,20,GrudgePlayer
1079,GrudgePlayer,144,259,403,14,37,GrudgePlayer
1080,GrudgePlayer,168,283,451,23,24,GrudgePlayer
1081,GrudgePlayer,181,281,462,31,23,GrudgePlayer
1082,GrudgePlayer,138,253,391,17,42,GrudgePlayer
1083,GrudgePlayer,150,265,415,14,33,GrudgePlayer
1084,GrudgePlayer,158,278,436,17,27,GrudgePlayer
1085,GrudgePlayer,140,260,400,17,39,GrudgePlayer
1086,GrudgePlayer,143,268,411,13,34,GrudgePlayer
1087,GrudgePlayer,120,260,380,9,43,GrudgePlayer
1088,GrudgePlayer,148,278,426,16,30,GrudgePlayer
1089,GrudgePlayer,157,277,434,21,29,GrudgePlayer
1090,GrudgePlayer,151,286,437,15,26,GrudgePlayer
1091,GrudgePlayer,157,272,429,19,30,GrudgePlayer
1092,GrudgePlayer,169,279,448,23,25,GrudgePlayer
1093,GrudgePlayer,151,276,427,14,29,GrudgePlayer
1094,GrudgePlayer,129,279,408,10,34,GrudgePlayer
1095,GrudgePlayer,129,289,418,8,30,GrudgePlayer
1096,GrudgePlayer,130,280,410,9,33,GrudgePlayer
1097,GrudgePlayer,160,255,415,17,34,GrudgePlayer
1098,GrudgePlayer,166,281,447,19,24,GrudgePlayer
1099,GrudgePlayer,172,287,459,25,22,GrudgePlayer
1100,GrudgePlayer,154,274,428,15,29,GrudgePlayer
1101,GrudgePlayer,161,301,462,19,19,GrudgePlayer
1102,GrudgePlayer,155,280,435,25,30,GrudgePlayer
1103,GrudgePlayer,169,284,453,22,23,GrudgePlayer
1104,GrudgePlayer,143,273,416,12,32,GrudgePlayer
1105,GrudgePlayer,170,270,440,27,29,GrudgePlayer
1106,GrudgePlayer,144,259,403,17,38,GrudgePlayer
1107,GrudgePlayer,157,262,419,18,33,GrudgePlayer
1108,GrudgePlayer,159,299,458,18,20,GrudgePlayer
1109,GrudgePlayer,181,301,482,30,16,GrudgePlayer
1110,GrudgePlayer,135,270,405,10,35,GrudgePlayer
1111,GrudgePlayer,180,280,460,26,22,GrudgePlayer
1112,GrudgePlayer,158,288,446,21,25,GrudgePlayer
1113,GrudgePlayer,144,304,448,11,21,GrudgePlayer
1114,GrudgePlayer,196,281,477,40,21,GrudgePlayer
1115,GrudgePlayer,163,278,441,19,26,GrudgePlayer
1116,GrudgePlayer,125,275,400,11,37,GrudgePlayer
1117,GrudgePlayer,137,282,419,12,31,GrudgePlayer
1118,GrudgePlayer,132,267,399,13,38,GrudgePlayer
1119,GrudgePlayer,121,266,387,7,40,GrudgePlayer
1120,GrudgePlayer,167,287,454,20,22,GrudgePlayer
1121,GrudgePlayer,153,268,421,20,33,GrudgePlayer
1122,GrudgePlayer,162,282,444,22,26,GrudgePlayer
1123,GrudgePlayer,150,265,415,17,34,GrudgePlayer
1124,GrudgePlayer,151,271,422,15,31,GrudgePlayer
1125,GrudgePlayer,175,285,460,29,23,GrudgePlayer
1126,GrudgePlayer,148,263,411,16,35,GrudgePlayer
1127,GrudgePlayer,145,280,425,15,30,GrudgePlayer
1128,GrudgePlayer,159,279,438,13,25,GrudgePlayer
1129,GrudgePlayer,168,268,436,26,30,GrudgePlayer
1130,GrudgePlayer,165,285,450,22,24,GrudgePlayer
1131,GrudgePlayer,163,273,436,26,30,GrudgePlayer
1132,GrudgePlayer,163,278,441,25,28,GrudgePlayer
1133,GrudgePlayer,164,279,443,21,26,GrudgePlayer
1134,GrudgePlayer,168,273,441,25,28,GrudgePlayer
1135,GrudgePlayer,152,277,429,19,30,GrudgePlayer
1136,GrudgePlayer,146,281,427,14,29,GrudgePlayer
1137,GrudgePlayer,178,293,471,28,19,GrudgePlayer
1138,GrudgePlayer,140,275,415,14,33,GrudgePlayer
1139,GrudgePlayer,154,274,428,12,28,GrudgePlayer
1140,GrudgePlayer,159,299,458,21,21,GrudgePlayer
1141,GrudgePlayer,145,260,405,19,38,GrudgePlayer
1142,GrudgePlayer,170,270,440,27,29,GrudgePlayer
1143,GrudgePlayer,142,282,424,14,30,GrudgePlayer
1144,GrudgePlayer,157,257,414,19,35,GrudgePlayer
1145,GrudgePlayer,153,288,441,13,24,GrudgePlayer
1146,GrudgePlayer,127,272,399,7,36,GrudgePlayer
1147,GrudgePlayer,164,274,438,22,28,GrudgePlayer
1148,GrudgePlayer,142,267,409,14,35,GrudgePlayer
1149,GrudgePlayer,157,272,429,19,30,GrudgePlayer
1150,GrudgePlayer,145,265,410,12,34,GrudgePlayer
1151,GrudgePlayer,130,280,410,9,33,GrudgePlayer
1152,GrudgePlayer,147,282,429,13,28,GrudgePlayer
1153,GrudgePlayer,131,266,397,14,39,GrudgePlayer
1154,GrudgePlayer,139,269,408,10,34,GrudgePlayer
1155,GrudgePlayer,150,285,435,19,28,GrudgePlayer
1156,GrudgePlayer,140,275,415,11,32,GrudgePlayer
1157,GrudgePlayer,141,271,412,11,33,GrudgePlayer
1158,GrudgePlayer,141,276,417,13,32,GrudgePlayer
1159,GrudgePlayer,132,257,389,12,41,GrudgePlayer
1160,GrudgePlayer,148,273,421,20,33,GrudgePlayer
1161,GrudgePlayer,141,266,407,15,36,GrudgePlayer
1162,GrudgePlayer,159,294,453,19,22,GrudgePlayer
1163,GrudgePlayer,137,272,409,14,35,GrudgePlayer
1164,GrudgePlayer,147,282,429,13,28,GrudgePlayer
1165,GrudgePlayer,126,261,387,10,41,GrudgePlayer
1166,GrudgePlayer,192,292,484,35,17,GrudgePlayer
1167,GrudgePlayer,139,279,418,14,32,GrudgePlayer
1168,GrudgePlayer,168,283,451,23,24,GrudgePlayer
1169,GrudgePlayer,141,271,412,11,33,GrudgePlayer
1170,GrudgePlayer,179,289,468,28,20,GrudgePlayer
1171,GrudgePlayer,175,285,460,26,22,GrudgePlayer
1172,GrudgePlayer,140,260,400,11,37,GrudgePlayer
1173,GrudgePlayer,161,276,437,24,29,GrudgePlayer
1174,GrudgePlayer,178,283,461,27,22,GrudgePlayer
1175,GrudgePlayer,161,246,407,24,39,GrudgePlayer
1176,GrudgePlayer,144,289,433,14,27,GrudgePlayer
1177,GrudgePlayer,161,281,442,20,26,GrudgePlayer
1178,GrudgePlayer,178,283,461,30,23,GrudgePlayer
1179,GrudgePlayer,148,278,426,10,28,GrudgePlayer
1180,GrudgePlayer,153,273,426,19,31,GrudgePlayer
1181,GrudgePlayer,172,287,459,22,21,GrudgePlayer
1182,GrudgePlayer,154,289,443,21,26,GrudgePlayer
1183,GrudgePlayer,157,272,429,19,30,GrudgePlayer
1184,GrudgePlayer,167,272,439,20,27,GrudgePlayer
1185,GrudgePlayer,125,265,390,7,39,GrudgePlayer
1186,GrudgePlayer,172,302,474,28,18,GrudgePlayer
1187,GrudgePlayer,144,254,398,15,39,GrudgePlayer
1188,GrudgePlayer,127,272,399,7,36,GrudgePlayer
1189,GrudgePlayer,152,272,424,20,32,GrudgePlayer
1190,GrudgePlayer,164,304,468,19,17,GrudgePlayer
1191,GrudgePlayer,149,274,423,22,33,GrudgePlayer
1192,GrudgePlayer,174,284,458,24,22,GrudgePlayer
1193,GrudgePlayer,135,280,415,11,32,GrudgePlayer
1194,GrudgePlayer,148,273,421,17,32,GrudgePlayer
1195,GrudgePlayer,138,278,416,12,32,GrudgePlayer
1196,GrudgePlayer,143,263,406,17,37,GrudgePlayer
1197,GrudgePlayer,126,266,392,9,39,GrudgePlayer
1198,GrudgePlayer,133,293,426,13,29,GrudgePlayer
1199,GrudgePlayer,150,255,405,19,38,GrudgePlayer
1200,GrudgePlayer,164,289,453,22,23,GrudgePlayer
1201,GrudgePlayer,177,287,464,21,19,GrudgePlayer
1202,GrudgePlayer,162,282,444,19,25,GrudgePlayer
1203,GrudgePlayer,157,277,434,18,28,GrudgePlayer
1204,GrudgePlayer,150,285,435,13,26,GrudgePlayer
1205,GrudgePlayer,146,281,427,14,29,GrudgePlayer
1206,GrudgePlayer,154,274,428,21,31,GrudgePlayer
1207,GrudgePlayer,156,276,432,16,28,GrudgePlayer
1208,GrudgePlayer,141,271,412,14,34,GrudgePlayer
1209,GrudgePlayer,157,292,449,24,25,GrudgePlayer
1210,GrudgePlayer,152,277,429,13,28,GrudgePlayer
1211,GrudgePlayer,150,270,420,16,32,GrudgePlayer
1212,GrudgePlayer,139,264,403,17,38,GrudgePlayer
1213,GrudgePlayer,147,277,424,11,29,GrudgePlayer
1214,GrudgePlayer,146,271,417,16,33,GrudgePlayer
1215,GrudgePlayer,126,286,412,8,32,GrudgePlayer
1216,GrudgePlayer,158,268,426,19,31,GrudgePlayer
1217,GrudgePlayer,159,274,433,20,29,GrudgePlayer
1218,GrudgePlayer,145,285,430,17,29,GrudgePlayer
1219,GrudgePlayer,149,274,423,13,30,GrudgePlayer
1220,GrudgePlayer,148,268,416,15,33,GrudgePlayer
1221,GrudgePlayer,118,268,386,12,42,GrudgePlayer
1222,GrudgePlayer,155,280,435,16,27,GrudgePlayer
1223,GrudgePlayer,149,289,438,13,25,GrudgePlayer
1224,GrudgePlayer,170,270,440,24,28,GrudgePlayer
1225,GrudgePlayer,126,271,397,14,39,GrudgePlayer
1226,GrudgePlayer,136,246,382,14,44,GrudgePlayer
1227,GrudgePlayer,156,296,452,15,21,GrudgePlayer
1228,GrudgePlayer,149,289,438,10,24,GrudgePlayer
1229,GrudgePlayer,169,269,438,25,29,GrudgePlayer
1230,GrudgePlayer,179,284,463,26,21,GrudgePlayer
1231,GrudgePlayer,138,273,411,16,35,GrudgePlayer
1232,GrudgePlayer,143,268,411,16,35,GrudgePlayer
1233,GrudgePlayer,158,273,431,18,29,GrudgePlayer
1234,GrudgePlayer,157,282,439,17,26,GrudgePlayer
1235,GrudgePlayer,169,269,438,25,29,GrudgePlayer
1236,GrudgePlayer,117,242,359,6,49,GrudgePlayer
1237,GrudgePlayer,140,245,385,14,43,GrudgePlayer
1238,GrudgePlayer,166,286,452,18,22,GrudgePlayer
1239,GrudgePlayer,154,274,428,21,31,GrudgePlayer
1240,GrudgePlayer,174,294,468,25,19,GrudgePlayer
1241,GrudgePlayer,137,267,404,12,36,GrudgePlayer
1242,GrudgePlayer,113,273,386,9,41,GrudgePlayer
1243,GrudgePlayer,150,270,420,19,33,GrudgePlayer
1244,GrudgePlayer,138,268,406,11,35,GrudgePlayer
1245,GrudgePlayer,166,281,447,22,25,GrudgePlayer
1246,GrudgePlayer,171,286,457,29,24,GrudgePlayer
1247,GrudgePlayer,153,273,426,19,31,GrudgePlayer
1248,GrudgePlayer,177,292,469,26,19,GrudgePlayer
1249,GrudgePlayer,148,283,431,15,28,GrudgePlayer
1250,GrudgePlayer,120,245,365,9,48,GrudgePlayer
1251,GrudgePlayer,149,284,433,17,28,GrudgePlayer
1252,GrudgePlayer,144,284,428,18,30,GrudgePlayer
1253,GrudgePlayer,155,265,420,22,34,GrudgePlayer
1254,GrudgePlayer,164,274,438,19,27,GrudgePlayer
1255,GrudgePlayer,171,266,437,24,29,GrudgePlayer
1256,GrudgePlayer,142,277,419,15,32,GrudgePlayer
1257,GrudgePlayer,180,280,460,29,23,GrudgePlayer
1258,GrudgePlayer,154,274,428,21,31,GrudgePlayer
1259,GrudgePlayer,151,281,432,19,29,GrudgePlayer
1260,GrudgePlayer,163,288,451,20,23,GrudgePlayer
1261,GrudgePlayer,161,281,442,17,25,GrudgePlayer
1262,GrudgePlayer,142,257,399,13,38,GrudgePlayer
1263,GrudgePlayer,159,279,438,19,27,GrudgePlayer
1264,GrudgePlayer,148,283,431,15,28,GrudgePlayer
1265,GrudgePlayer,155,290,445,20,25,GrudgePlayer
1266,GrudgePlayer,159,279,438,22,28,GrudgePlayer
1267,GrudgePlayer,168,283,451,23,24,GrudgePlayer
1268,GrudgePlayer,166,286,452,21,23,GrudgePlayer
1269,GrudgePlayer,148,283,431,18,29,GrudgePlayer
1270,GrudgePlayer,145,240,385,14,43,GrudgePlayer
1271,GrudgePlayer,152,272,424,23,33,GrudgePlayer
1272,GrudgePlayer,164,279,443,18,25,GrudgePlayer
1273,GrudgePlayer,142,262,404,12,36,GrudgePlayer
1274,GrudgePlayer,157,272,429,19,30,GrudgePlayer
1275,GrudgePlayer,140,260,400,14,38,GrudgePlayer
1276,GrudgePlayer,134,259,393,13,40,GrudgePlayer
1277,GrudgePlayer,162,277,439,17,26,GrudgePlayer
1278,GrudgePlayer,142,287,429,13,28,GrudgePlayer
1279,GrudgePlayer,160,285,445,17,24,GrudgePlayer
1280,GrudgePlayer,145,265,410,9,33,GrudgePlayer
1281,GrudgePlayer,127,267,394,14,40,GrudgePlayer
1282,GrudgePlayer,139,264,403,11,36,GrudgePlayer
1283,GrudgePlayer,133,248,381,7,42,GrudgePlayer
1284,GrudgePlayer,175,295,470,24,18,GrudgePlayer
1285,GrudgePlayer,164,274,438,22,28,GrudgePlayer
1286,GrudgePlayer,150,290,440,21,27,GrudgePlayer
1287,GrudgePlayer,158,268,426,19,31,GrudgePlayer
1288,GrudgePlayer,159,289,448,20,24,GrudgePlayer
1289,GrudgePlayer,135,265,400,11,37,GrudgePlayer
1290,GrudgePlayer,162,272,434,21,29,GrudgePlayer
1291,GrudgePlayer,160,285,445,23,26,GrudgePlayer
1292,GrudgePlayer,158,278,436,17,27,GrudgePlayer
1293,GrudgePlayer,159,284,443,21,26,GrudgePlayer
1294,GrudgePlayer,167,282,449,21,24,GrudgePlayer
1295,GrudgePlayer,168,268,436,23,29,GrudgePlayer
1296,GrudgePlayer,139,284,423,10,29,GrudgePlayer
1297,GrudgePlayer,166,281,447,25,26,GrudgePlayer
1298,GrudgePlayer,159,259,418,23,35,GrudgePlayer
1299,GrudgePlayer,177,287,464,30,22,GrudgePlayer
1300,GrudgePlayer,126,271,397,8,37,GrudgePlayer
1301,GrudgePlayer,163,278,441,13,24,GrudgePlayer
1302,GrudgePlayer,159,284,443,21,26,GrudgePlayer
1303,GrudgePlayer,118,273,391,5,38,GrudgePlayer
1304,GrudgePlayer,148,263,411,19,36,GrudgePlayer
1305,GrudgePlayer,167,292,459,19,20,GrudgePlayer
1306,GrudgePlayer,133,258,391,17,42,GrudgePlayer
1307,GrudgePlayer,157,292,449,18,23,GrudgePlayer
1308,GrudgePlayer,135,255,390,13,41,GrudgePlayer
1309,GrudgePlayer,121,251,372,7,45,GrudgePlayer
1310,GrudgePlayer,148,293,441,16,25,GrudgePlayer
1311,GrudgePlayer,153,283,436,17,27,GrudgePlayer
1312,GrudgePlayer,152,272,424,17,31,GrudgePlayer
1313,GrudgePlayer,155,285,440,21,27,GrudgePlayer
1314,GrudgePlayer,172,267,439,32,31,GrudgePlayer
1315,GrudgePlayer,153,263,416,18,34,GrudgePlayer
1316,GrudgePlayer,133,283,416,9,31,GrudgePlayer
1317,GrudgePlayer,151,286,437,18,27,GrudgePlayer
1318,GrudgePlayer,174,279,453,22,23,GrudgePlayer
1319,GrudgePlayer,166,276,442,23,27,GrudgePlayer
1320,GrudgePlayer,166,296,462,28,22,GrudgePlayer
1321,GrudgePlayer,162,272,434,21,29,GrudgePlayer
1322,GrudgePlayer,130,255,385,11,42,GrudgePlayer
1323,GrudgePlayer,132,277,409,5,32,GrudgePlayer
1324,GrudgePlayer,164,269,433,23,30,GrudgePlayer
1325,GrudgePlayer,172,282,454,23,23,GrudgePlayer
1326,GrudgePlayer,172,297,469,26,19,GrudgePlayer
1327,GrudgePlayer,143,278,421,11,30,GrudgePlayer
1328,GrudgePlayer,147,277,424,14,30,GrudgePlayer
1329,GrudgePlayer,152,262,414,16,34,GrudgePlayer
1330,GrudgePlayer,139,274,413,18,35,GrudgePlayer
1331,GrudgePlayer,159,269,428,24,32,GrudgePlayer
1332,GrudgePlayer,171,286,457,20,21,GrudgePlayer
1333,GrudgePlayer,169,279,448,23,25,GrudgePlayer
1334,GrudgePlayer,154,259,413,21,36,GrudgePlayer
1335,GrudgePlayer,130,265,395,12,39,GrudgePlayer
1336,GrudgePlayer,135,275,410,12,34,GrudgePlayer
1337,GrudgePlayer,161,276,437,15,26,GrudgePlayer
1338,GrudgePlayer,138,273,411,13,34,GrudgePlayer
1339,GrudgePlayer,167,287,454,23,23,GrudgePlayer
1340,GrudgePlayer,162,272,434,15,27,GrudgePlayer
1341,GrudgePlayer,150,285,435,16,27,GrudgePlayer
1342,GrudgePlayer,153,283,436,17,27,GrudgePlayer
1343,GrudgePlayer,155,270,425,18,31,GrudgePlayer
1344,GrudgePlayer,136,261,397,14,39,GrudgePlayer
1345,GrudgePlayer,147,257,404,15,37,GrudgePlayer
1346,GrudgePlayer,147,267,414,16,34,GrudgePlayer
1347,GrudgePlayer,164,269,433,23,30,GrudgePlayer
1348,GrudgePlayer,154,269,423,22,33,GrudgePlayer
1349,GrudgePlayer,153,288,441,16,25,GrudgePlayer
1350,GrudgePlayer,144,259,403,14,37,GrudgePlayer
1351,GrudgePlayer,153,273,426,19,31,GrudgePlayer
1352,GrudgePlayer,146,241,387,16,43,GrudgePlayer
1353,GrudgePlayer,154,279,433,20,29,GrudgePlayer
1354,GrudgePlayer,154,259,413,18,35,GrudgePlayer
1355,GrudgePlayer,160,280,440,24,28,GrudgePlayer
1356,GrudgePlayer,156,291,447,13,22,GrudgePlayer
1357,GrudgePlayer,181,271,452,30,26,GrudgePlayer
1358,GrudgePlayer,162,262,424,20,32,GrudgePlayer
1359,GrudgePlayer,121,251,372,7,45,GrudgePlayer
1360,GrudgePlayer,188,283,471,31,20,GrudgePlayer
1361,GrudgePlayer,123,248,371,9,46,GrudgePlayer
1362,GrudgePlayer,144,249,393,16,41,GrudgePlayer
1363,GrudgePlayer,134,269,403,11,36,GrudgePlayer
1364,GrudgePlayer,162,277,439,20,27,GrudgePlayer
1365,GrudgePlayer,136,256,392,9,39,GrudgePlayer
1366,GrudgePlayer,139,279,418,8,30,GrudgePlayer
1367,GrudgePlayer,171,311,482,18,12,GrudgePlayer
1368,GrudgePlayer,141,261,402,13,37,GrudgePlayer
1369,GrudgePlayer,151,291,442,17,25,GrudgePlayer
1370,GrudgePlayer,148,288,436,17,27,GrudgePlayer
1371,GrudgePlayer,164,269,433,20,29,GrudgePlayer
1372,GrudgePlayer,162,292,454,20,22,GrudgePlayer
1373,GrudgePlayer,143,273,416,15,33,GrudgePlayer
1374,GrudgePlayer,152,302,454,17,21,GrudgePlayer
1375,GrudgePlayer,141,276,417,13,32,GrudgePlayer
1376,GrudgePlayer,172,282,454,23,23,GrudgePlayer
1377,GrudgePlayer,130,275,405,10,35,GrudgePlayer
1378,GrudgePlayer,119,279,398,6,36,GrudgePlayer
1379,GrudgePlayer,156,266,422,21,33,GrudgePlayer
1380,GrudgePlayer,146,286,432,16,28,GrudgePlayer
1381,GrudgePlayer,153,283,436,14,26,GrudgePlayer
1382,GrudgePlayer,165,275,440,24,28,GrudgePlayer
1383,GrudgePlayer,133,273,406,11,35,GrudgePlayer
1384,GrudgePlayer,157,282,439,17,26,GrudgePlayer
1385,GrudgePlayer,172,282,454,23,23,GrudgePlayer
1386,GrudgePlayer,161,281,442,20,26,GrudgePlayer
1387,GrudgePlayer,136,251,387,13,42,GrudgePlayer
1388,GrudgePlayer,155,260,415,20,35,GrudgePlayer
1389,GrudgePlayer,138,258,396,10,38,GrudgePlayer
1390,GrudgePlayer,145,280,425,18,31,GrudgePlayer
1391,GrudgePlayer,169,274,443,21,26,GrudgePlayer
1392,GrudgePlayer,150,265,415,14,33,GrudgePlayer
1393,GrudgePlayer,156,261,417,19,34,GrudgePlayer
1394,GrudgePlayer,150,275,425,18,31,GrudgePlayer
1395,GrudgePlayer,145,260,405,13,36,GrudgePlayer
1396,GrudgePlayer,162,287,449,21,24,GrudgePlayer
1397,GrudgePlayer,129,264,393,7,38,GrudgePlayer
1398,GrudgePlayer,140,280,420,16,32,GrudgePlayer
1399,GrudgePlayer,128,268,396,13,39,GrudgePlayer
1400,GrudgePlayer,165,270,435,25,30,GrudgePlayer
1401,GrudgePlayer,173,288,461,24,21,GrudgePlayer
1402,GrudgePlayer,158,293,451,20,23,GrudgePlayer
1403,GrudgePlayer,171,276,447,28,27,GrudgePlayer
1404,GrudgePlayer,127,262,389,12,41,GrudgePlayer
1405,GrudgePlayer,138,258,396,13,39,GrudgePlayer
1406,GrudgePlayer,168,288,456,25,23,GrudgePlayer
1407,GrudgePlayer,117,257,374,3,43,GrudgePlayer
1408,GrudgePlayer,164,284,448,20,24,GrudgePlayer
1409,GrudgePlayer,159,264,423,22,33,GrudgePlayer
1410,GrudgePlayer,178,293,471,28,19,GrudgePlayer
1411,GrudgePlayer,139,249,388,14,42,GrudgePlayer
1412,GrudgePlayer,157,277,434,21,29,GrudgePlayer
1413,GrudgePlayer,146,286,432,13,27,GrudgePlayer
1414,GrudgePlayer,131,271,402,10,36,GrudgePlayer
1415,GrudgePlayer,168,278,446,21,25,GrudgePlayer
1416,GrudgePlayer,158,283,441,19,26,GrudgePlayer
1417,GrudgePlayer,154,294,448,26,26,GrudgePlayer
1418,GrudgePlayer,136,271,407,9,34,GrudgePlayer
1419,GrudgePlayer,142,262,404,12,36,GrudgePlayer
1420,GrudgePlayer,169,279,448,23,25,GrudgePlayer
1421,GrudgePlayer,126,271,397,8,37,GrudgePlayer
1422,GrudgePlayer,148,263,411,16,35,GrudgePlayer
1423,GrudgePlayer,139,284,423,13,30,GrudgePlayer
1424,GrudgePlayer,161,276,437,21,28,GrudgePlayer
1425,GrudgePlayer,136,271,407,15,36,GrudgePlayer
1426,GrudgePlayer,119,269,388,8,40,GrudgePlayer
1427,GrudgePlayer,137,272,409,11,34,GrudgePlayer
1428,GrudgePlayer,156,281,437,18,27,GrudgePlayer
1429,GrudgePlayer,174,269,443,24,27,GrudgePlayer
1430,GrudgePlayer,123,253,376,11,45,GrudgePlayer
1431,GrudgePlayer,167,282,449,27,26,GrudgePlayer
1432,GrudgePlayer,150,265,415,17,34,GrudgePlayer
1433,GrudgePlayer,137,282,419,15,32,GrudgePlayer
1434,GrudgePlayer,173,283,456,28,24,GrudgePlayer
1435,GrudgePlayer,170,270,440,24,28,GrudgePlayer
1436,GrudgePlayer,164,284,448,23,25,GrudgePlayer
1437,GrudgePlayer,154,279,433,17,28,GrudgePlayer
1438,GrudgePlayer,117,267,384,10,42,GrudgePlayer
1439,GrudgePlayer,167,292,459,22,21,GrudgePlayer
1440,GrudgePlayer,154,279,433,14,27,GrudgePlayer
1441,GrudgePlayer,129,269,398,12,38,GrudgePlayer
1442,GrudgePlayer,154,284,438,13,25,GrudgePlayer
1443,GrudgePlayer,154,264,418,20,34,GrudgePlayer
1444,GrudgePlayer,138,273,411,16,35,GrudgePlayer
1445,GrudgePlayer,160,255,415,17,34,GrudgePlayer
1446,GrudgePlayer,147,262,409,14,35,GrudgePlayer
1447,GrudgePlayer,145,260,405,16,37,GrudgePlayer
1448,GrudgePlayer,156,276,432,19,29,GrudgePlayer
1449,GrudgePlayer,159,279,438,22,28,GrudgePlayer
1450,GrudgePlayer,141,271,412,11,33,GrudgePlayer
1451,GrudgePlayer,155,275,430,17,29,GrudgePlayer
1452,GrudgePlayer,145,285,430,17,29,GrudgePlayer
1453,GrudgePlayer,132,257,389,12,41,GrudgePlayer
1454,GrudgePlayer,137,272,409,11,34,GrudgePlayer
1455,GrudgePlayer,139,284,423,7,28,GrudgePlayer
1456,GrudgePlayer,143,263,406,14,36,GrudgePlayer
1457,GrudgePlayer,160,275,435,19,28,GrudgePlayer
1458,GrudgePlayer,151,271,422,21,33,GrudgePlayer
1459,GrudgePlayer,137,262,399,13,38,GrudgePlayer
1460,GrudgePlayer,137,277,414,10,32,GrudgePlayer
1461,GrudgePlayer,153,273,426,22,32,GrudgePlayer
1462,GrudgePlayer,154,269,423,19,32,GrudgePlayer
1463,GrudgePlayer,152,262,414,16,34,GrudgePlayer
1464,GrudgePlayer,154,289,443,18,25,GrudgePlayer
1465,GrudgePlayer,133,273,406,11,35,GrudgePlayer
1466,GrudgePlayer,192,282,474,31,19,GrudgePlayer
1467,GrudgePlayer,146,271,417,16,33,GrudgePlayer
1468,GrudgePlayer,148,278,426,22,32,GrudgePlayer
1469,GrudgePlayer,147,267,414,19,35,GrudgePlayer
1470,GrudgePlayer,126,261,387,7,40,GrudgePlayer
1471,GrudgePlayer,172,282,454,26,24,GrudgePlayer
1472,GrudgePlayer,136,261,397,11,38,GrudgePlayer
1473,GrudgePlayer,126,241,367,8,47,GrudgePlayer
1474,GrudgePlayer,158,283,441,16,25,GrudgePlayer
1475,GrudgePlayer,142,267,409,14,35,GrudgePlayer
1476,GrudgePlayer,144,254,398,15,39,GrudgePlayer
1477,GrudgePlayer,149,274,423,22,33,GrudgePlayer
1478,GrudgePlayer,163,283,446,27,27,GrudgePlayer
1479,GrudgePlayer,151,291,442,17,25,GrudgePlayer
1480,GrudgePlayer,147,262,409,17,36,GrudgePlayer
1481,GrudgePlayer,158,278,436,23,29,GrudgePlayer
1482,GrudgePlayer,141,281,422,12,30,GrudgePlayer
1483,GrudgePlayer,145,290,435,13,26,GrudgePlayer
1484,GrudgePlayer,127,267,394,11,39,GrudgePlayer
1485,GrudgePlayer,176,271,447,25,26,GrudgePlayer
1486,GrudgePlayer,133,283,416,9,31,GrudgePlayer
1487,GrudgePlayer,127,272,399,13,38,GrudgePlayer
1488,GrudgePlayer,156,266,422,18,32,GrudgePlayer
1489,GrudgePlayer,143,278,421,14,31,GrudgePlayer
1490,GrudgePlayer,154,264,418,14,32,GrudgePlayer
1491,GrudgePlayer,157,297,454,20,22,GrudgePlayer
1492,GrudgePlayer,142,272,414,16,34,GrudgePlayer
1493,GrudgePlayer,148,243,391,17,42,GrudgePlayer
1494,GrudgePlayer,137,277,414,10,32,GrudgePlayer
1495,GrudgePlayer,142,272,414,7,31,GrudgePlayer
1496,GrudgePlayer,179,284,463,26,21,GrudgePlayer
1497,GrudgePlayer,178,283,461,24,21,GrudgePlayer
1498,GrudgePlayer,142,282,424,8,28,GrudgePlayer
1499,GrudgePlayer,135,275,410,6,32,GrudgePlayer
1500,GrudgePlayer,171,276,447,28,27,GrudgePlayer
1501,GrudgePlayer,133,283,416,12,32,GrudgePlayer
1502,GrudgePlayer,153,273,426,16,30,GrudgePlayer
1503,GrudgePlayer,152,287,439,17,26,GrudgePlayer
1504,GrudgePlayer,159,274,433,20,29,GrudgePlayer
1505,GrudgePlayer,138,268,406,11,35,GrudgePlayer
1506,GrudgePlayer,138,263,401,15,38,GrudgePlayer
1507,GrudgePlayer,142,277,419,18,33,GrudgePlayer
1508,GrudgePlayer,141,266,407,12,35,GrudgePlayer
1509,GrudgePlayer,120,270,390,7,39,GrudgePlayer
1510,GrudgePlayer,145,260,405,16,37,GrudgePlayer
1511,GrudgePlayer,164,269,433,20,29,GrudgePlayer
1512,GrudgePlayer,150,270,420,13,31,GrudgePlayer
1513,GrudgePlayer,153,288,441,19,26,GrudgePlayer
1514,GrudgePlayer,150,275,425,15,30,GrudgePlayer
1515,GrudgePlayer,153,283,436,14,26,GrudgePlayer
1516,GrudgePlayer,150,280,430,14,28,GrudgePlayer
1517,GrudgePlayer,128,278,406,11,35,GrudgePlayer
1518,GrudgePlayer,168,283,451,20,23,GrudgePlayer
1519,GrudgePlayer,151,266,417,13,32,GrudgePlayer
1520,GrudgePlayer,142,257,399,19,40,GrudgePlayer
1521,GrudgePlayer,173,288,461,30,23,GrudgePlayer
1522,GrudgePlayer,149,284,433,14,27,GrudgePlayer
1523,GrudgePlayer,167,267,434,24,30,GrudgePlayer
1524,GrudgePlayer,146,266,412,17,35,GrudgePlayer
1525,GrudgePlayer,137,262,399,7,36,GrudgePlayer
1526,GrudgePlayer,156,286,442,14,24,GrudgePlayer
1527,GrudgePlayer,161,281,442,23,27,GrudgePlayer
1528,GrudgePlayer,134,264,398,15,39,GrudgePlayer
1529,GrudgePlayer,160,280,440,21,27,GrudgePlayer
1530,GrudgePlayer,153,263,416,18,34,GrudgePlayer
1531,GrudgePlayer,152,287,439,17,26,GrudgePlayer
1532,GrudgePlayer,167,287,454,17,21,GrudgePlayer
1533,GrudgePlayer,137,272,409,14,35,GrudgePlayer
1534,GrudgePlayer,128,258,386,9,41,GrudgePlayer
1535,GrudgePlayer,137,252,389,15,42,GrudgePlayer
1536,GrudgePlayer,133,283,416,9,31,GrudgePlayer
1537,GrudgePlayer,165,270,435,19,28,GrudgePlayer
1538,GrudgePlayer,150,260,410,21,37,GrudgePlayer
1539,GrudgePlayer,149,269,418,14,32,GrudgePlayer
1540,GrudgePlayer,149,259,408,13,35,GrudgePlayer
1541,GrudgePlayer,146,276,422,18,32,GrudgePlayer
1542,GrudgePlayer,199,284,483,34,17,GrudgePlayer
1543,GrudgePlayer,128,258,386,9,41,GrudgePlayer
1544,GrudgePlayer,143,263,406,17,37,GrudgePlayer
1545,GrudgePlayer,143,263,406,14,36,GrudgePlayer
1546,GrudgePlayer,168,268,436,26,30,GrudgePlayer
1547,GrudgePlayer,142,272,414,13,33,GrudgePlayer
1548,GrudgePlayer,128,268,396,10,38,GrudgePlayer
1549,GrudgePlayer,151,276,427,17,30,GrudgePlayer
1550,GrudgePlayer,130,270,400,11,37,GrudgePlayer
1551,GrudgePlayer,143,263,406,17,37,GrudgePlayer
1552,GrudgePlayer,152,282,434,18,28,GrudgePlayer
1553,GrudgePlayer,148,278,426,19,31,GrudgePlayer
1554,GrudgePlayer,159,284,443,21,26,GrudgePlayer
1555,GrudgePlayer,178,268,446,33,29,GrudgePlayer
1556,GrudgePlayer,167,272,439,23,28,GrudgePlayer
1557,GrudgePlayer,143,268,411,13,34,GrudgePlayer
1558,GrudgePlayer,142,272,414,16,34,GrudgePlayer
1559,GrudgePlayer,151,286,437,18,27,GrudgePlayer
1560,GrudgePlayer,151,271,422,24,34,GrudgePlayer
1561,GrudgePlayer,161,271,432,22,30,GrudgePlayer
1562,GrudgePlayer,165,270,435,22,29,GrudgePlayer
1563,GrudgePlayer,180,300,480,28,16,GrudgePlayer
1564,GrudgePlayer,149,274,423,13,30,GrudgePlayer
1565,GrudgePlayer,164,264,428,21,31,GrudgePlayer
1566,GrudgePlayer,164,279,443,21,26,GrudgePlayer
1567,GrudgePlayer,145,285,430,11,27,GrudgePlayer
1568,GrudgePlayer,153,273,426,16,30,GrudgePlayer
1569,GrudgePlayer,158,288,446,21,25,GrudgePlayer
1570,GrudgePlayer,133,253,386,12,42,GrudgePlayer
1571,GrudgePlayer,146,291,437,12,25,GrudgePlayer
1572,GrudgePlayer,119,269,388,8,40,GrudgePlayer
1573,GrudgePlayer,169,289,458,24,22,GrudgePlayer
1574,GrudgePlayer,164,264,428,18,30,GrudgePlayer
1575,GrudgePlayer,149,284,433,14,27,GrudgePlayer
1576,GrudgePlayer,146,276,422,12,30,GrudgePlayer
1577,GrudgePlayer,167,282,449,24,25,GrudgePlayer
1578,GrudgePlayer,145,270,415,14,33,GrudgePlayer
1579,GrudgePlayer,151,286,437,15,26,GrudgePlayer
1580,GrudgePlayer,160,270,430,23,31,GrudgePlayer
1581,GrudgePlayer,143,273,416,12,32,GrudgePlayer
1582,GrudgePlayer,142,267,409,11,34,GrudgePlayer
1583,GrudgePlayer,138,278,416,12,32,GrudgePlayer
1584,GrudgePlayer,135,250,385,11,42,GrudgePlayer
1585,GrudgePlayer,159,289,448,17,23,GrudgePlayer
1586,GrudgePlayer,136,281,417,10,31,GrudgePlayer
1587,GrudgePlayer,163,283,446,18,24,GrudgePlayer
1588,GrudgePlayer,146,281,427,14,29,GrudgePlayer
1589,GrudgePlayer,175,285,460,20,20,GrudgePlayer
1590,GrudgePlayer,130,280,410,12,34,GrudgePlayer
1591,GrudgePlayer,133,283,416,12,32,GrudgePlayer
1592,GrudgePlayer,161,276,437,21,28,GrudgePlayer
1593,GrudgePlayer,128,253,381,7,42,GrudgePlayer
1594,GrudgePlayer,176,291,467,30,21,GrudgePlayer
1595,GrudgePlayer,120,245,365,6,47,GrudgePlayer
1596,GrudgePlayer,169,299,468,25,19,GrudgePlayer
1597,GrudgePlayer,149,284,433,14,27,GrudgePlayer
1598,GrudgePlayer,174,274,448,26,26,GrudgePlayer
1599,GrudgePlayer,126,266,392,9,39,GrudgePlayer
1600,GrudgePlayer,172,282,454,26,24,GrudgePlayer
1601,GrudgePlayer,168,283,451,23,24,GrudgePlayer
1602,GrudgePlayer,154,284,438,16,26,GrudgePlayer
1603,GrudgePlayer,145,285,430,17,29,GrudgePlayer
1604,GrudgePlayer,164,274,438,22,28,GrudgePlayer
1605,GrudgePlayer,131,271,402,10,36,GrudgePlayer
1606,GrudgePlayer,152,272,424,20,32,GrudgePlayer
1607,GrudgePlayer,153,263,416,18,34,GrudgePlayer
1608,GrudgePlayer,148,278,426,16,30,GrudgePlayer
1609,GrudgePlayer,138,248,386,12,42,GrudgePlayer
1610,GrudgePlayer,152,272,424,17,31,GrudgePlayer
1611,GrudgePlayer,128,248,376,11,45,GrudgePlayer
1612,GrudgePlayer,153,268,421,17,32,GrudgePlayer
1613,GrudgePlayer,149,279,428,15,29,GrudgePlayer
1614,GrudgePlayer,158,283,441,22,27,GrudgePlayer
1615,GrudgePlayer,166,276,442,20,26,GrudgePlayer
1616,GrudgePlayer,129,264,393,13,40,GrudgePlayer
1617,GrudgePlayer,142,282,424,14,30,GrudgePlayer
1618,GrudgePlayer,143,278,421,17,32,GrudgePlayer
1619,GrudgePlayer,122,257,379,8,43,GrudgePlayer
1620,GrudgePlayer,144,249,393,16,41,GrudgePlayer
1621,GrudgePlayer,141,261,402,13,37,GrudgePlayer
1622,GrudgePlayer,140,285,425,15,30,GrudgePlayer
1623,GrudgePlayer,150,255,405,16,37,GrudgePlayer
1624,GrudgePlayer,152,277,429,16,29,GrudgePlayer
1625,GrudgePlayer,172,287,459,28,23,GrudgePlayer
1626,GrudgePlayer,156,271,427,17,30,GrudgePlayer
1627,GrudgePlayer,151,261,412,17,35,GrudgePlayer
1628,GrudgePlayer,144,264,408,13,35,GrudgePlayer
1629,GrudgePlayer,148,273,421,14,31,GrudgePlayer
1630,GrudgePlayer,172,282,454,17,21,GrudgePlayer
1631,GrudgePlayer,144,274,418,14,32,GrudgePlayer
1632,GrudgePlayer,144,279,423,22,33,GrudgePlayer
1633,GrudgePlayer,153,273,426,16,30,GrudgePlayer
1634,GrudgePlayer,146,276,422,15,31,GrudgePlayer
1635,GrudgePlayer,145,265,410,15,35,GrudgePlayer
1636,GrudgePlayer,176,301,477,28,17,GrudgePlayer
1637,GrudgePlayer,186,276,462,31,23,GrudgePlayer
1638,GrudgePlayer,136,271,407,12,35,GrudgePlayer
1639,GrudgePlayer,164,244,408,16,36,GrudgePlayer
1640,GrudgePlayer,148,278,426,16,30,GrudgePlayer
1641,GrudgePlayer,163,288,451,20,23,GrudgePlayer
1642,GrudgePlayer,138,283,421,11,30,GrudgePlayer
1643,GrudgePlayer,150,255,405,16,37,GrudgePlayer
1644,GrudgePlayer,148,253,401,18,39,GrudgePlayer
1645,GrudgePlayer,149,274,423,16,31,GrudgePlayer
1646,GrudgePlayer,157,277,434,15,27,GrudgePlayer
1647,GrudgePlayer,127,242,369,13,48,GrudgePlayer
1648,GrudgePlayer,169,284,453,22,23,GrudgePlayer
1649,GrudgePlayer,155,285,440,21,27,GrudgePlayer
1650,GrudgePlayer,183,278,461,24,21,GrudgePlayer
1651,GrudgePlayer,139,274,413,15,34,GrudgePlayer
1652,GrudgePlayer,152,277,429,13,28,GrudgePlayer
1653,GrudgePlayer,145,280,425,12,29,GrudgePlayer
1654,GrudgePlayer,136,261,397,11,38,GrudgePlayer
1655,GrudgePlayer,166,276,442,20,26,GrudgePlayer
1656,GrudgePlayer,156,271,427,17,30,GrudgePlayer
1657,GrudgePlayer,173,293,466,20,18,GrudgePlayer
1658,GrudgePlayer,144,264,408,13,35,GrudgePlayer
1659,GrudgePlayer,136,246,382,14,44,GrudgePlayer
1660,GrudgePlayer,142,277,419,9,30,GrudgePlayer
1661,GrudgePlayer,129,274,403,11,36,GrudgePlayer
1662,GrudgePlayer,156,271,427,23,32,GrudgePlayer
1663,GrudgePlayer,178,293,471,25,18,GrudgePlayer
1664,GrudgePlayer,113,238,351,4,51,GrudgePlayer
1665,GrudgePlayer,111,236,347,6,53,GrudgePlayer
1666,GrudgePlayer,131,256,387,10,41,GrudgePlayer
1667,GrudgePlayer,162,292,454,20,22,GrudgePlayer
1668,GrudgePlayer,173,268,441,22,27,GrudgePlayer
1669,GrudgePlayer,147,262,409,14,35,GrudgePlayer
1670,GrudgePlayer,142,292,434,15,27,GrudgePlayer
1671,GrudgePlayer,142,257,399,13,38,GrudgePlayer
1672,GrudgePlayer,125,270,395,9,38,GrudgePlayer
1673,GrudgePlayer,149,259,408,19,37,GrudgePlayer
1674,GrudgePlayer,107,242,349,2,51,GrudgePlayer
1675,GrudgePlayer,126,266,392,9,39,GrudgePlayer
1676,GrudgePlayer,163,283,446,21,25,GrudgePlayer
1677,GrudgePlayer,150,280,430,17,29,GrudgePlayer
1678,GrudgePlayer,136,276,412,14,34,GrudgePlayer
1679,GrudgePlayer,146,266,412,14,34,GrudgePlayer
1680,GrudgePlayer,157,272,429,22,31,GrudgePlayer
1681,GrudgePlayer,167,292,459,25,22,GrudgePlayer
1682,GrudgePlayer,178,283,461,24,21,GrudgePlayer
1683,GrudgePlayer,150,280,430,20,30,GrudgePlayer
1684,GrudgePlayer,135,260,395,12,39,GrudgePlayer
1685,GrudgePlayer,143,258,401,12,37,GrudgePlayer
1686,GrudgePlayer,137,252,389,9,40,GrudgePlayer
1687,GrudgePlayer,139,269,408,13,35,GrudgePlayer
1688,GrudgePlayer,133,258,391,14,41,GrudgePlayer
1689,GrudgePlayer,146,276,422,21,33,GrudgePlayer
1690,GrudgePlayer,138,278,416,9,31,GrudgePlayer
1691,GrudgePlayer,136,246,382,11,43,GrudgePlayer
1692,GrudgePlayer,155,275,430,20,30,GrudgePlayer
1693,GrudgePlayer,155,280,435,19,28,GrudgePlayer
1694,GrudgePlayer,117,247,364,8,48,GrudgePlayer
1695,GrudgePlayer,130,260,390,10,40,GrudgePlayer
1696,GrudgePlayer,168,293,461,24,21,GrudgePlayer
1697,GrudgePlayer,158,273,431,18,29,GrudgePlayer
1698,GrudgePlayer,155,260,415,20,35,GrudgePlayer
1699,GrudgePlayer,169,289,458,27,23,GrudgePlayer
1700,GrudgePlayer,125,250,375,10,45,GrudgePlayer
1701,GrudgePlayer,121,226,347,6,53,GrudgePlayer
1702,GrudgePlayer,163,268,431,21,30,GrudgePlayer
1703,GrudgePlayer,160,285,445,17,24,GrudgePlayer
1704,GrudgePlayer,129,279,408,13,35,GrudgePlayer
1705,GrudgePlayer,152,282,434,18,28,GrudgePlayer
1706,GrudgePlayer,147,292,439,17,26,GrudgePlayer
1707,GrudgePlayer,148,283,431,18,29,GrudgePlayer
1708,GrudgePlayer,137,242,379,17,46,GrudgePlayer
1709,GrudgePlayer,165,270,435,22,29,GrudgePlayer
1710,GrudgePlayer,152,287,439,17,26,GrudgePlayer
1711,GrudgePlayer,137,262,399,16,39,GrudgePlayer
1712,GrudgePlayer,146,271,417,19,34,GrudgePlayer
1713,GrudgePlayer,133,273,406,11,35,GrudgePlayer
1714,GrudgePlayer,163,278,441,22,27,GrudgePlayer
1715,GrudgePlayer,137,267,404,12,36,GrudgePlayer
1716,GrudgePlayer,164,289,453,16,21,GrudgePlayer
1717,GrudgePlayer,154,274,428,21,31,GrudgePlayer
1718,GrudgePlayer,154,269,423,13,30,GrudgePlayer
1719,GrudgePlayer,139,254,393,13,40,GrudgePlayer
1720,GrudgePlayer,138,258,396,13,39,GrudgePlayer
1721,GrudgePlayer,138,273,411,10,33,GrudgePlayer
1722,GrudgePlayer,128,268,396,7,37,GrudgePlayer
1723,GrudgePlayer,156,266,422,18,32,GrudgePlayer
1724,GrudgePlayer,151,261,412,17,35,GrudgePlayer
1725,GrudgePlayer,182,287,469,32,21,GrudgePlayer
1726,GrudgePlayer,141,256,397,17,40,GrudgePlayer
1727,GrudgePlayer,145,260,405,16,37,GrudgePlayer
1728,GrudgePlayer,167,302,469,20,17,GrudgePlayer
1729,GrudgePlayer,158,268,426,25,33,GrudgePlayer
1730,GrudgePlayer,142,262,404,15,37,GrudgePlayer
1731,GrudgePlayer,154,284,438,13,25,GrudgePlayer
1732,GrudgePlayer,140,280,420,13,31,GrudgePlayer
1733,GrudgePlayer,180,285,465,31,22,GrudgePlayer
1734,GrudgePlayer,142,257,399,13,38,GrudgePlayer
1735,GrudgePlayer,144,264,408,16,36,GrudgePlayer
1736,GrudgePlayer,160,280,440,21,27,GrudgePlayer
1737,GrudgePlayer,154,294,448,11,21,GrudgePlayer
1738,GrudgePlayer,162,282,444,19,25,GrudgePlayer
1739,GrudgePlayer,183,293,476,27,17,GrudgePlayer
1740,GrudgePlayer,145,285,430,17,29,GrudgePlayer
1741,GrudgePlayer,149,244,393,16,41,GrudgePlayer
1742,GrudgePlayer,137,272,409,11,34,GrudgePlayer
1743,GrudgePlayer,166,281,447,19,24,GrudgePlayer
1744,GrudgePlayer,143,273,416,12,32,GrudgePlayer
1745,GrudgePlayer,151,261,412,17,35,GrudgePlayer
1746,GrudgePlayer,123,258,381,7,42,GrudgePlayer
1747,GrudgePlayer,172,282,454,26,24,GrudgePlayer
1748,GrudgePlayer,146,281,427,20,31,GrudgePlayer
1749,GrudgePlayer,139,269,408,10,34,GrudgePlayer
1750,GrudgePlayer,132,272,404,12,36,GrudgePlayer
1751,GrudgePlayer,166,281,447,22,25,GrudgePlayer
1752,GrudgePlayer,140,270,410,18,36,GrudgePlayer
1753,GrudgePlayer,166,276,442,23,27,GrudgePlayer
1754,GrudgePlayer,161,276,437,21,28,GrudgePlayer
1755,GrudgePlayer,162,262,424,20,32,GrudgePlayer
1756,GrudgePlayer,153,283,436,17,27,GrudgePlayer
1757,GrudgePlayer,144,259,403,14,37,GrudgePlayer
1758,GrudgePlayer,131,261,392,9,39,GrudgePlayer
1759,GrudgePlayer,177,277,454,26,24,GrudgePlayer
1760,GrudgePlayer,139,244,383,15,44,GrudgePlayer
1761,GrudgePlayer,121,256,377,9,44,GrudgePlayer
1762,GrudgePlayer,145,275,420,13,31,GrudgePlayer
1763,GrudgePlayer,164,289,453,22,23,GrudgePlayer
1764,GrudgePlayer,162,272,434,18,28,GrudgePlayer
1765,GrudgePlayer,165,280,445,20,25,GrudgePlayer
1766,GrudgePlayer,140,260,400,14,38,GrudgePlayer
1767,GrudgePlayer,134,269,403,8,35,GrudgePlayer
1768,GrudgePlayer,127,277,404,9,35,GrudgePlayer
1769,GrudgePlayer,152,272,424,20,32,GrudgePlayer
1770,GrudgePlayer,146,271,417,16,33,GrudgePlayer
1771,GrudgePlayer,164,284,448,20,24,GrudgePlayer
1772,GrudgePlayer,143,273,416,15,33,GrudgePlayer
1773,GrudgePlayer,138,278,416,15,33,GrudgePlayer
1774,GrudgePlayer,145,270,415,17,34,GrudgePlayer
1775,GrudgePlayer,157,272,429,22,31,GrudgePlayer
1776,GrudgePlayer,167,272,439,26,29,GrudgePlayer
1777,GrudgePlayer,144,279,423,13,30,GrudgePlayer
1778,GrudgePlayer,169,279,448,26,26,GrudgePlayer
1779,GrudgePlayer,157,272,429,19,30,GrudgePlayer
1780,GrudgePlayer,164,264,428,24,32,GrudgePlayer
1781,GrudgePlayer,152,267,419,18,33,GrudgePlayer
1782,GrudgePlayer,144,284,428,15,29,GrudgePlayer
1783,GrudgePlayer,147,257,404,15,37,GrudgePlayer
1784,GrudgePlayer,135,270,405,7,34,GrudgePlayer
1785,GrudgePlayer,148,268,416,18,34,GrudgePlayer
1786,GrudgePlayer,140,275,415,14,33,GrudgePlayer
1787,GrudgePlayer,147,292,439,14,25,GrudgePlayer
1788,GrudgePlayer,150,270,420,13,31,GrudgePlayer
1789,GrudgePlayer,150,260,410,21,37,GrudgePlayer
1790,GrudgePlayer,164,264,428,21,31,GrudgePlayer
1791,GrudgePlayer,160,275,435,19,28,GrudgePlayer
1792,GrudgePlayer,139,284,423,13,30,GrudgePlayer
1793,GrudgePlayer,145,285,430,14,28,GrudgePlayer
1794,GrudgePlayer,138,243,381,13,44,GrudgePlayer
1795,GrudgePlayer,149,279,428,15,29,GrudgePlayer
1796,GrudgePlayer,152,272,424,20,32,GrudgePlayer
1797,GrudgePlayer,140,270,410,15,35,GrudgePlayer
1798,GrudgePlayer,109,249,358,2,48,GrudgePlayer
1799,GrudgePlayer,154,279,433,20,29,GrudgePlayer
1800,GrudgePlayer,168,278,446,24,26,GrudgePlayer
1801,GrudgePlayer,137,262,399,13,38,GrudgePlayer
1802,GrudgePlayer,119,254,373,8,45,GrudgePlayer
1803,GrudgePlayer,163,258,421,20,33,GrudgePlayer
1804,GrudgePlayer,145,270,415,11,32,GrudgePlayer
1805,GrudgePlayer,179,274,453,28,25,GrudgePlayer
1806,GrudgePlayer,140,270,410,12,34,GrudgePlayer
1807,GrudgePlayer,172,282,454,23,23,GrudgePlayer
1808,GrudgePlayer,139,264,403,14,37,GrudgePlayer
1809,GrudgePlayer,154,274,428,18,30,GrudgePlayer
1810,GrudgePlayer,139,249,388,14,42,GrudgePlayer
1811,GrudgePlayer,161,281,442,23,27,GrudgePlayer
1812,GrudgePlayer,138,288,426,10,28,GrudgePlayer
1813,GrudgePlayer,133,263,396,10,38,GrudgePlayer
1814,GrudgePlayer,134,274,408,7,33,GrudgePlayer
1815,GrudgePlayer,149,284,433,20,29,GrudgePlayer
1816,GrudgePlayer,145,265,410,12,34,GrudgePlayer
1817,GrudgePlayer,118,258,376,5,43,GrudgePlayer
1818,GrudgePlayer,157,262,419,21,34,GrudgePlayer
1819,GrudgePlayer,124,279,403,5,34,GrudgePlayer
1820,GrudgePlayer,140,275,415,14,33,GrudgePlayer
1821,GrudgePlayer,146,281,427,17,30,GrudgePlayer
1822,GrudgePlayer,129,279,408,10,34,GrudgePlayer
1823,GrudgePlayer,155,280,435,19,28,GrudgePlayer
1824,GrudgePlayer,122,252,374,6,44,GrudgePlayer
1825,GrudgePlayer,143,283,426,16,30,GrudgePlayer
1826,GrudgePlayer,187,302,489,28,13,GrudgePlayer
1827,GrudgePlayer,141,281,422,12,30,GrudgePlayer
1828,GrudgePlayer,171,291,462,25,21,GrudgePlayer
1829,GrudgePlayer,142,277,419,12,31,GrudgePlayer
1830,GrudgePlayer,165,275,440,24,28,GrudgePlayer
1831,GrudgePlayer,152,277,429,19,30,GrudgePlayer
1832,GrudgePlayer,160,275,435,25,30,GrudgePlayer
1833,GrudgePlayer,126,271,397,11,38,GrudgePlayer
1834,GrudgePlayer,180,270,450,28,26,GrudgePlayer
1835,GrudgePlayer,146,276,422,18,32,GrudgePlayer
1836,GrudgePlayer,151,286,437,21,28,GrudgePlayer
1837,GrudgePlayer,161,291,452,18,22,GrudgePlayer
1838,GrudgePlayer,151,271,422,12,30,GrudgePlayer
1839,GrudgePlayer,146,271,417,19,34,GrudgePlayer
1840,GrudgePlayer,154,279,433,20,29,GrudgePlayer
1841,GrudgePlayer,160,270,430,20,30,GrudgePlayer
1842,GrudgePlayer,153,268,421,17,32,GrudgePlayer
1843,GrudgePlayer,143,268,411,10,33,GrudgePlayer
1844,GrudgePlayer,141,271,412,14,34,GrudgePlayer
1845,GrudgePlayer,138,268,406,17,37,GrudgePlayer
1846,GrudgePlayer,134,259,393,10,39,GrudgePlayer
1847,GrudgePlayer,151,256,407,21,38,GrudgePlayer
1848,GrudgePlayer,134,259,393,16,41,GrudgePlayer
1849,GrudgePlayer,146,271,417,10,31,GrudgePlayer
1850,GrudgePlayer,148,278,426,16,30,GrudgePlayer
1851,GrudgePlayer,133,268,401,9,36,GrudgePlayer
1852,GrudgePlayer,168,283,451,23,24,GrudgePlayer
1853,GrudgePlayer,173,278,451,26,25,GrudgePlayer
1854,GrudgePlayer,151,276,427,14,29,GrudgePlayer
1855,GrudgePlayer,165,275,440,30,30,GrudgePlayer
1856,GrudgePlayer,173,278,451,26,25,GrudgePlayer
1857,GrudgePlayer,141,271,412,8,32,GrudgePlayer
1858,GrudgePlayer,132,252,384,10,42,GrudgePlayer
1859,GrudgePlayer,158,273,431,18,29,GrudgePlayer
1860,GrudgePlayer,152,247,399,19,40,GrudgePlayer
1861,GrudgePlayer,149,279,428,15,29,GrudgePlayer
1862,GrudgePlayer,167,287,454,23,23,GrudgePlayer
1863,GrudgePlayer,138,268,406,14,36,GrudgePlayer
1864,GrudgePlayer,140,290,430,11,27,GrudgePlayer
1865,GrudgePlayer,138,268,406,14,36,GrudgePlayer
1866,GrudgePlayer,128,268,396,10,38,GrudgePlayer
1867,GrudgePlayer,145,270,415,11,32,GrudgePlayer
1868,GrudgePlayer,177,307,484,26,14,GrudgePlayer
1869,GrudgePlayer,131,266,397,11,38,GrudgePlayer
1870,GrudgePlayer,177,272,449,30,27,GrudgePlayer
1871,GrudgePlayer,163,278,441,22,27,GrudgePlayer
1872,GrudgePlayer,139,239,378,13,45,GrudgePlayer
1873,GrudgePlayer,172,282,454,26,24,GrudgePlayer
1874,GrudgePlayer,158,278,436,20,28,GrudgePlayer
1875,GrudgePlayer,141,271,412,17,35,GrudgePlayer
1876,GrudgePlayer,138,263,401,15,38,GrudgePlayer
1877,GrudgePlayer,159,264,423,16,31,GrudgePlayer
1878,GrudgePlayer,138,283,421,14,31,GrudgePlayer
1879,GrudgePlayer,176,276,452,27,25,GrudgePlayer
1880,GrudgePlayer,154,269,423,16,31,GrudgePlayer
1881,GrudgePlayer,152,272,424,14,30,GrudgePlayer
1882,GrudgePlayer,154,289,443,18,25,GrudgePlayer
1883,GrudgePlayer,130,265,395,9,38,GrudgePlayer
1884,GrudgePlayer,156,276,432,13,27,GrudgePlayer
1885,GrudgePlayer,121,261,382,5,41,GrudgePlayer
1886,GrudgePlayer,153,288,441,19,26,GrudgePlayer
1887,GrudgePlayer,181,286,467,27,20,GrudgePlayer
1888,GrudgePlayer,126,271,397,8,37,GrudgePlayer
1889,GrudgePlayer,136,261,397,11,38,GrudgePlayer
1890,GrudgePlayer,149,259,408,19,37,GrudgePlayer
1891,GrudgePlayer,156,291,447,22,25,GrudgePlayer
1892,GrudgePlayer,138,288,426,13,29,GrudgePlayer
1893,GrudgePlayer,134,269,403,11,36,GrudgePlayer
1894,GrudgePlayer,153,268,421,14,31,GrudgePlayer
1895,GrudgePlayer,127,247,374,9,45,GrudgePlayer
1896,GrudgePlayer,122,252,374,6,44,GrudgePlayer
1897,GrudgePlayer,134,274,408,10,34,GrudgePlayer
1898,GrudgePlayer,150,270,420,19,33,GrudgePlayer
1899,GrudgePlayer,146,286,432,16,28,GrudgePlayer
1900,GrudgePlayer,144,269,413,12,33,GrudgePlayer
1901,GrudgePlayer,143,268,411,16,35,GrudgePlayer
1902,GrudgePlayer,131,246,377,6,43,GrudgePlayer
1903,GrudgePlayer,160,275,435,19,28,GrudgePlayer
1904,GrudgePlayer,160,275,435,19,28,GrudgePlayer
1905,GrudgePlayer,164,284,448,26,26,GrudgePlayer
1906,GrudgePlayer,178,288,466,23,19,GrudgePlayer
1907,GrudgePlayer,156,261,417,16,33,GrudgePlayer
1908,GrudgePlayer,147,262,409,17,36,GrudgePlayer
1909,GrudgePlayer,155,275,430,20,30,GrudgePlayer
1910,GrudgePlayer,168,263,431,24,31,GrudgePlayer
1911,GrudgePlayer,172,287,459,28,23,GrudgePlayer
1912,GrudgePlayer,152,267,419,15,32,GrudgePlayer
1913,GrudgePlayer,147,272,419,12,31,GrudgePlayer
1914,GrudgePlayer,171,266,437,30,31,GrudgePlayer
1915,GrudgePlayer,145,275,420,16,32,GrudgePlayer
1916,GrudgePlayer,152,277,429,19,30,GrudgePlayer
1917,GrudgePlayer,154,269,423,22,33,GrudgePlayer
1918,GrudgePlayer,131,256,387,7,40,GrudgePlayer
1919,GrudgePlayer,172,282,454,23,23,GrudgePlayer
1920,GrudgePlayer,149,279,428,18,30,GrudgePlayer
1921,GrudgePlayer,144,264,408,13,35,GrudgePlayer
1922,GrudgePlayer,122,257,379,5,42,GrudgePlayer
1923,GrudgePlayer,129,274,403,11,36,GrudgePlayer
1924,GrudgePlayer,150,270,420,16,32,GrudgePlayer
1925,GrudgePlayer,151,256,407,15,36,GrudgePlayer
1926,GrudgePlayer,140,285,425,12,29,GrudgePlayer
1927,GrudgePlayer,164,269,433,23,30,GrudgePlayer
1928,GrudgePlayer,145,260,405,13,36,GrudgePlayer
1929,GrudgePlayer,132,257,389,6,39,GrudgePlayer
1930,GrudgePlayer,138,263,401,12,37,GrudgePlayer
1931,GrudgePlayer,149,259,408,22,38,GrudgePlayer
1932,GrudgePlayer,149,259,408,19,37,GrudgePlayer
1933,GrudgePlayer,147,257,404,12,36,GrudgePlayer
1934,GrudgePlayer,149,264,413,15,34,GrudgePlayer
1935,GrudgePlayer,152,277,429,16,29,GrudgePlayer
1936,GrudgePlayer,146,261,407,18,37,GrudgePlayer
1937,GrudgePlayer,142,272,414,16,34,GrudgePlayer
1938,GrudgePlayer,171,271,442,29,29,GrudgePlayer
1939,GrudgePlayer,184,289,473,36,21,GrudgePlayer
1940,GrudgePlayer,117,237,354,10,52,GrudgePlayer
1941,GrudgePlayer,138,278,416,12,32,GrudgePlayer
1942,GrudgePlayer,149,264,413,18,35,GrudgePlayer
1943,GrudgePlayer,153,278,431,15,28,GrudgePlayer
1944,GrudgePlayer,144,264,408,13,35,GrudgePlayer
1945,GrudgePlayer,144,274,418,17,33,GrudgePlayer
1946,GrudgePlayer,153,288,441,19,26,GrudgePlayer
1947,GrudgePlayer,157,277,434,18,28,GrudgePlayer
1948,GrudgePlayer,145,270,415,20,35,GrudgePlayer
1949,GrudgePlayer,141,266,407,9,34,GrudgePlayer
1950,GrudgePlayer,145,285,430,17,29,GrudgePlayer
1951,GrudgePlayer,155,275,430,17,29,GrudgePlayer
1952,GrudgePlayer,170,285,455,24,23,GrudgePlayer
1953,GrudgePlayer,161,276,437,15,26,GrudgePlayer
1954,GrudgePlayer,137,277,414,13,33,GrudgePlayer
1955,GrudgePlayer,171,276,447,25,26,GrudgePlayer
1956,GrudgePlayer,156,286,442,17,25,GrudgePlayer
1957,GrudgePlayer,144,279,423,16,31,GrudgePlayer
1958,GrudgePlayer,132,277,409,5,32,GrudgePlayer
1959,GrudgePlayer,143,253,396,13,39,GrudgePlayer
1960,GrudgePlayer,162,287,449,21,24,GrudgePlayer
1961,GrudgePlayer,136,281,417,16,33,GrudgePlayer
1962,GrudgePlayer,148,288,436,20,28,GrudgePlayer
1963,GrudgePlayer,155,265,420,13,31,GrudgePlayer
1964,GrudgePlayer,164,284,448,20,24,GrudgePlayer
1965,GrudgePlayer,129,269,398,9,37,GrudgePlayer
1966,GrudgePlayer,140,245,385,17,44,GrudgePlayer
1967,GrudgePlayer,131,266,397,8,37,GrudgePlayer
1968,GrudgePlayer,143,283,426,13,29,GrudgePlayer
1969,GrudgePlayer,179,279,458,27,23,GrudgePlayer
1970,GrudgePlayer,142,277,419,12,31,GrudgePlayer
1971,GrudgePlayer,163,263,426,19,31,GrudgePlayer
1972,GrudgePlayer,150,275,425,21,32,GrudgePlayer
1973,GrudgePlayer,159,279,438,19,27,GrudgePlayer
1974,GrudgePlayer,169,274,443,24,27,GrudgePlayer
1975,GrudgePlayer,142,277,419,12,31,GrudgePlayer
1976,GrudgePlayer,140,280,420,16,32,GrudgePlayer
1977,GrudgePlayer,170,265,435,22,29,GrudgePlayer
1978,GrudgePlayer,151,276,427,14,29,GrudgePlayer
1979,GrudgePlayer,143,278,421,14,31,GrudgePlayer
1980,GrudgePlayer,140,290,430,14,28,GrudgePlayer
1981,GrudgePlayer,152,282,434,18,28,GrudgePlayer
1982,GrudgePlayer,157,267,424,20,32,GrudgePlayer
1983,GrudgePlayer,157,272,429,19,30,GrudgePlayer
1984,GrudgePlayer,144,269,413,12,33,GrudgePlayer
1985,GrudgePlayer,137,272,409,14,35,GrudgePlayer
1986,GrudgePlayer,142,267,409,14,35,GrudgePlayer
1987,GrudgePlayer,176,281,457,26,23,GrudgePlayer
1988,GrudgePlayer,149,269,418,17,33,GrudgePlayer
1989,GrudgePlayer,149,284,433,14,27,GrudgePlayer
1990,GrudgePlayer,140,275,415,17,34,GrudgePlayer
1991,GrudgePlayer,156,266,422,18,32,GrudgePlayer
1992,GrudgePlayer,151,276,427,20,31,GrudgePlayer
1993,GrudgePlayer,145,265,410,15,35,GrudgePlayer
1994,GrudgePlayer,143,263,406,11,35,GrudgePlayer
1995,GrudgePlayer,124,254,378,10,44,GrudgePlayer
1996,GrudgePlayer,138,273,411,16,35,GrudgePlayer
1997,GrudgePlayer,136,276,412,11,33,GrudgePlayer
1998,GrudgePlayer,141,276,417,13,32,GrudgePlayer
1999,GrudgePlayer,160,260,420,19,33,GrudgePlayer
2000,GrudgePlayer,164,274,438,22,28,GrudgePlayer
2001,GrudgePlayer,139,274,413,15,34,GrudgePlayer
2002,GrudgePlayer,169,279,448,26,26,GrudgePlayer
2003,GrudgePlayer,135,260,395,15,40,GrudgePlayer
2004,GrudgePlayer,142,267,409,14,35,GrudgePlayer
2005,GrudgePlayer,127,277,404,9,35,GrudgePlayer
2006,GrudgePlayer,166,276,442,20,26,GrudgePlayer
2007,GrudgePlayer,132,262,394,11,39,GrudgePlayer
2008,GrudgePlayer,160,270,430,20,30,GrudgePlayer
2009,GrudgePlayer,154,279,433,20,29,GrudgePlayer
2010,GrudgePlayer,150,270,420,16,32,GrudgePlayer
2011,GrudgePlayer,151,281,432,22,30,GrudgePlayer
2012,GrudgePlayer,140,275,415,14,33,GrudgePlayer
2013,GrudgePlayer,168,283,451,23,24,GrudgePlayer
2014,GrudgePlayer,113,263,376,5,43,GrudgePlayer
2015,GrudgePlayer,118,253,371,6,45,GrudgePlayer
2016,GrudgePlayer,160,280,440,21,27,GrudgePlayer
2017,GrudgePlayer,136,266,402,13,37,GrudgePlayer
2018,GrudgePlayer,148,278,426,13,29,GrudgePlayer
2019,GrudgePlayer,163,273,436,23,29,GrudgePlayer
2020,GrudgePlayer,124,264,388,8,40,GrudgePlayer
2021,GrudgePlayer,167,282,449,24,25,GrudgePlayer
2022,GrudgePlayer,154,284,438,22,28,GrudgePlayer
2023,GrudgePlayer,132,247,379,11,44,GrudgePlayer
2024,GrudgePlayer,141,251,392,15,41,GrudgePlayer
2025,GrudgePlayer,157,282,439,20,27,GrudgePlayer
2026,GrudgePlayer,132,272,404,9,35,GrudgePlayer
2027,GrudgePlayer,130,265,395,12,39,GrudgePlayer
2028,GrudgePlayer,148,283,431,15,28,GrudgePlayer
2029,GrudgePlayer,150,295,445,14,23,GrudgePlayer
2030,GrudgePlayer,158,288,446,18,24,GrudgePlayer
2031,GrudgePlayer,147,262,409,17,36,GrudgePlayer
2032,GrudgePlayer,131,261,392,9,39,GrudgePlayer
2033,GrudgePlayer,150,265,415,14,33,GrudgePlayer
2034,GrudgePlayer,146,266,412,17,35,GrudgePlayer
2035,GrudgePlayer,127,282,409,11,34,GrudgePlayer
2036,GrudgePlayer,139,274,413,9,32,GrudgePlayer
2037,GrudgePlayer,162,272,434,15,27,GrudgePlayer
2038,GrudgePlayer,141,271,412,17,35,GrudgePlayer
2039,GrudgePlayer,164,274,438,19,27,GrudgePlayer
2040,GrudgePlayer,154,274,428,15,29,GrudgePlayer
2041,GrudgePlayer,148,273,421,17,32,GrudgePlayer
2042,GrudgePlayer,147,277,424,14,30,GrudgePlayer
2043,GrudgePlayer,127,267,394,5,37,GrudgePlayer
2044,GrudgePlayer,160,270,430,20,30,GrudgePlayer
2045,GrudgePlayer,174,289,463,26,21,GrudgePlayer
2046,GrudgePlayer,121,251,372,7,45,GrudgePlayer
2047,GrudgePlayer,162,282,444,19,25,GrudgePlayer
2048,GrudgePlayer,155,285,440,21,27,GrudgePlayer
2049,GrudgePlayer,153,268,421,17,32,GrudgePlayer
2050,GrudgePlayer,122,262,384,10,42,GrudgePlayer
2051,GrudgePlayer,138,268,406,14,36,GrudgePlayer
2052,GrudgePlayer,155,275,430,17,29,GrudgePlayer
2053,GrudgePlayer,149,279,428,18,30,GrudgePlayer
2054,GrudgePlayer,155,265,420,22,34,GrudgePlayer
2055,GrudgePlayer,147,272,419,9,30,GrudgePlayer
2056,GrudgePlayer,128,278,406,11,35,GrudgePlayer
2057,GrudgePlayer,139,254,393,13,40,GrudgePlayer
2058,GrudgePlayer,128,268,396,13,39,GrudgePlayer
2059,GrudgePlayer,174,289,463,23,20,GrudgePlayer
2060,GrudgePlayer,146,251,397,20,41,GrudgePlayer
2061,GrudgePlayer,148,273,421,20,33,GrudgePlayer
2062,GrudgePlayer,176,271,447,25,26,GrudgePlayer
2063,GrudgePlayer,173,283,456,25,23,GrudgePlayer
2064,GrudgePlayer,137,252,389,12,41,GrudgePlayer
2065,GrudgePlayer,167,282,449,18,23,GrudgePlayer
2066,GrudgePlayer,143,278,421,11,30,GrudgePlayer
2067,GrudgePlayer,157,262,419,15,32,GrudgePlayer
2068,GrudgePlayer,155,260,415,20,35,GrudgePlayer
2069,GrudgePlayer,123,263,386,9,41,GrudgePlayer
2070,GrudgePlayer,160,280,440,15,25,GrudgePlayer
2071,GrudgePlayer,128,278,406,8,34,GrudgePlayer
2072,GrudgePlayer,139,264,403,8,35,GrudgePlayer
2073,GrudgePlayer,127,287,414,7,31,GrudgePlayer
2074,GrudgePlayer,148,283,431,12,27,GrudgePlayer
2075,GrudgePlayer,128,268,396,4,36,GrudgePlayer
2076,GrudgePlayer,162,277,439,14,25,GrudgePlayer
2077,GrudgePlayer,136,266,402,10,36,GrudgePlayer
2078,GrudgePlayer,128,258,386,12,42,GrudgePlayer
2079,GrudgePlayer,159,269,428,18,30,GrudgePlayer
2080,GrudgePlayer,158,298,456,22,22,GrudgePlayer
2081,GrudgePlayer,142,282,424,14,30,GrudgePlayer
2082,GrudgePlayer,135,250,385,11,42,GrudgePlayer
2083,GrudgePlayer,173,278,451,23,24,GrudgePlayer
2084,GrudgePlayer,155,280,435,19,28,GrudgePlayer
2085,GrudgePlayer,145,290,435,16,27,GrudgePlayer
2086,GrudgePlayer,130,275,405,13,36,GrudgePlayer
2087,GrudgePlayer,133,273,406,11,35,GrudgePlayer
2088,GrudgePlayer,164,294,458,18,20,GrudgePlayer
2089,GrudgePlayer,110,270,380,6,42,GrudgePlayer
2090,GrudgePlayer,140,270,410,9,33,GrudgePlayer
2091,GrudgePlayer,166,286,452,21,23,GrudgePlayer
2092,GrudgePlayer,164,269,433,20,29,GrudgePlayer
2093,GrudgePlayer,135,280,415,11,32,GrudgePlayer
2094,GrudgePlayer,156,266,422,18,32,GrudgePlayer
2095,GrudgePlayer,149,264,413,24,37,GrudgePlayer
2096,GrudgePlayer,172,282,454,26,24,GrudgePlayer
2097,GrudgePlayer,157,272,429,19,30,GrudgePlayer
2098,GrudgePlayer,140,280,420,16,32,GrudgePlayer
2099,GrudgePlayer,127,277,404,12,36,GrudgePlayer
2100,GrudgePlayer,146,261,407,15,36,GrudgePlayer
2101,GrudgePlayer,144,289,433,14,27,GrudgePlayer
2102,GrudgePlayer,131,261,392,9,39,GrudgePlayer
2103,GrudgePlayer,142,282,424,14,30,GrudgePlayer
2104,GrudgePlayer,130,260,390,10,40,GrudgePlayer
2105,GrudgePlayer,143,283,426,13,29,GrudgePlayer
2106,GrudgePlayer,159,269,428,21,31,GrudgePlayer
2107,GrudgePlayer,139,269,408,13,35,GrudgePlayer
2108,GrudgePlayer,139,284,423,13,30,GrudgePlayer
2109,GrudgePlayer,175,275,450,25,25,GrudgePlayer
2110,GrudgePlayer,135,260,395,12,39,GrudgePlayer
2111,GrudgePlayer,133,263,396,10,38,GrudgePlayer
2112,GrudgePlayer,166,281,447,25,26,GrudgePlayer
2113,GrudgePlayer,154,289,443,18,25,GrudgePlayer
2114,GrudgePlayer,135,260,395,12,39,GrudgePlayer
2115,GrudgePlayer,126,261,387,10,41,GrudgePlayer
2116,GrudgePlayer,143,263,406,14,36,GrudgePlayer
2117,GrudgePlayer,157,292,449,24,25,GrudgePlayer
2118,GrudgePlayer,154,289,443,15,24,GrudgePlayer
2119,GrudgePlayer,178,278,456,28,24,GrudgePlayer
2120,GrudgePlayer,178,278,456,28,24,GrudgePlayer
2121,GrudgePlayer,155,260,415,26,37,GrudgePlayer
2122,GrudgePlayer,138,258,396,16,40,GrudgePlayer
2123,GrudgePlayer,142,272,414,16,34,GrudgePlayer
2124,GrudgePlayer,166,286,452,21,23,GrudgePlayer
2125,GrudgePlayer,136,261,397,14,39,GrudgePlayer
2126,GrudgePlayer,162,282,444,19,25,GrudgePlayer
2127,GrudgePlayer,159,284,443,27,28,GrudgePlayer
2128,GrudgePlayer,148,268,416,15,33,GrudgePlayer
2129,GrudgePlayer,168,283,451,23,24,GrudgePlayer
2130,GrudgePlayer,140,255,395,12,39,GrudgePlayer
2131,GrudgePlayer,170,275,445,23,26,GrudgePlayer
2132,GrudgePlayer,156,276,432,22,30,GrudgePlayer
2133,GrudgePlayer,128,258,386,12,42,GrudgePlayer
2134,GrudgePlayer,127,267,394,11,39,GrudgePlayer
2135,GrudgePlayer,136,276,412,11,33,GrudgePlayer
2136,GrudgePlayer,165,285,450,22,24,GrudgePlayer
2137,GrudgePlayer,172,282,454,29,25,GrudgePlayer
2138,GrudgePlayer,172,287,459,22,21,GrudgePlayer
2139,GrudgePlayer,150,290,440,18,26,GrudgePlayer
2140,GrudgePlayer,162,282,444,16,24,GrudgePlayer
2141,GrudgePlayer,134,249,383,9,42,GrudgePlayer
2142,GrudgePlayer,141,281,422,9,29,GrudgePlayer
2143,GrudgePlayer,163,278,441,22,27,GrudgePlayer
2144,GrudgePlayer,116,261,377,6,43,GrudgePlayer
2145,GrudgePlayer,145,280,425,12,29,GrudgePlayer
2146,GrudgePlayer,125,260,385,8,41,GrudgePlayer
2147,GrudgePlayer,154,279,433,17,28,GrudgePlayer
2148,GrudgePlayer,149,284,433,14,27,GrudgePlayer
2149,GrudgePlayer,151,251,402,19,39,GrudgePlayer
2150,GrudgePlayer,142,262,404,15,37,GrudgePlayer
2151,GrudgePlayer,143,283,426,13,29,GrudgePlayer
2152,GrudgePlayer,158,283,441,19,26,GrudgePlayer
2153,GrudgePlayer,163,273,436,20,28,GrudgePlayer
2154,GrudgePlayer,137,262,399,13,38,GrudgePlayer
2155,GrudgePlayer,157,277,434,18,28,GrudgePlayer
2156,GrudgePlayer,134,249,383,12,43,GrudgePlayer
2157,GrudgePlayer,142,277,419,12,31,GrudgePlayer
2158,GrudgePlayer,141,256,397,14,39,GrudgePlayer
2159,GrudgePlayer,139,284,423,13,30,GrudgePlayer
2160,GrudgePlayer,142,262,404,9,35,GrudgePlayer
2161,GrudgePlayer,142,267,409,14,35,GrudgePlayer
2162,GrudgePlayer,156,281,437,18,27,GrudgePlayer
2163,GrudgePlayer,178,288,466,23,19,GrudgePlayer
2164,GrudgePlayer,163,278,441,16,25,GrudgePlayer
2165,GrudgePlayer,140,260,400,14,38,GrudgePlayer
2166,GrudgePlayer,116,256,372,4,44,GrudgePlayer
2167,GrudgePlayer,139,264,403,14,37,GrudgePlayer
2168,GrudgePlayer,131,266,397,14,39,GrudgePlayer
2169,GrudgePlayer,155,275,430,17,29,GrudgePlayer
2170,GrudgePlayer,150,270,420,19,33,GrudgePlayer
2171,GrudgePlayer,182,287,469,32,21,GrudgePlayer
2172,GrudgePlayer,148,278,426,16,30,GrudgePlayer
2173,GrudgePlayer,135,260,395,12,39,GrudgePlayer
2174,GrudgePlayer,174,299,473,24,17,GrudgePlayer
2175,GrudgePlayer,145,270,415,14,33,GrudgePlayer
2176,GrudgePlayer,136,261,397,14,39,GrudgePlayer
2177,GrudgePlayer,135,275,410,6,32,GrudgePlayer
2178,GrudgePlayer,126,256,382,11,43,GrudgePlayer
2179,GrudgePlayer,151,276,427,14,29,GrudgePlayer
2180,GrudgePlayer,130,275,405,10,35,GrudgePlayer
2181,GrudgePlayer,143,273,416,12,32,GrudgePlayer
2182,GrudgePlayer,153,273,426,16,30,GrudgePlayer
2183,GrudgePlayer,145,265,410,18,36,GrudgePlayer
2184,GrudgePlayer,156,261,417,19,34,GrudgePlayer
2185,GrudgePlayer,127,262,389,6,39,GrudgePlayer
2186,GrudgePlayer,171,266,437,27,30,GrudgePlayer
2187,GrudgePlayer,149,279,428,12,28,GrudgePlayer
2188,GrudgePlayer,148,278,426,16,30,GrudgePlayer
2189,GrudgePlayer,155,280,435,16,27,GrudgePlayer
2190,GrudgePlayer,130,260,390,7,39,GrudgePlayer
2191,GrudgePlayer,142,277,419,12,31,GrudgePlayer
2192,GrudgePlayer,187,277,464,36,24,GrudgePlayer
2193,GrudgePlayer,124,249,373,11,46,GrudgePlayer
2194,GrudgePlayer,141,266,407,12,35,GrudgePlayer
2195,GrudgePlayer,156,281,437,21,28,GrudgePlayer
2196,GrudgePlayer,142,267,409,11,34,GrudgePlayer
2197,GrudgePlayer,164,274,438,22,28,GrudgePlayer
2198,GrudgePlayer,138,278,416,18,34,GrudgePlayer
2199,GrudgePlayer,129,284,413,6,31,GrudgePlayer
2200,GrudgePlayer,145,265,410,12,34,GrudgePlayer
2201,GrudgePlayer,149,274,423,16,31,GrudgePlayer
2202,GrudgePlayer,135,275,410,12,34,GrudgePlayer
2203,GrudgePlayer,168,273,441,25,28,GrudgePlayer
2204,GrudgePlayer,143,283,426,16,30,GrudgePlayer
2205,GrudgePlayer,138,273,411,10,33,GrudgePlayer
2206,GrudgePlayer,150,280,430,17,29,GrudgePlayer
2207,GrudgePlayer,150,260,410,18,36,GrudgePlayer
2208,GrudgePlayer,143,258,401,18,39,GrudgePlayer
2209,GrudgePlayer,169,274,443,21,26,GrudgePlayer
2210,GrudgePlayer,149,269,418,14,32,GrudgePlayer
2211,GrudgePlayer,147,262,409,17,36,GrudgePlayer
2212,GrudgePlayer,127,262,389,9,40,GrudgePlayer
2213,GrudgePlayer,153,268,421,17,32,GrudgePlayer
2214,GrudgePlayer,132,267,399,10,37,GrudgePlayer
2215,GrudgePlayer,129,274,403,11,36,GrudgePlayer
2216,GrudgePlayer,172,277,449,24,25,GrudgePlayer
2217,GrudgePlayer,148,273,421,17,32,GrudgePlayer
2218,GrudgePlayer,164,269,433,26,31,GrudgePlayer
2219,GrudgePlayer,130,260,390,13,41,GrudgePlayer
2220,GrudgePlayer,143,268,411,19,36,GrudgePlayer
2221,GrudgePlayer,138,288,426,13,29,GrudgePlayer
2222,GrudgePlayer,166,271,437,27,30,GrudgePlayer
2223,GrudgePlayer,160,275,435,19,28,GrudgePlayer
2224,GrudgePlayer,141,266,407,15,36,GrudgePlayer
2225,GrudgePlayer,144,279,423,13,30,GrudgePlayer
2226,GrudgePlayer,143,283,426,13,29,GrudgePlayer
2227,GrudgePlayer,160,280,440,18,26,GrudgePlayer
2228,GrudgePlayer,141,276,417,16,33,GrudgePlayer
2229,GrudgePlayer,111,246,357,4,49,GrudgePlayer
2230,GrudgePlayer,158,278,436,23,29,GrudgePlayer
2231,GrudgePlayer,148,273,421,17,32,GrudgePlayer
2232,GrudgePlayer,153,268,421,17,32,GrudgePlayer
2233,GrudgePlayer,157,277,434,21,29,GrudgePlayer
2234,GrudgePlayer,158,283,441,19,26,GrudgePlayer
2235,GrudgePlayer,153,263,416,21,35,GrudgePlayer
2236,GrudgePlayer,157,277,434,18,28,GrudgePlayer
2237,GrudgePlayer,139,294,433,14,27,GrudgePlayer
2238,GrudgePlayer,126,256,382,11,43,GrudgePlayer
2239,GrudgePlayer,145,260,405,13,36,GrudgePlayer
2240,GrudgePlayer,156,256,412,20,36,GrudgePlayer
2241,GrudgePlayer,134,269,403,8,35,GrudgePlayer
2242,GrudgePlayer,149,269,418,14,32,GrudgePlayer
2243,GrudgePlayer,173,293,466,23,19,GrudgePlayer
2244,GrudgePlayer,148,283,431,18,29,GrudgePlayer
2245,GrudgePlayer,145,265,410,12,34,GrudgePlayer
2246,GrudgePlayer,172,287,459,28,23,GrudgePlayer
2247,GrudgePlayer,132,277,409,8,33,GrudgePlayer
2248,GrudgePlayer,150,275,425,15,30,GrudgePlayer
2249,GrudgePlayer,175,285,460,26,22,GrudgePlayer
2250,GrudgePlayer,136,251,387,16,43,GrudgePlayer
2251,GrudgePlayer,162,262,424,20,32,GrudgePlayer
2252,GrudgePlayer,151,291,442,17,25,GrudgePlayer
2253,GrudgePlayer,139,244,383,9,42,GrudgePlayer
2254,GrudgePlayer,141,266,407,12,35,GrudgePlayer
2255,GrudgePlayer,137,252,389,9,40,GrudgePlayer
2256,GrudgePlayer,157,282,439,20,27,GrudgePlayer
2257,GrudgePlayer,133,268,401,9,36,GrudgePlayer
2258,GrudgePlayer,161,286,447,22,25,GrudgePlayer
2259,GrudgePlayer,134,254,388,11,41,GrudgePlayer
2260,GrudgePlayer,150,265,415,17,34,GrudgePlayer
2261,GrudgePlayer,152,277,429,16,29,GrudgePlayer
2262,GrudgePlayer,131,281,412,11,33,GrudgePlayer
2263,GrudgePlayer,168,283,451,26,25,GrudgePlayer
2264,GrudgePlayer,139,269,408,13,35,GrudgePlayer
2265,GrudgePlayer,126,261,387,10,41,GrudgePlayer
2266,GrudgePlayer,146,276,422,9,29,GrudgePlayer
2267,GrudgePlayer,158,268,426,25,33,GrudgePlayer
2268,GrudgePlayer,162,287,449,24,25,GrudgePlayer
2269,GrudgePlayer,142,277,419,9,30,GrudgePlayer
2270,GrudgePlayer,138,273,411,10,33,GrudgePlayer
2271,GrudgePlayer,138,258,396,10,38,GrudgePlayer
2272,GrudgePlayer,143,283,426,16,30,GrudgePlayer
2273,GrudgePlayer,140,275,415,14,33,GrudgePlayer
2274,GrudgePlayer,140,265,405,13,36,GrudgePlayer
2275,GrudgePlayer,135,265,400,11,37,GrudgePlayer
2276,GrudgePlayer,132,272,404,9,35,GrudgePlayer
2277,GrudgePlayer,128,268,396,10,38,GrudgePlayer
2278,GrudgePlayer,152,272,424,20,32,GrudgePlayer
2279,GrudgePlayer,163,253,416,21,35,GrudgePlayer
2280,GrudgePlayer,148,283,431,18,29,GrudgePlayer
2281,GrudgePlayer,138,253,391,14,41,GrudgePlayer
2282,GrudgePlayer,151,266,417,19,34,GrudgePlayer
2283,GrudgePlayer,151,281,432,16,28,GrudgePlayer
2284,GrudgePlayer,107,257,364,2,46,GrudgePlayer
2285,GrudgePlayer,163,278,441,19,26,GrudgePlayer
2286,GrudgePlayer,133,258,391,8,39,GrudgePlayer
2287,GrudgePlayer,137,257,394,14,40,GrudgePlayer
2288,GrudgePlayer,148,283,431,18,29,GrudgePlayer
2289,GrudgePlayer,136,261,397,17,40,GrudgePlayer
2290,GrudgePlayer,140,270,410,15,35,GrudgePlayer
2291,GrudgePlayer,162,272,434,21,29,GrudgePlayer
2292,GrudgePlayer,137,262,399,10,37,GrudgePlayer
2293,GrudgePlayer,143,278,421,17,32,GrudgePlayer
2294,GrudgePlayer,123,258,381,10,43,GrudgePlayer
2295,GrudgePlayer,166,281,447,22,25,GrudgePlayer
2296,GrudgePlayer,127,252,379,8,43,GrudgePlayer
2297,GrudgePlayer,138,273,411,10,33,GrudgePlayer
2298,GrudgePlayer,180,285,465,28,21,GrudgePlayer
2299,GrudgePlayer,156,276,432,19,29,GrudgePlayer
2300,GrudgePlayer,155,280,435,16,27,GrudgePlayer
2301,GrudgePlayer,129,264,393,10,39,GrudgePlayer
2302,GrudgePlayer,152,282,434,12,26,GrudgePlayer
2303,GrudgePlayer,136,276,412,11,33,GrudgePlayer
2304,GrudgePlayer,136,286,422,6,28,GrudgePlayer
2305,GrudgePlayer,153,273,426,19,31,GrudgePlayer
2306,GrudgePlayer,130,260,390,10,40,GrudgePlayer
2307,GrudgePlayer,153,273,426,16,30,GrudgePlayer
2308,GrudgePlayer,137,272,409,11,34,GrudgePlayer
2309,GrudgePlayer,141,281,422,9,29,GrudgePlayer
2310,GrudgePlayer,155,285,440,18,26,GrudgePlayer
2311,GrudgePlayer,154,279,433,20,29,GrudgePlayer
2312,GrudgePlayer,134,254,388,11,41,GrudgePlayer
2313,GrudgePlayer,137,282,419,12,31,GrudgePlayer
2314,GrudgePlayer,122,262,384,10,42,GrudgePlayer
2315,GrudgePlayer,113,263,376,8,44,GrudgePlayer
2316,GrudgePlayer,146,276,422,15,31,GrudgePlayer
2317,GrudgePlayer,151,266,417,19,34,GrudgePlayer
2318,GrudgePlayer,134,269,403,8,35,GrudgePlayer
2319,GrudgePlayer,135,250,385,11,42,GrudgePlayer
2320,GrudgePlayer,149,284,433,20,29,GrudgePlayer
2321,GrudgePlayer,144,269,413,15,34,GrudgePlayer
2322,GrudgePlayer,121,246,367,8,47,GrudgePlayer
2323,GrudgePlayer,151,281,432,16,28,GrudgePlayer
2324,GrudgePlayer,151,266,417,16,33,GrudgePlayer
2325,GrudgePlayer,158,278,436,14,26,GrudgePlayer
2326,GrudgePlayer,150,270,420,16,32,GrudgePlayer
2327,GrudgePlayer,173,273,446,24,26,GrudgePlayer
2328,GrudgePlayer,141,271,412,11,33,GrudgePlayer
2329,GrudgePlayer,146,261,407,18,37,GrudgePlayer
2330,GrudgePlayer,130,265,395,12,39,GrudgePlayer
2331,GrudgePlayer,165,270,435,25,30,GrudgePlayer
2332,GrudgePlayer,146,276,422,15,31,GrudgePlayer
2333,GrudgePlayer,133,258,391,14,41,GrudgePlayer
2334,GrudgePlayer,139,254,393,16,41,GrudgePlayer
2335,GrudgePlayer,161,271,432,22,30,GrudgePlayer
2336,GrudgePlayer,112,232,344,6,54,GrudgePlayer
2337,GrudgePlayer,151,286,437,12,25,GrudgePlayer
2338,GrudgePlayer,155,295,450,19,23,GrudgePlayer
2339,GrudgePlayer,154,284,438,22,28,GrudgePlayer
2340,GrudgePlayer,143,248,391,14,41,GrudgePlayer
2341,GrudgePlayer,150,275,425,15,30,GrudgePlayer
2342,GrudgePlayer,162,282,444,16,24,GrudgePlayer
2343,GrudgePlayer,146,271,417,16,33,GrudgePlayer
2344,GrudgePlayer,131,236,367,14,49,GrudgePlayer
2345,GrudgePlayer,147,282,429,16,29,GrudgePlayer
2346,GrudgePlayer,138,268,406,14,36,GrudgePlayer
2347,GrudgePlayer,144,269,413,15,34,GrudgePlayer
2348,GrudgePlayer,148,263,411,13,34,GrudgePlayer
2349,GrudgePlayer,138,283,421,14,31,GrudgePlayer
2350,GrudgePlayer,157,272,429,19,30,GrudgePlayer
2351,GrudgePlayer,156,291,447,16,23,GrudgePlayer
2352,GrudgePlayer,135,270,405,13,36,GrudgePlayer
2353,GrudgePlayer,145,270,415,11,32,GrudgePlayer
2354,GrudgePlayer,148,288,436,20,28,GrudgePlayer
2355,GrudgePlayer,162,272,434,24,30,GrudgePlayer
2356,GrudgePlayer,143,273,416,12,32,GrudgePlayer
2357,GrudgePlayer,151,281,432,22,30,GrudgePlayer
2358,GrudgePlayer,132,262,394,8,38,GrudgePlayer
2359,GrudgePlayer,143,283,426,13,29,GrudgePlayer
2360,GrudgePlayer,181,291,472,26,18,GrudgePlayer
2361,GrudgePlayer,147,282,429,13,28,GrudgePlayer
2362,GrudgePlayer,137,257,394,14,40,GrudgePlayer
2363,GrudgePlayer,146,256,402,16,38,GrudgePlayer
2364,GrudgePlayer,131,261,392,12,40,GrudgePlayer
2365,GrudgePlayer,139,264,403,11,36,GrudgePlayer
2366,GrudgePlayer,169,284,453,22,23,GrudgePlayer
2367,GrudgePlayer,159,274,433,23,30,GrudgePlayer
2368,GrudgePlayer,127,247,374,9,45,GrudgePlayer
2369,GrudgePlayer,160,275,435,19,28,GrudgePlayer
2370,GrudgePlayer,151,291,442,14,24,GrudgePlayer
2371,GrudgePlayer,180,285,465,28,21,GrudgePlayer
2372,GrudgePlayer,135,255,390,13,41,GrudgePlayer
2373,GrudgePlayer,160,275,435,22,29,GrudgePlayer
2374,GrudgePlayer,144,249,393,13,40,GrudgePlayer
2375,GrudgePlayer,161,271,432,22,30,GrudgePlayer
2376,GrudgePlayer,151,271,422,21,33,GrudgePlayer
2377,GrudgePlayer,159,279,438,22,28,GrudgePlayer
2378,GrudgePlayer,142,272,414,16,34,GrudgePlayer
2379,GrudgePlayer,155,285,440,18,26,GrudgePlayer
2380,GrudgePlayer,147,262,409,14,35,GrudgePlayer
2381,GrudgePlayer,169,264,433,23,30,GrudgePlayer
2382,GrudgePlayer,123,278,401,9,36,GrudgePlayer
2383,GrudgePlayer,148,278,426,16,30,GrudgePlayer
2384,GrudgePlayer,141,266,407,15,36,GrudgePlayer
2385,GrudgePlayer,141,251,392,15,41,GrudgePlayer
2386,GrudgePlayer,131,266,397,8,37,GrudgePlayer
2387,GrudgePlayer,148,278,426,13,29,GrudgePlayer
2388,GrudgePlayer,130,270,400,8,36,GrudgePlayer
2389,GrudgePlayer,166,281,447,22,25,GrudgePlayer
2390,GrudgePlayer,166,276,442,20,26,GrudgePlayer
2391,GrudgePlayer,161,301,462,16,18,GrudgePlayer
2392,GrudgePlayer,113,258,371,12,47,GrudgePlayer
2393,GrudgePlayer,140,260,400,11,37,GrudgePlayer
2394,GrudgePlayer,164,289,453,22,23,GrudgePlayer
2395,GrudgePlayer,152,267,419,18,33,GrudgePlayer
2396,GrudgePlayer,174,289,463,26,21,GrudgePlayer
2397,GrudgePlayer,157,272,429,16,29,GrudgePlayer
2398,GrudgePlayer,133,278,411,13,34,GrudgePlayer
2399,GrudgePlayer,172,282,454,23,23,GrudgePlayer
2400,GrudgePlayer,150,255,405,13,36,GrudgePlayer
2401,GrudgePlayer,171,286,457,26,23,GrudgePlayer
2402,GrudgePlayer,136,276,412,11,33,GrudgePlayer
2403,GrudgePlayer,142,287,429,16,29,GrudgePlayer
2404,GrudgePlayer,137,257,394,11,39,GrudgePlayer
2405,GrudgePlayer,147,272,419,18,33,GrudgePlayer
2406,GrudgePlayer,130,255,385,8,41,GrudgePlayer
2407,GrudgePlayer,142,257,399,13,38,GrudgePlayer
2408,GrudgePlayer,130,250,380,6,42,GrudgePlayer
2409,GrudgePlayer,128,258,386,6,40,GrudgePlayer
2410,GrudgePlayer,154,279,433,20,29,GrudgePlayer
2411,GrudgePlayer,156,281,437,18,27,GrudgePlayer
2412,GrudgePlayer,139,274,413,9,32,GrudgePlayer
2413,GrudgePlayer,134,264,398,6,36,GrudgePlayer
2414,GrudgePlayer,134,259,393,13,40,GrudgePlayer
2415,GrudgePlayer,131,251,382,11,43,GrudgePlayer
2416,GrudgePlayer,171,281,452,24,24,GrudgePlayer
2417,GrudgePlayer,168,273,441,19,26,GrudgePlayer
2418,GrudgePlayer,154,244,398,18,40,GrudgePlayer
2419,GrudgePlayer,139,254,393,16,41,GrudgePlayer
2420,GrudgePlayer,164,279,443,21,26,GrudgePlayer
2421,GrudgePlayer,169,289,458,30,24,GrudgePlayer
2422,GrudgePlayer,129,249,378,10,44,GrudgePlayer
2423,GrudgePlayer,123,258,381,7,42,GrudgePlayer
2424,GrudgePlayer,119,269,388,8,40,GrudgePlayer
2425,GrudgePlayer,129,254,383,12,43,GrudgePlayer
2426,GrudgePlayer,131,271,402,13,37,GrudgePlayer
2427,GrudgePlayer,121,261,382,11,43,GrudgePlayer
2428,GrudgePlayer,168,283,451,29,26,GrudgePlayer
2429,GrudgePlayer,119,269,388,5,39,GrudgePlayer
2430,GrudgePlayer,140,285,425,12,29,GrudgePlayer
2431,GrudgePlayer,143,258,401,15,38,GrudgePlayer
2432,GrudgePlayer,142,267,409,20,37,GrudgePlayer
2433,GrudgePlayer,144,254,398,12,38,GrudgePlayer
2434,GrudgePlayer,177,302,479,24,15,GrudgePlayer
2435,GrudgePlayer,146,266,412,14,34,GrudgePlayer
2436,GrudgePlayer,142,277,419,15,32,GrudgePlayer
2437,GrudgePlayer,115,245,360,10,50,GrudgePlayer
2438,GrudgePlayer,144,254,398,15,39,GrudgePlayer
2439,GrudgePlayer,148,273,421,20,33,GrudgePlayer
2440,GrudgePlayer,144,274,418,14,32,GrudgePlayer
2441,GrudgePlayer,126,231,357,10,51,GrudgePlayer
2442,GrudgePlayer,151,276,427,17,30,GrudgePlayer
2443,GrudgePlayer,164,259,423,22,33,GrudgePlayer
2444,GrudgePlayer,155,295,450,13,21,GrudgePlayer
2445,GrudgePlayer,151,276,427,23,32,GrudgePlayer
2446,GrudgePlayer,128,268,396,10,38,GrudgePlayer
2447,GrudgePlayer,149,259,408,13,35,GrudgePlayer
2448,GrudgePlayer,122,257,379,8,43,GrudgePlayer
2449,GrudgePlayer,136,281,417,13,32,GrudgePlayer
2450,GrudgePlayer,139,259,398,9,37,GrudgePlayer
2451,GrudgePlayer,131,261,392,9,39,GrudgePlayer
2452,GrudgePlayer,137,262,399,13,38,GrudgePlayer
2453,GrudgePlayer,158,283,441,22,27,GrudgePlayer
2454,GrudgePlayer,136,266,402,13,37,GrudgePlayer
2455,GrudgePlayer,157,272,429,16,29,GrudgePlayer
2456,GrudgePlayer,168,278,446,24,26,GrudgePlayer
2457,GrudgePlayer,122,257,379,8,43,GrudgePlayer
2458,GrudgePlayer,131,271,402,7,35,GrudgePlayer
2459,GrudgePlayer,154,274,428,15,29,GrudgePlayer
2460,GrudgePlayer,105,270,375,4,43,GrudgePlayer
2461,GrudgePlayer,121,261,382,11,43,GrudgePlayer
2462,GrudgePlayer,143,258,401,15,38,GrudgePlayer
2463,GrudgePlayer,140,265,405,16,37,GrudgePlayer
2464,GrudgePlayer,159,279,438,16,26,GrudgePlayer
2465,GrudgePlayer,164,284,448,20,24,GrudgePlayer
2466,GrudgePlayer,141,256,397,11,38,GrudgePlayer
2467,GrudgePlayer,179,284,463,32,23,GrudgePlayer
2468,GrudgePlayer,139,269,408,16,36,GrudgePlayer
2469,GrudgePlayer,146,266,412,17,35,GrudgePlayer
2470,GrudgePlayer,139,264,403,11,36,GrudgePlayer
2471,GrudgePlayer,128,238,366,10,48,GrudgePlayer
2472,GrudgePlayer,167,292,459,22,21,GrudgePlayer
2473,GrudgePlayer,130,265,395,9,38,GrudgePlayer
2474,GrudgePlayer,165,290,455,21,22,GrudgePlayer
2475,GrudgePlayer,155,265,420,19,33,GrudgePlayer
2476,GrudgePlayer,137,262,399,13,38,GrudgePlayer
2477,GrudgePlayer,159,289,448,20,24,GrudgePlayer
2478,GrudgePlayer,145,270,415,14,33,GrudgePlayer
2479,GrudgePlayer,150,275,425,18,31,GrudgePlayer
2480,GrudgePlayer,165,295,460,26,22,GrudgePlayer
2481,GrudgePlayer,163,263,426,25,33,GrudgePlayer
2482,GrudgePlayer,153,268,421,20,33,GrudgePlayer
2483,GrudgePlayer,145,285,430,17,29,GrudgePlayer
2484,GrudgePlayer,166,291,457,20,21,GrudgePlayer
2485,GrudgePlayer,158,268,426,19,31,GrudgePlayer
2486,GrudgePlayer,132,277,409,8,33,GrudgePlayer
2487,GrudgePlayer,165,290,455,18,21,GrudgePlayer
2488,GrudgePlayer,131,271,402,10,36,GrudgePlayer
2489,GrudgePlayer,129,264,393,7,38,GrudgePlayer
2490,GrudgePlayer,138,258,396,10,38,GrudgePlayer
2491,GrudgePlayer,153,293,446,18,24,GrudgePlayer
2492,GrudgePlayer,177,287,464,27,21,GrudgePlayer
2493,GrudgePlayer,175,265,440,24,28,GrudgePlayer
2494,GrudgePlayer,158,273,431,21,30,GrudgePlayer
2495,GrudgePlayer,156,266,422,18,32,GrudgePlayer
2496,GrudgePlayer,163,263,426,28,34,GrudgePlayer
2497,GrudgePlayer,168,263,431,21,30,GrudgePlayer
2498,GrudgePlayer,140,275,415,14,33,GrudgePlayer
2499,GrudgePlayer,125,265,390,10,40,GrudgePlayer
2500,GrudgePlayer,110,245,355,5,50,GrudgePlayer
2501,GrudgePlayer,168,288,456,19,21,GrudgePlayer
2502,GrudgePlayer,169,289,458,27,23,GrudgePlayer
2503,GrudgePlayer,142,267,409,11,34,GrudgePlayer
2504,GrudgePlayer,140,265,405,16,37,GrudgePlayer
2505,GrudgePlayer,149,284,433,14,27,GrudgePlayer
2506,GrudgePlayer,152,277,429,19,30,GrudgePlayer
2507,GrudgePlayer,141,271,412,8,32,GrudgePlayer
2508,GrudgePlayer,139,259,398,12,38,GrudgePlayer
2509,GrudgePlayer,122,267,389,9,40,GrudgePlayer
2510,GrudgePlayer,143,283,426,13,29,GrudgePlayer
2511,GrudgePlayer,140,265,405,16,37,GrudgePlayer
2512,GrudgePlayer,139,259,398,12,38,GrudgePlayer
2513,GrudgePlayer,149,279,428,15,29,GrudgePlayer
2514,GrudgePlayer,168,283,451,23,24,GrudgePlayer
2515,GrudgePlayer,155,270,425,15,30,GrudgePlayer
2516,GrudgePlayer,165,265,430,23,31,GrudgePlayer
2517,GrudgePlayer,138,263,401,12,37,GrudgePlayer
2518,GrudgePlayer,140,255,395,12,39,GrudgePlayer
2519,GrudgePlayer,134,279,413,12,33,GrudgePlayer
2520,GrudgePlayer,114,264,378,4,42,GrudgePlayer
2521,GrudgePlayer,141,276,417,13,32,GrudgePlayer
2522,GrudgePlayer,147,272,419,15,32,GrudgePlayer
2523,GrudgePlayer,148,263,411,16,35,GrudgePlayer
2524,GrudgePlayer,158,278,436,17,27,GrudgePlayer
2525,GrudgePlayer,159,289,448,17,23,GrudgePlayer
2526,GrudgePlayer,131,256,387,7,40,GrudgePlayer
2527,GrudgePlayer,156,281,437,21,28,GrudgePlayer
2528,GrudgePlayer,164,274,438,22,28,GrudgePlayer
2529,GrudgePlayer,170,285,455,21,22,GrudgePlayer
2530,GrudgePlayer,165,280,445,23,26,GrudgePlayer
2531,GrudgePlayer,148,268,416,15,33,GrudgePlayer
2532,GrudgePlayer,147,282,429,13,28,GrudgePlayer
2533,GrudgePlayer,146,271,417,13,32,GrudgePlayer
2534,GrudgePlayer,172,262,434,27,31,GrudgePlayer
2535,GrudgePlayer,155,290,445,17,24,GrudgePlayer
2536,GrudgePlayer,146,251,397,14,39,GrudgePlayer
2537,GrudgePlayer,121,276,397,5,36,GrudgePlayer
2538,GrudgePlayer,165,270,435,22,29,GrudgePlayer
2539,GrudgePlayer,124,259,383,6,41,GrudgePlayer
2540,GrudgePlayer,142,272,414,16,34,GrudgePlayer
2541,GrudgePlayer,138,268,406,11,35,GrudgePlayer
2542,GrudgePlayer,140,285,425,12,29,GrudgePlayer
2543,GrudgePlayer,133,253,386,9,41,GrudgePlayer
2544,GrudgePlayer,164,259,423,25,34,GrudgePlayer
2545,GrudgePlayer,134,269,403,14,37,GrudgePlayer
2546,GrudgePlayer,142,272,414,16,34,GrudgePlayer
2547,GrudgePlayer,148,283,431,15,28,GrudgePlayer
2548,GrudgePlayer,152,287,439,17,26,GrudgePlayer
2549,GrudgePlayer,145,290,435,13,26,GrudgePlayer
2550,GrudgePlayer,141,276,417,10,31,GrudgePlayer
2551,GrudgePlayer,146,271,417,16,33,GrudgePlayer
2552,GrudgePlayer,128,273,401,9,36,GrudgePlayer
2553,GrudgePlayer,138,258,396,13,39,GrudgePlayer
2554,GrudgePlayer,162,282,444,25,27,GrudgePlayer
2555,GrudgePlayer,132,252,384,10,42,GrudgePlayer
2556,GrudgePlayer,154,279,433,20,29,GrudgePlayer
2557,GrudgePlayer,132,252,384,13,43,GrudgePlayer
2558,GrudgePlayer,149,284,433,14,27,GrudgePlayer
2559,GrudgePlayer,145,270,415,14,33,GrudgePlayer
2560,GrudgePlayer,155,260,415,14,33,GrudgePlayer
2561,GrudgePlayer,132,272,404,9,35,GrudgePlayer
2562,GrudgePlayer,141,266,407,12,35,GrudgePlayer
2563,GrudgePlayer,144,269,413,15,34,GrudgePlayer
2564,GrudgePlayer,121,251,372,4,44,GrudgePlayer
2565,GrudgePlayer,122,257,379,5,42,GrudgePlayer
2566,GrudgePlayer,135,280,415,14,33,GrudgePlayer
2567,GrudgePlayer,156,276,432,13,27,GrudgePlayer
2568,GrudgePlayer,145,255,400,17,39,GrudgePlayer
2569,GrudgePlayer,144,264,408,16,36,GrudgePlayer
2570,GrudgePlayer,138,278,416,12,32,GrudgePlayer
2571,GrudgePlayer,124,254,378,7,43,GrudgePlayer
2572,GrudgePlayer,143,268,411,13,34,GrudgePlayer
2573,GrudgePlayer,159,269,428,18,30,GrudgePlayer
2574,GrudgePlayer,130,245,375,13,46,GrudgePlayer
2575,GrudgePlayer,151,271,422,21,33,GrudgePlayer
2576,GrudgePlayer,162,287,449,18,23,GrudgePlayer
2577,GrudgePlayer,152,267,419,12,31,GrudgePlayer
2578,GrudgePlayer,154,284,438,19,27,GrudgePlayer
2579,GrudgePlayer,126,276,402,10,36,GrudgePlayer
2580,GrudgePlayer,185,285,470,30,20,GrudgePlayer
2581,GrudgePlayer,161,266,427,20,31,GrudgePlayer
2582,GrudgePlayer,157,292,449,15,22,GrudgePlayer
2583,GrudgePlayer,155,275,430,20,30,GrudgePlayer
2584,GrudgePlayer,138,258,396,10,38,GrudgePlayer
2585,GrudgePlayer,155,260,415,20,35,GrudgePlayer
2586,GrudgePlayer,130,255,385,11,42,GrudgePlayer
2587,GrudgePlayer,173,283,456,25,23,GrudgePlayer
2588,GrudgePlayer,150,270,420,13,31,GrudgePlayer
2589,GrudgePlayer,126,266,392,12,40,GrudgePlayer
2590,GrudgePlayer,165,285,450,25,25,GrudgePlayer
2591,GrudgePlayer,169,274,443,30,29,GrudgePlayer
2592,GrudgePlayer,127,272,399,4,35,GrudgePlayer
2593,GrudgePlayer,147,267,414,16,34,GrudgePlayer
2594,GrudgePlayer,146,261,407,18,37,GrudgePlayer
2595,GrudgePlayer,140,275,415,11,32,GrudgePlayer
2596,GrudgePlayer,144,274,418,11,31,GrudgePlayer
2597,GrudgePlayer,138,278,416,15,33,GrudgePlayer
2598,GrudgePlayer,145,275,420,13,31,GrudgePlayer
2599,GrudgePlayer,111,271,382,2,40,GrudgePlayer
2600,GrudgePlayer,159,259,418,20,34,GrudgePlayer
2601,GrudgePlayer,151,271,422,15,31,GrudgePlayer
2602,GrudgePlayer,133,278,411,10,33,GrudgePlayer
2603,GrudgePlayer,144,254,398,12,38,GrudgePlayer
2604,GrudgePlayer,117,262,379,5,42,GrudgePlayer
2605,GrudgePlayer,139,274,413,15,34,GrudgePlayer
2606,GrudgePlayer,149,289,438,13,25,GrudgePlayer
2607,GrudgePlayer,120,265,385,8,41,GrudgePlayer
2608,GrudgePlayer,138,248,386,9,41,GrudgePlayer
2609,GrudgePlayer,132,272,404,9,35,GrudgePlayer
2610,GrudgePlayer,121,256,377,6,43,GrudgePlayer
2611,GrudgePlayer,139,274,413,15,34,GrudgePlayer
2612,GrudgePlayer,145,270,415,14,33,GrudgePlayer
2613,GrudgePlayer,137,262,399,13,38,GrudgePlayer
2614,GrudgePlayer,137,257,394,14,40,GrudgePlayer
2615,GrudgePlayer,135,265,400,11,37,GrudgePlayer
2616,GrudgePlayer,143,258,401,15,38,GrudgePlayer
2617,GrudgePlayer,125,260,385,8,41,GrudgePlayer
2618,GrudgePlayer,146,256,402,16,38,GrudgePlayer
2619,GrudgePlayer,122,277,399,7,36,GrudgePlayer
2620,GrudgePlayer,157,282,439,17,26,GrudgePlayer
2621,GrudgePlayer,174,299,473,27,18,GrudgePlayer
2622,GrudgePlayer,138,273,411,13,34,GrudgePlayer
2623,GrudgePlayer,123,283,406,8,34,GrudgePlayer
2624,GrudgePlayer,163,288,451,20,23,GrudgePlayer
2625,GrudgePlayer,158,273,431,18,29,GrudgePlayer
2626,GrudgePlayer,153,293,446,15,23,GrudgePlayer
2627,GrudgePlayer,152,287,439,17,26,GrudgePlayer
2628,GrudgePlayer,145,265,410,12,34,GrudgePlayer
2629,GrudgePlayer,154,269,423,19,32,GrudgePlayer
2630,GrudgePlayer,141,266,407,9,34,GrudgePlayer
2631,GrudgePlayer,133,268,401,9,36,GrudgePlayer
2632,GrudgePlayer,182,257,439,32,31,GrudgePlayer
2633,GrudgePlayer,149,269,418,14,32,GrudgePlayer
2634,GrudgePlayer,139,274,413,12,33,GrudgePlayer
2635,GrudgePlayer,127,257,384,10,42,GrudgePlayer
2636,GrudgePlayer,158,278,436,20,28,GrudgePlayer
2637,GrudgePlayer,147,272,419,12,31,GrudgePlayer
2638,GrudgePlayer,123,278,401,9,36,GrudgePlayer
2639,GrudgePlayer,154,269,423,16,31,GrudgePlayer
2640,GrudgePlayer,144,254,398,15,39,GrudgePlayer
2641,GrudgePlayer,178,298,476,24,16,GrudgePlayer
2642,GrudgePlayer,142,277,419,12,31,GrudgePlayer
2643,GrudgePlayer,131,261,392,9,39,GrudgePlayer
2644,GrudgePlayer,152,257,409,17,36,GrudgePlayer
2645,GrudgePlayer,148,273,421,17,32,GrudgePlayer
2646,GrudgePlayer,139,254,393,16,41,GrudgePlayer
2647,GrudgePlayer,170,260,430,23,31,GrudgePlayer
2648,GrudgePlayer,110,260,370,5,45,GrudgePlayer
2649,GrudgePlayer,144,249,393,16,41,GrudgePlayer
2650,GrudgePlayer,164,259,423,22,33,GrudgePlayer
2651,GrudgePlayer,134,269,403,11,36,GrudgePlayer
2652,GrudgePlayer,144,284,428,12,28,GrudgePlayer
2653,GrudgePlayer,137,272,409,8,33,GrudgePlayer
2654,GrudgePlayer,158,268,426,22,32,GrudgePlayer
2655,GrudgePlayer,138,258,396,13,39,GrudgePlayer
2656,GrudgePlayer,157,267,424,26,34,GrudgePlayer
2657,GrudgePlayer,137,272,409,11,34,GrudgePlayer
2658,GrudgePlayer,145,280,425,15,30,GrudgePlayer
2659,GrudgePlayer,147,267,414,16,34,GrudgePlayer
2660,GrudgePlayer,150,270,420,16,32,GrudgePlayer
2661,GrudgePlayer,138,273,411,19,36,GrudgePlayer
2662,GrudgePlayer,128,258,386,9,41,GrudgePlayer
2663,GrudgePlayer,124,279,403,11,36,GrudgePlayer
2664,GrudgePlayer,136,266,402,10,36,GrudgePlayer
2665,GrudgePlayer,141,256,397,11,38,GrudgePlayer
2666,GrudgePlayer,138,253,391,17,42,GrudgePlayer
2667,GrudgePlayer,152,267,419,18,33,GrudgePlayer
2668,GrudgePlayer,153,263,416,21,35,GrudgePlayer
2669,GrudgePlayer,158,283,441,19,26,GrudgePlayer
2670,GrudgePlayer,136,266,402,10,36,GrudgePlayer
2671,GrudgePlayer,159,279,438,25,29,GrudgePlayer
2672,GrudgePlayer,133,268,401,9,36,GrudgePlayer
2673,GrudgePlayer,139,259,398,12,38,GrudgePlayer
2674,GrudgePlayer,154,274,428,18,30,GrudgePlayer
2675,GrudgePlayer,175,295,470,24,18,GrudgePlayer
2676,GrudgePlayer,143,273,416,12,32,GrudgePlayer
2677,GrudgePlayer,132,257,389,15,42,GrudgePlayer
2678,GrudgePlayer,161,286,447,22,25,GrudgePlayer
2679,GrudgePlayer,134,269,403,14,37,GrudgePlayer
2680,GrudgePlayer,134,229,363,7,48,GrudgePlayer
2681,GrudgePlayer,140,285,425,15,30,GrudgePlayer
2682,GrudgePlayer,149,274,423,19,32,GrudgePlayer
2683,GrudgePlayer,177,272,449,27,26,GrudgePlayer
2684,GrudgePlayer,142,272,414,7,31,GrudgePlayer
2685,GrudgePlayer,157,287,444,16,24,GrudgePlayer
2686,GrudgePlayer,147,262,409,14,35,GrudgePlayer
2687,GrudgePlayer,133,248,381,10,43,GrudgePlayer
2688,GrudgePlayer,145,240,385,17,44,GrudgePlayer
2689,GrudgePlayer,132,247,379,14,45,GrudgePlayer
2690,GrudgePlayer,151,286,437,15,26,GrudgePlayer
2691,GrudgePlayer,150,275,425,15,30,GrudgePlayer
2692,GrudgePlayer,136,271,407,12,35,GrudgePlayer
2693,GrudgePlayer,163,288,451,20,23,GrudgePlayer
2694,GrudgePlayer,173,258,431,24,31,GrudgePlayer
2695,GrudgePlayer,133,283,416,15,33,GrudgePlayer
2696,GrudgePlayer,149,259,408,13,35,GrudgePlayer
2697,GrudgePlayer,134,259,393,13,40,GrudgePlayer
2698,GrudgePlayer,147,267,414,13,33,GrudgePlayer
2699,GrudgePlayer,156,266,422,18,32,GrudgePlayer
2700,GrudgePlayer,154,279,433,20,29,GrudgePlayer
2701,GrudgePlayer,159,284,443,21,26,GrudgePlayer
2702,GrudgePlayer,150,280,430,17,29,GrudgePlayer
2703,GrudgePlayer,123,278,401,9,36,GrudgePlayer
2704,GrudgePlayer,134,274,408,10,34,GrudgePlayer
2705,GrudgePlayer,126,271,397,11,38,GrudgePlayer
2706,GrudgePlayer,128,258,386,12,42,GrudgePlayer
2707,GrudgePlayer,146,276,422,12,30,GrudgePlayer
2708,GrudgePlayer,143,283,426,16,30,GrudgePlayer
2709,GrudgePlayer,124,264,388,11,41,GrudgePlayer
2710,GrudgePlayer,177,282,459,28,23,GrudgePlayer
2711,GrudgePlayer,137,267,404,12,36,GrudgePlayer
2712,GrudgePlayer,148,258,406,14,36,GrudgePlayer
2713,GrudgePlayer,136,281,417,10,31,GrudgePlayer
2714,GrudgePlayer,168,278,446,21,25,GrudgePlayer
2715,GrudgePlayer,163,293,456,19,21,GrudgePlayer
2716,GrudgePlayer,145,270,415,20,35,GrudgePlayer
2717,GrudgePlayer,136,251,387,13,42,GrudgePlayer
2718,GrudgePlayer,135,255,390,13,41,GrudgePlayer
2719,GrudgePlayer,148,263,411,16,35,GrudgePlayer
2720,GrudgePlayer,137,277,414,13,33,GrudgePlayer
2721,GrudgePlayer,130,250,380,6,42,GrudgePlayer
2722,GrudgePlayer,153,273,426,19,31,GrudgePlayer
2723,GrudgePlayer,151,276,427,17,30,GrudgePlayer
2724,GrudgePlayer,140,260,400,11,37,GrudgePlayer
2725,GrudgePlayer,156,281,437,24,29,GrudgePlayer
2726,GrudgePlayer,155,250,405,16,37,GrudgePlayer
2727,GrudgePlayer,141,261,402,13,37,GrudgePlayer
2728,GrudgePlayer,142,252,394,11,39,GrudgePlayer
2729,GrudgePlayer,130,265,395,9,38,GrudgePlayer
2730,GrudgePlayer,142,257,399,10,37,GrudgePlayer
2731,GrudgePlayer,153,283,436,14,26,GrudgePlayer
2732,GrudgePlayer,144,274,418,14,32,GrudgePlayer
2733,GrudgePlayer,145,270,415,17,34,GrudgePlayer
2734,GrudgePlayer,133,273,406,14,36,GrudgePlayer
2735,GrudgePlayer,175,275,450,28,26,GrudgePlayer
2736,GrudgePlayer,142,272,414,16,34,GrudgePlayer
2737,GrudgePlayer,152,272,424,17,31,GrudgePlayer
2738,GrudgePlayer,145,260,405,16,37,GrudgePlayer
2739,GrudgePlayer,125,265,390,7,39,GrudgePlayer
2740,GrudgePlayer,144,269,413,15,34,GrudgePlayer
2741,GrudgePlayer,127,277,404,9,35,GrudgePlayer
2742,GrudgePlayer,133,258,391,11,40,GrudgePlayer
2743,GrudgePlayer,130,260,390,10,40,GrudgePlayer
2744,GrudgePlayer,146,281,427,14,29,GrudgePlayer
2745,GrudgePlayer,116,251,367,8,47,GrudgePlayer
2746,GrudgePlayer,144,264,408,16,36,GrudgePlayer
2747,GrudgePlayer,143,278,421,14,31,GrudgePlayer
2748,GrudgePlayer,158,293,451,20,23,GrudgePlayer
2749,GrudgePlayer,166,286,452,24,24,GrudgePlayer
2750,GrudgePlayer,138,248,386,12,42,GrudgePlayer
2751,GrudgePlayer,125,255,380,9,43,GrudgePlayer
2752,GrudgePlayer,139,269,408,16,36,GrudgePlayer
2753,GrudgePlayer,140,260,400,14,38,GrudgePlayer
2754,GrudgePlayer,139,264,403,14,37,GrudgePlayer
2755,GrudgePlayer,124,269,393,10,39,GrudgePlayer
2756,GrudgePlayer,166,281,447,28,27,GrudgePlayer
2757,GrudgePlayer,131,276,407,9,34,GrudgePlayer
2758,GrudgePlayer,140,270,410,18,36,GrudgePlayer
2759,GrudgePlayer,142,277,419,12,31,GrudgePlayer
2760,GrudgePlayer,144,274,418,17,33,GrudgePlayer
2761,GrudgePlayer,154,279,433,20,29,GrudgePlayer
2762,GrudgePlayer,145,260,405,16,37,GrudgePlayer
2763,GrudgePlayer,158,263,421,20,33,GrudgePlayer
2764,GrudgePlayer,134,264,398,12,38,GrudgePlayer
2765,GrudgePlayer,147,257,404,18,38,GrudgePlayer
2766,GrudgePlayer,145,275,420,16,32,GrudgePlayer
2767,GrudgePlayer,127,262,389,6,39,GrudgePlayer
2768,GrudgePlayer,146,286,432,16,28,GrudgePlayer
2769,GrudgePlayer,136,246,382,11,43,GrudgePlayer
2770,GrudgePlayer,124,254,378,7,43,GrudgePlayer
2771,GrudgePlayer,132,262,394,8,38,GrudgePlayer
2772,GrudgePlayer,143,268,411,13,34,GrudgePlayer
2773,GrudgePlayer,156,286,442,20,26,GrudgePlayer
2774,GrudgePlayer,131,266,397,14,39,GrudgePlayer
2775,GrudgePlayer,165,255,420,19,33,GrudgePlayer
2776,GrudgePlayer,167,277,444,25,27,GrudgePlayer
2777,GrudgePlayer,138,258,396,16,40,GrudgePlayer
2778,GrudgePlayer,145,280,425,12,29,GrudgePlayer
2779,GrudgePlayer,128,253,381,7,42,GrudgePlayer
2780,GrudgePlayer,101,276,377,6,43,GrudgePlayer
2781,GrudgePlayer,130,265,395,12,39,GrudgePlayer
2782,GrudgePlayer,149,279,428,15,29,GrudgePlayer
2783,GrudgePlayer,147,287,434,18,28,GrudgePlayer
2784,GrudgePlayer,129,249,378,10,44,GrudgePlayer
2785,GrudgePlayer,130,250,380,9,43,GrudgePlayer
2786,GrudgePlayer,141,271,412,14,34,GrudgePlayer
2787,GrudgePlayer,148,258,406,17,37,GrudgePlayer
2788,GrudgePlayer,149,274,423,16,31,GrudgePlayer
2789,GrudgePlayer,167,267,434,24,30,GrudgePlayer
2790,GrudgePlayer,140,275,415,14,33,GrudgePlayer
2791,GrudgePlayer,165,280,445,26,27,GrudgePlayer
2792,GrudgePlayer,144,274,418,14,32,GrudgePlayer
2793,GrudgePlayer,125,230,355,8,51,GrudgePlayer
2794,GrudgePlayer,126,246,372,7,45,GrudgePlayer
2795,GrudgePlayer,122,267,389,9,40,GrudgePlayer
2796,GrudgePlayer,134,264,398,9,37,GrudgePlayer
2797,GrudgePlayer,137,282,419,12,31,GrudgePlayer
2798,GrudgePlayer,156,271,427,17,30,GrudgePlayer
2799,GrudgePlayer,156,276,432,22,30,GrudgePlayer
2800,GrudgePlayer,152,277,429,19,30,GrudgePlayer
2801,GrudgePlayer,133,273,406,14,36,GrudgePlayer
2802,GrudgePlayer,130,265,395,9,38,GrudgePlayer
2803,GrudgePlayer,136,266,402,10,36,GrudgePlayer
2804,GrudgePlayer,163,288,451,23,24,GrudgePlayer
2805,GrudgePlayer,143,278,421,11,30,GrudgePlayer
2806,GrudgePlayer,168,288,456,25,23,GrudgePlayer
2807,GrudgePlayer,181,296,477,28,17,GrudgePlayer
2808,GrudgePlayer,142,272,414,16,34,GrudgePlayer
2809,GrudgePlayer,142,272,414,13,33,GrudgePlayer
2810,GrudgePlayer,148,263,411,22,37,GrudgePlayer
2811,GrudgePlayer,140,250,390,13,41,GrudgePlayer
2812,GrudgePlayer,153,273,426,19,31,GrudgePlayer
2813,GrudgePlayer,147,267,414,13,33,GrudgePlayer
2814,GrudgePlayer,151,271,422,15,31,GrudgePlayer
2815,GrudgePlayer,155,255,410,24,38,GrudgePlayer
2816,GrudgePlayer,154,289,443,18,25,GrudgePlayer
2817,GrudgePlayer,184,289,473,24,17,GrudgePlayer
2818,GrudgePlayer,136,286,422,12,30,GrudgePlayer
2819,GrudgePlayer,161,276,437,21,28,GrudgePlayer
2820,GrudgePlayer,147,267,414,13,33,GrudgePlayer
2821,GrudgePlayer,151,286,437,15,26,GrudgePlayer
2822,GrudgePlayer,162,272,434,21,29,GrudgePlayer
2823,GrudgePlayer,156,246,402,16,38,GrudgePlayer
2824,GrudgePlayer,135,290,425,15,30,GrudgePlayer
2825,GrudgePlayer,149,259,408,16,36,GrudgePlayer
2826,GrudgePlayer,176,296,472,26,18,GrudgePlayer
2827,GrudgePlayer,114,244,358,2,48,GrudgePlayer
2828,GrudgePlayer,146,276,422,9,29,GrudgePlayer
2829,GrudgePlayer,121,271,392,6,38,GrudgePlayer
2830,GrudgePlayer,134,279,413,12,33,GrudgePlayer
2831,GrudgePlayer,146,281,427,14,29,GrudgePlayer
2832,GrudgePlayer,132,277,409,8,33,GrudgePlayer
2833,GrudgePlayer,159,269,428,21,31,GrudgePlayer
2834,GrudgePlayer,147,252,399,13,38,GrudgePlayer
2835,GrudgePlayer,158,273,431,24,31,GrudgePlayer
2836,GrudgePlayer,131,266,397,5,36,GrudgePlayer
2837,GrudgePlayer,136,261,397,11,38,GrudgePlayer
2838,GrudgePlayer,148,263,411,19,36,GrudgePlayer
2839,GrudgePlayer,159,284,443,15,24,GrudgePlayer
2840,GrudgePlayer,150,280,430,14,28,GrudgePlayer
2841,GrudgePlayer,143,268,411,16,35,GrudgePlayer
2842,GrudgePlayer,115,250,365,6,47,GrudgePlayer
2843,GrudgePlayer,138,268,406,14,36,GrudgePlayer
2844,GrudgePlayer,168,288,456,25,23,GrudgePlayer
2845,GrudgePlayer,123,253,376,8,44,GrudgePlayer
2846,GrudgePlayer,146,261,407,15,36,GrudgePlayer
2847,GrudgePlayer,116,246,362,6,48,GrudgePlayer
2848,GrudgePlayer,143,283,426,16,30,GrudgePlayer
2849,GrudgePlayer,151,271,422,18,32,GrudgePlayer
2850,GrudgePlayer,149,264,413,18,35,GrudgePlayer
2851,GrudgePlayer,121,256,377,9,44,GrudgePlayer
2852,GrudgePlayer,124,259,383,6,41,GrudgePlayer
2853,GrudgePlayer,130,260,390,13,41,GrudgePlayer
2854,GrudgePlayer,162,292,454,17,21,GrudgePlayer
2855,GrudgePlayer,125,250,375,10,45,GrudgePlayer
2856,GrudgePlayer,170,280,450,28,26,GrudgePlayer
2857,GrudgePlayer,137,272,409,11,34,GrudgePlayer
2858,GrudgePlayer,121,266,387,7,40,GrudgePlayer
2859,GrudgePlayer,109,264,373,5,44,GrudgePlayer
2860,GrudgePlayer,154,279,433,20,29,GrudgePlayer
2861,GrudgePlayer,132,247,379,11,44,GrudgePlayer
2862,GrudgePlayer,155,270,425,21,32,GrudgePlayer
2863,GrudgePlayer,155,270,425,18,31,GrudgePlayer
2864,GrudgePlayer,141,276,417,13,32,GrudgePlayer
2865,GrudgePlayer,161,281,442,20,26,GrudgePlayer
2866,GrudgePlayer,156,286,442,11,23,GrudgePlayer
2867,GrudgePlayer,145,265,410,18,36,GrudgePlayer
2868,GrudgePlayer,139,249,388,11,41,GrudgePlayer
2869,GrudgePlayer,162,277,439,20,27,GrudgePlayer
2870,GrudgePlayer,135,260,395,15,40,GrudgePlayer
2871,GrudgePlayer,150,275,425,15,30,GrudgePlayer
2872,GrudgePlayer,137,282,419,18,33,GrudgePlayer
2873,GrudgePlayer,131,261,392,12,40,GrudgePlayer
2874,GrudgePlayer,127,267,394,8,38,GrudgePlayer
2875,GrudgePlayer,127,227,354,10,52,GrudgePlayer
2876,GrudgePlayer,148,273,421,17,32,GrudgePlayer
2877,GrudgePlayer,162,277,439,17,26,GrudgePlayer
2878,GrudgePlayer,152,267,419,18,33,GrudgePlayer
2879,GrudgePlayer,154,284,438,16,26,GrudgePlayer
2880,GrudgePlayer,143,263,406,14,36,GrudgePlayer
2881,GrudgePlayer,166,286,452,21,23,GrudgePlayer
2882,GrudgePlayer,138,253,391,11,40,GrudgePlayer
2883,GrudgePlayer,176,281,457,26,23,GrudgePlayer
2884,GrudgePlayer,118,263,381,10,43,GrudgePlayer
2885,GrudgePlayer,133,263,396,10,38,GrudgePlayer
2886,GrudgePlayer,142,282,424,17,31,GrudgePlayer
2887,GrudgePlayer,138,268,406,11,35,GrudgePlayer
2888,GrudgePlayer,129,249,378,10,44,GrudgePlayer
2889,GrudgePlayer,151,261,412,17,35,GrudgePlayer
2890,GrudgePlayer,150,255,405,19,38,GrudgePlayer
2891,GrudgePlayer,146,266,412,14,34,GrudgePlayer
2892,GrudgePlayer,122,257,379,5,42,GrudgePlayer
2893,GrudgePlayer,137,257,394,8,38,GrudgePlayer
2894,GrudgePlayer,164,274,438,25,29,GrudgePlayer
2895,GrudgePlayer,162,292,454,20,22,GrudgePlayer
2896,GrudgePlayer,162,277,439,17,26,GrudgePlayer
2897,GrudgePlayer,145,275,420,13,31,GrudgePlayer
2898,GrudgePlayer,147,267,414,13,33,GrudgePlayer
2899,GrudgePlayer,137,282,419,12,31,GrudgePlayer
2900,GrudgePlayer,146,266,412,11,33,GrudgePlayer
2901,GrudgePlayer,149,269,418,17,33,GrudgePlayer
2902,GrudgePlayer,127,257,384,13,43,GrudgePlayer
2903,GrudgePlayer,154,264,418,20,34,GrudgePlayer
2904,GrudgePlayer,146,281,427,14,29,GrudgePlayer
2905,GrudgePlayer,138,273,411,13,34,GrudgePlayer
2906,GrudgePlayer,134,264,398,9,37,GrudgePlayer
2907,GrudgePlayer,132,262,394,8,38,GrudgePlayer
2908,GrudgePlayer,151,271,422,18,32,GrudgePlayer
2909,GrudgePlayer,126,256,382,11,43,GrudgePlayer
2910,GrudgePlayer,138,273,411,10,33,GrudgePlayer
2911,GrudgePlayer,166,276,442,26,28,GrudgePlayer
2912,GrudgePlayer,136,256,392,9,39,GrudgePlayer
2913,GrudgePlayer,164,279,443,24,27,GrudgePlayer
2914,GrudgePlayer,128,263,391,17,42,GrudgePlayer
2915,GrudgePlayer,163,263,426,22,32,GrudgePlayer
2916,GrudgePlayer,142,247,389,15,42,GrudgePlayer
2917,GrudgePlayer,139,259,398,12,38,GrudgePlayer
2918,GrudgePlayer,135,255,390,13,41,GrudgePlayer
2919,GrudgePlayer,183,288,471,31,20,GrudgePlayer
2920,GrudgePlayer,121,256,377,9,44,GrudgePlayer
2921,GrudgePlayer,159,289,448,17,23,GrudgePlayer
2922,GrudgePlayer,134,264,398,12,38,GrudgePlayer
2923,GrudgePlayer,150,270,420,16,32,GrudgePlayer
2924,GrudgePlayer,127,232,359,12,51,GrudgePlayer
2925,GrudgePlayer,142,267,409,14,35,GrudgePlayer
2926,GrudgePlayer,107,267,374,3,43,GrudgePlayer
2927,GrudgePlayer,146,286,432,19,29,GrudgePlayer
2928,GrudgePlayer,146,261,407,15,36,GrudgePlayer
2929,GrudgePlayer,142,267,409,14,35,GrudgePlayer
2930,GrudgePlayer,150,265,415,20,35,GrudgePlayer
2931,GrudgePlayer,146,261,407,15,36,GrudgePlayer
2932,GrudgePlayer,144,269,413,15,34,GrudgePlayer
2933,GrudgePlayer,133,253,386,9,41,GrudgePlayer
2934,GrudgePlayer,152,247,399,19,40,GrudgePlayer
2935,GrudgePlayer,134,249,383,9,42,GrudgePlayer
2936,GrudgePlayer,155,290,445,20,25,GrudgePlayer
2937,GrudgePlayer,156,276,432,19,29,GrudgePlayer
2938,GrudgePlayer,132,257,389,12,41,GrudgePlayer
2939,GrudgePlayer,171,281,452,27,25,GrudgePlayer
2940,GrudgePlayer,142,267,409,17,36,GrudgePlayer
2941,GrudgePlayer,155,280,435,22,29,GrudgePlayer
2942,GrudgePlayer,118,273,391,8,39,GrudgePlayer
2943,GrudgePlayer,133,243,376,8,44,GrudgePlayer
2944,GrudgePlayer,158,273,431,18,29,GrudgePlayer
2945,GrudgePlayer,142,272,414,13,33,GrudgePlayer
2946,GrudgePlayer,132,262,394,14,40,GrudgePlayer
2947,GrudgePlayer,121,251,372,10,46,GrudgePlayer
2948,GrudgePlayer,151,276,427,17,30,GrudgePlayer
2949,GrudgePlayer,147,257,404,21,39,GrudgePlayer
2950,GrudgePlayer,154,289,443,18,25,GrudgePlayer
2951,GrudgePlayer,155,270,425,18,31,GrudgePlayer
2952,GrudgePlayer,150,290,440,12,24,GrudgePlayer
2953,GrudgePlayer,138,253,391,14,41,GrudgePlayer
2954,GrudgePlayer,162,267,429,22,31,GrudgePlayer
2955,GrudgePlayer,157,277,434,18,28,GrudgePlayer
2956,GrudgePlayer,144,234,378,13,45,GrudgePlayer
2957,GrudgePlayer,160,275,435,22,29,GrudgePlayer
2958,GrudgePlayer,148,278,426,19,31,GrudgePlayer
2959,GrudgePlayer,131,266,397,11,38,GrudgePlayer
2960,GrudgePlayer,149,274,423,16,31,GrudgePlayer
2961,GrudgePlayer,138,278,416,12,32,GrudgePlayer
2962,GrudgePlayer,130,255,385,14,43,GrudgePlayer
2963,GrudgePlayer,116,256,372,10,46,GrudgePlayer
2964,GrudgePlayer,144,279,423,13,30,GrudgePlayer
2965,GrudgePlayer,139,274,413,12,33,GrudgePlayer
2966,GrudgePlayer,142,277,419,15,32,GrudgePlayer
2967,GrudgePlayer,133,273,406,14,36,GrudgePlayer
2968,GrudgePlayer,142,272,414,13,33,GrudgePlayer
2969,GrudgePlayer,139,259,398,15,39,GrudgePlayer
2970,GrudgePlayer,146,281,427,14,29,GrudgePlayer
2971,GrudgePlayer,104,264,368,3,45,GrudgePlayer
2972,GrudgePlayer,131,266,397,8,37,GrudgePlayer
2973,GrudgePlayer,133,273,406,14,36,GrudgePlayer
2974,GrudgePlayer,150,280,430,17,29,GrudgePlayer
2975,GrudgePlayer,142,272,414,16,34,GrudgePlayer
2976,GrudgePlayer,149,279,428,12,28,GrudgePlayer
2977,GrudgePlayer,144,259,403,14,37,GrudgePlayer
2978,GrudgePlayer,132,267,399,10,37,GrudgePlayer
2979,GrudgePlayer,122,252,374,9,45,GrudgePlayer
2980,GrudgePlayer,127,257,384,10,42,GrudgePlayer
2981,GrudgePlayer,146,276,422,15,31,GrudgePlayer
2982,GrudgePlayer,157,277,434,21,29,GrudgePlayer
2983,GrudgePlayer,151,281,432,16,28,GrudgePlayer
2984,GrudgePlayer,135,280,415,14,33,GrudgePlayer
2985,GrudgePlayer,130,270,400,11,37,GrudgePlayer
2986,GrudgePlayer,143,273,416,15,33,GrudgePlayer
2987,GrudgePlayer,123,258,381,4,41,GrudgePlayer
2988,GrudgePlayer,143,258,401,12,37,GrudgePlayer
2989,GrudgePlayer,146,256,402,16,38,GrudgePlayer
2990,GrudgePlayer,161,266,427,20,31,GrudgePlayer
2991,GrudgePlayer,161,266,427,23,32,GrudgePlayer
2992,GrudgePlayer,145,275,420,19,33,GrudgePlayer
2993,GrudgePlayer,143,273,416,18,34,GrudgePlayer
2994,GrudgePlayer,140,260,400,11,37,GrudgePlayer
2995,GrudgePlayer,158,273,431,21,30,GrudgePlayer
2996,GrudgePlayer,127,272,399,7,36,GrudgePlayer
2997,GrudgePlayer,142,272,414,13,33,GrudgePlayer
2998,GrudgePlayer,143,268,411,13,34,GrudgePlayer
2999,GrudgePlayer,158,253,411,22,37,GrudgePlayer
3000,GrudgePlayer,131,256,387,10,41,GrudgePlayer
3001,GrudgePlayer,140,265,405,16,37,GrudgePlayer
3002,GrudgePlayer,146,266,412,17,35,GrudgePlayer
3003,GrudgePlayer,177,277,454,29,25,GrudgePlayer
3004,GrudgePlayer,175,280,455,24,23,GrudgePlayer
3005,GrudgePlayer,153,273,426,19,31,GrudgePlayer
3006,GrudgePlayer,136,266,402,13,37,GrudgePlayer
3007,GrudgePlayer,107,242,349,2,51,GrudgePlayer
3008,GrudgePlayer,148,263,411,16,35,GrudgePlayer
3009,GrudgePlayer,154,289,443,18,25,GrudgePlayer
3010,GrudgePlayer,138,268,406,11,35,GrudgePlayer
3011,GrudgePlayer,155,270,425,21,32,GrudgePlayer
3012,GrudgePlayer,120,255,375,10,45,GrudgePlayer
3013,GrudgePlayer,139,264,403,14,37,GrudgePlayer
3014,GrudgePlayer,142,272,414,10,32,GrudgePlayer
3015,GrudgePlayer,143,258,401,15,38,GrudgePlayer
3016,GrudgePlayer,141,256,397,17,40,GrudgePlayer
3017,GrudgePlayer,136,261,397,14,39,GrudgePlayer
3018,GrudgePlayer,170,270,440,24,28,GrudgePlayer
3019,GrudgePlayer,132,252,384,10,42,GrudgePlayer
3020,GrudgePlayer,156,276,432,16,28,GrudgePlayer
3021,GrudgePlayer,150,270,420,13,31,GrudgePlayer
3022,GrudgePlayer,150,275,425,15,30,GrudgePlayer
3023,GrudgePlayer,134,274,408,13,35,GrudgePlayer
3024,GrudgePlayer,152,277,429,13,28,GrudgePlayer
3025,GrudgePlayer,139,274,413,12,33,GrudgePlayer
3026,GrudgePlayer,138,253,391,11,40,GrudgePlayer
3027,GrudgePlayer,157,277,434,18,28,GrudgePlayer
3028,GrudgePlayer,125,275,400,8,36,GrudgePlayer
3029,GrudgePlayer,169,284,453,19,22,GrudgePlayer
3030,GrudgePlayer,162,277,439,17,26,GrudgePlayer
3031,GrudgePlayer,161,266,427,20,31,GrudgePlayer
3032,GrudgePlayer,160,270,430,17,29,GrudgePlayer
3033,GrudgePlayer,165,265,430,23,31,GrudgePlayer
3034,GrudgePlayer,139,269,408,13,35,GrudgePlayer
3035,GrudgePlayer,129,264,393,10,39,GrudgePlayer
3036,GrudgePlayer,160,255,415,23,36,GrudgePlayer
3037,GrudgePlayer,135,265,400,11,37,GrudgePlayer
3038,GrudgePlayer,148,283,431,15,28,GrudgePlayer
3039,GrudgePlayer,125,230,355,8,51,GrudgePlayer
3040,GrudgePlayer,145,265,410,15,35,GrudgePlayer
3041,GrudgePlayer,144,264,408,13,35,GrudgePlayer
3042,GrudgePlayer,118,253,371,6,45,GrudgePlayer
3043,GrudgePlayer,144,259,403,11,36,GrudgePlayer
3044,GrudgePlayer,145,270,415,20,35,GrudgePlayer
3045,GrudgePlayer,143,268,411,13,34,GrudgePlayer
3046,GrudgePlayer,133,268,401,6,35,GrudgePlayer
3047,GrudgePlayer,139,264,403,11,36,GrudgePlayer
3048,GrudgePlayer,136,256,392,9,39,GrudgePlayer
3049,GrudgePlayer,142,282,424,8,28,GrudgePlayer
3050,GrudgePlayer,157,277,434,18,28,GrudgePlayer
3051,GrudgePlayer,130,270,400,8,36,GrudgePlayer
3052,GrudgePlayer,143,263,406,11,35,GrudgePlayer
3053,GrudgePlayer,132,282,414,10,32,GrudgePlayer
3054,GrudgePlayer,141,246,387,13,42,GrudgePlayer
3055,GrudgePlayer,160,270,430,23,31,GrudgePlayer
3056,GrudgePlayer,159,289,448,23,25,GrudgePlayer
3057,GrudgePlayer,135,260,395,12,39,GrudgePlayer
3058,GrudgePlayer,153,263,416,18,34,GrudgePlayer
3059,GrudgePlayer,151,251,402,19,39,GrudgePlayer
3060,GrudgePlayer,149,284,433,20,29,GrudgePlayer
3061,GrudgePlayer,175,275,450,25,25,GrudgePlayer
3062,GrudgePlayer,158,268,426,19,31,GrudgePlayer
3063,GrudgePlayer,139,264,403,14,37,GrudgePlayer
3064,GrudgePlayer,155,270,425,18,31,GrudgePlayer
3065,GrudgePlayer,154,269,423,19,32,GrudgePlayer
3066,GrudgePlayer,144,279,423,16,31,GrudgePlayer
3067,GrudgePlayer,147,287,434,12,26,GrudgePlayer
3068,GrudgePlayer,118,228,346,8,54,GrudgePlayer
3069,GrudgePlayer,143,273,416,18,34,GrudgePlayer
3070,GrudgePlayer,150,280,430,17,29,GrudgePlayer
3071,GrudgePlayer,149,264,413,15,34,GrudgePlayer
3072,GrudgePlayer,146,266,412,17,35,GrudgePlayer
3073,GrudgePlayer,140,250,390,16,42,GrudgePlayer
3074,GrudgePlayer,138,253,391,14,41,GrudgePlayer
3075,GrudgePlayer,156,261,417,25,36,GrudgePlayer
3076,GrudgePlayer,172,287,459,22,21,GrudgePlayer
3077,GrudgePlayer,151,296,447,16,23,GrudgePlayer
3078,GrudgePlayer,149,259,408,16,36,GrudgePlayer
3079,GrudgePlayer,148,273,421,17,32,GrudgePlayer
3080,GrudgePlayer,125,265,390,13,41,GrudgePlayer
3081,GrudgePlayer,132,262,394,14,40,GrudgePlayer
3082,GrudgePlayer,127,262,389,9,40,GrudgePlayer
3083,GrudgePlayer,144,274,418,14,32,GrudgePlayer
3084,GrudgePlayer,156,271,427,11,28,GrudgePlayer
3085,GrudgePlayer,149,259,408,19,37,GrudgePlayer
3086,GrudgePlayer,139,259,398,12,38,GrudgePlayer
3087,GrudgePlayer,138,263,401,18,39,GrudgePlayer
3088,GrudgePlayer,120,245,365,9,48,GrudgePlayer
3089,GrudgePlayer,166,281,447,19,24,GrudgePlayer
3090,GrudgePlayer,128,258,386,12,42,GrudgePlayer
3091,GrudgePlayer,155,270,425,15,30,GrudgePlayer
3092,GrudgePlayer,160,280,440,18,26,GrudgePlayer
3093,GrudgePlayer,143,268,411,16,35,GrudgePlayer
3094,GrudgePlayer,143,278,421,14,31,GrudgePlayer
3095,GrudgePlayer,153,268,421,20,33,GrudgePlayer
3096,GrudgePlayer,144,269,413,15,34,GrudgePlayer
3097,GrudgePlayer,138,253,391,14,41,GrudgePlayer
3098,GrudgePlayer,152,272,424,17,31,GrudgePlayer
3099,GrudgePlayer,139,284,423,10,29,GrudgePlayer
3100,GrudgePlayer,136,261,397,14,39,GrudgePlayer
3101,GrudgePlayer,167,262,429,25,32,GrudgePlayer
3102,GrudgePlayer,142,277,419,12,31,GrudgePlayer
3103,GrudgePlayer,139,274,413,18,35,GrudgePlayer
3104,GrudgePlayer,172,272,444,25,27,GrudgePlayer
3105,GrudgePlayer,122,252,374,9,45,GrudgePlayer
3106,GrudgePlayer,155,270,425,18,31,GrudgePlayer
3107,GrudgePlayer,148,258,406,14,36,GrudgePlayer
3108,GrudgePlayer,143,253,396,16,40,GrudgePlayer
3109,GrudgePlayer,163,263,426,22,32,GrudgePlayer
3110,GrudgePlayer,136,256,392,12,40,GrudgePlayer
3111,GrudgePlayer,136,251,387,10,41,GrudgePlayer
3112,GrudgePlayer,129,284,413,12,33,GrudgePlayer
3113,GrudgePlayer,124,274,398,9,37,GrudgePlayer
3114,GrudgePlayer,151,271,422,15,31,GrudgePlayer
3115,GrudgePlayer,129,269,398,12,38,GrudgePlayer
3116,GrudgePlayer,149,264,413,15,34,GrudgePlayer
3117,GrudgePlayer,145,265,410,15,35,GrudgePlayer
3118,GrudgePlayer,156,271,427,17,30,GrudgePlayer
3119,GrudgePlayer,126,251,377,9,44,GrudgePlayer
3120,GrudgePlayer,143,283,426,16,30,GrudgePlayer
3121,GrudgePlayer,128,273,401,9,36,GrudgePlayer
3122,GrudgePlayer,167,277,444,28,28,GrudgePlayer
3123,GrudgePlayer,146,261,407,15,36,GrudgePlayer
3124,GrudgePlayer,154,279,433,17,28,GrudgePlayer
3125,GrudgePlayer,142,262,404,15,37,GrudgePlayer
3126,GrudgePlayer,116,256,372,10,46,GrudgePlayer
3127,GrudgePlayer,135,275,410,9,33,GrudgePlayer
3128,GrudgePlayer,131,251,382,8,42,GrudgePlayer
3129,GrudgePlayer,105,255,360,7,49,GrudgePlayer
3130,GrudgePlayer,142,252,394,17,41,GrudgePlayer
3131,GrudgePlayer,147,282,429,22,31,GrudgePlayer
3132,GrudgePlayer,160,280,440,18,26,GrudgePlayer
3133,GrudgePlayer,136,266,402,13,37,GrudgePlayer
3134,GrudgePlayer,164,279,443,21,26,GrudgePlayer
3135,GrudgePlayer,162,287,449,18,23,GrudgePlayer
3136,GrudgePlayer,169,279,448,20,24,GrudgePlayer
3137,GrudgePlayer,140,280,420,13,31,GrudgePlayer
3138,GrudgePlayer,143,278,421,14,31,GrudgePlayer
3139,GrudgePlayer,132,267,399,13,38,GrudgePlayer
3140,GrudgePlayer,133,263,396,13,39,GrudgePlayer
3141,GrudgePlayer,142,292,434,15,27,GrudgePlayer
3142,GrudgePlayer,150,255,405,19,38,GrudgePlayer
3143,GrudgePlayer,126,256,382,8,42,GrudgePlayer
3144,GrudgePlayer,145,275,420,10,30,GrudgePlayer
3145,GrudgePlayer,142,262,404,15,37,GrudgePlayer
3146,GrudgePlayer,128,268,396,7,37,GrudgePlayer
3147,GrudgePlayer,137,267,404,12,36,GrudgePlayer
3148,GrudgePlayer,119,274,393,7,38,GrudgePlayer
3149,GrudgePlayer,129,269,398,12,38,GrudgePlayer
3150,GrudgePlayer,151,286,437,18,27,GrudgePlayer
3151,GrudgePlayer,144,279,423,16,31,GrudgePlayer
3152,GrudgePlayer,143,278,421,14,31,GrudgePlayer
3153,GrudgePlayer,114,274,388,5,39,GrudgePlayer
3154,GrudgePlayer,124,269,393,13,40,GrudgePlayer
3155,GrudgePlayer,139,274,413,9,32,GrudgePlayer
3156,GrudgePlayer,184,289,473,33,20,GrudgePlayer
3157,GrudgePlayer,121,261,382,8,42,GrudgePlayer
3158,GrudgePlayer,155,275,430,11,27,GrudgePlayer
3159,GrudgePlayer,156,271,427,23,32,GrudgePlayer
3160,GrudgePlayer,124,254,378,7,43,GrudgePlayer
3161,GrudgePlayer,135,270,405,13,36,GrudgePlayer
3162,GrudgePlayer,134,249,383,12,43,GrudgePlayer
3163,GrudgePlayer,138,268,406,8,34,GrudgePlayer
3164,GrudgePlayer,137,267,404,12,36,GrudgePlayer
3165,GrudgePlayer,170,275,445,29,28,GrudgePlayer
3166,GrudgePlayer,145,265,410,21,37,GrudgePlayer
3167,GrudgePlayer,129,274,403,11,36,GrudgePlayer
3168,GrudgePlayer,129,269,398,9,37,GrudgePlayer
3169,GrudgePlayer,142,267,409,14,35,GrudgePlayer
3170,GrudgePlayer,157,272,429,22,31,GrudgePlayer
3171,GrudgePlayer,125,275,400,8,36,GrudgePlayer
3172,GrudgePlayer,163,273,436,23,29,GrudgePlayer
3173,GrudgePlayer,145,275,420,13,31,GrudgePlayer
3174,GrudgePlayer,145,270,415,17,34,GrudgePlayer
3175,GrudgePlayer,173,278,451,20,23,GrudgePlayer
3176,GrudgePlayer,142,262,404,12,36,GrudgePlayer
3177,GrudgePlayer,124,244,368,9,47,GrudgePlayer
3178,GrudgePlayer,155,285,440,24,28,GrudgePlayer
3179,GrudgePlayer,122,252,374,12,46,GrudgePlayer
3180,GrudgePlayer,153,273,426,19,31,GrudgePlayer
3181,GrudgePlayer,146,241,387,16,43,GrudgePlayer
3182,GrudgePlayer,131,271,402,7,35,GrudgePlayer
3183,GrudgePlayer,115,265,380,12,44,GrudgePlayer
3184,GrudgePlayer,143,273,416,15,33,GrudgePlayer
3185,GrudgePlayer,129,264,393,10,39,GrudgePlayer
3186,GrudgePlayer,124,274,398,12,38,GrudgePlayer
3187,GrudgePlayer,136,281,417,16,33,GrudgePlayer
3188,GrudgePlayer,135,270,405,10,35,GrudgePlayer
3189,GrudgePlayer,175,275,450,28,26,GrudgePlayer
3190,GrudgePlayer,128,248,376,14,46,GrudgePlayer
3191,GrudgePlayer,144,269,413,18,35,GrudgePlayer
3192,GrudgePlayer,156,276,432,16,28,GrudgePlayer
3193,GrudgePlayer,115,265,380,6,42,GrudgePlayer
3194,GrudgePlayer,131,256,387,7,40,GrudgePlayer
3195,GrudgePlayer,141,261,402,13,37,GrudgePlayer
3196,GrudgePlayer,143,288,431,15,28,GrudgePlayer
3197,GrudgePlayer,129,234,363,13,50,GrudgePlayer
3198,GrudgePlayer,143,243,386,18,44,GrudgePlayer
3199,GrudgePlayer,150,260,410,18,36,GrudgePlayer
3200,GrudgePlayer,146,276,422,15,31,GrudgePlayer
3201,GrudgePlayer,168,268,436,23,29,GrudgePlayer
3202,GrudgePlayer,116,251,367,5,46,GrudgePlayer
3203,GrudgePlayer,130,245,375,13,46,GrudgePlayer
3204,GrudgePlayer,150,280,430,11,27,GrudgePlayer
3205,GrudgePlayer,144,249,393,16,41,GrudgePlayer
3206,GrudgePlayer,137,277,414,13,33,GrudgePlayer
3207,GrudgePlayer,171,276,447,25,26,GrudgePlayer
3208,GrudgePlayer,146,281,427,14,29,GrudgePlayer
3209,GrudgePlayer,145,275,420,13,31,GrudgePlayer
3210,GrudgePlayer,129,264,393,10,39,GrudgePlayer
3211,GrudgePlayer,156,276,432,19,29,GrudgePlayer
3212,GrudgePlayer,134,274,408,13,35,GrudgePlayer
3213,GrudgePlayer,145,275,420,19,33,GrudgePlayer
3214,GrudgePlayer,154,254,408,16,36,GrudgePlayer
3215,GrudgePlayer,173,278,451,29,26,GrudgePlayer
3216,GrudgePlayer,145,260,405,19,38,GrudgePlayer
3217,GrudgePlayer,146,281,427,14,29,GrudgePlayer
3218,GrudgePlayer,150,290,440,15,25,GrudgePlayer
3219,GrudgePlayer,121,246,367,5,46,GrudgePlayer
3220,GrudgePlayer,153,283,436,17,27,GrudgePlayer
3221,GrudgePlayer,123,248,371,6,45,GrudgePlayer
3222,GrudgePlayer,148,283,431,15,28,GrudgePlayer
3223,GrudgePlayer,159,279,438,19,27,GrudgePlayer
3224,GrudgePlayer,134,264,398,12,38,GrudgePlayer
3225,GrudgePlayer,131,276,407,12,35,GrudgePlayer
3226,GrudgePlayer,143,253,396,16,40,GrudgePlayer
3227,GrudgePlayer,131,276,407,12,35,GrudgePlayer
3228,GrudgePlayer,134,259,393,10,39,GrudgePlayer
3229,GrudgePlayer,131,246,377,9,44,GrudgePlayer
3230,GrudgePlayer,111,246,357,7,50,GrudgePlayer
3231,GrudgePlayer,169,289,458,24,22,GrudgePlayer
3232,GrudgePlayer,142,272,414,16,34,GrudgePlayer
3233,GrudgePlayer,114,254,368,6,46,GrudgePlayer
3234,GrudgePlayer,173,268,441,25,28,GrudgePlayer
3235,GrudgePlayer,137,272,409,8,33,GrudgePlayer
3236,GrudgePlayer,174,269,443,30,29,GrudgePlayer
3237,GrudgePlayer,126,261,387,7,40,GrudgePlayer
3238,GrudgePlayer,116,261,377,6,43,GrudgePlayer
3239,GrudgePlayer,138,268,406,11,35,GrudgePlayer
3240,GrudgePlayer,122,267,389,6,39,GrudgePlayer
3241,GrudgePlayer,162,277,439,26,29,GrudgePlayer
3242,GrudgePlayer,162,287,449,21,24,GrudgePlayer
3243,GrudgePlayer,137,267,404,9,35,GrudgePlayer
3244,GrudgePlayer,130,245,375,7,44,GrudgePlayer
3245,GrudgePlayer,132,257,389,12,41,GrudgePlayer
3246,GrudgePlayer,122,272,394,8,38,GrudgePlayer
3247,GrudgePlayer,169,259,428,24,32,GrudgePlayer
3248,GrudgePlayer,123,253,376,8,44,GrudgePlayer
3249,GrudgePlayer,134,259,393,10,39,GrudgePlayer
3250,GrudgePlayer,135,255,390,13,41,GrudgePlayer
3251,GrudgePlayer,153,278,431,21,30,GrudgePlayer
3252,GrudgePlayer,152,282,434,18,28,GrudgePlayer
3253,GrudgePlayer,139,259,398,12,38,GrudgePlayer
3254,GrudgePlayer,111,251,362,6,48,GrudgePlayer
3255,GrudgePlayer,157,292,449,18,23,GrudgePlayer
3256,GrudgePlayer,125,275,400,8,36,GrudgePlayer
3257,GrudgePlayer,138,268,406,14,36,GrudgePlayer
3258,GrudgePlayer,156,281,437,15,26,GrudgePlayer
3259,GrudgePlayer,127,262,389,12,41,GrudgePlayer
3260,GrudgePlayer,143,263,406,11,35,GrudgePlayer
3261,GrudgePlayer,133,258,391,14,41,GrudgePlayer
3262,GrudgePlayer,143,278,421,14,31,GrudgePlayer
3263,GrudgePlayer,132,252,384,13,43,GrudgePlayer
3264,GrudgePlayer,156,276,432,19,29,GrudgePlayer
3265,GrudgePlayer,123,268,391,11,40,GrudgePlayer
3266,GrudgePlayer,148,278,426,16,30,GrudgePlayer
3267,GrudgePlayer,140,270,410,12,34,GrudgePlayer
3268,GrudgePlayer,149,264,413,12,33,GrudgePlayer
3269,GrudgePlayer,156,266,422,18,32,GrudgePlayer
3270,GrudgePlayer,117,242,359,6,49,GrudgePlayer
3271,GrudgePlayer,142,277,419,9,30,GrudgePlayer
3272,GrudgePlayer,129,269,398,9,37,GrudgePlayer
3273,GrudgePlayer,137,272,409,11,34,GrudgePlayer
3274,GrudgePlayer,132,252,384,10,42,GrudgePlayer
3275,GrudgePlayer,176,271,447,31,28,GrudgePlayer
3276,GrudgePlayer,129,284,413,6,31,GrudgePlayer
3277,GrudgePlayer,128,268,396,10,38,GrudgePlayer
3278,GrudgePlayer,136,261,397,11,38,GrudgePlayer
3279,GrudgePlayer,126,266,392,9,39,GrudgePlayer
3280,GrudgePlayer,140,270,410,12,34,GrudgePlayer
3281,GrudgePlayer,127,247,374,9,45,GrudgePlayer
3282,GrudgePlayer,138,293,431,15,28,GrudgePlayer
3283,GrudgePlayer,139,269,408,16,36,GrudgePlayer
3284,GrudgePlayer,147,287,434,15,27,GrudgePlayer
3285,GrudgePlayer,146,271,417,13,32,GrudgePlayer
3286,GrudgePlayer,157,292,449,15,22,GrudgePlayer
3287,GrudgePlayer,119,259,378,7,43,GrudgePlayer
3288,GrudgePlayer,140,270,410,15,35,GrudgePlayer
3289,GrudgePlayer,145,260,405,19,38,GrudgePlayer
3290,GrudgePlayer,127,247,374,12,46,GrudgePlayer
3291,GrudgePlayer,152,282,434,15,27,GrudgePlayer
3292,GrudgePlayer,120,250,370,5,45,GrudgePlayer
3293,GrudgePlayer,144,279,423,16,31,GrudgePlayer
3294,GrudgePlayer,164,274,438,22,28,GrudgePlayer
3295,GrudgePlayer,156,281,437,18,27,GrudgePlayer
3296,GrudgePlayer,130,270,400,14,38,GrudgePlayer
3297,GrudgePlayer,150,260,410,15,35,GrudgePlayer
3298,GrudgePlayer,128,268,396,10,38,GrudgePlayer
3299,GrudgePlayer,137,262,399,10,37,GrudgePlayer
3300,GrudgePlayer,124,279,403,5,34,GrudgePlayer
3301,GrudgePlayer,140,280,420,16,32,GrudgePlayer
3302,GrudgePlayer,157,277,434,18,28,GrudgePlayer
3303,GrudgePlayer,150,275,425,21,32,GrudgePlayer
3304,GrudgePlayer,147,272,419,15,32,GrudgePlayer
3305,GrudgePlayer,149,254,403,17,38,GrudgePlayer
3306,GrudgePlayer,136,266,402,16,38,GrudgePlayer
3307,GrudgePlayer,148,293,441,13,24,GrudgePlayer
3308,GrudgePlayer,128,253,381,7,42,GrudgePlayer
3309,GrudgePlayer,146,256,402,13,37,GrudgePlayer
3310,GrudgePlayer,159,289,448,20,24,GrudgePlayer
3311,GrudgePlayer,140,270,410,12,34,GrudgePlayer
3312,GrudgePlayer,137,267,404,12,36,GrudgePlayer
3313,GrudgePlayer,140,270,410,12,34,GrudgePlayer
3314,GrudgePlayer,156,276,432,13,27,GrudgePlayer
3315,GrudgePlayer,166,276,442,23,27,GrudgePlayer
3316,GrudgePlayer,154,264,418,23,35,GrudgePlayer
3317,GrudgePlayer,155,285,440,15,25,GrudgePlayer
3318,GrudgePlayer,132,272,404,6,34,GrudgePlayer
3319,GrudgePlayer,153,268,421,17,32,GrudgePlayer
3320,GrudgePlayer,139,254,393,13,40,GrudgePlayer
0,Gullible,376,186,562,62,0,Player A
1,Gullible,386,171,557,57,0,Player A
2,Gullible,382,177,559,59,0,Player A
3,Gullible,394,159,553,53,0,Player A
4,Gullible,402,147,549,49,0,Player A
5,Gullible,408,138,546,46,0,Player A
6,Gullible,402,147,549,49,0,Player A
7,Gullible,400,150,550,50,0,Player A
8,Gullible,396,156,552,52,0,Player A
9,Gullible,386,171,557,57,0,Player A
10,Gullible,406,141,547,47,0,Player A
11,Gullible,386,171,557,57,0,Player A
12,Gullible,394,159,553,53,0,Player A
13,Gullible,408,138,546,46,0,Player A
14,Gullible,390,165,555,55,0,Player A
15,Gullible,392,162,554,54,0,Player A
16,Gullible,404,144,548,48,0,Player A
17,Gullible,406,141,547,47,0,Player A
18,Gullible,402,147,549,49,0,Player A
19,Gullible,402,147,549,49,0,Player A
20,Gullible,388,168,556,56,0,Player A
21,Gullible,406,141,547,47,0,Player A
22,Gullible,402,147,549,49,0,Player A
23,Gullible,392,162,554,54,0,Player A
24,Gullible,390,165,555,55,0,Player A
25,Gullible,396,156,552,52,0,Player A
26,Gullible,424,114,538,38,0,Player A
27,Gullible,410,135,545,45,0,Player A
28,Gullible,400,150,550,50,0,Player A
29,Gullible,392,162,554,54,0,Player A
30,Gullible,400,150,550,50,0,Player A
31,Gullible,404,144,548,48,0,Player A
32,Gullible,408,138,546,46,0,Player A
33,Gullible,378,183,561,61,0,Player A
34,Gullible,400,150,550,50,0,Player A
35,Gullible,388,168,556,56,0,Player A
36,Gullible,390,165,555,55,0,Player A
37,Gullible,394,159,553,53,0,Player A
38,Gullible,400,150,550,50,0,Player A
39,Gullible,396,156,552,52,0,Player A
40,Gullible,394,159,553,53,0,Player A
41,Gullible,422,117,539,39,0,Player A
42,Gullible,400,150,550,50,0,Player A
43,Gullible,398,153,551,51,0,Player A
44,Gullible,400,150,550,50,0,Player A
45,Gullible,390,165,555,55,0,Player A
46,Gullible,394,159,553,53,0,Player A
47,Gullible,394,159,553,53,0,Player A
48,Gullible,402,147,549,49,0,Player A
49,Gullible,400,150,550,50,0,Player A
50,Gullible,404,144,548,48,0,Player A
51,Gullible,400,150,550,50,0,Player A
52,Gullible,400,150,550,50,0,Player A
53,Gullible,394,159,553,53,0,Player A
54,Gullible,394,159,553,53,0,Player A
55,Gullible,402,147,549,49,0,Player A
56,Gullible,416,126,542,42,0,Player A
57,Gullible,400,150,550,50,0,Player A
58,Gullible,400,150,550,50,0,Player A
59,Gullible,396,156,552,52,0,Player A
60,Gullible,404,144,548,48,0,Player A
61,Gullible,392,162,554,54,0,Player A
62,Gullible,396,156,552,52,0,Player A
63,Gullible,384,174,558,58,0,Player A
64,Gullible,398,153,551,51,0,Player A
65,Gullible,408,138,546,46,0,Player A
66,Gullible,400,150,550,50,0,Player A
67,Gullible,384,174,558,58,0,Player A
68,Gullible,384,174,558,58,0,Player A
69,Gullible,402,147,549,49,0,Player A
70,Gullible,388,168,556,56,0,Player A
71,Gullible,384,174,558,58,0,Player A
72,Gullible,378,183,561,61,0,Player A
73,Gullible,380,180,560,60,0,Player A
74,Gullible,408,138,546,46,0,Player A
75,Gullible,402,147,549,49,0,Player A
76,Gullible,402,147,549,49,0,Player A
77,Gullible,378,183,561,61,0,Player A
78,Gullible,402,147,549,49,0,Player A
79,Gullible,398,153,551,51,0,Player A
80,Gullible,402,147,549,49,0,Player A
81,Gullible,404,144,548,48,0,Player A
82,Gullible,394,159,553,53,0,Player A
83,Gullible,388,168,556,56,0,Player A
84,Gullible,392,162,554,54,0,Player A
85,Gullible,402,147,549,49,0,Player A
86,Gullible,396,156,552,52,0,Player A
87,Gullible,400,150,550,50,0,Player A
88,Gullible,388,168,556,56,0,Player A
89,Gullible,374,189,563,63,0,Player A
90,Gullible,402,147,549,49,0,Player A
91,Gullible,382,177,559,59,0,Player A
92,Gullible,404,144,548,48,0,Player A
93,Gullible,396,156,552,52,0,Player A
94,Gullible,404,144,548,48,0,Player A
95,Gullible,388,168,556,56,0,Player A
96,Gullible,392,162,554,54,0,Player A
97,Gullible,400,150,550,50,0,Player A
98,Gullible,398,153,551,51,0,Player A
99,Gullible,392,162,554,54,0,Player A
100,Gullible,398,153,551,51,0,Player A
101,Gullible,396,156,552,52,0,Player A
0,Sly Fox,47,312,359,0,47,Sly Fox
1,Sly Fox,48,308,356,0,48,Sly Fox
2,Sly Fox,55,280,335,0,55,Sly Fox
3,Sly Fox,51,296,347,0,51,Sly Fox
4,Sly Fox,49,304,353,0,49,Sly Fox
5,Sly Fox,50,300,350,0,50,Sly Fox
6,Sly Fox,45,320,365,0,45,Sly Fox
7,Sly Fox,45,320,365,0,45,Sly Fox
8,Sly Fox,46,316,362,0,46,Sly Fox
9,Sly Fox,46,316,362,0,46,Sly Fox
10,Sly Fox,42,332,374,0,42,Sly Fox
11,Sly Fox,47,312,359,0,47,Sly Fox
12,Sly Fox,54,284,338,0,54,Sly Fox
13,Sly Fox,50,300,350,0,50,Sly Fox
14,Sly Fox,53,288,341,0,53,Sly Fox
15,Sly Fox,59,264,323,0,59,Sly Fox
16,Sly Fox,55,280,335,0,55,Sly Fox
17,Sly Fox,41,336,377,0,41,Sly Fox
18,Sly Fox,46,316,362,0,46,Sly Fox
19,Sly Fox,45,320,365,0,45,Sly Fox
20,Sly Fox,50,300,350,0,50,Sly Fox
21,Sly Fox,53,288,341,0,53,Sly Fox
22,Sly Fox,60,260,320,0,60,Sly Fox
23,Sly Fox,49,304,353,0,49,Sly Fox
24,Sly Fox,52,292,344,0,52,Sly Fox
25,Sly Fox,51,296,347,0,51,Sly Fox
26,Sly Fox,47,312,359,0,47,Sly Fox
27,Sly Fox,50,300,350,0,50,Sly Fox
28,Sly Fox,52,292,344,0,52,Sly Fox
29,Sly Fox,48,308,356,0,48,Sly Fox
30,Sly Fox,42,332,374,0,42,Sly Fox
31,Sly Fox,46,316,362,0,46,Sly Fox
32,Sly Fox,47,312,359,0,47,Sly Fox
33,Sly Fox,53,288,341,0,53,Sly Fox
34,Sly Fox,50,300,350,0,50,Sly Fox
35,Sly Fox,44,324,368,0,44,Sly Fox
36,Sly Fox,42,332,374,0,42,Sly Fox
37,Sly Fox,43,328,371,0,43,Sly Fox
38,Sly Fox,52,292,344,0,52,Sly Fox
39,Sly Fox,56,276,332,0,56,Sly Fox
40,Sly Fox,36,356,392,0,36,Sly Fox
41,Sly Fox,43,328,371,0,43,Sly Fox
42,Sly Fox,50,300,350,0,50,Sly Fox
43,Sly Fox,48,308,356,0,48,Sly Fox
44,Sly Fox,50,300,350,0,50,Sly Fox
45,Sly Fox,46,316,362,0,46,Sly Fox
46,Sly Fox,47,312,359,0,47,Sly Fox
47,Sly Fox,45,320,365,0,45,Sly Fox
48,Sly Fox,43,328,371,0,43,Sly Fox
49,Sly Fox,57,272,329,0,57,Sly Fox
50,Sly Fox,55,280,335,0,55,Sly Fox
51,Sly Fox,51,296,347,0,51,Sly Fox
52,Sly Fox,50,300,350,0,50,Sly Fox
53,Sly Fox,49,304,353,0,49,Sly Fox
54,Sly Fox,45,320,365,0,45,Sly Fox
55,Sly Fox,41,336,377,0,41,Sly Fox
56,Sly Fox,55,280,335,0,55,Sly Fox
57,Sly Fox,43,328,371,0,43,Sly Fox
58,Sly Fox,51,296,347,0,51,Sly Fox
59,Sly Fox,49,304,353,0,49,Sly Fox
60,Sly Fox,51,296,347,0,51,Sly Fox
61,Sly Fox,43,328,371,0,43,Sly Fox
62,Sly Fox,44,324,368,0,44,Sly Fox
63,Sly Fox,53,288,341,0,53,Sly Fox
64,Sly Fox,38,348,386,0,38,Sly Fox
65,Sly Fox,50,300,350,0,50,Sly Fox
66,Sly Fox,55,280,335,0,55,Sly Fox
67,Sly Fox,48,308,356,0,48,Sly Fox
68,Sly Fox,40,340,380,0,40,Sly Fox
69,Sly Fox,40,340,380,0,40,Sly Fox
70,Sly Fox,58,268,326,0,58,Sly Fox
71,Sly Fox,48,308,356,0,48,Sly Fox
72,Sly Fox,43,328,371,0,43,Sly Fox
73,Sly Fox,50,300,350,0,50,Sly Fox
74,Sly Fox,48,308,356,0,48,Sly Fox
75,Sly Fox,43,328,371,0,43,Sly Fox
76,Sly Fox,48,308,356,0,48,Sly Fox
77,Sly Fox,55,280,335,0,55,Sly Fox
78,Sly Fox,42,332,374,0,42,Sly Fox
79,Sly Fox,51,296,347,0,51,Sly Fox
80,Sly Fox,48,308,356,0,48,Sly Fox
81,Sly Fox,46,316,362,0,46,Sly Fox
82,Sly Fox,49,304,353,0,49,Sly Fox
83,Sly Fox,45,320,365,0,45,Sly Fox
84,Sly Fox,52,292,344,0,52,Sly Fox
85,Sly Fox,53,288,341,0,53,Sly Fox
86,Sly Fox,56,276,332,0,56,Sly Fox
87,Sly Fox,49,304,353,0,49,Sly Fox
88,Sly Fox,50,300,350,0,50,Sly Fox
89,Sly Fox,38,348,386,0,38,Sly Fox
90,Sly Fox,48,308,356,0,48,Sly Fox
91,Sly Fox,52,292,344,0,52,Sly Fox
92,Sly Fox,42,332,374,0,42,Sly Fox
93,Sly Fox,49,304,353,0,49,Sly Fox
94,Sly Fox,50,300,350,0,50,Sly Fox
95,Sly Fox,51,296,347,0,51,Sly Fox
96,Sly Fox,46,316,362,0,46,Sly Fox
97,Sly Fox,53,288,341,0,53,Sly Fox
98,Sly Fox,51,296,347,0,51,Sly Fox
99,Sly Fox,44,324,368,0,44,Sly Fox
100,Sly Fox,50,300,350,0,50,Sly Fox
101,Sly Fox,50,300,350,0,50,Sly Fox
102,Sly Fox,45,320,365,0,45,Sly Fox
103,Sly Fox,46,316,362,0,46,Sly Fox
104,Sly Fox,43,328,371,0,43,Sly Fox
105,Sly Fox,57,272,329,0,57,Sly Fox
106,Sly Fox,55,280,335,0,55,Sly Fox
107,Sly Fox,49,304,353,0,49,Sly Fox
108,Sly Fox,51,296,347,0,51,Sly Fox
109,Sly Fox,47,312,359,0,47,Sly Fox
110,Sly Fox,43,328,371,0,43,Sly Fox
111,Sly Fox,51,296,347,0,51,Sly Fox
112,Sly Fox,43,328,371,0,43,Sly Fox
113,Sly Fox,55,280,335,0,55,Sly Fox
114,Sly Fox,54,284,338,0,54,Sly Fox
115,Sly Fox,51,296,347,0,51,Sly Fox
116,Sly Fox,50,300,350,0,50,Sly Fox
117,Sly Fox,49,304,353,0,49,Sly Fox
118,Sly Fox,53,288,341,0,53,Sly Fox
119,Sly Fox,51,296,347,0,51,Sly Fox
120,Sly Fox,47,312,359,0,47,Sly Fox
121,Sly Fox,47,312,359,0,47,Sly Fox
122,Sly Fox,43,328,371,0,43,Sly Fox
123,Sly Fox,46,316,362,0,46,Sly Fox
124,Sly Fox,46,316,362,0,46,Sly Fox
125,Sly Fox,42,332,374,0,42,Sly Fox
126,Sly Fox,50,300,350,0,50,Sly Fox
127,Sly Fox,40,340,380,0,40,Sly Fox
128,Sly Fox,51,296,347,0,51,Sly Fox
129,Sly Fox,42,332,374,0,42,Sly Fox
130,Sly Fox,44,324,368,0,44,Sly Fox
131,Sly Fox,44,324,368,0,44,Sly Fox
132,Sly Fox,54,284,338,0,54,Sly Fox
133,Sly Fox,44,324,368,0,44,Sly Fox
134,Sly Fox,44,324,368,0,44,Sly Fox
135,Sly Fox,43,328,371,0,43,Sly Fox
136,Sly Fox,45,320,365,0,45,Sly Fox
137,Sly Fox,44,324,368,0,44,Sly Fox
138,Sly Fox,51,296,347,0,51,Sly Fox
139,Sly Fox,50,300,350,0,50,Sly Fox
140,Sly Fox,52,292,344,0,52,Sly Fox
141,Sly Fox,44,324,368,0,44,Sly Fox
142,Sly Fox,44,324,368,0,44,Sly Fox
143,Sly Fox,47,312,359,0,47,Sly Fox
144,Sly Fox,39,344,383,0,39,Sly Fox
145,Sly Fox,54,284,338,0,54,Sly Fox
146,Sly Fox,58,268,326,0,58,Sly Fox
147,Sly Fox,52,292,344,0,52,Sly Fox
148,Sly Fox,50,300,350,0,50,Sly Fox
149,Sly Fox,41,336,377,0,41,Sly Fox
150,Sly Fox,50,300,350,0,50,Sly Fox
151,Sly Fox,55,280,335,0,55,Sly Fox
152,Sly Fox,44,324,368,0,44,Sly Fox
153,Sly Fox,52,292,344,0,52,Sly Fox
154,Sly Fox,39,344,383,0,39,Sly Fox
155,Sly Fox,56,276,332,0,56,Sly Fox
156,Sly Fox,52,292,344,0,52,Sly Fox
157,Sly Fox,46,316,362,0,46,Sly Fox
158,Sly Fox,46,316,362,0,46,Sly Fox
159,Sly Fox,49,304,353,0,49,Sly Fox
160,Sly Fox,50,300,350,0,50,Sly Fox
161,Sly Fox,44,324,368,0,44,Sly Fox
162,Sly Fox,45,320,365,0,45,Sly Fox
163,Sly Fox,49,304,353,0,49,Sly Fox
164,Sly Fox,49,304,353,0,49,Sly Fox
165,Sly Fox,49,304,353,0,49,Sly Fox
166,Sly Fox,36,356,392,0,36,Sly Fox
167,Sly Fox,54,284,338,0,54,Sly Fox
168,Sly Fox,53,288,341,0,53,Sly Fox
169,Sly Fox,49,304,353,0,49,Sly Fox
170,Sly Fox,49,304,353,0,49,Sly Fox
171,Sly Fox,49,304,353,0,49,Sly Fox
172,Sly Fox,46,316,362,0,46,Sly Fox
173,Sly Fox,47,312,359,0,47,Sly Fox
174,Sly Fox,51,296,347,0,51,Sly Fox
175,Sly Fox,49,304,353,0,49,Sly Fox
176,Sly Fox,49,304,353,0,49,Sly Fox
177,Sly Fox,47,312,359,0,47,Sly Fox
178,Sly Fox,51,296,347,0,51,Sly Fox
179,Sly Fox,52,292,344,0,52,Sly Fox
180,Sly Fox,49,304,353,0,49,Sly Fox
181,Sly Fox,50,300,350,0,50,Sly Fox
182,Sly Fox,53,288,341,0,53,Sly Fox
183,Sly Fox,53,288,341,0,53,Sly Fox
184,Sly Fox,45,320,365,0,45,Sly Fox
185,Sly Fox,50,300,350,0,50,Sly Fox
186,Sly Fox,49,304,353,0,49,Sly Fox
187,Sly Fox,34,364,398,0,34,Sly Fox
188,Sly Fox,49,304,353,0,49,Sly Fox
189,Sly Fox,47,312,359,0,47,Sly Fox
190,Sly Fox,50,300,350,0,50,Sly Fox
191,Sly Fox,49,304,353,0,49,Sly Fox
192,Sly Fox,68,228,296,0,68,Sly Fox
193,Sly Fox,53,288,341,0,53,Sly Fox
194,Sly Fox,48,308,356,0,48,Sly Fox
195,Sly Fox,57,272,329,0,57,Sly Fox
196,Sly Fox,52,292,344,0,52,Sly Fox
197,Sly Fox,49,304,353,0,49,Sly Fox
198,Sly Fox,47,312,359,0,47,Sly Fox
199,Sly Fox,45,320,365,0,45,Sly Fox
200,Sly Fox,52,292,344,0,52,Sly Fox
201,Sly Fox,52,292,344,0,52,Sly Fox
202,Sly Fox,49,304,353,0,49,Sly Fox
203,Sly Fox,48,308,356,0,48,Sly Fox
204,Sly Fox,48,308,356,0,48,Sly Fox
205,Sly Fox,57,272,329,0,57,Sly Fox
206,Sly Fox,51,296,347,0,51,Sly Fox
207,Sly Fox,51,296,347,0,51,Sly Fox
208,Sly Fox,48,308,356,0,48,Sly Fox
209,Sly Fox,45,320,365,0,45,Sly Fox
210,Sly Fox,59,264,323,0,59,Sly Fox
211,Sly Fox,43,328,371,0,43,Sly Fox
212,Sly Fox,58,268,326,0,58,Sly Fox
213,Sly Fox,48,308,356,0,48,Sly Fox
214,Sly Fox,45,320,365,0,45,Sly Fox
215,Sly Fox,46,316,362,0,46,Sly Fox
216,Sly Fox,49,304,353,0,49,Sly Fox
217,Sly Fox,41,336,377,0,41,Sly Fox
218,Sly Fox,47,312,359,0,47,Sly Fox
219,Sly Fox,46,316,362,0,46,Sly Fox
220,Sly Fox,46,316,362,0,46,Sly Fox
221,Sly Fox,44,324,368,0,44,Sly Fox
222,Sly Fox,47,312,359,0,47,Sly Fox
223,Sly Fox,56,276,332,0,56,Sly Fox
224,Sly Fox,43,328,371,0,43,Sly Fox
225,Sly Fox,55,280,335,0,55,Sly Fox
226,Sly Fox,51,296,347,0,51,Sly Fox
227,Sly Fox,49,304,353,0,49,Sly Fox
228,Sly Fox,51,296,347,0,51,Sly Fox
229,Sly Fox,44,324,368,0,44,Sly Fox
230,Sly Fox,54,284,338,0,54,Sly Fox
231,Sly Fox,42,332,374,0,42,Sly Fox
232,Sly Fox,57,272,329,0,57,Sly Fox
233,Sly Fox,40,340,380,0,40,Sly Fox
234,Sly Fox,48,308,356,0,48,Sly Fox
235,Sly Fox,55,280,335,0,55,Sly Fox
236,Sly Fox,40,340,380,0,40,Sly Fox
237,Sly Fox,56,276,332,0,56,Sly Fox
238,Sly Fox,53,288,341,0,53,Sly Fox
239,Sly Fox,47,312,359,0,47,Sly Fox
240,Sly Fox,47,312,359,0,47,Sly Fox
241,Sly Fox,42,332,374,0,42,Sly Fox
242,Sly Fox,43,328,371,0,43,Sly Fox
243,Sly Fox,41,336,377,0,41,Sly Fox
244,Sly Fox,47,312,359,0,47,Sly Fox
245,Sly Fox,45,320,365,0,45,Sly Fox
246,Sly Fox,45,320,365,0,45,Sly Fox
247,Sly Fox,55,280,335,0,55,Sly Fox
248,Sly Fox,47,312,359,0,47,Sly Fox
249,Sly Fox,50,300,350,0,50,Sly Fox
250,Sly Fox,52,292,344,0,52,Sly Fox
251,Sly Fox,48,308,356,0,48,Sly Fox
252,Sly Fox,47,312,359,0,47,Sly Fox
253,Sly Fox,54,284,338,0,54,Sly Fox
254,Sly Fox,49,304,353,0,49,Sly Fox
255,Sly Fox,56,276,332,0,56,Sly Fox
256,Sly Fox,54,284,338,0,54,Sly Fox
257,Sly Fox,46,316,362,0,46,Sly Fox
258,Sly Fox,47,312,359,0,47,Sly Fox
259,Sly Fox,51,296,347,0,51,Sly Fox
260,Sly Fox,53,288,341,0,53,Sly Fox
261,Sly Fox,45,320,365,0,45,Sly Fox
262,Sly Fox,55,280,335,0,55,Sly Fox
263,Sly Fox,40,340,380,0,40,Sly Fox
264,Sly Fox,54,284,338,0,54,Sly Fox
265,Sly Fox,44,324,368,0,44,Sly Fox
266,Sly Fox,51,296,347,0,51,Sly Fox
267,Sly Fox,54,284,338,0,54,Sly Fox
268,Sly Fox,53,288,341,0,53,Sly Fox
269,Sly Fox,50,300,350,0,50,Sly Fox
270,Sly Fox,44,324,368,0,44,Sly Fox
271,Sly Fox,46,316,362,0,46,Sly Fox
272,Sly Fox,41,336,377,0,41,Sly Fox
273,Sly Fox,44,324,368,0,44,Sly Fox
274,Sly Fox,46,316,362,0,46,Sly Fox
275,Sly Fox,50,300,350,0,50,Sly Fox
276,Sly Fox,51,296,347,0,51,Sly Fox
277,Sly Fox,52,292,344,0,52,Sly Fox
278,Sly Fox,46,316,362,0,46,Sly Fox
279,Sly Fox,46,316,362,0,46,Sly Fox
280,Sly Fox,46,316,362,0,46,Sly Fox
281,Sly Fox,47,312,359,0,47,Sly Fox
282,Sly Fox,50,300,350,0,50,Sly Fox
283,Sly Fox,47,312,359,0,47,Sly Fox
284,Sly Fox,50,300,350,0,50,Sly Fox
285,Sly Fox,53,288,341,0,53,Sly Fox
286,Sly Fox,48,308,356,0,48,Sly Fox
287,Sly Fox,39,344,383,0,39,Sly Fox
288,Sly Fox,51,296,347,0,51,Sly Fox
289,Sly Fox,52,292,344,0,52,Sly Fox
290,Sly Fox,49,304,353,0,49,Sly Fox
291,Sly Fox,51,296,347,0,51,Sly Fox
292,Sly Fox,44,324,368,0,44,Sly Fox
293,Sly Fox,44,324,368,0,44,Sly Fox
294,Sly Fox,55,280,335,0,55,Sly Fox
295,Sly Fox,47,312,359,0,47,Sly Fox
296,Sly Fox,44,324,368,0,44,Sly Fox
297,Sly Fox,48,308,356,0,48,Sly Fox
298,Sly Fox,57,272,329,0,57,Sly Fox
299,Sly Fox,42,332,374,0,42,Sly Fox
300,Sly Fox,53,288,341,0,53,Sly Fox
301,Sly Fox,51,296,347,0,51,Sly Fox
302,Sly Fox,43,328,371,0,43,Sly Fox
303,Sly Fox,59,264,323,0,59,Sly Fox
304,Sly Fox,49,304,353,0,49,Sly Fox
305,Sly Fox,48,308,356,0,48,Sly Fox
306,Sly Fox,49,304,353,0,49,Sly Fox
307,Sly Fox,51,296,347,0,51,Sly Fox
308,Sly Fox,48,308,356,0,48,Sly Fox
309,Sly Fox,56,276,332,0,56,Sly Fox
310,Sly Fox,56,276,332,0,56,Sly Fox
311,Sly Fox,46,316,362,0,46,Sly Fox
312,Sly Fox,41,336,377,0,41,Sly Fox
313,Sly Fox,50,300,350,0,50,Sly Fox
314,Sly Fox,50,300,350,0,50,Sly Fox
315,Sly Fox,56,276,332,0,56,Sly Fox
316,Sly Fox,50,300,350,0,50,Sly Fox
317,Sly Fox,48,308,356,0,48,Sly Fox
318,Sly Fox,41,336,377,0,41,Sly Fox
319,Sly Fox,41,336,377,0,41,Sly Fox
320,Sly Fox,46,316,362,0,46,Sly Fox
321,Sly Fox,54,284,338,0,54,Sly Fox
322,Sly Fox,58,268,326,0,58,Sly Fox
323,Sly Fox,48,308,356,0,48,Sly Fox
324,Sly Fox,49,304,353,0,49,Sly Fox
325,Sly Fox,51,296,347,0,51,Sly Fox
326,Sly Fox,54,284,338,0,54,Sly Fox
327,Sly Fox,48,308,356,0,48,Sly Fox
328,Sly Fox,47,312,359,0,47,Sly Fox
329,Sly Fox,38,348,386,0,38,Sly Fox
330,Sly Fox,39,344,383,0,39,Sly Fox
331,Sly Fox,35,360,395,0,35,Sly Fox
332,Sly Fox,54,284,338,0,54,Sly Fox
333,Sly Fox,54,284,338,0,54,Sly Fox
334,Sly Fox,48,308,356,0,48,Sly Fox
335,Sly Fox,47,312,359,0,47,Sly Fox
336,Sly Fox,50,300,350,0,50,Sly Fox
337,Sly Fox,51,296,347,0,51,Sly Fox
338,Sly Fox,42,332,374,0,42,Sly Fox
339,Sly Fox,43,328,371,0,43,Sly Fox
340,Sly Fox,62,252,314,0,62,Sly Fox
341,Sly Fox,52,292,344,0,52,Sly Fox
342,Sly Fox,61,256,317,0,61,Sly Fox
343,Sly Fox,51,296,347,0,51,Sly Fox
344,Sly Fox,48,308,356,0,48,Sly Fox
0,Evan,240,195,435,19,28,Player A
1,Evan,219,244,463,26,21,Evan
2,Evan,232,187,419,27,36,Player A
3,Evan,223,233,456,25,23,Evan
4,Evan,230,220,450,22,24,Player A
5,Evan,218,243,461,27,22,Evan
6,Evan,227,217,444,25,27,Player A
7,Evan,225,225,450,25,25,Tie
8,Evan,224,214,438,28,30,Player A
9,Evan,223,248,471,22,17,Evan
10,Evan,225,220,445,26,27,Player A
11,Evan,207,277,484,29,15,Evan
12,Evan,219,249,468,25,19,Evan
13,Evan,235,200,435,22,29,Player A
14,Evan,227,217,444,25,27,Player A
15,Evan,219,239,458,27,23,Evan
16,Evan,229,229,458,21,21,Tie
17,Evan,230,220,450,22,24,Player A
18,Evan,217,232,449,30,27,Evan
19,Evan,236,201,437,21,28,Player A
20,Evan,224,224,448,26,26,Tie
21,Evan,228,228,456,22,22,Tie
22,Evan,228,223,451,23,24,Player A
23,Evan,216,246,462,28,22,Evan
24,Evan,242,192,434,18,28,Player A
25,Evan,214,244,458,30,24,Evan
26,Evan,229,209,438,25,29,Player A
27,Evan,222,252,474,22,16,Evan
28,Evan,231,216,447,22,25,Player A
29,Evan,218,243,461,27,22,Evan
30,Evan,208,253,461,33,24,Evan
31,Evan,238,213,451,17,22,Player A
32,Evan,232,212,444,22,26,Player A
33,Evan,234,209,443,21,26,Player A
34,Evan,225,215,440,27,29,Player A
35,Evan,221,226,447,28,27,Evan
36,Evan,244,169,413,21,36,Player A
37,Evan,220,225,445,29,28,Evan
38,Evan,216,246,462,28,22,Evan
39,Evan,222,232,454,26,24,Evan
40,Evan,223,233,456,25,23,Evan
41,Evan,225,220,445,26,27,Player A
42,Evan,219,234,453,28,25,Evan
43,Evan,219,234,453,28,25,Evan
44,Evan,214,234,448,32,28,Evan
45,Evan,220,225,445,29,28,Evan
46,Evan,222,227,449,27,26,Evan
47,Evan,222,232,454,26,24,Evan
48,Evan,229,209,438,25,29,Player A
49,Evan,215,245,460,29,23,Evan
50,Evan,224,224,448,26,26,Tie
51,Evan,217,237,454,29,25,Evan
52,Evan,218,248,466,26,20,Evan
53,Evan,219,244,463,26,21,Evan
54,Evan,214,244,458,30,24,Evan
55,Evan,230,230,460,20,20,Tie
56,Evan,226,221,447,25,26,Player A
57,Evan,229,214,443,24,27,Player A
58,Evan,228,203,431,27,32,Player A
59,Evan,228,238,466,20,18,Evan
60,Evan,214,244,458,30,24,Evan
61,Evan,221,241,462,25,21,Evan
62,Evan,223,223,446,27,27,Tie
63,Evan,234,199,433,23,30,Player A
64,Evan,218,248,466,26,20,Evan
65,Evan,222,232,454,26,24,Evan
66,Evan,217,227,444,31,29,Evan
67,Evan,213,258,471,28,19,Evan
68,Evan,213,253,466,29,21,Evan
69,Evan,222,227,449,27,26,Evan
70,Evan,221,221,442,29,29,Tie
71,Evan,217,242,459,28,23,Evan
72,Evan,218,238,456,28,24,Evan
73,Evan,216,236,452,30,26,Evan
74,Evan,231,221,452,21,23,Player A
75,Evan,225,225,450,25,25,Tie
76,Evan,243,183,426,19,31,Player A
77,Evan,224,224,448,26,26,Tie
78,Evan,219,234,453,28,25,Evan
79,Evan,226,241,467,21,18,Evan
80,Evan,225,230,455,24,23,Evan
81,Evan,221,246,467,24,19,Evan
82,Evan,221,246,467,24,19,Evan
83,Evan,218,223,441,31,30,Evan
84,Evan,222,217,439,29,30,Player A
85,Evan,209,264,473,30,19,Evan
86,Evan,225,240,465,22,19,Evan
87,Evan,228,223,451,23,24,Player A
88,Evan,225,225,450,25,25,Tie
89,Evan,238,193,431,21,30,Player A
90,Evan,215,240,455,30,25,Evan
91,Evan,208,263,471,31,20,Evan
92,Evan,233,198,431,24,31,Player A
93,Evan,216,231,447,31,28,Evan
94,Evan,215,250,465,28,21,Evan
95,Evan,230,230,460,20,20,Tie
96,Evan,220,240,460,26,22,Evan
97,Evan,231,226,457,20,21,Player A
98,Evan,225,220,445,26,27,Player A
99,Evan,219,244,463,26,21,Evan
100,Evan,227,227,454,23,23,Tie
101,Evan,227,222,449,24,25,Player A
102,Evan,227,227,454,23,23,Tie
103,Evan,234,229,463,17,18,Player A
104,Evan,230,210,440,24,28,Player A
105,Evan,232,217,449,21,24,Player A
106,Evan,213,248,461,30,23,Evan
107,Evan,205,255,460,35,25,Evan
108,Evan,226,226,452,24,24,Tie
109,Evan,235,190,425,24,33,Player A
110,Evan,217,242,459,28,23,Evan
111,Evan,230,210,440,24,28,Player A
112,Evan,229,209,438,25,29,Player A
113,Evan,227,222,449,24,25,Player A
114,Evan,225,225,450,25,25,Tie
115,Evan,227,217,444,25,27,Player A
116,Evan,229,229,458,21,21,Tie
117,Evan,232,227,459,19,20,Player A
118,Evan,227,227,454,23,23,Tie
119,Evan,223,223,446,27,27,Tie
120,Evan,232,202,434,24,30,Player A
121,Evan,221,236,457,26,23,Evan
122,Evan,221,236,457,26,23,Evan
123,Evan,226,226,452,24,24,Tie
124,Evan,229,214,443,24,27,Player A
125,Evan,225,230,455,24,23,Evan
126,Evan,203,278,481,32,17,Evan
127,Evan,219,239,458,27,23,Evan
128,Evan,231,206,437,24,29,Player A
129,Evan,231,216,447,22,25,Player A
130,Evan,221,231,452,27,25,Evan
131,Evan,221,246,467,24,19,Evan
132,Evan,237,192,429,22,31,Player A
133,Evan,213,248,461,30,23,Evan
134,Evan,224,224,448,26,26,Tie
135,Evan,236,211,447,19,24,Player A
136,Evan,218,243,461,27,22,Evan
137,Evan,219,244,463,26,21,Evan
138,Evan,218,248,466,26,20,Evan
139,Evan,227,217,444,25,27,Player A
140,Evan,225,210,435,28,31,Player A
141,Evan,224,219,443,27,28,Player A
142,Evan,221,241,462,25,21,Evan
143,Evan,228,208,436,26,30,Player A
144,Evan,227,222,449,24,25,Player A
145,Evan,221,216,437,30,31,Player A
146,Evan,217,252,469,26,19,Evan
147,Evan,224,229,453,25,24,Evan
148,Evan,217,242,459,28,23,Evan
149,Evan,228,218,446,24,26,Player A
150,Evan,223,228,451,26,25,Evan
151,Evan,211,261,472,29,19,Evan
152,Evan,220,260,480,22,14,Evan
153,Evan,236,191,427,23,32,Player A
154,Evan,225,225,450,25,25,Tie
155,Evan,233,213,446,21,25,Player A
156,Evan,220,240,460,26,22,Evan
157,Evan,227,227,454,23,23,Tie
158,Evan,214,244,458,30,24,Evan
159,Evan,220,240,460,26,22,Evan
160,Evan,234,204,438,22,28,Player A
161,Evan,222,227,449,27,26,Evan
162,Evan,225,220,445,26,27,Player A
163,Evan,234,209,443,21,26,Player A
164,Evan,229,209,438,25,29,Player A
165,Evan,225,230,455,24,23,Evan
166,Evan,226,231,457,23,22,Evan
167,Evan,228,238,466,20,18,Evan
168,Evan,220,235,455,27,24,Evan
169,Evan,229,209,438,25,29,Player A
170,Evan,219,224,443,30,29,Evan
171,Evan,221,246,467,24,19,Evan
172,Evan,232,222,454,20,22,Player A
173,Evan,215,250,465,28,21,Evan
174,Evan,234,219,453,19,22,Player A
175,Evan,222,252,474,22,16,Evan
176,Evan,223,223,446,27,27,Tie
177,Evan,228,223,451,23,24,Player A
178,Evan,218,253,471,25,18,Evan
179,Evan,233,213,446,21,25,Player A
180,Evan,220,230,450,28,26,Evan
181,Evan,218,248,466,26,20,Evan
182,Evan,216,246,462,28,22,Evan
183,Evan,230,210,440,24,28,Player A
184,Evan,218,243,461,27,22,Evan
185,Evan,218,233,451,29,26,Evan
186,Evan,223,243,466,23,19,Evan
187,Evan,229,204,433,26,31,Player A
188,Evan,215,245,460,29,23,Evan
189,Evan,238,188,426,22,32,Player A
190,Evan,217,242,459,28,23,Evan
191,Evan,231,221,452,21,23,Player A
192,Evan,217,242,459,28,23,Evan
193,Evan,218,248,466,26,20,Evan
194,Evan,218,233,451,29,26,Evan
195,Evan,230,210,440,24,28,Player A
196,Evan,216,236,452,30,26,Evan
197,Evan,223,223,446,27,27,Tie
198,Evan,231,201,432,25,31,Player A
199,Evan,218,228,446,30,28,Evan
200,Evan,228,223,451,23,24,Player A
201,Evan,217,237,454,29,25,Evan
202,Evan,217,237,454,29,25,Evan
203,Evan,208,263,471,31,20,Evan
204,Evan,231,211,442,23,27,Player A
205,Evan,225,215,440,27,29,Player A
206,Evan,230,215,445,23,26,Player A
207,Evan,224,234,458,24,22,Evan
208,Evan,218,243,461,27,22,Evan
209,Evan,212,252,464,30,22,Evan
210,Evan,214,239,453,31,26,Evan
211,Evan,218,223,441,31,30,Evan
212,Evan,223,233,456,25,23,Evan
213,Evan,210,245,455,33,26,Evan
214,Evan,245,195,440,15,25,Player A
215,Evan,228,213,441,25,28,Player A
216,Evan,227,212,439,26,29,Player A
217,Evan,204,269,473,33,20,Evan
218,Evan,218,228,446,30,28,Evan
219,Evan,234,204,438,22,28,Player A
220,Evan,212,262,474,28,18,Evan
221,Evan,229,229,458,21,21,Tie
222,Evan,227,222,449,24,25,Player A
223,Evan,219,229,448,29,27,Evan
224,Evan,221,226,447,28,27,Evan
225,Evan,216,236,452,30,26,Evan
226,Evan,237,217,454,17,21,Player A
227,Evan,218,228,446,30,28,Evan
228,Evan,221,231,452,27,25,Evan
229,Evan,223,223,446,27,27,Tie
230,Evan,224,229,453,25,24,Evan
231,Evan,231,221,452,21,23,Player A
232,Evan,229,214,443,24,27,Player A
233,Evan,228,208,436,26,30,Player A
234,Evan,219,239,458,27,23,Evan
235,Evan,241,186,427,20,31,Player A
236,Evan,226,231,457,23,22,Evan
237,Evan,222,242,464,24,20,Evan
238,Evan,228,223,451,23,24,Player A
239,Evan,223,238,461,24,21,Evan
240,Evan,218,233,451,29,26,Evan
241,Evan,220,225,445,29,28,Evan
242,Evan,207,257,464,33,23,Evan
243,Evan,230,205,435,25,30,Player A
244,Evan,224,224,448,26,26,Tie
245,Evan,221,241,462,25,21,Evan
246,Evan,219,249,468,25,19,Evan
247,Evan,237,207,444,19,25,Player A
248,Evan,234,214,448,20,24,Player A
249,Evan,222,222,444,28,28,Tie
250,Evan,224,219,443,27,28,Player A
251,Evan,221,226,447,28,27,Evan
252,Evan,223,228,451,26,25,Evan
253,Evan,231,216,447,22,25,Player A
254,Evan,230,225,455,21,22,Player A
255,Evan,202,282,484,32,16,Evan
256,Evan,213,238,451,32,27,Evan
257,Evan,229,209,438,25,29,Player A
258,Evan,228,228,456,22,22,Tie
259,Evan,221,221,442,29,29,Tie
260,Evan,220,225,445,29,28,Evan
261,Evan,234,214,448,20,24,Player A
262,Evan,231,226,457,20,21,Player A
263,Evan,218,233,451,29,26,Evan
264,Evan,222,217,439,29,30,Player A
265,Evan,205,265,470,33,21,Evan
266,Evan,225,230,455,24,23,Evan
267,Evan,217,242,459,28,23,Evan
268,Evan,219,229,448,29,27,Evan
269,Evan,228,228,456,22,22,Tie
270,Evan,207,262,469,32,21,Evan
271,Evan,225,240,465,22,19,Evan
272,Evan,236,196,432,22,30,Player A
273,Evan,215,245,460,29,23,Evan
274,Evan,228,233,461,21,20,Evan
275,Evan,238,203,441,19,26,Player A
276,Evan,219,239,458,27,23,Evan
277,Evan,231,221,452,21,23,Player A
278,Evan,229,224,453,22,23,Player A
279,Evan,215,245,460,29,23,Evan
280,Evan,218,228,446,30,28,Evan
281,Evan,216,251,467,27,20,Evan
282,Evan,217,237,454,29,25,Evan
283,Evan,218,228,446,30,28,Evan
284,Evan,223,223,446,27,27,Tie
285,Evan,230,220,450,22,24,Player A
286,Evan,232,212,444,22,26,Player A
287,Evan,225,215,440,27,29,Player A
288,Evan,217,247,464,27,21,Evan
289,Evan,214,244,458,30,24,Evan
290,Evan,231,216,447,22,25,Player A
291,Evan,214,264,478,26,16,Evan
292,Evan,215,245,460,29,23,Evan
293,Evan,214,249,463,29,22,Evan
294,Evan,233,218,451,20,23,Player A
295,Evan,217,247,464,27,21,Evan
296,Evan,222,232,454,26,24,Evan
297,Evan,224,219,443,27,28,Player A
298,Evan,222,232,454,26,24,Evan
299,Evan,226,226,452,24,24,Tie
300,Evan,222,227,449,27,26,Evan
301,Evan,233,198,431,24,31,Player A
302,Evan,223,223,446,27,27,Tie
303,Evan,222,237,459,25,22,Evan
304,Evan,238,193,431,21,30,Player A
305,Evan,221,226,447,28,27,Evan
306,Evan,225,225,450,25,25,Tie
307,Evan,225,230,455,24,23,Evan
308,Evan,218,238,456,28,24,Evan
309,Evan,221,246,467,24,19,Evan
310,Evan,227,227,454,23,23,Tie
311,Evan,223,208,431,30,33,Player A
312,Evan,230,215,445,23,26,Player A
313,Evan,234,209,443,21,26,Player A
314,Evan,229,219,448,23,25,Player A
315,Evan,230,215,445,23,26,Player A
316,Evan,231,211,442,23,27,Player A
317,Evan,220,245,465,25,20,Evan
318,Evan,230,210,440,24,28,Player A
319,Evan,223,228,451,26,25,Evan
320,Evan,209,264,473,30,19,Evan
321,Evan,230,200,430,26,32,Player A
322,Evan,223,233,456,25,23,Evan
323,Evan,214,244,458,30,24,Evan
324,Evan,229,229,458,21,21,Tie
325,Evan,223,238,461,24,21,Evan
326,Evan,211,256,467,30,21,Evan
327,Evan,222,232,454,26,24,Evan
328,Evan,231,206,437,24,29,Player A
329,Evan,246,181,427,17,30,Player A
330,Evan,219,229,448,29,27,Evan
331,Evan,234,209,443,21,26,Player A
332,Evan,222,227,449,27,26,Evan
333,Evan,219,249,468,25,19,Evan
334,Evan,233,208,441,22,27,Player A
335,Evan,220,230,450,28,26,Evan
336,Evan,224,219,443,27,28,Player A
337,Evan,238,203,441,19,26,Player A
338,Evan,228,213,441,25,28,Player A
339,Evan,224,229,453,25,24,Evan
340,Evan,227,207,434,27,31,Player A
341,Evan,224,229,453,25,24,Evan
342,Evan,206,266,472,32,20,Evan
343,Evan,220,245,465,25,20,Evan
344,Evan,231,206,437,24,29,Player A
345,Evan,219,234,453,28,25,Evan
346,Evan,234,199,433,23,30,Player A
347,Evan,230,215,445,23,26,Player A
348,Evan,231,226,457,20,21,Player A
349,Evan,225,220,445,26,27,Player A
350,Evan,219,244,463,26,21,Evan
351,Evan,224,229,453,25,24,Evan
352,Evan,220,240,460,26,22,Evan
353,Evan,222,217,439,29,30,Player A
354,Evan,217,252,469,26,19,Evan
355,Evan,228,218,446,24,26,Player A
356,Evan,224,239,463,23,20,Evan
357,Evan,223,228,451,26,25,Evan
358,Evan,230,215,445,23,26,Player A
359,Evan,230,200,430,26,32,Player A
360,Evan,220,240,460,26,22,Evan
361,Evan,225,230,455,24,23,Evan
362,Evan,236,201,437,21,28,Player A
363,Evan,216,236,452,30,26,Evan
364,Evan,215,245,460,29,23,Evan
365,Evan,214,249,463,29,22,Evan
366,Evan,232,222,454,20,22,Player A
367,Evan,212,237,449,33,28,Evan
368,Evan,236,206,442,20,26,Player A
369,Evan,231,226,457,20,21,Player A
370,Evan,224,224,448,26,26,Tie
371,Evan,225,220,445,26,27,Player A
372,Evan,219,244,463,26,21,Evan
373,Evan,199,274,473,36,21,Evan
374,Evan,229,219,448,23,25,Player A
375,Evan,219,239,458,27,23,Evan
376,Evan,219,239,458,27,23,Evan
377,Evan,223,218,441,28,29,Player A
378,Evan,235,210,445,20,25,Player A
379,Evan,224,234,458,24,22,Evan
380,Evan,227,227,454,23,23,Tie
381,Evan,233,213,446,21,25,Player A
382,Evan,224,229,453,25,24,Evan
383,Evan,227,212,439,26,29,Player A
384,Evan,206,246,452,36,28,Evan
385,Evan,221,226,447,28,27,Evan
386,Evan,248,173,421,17,32,Player A
387,Evan,217,242,459,28,23,Evan
388,Evan,225,235,460,23,21,Evan
389,Evan,211,261,472,29,19,Evan
390,Evan,215,245,460,29,23,Evan
391,Evan,220,240,460,26,22,Evan
392,Evan,232,217,449,21,24,Player A
393,Evan,220,235,455,27,24,Evan
394,Evan,223,238,461,24,21,Evan
395,Evan,219,234,453,28,25,Evan
396,Evan,235,205,440,21,27,Player A
397,Evan,228,213,441,25,28,Player A
398,Evan,217,232,449,30,27,Evan
399,Evan,215,245,460,29,23,Evan
400,Evan,220,220,440,30,30,Tie
401,Evan,218,238,456,28,24,Evan
402,Evan,226,226,452,24,24,Tie
403,Evan,208,268,476,30,18,Evan
404,Evan,224,234,458,24,22,Evan
405,Evan,219,234,453,28,25,Evan
406,Evan,232,197,429,25,32,Player A
407,Evan,223,228,451,26,25,Evan
408,Evan,214,249,463,29,22,Evan
409,Evan,204,264,468,34,22,Evan
410,Evan,220,235,455,27,24,Evan
411,Evan,225,220,445,26,27,Player A
412,Evan,226,236,462,22,20,Evan
413,Evan,212,257,469,29,20,Evan
414,Evan,218,233,451,29,26,Evan
415,Evan,221,231,452,27,25,Evan
416,Evan,212,247,459,31,24,Evan
417,Evan,227,227,454,23,23,Tie
418,Evan,217,242,459,28,23,Evan
419,Evan,215,245,460,29,23,Evan
420,Evan,215,250,465,28,21,Evan
421,Evan,225,215,440,27,29,Player A
422,Evan,227,227,454,23,23,Tie
423,Evan,238,203,441,19,26,Player A
424,Evan,213,253,466,29,21,Evan
425,Evan,217,242,459,28,23,Evan
426,Evan,218,253,471,25,18,Evan
427,Evan,226,231,457,23,22,Evan
428,Evan,229,219,448,23,25,Player A
429,Evan,226,216,442,26,28,Player A
430,Evan,238,203,441,19,26,Player A
431,Evan,234,209,443,21,26,Player A
432,Evan,233,198,431,24,31,Player A
433,Evan,206,256,462,34,24,Evan
434,Evan,231,196,427,26,33,Player A
435,Evan,219,234,453,28,25,Evan
436,Evan,232,212,444,22,26,Player A
437,Evan,221,241,462,25,21,Evan
438,Evan,220,235,455,27,24,Evan
439,Evan,232,212,444,22,26,Player A
440,Evan,232,217,449,21,24,Player A
441,Evan,222,217,439,29,30,Player A
442,Evan,227,217,444,25,27,Player A
443,Evan,238,183,421,23,34,Player A
444,Evan,219,224,443,30,29,Evan
445,Evan,232,207,439,23,28,Player A
446,Evan,231,231,462,19,19,Tie
447,Evan,224,234,458,24,22,Evan
448,Evan,218,243,461,27,22,Evan
449,Evan,221,231,452,27,25,Evan
450,Evan,219,224,443,30,29,Evan
451,Evan,220,230,450,28,26,Evan
452,Evan,215,245,460,29,23,Evan
453,Evan,226,231,457,23,22,Evan
454,Evan,222,232,454,26,24,Evan
455,Evan,225,215,440,27,29,Player A
456,Evan,220,240,460,26,22,Evan
457,Evan,219,244,463,26,21,Evan
458,Evan,239,199,438,19,27,Player A
459,Evan,231,206,437,24,29,Player A
460,Evan,245,175,420,19,33,Player A
461,Evan,227,232,459,22,21,Evan
462,Evan,216,226,442,32,30,Evan
463,Evan,229,224,453,22,23,Player A
464,Evan,237,207,444,19,25,Player A
465,Evan,229,224,453,22,23,Player A
466,Evan,227,207,434,27,31,Player A
467,Evan,224,234,458,24,22,Evan
468,Evan,218,253,471,25,18,Evan
469,Evan,215,245,460,29,23,Evan
470,Evan,223,248,471,22,17,Evan
471,Evan,220,245,465,25,20,Evan
472,Evan,230,225,455,21,22,Player A
473,Evan,223,233,456,25,23,Evan
474,Evan,224,234,458,24,22,Evan
475,Evan,215,255,470,27,19,Evan
476,Evan,230,225,455,21,22,Player A
477,Evan,209,264,473,30,19,Evan
478,Evan,218,243,461,27,22,Evan
479,Evan,235,215,450,19,23,Player A
480,Evan,219,249,468,25,19,Evan
481,Evan,223,228,451,26,25,Evan
482,Evan,218,228,446,30,28,Evan
483,Evan,225,230,455,24,23,Evan
484,Evan,223,243,466,23,19,Evan
485,Evan,225,225,450,25,25,Tie
486,Evan,214,259,473,27,18,Evan
487,Evan,219,239,458,27,23,Evan
488,Evan,224,229,453,25,24,Evan
489,Evan,217,237,454,29,25,Evan
490,Evan,206,276,482,30,16,Evan
491,Evan,226,216,442,26,28,Player A
492,Evan,210,250,460,32,24,Evan
493,Evan,227,222,449,24,25,Player A
494,Evan,206,266,472,32,20,Evan
495,Evan,239,204,443,18,25,Player A
496,Evan,219,239,458,27,23,Evan
497,Evan,224,214,438,28,30,Player A
498,Evan,218,243,461,27,22,Evan
499,Evan,222,227,449,27,26,Evan
500,Evan,222,232,454,26,24,Evan
501,Evan,231,211,442,23,27,Player A
502,Evan,202,267,469,35,22,Evan
503,Evan,227,222,449,24,25,Player A
504,Evan,208,258,466,32,22,Evan
505,Evan,226,221,447,25,26,Player A
506,Evan,226,211,437,27,30,Player A
507,Evan,228,218,446,24,26,Player A
508,Evan,204,274,478,32,18,Evan
509,Evan,208,258,466,32,22,Evan
510,Evan,221,236,457,26,23,Evan
511,Evan,228,223,451,23,24,Player A
512,Evan,216,246,462,28,22,Evan
513,Evan,228,208,436,26,30,Player A
514,Evan,215,250,465,28,21,Evan
515,Evan,232,222,454,20,22,Player A
516,Evan,237,202,439,20,27,Player A
517,Evan,230,220,450,22,24,Player A
518,Evan,233,198,431,24,31,Player A
519,Evan,221,236,457,26,23,Evan
520,Evan,223,228,451,26,25,Evan
521,Evan,217,247,464,27,21,Evan
522,Evan,214,249,463,29,22,Evan
523,Evan,227,222,449,24,25,Player A
524,Evan,226,221,447,25,26,Player A
525,Evan,215,255,470,27,19,Evan
526,Evan,222,227,449,27,26,Evan
527,Evan,214,259,473,27,18,Evan
528,Evan,238,193,431,21,30,Player A
529,Evan,226,226,452,24,24,Tie
530,Evan,227,232,459,22,21,Evan
531,Evan,217,237,454,29,25,Evan
532,Evan,213,253,466,29,21,Evan
533,Evan,209,254,463,32,23,Evan
534,Evan,219,244,463,26,21,Evan
535,Evan,232,202,434,24,30,Player A
536,Evan,209,249,458,33,25,Evan
537,Evan,213,243,456,31,25,Evan
538,Evan,214,249,463,29,22,Evan
539,Evan,211,256,467,30,21,Evan
540,Evan,205,255,460,35,25,Evan
541,Evan,222,237,459,25,22,Evan
542,Evan,223,233,456,25,23,Evan
543,Evan,232,217,449,21,24,Player A
544,Evan,229,214,443,24,27,Player A
545,Evan,219,234,453,28,25,Evan
546,Evan,215,260,475,26,17,Evan
547,Evan,222,232,454,26,24,Evan
548,Evan,222,217,439,29,30,Player A
549,Evan,236,196,432,22,30,Player A
550,Evan,220,230,450,28,26,Evan
551,Evan,209,254,463,32,23,Evan
552,Evan,214,244,458,30,24,Evan
553,Evan,226,231,457,23,22,Evan
554,Evan,231,216,447,22,25,Player A
555,Evan,224,224,448,26,26,Tie
556,Evan,232,217,449,21,24,Player A
557,Evan,226,231,457,23,22,Evan
558,Evan,234,199,433,23,30,Player A
559,Evan,231,226,457,20,21,Player A
560,Evan,217,252,469,26,19,Evan
561,Evan,236,196,432,22,30,Player A
562,Evan,221,241,462,25,21,Evan
563,Evan,236,206,442,20,26,Player A
564,Evan,218,238,456,28,24,Evan
565,Evan,217,232,449,30,27,Evan
566,Evan,229,214,443,24,27,Player A
567,Evan,222,237,459,25,22,Evan
568,Evan,216,236,452,30,26,Evan
569,Evan,215,260,475,26,17,Evan
570,Evan,229,239,468,19,17,Evan
571,Evan,235,200,435,22,29,Player A
572,Evan,212,252,464,30,22,Evan
573,Evan,221,246,467,24,19,Evan
574,Evan,245,195,440,15,25,Player A
575,Evan,218,228,446,30,28,Evan
576,Evan,216,251,467,27,20,Evan
577,Evan,230,220,450,22,24,Player A
578,Evan,234,199,433,23,30,Player A
579,Evan,213,243,456,31,25,Evan
580,Evan,230,230,460,20,20,Tie
581,Evan,225,220,445,26,27,Player A
582,Evan,210,270,480,28,16,Evan
583,Evan,215,235,450,31,27,Evan
584,Evan,229,209,438,25,29,Player A
585,Evan,230,210,440,24,28,Player A
586,Evan,223,243,466,23,19,Evan
587,Evan,221,231,452,27,25,Evan
588,Evan,226,221,447,25,26,Player A
589,Evan,226,231,457,23,22,Evan
590,Evan,228,218,446,24,26,Player A
591,Evan,230,230,460,20,20,Tie
592,Evan,216,256,472,26,18,Evan
593,Evan,221,236,457,26,23,Evan
594,Evan,233,208,441,22,27,Player A
595,Evan,219,239,458,27,23,Evan
596,Evan,233,213,446,21,25,Player A
597,Evan,222,247,469,23,18,Evan
598,Evan,218,243,461,27,22,Evan
599,Evan,238,213,451,17,22,Player A
600,Evan,231,216,447,22,25,Player A
601,Evan,223,223,446,27,27,Tie
602,Evan,230,215,445,23,26,Player A
603,Evan,221,251,472,23,17,Evan
604,Evan,211,276,487,26,13,Evan
605,Evan,223,253,476,21,15,Evan
606,Evan,228,223,451,23,24,Player A
607,Evan,213,248,461,30,23,Evan
608,Evan,222,212,434,30,32,Player A
609,Evan,225,225,450,25,25,Tie
610,Evan,228,223,451,23,24,Player A
611,Evan,224,224,448,26,26,Tie
612,Evan,208,268,476,30,18,Evan
613,Evan,223,238,461,24,21,Evan
614,Evan,234,209,443,21,26,Player A
615,Evan,224,224,448,26,26,Tie
616,Evan,218,233,451,29,26,Evan
617,Evan,226,216,442,26,28,Player A
618,Evan,226,221,447,25,26,Player A
619,Evan,232,217,449,21,24,Player A
620,Evan,221,241,462,25,21,Evan
621,Evan,235,200,435,22,29,Player A
622,Evan,219,244,463,26,21,Evan
623,Evan,221,221,442,29,29,Tie
624,Evan,215,250,465,28,21,Evan
625,Evan,216,246,462,28,22,Evan
626,Evan,230,215,445,23,26,Player A
627,Evan,227,227,454,23,23,Tie
628,Evan,227,222,449,24,25,Player A
629,Evan,226,211,437,27,30,Player A
630,Evan,222,227,449,27,26,Evan
631,Evan,229,209,438,25,29,Player A
632,Evan,217,227,444,31,29,Evan
633,Evan,225,215,440,27,29,Player A
634,Evan,237,187,424,23,33,Player A
635,Evan,217,242,459,28,23,Evan
636,Evan,220,235,455,27,24,Evan
637,Evan,223,218,441,28,29,Player A
638,Evan,233,203,436,23,29,Player A
639,Evan,227,222,449,24,25,Player A
640,Evan,215,250,465,28,21,Evan
641,Evan,225,240,465,22,19,Evan
642,Evan,206,266,472,32,20,Evan
643,Evan,223,233,456,25,23,Evan
644,Evan,234,209,443,21,26,Player A
645,Evan,203,273,476,33,19,Evan
646,Evan,222,232,454,26,24,Evan
647,Evan,214,244,458,30,24,Evan
648,Evan,233,213,446,21,25,Player A
649,Evan,221,241,462,25,21,Evan
650,Evan,213,253,466,29,21,Evan
651,Evan,212,247,459,31,24,Evan
652,Evan,225,210,435,28,31,Player A
653,Evan,214,254,468,28,20,Evan
654,Evan,210,250,460,32,24,Evan
655,Evan,224,229,453,25,24,Evan
656,Evan,224,214,438,28,30,Player A
657,Evan,215,235,450,31,27,Evan
658,Evan,232,222,454,20,22,Player A
659,Evan,222,237,459,25,22,Evan
660,Evan,229,224,453,22,23,Player A
661,Evan,218,228,446,30,28,Evan
662,Evan,232,217,449,21,24,Player A
663,Evan,222,242,464,24,20,Evan
664,Evan,227,222,449,24,25,Player A
665,Evan,235,210,445,20,25,Player A
666,Evan,224,219,443,27,28,Player A
667,Evan,215,240,455,30,25,Evan
668,Evan,210,245,455,33,26,Evan
669,Evan,213,233,446,33,29,Evan
670,Evan,232,222,454,20,22,Player A
671,Evan,225,220,445,26,27,Player A
672,Evan,216,236,452,30,26,Evan
673,Evan,228,213,441,25,28,Player A
674,Evan,227,212,439,26,29,Player A
675,Evan,223,238,461,24,21,Evan
676,Evan,226,216,442,26,28,Player A
677,Evan,229,224,453,22,23,Player A
678,Evan,223,228,451,26,25,Evan
679,Evan,228,223,451,23,24,Player A
680,Evan,224,234,458,24,22,Evan
681,Evan,234,214,448,20,24,Player A
682,Evan,220,225,445,29,28,Evan
683,Evan,236,211,447,19,24,Player A
684,Evan,213,248,461,30,23,Evan
685,Evan,211,256,467,30,21,Evan
686,Evan,231,196,427,26,33,Player A
687,Evan,219,234,453,28,25,Evan
688,Evan,218,243,461,27,22,Evan
689,Evan,224,224,448,26,26,Tie
690,Evan,232,217,449,21,24,Player A
691,Evan,232,202,434,24,30,Player A
692,Evan,221,241,462,25,21,Evan
693,Evan,223,218,441,28,29,Player A
694,Evan,234,189,423,25,34,Player A
695,Evan,209,269,478,29,17,Evan
696,Evan,210,255,465,31,22,Evan
697,Evan,221,246,467,24,19,Evan
698,Evan,200,275,475,35,20,Evan
699,Evan,215,255,470,27,19,Evan
700,Evan,217,252,469,26,19,Evan
701,Evan,224,224,448,26,26,Tie
702,Evan,229,224,453,22,23,Player A
703,Evan,227,217,444,25,27,Player A
704,Evan,223,248,471,22,17,Evan
705,Evan,218,233,451,29,26,Evan
706,Evan,210,245,455,33,26,Evan
707,Evan,229,224,453,22,23,Player A
708,Evan,207,252,459,34,25,Evan
709,Evan,203,258,461,36,25,Evan
710,Evan,243,193,436,17,27,Player A
711,Evan,210,245,455,33,26,Evan
712,Evan,226,241,467,21,18,Evan
713,Evan,241,191,432,19,29,Player A
714,Evan,230,205,435,25,30,Player A
715,Evan,213,253,466,29,21,Evan
716,Evan,227,227,454,23,23,Tie
717,Evan,219,234,453,28,25,Evan
718,Evan,235,200,435,22,29,Player A
719,Evan,214,264,478,26,16,Evan
720,Evan,228,213,441,25,28,Player A
721,Evan,206,266,472,32,20,Evan
722,Evan,213,248,461,30,23,Evan
723,Evan,217,237,454,29,25,Evan
724,Evan,213,263,476,27,17,Evan
725,Evan,224,229,453,25,24,Evan
726,Evan,225,220,445,26,27,Player A
727,Evan,225,215,440,27,29,Player A
728,Evan,227,222,449,24,25,Player A
729,Evan,218,233,451,29,26,Evan
730,Evan,226,216,442,26,28,Player A
731,Evan,224,224,448,26,26,Tie
732,Evan,230,215,445,23,26,Player A
733,Evan,216,246,462,28,22,Evan
734,Evan,219,224,443,30,29,Evan
735,Evan,224,224,448,26,26,Tie
736,Evan,217,232,449,30,27,Evan
737,Evan,220,230,450,28,26,Evan
738,Evan,224,229,453,25,24,Evan
739,Evan,213,248,461,30,23,Evan
740,Evan,229,219,448,23,25,Player A
741,Evan,234,209,443,21,26,Player A
742,Evan,223,233,456,25,23,Evan
743,Evan,219,239,458,27,23,Evan
744,Evan,236,221,457,17,20,Player A
745,Evan,222,237,459,25,22,Evan
746,Evan,205,255,460,35,25,Evan
747,Evan,223,238,461,24,21,Evan
748,Evan,220,230,450,28,26,Evan
749,Evan,222,237,459,25,22,Evan
750,Evan,225,230,455,24,23,Evan
751,Evan,222,237,459,25,22,Evan
752,Evan,244,194,438,16,26,Player A
753,Evan,218,233,451,29,26,Evan
754,Evan,230,220,450,22,24,Player A
755,Evan,225,235,460,23,21,Evan
756,Evan,225,210,435,28,31,Player A
757,Evan,231,201,432,25,31,Player A
758,Evan,224,229,453,25,24,Evan
759,Evan,234,194,428,24,32,Player A
760,Evan,234,199,433,23,30,Player A
761,Evan,219,249,468,25,19,Evan
762,Evan,232,222,454,20,22,Player A
763,Evan,212,242,454,32,26,Evan
764,Evan,224,229,453,25,24,Evan
765,Evan,220,240,460,26,22,Evan
766,Evan,218,223,441,31,30,Evan
767,Evan,234,209,443,21,26,Player A
768,Evan,217,237,454,29,25,Evan
769,Evan,226,216,442,26,28,Player A
770,Evan,231,211,442,23,27,Player A
771,Evan,214,249,463,29,22,Evan
772,Evan,226,221,447,25,26,Player A
773,Evan,212,252,464,30,22,Evan
774,Evan,218,238,456,28,24,Evan
775,Evan,229,204,433,26,31,Player A
776,Evan,222,237,459,25,22,Evan
777,Evan,219,229,448,29,27,Evan
778,Evan,219,234,453,28,25,Evan
779,Evan,223,233,456,25,23,Evan
780,Evan,215,250,465,28,21,Evan
781,Evan,229,224,453,22,23,Player A
782,Evan,215,250,465,28,21,Evan
783,Evan,212,257,469,29,20,Evan
784,Evan,228,223,451,23,24,Player A
785,Evan,231,231,462,19,19,Tie
786,Evan,231,206,437,24,29,Player A
787,Evan,233,208,441,22,27,Player A
788,Evan,231,216,447,22,25,Player A
789,Evan,233,203,436,23,29,Player A
790,Evan,229,229,458,21,21,Tie
791,Evan,226,226,452,24,24,Tie
792,Evan,228,223,451,23,24,Player A
793,Evan,229,229,458,21,21,Tie
794,Evan,226,221,447,25,26,Player A
795,Evan,221,221,442,29,29,Tie
796,Evan,226,216,442,26,28,Player A
797,Evan,222,222,444,28,28,Tie
798,Evan,222,242,464,24,20,Evan
799,Evan,222,242,464,24,20,Evan
800,Evan,228,223,451,23,24,Player A
801,Evan,197,282,479,36,19,Evan
802,Evan,234,204,438,22,28,Player A
803,Evan,208,253,461,33,24,Evan
804,Evan,229,214,443,24,27,Player A
805,Evan,215,235,450,31,27,Evan
806,Evan,219,254,473,24,17,Evan
807,Evan,219,239,458,27,23,Evan
808,Evan,230,210,440,24,28,Player A
809,Evan,223,228,451,26,25,Evan
810,Evan,222,232,454,26,24,Evan
811,Evan,227,207,434,27,31,Player A
812,Evan,221,231,452,27,25,Evan
813,Evan,232,217,449,21,24,Player A
814,Evan,213,253,466,29,21,Evan
815,Evan,234,204,438,22,28,Player A
816,Evan,212,252,464,30,22,Evan
817,Evan,231,211,442,23,27,Player A
818,Evan,229,214,443,24,27,Player A
819,Evan,222,227,449,27,26,Evan
820,Evan,226,226,452,24,24,Tie
821,Evan,221,236,457,26,23,Evan
822,Evan,215,245,460,29,23,Evan
823,Evan,227,227,454,23,23,Tie
824,Evan,220,240,460,26,22,Evan
825,Evan,217,252,469,26,19,Evan
826,Evan,227,222,449,24,25,Player A
827,Evan,222,247,469,23,18,Evan
828,Evan,235,215,450,19,23,Player A
829,Evan,233,203,436,23,29,Player A
830,Evan,235,205,440,21,27,Player A
831,Evan,219,244,463,26,21,Evan
832,Evan,224,224,448,26,26,Tie
833,Evan,233,218,451,20,23,Player A
834,Evan,218,243,461,27,22,Evan
835,Evan,221,231,452,27,25,Evan
836,Evan,221,226,447,28,27,Evan
837,Evan,212,262,474,28,18,Evan
838,Evan,231,216,447,22,25,Player A
839,Evan,226,226,452,24,24,Tie
840,Evan,222,222,444,28,28,Tie
841,Evan,227,227,454,23,23,Tie
842,Evan,220,235,455,27,24,Evan
843,Evan,220,245,465,25,20,Evan
844,Evan,223,238,461,24,21,Evan
845,Evan,215,240,455,30,25,Evan
846,Evan,213,238,451,32,27,Evan
847,Evan,217,247,464,27,21,Evan
848,Evan,227,217,444,25,27,Player A
849,Evan,229,234,463,20,19,Evan
850,Evan,230,210,440,24,28,Player A
851,Evan,222,227,449,27,26,Evan
852,Evan,236,211,447,19,24,Player A
853,Evan,243,198,441,16,25,Player A
854,Evan,227,217,444,25,27,Player A
855,Evan,221,246,467,24,19,Evan
856,Evan,217,252,469,26,19,Evan
857,Evan,233,213,446,21,25,Player A
858,Evan,213,243,456,31,25,Evan
859,Evan,231,221,452,21,23,Player A
860,Evan,225,230,455,24,23,Evan
861,Evan,230,210,440,24,28,Player A
862,Evan,224,224,448,26,26,Tie
863,Evan,222,232,454,26,24,Evan
864,Evan,219,229,448,29,27,Evan
865,Evan,220,250,470,24,18,Evan
866,Evan,223,228,451,26,25,Evan
867,Evan,217,252,469,26,19,Evan
868,Evan,221,231,452,27,25,Evan
869,Evan,226,221,447,25,26,Player A
870,Evan,216,241,457,29,24,Evan
871,Evan,238,198,436,20,28,Player A
872,Evan,216,251,467,27,20,Evan
873,Evan,221,226,447,28,27,Evan
874,Evan,220,235,455,27,24,Evan
875,Evan,225,230,455,24,23,Evan
876,Evan,240,195,435,19,28,Player A
877,Evan,228,223,451,23,24,Player A
878,Evan,209,249,458,33,25,Evan
879,Evan,210,250,460,32,24,Evan
880,Evan,224,224,448,26,26,Tie
881,Evan,221,226,447,28,27,Evan
882,Evan,220,235,455,27,24,Evan
883,Evan,231,221,452,21,23,Player A
884,Evan,237,202,439,20,27,Player A
885,Evan,235,200,435,22,29,Player A
886,Evan,223,228,451,26,25,Evan
887,Evan,220,235,455,27,24,Evan
888,Evan,212,252,464,30,22,Evan
889,Evan,220,235,455,27,24,Evan
890,Evan,225,225,450,25,25,Tie
891,Evan,229,229,458,21,21,Tie
892,Evan,212,257,469,29,20,Evan
893,Evan,228,218,446,24,26,Player A
894,Evan,224,239,463,23,20,Evan
895,Evan,226,216,442,26,28,Player A
896,Evan,222,247,469,23,18,Evan
897,Evan,221,221,442,29,29,Tie
898,Evan,222,237,459,25,22,Evan
899,Evan,216,246,462,28,22,Evan
900,Evan,230,220,450,22,24,Player A
901,Evan,222,237,459,25,22,Evan
902,Evan,240,185,425,21,32,Player A
903,Evan,234,209,443,21,26,Player A
0,Randy,212,227,439,17,26,Randy
1,Randy,218,238,456,31,25,Randy
2,Randy,260,180,440,27,29,Player A
3,Randy,217,222,439,26,29,Randy
4,Randy,227,207,434,15,27,Player A
5,Randy,240,240,480,28,16,Tie
6,Randy,242,222,464,27,21,Player A
7,Randy,230,210,440,33,31,Player A
8,Randy,223,203,426,19,31,Player A
9,Randy,226,236,462,22,20,Randy
10,Randy,208,258,466,26,20,Randy
11,Randy,212,232,444,22,26,Randy
12,Randy,214,234,448,26,26,Randy
13,Randy,260,215,475,35,20,Player A
14,Randy,241,206,447,19,24,Player A
15,Randy,215,215,430,20,30,Tie
16,Randy,222,207,429,22,31,Player A
17,Randy,200,220,420,25,35,Randy
18,Randy,221,211,432,25,31,Player A
19,Randy,235,215,450,25,25,Player A
20,Randy,213,238,451,26,25,Randy
21,Randy,208,243,451,26,25,Randy
22,Randy,204,224,428,27,33,Randy
23,Randy,218,218,436,20,28,Tie
24,Randy,229,209,438,28,30,Player A
25,Randy,227,212,439,26,29,Player A
26,Randy,231,226,457,26,23,Player A
27,Randy,229,229,458,24,22,Tie
28,Randy,235,225,460,26,22,Player A
29,Randy,208,263,471,28,19,Randy
30,Randy,208,258,466,29,21,Randy
31,Randy,245,225,470,24,18,Player A
32,Randy,255,210,465,25,20,Player A
33,Randy,237,222,459,25,22,Player A
34,Randy,229,239,468,28,20,Randy
35,Randy,211,236,447,28,27,Randy
36,Randy,222,217,439,23,28,Player A
37,Randy,242,217,459,22,21,Player A
38,Randy,210,250,460,23,21,Randy
39,Randy,251,196,447,25,26,Player A
40,Randy,262,192,454,29,25,Player A
41,Randy,220,220,440,21,27,Tie
42,Randy,218,238,456,25,23,Randy
43,Randy,246,216,462,25,21,Player A
44,Randy,216,236,452,24,24,Randy
45,Randy,207,227,434,21,29,Randy
46,Randy,241,206,447,19,24,Player A
47,Randy,218,238,456,31,25,Randy
48,Randy,194,279,473,27,18,Randy
49,Randy,207,227,434,21,29,Randy
50,Randy,202,252,454,23,23,Randy
51,Randy,197,227,424,23,33,Randy
52,Randy,238,193,431,24,31,Player A
53,Randy,233,223,456,28,24,Player A
54,Randy,213,253,466,23,19,Randy
55,Randy,216,251,467,24,19,Randy
56,Randy,195,260,455,27,24,Randy
57,Randy,238,228,466,26,20,Player A
58,Randy,207,232,439,23,28,Randy
59,Randy,218,233,451,20,23,Randy
60,Randy,235,190,425,27,34,Player A
61,Randy,221,241,462,25,21,Randy
62,Randy,212,222,434,24,30,Randy
63,Randy,226,211,437,24,29,Player A
64,Randy,230,240,470,36,22,Randy
65,Randy,257,187,444,22,26,Player A
66,Randy,261,226,487,35,16,Player A
67,Randy,224,239,463,29,22,Randy
68,Randy,238,223,461,27,22,Player A
69,Randy,208,238,446,21,25,Randy
70,Randy,193,228,421,20,33,Randy
71,Randy,206,241,447,22,25,Randy
72,Randy,200,235,435,25,30,Randy
73,Randy,203,243,446,24,26,Randy
74,Randy,220,230,450,25,25,Randy
75,Randy,248,223,471,31,20,Player A
76,Randy,209,219,428,24,32,Randy
77,Randy,259,189,448,26,26,Player A
78,Randy,212,257,469,35,22,Randy
79,Randy,203,223,426,22,32,Randy
80,Randy,194,244,438,25,29,Randy
81,Randy,198,233,431,21,30,Randy
82,Randy,266,201,467,24,19,Player A
83,Randy,212,222,434,18,28,Randy
84,Randy,259,194,453,25,24,Player A
85,Randy,218,253,471,22,17,Randy
86,Randy,206,246,452,27,25,Randy
87,Randy,263,213,476,33,19,Player A
88,Randy,242,252,494,30,12,Randy
89,Randy,233,218,451,23,24,Player A
90,Randy,236,211,447,28,27,Player A
91,Randy,200,240,440,21,27,Randy
92,Randy,235,205,440,21,27,Player A
93,Randy,192,272,464,27,21,Randy
94,Randy,236,216,452,24,24,Player A
95,Randy,212,257,469,29,20,Randy
96,Randy,230,235,465,28,21,Randy
97,Randy,237,222,459,28,23,Player A
98,Randy,254,184,438,25,29,Player A
99,Randy,219,234,453,22,23,Randy
100,Randy,208,228,436,20,28,Randy
101,Randy,225,245,470,24,18,Randy
102,Randy,208,218,426,22,32,Randy
103,Randy,230,215,445,29,28,Player A
104,Randy,249,184,433,23,30,Player A
105,Randy,218,243,461,36,25,Randy
106,Randy,235,205,440,18,26,Player A
107,Randy,235,220,455,33,26,Player A
108,Randy,226,246,472,26,18,Randy
109,Randy,230,215,445,29,28,Player A
110,Randy,203,253,456,25,23,Randy
111,Randy,202,252,454,20,22,Randy
112,Randy,252,202,454,26,24,Player A
113,Randy,239,234,473,36,21,Player A
114,Randy,202,257,459,31,24,Randy
115,Randy,239,209,448,20,24,Player A
116,Randy,230,230,460,29,23,Tie
117,Randy,241,216,457,29,24,Player A
118,Randy,181,271,452,18,22,Randy
119,Randy,191,251,442,23,27,Randy
120,Randy,246,206,452,24,24,Player A
121,Randy,216,256,472,26,18,Randy
122,Randy,227,202,429,22,31,Player A
123,Randy,202,262,464,30,22,Randy
124,Randy,209,264,473,36,21,Randy
125,Randy,225,240,465,25,20,Randy
126,Randy,237,217,454,26,24,Player A
127,Randy,213,208,421,20,33,Player A
128,Randy,223,178,401,15,38,Player A
129,Randy,201,226,427,17,30,Randy
130,Randy,225,230,455,24,23,Randy
131,Randy,247,217,464,30,22,Player A
132,Randy,264,204,468,31,21,Player A
133,Randy,186,251,437,18,27,Randy
134,Randy,242,257,499,35,12,Randy
135,Randy,205,245,450,25,25,Randy
136,Randy,209,234,443,21,26,Randy
137,Randy,234,249,483,31,16,Randy
138,Randy,182,237,419,21,34,Randy
139,Randy,247,202,449,24,25,Player A
140,Randy,225,215,440,18,26,Player A
141,Randy,229,214,443,30,29,Player A
142,Randy,218,243,461,18,19,Randy
143,Randy,215,230,445,20,25,Randy
144,Randy,218,213,431,27,32,Player A
145,Randy,259,234,493,29,12,Player A
146,Randy,259,204,463,26,21,Player A
147,Randy,208,228,436,26,30,Randy
148,Randy,253,193,446,30,28,Player A
149,Randy,245,205,450,34,28,Player A
150,Randy,222,227,449,30,27,Randy
151,Randy,235,195,430,26,32,Player A
152,Randy,248,218,466,23,19,Player A
153,Randy,255,205,460,26,22,Player A
154,Randy,218,253,471,31,20,Randy
155,Randy,206,231,437,18,27,Randy
156,Randy,224,239,463,20,19,Randy
157,Randy,204,229,433,23,30,Randy
158,Randy,243,223,466,29,21,Player A
159,Randy,219,249,468,31,21,Randy
160,Randy,245,250,495,46,17,Randy
161,Randy,232,222,454,26,24,Player A
162,Randy,223,238,461,30,23,Randy
163,Randy,248,223,471,25,18,Player A
164,Randy,175,275,450,22,24,Randy
165,Randy,204,244,448,29,27,Randy
166,Randy,238,218,456,28,24,Player A
167,Randy,216,261,477,28,17,Randy
168,Randy,238,218,456,25,23,Player A
169,Randy,258,223,481,29,16,Player A
170,Randy,225,230,455,27,24,Randy
171,Randy,230,225,455,27,24,Player A
172,Randy,225,215,440,24,28,Player A
173,Randy,238,193,431,21,30,Player A
174,Randy,267,202,469,29,20,Player A
175,Randy,235,245,480,37,19,Randy
176,Randy,231,221,452,18,22,Player A
177,Randy,208,218,426,13,29,Randy
178,Randy,209,229,438,19,27,Randy
179,Randy,219,229,448,32,28,Randy
180,Randy,264,164,428,21,31,Player A
181,Randy,210,240,450,25,25,Randy
182,Randy,242,207,449,27,26,Player A
183,Randy,226,231,457,32,25,Randy
184,Randy,221,256,477,28,17,Randy
185,Randy,199,229,428,27,33,Randy
186,Randy,164,259,423,16,31,Randy
187,Randy,258,203,461,24,21,Player A
188,Randy,222,227,449,24,25,Randy
189,Randy,216,231,447,22,25,Randy
190,Randy,197,282,479,30,17,Randy
191,Randy,253,223,476,24,16,Player A
192,Randy,231,236,467,33,22,Randy
193,Randy,224,204,428,27,33,Player A
194,Randy,217,232,449,24,25,Randy
195,Randy,183,263,446,24,26,Randy
196,Randy,213,233,446,21,25,Randy
197,Randy,257,222,479,33,18,Player A
198,Randy,221,216,437,30,31,Player A
199,Randy,206,231,437,27,30,Randy
200,Randy,234,224,458,30,24,Player A
201,Randy,196,231,427,23,32,Randy
202,Randy,237,202,439,26,29,Player A
203,Randy,230,250,480,34,18,Randy
204,Randy,223,268,491,36,15,Randy
205,Randy,209,209,418,14,32,Tie
206,Randy,220,205,425,24,33,Player A
207,Randy,222,237,459,22,21,Randy
208,Randy,220,245,465,28,21,Randy
209,Randy,231,261,492,34,14,Randy
210,Randy,224,239,463,29,22,Randy
211,Randy,192,247,439,20,27,Randy
212,Randy,219,249,468,25,19,Randy
213,Randy,206,246,452,33,27,Randy
214,Randy,172,247,419,18,33,Randy
215,Randy,226,221,447,31,28,Player A
216,Randy,243,188,431,18,29,Player A
217,Randy,160,300,460,26,22,Randy
218,Randy,211,236,447,25,26,Randy
219,Randy,204,269,473,33,20,Randy
220,Randy,213,243,456,28,24,Randy
221,Randy,253,193,446,21,25,Player A
222,Randy,215,230,445,29,28,Randy
223,Randy,231,206,437,24,29,Player A
224,Randy,214,224,438,28,30,Randy
225,Randy,255,230,485,33,16,Player A
226,Randy,228,223,451,23,24,Player A
227,Randy,187,262,449,24,25,Randy
228,Randy,212,247,459,28,23,Randy
229,Randy,251,201,452,27,25,Player A
230,Randy,250,190,440,30,30,Player A
231,Randy,216,231,447,28,27,Randy
232,Randy,194,254,448,26,26,Randy
233,Randy,241,216,457,26,23,Player A
234,Randy,229,254,483,34,17,Randy
235,Randy,264,174,438,22,28,Player A
236,Randy,230,210,440,21,27,Player A
237,Randy,225,240,465,31,22,Randy
238,Randy,248,233,481,35,18,Player A
239,Randy,266,181,447,25,26,Player A
240,Randy,211,231,442,23,27,Randy
241,Randy,211,251,462,28,22,Randy
242,Randy,208,223,431,24,31,Randy
243,Randy,209,234,443,24,27,Randy
244,Randy,241,226,467,33,22,Player A
245,Randy,247,207,454,23,23,Player A
246,Randy,228,233,461,30,23,Randy
247,Randy,205,225,430,17,29,Randy
248,Randy,213,258,471,22,17,Randy
249,Randy,219,219,438,22,28,Tie
250,Randy,239,204,443,24,27,Player A
251,Randy,194,244,438,25,29,Randy
252,Randy,213,248,461,27,22,Randy
253,Randy,226,221,447,22,25,Player A
254,Randy,227,232,459,25,22,Randy
255,Randy,199,249,448,26,26,Randy
256,Randy,211,251,462,28,22,Randy
257,Randy,235,215,450,31,27,Player A
258,Randy,232,252,484,26,14,Randy
259,Randy,213,218,431,18,29,Randy
260,Randy,252,212,464,30,22,Player A
261,Randy,254,214,468,28,20,Player A
262,Randy,242,197,439,26,29,Player A
263,Randy,234,234,468,25,19,Tie
264,Randy,219,244,463,29,22,Randy
265,Randy,216,251,467,30,21,Randy
266,Randy,195,245,440,24,28,Randy
267,Randy,234,219,453,25,24,Player A
268,Randy,227,212,439,23,28,Player A
269,Randy,229,219,448,26,26,Player A
270,Randy,231,236,467,33,22,Randy
271,Randy,233,223,456,25,23,Player A
272,Randy,195,235,430,17,29,Randy
273,Randy,245,205,450,25,25,Player A
274,Randy,204,239,443,27,28,Randy
275,Randy,227,227,454,29,25,Tie
276,Randy,245,200,445,26,27,Player A
277,Randy,230,225,455,27,24,Player A
278,Randy,216,251,467,33,22,Randy
279,Randy,201,251,452,21,23,Randy
280,Randy,234,214,448,23,25,Player A
281,Randy,226,226,452,18,22,Tie
282,Randy,196,226,422,24,34,Randy
283,Randy,225,230,455,27,24,Randy
284,Randy,227,247,474,37,21,Randy
285,Randy,222,217,439,26,29,Player A
286,Randy,257,192,449,24,25,Player A
287,Randy,208,218,426,16,30,Randy
288,Randy,205,245,450,25,25,Randy
289,Randy,242,212,454,29,25,Player A
290,Randy,200,245,445,20,25,Randy
291,Randy,238,208,446,21,25,Player A
292,Randy,215,235,450,28,26,Randy
293,Randy,237,232,469,32,21,Player A
294,Randy,228,208,436,29,31,Player A
295,Randy,225,230,455,27,24,Randy
296,Randy,212,257,469,32,21,Randy
297,Randy,206,221,427,23,32,Randy
298,Randy,212,257,469,23,18,Randy
299,Randy,189,274,463,20,19,Randy
300,Randy,218,243,461,27,22,Randy
301,Randy,246,216,462,25,21,Player A
302,Randy,237,222,459,28,23,Player A
303,Randy,198,283,481,26,15,Randy
304,Randy,206,236,442,23,27,Randy
305,Randy,204,224,428,21,31,Randy
306,Randy,234,239,473,36,21,Randy
307,Randy,234,229,463,29,22,Player A
308,Randy,218,258,476,30,18,Randy
309,Randy,238,213,451,26,25,Player A
310,Randy,225,215,440,21,27,Player A
311,Randy,197,227,424,17,31,Randy
312,Randy,223,243,466,26,20,Randy
313,Randy,222,227,449,24,25,Randy
314,Randy,223,243,466,32,22,Randy
315,Randy,255,200,455,27,24,Player A
316,Randy,221,241,462,31,23,Randy
317,Randy,221,236,457,26,23,Randy
318,Randy,212,247,459,22,21,Randy
319,Randy,197,262,459,31,24,Randy
320,Randy,205,240,445,26,27,Randy
321,Randy,234,214,448,26,26,Player A
322,Randy,201,251,452,24,24,Randy
323,Randy,214,229,443,21,26,Randy
324,Randy,202,237,439,29,30,Randy
325,Randy,244,229,473,30,19,Player A
326,Randy,222,237,459,25,22,Randy
327,Randy,213,228,441,16,25,Randy
328,Randy,220,255,475,32,19,Randy
329,Randy,205,230,435,28,31,Randy
330,Randy,212,232,444,28,28,Randy
331,Randy,203,253,456,25,23,Randy
332,Randy,212,257,469,29,20,Randy
333,Randy,202,227,429,28,33,Randy
334,Randy,234,209,443,24,27,Player A
335,Randy,236,221,457,26,23,Player A
336,Randy,221,236,457,26,23,Randy
337,Randy,196,246,442,23,27,Randy
338,Randy,220,225,445,23,26,Randy
339,Randy,232,197,429,19,30,Player A
340,Randy,207,242,449,30,27,Randy
341,Randy,262,217,479,30,17,Player A
342,Randy,250,200,450,22,24,Player A
343,Randy,242,222,464,24,20,Player A
344,Randy,216,221,437,27,30,Randy
345,Randy,232,207,439,26,29,Player A
346,Randy,237,217,454,29,25,Player A
347,Randy,200,240,440,27,29,Randy
348,Randy,224,244,468,22,18,Randy
349,Randy,241,211,452,18,22,Player A
350,Randy,236,211,447,22,25,Player A
351,Randy,234,209,443,21,26,Player A
352,Randy,231,216,447,31,28,Player A
353,Randy,243,218,461,33,24,Player A
354,Randy,203,248,451,29,26,Randy
355,Randy,229,229,458,27,23,Tie
356,Randy,236,221,457,26,23,Player A
357,Randy,242,202,444,22,26,Player A
358,Randy,228,208,436,23,29,Player A
359,Randy,220,220,440,24,28,Tie
360,Randy,197,232,429,25,32,Randy
361,Randy,233,223,456,28,24,Player A
362,Randy,233,213,446,21,25,Player A
363,Randy,229,219,448,26,26,Player A
364,Randy,212,232,444,22,26,Randy
365,Randy,210,240,450,34,28,Randy
366,Randy,210,225,435,25,30,Randy
367,Randy,253,228,481,29,16,Player A
368,Randy,225,230,455,21,22,Randy
369,Randy,226,226,452,33,27,Tie
370,Randy,231,236,467,30,21,Randy
371,Randy,205,230,435,22,29,Randy
372,Randy,239,214,453,25,24,Player A
373,Randy,250,210,460,23,21,Player A
374,Randy,225,230,455,27,24,Randy
375,Randy,205,250,455,30,25,Randy
376,Randy,220,255,475,32,19,Randy
377,Randy,198,263,461,27,22,Randy
378,Randy,243,198,441,25,28,Player A
379,Randy,221,256,477,25,16,Randy
380,Randy,241,211,452,24,24,Player A
381,Randy,222,252,474,25,17,Randy
382,Randy,220,225,445,20,25,Randy
383,Randy,263,213,476,27,17,Player A
384,Randy,225,240,465,31,22,Randy
385,Randy,200,245,445,23,26,Randy
386,Randy,225,235,460,26,22,Randy
387,Randy,236,221,457,23,22,Player A
388,Randy,228,223,451,26,25,Player A
389,Randy,227,217,444,25,27,Player A
390,Randy,231,196,427,14,29,Player A
391,Randy,240,230,470,30,20,Player A
392,Randy,200,245,445,23,26,Randy
393,Randy,203,218,421,20,33,Randy
394,Randy,233,218,451,26,25,Player A
395,Randy,241,211,452,27,25,Player A
396,Randy,244,234,478,32,18,Player A
397,Randy,239,214,453,28,25,Player A
398,Randy,255,205,460,29,23,Player A
399,Randy,247,207,454,23,23,Player A
400,Randy,249,209,458,21,21,Player A
401,Randy,241,201,442,20,26,Player A
402,Randy,222,212,434,24,30,Player A
403,Randy,208,253,461,33,24,Randy
404,Randy,242,217,459,25,22,Player A
405,Randy,192,252,444,16,24,Randy
406,Randy,266,201,467,30,21,Player A
407,Randy,244,224,468,34,22,Player A
408,Randy,238,223,461,33,24,Player A
409,Randy,200,225,425,24,33,Randy
410,Randy,258,208,466,29,21,Player A
411,Randy,216,236,452,24,24,Randy
412,Randy,183,273,456,25,23,Randy
413,Randy,245,205,450,22,24,Player A
414,Randy,222,212,434,18,28,Player A
415,Randy,259,189,448,23,25,Player A
416,Randy,247,207,454,26,24,Player A
417,Randy,226,231,457,29,24,Randy
418,Randy,195,245,440,21,27,Randy
419,Randy,229,214,443,21,26,Player A
420,Randy,240,240,480,34,18,Tie
421,Randy,208,238,446,27,27,Randy
422,Randy,224,214,438,19,27,Player A
423,Randy,239,219,458,27,23,Player A
424,Randy,240,220,460,32,24,Player A
425,Randy,239,219,458,30,24,Player A
426,Randy,224,224,448,26,26,Tie
427,Randy,233,213,446,27,27,Player A
428,Randy,232,217,449,27,26,Player A
429,Randy,215,215,430,17,29,Tie
430,Randy,233,238,471,28,19,Randy
431,Randy,234,234,468,31,21,Tie
432,Randy,240,230,470,33,21,Player A
433,Randy,231,211,442,20,26,Player A
434,Randy,208,258,466,26,20,Randy
435,Randy,218,253,471,25,18,Randy
436,Randy,203,253,456,28,24,Randy
437,Randy,219,229,448,26,26,Randy
438,Randy,210,215,425,21,32,Randy
439,Randy,246,221,467,33,22,Player A
440,Randy,247,242,489,37,16,Player A
441,Randy,189,229,418,20,34,Randy
442,Randy,235,240,475,29,18,Randy
443,Randy,265,200,465,28,21,Player A
444,Randy,218,253,471,31,20,Randy
445,Randy,232,227,459,25,22,Player A
446,Randy,204,219,423,19,32,Randy
447,Randy,229,229,458,21,21,Tie
448,Randy,198,228,426,19,31,Randy
449,Randy,250,195,445,26,27,Player A
450,Randy,218,223,441,19,26,Randy
451,Randy,232,202,434,18,28,Player A
452,Randy,204,249,453,25,24,Randy
453,Randy,262,202,464,24,20,Player A
454,Randy,229,229,458,24,22,Tie
455,Randy,208,238,446,24,26,Randy
456,Randy,219,249,468,19,17,Randy
457,Randy,244,199,443,24,27,Player A
458,Randy,249,204,453,28,25,Player A
459,Randy,217,232,449,30,27,Randy
460,Randy,220,225,445,20,25,Randy
461,Randy,265,190,455,24,23,Player A
462,Randy,225,240,465,28,21,Randy
463,Randy,247,207,454,29,25,Player A
464,Randy,240,230,470,24,18,Player A
465,Randy,233,198,431,21,30,Player A
466,Randy,213,228,441,25,28,Randy
467,Randy,229,234,463,20,19,Randy
468,Randy,204,244,448,26,26,Randy
469,Randy,214,264,478,26,16,Randy
470,Randy,223,253,476,30,18,Randy
471,Randy,266,211,477,31,18,Player A
472,Randy,227,212,439,20,27,Player A
473,Randy,225,235,460,23,21,Randy
474,Randy,190,270,460,26,22,Randy
475,Randy,255,190,445,26,27,Player A
476,Randy,233,228,461,27,22,Player A
477,Randy,243,218,461,21,20,Player A
478,Randy,230,205,435,25,30,Player A
479,Randy,210,230,440,21,27,Randy
480,Randy,273,188,461,33,24,Player A
481,Randy,252,227,479,27,16,Player A
482,Randy,219,274,493,32,13,Randy
483,Randy,220,215,435,25,30,Player A
484,Randy,189,239,428,21,31,Randy
485,Randy,234,239,473,27,18,Randy
486,Randy,245,195,440,21,27,Player A
487,Randy,246,196,442,23,27,Player A
488,Randy,253,178,431,18,29,Player A
489,Randy,244,219,463,32,23,Player A
490,Randy,231,226,457,29,24,Player A
491,Randy,189,224,413,21,36,Randy
492,Randy,224,239,463,26,21,Randy
493,Randy,204,259,463,26,21,Randy
494,Randy,225,220,445,29,28,Player A
495,Randy,233,223,456,25,23,Player A
496,Randy,219,234,453,31,26,Randy
497,Randy,231,221,452,27,25,Player A
498,Randy,235,215,450,25,25,Player A
499,Randy,225,235,460,26,22,Randy
500,Randy,260,190,450,25,25,Player A
501,Randy,207,237,444,28,28,Randy
502,Randy,209,234,443,21,26,Randy
503,Randy,239,214,453,19,22,Player A
504,Randy,233,223,456,34,26,Player A
505,Randy,222,227,449,24,25,Randy
506,Randy,234,219,453,28,25,Player A
507,Randy,239,224,463,23,20,Player A
508,Randy,232,222,454,23,23,Player A
509,Randy,227,227,454,32,26,Tie
510,Randy,238,193,431,24,31,Player A
511,Randy,228,218,446,27,27,Player A
512,Randy,200,230,430,20,30,Randy
513,Randy,257,207,464,30,22,Player A
514,Randy,262,202,464,24,20,Player A
515,Randy,249,219,468,22,18,Player A
516,Randy,231,241,472,29,19,Randy
517,Randy,253,213,466,35,23,Player A
518,Randy,203,213,416,18,34,Randy
519,Randy,236,226,462,25,21,Player A
520,Randy,190,240,430,23,31,Randy
521,Randy,249,199,448,26,26,Player A
522,Randy,242,217,459,31,24,Player A
523,Randy,197,257,454,32,26,Randy
524,Randy,229,224,453,34,27,Player A
525,Randy,220,255,475,26,17,Randy
526,Randy,242,227,469,32,21,Player A
527,Randy,199,229,428,24,32,Randy
528,Randy,255,200,455,33,26,Player A
529,Randy,225,225,450,22,24,Tie
530,Randy,226,226,452,27,25,Tie
531,Randy,248,223,471,31,20,Player A
532,Randy,234,214,448,26,26,Player A
533,Randy,230,225,455,18,21,Player A
534,Randy,219,249,468,34,22,Randy
535,Randy,240,215,455,27,24,Player A
536,Randy,219,249,468,28,20,Randy
537,Randy,205,255,460,32,24,Randy
538,Randy,243,218,461,27,22,Player A
539,Randy,209,244,453,25,24,Randy
540,Randy,250,210,460,26,22,Player A
541,Randy,208,248,456,22,22,Randy
542,Randy,238,223,461,27,22,Player A
543,Randy,248,208,456,25,23,Player A
544,Randy,202,262,464,30,22,Randy
545,Randy,240,195,435,28,31,Player A
546,Randy,202,257,459,25,22,Randy
547,Randy,267,207,474,31,19,Player A
548,Randy,191,246,437,21,28,Randy
549,Randy,231,216,447,25,26,Player A
550,Randy,223,218,441,25,28,Player A
551,Randy,228,238,466,29,21,Randy
552,Randy,204,264,468,34,22,Randy
553,Randy,218,213,431,21,30,Player A
554,Randy,204,229,433,23,30,Randy
555,Randy,267,197,464,27,21,Player A
556,Randy,235,230,465,31,22,Player A
557,Randy,230,225,455,27,24,Player A
558,Randy,226,236,462,34,24,Randy
559,Randy,240,205,445,20,25,Player A
560,Randy,207,237,444,22,26,Randy
561,Randy,218,228,446,24,26,Randy
562,Randy,211,221,432,22,30,Randy
563,Randy,231,211,442,26,28,Player A
564,Randy,201,236,437,21,28,Randy
565,Randy,208,233,441,25,28,Randy
566,Randy,223,233,456,28,24,Randy
567,Randy,219,229,448,29,27,Randy
568,Randy,206,226,432,22,30,Randy
569,Randy,191,256,447,25,26,Randy
570,Randy,197,227,424,20,32,Randy
571,Randy,176,276,452,21,23,Randy
572,Randy,232,237,469,29,20,Randy
573,Randy,262,192,454,26,24,Player A
574,Randy,234,204,438,22,28,Player A
575,Randy,221,246,467,33,22,Randy
576,Randy,207,212,419,18,33,Randy
577,Randy,209,229,438,25,29,Randy
578,Randy,215,230,445,23,26,Randy
579,Randy,220,230,450,22,24,Randy
580,Randy,217,247,464,30,22,Randy
581,Randy,213,243,456,31,25,Randy
582,Randy,233,223,456,22,22,Player A
583,Randy,196,241,437,24,29,Randy
584,Randy,228,223,451,23,24,Player A
585,Randy,211,261,472,26,18,Randy
586,Randy,275,190,465,22,19,Player A
587,Randy,213,238,451,20,23,Randy
588,Randy,238,243,481,29,16,Randy
589,Randy,211,221,432,22,30,Randy
590,Randy,230,215,445,20,25,Player A
591,Randy,210,260,470,27,19,Randy
592,Randy,228,213,441,22,27,Player A
593,Randy,229,219,448,26,26,Player A
594,Randy,228,203,431,24,31,Player A
595,Randy,228,223,451,26,25,Player A
596,Randy,221,216,437,24,29,Player A
597,Randy,203,218,421,23,34,Randy
598,Randy,193,243,436,23,29,Randy
599,Randy,231,221,452,27,25,Player A
600,Randy,234,194,428,21,31,Player A
601,Randy,209,229,438,22,28,Randy
602,Randy,247,197,444,22,26,Player A
603,Randy,225,235,460,32,24,Randy
604,Randy,219,224,443,24,27,Randy
605,Randy,228,223,451,29,26,Player A
606,Randy,253,173,426,13,29,Player A
607,Randy,221,231,452,30,26,Randy
608,Randy,208,233,441,28,29,Randy
609,Randy,220,245,465,28,21,Randy
610,Randy,214,234,448,20,24,Randy
611,Randy,222,237,459,25,22,Randy
612,Randy,194,239,433,23,30,Randy
613,Randy,223,223,446,24,26,Tie
614,Randy,227,237,464,24,20,Randy
615,Randy,195,250,445,29,28,Randy
616,Randy,203,218,421,20,33,Randy
617,Randy,192,247,439,26,29,Randy
618,Randy,208,213,421,20,33,Randy
619,Randy,219,229,448,23,25,Randy
620,Randy,212,217,429,25,32,Randy
621,Randy,239,199,438,25,29,Player A
622,Randy,204,244,448,26,26,Randy
623,Randy,209,249,458,27,23,Randy
624,Randy,214,244,458,27,23,Randy
625,Randy,208,258,466,29,21,Randy
626,Randy,226,241,467,27,20,Randy
627,Randy,212,272,484,38,18,Randy
628,Randy,217,227,444,25,27,Randy
629,Randy,247,202,449,24,25,Player A
630,Randy,261,201,462,28,22,Player A
631,Randy,218,223,441,34,31,Randy
632,Randy,235,220,455,27,24,Player A
633,Randy,212,217,429,22,31,Randy
634,Randy,235,215,450,22,24,Player A
635,Randy,195,260,455,21,22,Randy
636,Randy,206,236,442,20,26,Randy
637,Randy,238,223,461,24,21,Player A
638,Randy,216,226,442,23,27,Randy
639,Randy,200,240,440,27,29,Randy
640,Randy,232,207,439,26,29,Player A
641,Randy,244,224,468,34,22,Player A
642,Randy,219,239,458,27,23,Randy
643,Randy,268,213,481,29,16,Player A
644,Randy,187,242,429,25,32,Randy
645,Randy,276,176,452,27,25,Player A
646,Randy,231,226,457,26,23,Player A
647,Randy,232,222,454,26,24,Player A
648,Randy,234,209,443,21,26,Player A
649,Randy,197,232,429,22,31,Randy
650,Randy,209,214,423,19,32,Randy
651,Randy,205,265,470,24,18,Randy
652,Randy,237,237,474,31,19,Tie
653,Randy,243,228,471,31,20,Player A
654,Randy,233,213,446,30,28,Player A
655,Randy,227,247,474,28,18,Randy
656,Randy,184,264,448,17,23,Randy
657,Randy,210,240,450,28,26,Randy
658,Randy,248,233,481,32,17,Player A
659,Randy,185,255,440,24,28,Randy
660,Randy,206,246,452,24,24,Randy
661,Randy,212,252,464,30,22,Randy
662,Randy,227,207,434,21,29,Player A
663,Randy,235,210,445,20,25,Player A
664,Randy,238,213,451,17,22,Player A
665,Randy,202,207,409,20,37,Randy
666,Randy,215,210,425,18,31,Player A
667,Randy,235,240,475,23,16,Randy
668,Randy,236,226,462,28,22,Player A
669,Randy,233,213,446,27,27,Player A
670,Randy,203,233,436,29,31,Randy
671,Randy,251,201,452,27,25,Player A
672,Randy,242,227,469,32,21,Player A
673,Randy,277,172,449,21,24,Player A
674,Randy,250,185,435,16,27,Player A
675,Randy,194,269,463,32,23,Randy
676,Randy,236,216,452,24,24,Player A
677,Randy,256,196,452,27,25,Player A
678,Randy,221,226,447,28,27,Randy
679,Randy,247,212,459,28,23,Player A
680,Randy,238,208,446,24,26,Player A
681,Randy,223,233,456,31,25,Randy
682,Randy,244,219,463,32,23,Player A
683,Randy,189,274,463,20,19,Randy
684,Randy,233,203,436,20,28,Player A
685,Randy,218,248,466,29,21,Randy
686,Randy,187,257,444,22,26,Randy
687,Randy,208,243,451,23,24,Randy
688,Randy,241,226,467,27,20,Player A
689,Randy,224,249,473,27,18,Randy
690,Randy,235,235,470,27,19,Tie
691,Randy,197,222,419,9,30,Randy
692,Randy,219,214,433,26,31,Player A
693,Randy,206,236,442,23,27,Randy
694,Randy,240,210,450,22,24,Player A
695,Randy,218,233,451,29,26,Randy
696,Randy,238,243,481,32,17,Randy
697,Randy,222,227,449,21,24,Randy
698,Randy,215,250,465,31,22,Randy
699,Randy,244,224,468,34,22,Player A
700,Randy,206,256,462,28,22,Randy
701,Randy,196,276,472,17,15,Randy
702,Randy,235,215,450,25,25,Player A
703,Randy,220,220,440,24,28,Tie
704,Randy,253,208,461,30,23,Player A
705,Randy,250,215,465,22,19,Player A
706,Randy,191,241,432,19,29,Randy
707,Randy,213,218,431,24,31,Randy
708,Randy,193,258,451,23,24,Randy
709,Randy,231,231,462,22,20,Tie
710,Randy,183,268,451,26,25,Randy
711,Randy,244,214,458,27,23,Player A
712,Randy,223,233,456,28,24,Randy
713,Randy,207,242,449,27,26,Randy
714,Randy,224,224,448,23,25,Tie
715,Randy,189,239,428,21,31,Randy
716,Randy,233,228,461,27,22,Player A
717,Randy,230,240,470,27,19,Randy
718,Randy,224,199,423,25,34,Player A
719,Randy,219,229,448,23,25,Randy
720,Randy,217,247,464,27,21,Randy
721,Randy,213,243,456,25,23,Randy
722,Randy,222,222,444,19,25,Tie
723,Randy,234,219,453,28,25,Player A
724,Randy,200,240,440,21,27,Randy
725,Randy,229,224,453,28,25,Player A
726,Randy,223,258,481,29,16,Randy
727,Randy,229,224,453,31,26,Player A
728,Randy,207,242,449,21,24,Randy
729,Randy,256,206,462,28,22,Player A
730,Randy,223,198,421,23,34,Player A
731,Randy,238,213,451,23,24,Player A
732,Randy,222,242,464,30,22,Randy
733,Randy,220,230,450,16,22,Randy
734,Randy,220,245,465,28,21,Randy
735,Randy,222,227,449,27,26,Randy
736,Randy,229,219,448,23,25,Player A
737,Randy,240,195,435,25,30,Player A
738,Randy,236,226,462,31,23,Player A
739,Randy,217,207,424,20,32,Player A
740,Randy,201,246,447,25,26,Randy
741,Randy,212,242,454,26,24,Randy
742,Randy,209,249,458,27,23,Randy
743,Randy,222,227,449,24,25,Randy
744,Randy,200,265,465,31,22,Randy
745,Randy,242,212,454,32,26,Player A
746,Randy,195,240,435,25,30,Randy
747,Randy,208,248,456,19,21,Randy
748,Randy,248,193,441,28,29,Player A
749,Randy,210,255,465,34,23,Randy
750,Randy,216,241,457,29,24,Randy
751,Randy,202,252,454,32,26,Randy
752,Randy,236,226,462,25,21,Player A
753,Randy,228,213,441,28,29,Player A
754,Randy,221,246,467,24,19,Randy
755,Randy,247,227,474,31,19,Player A
756,Randy,198,248,446,21,25,Randy
757,Randy,215,245,460,26,22,Randy
758,Randy,209,224,433,23,30,Randy
759,Randy,212,222,434,21,29,Randy
760,Randy,224,189,413,18,35,Player A
761,Randy,235,215,450,28,26,Player A
762,Randy,240,195,435,19,28,Player A
763,Randy,253,208,461,27,22,Player A
764,Randy,191,256,447,19,24,Randy
765,Randy,229,224,453,25,24,Player A
766,Randy,214,224,438,19,27,Randy
767,Randy,198,248,446,27,27,Randy
768,Randy,250,195,445,29,28,Player A
769,Randy,206,256,462,25,21,Randy
770,Randy,221,226,447,19,24,Randy
771,Randy,219,229,448,23,25,Randy
772,Randy,199,259,458,18,20,Randy
773,Randy,237,217,454,26,24,Player A
774,Randy,241,221,462,25,21,Player A
775,Randy,220,255,475,26,17,Randy
776,Randy,203,233,436,23,29,Randy
777,Randy,194,239,433,20,29,Randy
778,Randy,255,195,450,28,26,Player A
779,Randy,239,199,438,28,30,Player A
780,Randy,241,211,452,27,25,Player A
781,Randy,202,257,459,28,23,Randy
782,Randy,197,237,434,21,29,Randy
783,Randy,247,207,454,32,26,Player A
784,Randy,231,216,447,22,25,Player A
785,Randy,237,242,479,36,19,Randy
786,Randy,206,261,467,24,19,Randy
787,Randy,215,240,455,21,22,Randy
788,Randy,236,231,467,30,21,Player A
789,Randy,234,229,463,32,23,Player A
790,Randy,234,224,458,30,24,Player A
791,Randy,248,213,461,27,22,Player A
792,Randy,272,212,484,32,16,Player A
793,Randy,202,242,444,28,28,Randy
794,Randy,199,244,443,27,28,Randy
795,Randy,207,212,419,21,34,Randy
796,Randy,213,243,456,28,24,Randy
797,Randy,207,252,459,28,23,Randy
798,Randy,208,238,446,24,26,Randy
799,Randy,209,239,448,23,25,Randy
800,Randy,183,258,441,19,26,Randy
801,Randy,231,236,467,27,20,Randy
802,Randy,231,246,477,31,18,Randy
803,Randy,242,202,444,22,26,Player A
804,Randy,220,245,465,28,21,Randy
805,Randy,249,209,458,27,23,Player A
806,Randy,223,223,446,27,27,Tie
807,Randy,207,227,434,18,28,Randy
808,Randy,224,224,448,29,27,Tie
809,Randy,217,242,459,22,21,Randy
810,Randy,224,224,448,26,26,Tie
811,Randy,193,248,441,28,29,Randy
812,Randy,218,218,436,20,28,Tie
813,Randy,224,214,438,22,28,Player A
814,Randy,247,227,474,28,18,Player A
815,Randy,259,194,453,25,24,Player A
816,Randy,198,258,456,28,24,Randy
817,Randy,195,265,460,26,22,Randy
818,Randy,248,218,466,29,21,Player A
819,Randy,216,231,447,22,25,Randy
820,Randy,187,282,469,29,20,Randy
821,Randy,225,235,460,32,24,Randy
822,Randy,240,235,475,26,17,Player A
823,Randy,205,235,440,18,26,Randy
824,Randy,230,240,470,27,19,Randy
825,Randy,247,197,444,22,26,Player A
826,Randy,242,232,474,34,20,Player A
827,Randy,219,224,443,21,26,Randy
828,Randy,246,201,447,25,26,Player A
829,Randy,229,199,428,24,32,Player A
830,Randy,223,248,471,31,20,Randy
831,Randy,233,228,461,30,23,Player A
832,Randy,210,220,430,20,30,Randy
833,Randy,241,221,462,19,19,Player A
834,Randy,205,245,450,22,24,Randy
835,Randy,231,226,457,29,24,Player A
836,Randy,196,246,442,32,30,Randy
837,Randy,218,218,436,26,30,Tie
838,Randy,184,249,433,26,31,Randy
839,Randy,227,222,449,33,28,Player A
840,Randy,249,209,458,27,23,Player A
841,Randy,213,228,441,25,28,Randy
842,Randy,220,220,440,21,27,Tie
843,Randy,195,250,445,26,27,Randy
844,Randy,238,203,441,22,27,Player A
845,Randy,270,185,455,27,24,Player A
846,Randy,219,224,443,21,26,Randy
847,Randy,230,205,435,22,29,Player A
848,Randy,250,205,455,27,24,Player A
849,Randy,239,214,453,28,25,Player A
850,Randy,198,258,456,34,26,Randy
851,Randy,236,226,462,31,23,Player A
852,Randy,194,234,428,21,31,Randy
853,Randy,234,224,458,27,23,Player A
854,Randy,239,214,453,22,23,Player A
855,Randy,258,203,461,24,21,Player A
856,Randy,188,233,421,20,33,Randy
857,Randy,214,244,458,24,22,Randy
858,Randy,230,215,445,23,26,Player A
859,Randy,228,213,441,25,28,Player A
860,Randy,256,191,447,19,24,Player A
861,Randy,230,215,445,23,26,Player A
862,Randy,166,281,447,31,28,Randy
863,Randy,186,246,432,22,30,Randy
864,Randy,203,248,451,32,27,Randy
865,Randy,216,236,452,27,25,Randy
866,Randy,226,211,437,24,29,Player A
867,Randy,218,223,441,19,26,Randy
868,Randy,203,233,436,26,30,Randy
869,Randy,172,242,414,22,36,Randy
870,Randy,230,210,440,27,29,Player A
871,Randy,191,236,427,23,32,Randy
872,Randy,226,226,452,24,24,Tie
873,Randy,221,251,472,26,18,Randy
874,Randy,212,242,454,29,25,Randy
875,Randy,225,250,475,29,18,Randy
876,Randy,235,225,460,26,22,Player A
877,Randy,214,229,443,21,26,Randy
878,Randy,227,217,444,22,26,Player A
879,Randy,226,226,452,21,23,Tie
880,Randy,231,201,432,22,30,Player A
881,Randy,233,198,431,21,30,Player A
882,Randy,186,251,437,21,28,Randy
883,Randy,193,248,441,28,29,Randy
884,Randy,222,222,444,28,28,Tie
885,Randy,227,207,434,24,30,Player A
886,Randy,252,222,474,31,19,Player A
887,Randy,230,215,445,23,26,Player A
888,Randy,232,227,459,31,24,Player A
889,Randy,208,223,431,18,29,Randy
890,Randy,213,238,451,29,26,Randy
891,Randy,215,245,460,23,21,Randy
892,Randy,195,255,450,25,25,Randy
893,Randy,279,194,473,27,18,Player A
894,Randy,219,224,443,24,27,Randy
895,Randy,235,200,435,25,30,Player A
896,Randy,228,218,446,27,27,Player A
897,Randy,220,255,475,26,17,Randy
898,Randy,224,219,443,27,28,Player A
899,Randy,199,224,423,22,33,Randy
900,Randy,193,243,436,26,30,Randy
901,Randy,249,214,463,29,22,Player A
902,Randy,218,243,461,30,23,Randy
903,Randy,239,224,463,26,21,Player A
904,Randy,225,230,455,24,23,Randy
905,Randy,243,198,441,22,27,Player A
906,Randy,217,197,414,19,35,Player A
907,Randy,222,227,449,24,25,Randy
908,Randy,216,236,452,30,26,Randy
909,Randy,164,279,443,24,27,Randy
910,Randy,228,233,461,27,22,Randy
911,Randy,214,234,448,32,28,Randy
912,Randy,194,234,428,21,31,Randy
913,Randy,239,204,443,24,27,Player A
914,Randy,216,251,467,24,19,Randy
915,Randy,202,227,429,25,32,Randy
916,Randy,218,208,426,22,32,Player A
917,Randy,225,225,450,25,25,Tie
918,Randy,229,209,438,22,28,Player A
919,Randy,198,233,431,18,29,Randy
920,Randy,225,245,470,33,21,Randy
921,Randy,206,226,432,16,28,Randy
922,Randy,235,200,435,25,30,Player A
923,Randy,200,245,445,29,28,Randy
924,Randy,214,224,438,19,27,Randy
925,Randy,214,224,438,22,28,Randy
926,Randy,269,199,468,28,20,Player A
927,Randy,252,197,449,21,24,Player A
928,Randy,201,226,427,20,31,Randy
929,Randy,208,228,436,23,29,Randy
930,Randy,208,248,456,28,24,Randy
931,Randy,246,216,462,28,22,Player A
932,Randy,233,238,471,25,18,Randy
933,Randy,242,242,484,32,16,Tie
934,Randy,196,246,442,26,28,Randy
935,Randy,168,268,436,23,29,Randy
936,Randy,245,225,470,27,19,Player A
937,Randy,203,248,451,23,24,Randy
938,Randy,220,210,430,20,30,Player A
939,Randy,205,245,450,25,25,Randy
940,Randy,227,212,439,23,28,Player A
941,Randy,226,226,452,30,26,Tie
942,Randy,228,228,456,25,23,Tie
943,Randy,226,226,452,24,24,Tie
944,Randy,258,183,441,22,27,Player A
945,Randy,206,221,427,17,30,Randy
946,Randy,218,243,461,30,23,Randy
947,Randy,227,227,454,20,22,Tie
948,Randy,239,204,443,33,30,Player A
949,Randy,240,215,455,27,24,Player A
950,Randy,241,206,447,28,27,Player A
951,Randy,222,207,429,19,30,Player A
952,Randy,244,219,463,26,21,Player A
953,Randy,229,244,473,24,17,Randy
954,Randy,226,226,452,18,22,Tie
955,Randy,236,231,467,21,18,Player A
956,Randy,230,230,460,32,24,Tie
957,Randy,226,231,457,26,23,Randy
958,Randy,190,280,470,21,17,Randy
959,Randy,231,201,432,22,30,Player A
960,Randy,228,218,446,30,28,Player A
961,Randy,227,242,469,29,20,Randy
962,Randy,259,219,478,32,18,Player A
963,Randy,220,215,435,22,29,Player A
964,Randy,246,196,442,26,28,Player A
965,Randy,221,251,472,26,18,Randy
966,Randy,261,211,472,26,18,Player A
967,Randy,226,221,447,22,25,Player A
968,Randy,226,236,462,28,22,Randy
969,Randy,225,230,455,24,23,Randy
970,Randy,235,220,455,33,26,Player A
971,Randy,230,230,460,26,22,Tie
972,Randy,231,236,467,27,20,Randy
973,Randy,205,255,460,29,23,Randy
974,Randy,245,220,465,28,21,Player A
975,Randy,260,200,460,29,23,Player A
976,Randy,227,227,454,26,24,Tie
977,Randy,229,249,478,35,19,Randy
978,Randy,241,221,462,31,23,Player A
979,Randy,210,250,460,26,22,Randy
980,Randy,210,220,430,23,31,Randy
981,Randy,215,225,440,21,27,Randy
982,Randy,252,207,459,28,23,Player A
983,Randy,235,210,445,23,26,Player A
984,Randy,159,269,428,18,30,Randy
985,Randy,251,186,437,24,29,Player A
986,Randy,229,204,433,23,30,Player A
987,Randy,194,244,438,28,30,Randy
988,Randy,204,234,438,22,28,Randy
989,Randy,235,230,465,28,21,Player A
990,Randy,191,241,432,22,30,Randy
991,Randy,240,215,455,27,24,Player A
992,Randy,212,217,429,19,30,Randy
993,Randy,207,252,459,28,23,Randy
994,Randy,222,212,434,21,29,Player A
995,Randy,255,190,445,20,25,Player A
996,Randy,220,220,440,21,27,Tie
997,Randy,256,191,447,25,26,Player A
998,Randy,274,204,478,35,19,Player A
999,Randy,195,230,425,24,33,Randy
1000,Randy,240,170,410,21,37,Player A
1001,Randy,239,229,468,25,19,Player A
1002,Randy,235,220,455,24,23,Player A
1003,Randy,245,180,425,15,30,Player A
1004,Randy,242,217,459,22,21,Player A
1005,Randy,242,197,439,29,30,Player A
1006,Randy,256,201,457,26,23,Player A
1007,Randy,238,203,441,28,29,Player A
1008,Randy,204,209,413,18,35,Randy
1009,Randy,224,234,458,24,22,Randy
1010,Randy,239,229,468,34,22,Player A
1011,Randy,199,239,438,28,30,Randy
1012,Randy,237,252,489,34,15,Randy
1013,Randy,209,234,443,21,26,Randy
1014,Randy,201,226,427,23,32,Randy
1015,Randy,219,224,443,30,29,Randy
1016,Randy,230,220,450,28,26,Player A
1017,Randy,197,247,444,28,28,Randy
1018,Randy,261,206,467,27,20,Player A
1019,Randy,236,226,462,28,22,Player A
1020,Randy,218,228,446,21,25,Randy
1021,Randy,265,195,460,23,21,Player A
1022,Randy,205,225,430,23,31,Randy
1023,Randy,224,224,448,29,27,Tie
1024,Randy,208,258,466,32,22,Randy
1025,Randy,246,216,462,25,21,Player A
1026,Randy,270,210,480,31,17,Player A
1027,Randy,246,236,482,33,17,Player A
1028,Randy,213,248,461,27,22,Randy
1029,Randy,227,242,469,32,21,Randy
1030,Randy,242,202,444,22,26,Player A
1031,Randy,227,242,469,26,19,Randy
1032,Randy,234,209,443,27,28,Player A
1033,Randy,224,249,473,27,18,Randy
1034,Randy,224,239,463,38,25,Randy
1035,Randy,196,246,442,14,24,Randy
1036,Randy,252,202,454,26,24,Player A
1037,Randy,199,249,448,26,26,Randy
1038,Randy,212,247,459,31,24,Randy
1039,Randy,224,199,423,25,34,Player A
1040,Randy,231,216,447,19,24,Player A
1041,Randy,227,222,449,24,25,Player A
1042,Randy,233,233,466,26,20,Tie
1043,Randy,193,263,456,25,23,Randy
1044,Randy,253,188,441,19,26,Player A
1045,Randy,217,237,454,29,25,Randy
1046,Randy,220,235,455,27,24,Randy
1047,Randy,223,218,441,28,29,Player A
1048,Randy,229,229,458,27,23,Tie
1049,Randy,222,247,469,29,20,Randy
1050,Randy,207,252,459,25,22,Randy
1051,Randy,211,231,442,23,27,Randy
1052,Randy,219,249,468,25,19,Randy
1053,Randy,224,224,448,29,27,Tie
1054,Randy,210,230,440,30,30,Randy
1055,Randy,265,230,495,34,13,Player A
1056,Randy,232,217,449,30,27,Player A
1057,Randy,235,210,445,26,27,Player A
1058,Randy,238,223,461,24,21,Player A
1059,Randy,195,230,425,15,30,Randy
1060,Randy,240,230,470,24,18,Player A
1061,Randy,257,207,464,30,22,Player A
1062,Randy,243,198,441,28,29,Player A
1063,Randy,242,222,464,30,22,Player A
1064,Randy,220,240,460,32,24,Randy
1065,Randy,209,239,448,23,25,Randy
1066,Randy,236,221,457,29,24,Player A
1067,Randy,234,229,463,26,21,Player A
1068,Randy,221,221,442,23,27,Tie
1069,Randy,212,217,429,22,31,Randy
1070,Randy,207,242,449,21,24,Randy
1071,Randy,225,220,445,26,27,Player A
