Game,Opponent,PlayerA_Score,PlayerB_Score,Cumulative_Score,CCs,DDs,Winner
0,QLearningPlayer,222,222,444,28,28,Tie
1,QLearningPlayer,255,215,470,27,19,Player A
2,QLearningPlayer,231,221,452,27,25,Player A
3,QLearningPlayer,219,229,448,23,25,QLearningPlayer
4,QLearningPlayer,228,228,456,22,22,Tie
5,QLearningPlayer,240,215,455,30,25,Player A
6,QLearningPlayer,192,237,429,22,31,QLearningPlayer
7,QLearningPlayer,250,215,465,28,21,Player A
8,QLearningPlayer,231,221,452,27,25,Player A
9,QLearningPlayer,226,226,452,24,24,Tie
10,QLearningPlayer,203,233,436,23,29,QLearningPlayer
11,QLearningPlayer,258,218,476,24,16,Player A
12,QLearningPlayer,210,230,440,24,28,QLearningPlayer
13,QLearningPlayer,247,222,469,23,18,Player A
14,QLearningPlayer,238,218,456,28,24,Player A
15,QLearningPlayer,212,227,439,26,29,QLearningPlayer
16,QLearningPlayer,205,235,440,21,27,QLearningPlayer
17,QLearningPlayer,199,234,433,23,30,QLearningPlayer
18,QLearningPlayer,233,228,461,21,20,Player A
19,QLearningPlayer,241,221,462,25,21,Player A
20,QLearningPlayer,217,232,449,21,24,QLearningPlayer
21,QLearningPlayer,225,225,450,25,25,Tie
22,QLearningPlayer,233,218,451,29,26,Player A
23,QLearningPlayer,223,228,451,23,24,QLearningPlayer
24,QLearningPlayer,212,232,444,22,26,QLearningPlayer
25,QLearningPlayer,228,218,446,30,28,Player A
26,QLearningPlayer,228,218,446,30,28,Player A
27,QLearningPlayer,239,224,463,23,20,Player A
28,QLearningPlayer,231,226,457,23,22,Player A
29,QLearningPlayer,206,226,432,28,32,QLearningPlayer
30,QLearningPlayer,264,204,468,34,22,Player A
31,QLearningPlayer,229,224,453,25,24,Player A
32,QLearningPlayer,238,223,461,24,21,Player A
33,QLearningPlayer,248,223,471,22,17,Player A
34,QLearningPlayer,213,238,451,17,22,QLearningPlayer
35,QLearningPlayer,214,229,443,24,27,QLearningPlayer
36,QLearningPlayer,217,217,434,33,33,Tie
37,QLearningPlayer,222,227,449,24,25,QLearningPlayer
38,QLearningPlayer,224,229,453,22,23,QLearningPlayer
39,QLearningPlayer,214,229,443,24,27,QLearningPlayer
40,QLearningPlayer,208,233,441,22,27,QLearningPlayer
41,QLearningPlayer,223,223,446,27,27,Tie
42,QLearningPlayer,206,231,437,24,29,QLearningPlayer
43,QLearningPlayer,224,224,448,26,26,Tie
44,QLearningPlayer,227,227,454,23,23,Tie
45,QLearningPlayer,263,203,466,35,23,Player A
46,QLearningPlayer,208,233,441,22,27,QLearningPlayer
47,QLearningPlayer,264,204,468,34,22,Player A
48,QLearningPlayer,241,216,457,29,24,Player A
49,QLearningPlayer,240,220,460,26,22,Player A
50,QLearningPlayer,216,226,442,26,28,QLearningPlayer
51,QLearningPlayer,234,224,458,24,22,Player A
52,QLearningPlayer,245,220,465,25,20,Player A
53,QLearningPlayer,223,228,451,23,24,QLearningPlayer
54,QLearningPlayer,231,226,457,23,22,Player A
55,QLearningPlayer,243,213,456,31,25,Player A
56,QLearningPlayer,269,209,478,29,17,Player A
57,QLearningPlayer,204,229,433,26,31,QLearningPlayer
58,QLearningPlayer,229,224,453,25,24,Player A
59,QLearningPlayer,240,220,460,26,22,Player A
60,QLearningPlayer,228,223,451,26,25,Player A
61,QLearningPlayer,238,218,456,28,24,Player A
62,QLearningPlayer,204,239,443,18,25,QLearningPlayer
63,QLearningPlayer,229,219,448,29,27,Player A
64,QLearningPlayer,221,226,447,25,26,QLearningPlayer
65,QLearningPlayer,219,229,448,23,25,QLearningPlayer
66,QLearningPlayer,227,227,454,23,23,Tie
67,QLearningPlayer,210,235,445,20,25,QLearningPlayer
68,QLearningPlayer,208,238,446,18,24,QLearningPlayer
69,QLearningPlayer,202,227,429,28,33,QLearningPlayer
70,QLearningPlayer,236,221,457,26,23,Player A
71,QLearningPlayer,195,235,430,23,31,QLearningPlayer
72,QLearningPlayer,223,223,446,27,27,Tie
73,QLearningPlayer,222,227,449,24,25,QLearningPlayer
74,QLearningPlayer,247,222,469,23,18,Player A
75,QLearningPlayer,198,238,436,20,28,QLearningPlayer
76,QLearningPlayer,243,218,461,27,22,Player A
77,QLearningPlayer,229,224,453,25,24,Player A
78,QLearningPlayer,219,229,448,23,25,QLearningPlayer
79,QLearningPlayer,191,236,427,23,32,QLearningPlayer
80,QLearningPlayer,238,218,456,28,24,Player A
81,QLearningPlayer,195,240,435,19,28,QLearningPlayer
82,QLearningPlayer,220,230,450,22,24,QLearningPlayer
83,QLearningPlayer,231,221,452,27,25,Player A
84,QLearningPlayer,263,208,471,31,20,Player A
85,QLearningPlayer,236,226,462,22,20,Player A
86,QLearningPlayer,206,231,437,24,29,QLearningPlayer
87,QLearningPlayer,238,223,461,24,21,Player A
88,QLearningPlayer,199,239,438,19,27,QLearningPlayer
89,QLearningPlayer,232,222,454,26,24,Player A
90,QLearningPlayer,241,221,462,25,21,Player A
91,QLearningPlayer,215,225,440,27,29,QLearningPlayer
92,QLearningPlayer,242,217,459,28,23,Player A
93,QLearningPlayer,227,227,454,23,23,Tie
94,QLearningPlayer,245,215,460,29,23,Player A
95,QLearningPlayer,257,212,469,29,20,Player A
96,QLearningPlayer,195,230,425,27,34,QLearningPlayer
97,QLearningPlayer,208,233,441,22,27,QLearningPlayer
98,QLearningPlayer,230,225,455,24,23,Player A
99,QLearningPlayer,242,212,454,32,26,Player A
100,QLearningPlayer,224,224,448,26,26,Tie
101,QLearningPlayer,230,225,455,24,23,Player A
102,QLearningPlayer,214,234,448,20,24,QLearningPlayer
103,QLearningPlayer,227,222,449,27,26,Player A
104,QLearningPlayer,247,217,464,27,21,Player A
105,QLearningPlayer,221,221,442,29,29,Tie
106,QLearningPlayer,187,237,424,23,33,QLearningPlayer
107,QLearningPlayer,197,242,439,17,26,QLearningPlayer
108,QLearningPlayer,235,220,455,27,24,Player A
109,QLearningPlayer,208,238,446,18,24,QLearningPlayer
110,QLearningPlayer,236,221,457,26,23,Player A
111,QLearningPlayer,254,214,468,28,20,Player A
112,QLearningPlayer,208,233,441,22,27,QLearningPlayer
113,QLearningPlayer,196,236,432,22,30,QLearningPlayer
114,QLearningPlayer,248,218,466,26,20,Player A
115,QLearningPlayer,236,226,462,22,20,Player A
116,QLearningPlayer,232,222,454,26,24,Player A
117,QLearningPlayer,215,225,440,27,29,QLearningPlayer
118,QLearningPlayer,241,216,457,29,24,Player A
119,QLearningPlayer,247,217,464,27,21,Player A
120,QLearningPlayer,200,230,430,26,32,QLearningPlayer
121,QLearningPlayer,215,225,440,27,29,QLearningPlayer
122,QLearningPlayer,246,216,462,28,22,Player A
123,QLearningPlayer,212,232,444,22,26,QLearningPlayer
124,QLearningPlayer,206,231,437,24,29,QLearningPlayer
125,QLearningPlayer,230,220,450,28,26,Player A
126,QLearningPlayer,211,231,442,23,27,QLearningPlayer
127,QLearningPlayer,215,230,445,23,26,QLearningPlayer
128,QLearningPlayer,204,234,438,22,28,QLearningPlayer
129,QLearningPlayer,234,224,458,24,22,Player A
130,QLearningPlayer,220,230,450,22,24,QLearningPlayer
131,QLearningPlayer,233,223,456,25,23,Player A
132,QLearningPlayer,190,235,425,24,33,QLearningPlayer
133,QLearningPlayer,257,212,469,29,20,Player A
134,QLearningPlayer,224,219,443,30,29,Player A
135,QLearningPlayer,232,222,454,26,24,Player A
136,QLearningPlayer,231,226,457,23,22,Player A
137,QLearningPlayer,216,236,452,18,22,QLearningPlayer
138,QLearningPlayer,224,224,448,26,26,Tie
139,QLearningPlayer,216,231,447,22,25,QLearningPlayer
140,QLearningPlayer,221,226,447,25,26,QLearningPlayer
141,QLearningPlayer,261,211,472,29,19,Player A
142,QLearningPlayer,241,216,457,29,24,Player A
143,QLearningPlayer,204,229,433,26,31,QLearningPlayer
144,QLearningPlayer,197,232,429,25,32,QLearningPlayer
145,QLearningPlayer,215,230,445,23,26,QLearningPlayer
146,QLearningPlayer,250,215,465,28,21,Player A
147,QLearningPlayer,254,214,468,28,20,Player A
148,QLearningPlayer,217,232,449,21,24,QLearningPlayer
149,QLearningPlayer,239,219,458,27,23,Player A
150,QLearningPlayer,234,224,458,24,22,Player A
151,QLearningPlayer,234,219,453,28,25,Player A
152,QLearningPlayer,217,227,444,25,27,QLearningPlayer
153,QLearningPlayer,235,225,460,23,21,Player A
154,QLearningPlayer,231,221,452,27,25,Player A
155,QLearningPlayer,228,223,451,26,25,Player A
156,QLearningPlayer,219,234,453,19,22,QLearningPlayer
157,QLearningPlayer,252,212,464,30,22,Player A
158,QLearningPlayer,242,217,459,28,23,Player A
159,QLearningPlayer,218,228,446,24,26,QLearningPlayer
160,QLearningPlayer,241,221,462,25,21,Player A
161,QLearningPlayer,219,229,448,23,25,QLearningPlayer
162,QLearningPlayer,228,223,451,26,25,Player A
163,QLearningPlayer,222,227,449,24,25,QLearningPlayer
164,QLearningPlayer,240,220,460,26,22,Player A
165,QLearningPlayer,228,223,451,26,25,Player A
166,QLearningPlayer,214,229,443,24,27,QLearningPlayer
167,QLearningPlayer,202,237,439,20,27,QLearningPlayer
168,QLearningPlayer,190,235,425,24,33,QLearningPlayer
169,QLearningPlayer,231,221,452,27,25,Player A
170,QLearningPlayer,217,232,449,21,24,QLearningPlayer
171,QLearningPlayer,243,218,461,27,22,Player A
172,QLearningPlayer,224,224,448,26,26,Tie
173,QLearningPlayer,237,217,454,29,25,Player A
174,QLearningPlayer,216,231,447,22,25,QLearningPlayer
175,QLearningPlayer,243,223,466,23,19,Player A
176,QLearningPlayer,242,212,454,32,26,Player A
177,QLearningPlayer,218,228,446,24,26,QLearningPlayer
178,QLearningPlayer,230,225,455,24,23,Player A
179,QLearningPlayer,211,236,447,19,24,QLearningPlayer
180,QLearningPlayer,211,231,442,23,27,QLearningPlayer
181,QLearningPlayer,191,241,432,19,29,QLearningPlayer
182,QLearningPlayer,231,226,457,23,22,Player A
183,QLearningPlayer,251,211,462,31,23,Player A
184,QLearningPlayer,223,228,451,23,24,QLearningPlayer
185,QLearningPlayer,239,219,458,27,23,Player A
186,QLearningPlayer,193,238,431,21,30,QLearningPlayer
187,QLearningPlayer,208,238,446,18,24,QLearningPlayer
188,QLearningPlayer,209,229,438,25,29,QLearningPlayer
189,QLearningPlayer,208,233,441,22,27,QLearningPlayer
190,QLearningPlayer,242,217,459,28,23,Player A
191,QLearningPlayer,197,232,429,25,32,QLearningPlayer
192,QLearningPlayer,239,219,458,27,23,Player A
193,QLearningPlayer,259,209,468,31,21,Player A
194,QLearningPlayer,202,237,439,20,27,QLearningPlayer
195,QLearningPlayer,211,231,442,23,27,QLearningPlayer
196,QLearningPlayer,215,230,445,23,26,QLearningPlayer
197,QLearningPlayer,194,234,428,24,32,QLearningPlayer
198,QLearningPlayer,229,219,448,29,27,Player A
199,QLearningPlayer,205,235,440,21,27,QLearningPlayer
200,QLearningPlayer,234,224,458,24,22,Player A
201,QLearningPlayer,197,237,434,21,29,QLearningPlayer
202,QLearningPlayer,229,219,448,29,27,Player A
203,QLearningPlayer,204,234,438,22,28,QLearningPlayer
204,QLearningPlayer,213,228,441,25,28,QLearningPlayer
205,QLearningPlayer,229,224,453,25,24,Player A
206,QLearningPlayer,216,231,447,22,25,QLearningPlayer
207,QLearningPlayer,227,217,444,31,29,Player A
208,QLearningPlayer,203,228,431,27,32,QLearningPlayer
209,QLearningPlayer,224,229,453,22,23,QLearningPlayer
210,QLearningPlayer,243,223,466,23,19,Player A
211,QLearningPlayer,246,216,462,28,22,Player A
212,QLearningPlayer,246,216,462,28,22,Player A
213,QLearningPlayer,219,219,438,31,31,Tie
214,QLearningPlayer,212,232,444,22,26,QLearningPlayer
215,QLearningPlayer,218,228,446,24,26,QLearningPlayer
216,QLearningPlayer,238,218,456,28,24,Player A
217,QLearningPlayer,225,225,450,25,25,Tie
218,QLearningPlayer,184,239,423,22,33,QLearningPlayer
219,QLearningPlayer,196,241,437,18,27,QLearningPlayer
220,QLearningPlayer,250,210,460,32,24,Player A
221,QLearningPlayer,234,219,453,28,25,Player A
222,QLearningPlayer,198,233,431,24,31,QLearningPlayer
223,QLearningPlayer,238,218,456,28,24,Player A
224,QLearningPlayer,227,222,449,27,26,Player A
225,QLearningPlayer,248,213,461,30,23,Player A
226,QLearningPlayer,240,215,455,30,25,Player A
227,QLearningPlayer,253,213,466,29,21,Player A
228,QLearningPlayer,240,220,460,26,22,Player A
229,QLearningPlayer,226,226,452,24,24,Tie
230,QLearningPlayer,221,231,452,21,23,QLearningPlayer
231,QLearningPlayer,266,206,472,32,20,Player A
232,QLearningPlayer,185,240,425,21,32,QLearningPlayer
233,QLearningPlayer,226,226,452,24,24,Tie
234,QLearningPlayer,209,234,443,21,26,QLearningPlayer
235,QLearningPlayer,239,214,453,31,26,Player A
236,QLearningPlayer,236,226,462,22,20,Player A
237,QLearningPlayer,240,220,460,26,22,Player A
238,QLearningPlayer,227,227,454,23,23,Tie
239,QLearningPlayer,222,227,449,24,25,QLearningPlayer
240,QLearningPlayer,215,225,440,27,29,QLearningPlayer
241,QLearningPlayer,210,240,450,16,22,QLearningPlayer
242,QLearningPlayer,262,207,469,32,21,Player A
243,QLearningPlayer,217,227,444,25,27,QLearningPlayer
244,QLearningPlayer,226,226,452,24,24,Tie
245,QLearningPlayer,243,223,466,23,19,Player A
246,QLearningPlayer,194,239,433,20,29,QLearningPlayer
247,QLearningPlayer,225,225,450,25,25,Tie
248,QLearningPlayer,221,226,447,25,26,QLearningPlayer
249,QLearningPlayer,249,214,463,29,22,Player A
250,QLearningPlayer,208,228,436,26,30,QLearningPlayer
251,QLearningPlayer,249,214,463,29,22,Player A
252,QLearningPlayer,266,211,477,28,17,Player A
253,QLearningPlayer,226,231,457,20,21,QLearningPlayer
254,QLearningPlayer,260,210,470,30,20,Player A
255,QLearningPlayer,240,210,450,34,28,Player A
256,QLearningPlayer,222,232,454,20,22,QLearningPlayer
257,QLearningPlayer,208,228,436,26,30,QLearningPlayer
258,QLearningPlayer,229,234,463,17,18,QLearningPlayer
259,QLearningPlayer,244,214,458,30,24,Player A
260,QLearningPlayer,228,218,446,30,28,Player A
261,QLearningPlayer,217,227,444,25,27,QLearningPlayer
262,QLearningPlayer,229,224,453,25,24,Player A
263,QLearningPlayer,226,226,452,24,24,Tie
264,QLearningPlayer,214,229,443,24,27,QLearningPlayer
265,QLearningPlayer,221,226,447,25,26,QLearningPlayer
266,QLearningPlayer,270,205,475,32,19,Player A
267,QLearningPlayer,247,212,459,31,24,Player A
268,QLearningPlayer,211,231,442,23,27,QLearningPlayer
269,QLearningPlayer,214,234,448,20,24,QLearningPlayer
270,QLearningPlayer,215,235,450,19,23,QLearningPlayer
271,QLearningPlayer,228,223,451,26,25,Player A
272,QLearningPlayer,214,234,448,20,24,QLearningPlayer
273,QLearningPlayer,195,240,435,19,28,QLearningPlayer
274,QLearningPlayer,217,232,449,21,24,QLearningPlayer
275,QLearningPlayer,233,223,456,25,23,Player A
276,QLearningPlayer,218,233,451,20,23,QLearningPlayer
277,QLearningPlayer,196,236,432,22,30,QLearningPlayer
278,QLearningPlayer,216,226,442,26,28,QLearningPlayer
279,QLearningPlayer,202,232,434,24,30,QLearningPlayer
280,QLearningPlayer,244,219,463,26,21,Player A
281,QLearningPlayer,236,221,457,26,23,Player A
282,QLearningPlayer,214,229,443,24,27,QLearningPlayer
283,QLearningPlayer,222,222,444,28,28,Tie
284,QLearningPlayer,227,227,454,23,23,Tie
285,QLearningPlayer,244,224,468,22,18,Player A
286,QLearningPlayer,244,214,458,30,24,Player A
287,QLearningPlayer,254,209,463,32,23,Player A
288,QLearningPlayer,233,223,456,25,23,Player A
289,QLearningPlayer,201,236,437,21,28,QLearningPlayer
290,QLearningPlayer,224,224,448,26,26,Tie
291,QLearningPlayer,244,224,468,22,18,Player A
292,QLearningPlayer,226,226,452,24,24,Tie
293,QLearningPlayer,234,219,453,28,25,Player A
294,QLearningPlayer,216,231,447,22,25,QLearningPlayer
295,QLearningPlayer,217,227,444,25,27,QLearningPlayer
296,QLearningPlayer,201,236,437,21,28,QLearningPlayer
297,QLearningPlayer,224,229,453,22,23,QLearningPlayer
298,QLearningPlayer,269,209,478,29,17,Player A
299,QLearningPlayer,221,221,442,29,29,Tie
300,QLearningPlayer,240,225,465,22,19,Player A
301,QLearningPlayer,210,230,440,24,28,QLearningPlayer
302,QLearningPlayer,225,220,445,29,28,Player A
303,QLearningPlayer,244,219,463,26,21,Player A
304,QLearningPlayer,236,221,457,26,23,Player A
305,QLearningPlayer,231,216,447,31,28,Player A
306,QLearningPlayer,206,236,442,20,26,QLearningPlayer
307,QLearningPlayer,219,229,448,23,25,QLearningPlayer
308,QLearningPlayer,236,221,457,26,23,Player A
309,QLearningPlayer,266,206,472,32,20,Player A
310,QLearningPlayer,241,221,462,25,21,Player A
311,QLearningPlayer,218,228,446,24,26,QLearningPlayer
312,QLearningPlayer,194,239,433,20,29,QLearningPlayer
313,QLearningPlayer,222,222,444,28,28,Tie
314,QLearningPlayer,217,227,444,25,27,QLearningPlayer
315,QLearningPlayer,202,232,434,24,30,QLearningPlayer
316,QLearningPlayer,227,227,454,23,23,Tie
317,QLearningPlayer,224,229,453,22,23,QLearningPlayer
318,QLearningPlayer,233,223,456,25,23,Player A
319,QLearningPlayer,232,227,459,22,21,Player A
320,QLearningPlayer,221,221,442,29,29,Tie
321,QLearningPlayer,220,230,450,22,24,QLearningPlayer
322,QLearningPlayer,223,228,451,23,24,QLearningPlayer
323,QLearningPlayer,244,214,458,30,24,Player A
324,QLearningPlayer,221,231,452,21,23,QLearningPlayer
325,QLearningPlayer,195,235,430,23,31,QLearningPlayer
326,QLearningPlayer,237,217,454,29,25,Player A
327,QLearningPlayer,221,226,447,25,26,QLearningPlayer
328,QLearningPlayer,230,225,455,24,23,Player A
329,QLearningPlayer,247,217,464,27,21,Player A
330,QLearningPlayer,241,216,457,29,24,Player A
331,QLearningPlayer,259,214,473,27,18,Player A
332,QLearningPlayer,211,231,442,23,27,QLearningPlayer
333,QLearningPlayer,235,220,455,27,24,Player A
334,QLearningPlayer,242,217,459,28,23,Player A
335,QLearningPlayer,242,217,459,28,23,Player A
336,QLearningPlayer,228,228,456,22,22,Tie
337,QLearningPlayer,225,225,450,25,25,Tie
338,QLearningPlayer,232,217,449,30,27,Player A
339,QLearningPlayer,239,219,458,27,23,Player A
340,QLearningPlayer,244,219,463,26,21,Player A
341,QLearningPlayer,204,234,438,22,28,QLearningPlayer
342,QLearningPlayer,216,231,447,22,25,QLearningPlayer
343,QLearningPlayer,251,216,467,27,20,Player A
344,QLearningPlayer,230,225,455,24,23,Player A
345,QLearningPlayer,222,222,444,28,28,Tie
346,QLearningPlayer,224,224,448,26,26,Tie
347,QLearningPlayer,237,217,454,29,25,Player A
348,QLearningPlayer,217,227,444,25,27,QLearningPlayer
349,QLearningPlayer,224,229,453,22,23,QLearningPlayer
350,QLearningPlayer,221,221,442,29,29,Tie
351,QLearningPlayer,186,241,427,20,31,QLearningPlayer
352,QLearningPlayer,227,217,444,31,29,Player A
353,QLearningPlayer,222,232,454,20,22,QLearningPlayer
354,QLearningPlayer,226,226,452,24,24,Tie
355,QLearningPlayer,218,233,451,20,23,QLearningPlayer
356,QLearningPlayer,238,223,461,24,21,Player A
357,QLearningPlayer,219,224,443,27,28,QLearningPlayer
358,QLearningPlayer,215,235,450,19,23,QLearningPlayer
359,QLearningPlayer,240,215,455,30,25,Player A
360,QLearningPlayer,256,216,472,26,18,Player A
361,QLearningPlayer,231,226,457,23,22,Player A
362,QLearningPlayer,204,234,438,22,28,QLearningPlayer
363,QLearningPlayer,227,222,449,27,26,Player A
364,QLearningPlayer,272,207,479,30,17,Player A
365,QLearningPlayer,227,222,449,27,26,Player A
366,QLearningPlayer,270,205,475,32,19,Player A
367,QLearningPlayer,210,230,440,24,28,QLearningPlayer
368,QLearningPlayer,204,229,433,26,31,QLearningPlayer
369,QLearningPlayer,221,231,452,21,23,QLearningPlayer
370,QLearningPlayer,210,230,440,24,28,QLearningPlayer
371,QLearningPlayer,204,234,438,22,28,QLearningPlayer
372,QLearningPlayer,219,224,443,27,28,QLearningPlayer
373,QLearningPlayer,224,229,453,22,23,QLearningPlayer
374,QLearningPlayer,213,228,441,25,28,QLearningPlayer
375,QLearningPlayer,208,228,436,26,30,QLearningPlayer
376,QLearningPlayer,231,221,452,27,25,Player A
377,QLearningPlayer,273,208,481,29,16,Player A
378,QLearningPlayer,223,223,446,27,27,Tie
379,QLearningPlayer,216,231,447,22,25,QLearningPlayer
380,QLearningPlayer,236,216,452,30,26,Player A
381,QLearningPlayer,242,217,459,28,23,Player A
382,QLearningPlayer,211,231,442,23,27,QLearningPlayer
383,QLearningPlayer,222,227,449,24,25,QLearningPlayer
384,QLearningPlayer,239,224,463,23,20,Player A
385,QLearningPlayer,244,214,458,30,24,Player A
386,QLearningPlayer,213,228,441,25,28,QLearningPlayer
387,QLearningPlayer,221,221,442,29,29,Tie
388,QLearningPlayer,209,229,438,25,29,QLearningPlayer
389,QLearningPlayer,208,243,451,14,21,QLearningPlayer
390,QLearningPlayer,240,220,460,26,22,Player A
391,QLearningPlayer,223,223,446,27,27,Tie
392,QLearningPlayer,250,215,465,28,21,Player A
393,QLearningPlayer,226,226,452,24,24,Tie
394,QLearningPlayer,232,222,454,26,24,Player A
395,QLearningPlayer,215,235,450,19,23,QLearningPlayer
396,QLearningPlayer,230,225,455,24,23,Player A
397,QLearningPlayer,232,217,449,30,27,Player A
398,QLearningPlayer,253,223,476,21,15,Player A
399,QLearningPlayer,246,211,457,32,25,Player A
400,QLearningPlayer,237,222,459,25,22,Player A
401,QLearningPlayer,224,219,443,30,29,Player A
402,QLearningPlayer,189,239,428,21,31,QLearningPlayer
403,QLearningPlayer,217,227,444,25,27,QLearningPlayer
404,QLearningPlayer,237,222,459,25,22,Player A
405,QLearningPlayer,215,225,440,27,29,QLearningPlayer
406,QLearningPlayer,208,228,436,26,30,QLearningPlayer
407,QLearningPlayer,228,228,456,22,22,Tie
408,QLearningPlayer,246,216,462,28,22,Player A
409,QLearningPlayer,216,231,447,22,25,QLearningPlayer
410,QLearningPlayer,198,243,441,16,25,QLearningPlayer
411,QLearningPlayer,241,211,452,33,27,Player A
412,QLearningPlayer,233,218,451,29,26,Player A
413,QLearningPlayer,226,221,447,28,27,Player A
414,QLearningPlayer,249,214,463,29,22,Player A
415,QLearningPlayer,203,233,436,23,29,QLearningPlayer
416,QLearningPlayer,206,231,437,24,29,QLearningPlayer
417,QLearningPlayer,216,231,447,22,25,QLearningPlayer
418,QLearningPlayer,235,220,455,27,24,Player A
419,QLearningPlayer,234,224,458,24,22,Player A
420,QLearningPlayer,206,226,432,28,32,QLearningPlayer
421,QLearningPlayer,210,225,435,28,31,QLearningPlayer
422,QLearningPlayer,256,211,467,30,21,Player A
423,QLearningPlayer,219,229,448,23,25,QLearningPlayer
424,QLearningPlayer,221,226,447,25,26,QLearningPlayer
425,QLearningPlayer,227,227,454,23,23,Tie
426,QLearningPlayer,220,230,450,22,24,QLearningPlayer
427,QLearningPlayer,247,217,464,27,21,Player A
428,QLearningPlayer,192,237,429,22,31,QLearningPlayer
429,QLearningPlayer,214,234,448,20,24,QLearningPlayer
430,QLearningPlayer,243,218,461,27,22,Player A
431,QLearningPlayer,221,231,452,21,23,QLearningPlayer
432,QLearningPlayer,203,233,436,23,29,QLearningPlayer
433,QLearningPlayer,235,215,450,31,27,Player A
434,QLearningPlayer,228,223,451,26,25,Player A
435,QLearningPlayer,241,226,467,21,18,Player A
436,QLearningPlayer,222,222,444,28,28,Tie
437,QLearningPlayer,206,231,437,24,29,QLearningPlayer
438,QLearningPlayer,222,222,444,28,28,Tie
439,QLearningPlayer,239,219,458,27,23,Player A
440,QLearningPlayer,216,226,442,26,28,QLearningPlayer
441,QLearningPlayer,226,226,452,24,24,Tie
442,QLearningPlayer,218,228,446,24,26,QLearningPlayer
443,QLearningPlayer,216,226,442,26,28,QLearningPlayer
444,QLearningPlayer,227,227,454,23,23,Tie
445,QLearningPlayer,214,229,443,24,27,QLearningPlayer
446,QLearningPlayer,213,228,441,25,28,QLearningPlayer
447,QLearningPlayer,211,231,442,23,27,QLearningPlayer
448,QLearningPlayer,191,246,437,15,26,QLearningPlayer
449,QLearningPlayer,232,222,454,26,24,Player A
450,QLearningPlayer,212,232,444,22,26,QLearningPlayer
451,QLearningPlayer,217,227,444,25,27,QLearningPlayer
452,QLearningPlayer,246,216,462,28,22,Player A
453,QLearningPlayer,222,227,449,24,25,QLearningPlayer
454,QLearningPlayer,219,229,448,23,25,QLearningPlayer
455,QLearningPlayer,238,228,466,20,18,Player A
456,QLearningPlayer,231,216,447,31,28,Player A
457,QLearningPlayer,217,227,444,25,27,QLearningPlayer
458,QLearningPlayer,252,217,469,26,19,Player A
459,QLearningPlayer,227,222,449,27,26,Player A
460,QLearningPlayer,213,228,441,25,28,QLearningPlayer
461,QLearningPlayer,224,229,453,22,23,QLearningPlayer
462,QLearningPlayer,243,223,466,23,19,Player A
463,QLearningPlayer,239,219,458,27,23,Player A
464,QLearningPlayer,202,232,434,24,30,QLearningPlayer
465,QLearningPlayer,251,216,467,27,20,Player A
466,QLearningPlayer,180,240,420,22,34,QLearningPlayer
467,QLearningPlayer,250,220,470,24,18,Player A
468,QLearningPlayer,219,229,448,23,25,QLearningPlayer
469,QLearningPlayer,232,227,459,22,21,Player A
470,QLearningPlayer,229,224,453,25,24,Player A
471,QLearningPlayer,234,224,458,24,22,Player A
472,QLearningPlayer,218,228,446,24,26,QLearningPlayer
473,QLearningPlayer,219,229,448,23,25,QLearningPlayer
474,QLearningPlayer,194,239,433,20,29,QLearningPlayer
475,QLearningPlayer,232,217,449,30,27,Player A
476,QLearningPlayer,222,227,449,24,25,QLearningPlayer
477,QLearningPlayer,245,215,460,29,23,Player A
478,QLearningPlayer,269,209,478,29,17,Player A
479,QLearningPlayer,252,212,464,30,22,Player A
480,QLearningPlayer,247,222,469,23,18,Player A
0,PatternLearningPlayer,212,197,409,50,47,Player A
1,PatternLearningPlayer,204,199,403,50,49,Player A
2,PatternLearningPlayer,208,198,406,50,48,Player A
3,PatternLearningPlayer,205,200,405,49,48,Player A
4,PatternLearningPlayer,212,197,409,50,47,Player A
5,PatternLearningPlayer,208,198,406,50,48,Player A
6,PatternLearningPlayer,205,200,405,49,48,Player A
7,PatternLearningPlayer,204,199,403,50,49,Player A
8,PatternLearningPlayer,208,198,406,50,48,Player A
9,PatternLearningPlayer,201,201,402,49,49,Tie
10,PatternLearningPlayer,208,198,406,50,48,Player A
11,PatternLearningPlayer,209,199,408,49,47,Player A
12,PatternLearningPlayer,212,197,409,50,47,Player A
13,PatternLearningPlayer,208,198,406,50,48,Player A
14,PatternLearningPlayer,205,200,405,49,48,Player A
15,PatternLearningPlayer,205,200,405,49,48,Player A
16,PatternLearningPlayer,212,197,409,50,47,Player A
17,PatternLearningPlayer,204,199,403,50,49,Player A
18,PatternLearningPlayer,204,199,403,50,49,Player A
19,PatternLearningPlayer,205,200,405,49,48,Player A
20,PatternLearningPlayer,205,200,405,49,48,Player A
21,PatternLearningPlayer,212,197,409,50,47,Player A
0,TitForTat,250,250,500,0,0,Tie
1,TitForTat,250,250,500,0,0,Tie
2,TitForTat,250,250,500,0,0,Tie
3,TitForTat,250,250,500,0,0,Tie
4,TitForTat,250,250,500,0,0,Tie
5,TitForTat,250,250,500,0,0,Tie
6,TitForTat,250,250,500,0,0,Tie
7,TitForTat,250,250,500,0,0,Tie
8,TitForTat,250,250,500,0,0,Tie
9,TitForTat,250,250,500,0,0,Tie
10,TitForTat,250,250,500,0,0,Tie
0,Bayesian,232,227,459,22,21,Player A
1,Bayesian,209,234,443,21,26,Bayesian
2,Bayesian,259,209,468,31,21,Player A
3,Bayesian,229,224,453,25,24,Player A
4,Bayesian,210,230,440,24,28,Bayesian
5,Bayesian,239,214,453,31,26,Player A
6,Bayesian,258,213,471,28,19,Player A
7,Bayesian,234,224,458,24,22,Player A
8,Bayesian,228,228,456,22,22,Tie
9,Bayesian,232,222,454,26,24,Player A
10,Bayesian,218,228,446,24,26,Bayesian
11,Bayesian,235,220,455,27,24,Player A
12,Bayesian,205,235,440,21,27,Bayesian
13,Bayesian,261,206,467,33,22,Player A
14,Bayesian,217,227,444,25,27,Bayesian
15,Bayesian,213,233,446,21,25,Bayesian
16,Bayesian,220,225,445,26,27,Bayesian
17,Bayesian,233,223,456,25,23,Player A
18,Bayesian,243,223,466,23,19,Player A
19,Bayesian,216,226,442,26,28,Bayesian
20,Bayesian,199,239,438,19,27,Bayesian
21,Bayesian,237,222,459,25,22,Player A
22,Bayesian,233,218,451,29,26,Player A
23,Bayesian,208,233,441,22,27,Bayesian
24,Bayesian,209,239,448,17,23,Bayesian
25,Bayesian,229,219,448,29,27,Player A
26,Bayesian,229,224,453,25,24,Player A
27,Bayesian,239,219,458,27,23,Player A
28,Bayesian,236,221,457,26,23,Player A
29,Bayesian,208,228,436,26,30,Bayesian
30,Bayesian,240,220,460,26,22,Player A
31,Bayesian,267,207,474,31,19,Player A
32,Bayesian,227,227,454,23,23,Tie
33,Bayesian,245,215,460,29,23,Player A
34,Bayesian,230,225,455,24,23,Player A
35,Bayesian,218,228,446,24,26,Bayesian
36,Bayesian,254,209,463,32,23,Player A
37,Bayesian,210,230,440,24,28,Bayesian
38,Bayesian,208,228,436,26,30,Bayesian
39,Bayesian,210,240,450,16,22,Bayesian
40,Bayesian,180,245,425,18,31,Bayesian
41,Bayesian,224,229,453,22,23,Bayesian
42,Bayesian,222,222,444,28,28,Tie
43,Bayesian,223,223,446,27,27,Tie
44,Bayesian,260,215,475,26,17,Player A
45,Bayesian,224,229,453,22,23,Bayesian
46,Bayesian,252,212,464,30,22,Player A
47,Bayesian,224,224,448,26,26,Tie
48,Bayesian,254,214,468,28,20,Player A
49,Bayesian,256,211,467,30,21,Player A
50,Bayesian,182,237,419,24,35,Bayesian
51,Bayesian,206,231,437,24,29,Bayesian
52,Bayesian,210,235,445,20,25,Bayesian
53,Bayesian,217,227,444,25,27,Bayesian
54,Bayesian,185,235,420,25,35,Bayesian
55,Bayesian,232,222,454,26,24,Player A
56,Bayesian,231,221,452,27,25,Player A
57,Bayesian,244,219,463,26,21,Player A
58,Bayesian,209,239,448,17,23,Bayesian
59,Bayesian,256,221,477,22,15,Player A
60,Bayesian,238,223,461,24,21,Player A
61,Bayesian,231,211,442,35,31,Player A
62,Bayesian,207,232,439,23,28,Bayesian
63,Bayesian,210,235,445,20,25,Bayesian
64,Bayesian,202,237,439,20,27,Bayesian
65,Bayesian,248,213,461,30,23,Player A
66,Bayesian,256,211,467,30,21,Player A
67,Bayesian,220,230,450,22,24,Bayesian
68,Bayesian,236,216,452,30,26,Player A
69,Bayesian,231,221,452,27,25,Player A
70,Bayesian,221,221,442,29,29,Tie
71,Bayesian,223,228,451,23,24,Bayesian
72,Bayesian,193,238,431,21,30,Bayesian
73,Bayesian,199,234,433,23,30,Bayesian
74,Bayesian,215,230,445,23,26,Bayesian
75,Bayesian,226,226,452,24,24,Tie
76,Bayesian,209,229,438,25,29,Bayesian
77,Bayesian,230,225,455,24,23,Player A
78,Bayesian,221,231,452,21,23,Bayesian
79,Bayesian,220,230,450,22,24,Bayesian
80,Bayesian,227,227,454,23,23,Tie
81,Bayesian,208,233,441,22,27,Bayesian
82,Bayesian,204,229,433,26,31,Bayesian
83,Bayesian,253,213,466,29,21,Player A
84,Bayesian,240,220,460,26,22,Player A
85,Bayesian,229,224,453,25,24,Player A
86,Bayesian,248,223,471,22,17,Player A
87,Bayesian,258,218,476,24,16,Player A
88,Bayesian,226,226,452,24,24,Tie
89,Bayesian,237,212,449,33,28,Player A
90,Bayesian,220,220,440,30,30,Tie
91,Bayesian,205,230,435,25,30,Bayesian
92,Bayesian,211,231,442,23,27,Bayesian
93,Bayesian,204,234,438,22,28,Bayesian
94,Bayesian,253,213,466,29,21,Player A
95,Bayesian,225,225,450,25,25,Tie
96,Bayesian,236,221,457,26,23,Player A
97,Bayesian,240,220,460,26,22,Player A
98,Bayesian,246,216,462,28,22,Player A
99,Bayesian,228,223,451,26,25,Player A
100,Bayesian,223,228,451,23,24,Bayesian
101,Bayesian,230,220,450,28,26,Player A
102,Bayesian,253,213,466,29,21,Player A
103,Bayesian,246,216,462,28,22,Player A
104,Bayesian,249,219,468,25,19,Player A
105,Bayesian,201,236,437,21,28,Bayesian
106,Bayesian,206,236,442,20,26,Bayesian
107,Bayesian,260,210,470,30,20,Player A
108,Bayesian,209,234,443,21,26,Bayesian
109,Bayesian,241,216,457,29,24,Player A
110,Bayesian,230,220,450,28,26,Player A
111,Bayesian,230,225,455,24,23,Player A
112,Bayesian,238,218,456,28,24,Player A
113,Bayesian,236,221,457,26,23,Player A
114,Bayesian,221,226,447,25,26,Bayesian
115,Bayesian,233,223,456,25,23,Player A
116,Bayesian,194,239,433,20,29,Bayesian
117,Bayesian,221,226,447,25,26,Bayesian
118,Bayesian,246,216,462,28,22,Player A
119,Bayesian,234,224,458,24,22,Player A
120,Bayesian,243,223,466,23,19,Player A
121,Bayesian,238,223,461,24,21,Player A
122,Bayesian,245,220,465,25,20,Player A
123,Bayesian,229,229,458,21,21,Tie
124,Bayesian,205,235,440,21,27,Bayesian
125,Bayesian,219,229,448,23,25,Bayesian
126,Bayesian,224,224,448,26,26,Tie
127,Bayesian,202,232,434,24,30,Bayesian
128,Bayesian,229,219,448,29,27,Player A
129,Bayesian,237,222,459,25,22,Player A
130,Bayesian,218,223,441,28,29,Bayesian
131,Bayesian,217,227,444,25,27,Bayesian
132,Bayesian,220,225,445,26,27,Bayesian
133,Bayesian,224,224,448,26,26,Tie
134,Bayesian,218,223,441,28,29,Bayesian
135,Bayesian,219,224,443,27,28,Bayesian
136,Bayesian,209,234,443,21,26,Bayesian
137,Bayesian,248,223,471,22,17,Player A
138,Bayesian,219,224,443,27,28,Bayesian
139,Bayesian,235,225,460,23,21,Player A
140,Bayesian,235,215,450,31,27,Player A
141,Bayesian,190,240,430,20,30,Bayesian
142,Bayesian,236,226,462,22,20,Player A
143,Bayesian,215,230,445,23,26,Bayesian
144,Bayesian,214,234,448,20,24,Bayesian
145,Bayesian,220,225,445,26,27,Bayesian
146,Bayesian,222,227,449,24,25,Bayesian
147,Bayesian,205,235,440,21,27,Bayesian
148,Bayesian,225,225,450,25,25,Tie
149,Bayesian,246,211,457,32,25,Player A
150,Bayesian,242,222,464,24,20,Player A
151,Bayesian,215,220,435,31,32,Bayesian
152,Bayesian,213,228,441,25,28,Bayesian
153,Bayesian,244,219,463,26,21,Player A
154,Bayesian,226,221,447,28,27,Player A
155,Bayesian,217,222,439,29,30,Bayesian
156,Bayesian,222,222,444,28,28,Tie
157,Bayesian,238,223,461,24,21,Player A
158,Bayesian,220,225,445,26,27,Bayesian
159,Bayesian,219,229,448,23,25,Bayesian
160,Bayesian,230,225,455,24,23,Player A
161,Bayesian,255,220,475,23,16,Player A
162,Bayesian,228,223,451,26,25,Player A
163,Bayesian,229,229,458,21,21,Tie
164,Bayesian,235,225,460,23,21,Player A
165,Bayesian,247,217,464,27,21,Player A
166,Bayesian,204,234,438,22,28,Bayesian
167,Bayesian,229,229,458,21,21,Tie
168,Bayesian,217,227,444,25,27,Bayesian
169,Bayesian,198,238,436,20,28,Bayesian
170,Bayesian,221,231,452,21,23,Bayesian
171,Bayesian,246,216,462,28,22,Player A
172,Bayesian,261,211,472,29,19,Player A
173,Bayesian,202,237,439,20,27,Bayesian
174,Bayesian,249,219,468,25,19,Player A
175,Bayesian,234,219,453,28,25,Player A
176,Bayesian,246,221,467,24,19,Player A
177,Bayesian,217,222,439,29,30,Bayesian
178,Bayesian,246,216,462,28,22,Player A
179,Bayesian,222,232,454,20,22,Bayesian
180,Bayesian,207,232,439,23,28,Bayesian
181,Bayesian,217,232,449,21,24,Bayesian
182,Bayesian,227,227,454,23,23,Tie
183,Bayesian,220,230,450,22,24,Bayesian
184,Bayesian,238,218,456,28,24,Player A
185,Bayesian,243,218,461,27,22,Player A
186,Bayesian,242,222,464,24,20,Player A
187,Bayesian,250,220,470,24,18,Player A
188,Bayesian,214,234,448,20,24,Bayesian
189,Bayesian,225,225,450,25,25,Tie
190,Bayesian,219,234,453,19,22,Bayesian
191,Bayesian,200,240,440,18,26,Bayesian
192,Bayesian,210,230,440,24,28,Bayesian
193,Bayesian,221,231,452,21,23,Bayesian
194,Bayesian,198,238,436,20,28,Bayesian
195,Bayesian,213,228,441,25,28,Bayesian
196,Bayesian,227,222,449,27,26,Player A
197,Bayesian,214,224,438,28,30,Bayesian
198,Bayesian,245,220,465,25,20,Player A
199,Bayesian,220,225,445,26,27,Bayesian
200,Bayesian,203,223,426,31,35,Bayesian
201,Bayesian,217,222,439,29,30,Bayesian
202,Bayesian,236,221,457,26,23,Player A
203,Bayesian,237,227,464,21,19,Player A
204,Bayesian,237,227,464,21,19,Player A
205,Bayesian,232,227,459,22,21,Player A
206,Bayesian,252,217,469,26,19,Player A
207,Bayesian,228,228,456,22,22,Tie
208,Bayesian,241,221,462,25,21,Player A
209,Bayesian,229,219,448,29,27,Player A
210,Bayesian,220,225,445,26,27,Bayesian
211,Bayesian,228,218,446,30,28,Player A
212,Bayesian,213,228,441,25,28,Bayesian
213,Bayesian,216,231,447,22,25,Bayesian
214,Bayesian,238,218,456,28,24,Player A
215,Bayesian,268,208,476,30,18,Player A
216,Bayesian,216,226,442,26,28,Bayesian
217,Bayesian,228,223,451,26,25,Player A
218,Bayesian,204,239,443,18,25,Bayesian
219,Bayesian,261,211,472,29,19,Player A
220,Bayesian,231,221,452,27,25,Player A
221,Bayesian,229,224,453,25,24,Player A
222,Bayesian,235,220,455,27,24,Player A
223,Bayesian,221,226,447,25,26,Bayesian
224,Bayesian,203,238,441,19,26,Bayesian
225,Bayesian,244,219,463,26,21,Player A
226,Bayesian,209,234,443,21,26,Bayesian
227,Bayesian,235,225,460,23,21,Player A
228,Bayesian,216,226,442,26,28,Bayesian
229,Bayesian,230,225,455,24,23,Player A
230,Bayesian,214,229,443,24,27,Bayesian
231,Bayesian,216,221,437,30,31,Bayesian
232,Bayesian,212,232,444,22,26,Bayesian
233,Bayesian,224,229,453,22,23,Bayesian
234,Bayesian,212,232,444,22,26,Bayesian
235,Bayesian,183,243,426,19,31,Bayesian
236,Bayesian,249,219,468,25,19,Player A
237,Bayesian,224,234,458,18,20,Bayesian
238,Bayesian,252,217,469,26,19,Player A
239,Bayesian,214,229,443,24,27,Bayesian
240,Bayesian,210,230,440,24,28,Bayesian
241,Bayesian,246,211,457,32,25,Player A
242,Bayesian,248,218,466,26,20,Player A
243,Bayesian,202,237,439,20,27,Bayesian
244,Bayesian,227,222,449,27,26,Player A
245,Bayesian,236,221,457,26,23,Player A
246,Bayesian,236,221,457,26,23,Player A
247,Bayesian,218,228,446,24,26,Bayesian
248,Bayesian,216,231,447,22,25,Bayesian
249,Bayesian,257,212,469,29,20,Player A
250,Bayesian,234,224,458,24,22,Player A
251,Bayesian,196,241,437,18,27,Bayesian
252,Bayesian,211,226,437,27,30,Bayesian
253,Bayesian,239,219,458,27,23,Player A
254,Bayesian,229,234,463,17,18,Bayesian
255,Bayesian,247,217,464,27,21,Player A
256,Bayesian,212,232,444,22,26,Bayesian
257,Bayesian,233,223,456,25,23,Player A
258,Bayesian,233,218,451,29,26,Player A
259,Bayesian,212,232,444,22,26,Bayesian
260,Bayesian,224,224,448,26,26,Tie
261,Bayesian,231,221,452,27,25,Player A
262,Bayesian,206,236,442,20,26,Bayesian
263,Bayesian,217,232,449,21,24,Bayesian
264,Bayesian,206,231,437,24,29,Bayesian
265,Bayesian,225,225,450,25,25,Tie
266,Bayesian,214,229,443,24,27,Bayesian
267,Bayesian,225,225,450,25,25,Tie
268,Bayesian,214,229,443,24,27,Bayesian
269,Bayesian,254,209,463,32,23,Player A
270,Bayesian,199,234,433,23,30,Bayesian
271,Bayesian,225,220,445,29,28,Player A
272,Bayesian,226,226,452,24,24,Tie
273,Bayesian,233,218,451,29,26,Player A
274,Bayesian,246,221,467,24,19,Player A
275,Bayesian,217,232,449,21,24,Bayesian
276,Bayesian,221,231,452,21,23,Bayesian
277,Bayesian,238,223,461,24,21,Player A
278,Bayesian,222,222,444,28,28,Tie
279,Bayesian,236,221,457,26,23,Player A
280,Bayesian,198,238,436,20,28,Bayesian
281,Bayesian,239,224,463,23,20,Player A
282,Bayesian,223,233,456,19,21,Bayesian
283,Bayesian,225,225,450,25,25,Tie
284,Bayesian,209,234,443,21,26,Bayesian
285,Bayesian,212,237,449,18,23,Bayesian
286,Bayesian,251,211,462,31,23,Player A
287,Bayesian,217,227,444,25,27,Bayesian
288,Bayesian,251,211,462,31,23,Player A
289,Bayesian,232,227,459,22,21,Player A
290,Bayesian,205,235,440,21,27,Bayesian
291,Bayesian,236,221,457,26,23,Player A
292,Bayesian,244,214,458,30,24,Player A
293,Bayesian,226,226,452,24,24,Tie
294,Bayesian,189,239,428,21,31,Bayesian
295,Bayesian,193,233,426,25,33,Bayesian
296,Bayesian,221,226,447,25,26,Bayesian
297,Bayesian,197,237,434,21,29,Bayesian
298,Bayesian,210,230,440,24,28,Bayesian
299,Bayesian,194,239,433,20,29,Bayesian
300,Bayesian,216,231,447,22,25,Bayesian
301,Bayesian,237,217,454,29,25,Player A
302,Bayesian,244,219,463,26,21,Player A
303,Bayesian,212,232,444,22,26,Bayesian
304,Bayesian,255,215,470,27,19,Player A
305,Bayesian,193,238,431,21,30,Bayesian
306,Bayesian,222,232,454,20,22,Bayesian
307,Bayesian,215,230,445,23,26,Bayesian
308,Bayesian,225,225,450,25,25,Tie
309,Bayesian,231,226,457,23,22,Player A
310,Bayesian,206,231,437,24,29,Bayesian
311,Bayesian,229,229,458,21,21,Tie
312,Bayesian,226,226,452,24,24,Tie
313,Bayesian,231,221,452,27,25,Player A
314,Bayesian,201,236,437,21,28,Bayesian
315,Bayesian,203,238,441,19,26,Bayesian
316,Bayesian,257,217,474,25,17,Player A
317,Bayesian,260,215,475,26,17,Player A
318,Bayesian,248,213,461,30,23,Player A
319,Bayesian,225,225,450,25,25,Tie
320,Bayesian,203,238,441,19,26,Bayesian
321,Bayesian,257,212,469,29,20,Player A
322,Bayesian,262,212,474,28,18,Player A
323,Bayesian,185,240,425,21,32,Bayesian
324,Bayesian,221,221,442,29,29,Tie
325,Bayesian,233,218,451,29,26,Player A
326,Bayesian,221,231,452,21,23,Bayesian
327,Bayesian,241,216,457,29,24,Player A
328,Bayesian,213,233,446,21,25,Bayesian
329,Bayesian,211,236,447,19,24,Bayesian
330,Bayesian,233,218,451,29,26,Player A
331,Bayesian,212,227,439,26,29,Bayesian
332,Bayesian,257,212,469,29,20,Player A
333,Bayesian,202,232,434,24,30,Bayesian
334,Bayesian,221,221,442,29,29,Tie
335,Bayesian,212,232,444,22,26,Bayesian
336,Bayesian,250,215,465,28,21,Player A
337,Bayesian,234,224,458,24,22,Player A
338,Bayesian,209,229,438,25,29,Bayesian
339,Bayesian,228,223,451,26,25,Player A
340,Bayesian,231,221,452,27,25,Player A
341,Bayesian,223,223,446,27,27,Tie
342,Bayesian,223,228,451,23,24,Bayesian
343,Bayesian,213,233,446,21,25,Bayesian
344,Bayesian,227,222,449,27,26,Player A
345,Bayesian,223,223,446,27,27,Tie
346,Bayesian,258,208,466,32,22,Player A
347,Bayesian,235,220,455,27,24,Player A
348,Bayesian,211,236,447,19,24,Bayesian
349,Bayesian,226,226,452,24,24,Tie
350,Bayesian,237,222,459,25,22,Player A
351,Bayesian,239,209,448,35,29,Player A
352,Bayesian,210,230,440,24,28,Bayesian
0,UCBPlayer,54,299,353,0,49,UCBPlayer
1,UCBPlayer,54,299,353,0,49,UCBPlayer
2,UCBPlayer,54,299,353,0,49,UCBPlayer
3,UCBPlayer,54,299,353,0,49,UCBPlayer
4,UCBPlayer,54,299,353,0,49,UCBPlayer
5,UCBPlayer,54,299,353,0,49,UCBPlayer
6,UCBPlayer,54,299,353,0,49,UCBPlayer
7,UCBPlayer,54,299,353,0,49,UCBPlayer
8,UCBPlayer,54,299,353,0,49,UCBPlayer
9,UCBPlayer,54,299,353,0,49,UCBPlayer
10,UCBPlayer,54,299,353,0,49,UCBPlayer
0,JointPQPlayer,341,176,517,41,8,Player A
1,JointPQPlayer,321,186,507,37,10,Player A
2,JointPQPlayer,191,241,432,19,29,JointPQPlayer
3,JointPQPlayer,159,254,413,15,34,JointPQPlayer
4,JointPQPlayer,120,275,395,6,37,JointPQPlayer
5,JointPQPlayer,259,209,468,31,21,Player A
6,JointPQPlayer,310,190,500,36,12,Player A
7,JointPQPlayer,256,206,462,34,24,Player A
8,JointPQPlayer,271,206,477,31,18,Player A
9,JointPQPlayer,295,195,490,35,15,Player A
10,JointPQPlayer,294,194,488,36,16,Player A
11,JointPQPlayer,312,187,499,38,13,Player A
12,JointPQPlayer,137,267,404,9,35,JointPQPlayer
13,JointPQPlayer,290,195,485,36,17,Player A
14,JointPQPlayer,305,195,500,33,11,Player A
15,JointPQPlayer,278,203,481,32,17,Player A
16,JointPQPlayer,331,176,507,43,12,Player A
17,JointPQPlayer,307,187,494,39,15,Player A
18,JointPQPlayer,273,203,476,33,19,Player A
19,JointPQPlayer,281,201,482,33,17,Player A
20,JointPQPlayer,289,194,483,37,18,Player A
21,JointPQPlayer,279,204,483,31,16,Player A
22,JointPQPlayer,321,186,507,37,10,Player A
23,JointPQPlayer,256,211,467,30,21,Player A
24,JointPQPlayer,313,188,501,37,12,Player A
25,JointPQPlayer,248,213,461,30,23,Player A
26,JointPQPlayer,130,265,395,12,39,JointPQPlayer
27,JointPQPlayer,294,194,488,36,16,Player A
28,JointPQPlayer,185,240,425,21,32,JointPQPlayer
29,JointPQPlayer,291,196,487,35,16,Player A
30,JointPQPlayer,309,189,498,37,13,Player A
31,JointPQPlayer,276,201,477,34,19,Player A
32,JointPQPlayer,314,189,503,36,11,Player A
33,JointPQPlayer,290,195,485,36,17,Player A
34,JointPQPlayer,280,200,480,34,18,Player A
35,JointPQPlayer,292,197,489,34,15,Player A
36,JointPQPlayer,192,242,434,18,28,JointPQPlayer
37,JointPQPlayer,153,253,406,17,37,JointPQPlayer
38,JointPQPlayer,299,194,493,35,14,Player A
39,JointPQPlayer,154,254,408,16,36,JointPQPlayer
40,JointPQPlayer,277,207,484,29,15,Player A
41,JointPQPlayer,293,198,491,33,14,Player A
42,JointPQPlayer,303,193,496,35,13,Player A
43,JointPQPlayer,283,203,486,31,15,Player A
44,JointPQPlayer,319,194,513,31,6,Player A
45,JointPQPlayer,282,202,484,32,16,Player A
46,JointPQPlayer,297,192,489,37,16,Player A
47,JointPQPlayer,157,257,414,13,33,JointPQPlayer
48,JointPQPlayer,284,199,483,34,17,Player A
49,JointPQPlayer,290,195,485,36,17,Player A
50,JointPQPlayer,314,189,503,36,11,Player A
51,JointPQPlayer,301,191,492,37,15,Player A
52,JointPQPlayer,292,197,489,34,15,Player A
53,JointPQPlayer,153,258,411,13,34,JointPQPlayer
54,JointPQPlayer,289,194,483,37,18,Player A
55,JointPQPlayer,288,193,481,38,19,Player A
56,JointPQPlayer,266,206,472,32,20,Player A
57,JointPQPlayer,279,209,488,27,13,Player A
58,JointPQPlayer,299,189,488,39,17,Player A
59,JointPQPlayer,271,206,477,31,18,Player A
60,JointPQPlayer,285,200,485,33,16,Player A
61,JointPQPlayer,219,224,443,27,28,JointPQPlayer
62,JointPQPlayer,127,267,394,11,39,JointPQPlayer
63,JointPQPlayer,143,263,406,11,35,JointPQPlayer
64,JointPQPlayer,134,264,398,12,38,JointPQPlayer
65,JointPQPlayer,277,202,479,33,18,Player A
66,JointPQPlayer,297,197,494,33,13,Player A
67,JointPQPlayer,283,203,486,31,15,Player A
68,JointPQPlayer,267,207,474,31,19,Player A
69,JointPQPlayer,133,263,396,13,39,JointPQPlayer
70,JointPQPlayer,146,261,407,12,35,JointPQPlayer
71,JointPQPlayer,281,201,482,33,17,Player A
72,JointPQPlayer,286,196,482,36,18,Player A
73,JointPQPlayer,323,188,511,35,8,Player A
74,JointPQPlayer,312,187,499,38,13,Player A
75,JointPQPlayer,320,185,505,38,11,Player A
76,JointPQPlayer,139,259,398,15,39,JointPQPlayer
77,JointPQPlayer,215,230,445,23,26,JointPQPlayer
78,JointPQPlayer,263,203,466,35,23,Player A
79,JointPQPlayer,299,194,493,35,14,Player A
80,JointPQPlayer,276,201,477,34,19,Player A
81,JointPQPlayer,147,257,404,15,37,JointPQPlayer
82,JointPQPlayer,312,192,504,34,10,Player A
83,JointPQPlayer,270,205,475,32,19,Player A
84,JointPQPlayer,295,195,490,35,15,Player A
85,JointPQPlayer,226,221,447,28,27,Player A
86,JointPQPlayer,270,205,475,32,19,Player A
87,JointPQPlayer,311,191,502,35,11,Player A
88,JointPQPlayer,289,194,483,37,18,Player A
89,JointPQPlayer,297,192,489,37,16,Player A
90,JointPQPlayer,321,186,507,37,10,Player A
91,JointPQPlayer,259,214,473,27,18,Player A
92,JointPQPlayer,294,194,488,36,16,Player A
93,JointPQPlayer,169,244,413,21,36,JointPQPlayer
94,JointPQPlayer,244,214,458,30,24,Player A
95,JointPQPlayer,279,204,483,31,16,Player A
96,JointPQPlayer,299,189,488,39,17,Player A
97,JointPQPlayer,283,198,481,35,18,Player A
98,JointPQPlayer,301,186,487,41,18,Player A
99,JointPQPlayer,308,188,496,38,14,Player A
100,JointPQPlayer,283,198,481,35,18,Player A
101,JointPQPlayer,218,223,441,28,29,JointPQPlayer
102,JointPQPlayer,315,180,495,43,16,Player A
103,JointPQPlayer,278,198,476,36,20,Player A
104,JointPQPlayer,310,195,505,32,9,Player A
105,JointPQPlayer,154,259,413,12,33,JointPQPlayer
106,JointPQPlayer,154,259,413,12,33,JointPQPlayer
107,JointPQPlayer,313,188,501,37,12,Player A
108,JointPQPlayer,306,191,497,36,13,Player A
109,JointPQPlayer,283,198,481,35,18,Player A
110,JointPQPlayer,283,198,481,35,18,Player A
111,JointPQPlayer,279,199,478,35,19,Player A
112,JointPQPlayer,295,195,490,35,15,Player A
113,JointPQPlayer,284,204,488,30,14,Player A
114,JointPQPlayer,211,236,447,19,24,JointPQPlayer
115,JointPQPlayer,280,200,480,34,18,Player A
116,JointPQPlayer,250,210,460,32,24,Player A
117,JointPQPlayer,308,188,496,38,14,Player A
118,JointPQPlayer,146,261,407,12,35,JointPQPlayer
119,JointPQPlayer,137,262,399,13,38,JointPQPlayer
120,JointPQPlayer,294,199,493,32,13,Player A
121,JointPQPlayer,312,187,499,38,13,Player A
122,JointPQPlayer,145,260,405,13,36,JointPQPlayer
123,JointPQPlayer,286,196,482,36,18,Player A
124,JointPQPlayer,288,198,486,34,16,Player A
125,JointPQPlayer,315,190,505,35,10,Player A
126,JointPQPlayer,326,176,502,44,14,Player A
127,JointPQPlayer,137,262,399,13,38,JointPQPlayer
128,JointPQPlayer,282,197,479,36,19,Player A
129,JointPQPlayer,271,201,472,35,21,Player A
130,JointPQPlayer,279,204,483,31,16,Player A
131,JointPQPlayer,279,204,483,31,16,Player A
132,JointPQPlayer,303,193,496,35,13,Player A
133,JointPQPlayer,291,196,487,35,16,Player A
134,JointPQPlayer,288,193,481,38,19,Player A
135,JointPQPlayer,300,190,490,38,16,Player A
136,JointPQPlayer,284,199,483,34,17,Player A
137,JointPQPlayer,290,190,480,40,20,Player A
138,JointPQPlayer,273,203,476,33,19,Player A
139,JointPQPlayer,304,194,498,34,12,Player A
140,JointPQPlayer,275,200,475,35,20,Player A
141,JointPQPlayer,330,180,510,40,10,Player A
142,JointPQPlayer,289,204,493,29,12,Player A
143,JointPQPlayer,179,244,423,19,32,JointPQPlayer
144,JointPQPlayer,278,203,481,32,17,Player A
145,JointPQPlayer,296,186,482,42,20,Player A
146,JointPQPlayer,133,268,401,9,36,JointPQPlayer
147,JointPQPlayer,276,201,477,34,19,Player A
148,JointPQPlayer,300,190,490,38,16,Player A
149,JointPQPlayer,263,213,476,27,17,Player A
150,JointPQPlayer,276,201,477,34,19,Player A
151,JointPQPlayer,251,211,462,31,23,Player A
152,JointPQPlayer,189,239,428,21,31,JointPQPlayer
153,JointPQPlayer,280,205,485,30,15,Player A
154,JointPQPlayer,122,267,389,12,41,JointPQPlayer
155,JointPQPlayer,285,200,485,33,16,Player A
156,JointPQPlayer,278,198,476,36,20,Player A
157,JointPQPlayer,296,191,487,38,17,Player A
158,JointPQPlayer,288,198,486,34,16,Player A
159,JointPQPlayer,125,265,390,13,41,JointPQPlayer
160,JointPQPlayer,255,210,465,31,22,Player A
161,JointPQPlayer,289,194,483,37,18,Player A
162,JointPQPlayer,273,203,476,33,19,Player A
163,JointPQPlayer,298,193,491,36,15,Player A
164,JointPQPlayer,290,195,485,36,17,Player A
165,JointPQPlayer,295,195,490,35,15,Player A
166,JointPQPlayer,183,243,426,19,31,JointPQPlayer
167,JointPQPlayer,306,191,497,36,13,Player A
168,JointPQPlayer,303,198,501,31,10,Player A
169,JointPQPlayer,168,253,421,14,31,JointPQPlayer
170,JointPQPlayer,286,201,487,32,15,Player A
171,JointPQPlayer,310,190,500,36,12,Player A
172,JointPQPlayer,264,209,473,30,19,Player A
173,JointPQPlayer,309,184,493,41,16,Player A
174,JointPQPlayer,295,200,495,31,12,Player A
175,JointPQPlayer,135,260,395,15,40,JointPQPlayer
176,JointPQPlayer,314,189,503,36,11,Player A
177,JointPQPlayer,284,194,478,38,20,Player A
178,JointPQPlayer,305,195,500,33,11,Player A
179,JointPQPlayer,127,267,394,11,39,JointPQPlayer
180,JointPQPlayer,153,253,406,17,37,JointPQPlayer
181,JointPQPlayer,295,195,490,35,15,Player A
182,JointPQPlayer,162,247,409,20,37,JointPQPlayer
183,JointPQPlayer,123,273,396,7,37,JointPQPlayer
184,JointPQPlayer,156,256,412,14,34,JointPQPlayer
185,JointPQPlayer,304,189,493,38,15,Player A
186,JointPQPlayer,293,193,486,37,17,Player A
187,JointPQPlayer,313,188,501,37,12,Player A
188,JointPQPlayer,314,189,503,36,11,Player A
189,JointPQPlayer,280,200,480,34,18,Player A
190,JointPQPlayer,296,196,492,34,14,Player A
191,JointPQPlayer,288,203,491,30,13,Player A
192,JointPQPlayer,276,201,477,34,19,Player A
193,JointPQPlayer,292,202,494,30,12,Player A
194,JointPQPlayer,275,200,475,35,20,Player A
195,JointPQPlayer,287,202,489,31,14,Player A
196,JointPQPlayer,311,186,497,39,14,Player A
197,JointPQPlayer,319,184,503,39,12,Player A
198,JointPQPlayer,296,191,487,38,17,Player A
199,JointPQPlayer,146,256,402,16,38,JointPQPlayer
200,JointPQPlayer,293,198,491,33,14,Player A
201,JointPQPlayer,312,187,499,38,13,Player A
202,JointPQPlayer,282,197,479,36,19,Player A
203,JointPQPlayer,286,201,487,32,15,Player A
204,JointPQPlayer,148,263,411,10,33,JointPQPlayer
205,JointPQPlayer,276,196,472,38,22,Player A
206,JointPQPlayer,291,201,492,31,13,Player A
207,JointPQPlayer,275,205,480,31,17,Player A
208,JointPQPlayer,290,195,485,36,17,Player A
209,JointPQPlayer,133,263,396,13,39,JointPQPlayer
210,JointPQPlayer,306,191,497,36,13,Player A
211,JointPQPlayer,170,245,415,20,35,JointPQPlayer
212,JointPQPlayer,289,199,488,33,15,Player A
213,JointPQPlayer,271,206,477,31,18,Player A
214,JointPQPlayer,280,200,480,34,18,Player A
215,JointPQPlayer,318,188,506,36,10,Player A
216,JointPQPlayer,290,190,480,40,20,Player A
217,JointPQPlayer,291,196,487,35,16,Player A
218,JointPQPlayer,307,187,494,39,15,Player A
219,JointPQPlayer,134,264,398,12,38,JointPQPlayer
220,JointPQPlayer,324,184,508,38,10,Player A
221,JointPQPlayer,305,190,495,37,14,Player A
222,JointPQPlayer,289,199,488,33,15,Player A
223,JointPQPlayer,274,204,478,32,18,Player A
224,JointPQPlayer,148,258,406,14,36,JointPQPlayer
225,JointPQPlayer,308,193,501,34,11,Player A
226,JointPQPlayer,299,194,493,35,14,Player A
227,JointPQPlayer,274,204,478,32,18,Player A
228,JointPQPlayer,278,203,481,32,17,Player A
229,JointPQPlayer,274,209,483,28,15,Player A
230,JointPQPlayer,291,196,487,35,16,Player A
231,JointPQPlayer,312,187,499,38,13,Player A
232,JointPQPlayer,279,204,483,31,16,Player A
233,JointPQPlayer,294,199,493,32,13,Player A
234,JointPQPlayer,307,187,494,39,15,Player A
235,JointPQPlayer,147,257,404,15,37,JointPQPlayer
236,JointPQPlayer,247,217,464,27,21,Player A
237,JointPQPlayer,294,199,493,32,13,Player A
238,JointPQPlayer,162,247,409,20,37,JointPQPlayer
239,JointPQPlayer,186,241,427,20,31,JointPQPlayer
240,JointPQPlayer,188,243,431,18,29,JointPQPlayer
241,JointPQPlayer,307,192,499,35,12,Player A
242,JointPQPlayer,292,192,484,38,18,Player A
243,JointPQPlayer,256,211,467,30,21,Player A
244,JointPQPlayer,256,206,462,34,24,Player A
245,JointPQPlayer,251,206,457,35,26,Player A
246,JointPQPlayer,322,182,504,40,12,Player A
247,JointPQPlayer,296,201,497,30,11,Player A
248,JointPQPlayer,230,220,450,28,26,Player A
249,JointPQPlayer,296,196,492,34,14,Player A
250,JointPQPlayer,303,188,491,39,16,Player A
251,JointPQPlayer,292,197,489,34,15,Player A
252,JointPQPlayer,279,199,478,35,19,Player A
253,JointPQPlayer,250,215,465,28,21,Player A
254,JointPQPlayer,311,191,502,35,11,Player A
255,JointPQPlayer,279,204,483,31,16,Player A
256,JointPQPlayer,288,198,486,34,16,Player A
257,JointPQPlayer,291,196,487,35,16,Player A
258,JointPQPlayer,303,193,496,35,13,Player A
259,JointPQPlayer,297,187,484,41,19,Player A
260,JointPQPlayer,310,190,500,36,12,Player A
261,JointPQPlayer,291,201,492,31,13,Player A
262,JointPQPlayer,145,255,400,17,39,JointPQPlayer
263,JointPQPlayer,332,177,509,42,11,Player A
264,JointPQPlayer,305,185,490,41,17,Player A
265,JointPQPlayer,278,203,481,32,17,Player A
266,JointPQPlayer,288,198,486,34,16,Player A
267,JointPQPlayer,147,257,404,15,37,JointPQPlayer
268,JointPQPlayer,136,261,397,14,39,JointPQPlayer
269,JointPQPlayer,318,183,501,40,13,Player A
270,JointPQPlayer,251,211,462,31,23,Player A
271,JointPQPlayer,222,232,454,20,22,JointPQPlayer
272,JointPQPlayer,261,211,472,29,19,Player A
273,JointPQPlayer,287,192,479,39,20,Player A
274,JointPQPlayer,293,193,486,37,17,Player A
275,JointPQPlayer,300,190,490,38,16,Player A
276,JointPQPlayer,299,189,488,39,17,Player A
277,JointPQPlayer,293,198,491,33,14,Player A
278,JointPQPlayer,272,197,469,38,23,Player A
279,JointPQPlayer,293,193,486,37,17,Player A
280,JointPQPlayer,302,197,499,32,11,Player A
281,JointPQPlayer,295,195,490,35,15,Player A
282,JointPQPlayer,310,185,495,40,15,Player A
283,JointPQPlayer,306,191,497,36,13,Player A
284,JointPQPlayer,302,192,494,36,14,Player A
285,JointPQPlayer,142,257,399,16,39,JointPQPlayer
286,JointPQPlayer,157,252,409,17,36,JointPQPlayer
287,JointPQPlayer,288,198,486,34,16,Player A
288,JointPQPlayer,122,267,389,12,41,JointPQPlayer
289,JointPQPlayer,314,184,498,40,14,Player A
290,JointPQPlayer,320,185,505,38,11,Player A
291,JointPQPlayer,268,203,471,34,21,Player A
292,JointPQPlayer,298,198,496,32,12,Player A
293,JointPQPlayer,148,263,411,10,33,JointPQPlayer
294,JointPQPlayer,307,187,494,39,15,Player A
295,JointPQPlayer,313,188,501,37,12,Player A
296,JointPQPlayer,315,185,500,39,13,Player A
297,JointPQPlayer,150,260,410,12,34,JointPQPlayer
298,JointPQPlayer,312,192,504,34,10,Player A
299,JointPQPlayer,313,188,501,37,12,Player A
300,JointPQPlayer,292,197,489,34,15,Player A
301,JointPQPlayer,273,203,476,33,19,Player A
302,JointPQPlayer,149,259,408,13,35,JointPQPlayer
303,JointPQPlayer,299,189,488,39,17,Player A
304,JointPQPlayer,253,213,466,29,21,Player A
305,JointPQPlayer,294,194,488,36,16,Player A
306,JointPQPlayer,285,200,485,33,16,Player A
307,JointPQPlayer,134,264,398,12,38,JointPQPlayer
308,JointPQPlayer,269,204,473,33,20,Player A
309,JointPQPlayer,264,199,463,38,25,Player A
310,JointPQPlayer,300,195,495,34,13,Player A
311,JointPQPlayer,156,246,402,22,40,JointPQPlayer
312,JointPQPlayer,284,204,488,30,14,Player A
313,JointPQPlayer,277,207,484,29,15,Player A
314,JointPQPlayer,292,197,489,34,15,Player A
315,JointPQPlayer,310,195,505,32,9,Player A
316,JointPQPlayer,164,249,413,18,35,JointPQPlayer
317,JointPQPlayer,311,186,497,39,14,Player A
318,JointPQPlayer,313,183,496,41,15,Player A
319,JointPQPlayer,307,187,494,39,15,Player A
320,JointPQPlayer,297,192,489,37,16,Player A
321,JointPQPlayer,275,200,475,35,20,Player A
322,JointPQPlayer,291,196,487,35,16,Player A
323,JointPQPlayer,279,209,488,27,13,Player A
324,JointPQPlayer,270,205,475,32,19,Player A
325,JointPQPlayer,283,198,481,35,18,Player A
326,JointPQPlayer,295,195,490,35,15,Player A
327,JointPQPlayer,293,198,491,33,14,Player A
328,JointPQPlayer,308,193,501,34,11,Player A
329,JointPQPlayer,292,197,489,34,15,Player A
330,JointPQPlayer,182,242,424,20,32,JointPQPlayer
331,JointPQPlayer,321,191,512,33,7,Player A
332,JointPQPlayer,322,182,504,40,12,Player A
333,JointPQPlayer,159,249,408,19,37,JointPQPlayer
334,JointPQPlayer,331,181,512,39,9,Player A
335,JointPQPlayer,276,196,472,38,22,Player A
336,JointPQPlayer,290,195,485,36,17,Player A
337,JointPQPlayer,292,192,484,38,18,Player A
338,JointPQPlayer,286,196,482,36,18,Player A
339,JointPQPlayer,162,242,404,24,40,JointPQPlayer
340,JointPQPlayer,281,201,482,33,17,Player A
341,JointPQPlayer,271,206,477,31,18,Player A
342,JointPQPlayer,279,204,483,31,16,Player A
343,JointPQPlayer,317,182,499,41,14,Player A
344,JointPQPlayer,293,198,491,33,14,Player A
345,JointPQPlayer,267,202,469,35,22,Player A
346,JointPQPlayer,284,194,478,38,20,Player A
347,JointPQPlayer,263,208,471,31,20,Player A
348,JointPQPlayer,261,206,467,33,22,Player A
349,JointPQPlayer,280,200,480,34,18,Player A
350,JointPQPlayer,292,197,489,34,15,Player A
351,JointPQPlayer,149,254,403,17,38,JointPQPlayer
352,JointPQPlayer,284,199,483,34,17,Player A
353,JointPQPlayer,282,202,484,32,16,Player A
354,JointPQPlayer,315,190,505,35,10,Player A
355,JointPQPlayer,296,191,487,38,17,Player A
356,JointPQPlayer,299,199,498,31,11,Player A
357,JointPQPlayer,255,215,470,27,19,Player A
358,JointPQPlayer,301,191,492,37,15,Player A
359,JointPQPlayer,283,198,481,35,18,Player A
360,JointPQPlayer,275,205,480,31,17,Player A
361,JointPQPlayer,292,197,489,34,15,Player A
362,JointPQPlayer,167,252,419,15,32,JointPQPlayer
363,JointPQPlayer,276,211,487,26,13,Player A
364,JointPQPlayer,137,267,404,9,35,JointPQPlayer
365,JointPQPlayer,286,196,482,36,18,Player A
366,JointPQPlayer,305,190,495,37,14,Player A
367,JointPQPlayer,185,245,430,17,29,JointPQPlayer
368,JointPQPlayer,306,186,492,40,16,Player A
369,JointPQPlayer,315,185,500,39,13,Player A
370,JointPQPlayer,235,220,455,27,24,Player A
371,JointPQPlayer,311,186,497,39,14,Player A
372,JointPQPlayer,287,192,479,39,20,Player A
373,JointPQPlayer,196,236,432,22,30,JointPQPlayer
374,JointPQPlayer,286,201,487,32,15,Player A
375,JointPQPlayer,152,257,409,14,35,JointPQPlayer
376,JointPQPlayer,298,193,491,36,15,Player A
377,JointPQPlayer,312,187,499,38,13,Player A
378,JointPQPlayer,279,199,478,35,19,Player A
379,JointPQPlayer,306,191,497,36,13,Player A
380,JointPQPlayer,306,191,497,36,13,Player A
381,JointPQPlayer,322,182,504,40,12,Player A
382,JointPQPlayer,223,223,446,27,27,Tie
383,JointPQPlayer,294,199,493,32,13,Player A
384,JointPQPlayer,304,189,493,38,15,Player A
385,JointPQPlayer,142,262,404,12,36,JointPQPlayer
386,JointPQPlayer,276,206,482,30,16,Player A
387,JointPQPlayer,301,191,492,37,15,Player A
388,JointPQPlayer,264,209,473,30,19,Player A
389,JointPQPlayer,304,189,493,38,15,Player A
390,JointPQPlayer,286,196,482,36,18,Player A
391,JointPQPlayer,295,200,495,31,12,Player A
392,JointPQPlayer,261,211,472,29,19,Player A
393,JointPQPlayer,268,208,476,30,18,Player A
394,JointPQPlayer,283,198,481,35,18,Player A
395,JointPQPlayer,308,188,496,38,14,Player A
396,JointPQPlayer,287,192,479,39,20,Player A
397,JointPQPlayer,287,197,484,35,17,Player A
398,JointPQPlayer,317,187,504,37,11,Player A
399,JointPQPlayer,155,255,410,15,35,JointPQPlayer
400,JointPQPlayer,289,199,488,33,15,Player A
401,JointPQPlayer,297,197,494,33,13,Player A
402,JointPQPlayer,301,191,492,37,15,Player A
403,JointPQPlayer,135,260,395,15,40,JointPQPlayer
404,JointPQPlayer,306,196,502,32,10,Player A
405,JointPQPlayer,302,192,494,36,14,Player A
406,JointPQPlayer,319,184,503,39,12,Player A
407,JointPQPlayer,299,194,493,35,14,Player A
408,JointPQPlayer,136,261,397,14,39,JointPQPlayer
409,JointPQPlayer,302,192,494,36,14,Player A
410,JointPQPlayer,279,199,478,35,19,Player A
411,JointPQPlayer,315,185,500,39,13,Player A
412,JointPQPlayer,162,257,419,12,31,JointPQPlayer
413,JointPQPlayer,312,187,499,38,13,Player A
414,JointPQPlayer,313,193,506,33,9,Player A
415,JointPQPlayer,323,183,506,39,11,Player A
416,JointPQPlayer,299,199,498,31,11,Player A
417,JointPQPlayer,279,199,478,35,19,Player A
418,JointPQPlayer,273,208,481,29,16,Player A
419,JointPQPlayer,140,265,405,10,35,JointPQPlayer
420,JointPQPlayer,291,201,492,31,13,Player A
421,JointPQPlayer,285,200,485,33,16,Player A
422,JointPQPlayer,331,181,512,39,9,Player A
423,JointPQPlayer,298,193,491,36,15,Player A
424,JointPQPlayer,277,202,479,33,18,Player A
425,JointPQPlayer,284,204,488,30,14,Player A
426,JointPQPlayer,143,253,396,19,41,JointPQPlayer
427,JointPQPlayer,305,190,495,37,14,Player A
428,JointPQPlayer,265,200,465,37,24,Player A
429,JointPQPlayer,305,190,495,37,14,Player A
430,JointPQPlayer,310,185,495,40,15,Player A
431,JointPQPlayer,134,264,398,12,38,JointPQPlayer
432,JointPQPlayer,298,193,491,36,15,Player A
433,JointPQPlayer,284,194,478,38,20,Player A
434,JointPQPlayer,149,259,408,13,35,JointPQPlayer
435,JointPQPlayer,145,265,410,9,33,JointPQPlayer
436,JointPQPlayer,136,266,402,10,36,JointPQPlayer
437,JointPQPlayer,279,199,478,35,19,Player A
438,JointPQPlayer,297,202,499,29,10,Player A
439,JointPQPlayer,291,196,487,35,16,Player A
440,JointPQPlayer,293,198,491,33,14,Player A
441,JointPQPlayer,166,251,417,16,33,JointPQPlayer
442,JointPQPlayer,270,205,475,32,19,Player A
443,JointPQPlayer,138,263,401,12,37,JointPQPlayer
444,JointPQPlayer,270,210,480,28,16,Player A
445,JointPQPlayer,282,202,484,32,16,Player A
446,JointPQPlayer,309,189,498,37,13,Player A
447,JointPQPlayer,278,198,476,36,20,Player A
448,JointPQPlayer,304,189,493,38,15,Player A
449,JointPQPlayer,261,206,467,33,22,Player A
450,JointPQPlayer,271,206,477,31,18,Player A
451,JointPQPlayer,291,196,487,35,16,Player A
452,JointPQPlayer,298,198,496,32,12,Player A
453,JointPQPlayer,240,220,460,26,22,Player A
454,JointPQPlayer,168,248,416,18,34,JointPQPlayer
455,JointPQPlayer,259,214,473,27,18,Player A
456,JointPQPlayer,116,271,387,10,41,JointPQPlayer
457,JointPQPlayer,307,192,499,35,12,Player A
458,JointPQPlayer,293,198,491,33,14,Player A
459,JointPQPlayer,301,186,487,41,18,Player A
460,JointPQPlayer,304,194,498,34,12,Player A
461,JointPQPlayer,284,204,488,30,14,Player A
462,JointPQPlayer,284,199,483,34,17,Player A
463,JointPQPlayer,301,196,497,33,12,Player A
464,JointPQPlayer,307,192,499,35,12,Player A
465,JointPQPlayer,249,214,463,29,22,Player A
466,JointPQPlayer,284,204,488,30,14,Player A
467,JointPQPlayer,249,214,463,29,22,Player A
468,JointPQPlayer,130,265,395,12,39,JointPQPlayer
469,JointPQPlayer,131,266,397,11,38,JointPQPlayer
470,JointPQPlayer,156,261,417,10,31,JointPQPlayer
471,JointPQPlayer,273,203,476,33,19,Player A
472,JointPQPlayer,249,214,463,29,22,Player A
473,JointPQPlayer,150,255,405,16,37,JointPQPlayer
474,JointPQPlayer,300,195,495,34,13,Player A
475,JointPQPlayer,313,188,501,37,12,Player A
476,JointPQPlayer,163,243,406,23,39,JointPQPlayer
477,JointPQPlayer,278,203,481,32,17,Player A
478,JointPQPlayer,278,198,476,36,20,Player A
479,JointPQPlayer,159,259,418,11,31,JointPQPlayer
480,JointPQPlayer,294,199,493,32,13,Player A
481,JointPQPlayer,282,202,484,32,16,Player A
482,JointPQPlayer,298,193,491,36,15,Player A
483,JointPQPlayer,132,262,394,14,40,JointPQPlayer
484,JointPQPlayer,271,201,472,35,21,Player A
485,JointPQPlayer,300,190,490,38,16,Player A
486,JointPQPlayer,232,222,454,26,24,Player A
487,JointPQPlayer,147,262,409,11,34,JointPQPlayer
488,JointPQPlayer,315,185,500,39,13,Player A
489,JointPQPlayer,297,192,489,37,16,Player A
490,JointPQPlayer,268,203,471,34,21,Player A
491,JointPQPlayer,313,188,501,37,12,Player A
492,JointPQPlayer,254,209,463,32,23,Player A
493,JointPQPlayer,291,191,482,39,19,Player A
494,JointPQPlayer,148,258,406,14,36,JointPQPlayer
495,JointPQPlayer,282,202,484,32,16,Player A
496,JointPQPlayer,152,257,409,14,35,JointPQPlayer
497,JointPQPlayer,294,194,488,36,16,Player A
498,JointPQPlayer,258,208,466,32,22,Player A
499,JointPQPlayer,293,198,491,33,14,Player A
500,JointPQPlayer,320,180,500,42,14,Player A
501,JointPQPlayer,304,194,498,34,12,Player A
502,JointPQPlayer,326,181,507,40,11,Player A
503,JointPQPlayer,146,256,402,16,38,JointPQPlayer
504,JointPQPlayer,136,261,397,14,39,JointPQPlayer
505,JointPQPlayer,156,251,407,18,37,JointPQPlayer
506,JointPQPlayer,245,215,460,29,23,Player A
507,JointPQPlayer,306,191,497,36,13,Player A
508,JointPQPlayer,296,196,492,34,14,Player A
509,JointPQPlayer,144,259,403,14,37,JointPQPlayer
510,JointPQPlayer,210,230,440,24,28,JointPQPlayer
511,JointPQPlayer,295,195,490,35,15,Player A
512,JointPQPlayer,276,206,482,30,16,Player A
513,JointPQPlayer,154,249,403,20,39,JointPQPlayer
514,JointPQPlayer,308,193,501,34,11,Player A
515,JointPQPlayer,293,198,491,33,14,Player A
516,JointPQPlayer,289,194,483,37,18,Player A
517,JointPQPlayer,114,274,388,8,40,JointPQPlayer
518,JointPQPlayer,147,257,404,15,37,JointPQPlayer
519,JointPQPlayer,272,202,474,34,20,Player A
520,JointPQPlayer,147,257,404,15,37,JointPQPlayer
521,JointPQPlayer,314,184,498,40,14,Player A
522,JointPQPlayer,136,261,397,14,39,JointPQPlayer
523,JointPQPlayer,136,261,397,14,39,JointPQPlayer
524,JointPQPlayer,290,200,490,32,14,Player A
525,JointPQPlayer,278,203,481,32,17,Player A
526,JointPQPlayer,291,191,482,39,19,Player A
527,JointPQPlayer,305,190,495,37,14,Player A
528,JointPQPlayer,216,226,442,26,28,JointPQPlayer
529,JointPQPlayer,211,231,442,23,27,JointPQPlayer
530,JointPQPlayer,300,195,495,34,13,Player A
531,JointPQPlayer,334,179,513,40,9,Player A
532,JointPQPlayer,301,196,497,33,12,Player A
533,JointPQPlayer,296,191,487,38,17,Player A
534,JointPQPlayer,111,271,382,11,43,JointPQPlayer
535,JointPQPlayer,150,255,405,16,37,JointPQPlayer
536,JointPQPlayer,176,241,417,22,35,JointPQPlayer
537,JointPQPlayer,231,226,457,23,22,Player A
538,JointPQPlayer,234,224,458,24,22,Player A
539,JointPQPlayer,313,183,496,41,15,Player A
540,JointPQPlayer,307,192,499,35,12,Player A
541,JointPQPlayer,298,198,496,32,12,Player A
542,JointPQPlayer,301,191,492,37,15,Player A
543,JointPQPlayer,315,185,500,39,13,Player A
544,JointPQPlayer,117,277,394,5,37,JointPQPlayer
545,JointPQPlayer,302,192,494,36,14,Player A
546,JointPQPlayer,133,263,396,13,39,JointPQPlayer
547,JointPQPlayer,159,259,418,11,31,JointPQPlayer
548,JointPQPlayer,265,210,475,29,18,Player A
549,JointPQPlayer,162,257,419,12,31,JointPQPlayer
550,JointPQPlayer,308,193,501,34,11,Player A
551,JointPQPlayer,294,194,488,36,16,Player A
552,JointPQPlayer,287,192,479,39,20,Player A
553,JointPQPlayer,299,194,493,35,14,Player A
554,JointPQPlayer,274,204,478,32,18,Player A
555,JointPQPlayer,300,195,495,34,13,Player A
556,JointPQPlayer,122,267,389,12,41,JointPQPlayer
557,JointPQPlayer,297,192,489,37,16,Player A
558,JointPQPlayer,321,186,507,37,10,Player A
559,JointPQPlayer,307,192,499,35,12,Player A
560,JointPQPlayer,278,203,481,32,17,Player A
561,JointPQPlayer,291,201,492,31,13,Player A
562,JointPQPlayer,146,256,402,16,38,JointPQPlayer
563,JointPQPlayer,302,192,494,36,14,Player A
564,JointPQPlayer,157,257,414,13,33,JointPQPlayer
565,JointPQPlayer,285,200,485,33,16,Player A
566,JointPQPlayer,256,211,467,30,21,Player A
567,JointPQPlayer,136,261,397,14,39,JointPQPlayer
568,JointPQPlayer,292,197,489,34,15,Player A
569,JointPQPlayer,167,247,414,19,35,JointPQPlayer
570,JointPQPlayer,296,191,487,38,17,Player A
571,JointPQPlayer,152,257,409,14,35,JointPQPlayer
572,JointPQPlayer,273,203,476,33,19,Player A
573,JointPQPlayer,265,205,470,33,21,Player A
574,JointPQPlayer,287,202,489,31,14,Player A
575,JointPQPlayer,257,212,469,29,20,Player A
576,JointPQPlayer,314,194,508,32,8,Player A
577,JointPQPlayer,135,270,405,7,34,JointPQPlayer
578,JointPQPlayer,314,189,503,36,11,Player A
579,JointPQPlayer,296,196,492,34,14,Player A
580,JointPQPlayer,181,241,422,21,33,JointPQPlayer
581,JointPQPlayer,138,268,406,8,34,JointPQPlayer
582,JointPQPlayer,298,198,496,32,12,Player A
583,JointPQPlayer,306,186,492,40,16,Player A
584,JointPQPlayer,293,203,496,29,11,Player A
585,JointPQPlayer,155,255,410,15,35,JointPQPlayer
586,JointPQPlayer,312,192,504,34,10,Player A
587,JointPQPlayer,266,206,472,32,20,Player A
588,JointPQPlayer,290,195,485,36,17,Player A
589,JointPQPlayer,299,194,493,35,14,Player A
590,JointPQPlayer,187,242,429,19,30,JointPQPlayer
591,JointPQPlayer,287,197,484,35,17,Player A
592,JointPQPlayer,298,193,491,36,15,Player A
593,JointPQPlayer,128,268,396,10,38,JointPQPlayer
594,JointPQPlayer,303,198,501,31,10,Player A
595,JointPQPlayer,279,204,483,31,16,Player A
596,JointPQPlayer,173,248,421,17,32,JointPQPlayer
597,JointPQPlayer,282,197,479,36,19,Player A
598,JointPQPlayer,165,250,415,17,34,JointPQPlayer
599,JointPQPlayer,124,264,388,14,42,JointPQPlayer
600,JointPQPlayer,137,262,399,13,38,JointPQPlayer
601,JointPQPlayer,289,194,483,37,18,Player A
602,JointPQPlayer,273,208,481,29,16,Player A
603,JointPQPlayer,264,209,473,30,19,Player A
604,JointPQPlayer,139,264,403,11,36,JointPQPlayer
605,JointPQPlayer,273,203,476,33,19,Player A
606,JointPQPlayer,273,208,481,29,16,Player A
607,JointPQPlayer,164,249,413,18,35,JointPQPlayer
608,JointPQPlayer,310,195,505,32,9,Player A
609,JointPQPlayer,254,209,463,32,23,Player A
610,JointPQPlayer,319,184,503,39,12,Player A
611,JointPQPlayer,293,193,486,37,17,Player A
612,JointPQPlayer,270,210,480,28,16,Player A
613,JointPQPlayer,322,182,504,40,12,Player A
614,JointPQPlayer,158,258,416,12,32,JointPQPlayer
615,JointPQPlayer,301,191,492,37,15,Player A
616,JointPQPlayer,161,251,412,17,35,JointPQPlayer
617,JointPQPlayer,159,254,413,15,34,JointPQPlayer
618,JointPQPlayer,304,189,493,38,15,Player A
619,JointPQPlayer,272,202,474,34,20,Player A
620,JointPQPlayer,296,196,492,34,14,Player A
621,JointPQPlayer,275,205,480,31,17,Player A
622,JointPQPlayer,229,224,453,25,24,Player A
623,JointPQPlayer,266,206,472,32,20,Player A
624,JointPQPlayer,337,177,514,41,9,Player A
625,JointPQPlayer,275,210,485,27,14,Player A
626,JointPQPlayer,157,262,419,9,30,JointPQPlayer
627,JointPQPlayer,147,257,404,15,37,JointPQPlayer
628,JointPQPlayer,156,256,412,14,34,JointPQPlayer
629,JointPQPlayer,299,189,488,39,17,Player A
630,JointPQPlayer,269,204,473,33,20,Player A
631,JointPQPlayer,149,259,408,13,35,JointPQPlayer
632,JointPQPlayer,207,232,439,23,28,JointPQPlayer
633,JointPQPlayer,159,259,418,11,31,JointPQPlayer
634,JointPQPlayer,135,260,395,15,40,JointPQPlayer
635,JointPQPlayer,158,253,411,16,35,JointPQPlayer
636,JointPQPlayer,267,207,474,31,19,Player A
637,JointPQPlayer,285,195,480,37,19,Player A
638,JointPQPlayer,291,196,487,35,16,Player A
639,JointPQPlayer,148,258,406,14,36,JointPQPlayer
640,JointPQPlayer,231,221,452,27,25,Player A
641,JointPQPlayer,334,179,513,40,9,Player A
642,JointPQPlayer,323,183,506,39,11,Player A
643,JointPQPlayer,305,190,495,37,14,Player A
644,JointPQPlayer,139,254,393,19,42,JointPQPlayer
645,JointPQPlayer,309,189,498,37,13,Player A
646,JointPQPlayer,277,197,474,37,21,Player A
647,JointPQPlayer,167,252,419,15,32,JointPQPlayer
648,JointPQPlayer,286,201,487,32,15,Player A
649,JointPQPlayer,279,204,483,31,16,Player A
650,JointPQPlayer,171,246,417,19,34,JointPQPlayer
651,JointPQPlayer,299,194,493,35,14,Player A
652,JointPQPlayer,285,200,485,33,16,Player A
653,JointPQPlayer,314,184,498,40,14,Player A
654,JointPQPlayer,315,185,500,39,13,Player A
655,JointPQPlayer,288,198,486,34,16,Player A
656,JointPQPlayer,283,203,486,31,15,Player A
657,JointPQPlayer,298,193,491,36,15,Player A
658,JointPQPlayer,294,194,488,36,16,Player A
659,JointPQPlayer,168,248,416,18,34,JointPQPlayer
660,JointPQPlayer,145,260,405,13,36,JointPQPlayer
661,JointPQPlayer,151,261,412,11,33,JointPQPlayer
662,JointPQPlayer,298,198,496,32,12,Player A
663,JointPQPlayer,279,199,478,35,19,Player A
664,JointPQPlayer,303,188,491,39,16,Player A
665,JointPQPlayer,293,193,486,37,17,Player A
666,JointPQPlayer,321,191,512,33,7,Player A
667,JointPQPlayer,284,199,483,34,17,Player A
668,JointPQPlayer,319,184,503,39,12,Player A
669,JointPQPlayer,283,203,486,31,15,Player A
670,JointPQPlayer,282,197,479,36,19,Player A
671,JointPQPlayer,285,195,480,37,19,Player A
672,JointPQPlayer,296,191,487,38,17,Player A
673,JointPQPlayer,311,186,497,39,14,Player A
674,JointPQPlayer,142,257,399,16,39,JointPQPlayer
675,JointPQPlayer,150,255,405,16,37,JointPQPlayer
676,JointPQPlayer,287,192,479,39,20,Player A
677,JointPQPlayer,134,264,398,12,38,JointPQPlayer
678,JointPQPlayer,306,196,502,32,10,Player A
679,JointPQPlayer,284,204,488,30,14,Player A
680,JointPQPlayer,279,199,478,35,19,Player A
681,JointPQPlayer,284,199,483,34,17,Player A
682,JointPQPlayer,316,186,502,38,12,Player A
683,JointPQPlayer,317,187,504,37,11,Player A
684,JointPQPlayer,299,199,498,31,11,Player A
685,JointPQPlayer,319,184,503,39,12,Player A
686,JointPQPlayer,213,228,441,25,28,JointPQPlayer
687,JointPQPlayer,236,226,462,22,20,Player A
688,JointPQPlayer,265,205,470,33,21,Player A
689,JointPQPlayer,318,183,501,40,13,Player A
690,JointPQPlayer,294,199,493,32,13,Player A
691,JointPQPlayer,306,191,497,36,13,Player A
692,JointPQPlayer,295,200,495,31,12,Player A
693,JointPQPlayer,296,201,497,30,11,Player A
694,JointPQPlayer,298,193,491,36,15,Player A
695,JointPQPlayer,204,234,438,22,28,JointPQPlayer
696,JointPQPlayer,303,193,496,35,13,Player A
697,JointPQPlayer,136,261,397,14,39,JointPQPlayer
698,JointPQPlayer,140,265,405,10,35,JointPQPlayer
699,JointPQPlayer,138,263,401,12,37,JointPQPlayer
700,JointPQPlayer,290,200,490,32,14,Player A
701,JointPQPlayer,305,190,495,37,14,Player A
702,JointPQPlayer,149,254,403,17,38,JointPQPlayer
703,JointPQPlayer,294,194,488,36,16,Player A
704,JointPQPlayer,292,207,499,26,9,Player A
705,JointPQPlayer,306,196,502,32,10,Player A
706,JointPQPlayer,311,186,497,39,14,Player A
707,JointPQPlayer,303,188,491,39,16,Player A
708,JointPQPlayer,288,193,481,38,19,Player A
709,JointPQPlayer,274,204,478,32,18,Player A
710,JointPQPlayer,223,228,451,23,24,JointPQPlayer
711,JointPQPlayer,266,206,472,32,20,Player A
712,JointPQPlayer,311,186,497,39,14,Player A
713,JointPQPlayer,109,279,388,5,39,JointPQPlayer
714,JointPQPlayer,170,250,420,16,32,JointPQPlayer
715,JointPQPlayer,289,199,488,33,15,Player A
716,JointPQPlayer,293,198,491,33,14,Player A
717,JointPQPlayer,151,261,412,11,33,JointPQPlayer
718,JointPQPlayer,142,257,399,16,39,JointPQPlayer
719,JointPQPlayer,288,198,486,34,16,Player A
720,JointPQPlayer,291,191,482,39,19,Player A
721,JointPQPlayer,130,270,400,8,36,JointPQPlayer
722,JointPQPlayer,228,223,451,26,25,Player A
723,JointPQPlayer,292,192,484,38,18,Player A
724,JointPQPlayer,120,275,395,6,37,JointPQPlayer
725,JointPQPlayer,310,185,495,40,15,Player A
726,JointPQPlayer,302,197,499,32,11,Player A
727,JointPQPlayer,263,208,471,31,20,Player A
728,JointPQPlayer,270,210,480,28,16,Player A
729,JointPQPlayer,276,201,477,34,19,Player A
730,JointPQPlayer,292,197,489,34,15,Player A
731,JointPQPlayer,303,193,496,35,13,Player A
732,JointPQPlayer,292,197,489,34,15,Player A
733,JointPQPlayer,281,201,482,33,17,Player A
734,JointPQPlayer,312,192,504,34,10,Player A
735,JointPQPlayer,308,188,496,38,14,Player A
736,JointPQPlayer,140,265,405,10,35,JointPQPlayer
737,JointPQPlayer,156,261,417,10,31,JointPQPlayer
738,JointPQPlayer,300,195,495,34,13,Player A
739,JointPQPlayer,293,193,486,37,17,Player A
740,JointPQPlayer,298,193,491,36,15,Player A
741,JointPQPlayer,275,205,480,31,17,Player A
742,JointPQPlayer,287,202,489,31,14,Player A
743,JointPQPlayer,305,190,495,37,14,Player A
744,JointPQPlayer,136,261,397,14,39,JointPQPlayer
745,JointPQPlayer,309,189,498,37,13,Player A
746,JointPQPlayer,280,200,480,34,18,Player A
747,JointPQPlayer,310,190,500,36,12,Player A
748,JointPQPlayer,303,198,501,31,10,Player A
749,JointPQPlayer,305,190,495,37,14,Player A
750,JointPQPlayer,136,256,392,18,42,JointPQPlayer
751,JointPQPlayer,138,258,396,16,40,JointPQPlayer
752,JointPQPlayer,294,194,488,36,16,Player A
753,JointPQPlayer,302,192,494,36,14,Player A
754,JointPQPlayer,294,194,488,36,16,Player A
755,JointPQPlayer,152,257,409,14,35,JointPQPlayer
756,JointPQPlayer,298,188,486,40,18,Player A
757,JointPQPlayer,160,250,410,18,36,JointPQPlayer
758,JointPQPlayer,290,195,485,36,17,Player A
759,JointPQPlayer,314,189,503,36,11,Player A
760,JointPQPlayer,171,246,417,19,34,JointPQPlayer
761,JointPQPlayer,198,233,431,24,31,JointPQPlayer
762,JointPQPlayer,281,206,487,29,14,Player A
763,JointPQPlayer,303,193,496,35,13,Player A
764,JointPQPlayer,133,263,396,13,39,JointPQPlayer
765,JointPQPlayer,280,195,475,38,21,Player A
766,JointPQPlayer,142,262,404,12,36,JointPQPlayer
767,JointPQPlayer,192,242,434,18,28,JointPQPlayer
768,JointPQPlayer,201,236,437,21,28,JointPQPlayer
769,JointPQPlayer,308,193,501,34,11,Player A
770,JointPQPlayer,301,191,492,37,15,Player A
771,JointPQPlayer,268,203,471,34,21,Player A
772,JointPQPlayer,286,196,482,36,18,Player A
773,JointPQPlayer,253,213,466,29,21,Player A
774,JointPQPlayer,269,199,468,37,23,Player A
775,JointPQPlayer,294,199,493,32,13,Player A
776,JointPQPlayer,271,206,477,31,18,Player A
777,JointPQPlayer,303,188,491,39,16,Player A
778,JointPQPlayer,302,197,499,32,11,Player A
779,JointPQPlayer,276,206,482,30,16,Player A
780,JointPQPlayer,289,199,488,33,15,Player A
781,JointPQPlayer,296,191,487,38,17,Player A
782,JointPQPlayer,253,208,461,33,24,Player A
783,JointPQPlayer,296,196,492,34,14,Player A
784,JointPQPlayer,244,219,463,26,21,Player A
785,JointPQPlayer,273,203,476,33,19,Player A
786,JointPQPlayer,304,194,498,34,12,Player A
787,JointPQPlayer,302,192,494,36,14,Player A
788,JointPQPlayer,306,201,507,28,7,Player A
789,JointPQPlayer,277,207,484,29,15,Player A
790,JointPQPlayer,298,193,491,36,15,Player A
791,JointPQPlayer,297,192,489,37,16,Player A
792,JointPQPlayer,302,192,494,36,14,Player A
793,JointPQPlayer,194,239,433,20,29,JointPQPlayer
794,JointPQPlayer,345,175,520,41,7,Player A
795,JointPQPlayer,304,189,493,38,15,Player A
796,JointPQPlayer,267,207,474,31,19,Player A
797,JointPQPlayer,281,201,482,33,17,Player A
798,JointPQPlayer,276,201,477,34,19,Player A
799,JointPQPlayer,270,205,475,32,19,Player A
800,JointPQPlayer,277,202,479,33,18,Player A
801,JointPQPlayer,296,191,487,38,17,Player A
802,JointPQPlayer,282,207,489,28,13,Player A
803,JointPQPlayer,319,184,503,39,12,Player A
804,JointPQPlayer,293,198,491,33,14,Player A
805,JointPQPlayer,316,186,502,38,12,Player A
806,JointPQPlayer,289,194,483,37,18,Player A
807,JointPQPlayer,312,192,504,34,10,Player A
808,JointPQPlayer,166,246,412,20,36,JointPQPlayer
809,JointPQPlayer,149,259,408,13,35,JointPQPlayer
810,JointPQPlayer,277,202,479,33,18,Player A
811,JointPQPlayer,302,192,494,36,14,Player A
812,JointPQPlayer,204,234,438,22,28,JointPQPlayer
813,JointPQPlayer,277,207,484,29,15,Player A
814,JointPQPlayer,144,259,403,14,37,JointPQPlayer
815,JointPQPlayer,296,191,487,38,17,Player A
816,JointPQPlayer,298,198,496,32,12,Player A
817,JointPQPlayer,319,184,503,39,12,Player A
818,JointPQPlayer,314,184,498,40,14,Player A
819,JointPQPlayer,250,215,465,28,21,Player A
820,JointPQPlayer,287,197,484,35,17,Player A
821,JointPQPlayer,155,255,410,15,35,JointPQPlayer
822,JointPQPlayer,305,195,500,33,11,Player A
823,JointPQPlayer,300,200,500,30,10,Player A
824,JointPQPlayer,152,257,409,14,35,JointPQPlayer
825,JointPQPlayer,303,193,496,35,13,Player A
826,JointPQPlayer,285,200,485,33,16,Player A
827,JointPQPlayer,321,186,507,37,10,Player A
828,JointPQPlayer,296,196,492,34,14,Player A
829,JointPQPlayer,201,236,437,21,28,JointPQPlayer
830,JointPQPlayer,281,196,477,37,20,Player A
831,JointPQPlayer,291,196,487,35,16,Player A
832,JointPQPlayer,308,188,496,38,14,Player A
833,JointPQPlayer,309,189,498,37,13,Player A
834,JointPQPlayer,305,190,495,37,14,Player A
835,JointPQPlayer,260,210,470,30,20,Player A
836,JointPQPlayer,310,195,505,32,9,Player A
837,JointPQPlayer,300,195,495,34,13,Player A
838,JointPQPlayer,123,273,396,7,37,JointPQPlayer
839,JointPQPlayer,276,201,477,34,19,Player A
840,JointPQPlayer,291,191,482,39,19,Player A
841,JointPQPlayer,179,244,423,19,32,JointPQPlayer
842,JointPQPlayer,283,203,486,31,15,Player A
843,JointPQPlayer,284,199,483,34,17,Player A
844,JointPQPlayer,295,195,490,35,15,Player A
845,JointPQPlayer,298,193,491,36,15,Player A
846,JointPQPlayer,287,202,489,31,14,Player A
847,JointPQPlayer,132,262,394,14,40,JointPQPlayer
848,JointPQPlayer,317,187,504,37,11,Player A
849,JointPQPlayer,295,195,490,35,15,Player A
850,JointPQPlayer,152,257,409,14,35,JointPQPlayer
851,JointPQPlayer,288,198,486,34,16,Player A
852,JointPQPlayer,141,256,397,17,40,JointPQPlayer
853,JointPQPlayer,305,195,500,33,11,Player A
854,JointPQPlayer,322,182,504,40,12,Player A
855,JointPQPlayer,305,190,495,37,14,Player A
856,JointPQPlayer,298,193,491,36,15,Player A
857,JointPQPlayer,294,194,488,36,16,Player A
858,JointPQPlayer,292,197,489,34,15,Player A
859,JointPQPlayer,281,201,482,33,17,Player A
860,JointPQPlayer,144,259,403,14,37,JointPQPlayer
861,JointPQPlayer,272,202,474,34,20,Player A
862,JointPQPlayer,272,197,469,38,23,Player A
863,JointPQPlayer,297,192,489,37,16,Player A
864,JointPQPlayer,311,191,502,35,11,Player A
865,JointPQPlayer,268,203,471,34,21,Player A
866,JointPQPlayer,292,202,494,30,12,Player A
867,JointPQPlayer,289,199,488,33,15,Player A
868,JointPQPlayer,253,218,471,25,18,Player A
869,JointPQPlayer,289,199,488,33,15,Player A
870,JointPQPlayer,153,253,406,17,37,JointPQPlayer
871,JointPQPlayer,284,199,483,34,17,Player A
872,JointPQPlayer,146,261,407,12,35,JointPQPlayer
873,JointPQPlayer,280,195,475,38,21,Player A
874,JointPQPlayer,274,204,478,32,18,Player A
875,JointPQPlayer,286,201,487,32,15,Player A
876,JointPQPlayer,282,197,479,36,19,Player A
877,JointPQPlayer,303,193,496,35,13,Player A
878,JointPQPlayer,304,194,498,34,12,Player A
879,JointPQPlayer,320,185,505,38,11,Player A
880,JointPQPlayer,224,224,448,26,26,Tie
881,JointPQPlayer,289,199,488,33,15,Player A
882,JointPQPlayer,298,198,496,32,12,Player A
883,JointPQPlayer,275,205,480,31,17,Player A
884,JointPQPlayer,293,198,491,33,14,Player A
885,JointPQPlayer,256,211,467,30,21,Player A
886,JointPQPlayer,286,196,482,36,18,Player A
887,JointPQPlayer,292,197,489,34,15,Player A
888,JointPQPlayer,299,194,493,35,14,Player A
889,JointPQPlayer,287,197,484,35,17,Player A
890,JointPQPlayer,283,198,481,35,18,Player A
891,JointPQPlayer,313,183,496,41,15,Player A
892,JointPQPlayer,317,192,509,33,8,Player A
893,JointPQPlayer,288,198,486,34,16,Player A
894,JointPQPlayer,135,260,395,15,40,JointPQPlayer
895,JointPQPlayer,259,209,468,31,21,Player A
896,JointPQPlayer,274,204,478,32,18,Player A
897,JointPQPlayer,137,262,399,13,38,JointPQPlayer
898,JointPQPlayer,164,259,423,10,29,JointPQPlayer
899,JointPQPlayer,288,198,486,34,16,Player A
900,JointPQPlayer,296,196,492,34,14,Player A
901,JointPQPlayer,283,198,481,35,18,Player A
902,JointPQPlayer,193,238,431,21,30,JointPQPlayer
903,JointPQPlayer,139,259,398,15,39,JointPQPlayer
904,JointPQPlayer,334,179,513,40,9,Player A
905,JointPQPlayer,312,192,504,34,10,Player A
906,JointPQPlayer,215,230,445,23,26,JointPQPlayer
907,JointPQPlayer,144,264,408,10,34,JointPQPlayer
908,JointPQPlayer,138,263,401,12,37,JointPQPlayer
909,JointPQPlayer,305,190,495,37,14,Player A
910,JointPQPlayer,288,198,486,34,16,Player A
911,JointPQPlayer,298,193,491,36,15,Player A
912,JointPQPlayer,205,230,435,25,30,JointPQPlayer
913,JointPQPlayer,291,196,487,35,16,Player A
914,JointPQPlayer,233,218,451,29,26,Player A
915,JointPQPlayer,151,256,407,15,36,JointPQPlayer
916,JointPQPlayer,229,224,453,25,24,Player A
917,JointPQPlayer,301,196,497,33,12,Player A
918,JointPQPlayer,300,195,495,34,13,Player A
919,JointPQPlayer,315,195,510,31,7,Player A
920,JointPQPlayer,290,200,490,32,14,Player A
921,JointPQPlayer,277,202,479,33,18,Player A
922,JointPQPlayer,154,254,408,16,36,JointPQPlayer
923,JointPQPlayer,294,199,493,32,13,Player A
924,JointPQPlayer,289,199,488,33,15,Player A
925,JointPQPlayer,282,202,484,32,16,Player A
926,JointPQPlayer,295,195,490,35,15,Player A
927,JointPQPlayer,296,191,487,38,17,Player A
928,JointPQPlayer,290,195,485,36,17,Player A
929,JointPQPlayer,137,262,399,13,38,JointPQPlayer
930,JointPQPlayer,287,197,484,35,17,Player A
931,JointPQPlayer,145,260,405,13,36,JointPQPlayer
932,JointPQPlayer,301,196,497,33,12,Player A
933,JointPQPlayer,292,197,489,34,15,Player A
934,JointPQPlayer,315,180,495,43,16,Player A
935,JointPQPlayer,149,259,408,13,35,JointPQPlayer
936,JointPQPlayer,310,190,500,36,12,Player A
937,JointPQPlayer,261,211,472,29,19,Player A
938,JointPQPlayer,300,195,495,34,13,Player A
939,JointPQPlayer,284,199,483,34,17,Player A
940,JointPQPlayer,282,197,479,36,19,Player A
941,JointPQPlayer,294,199,493,32,13,Player A
942,JointPQPlayer,270,210,480,28,16,Player A
943,JointPQPlayer,314,189,503,36,11,Player A
944,JointPQPlayer,302,192,494,36,14,Player A
945,JointPQPlayer,151,256,407,15,36,JointPQPlayer
946,JointPQPlayer,146,256,402,16,38,JointPQPlayer
947,JointPQPlayer,299,194,493,35,14,Player A
948,JointPQPlayer,270,205,475,32,19,Player A
949,JointPQPlayer,281,201,482,33,17,Player A
950,JointPQPlayer,186,241,427,20,31,JointPQPlayer
951,JointPQPlayer,126,261,387,16,43,JointPQPlayer
952,JointPQPlayer,301,196,497,33,12,Player A
953,JointPQPlayer,297,192,489,37,16,Player A
954,JointPQPlayer,150,255,405,16,37,JointPQPlayer
955,JointPQPlayer,310,190,500,36,12,Player A
956,JointPQPlayer,193,238,431,21,30,JointPQPlayer
957,JointPQPlayer,157,252,409,17,36,JointPQPlayer
958,JointPQPlayer,291,196,487,35,16,Player A
959,JointPQPlayer,326,181,507,40,11,Player A
960,JointPQPlayer,282,202,484,32,16,Player A
961,JointPQPlayer,149,254,403,17,38,JointPQPlayer
962,JointPQPlayer,285,200,485,33,16,Player A
963,JointPQPlayer,297,197,494,33,13,Player A
964,JointPQPlayer,291,196,487,35,16,Player A
965,JointPQPlayer,320,185,505,38,11,Player A
966,JointPQPlayer,143,258,401,15,38,JointPQPlayer
967,JointPQPlayer,288,198,486,34,16,Player A
968,JointPQPlayer,300,195,495,34,13,Player A
969,JointPQPlayer,271,206,477,31,18,Player A
970,JointPQPlayer,141,256,397,17,40,JointPQPlayer
971,JointPQPlayer,294,199,493,32,13,Player A
972,JointPQPlayer,289,194,483,37,18,Player A
973,JointPQPlayer,286,201,487,32,15,Player A
974,JointPQPlayer,294,194,488,36,16,Player A
975,JointPQPlayer,300,190,490,38,16,Player A
976,JointPQPlayer,270,210,480,28,16,Player A
977,JointPQPlayer,278,198,476,36,20,Player A
978,JointPQPlayer,291,201,492,31,13,Player A
979,JointPQPlayer,276,201,477,34,19,Player A
980,JointPQPlayer,273,208,481,29,16,Player A
981,JointPQPlayer,268,203,471,34,21,Player A
982,JointPQPlayer,253,213,466,29,21,Player A
983,JointPQPlayer,288,193,481,38,19,Player A
984,JointPQPlayer,129,264,393,13,40,JointPQPlayer
985,JointPQPlayer,285,200,485,33,16,Player A
986,JointPQPlayer,291,196,487,35,16,Player A
987,JointPQPlayer,163,253,416,15,33,JointPQPlayer
988,JointPQPlayer,270,205,475,32,19,Player A
989,JointPQPlayer,257,217,474,25,17,Player A
990,JointPQPlayer,293,193,486,37,17,Player A
991,JointPQPlayer,276,196,472,38,22,Player A
992,JointPQPlayer,242,212,454,32,26,Player A
993,JointPQPlayer,293,198,491,33,14,Player A
994,JointPQPlayer,300,185,485,42,19,Player A
995,JointPQPlayer,123,268,391,11,40,JointPQPlayer
996,JointPQPlayer,310,190,500,36,12,Player A
997,JointPQPlayer,279,199,478,35,19,Player A
998,JointPQPlayer,186,246,432,16,28,JointPQPlayer
999,JointPQPlayer,288,198,486,34,16,Player A
1000,JointPQPlayer,131,266,397,11,38,JointPQPlayer
1001,JointPQPlayer,148,258,406,14,36,JointPQPlayer
1002,JointPQPlayer,276,206,482,30,16,Player A
1003,JointPQPlayer,322,182,504,40,12,Player A
1004,JointPQPlayer,289,194,483,37,18,Player A
1005,JointPQPlayer,153,253,406,17,37,JointPQPlayer
1006,JointPQPlayer,305,190,495,37,14,Player A
1007,JointPQPlayer,154,259,413,12,33,JointPQPlayer
1008,JointPQPlayer,160,255,415,14,33,JointPQPlayer
1009,JointPQPlayer,266,206,472,32,20,Player A
1010,JointPQPlayer,294,194,488,36,16,Player A
1011,JointPQPlayer,283,203,486,31,15,Player A
1012,JointPQPlayer,313,183,496,41,15,Player A
1013,JointPQPlayer,271,201,472,35,21,Player A
1014,JointPQPlayer,287,197,484,35,17,Player A
1015,JointPQPlayer,140,265,405,10,35,JointPQPlayer
1016,JointPQPlayer,173,253,426,13,29,JointPQPlayer
1017,JointPQPlayer,324,184,508,38,10,Player A
1018,JointPQPlayer,281,201,482,33,17,Player A
1019,JointPQPlayer,249,214,463,29,22,Player A
1020,JointPQPlayer,287,197,484,35,17,Player A
1021,JointPQPlayer,315,185,500,39,13,Player A
1022,JointPQPlayer,278,203,481,32,17,Player A
1023,JointPQPlayer,127,267,394,11,39,JointPQPlayer
1024,JointPQPlayer,264,209,473,30,19,Player A
1025,JointPQPlayer,294,199,493,32,13,Player A
1026,JointPQPlayer,242,222,464,24,20,Player A
1027,JointPQPlayer,292,197,489,34,15,Player A
1028,JointPQPlayer,280,205,485,30,15,Player A
1029,JointPQPlayer,284,199,483,34,17,Player A
1030,JointPQPlayer,300,190,490,38,16,Player A
1031,JointPQPlayer,285,200,485,33,16,Player A
1032,JointPQPlayer,273,198,471,37,22,Player A
1033,JointPQPlayer,299,194,493,35,14,Player A
1034,JointPQPlayer,297,197,494,33,13,Player A
1035,JointPQPlayer,277,202,479,33,18,Player A
1036,JointPQPlayer,300,195,495,34,13,Player A
1037,JointPQPlayer,307,187,494,39,15,Player A
1038,JointPQPlayer,273,203,476,33,19,Player A
1039,JointPQPlayer,298,198,496,32,12,Player A
1040,JointPQPlayer,302,192,494,36,14,Player A
1041,JointPQPlayer,315,185,500,39,13,Player A
1042,JointPQPlayer,154,254,408,16,36,JointPQPlayer
1043,JointPQPlayer,310,185,495,40,15,Player A
1044,JointPQPlayer,307,187,494,39,15,Player A
1045,JointPQPlayer,263,208,471,31,20,Player A
1046,JointPQPlayer,298,188,486,40,18,Player A
1047,JointPQPlayer,152,252,404,18,38,JointPQPlayer
1048,JointPQPlayer,143,263,406,11,35,JointPQPlayer
1049,JointPQPlayer,308,188,496,38,14,Player A
1050,JointPQPlayer,156,251,407,18,37,JointPQPlayer
1051,JointPQPlayer,282,202,484,32,16,Player A
1052,JointPQPlayer,316,186,502,38,12,Player A
1053,JointPQPlayer,284,199,483,34,17,Player A
1054,JointPQPlayer,282,207,489,28,13,Player A
1055,JointPQPlayer,313,188,501,37,12,Player A
1056,JointPQPlayer,295,200,495,31,12,Player A
1057,JointPQPlayer,291,191,482,39,19,Player A
1058,JointPQPlayer,163,253,416,15,33,JointPQPlayer
1059,JointPQPlayer,215,230,445,23,26,JointPQPlayer
1060,JointPQPlayer,154,249,403,20,39,JointPQPlayer
1061,JointPQPlayer,154,254,408,16,36,JointPQPlayer
1062,JointPQPlayer,146,256,402,16,38,JointPQPlayer
1063,JointPQPlayer,302,192,494,36,14,Player A
1064,JointPQPlayer,305,190,495,37,14,Player A
1065,JointPQPlayer,145,260,405,13,36,JointPQPlayer
1066,JointPQPlayer,262,202,464,36,24,Player A
1067,JointPQPlayer,290,195,485,36,17,Player A
1068,JointPQPlayer,292,197,489,34,15,Player A
1069,JointPQPlayer,274,204,478,32,18,Player A
1070,JointPQPlayer,309,189,498,37,13,Player A
1071,JointPQPlayer,279,204,483,31,16,Player A
1072,JointPQPlayer,291,191,482,39,19,Player A
1073,JointPQPlayer,284,199,483,34,17,Player A
1074,JointPQPlayer,283,198,481,35,18,Player A
1075,JointPQPlayer,231,216,447,31,28,Player A
1076,JointPQPlayer,293,198,491,33,14,Player A
1077,JointPQPlayer,306,191,497,36,13,Player A
1078,JointPQPlayer,229,224,453,25,24,Player A
1079,JointPQPlayer,292,197,489,34,15,Player A
1080,JointPQPlayer,254,214,468,28,20,Player A
1081,JointPQPlayer,329,179,508,41,11,Player A
1082,JointPQPlayer,301,196,497,33,12,Player A
1083,JointPQPlayer,268,208,476,30,18,Player A
1084,JointPQPlayer,308,188,496,38,14,Player A
1085,JointPQPlayer,287,197,484,35,17,Player A
1086,JointPQPlayer,160,255,415,14,33,JointPQPlayer
1087,JointPQPlayer,294,199,493,32,13,Player A
1088,JointPQPlayer,312,192,504,34,10,Player A
1089,JointPQPlayer,140,260,400,14,38,JointPQPlayer
1090,JointPQPlayer,291,196,487,35,16,Player A
1091,JointPQPlayer,289,194,483,37,18,Player A
1092,JointPQPlayer,286,201,487,32,15,Player A
1093,JointPQPlayer,310,185,495,40,15,Player A
1094,JointPQPlayer,316,191,507,34,9,Player A
1095,JointPQPlayer,130,265,395,12,39,JointPQPlayer
1096,JointPQPlayer,307,187,494,39,15,Player A
1097,JointPQPlayer,294,199,493,32,13,Player A
1098,JointPQPlayer,286,196,482,36,18,Player A
1099,JointPQPlayer,134,269,403,8,35,JointPQPlayer
1100,JointPQPlayer,302,202,504,28,8,Player A
1101,JointPQPlayer,291,196,487,35,16,Player A
1102,JointPQPlayer,126,266,392,12,40,JointPQPlayer
1103,JointPQPlayer,307,187,494,39,15,Player A
1104,JointPQPlayer,145,260,405,13,36,JointPQPlayer
1105,JointPQPlayer,283,203,486,31,15,Player A
1106,JointPQPlayer,149,259,408,13,35,JointPQPlayer
1107,JointPQPlayer,257,207,464,33,23,Player A
1108,JointPQPlayer,322,182,504,40,12,Player A
1109,JointPQPlayer,156,261,417,10,31,JointPQPlayer
1110,JointPQPlayer,261,211,472,29,19,Player A
1111,JointPQPlayer,293,193,486,37,17,Player A
1112,JointPQPlayer,121,271,392,9,39,JointPQPlayer
1113,JointPQPlayer,285,205,490,29,13,Player A
1114,JointPQPlayer,315,190,505,35,10,Player A
1115,JointPQPlayer,323,183,506,39,11,Player A
1116,JointPQPlayer,282,197,479,36,19,Player A
1117,JointPQPlayer,311,186,497,39,14,Player A
1118,JointPQPlayer,313,183,496,41,15,Player A
1119,JointPQPlayer,283,198,481,35,18,Player A
1120,JointPQPlayer,286,201,487,32,15,Player A
1121,JointPQPlayer,218,228,446,24,26,JointPQPlayer
1122,JointPQPlayer,281,206,487,29,14,Player A
1123,JointPQPlayer,296,191,487,38,17,Player A
1124,JointPQPlayer,159,249,408,19,37,JointPQPlayer
1125,JointPQPlayer,314,194,508,32,8,Player A
1126,JointPQPlayer,295,200,495,31,12,Player A
1127,JointPQPlayer,188,238,426,22,32,JointPQPlayer
1128,JointPQPlayer,299,199,498,31,11,Player A
1129,JointPQPlayer,268,208,476,30,18,Player A
1130,JointPQPlayer,310,185,495,40,15,Player A
1131,JointPQPlayer,285,200,485,33,16,Player A
1132,JointPQPlayer,280,200,480,34,18,Player A
1133,JointPQPlayer,217,232,449,21,24,JointPQPlayer
1134,JointPQPlayer,282,202,484,32,16,Player A
1135,JointPQPlayer,311,186,497,39,14,Player A
1136,JointPQPlayer,195,240,435,19,28,JointPQPlayer
1137,JointPQPlayer,246,211,457,32,25,Player A
1138,JointPQPlayer,281,201,482,33,17,Player A
1139,JointPQPlayer,147,257,404,15,37,JointPQPlayer
1140,JointPQPlayer,310,190,500,36,12,Player A
1141,JointPQPlayer,299,189,488,39,17,Player A
1142,JointPQPlayer,306,191,497,36,13,Player A
1143,JointPQPlayer,298,193,491,36,15,Player A
1144,JointPQPlayer,293,198,491,33,14,Player A
1145,JointPQPlayer,311,186,497,39,14,Player A
1146,JointPQPlayer,296,191,487,38,17,Player A
1147,JointPQPlayer,146,261,407,12,35,JointPQPlayer
1148,JointPQPlayer,281,201,482,33,17,Player A
1149,JointPQPlayer,259,209,468,31,21,Player A
1150,JointPQPlayer,308,193,501,34,11,Player A
1151,JointPQPlayer,281,201,482,33,17,Player A
1152,JointPQPlayer,266,206,472,32,20,Player A
1153,JointPQPlayer,253,213,466,29,21,Player A
1154,JointPQPlayer,317,187,504,37,11,Player A
1155,JointPQPlayer,315,190,505,35,10,Player A
1156,JointPQPlayer,284,199,483,34,17,Player A
1157,JointPQPlayer,313,188,501,37,12,Player A
1158,JointPQPlayer,299,194,493,35,14,Player A
1159,JointPQPlayer,309,189,498,37,13,Player A
1160,JointPQPlayer,312,187,499,38,13,Player A
1161,JointPQPlayer,299,199,498,31,11,Player A
1162,JointPQPlayer,295,200,495,31,12,Player A
1163,JointPQPlayer,302,192,494,36,14,Player A
1164,JointPQPlayer,297,197,494,33,13,Player A
1165,JointPQPlayer,133,263,396,13,39,JointPQPlayer
1166,JointPQPlayer,124,264,388,14,42,JointPQPlayer
1167,JointPQPlayer,142,257,399,16,39,JointPQPlayer
1168,JointPQPlayer,279,204,483,31,16,Player A
1169,JointPQPlayer,275,205,480,31,17,Player A
1170,JointPQPlayer,291,191,482,39,19,Player A
1171,JointPQPlayer,287,197,484,35,17,Player A
1172,JointPQPlayer,271,211,482,27,15,Player A
1173,JointPQPlayer,324,184,508,38,10,Player A
1174,JointPQPlayer,300,195,495,34,13,Player A
1175,JointPQPlayer,143,253,396,19,41,JointPQPlayer
1176,JointPQPlayer,274,209,483,28,15,Player A
1177,JointPQPlayer,135,265,400,11,37,JointPQPlayer
1178,JointPQPlayer,280,200,480,34,18,Player A
1179,JointPQPlayer,275,210,485,27,14,Player A
1180,JointPQPlayer,209,234,443,21,26,JointPQPlayer
1181,JointPQPlayer,274,194,468,40,24,Player A
1182,JointPQPlayer,263,213,476,27,17,Player A
1183,JointPQPlayer,116,271,387,10,41,JointPQPlayer
1184,JointPQPlayer,274,204,478,32,18,Player A
1185,JointPQPlayer,288,198,486,34,16,Player A
1186,JointPQPlayer,297,197,494,33,13,Player A
1187,JointPQPlayer,300,195,495,34,13,Player A
1188,JointPQPlayer,297,192,489,37,16,Player A
1189,JointPQPlayer,284,199,483,34,17,Player A
1190,JointPQPlayer,319,184,503,39,12,Player A
1191,JointPQPlayer,281,201,482,33,17,Player A
1192,JointPQPlayer,325,185,510,37,9,Player A
1193,JointPQPlayer,303,193,496,35,13,Player A
1194,JointPQPlayer,299,204,503,27,8,Player A
1195,JointPQPlayer,254,214,468,28,20,Player A
1196,JointPQPlayer,156,261,417,10,31,JointPQPlayer
1197,JointPQPlayer,287,192,479,39,20,Player A
1198,JointPQPlayer,295,200,495,31,12,Player A
1199,JointPQPlayer,278,198,476,36,20,Player A
1200,JointPQPlayer,280,200,480,34,18,Player A
1201,JointPQPlayer,290,200,490,32,14,Player A
1202,JointPQPlayer,307,187,494,39,15,Player A
1203,JointPQPlayer,246,216,462,28,22,Player A
1204,JointPQPlayer,260,210,470,30,20,Player A
1205,JointPQPlayer,262,202,464,36,24,Player A
1206,JointPQPlayer,148,258,406,14,36,JointPQPlayer
1207,JointPQPlayer,271,201,472,35,21,Player A
1208,JointPQPlayer,260,220,480,22,14,Player A
1209,JointPQPlayer,161,256,417,13,32,JointPQPlayer
1210,JointPQPlayer,283,198,481,35,18,Player A
1211,JointPQPlayer,277,197,474,37,21,Player A
1212,JointPQPlayer,306,191,497,36,13,Player A
1213,JointPQPlayer,290,195,485,36,17,Player A
1214,JointPQPlayer,310,185,495,40,15,Player A
1215,JointPQPlayer,293,198,491,33,14,Player A
1216,JointPQPlayer,180,250,430,14,28,JointPQPlayer
1217,JointPQPlayer,321,186,507,37,10,Player A
1218,JointPQPlayer,274,204,478,32,18,Player A
1219,JointPQPlayer,169,249,418,17,33,JointPQPlayer
1220,JointPQPlayer,259,209,468,31,21,Player A
1221,JointPQPlayer,269,204,473,33,20,Player A
1222,JointPQPlayer,295,190,485,39,18,Player A
1223,JointPQPlayer,290,195,485,36,17,Player A
1224,JointPQPlayer,307,192,499,35,12,Player A
1225,JointPQPlayer,288,203,491,30,13,Player A
1226,JointPQPlayer,208,233,441,22,27,JointPQPlayer
1227,JointPQPlayer,140,260,400,14,38,JointPQPlayer
1228,JointPQPlayer,304,194,498,34,12,Player A
1229,JointPQPlayer,339,174,513,43,10,Player A
1230,JointPQPlayer,278,198,476,36,20,Player A
1231,JointPQPlayer,298,188,486,40,18,Player A
1232,JointPQPlayer,305,195,500,33,11,Player A
1233,JointPQPlayer,311,186,497,39,14,Player A
1234,JointPQPlayer,310,185,495,40,15,Player A
1235,JointPQPlayer,302,197,499,32,11,Player A
1236,JointPQPlayer,315,185,500,39,13,Player A
1237,JointPQPlayer,307,187,494,39,15,Player A
1238,JointPQPlayer,250,215,465,28,21,Player A
1239,JointPQPlayer,242,212,454,32,26,Player A
1240,JointPQPlayer,274,204,478,32,18,Player A
1241,JointPQPlayer,148,258,406,14,36,JointPQPlayer
1242,JointPQPlayer,130,265,395,12,39,JointPQPlayer
1243,JointPQPlayer,277,197,474,37,21,Player A
1244,JointPQPlayer,294,204,498,28,10,Player A
1245,JointPQPlayer,309,194,503,33,10,Player A
1246,JointPQPlayer,284,204,488,30,14,Player A
1247,JointPQPlayer,287,197,484,35,17,Player A
1248,JointPQPlayer,324,184,508,38,10,Player A
1249,JointPQPlayer,310,190,500,36,12,Player A
1250,JointPQPlayer,267,212,479,27,16,Player A
1251,JointPQPlayer,263,208,471,31,20,Player A
1252,JointPQPlayer,253,208,461,33,24,Player A
1253,JointPQPlayer,310,185,495,40,15,Player A
1254,JointPQPlayer,269,204,473,33,20,Player A
1255,JointPQPlayer,278,198,476,36,20,Player A
1256,JointPQPlayer,295,195,490,35,15,Player A
1257,JointPQPlayer,145,260,405,13,36,JointPQPlayer
1258,JointPQPlayer,292,197,489,34,15,Player A
1259,JointPQPlayer,138,263,401,12,37,JointPQPlayer
1260,JointPQPlayer,292,197,489,34,15,Player A
1261,JointPQPlayer,162,247,409,20,37,JointPQPlayer
1262,JointPQPlayer,296,191,487,38,17,Player A
1263,JointPQPlayer,307,187,494,39,15,Player A
1264,JointPQPlayer,150,255,405,16,37,JointPQPlayer
1265,JointPQPlayer,140,260,400,14,38,JointPQPlayer
1266,JointPQPlayer,298,193,491,36,15,Player A
1267,JointPQPlayer,304,189,493,38,15,Player A
1268,JointPQPlayer,311,186,497,39,14,Player A
1269,JointPQPlayer,294,189,483,40,19,Player A
1270,JointPQPlayer,303,198,501,31,10,Player A
1271,JointPQPlayer,308,188,496,38,14,Player A
1272,JointPQPlayer,292,197,489,34,15,Player A
1273,JointPQPlayer,263,208,471,31,20,Player A
1274,JointPQPlayer,163,253,416,15,33,JointPQPlayer
1275,JointPQPlayer,241,221,462,25,21,Player A
1276,JointPQPlayer,273,208,481,29,16,Player A
1277,JointPQPlayer,318,183,501,40,13,Player A
1278,JointPQPlayer,273,203,476,33,19,Player A
1279,JointPQPlayer,297,192,489,37,16,Player A
1280,JointPQPlayer,310,190,500,36,12,Player A
1281,JointPQPlayer,251,211,462,31,23,Player A
1282,JointPQPlayer,308,188,496,38,14,Player A
1283,JointPQPlayer,319,184,503,39,12,Player A
1284,JointPQPlayer,145,260,405,13,36,JointPQPlayer
1285,JointPQPlayer,282,202,484,32,16,Player A
1286,JointPQPlayer,279,199,478,35,19,Player A
1287,JointPQPlayer,309,194,503,33,10,Player A
1288,JointPQPlayer,154,254,408,16,36,JointPQPlayer
1289,JointPQPlayer,307,192,499,35,12,Player A
1290,JointPQPlayer,265,205,470,33,21,Player A
1291,JointPQPlayer,249,214,463,29,22,Player A
1292,JointPQPlayer,221,231,452,21,23,JointPQPlayer
1293,JointPQPlayer,290,195,485,36,17,Player A
1294,JointPQPlayer,296,196,492,34,14,Player A
1295,JointPQPlayer,283,203,486,31,15,Player A
1296,JointPQPlayer,300,195,495,34,13,Player A
1297,JointPQPlayer,277,202,479,33,18,Player A
1298,JointPQPlayer,315,185,500,39,13,Player A
1299,JointPQPlayer,151,256,407,15,36,JointPQPlayer
1300,JointPQPlayer,144,254,398,18,40,JointPQPlayer
1301,JointPQPlayer,226,226,452,24,24,Tie
1302,JointPQPlayer,283,203,486,31,15,Player A
1303,JointPQPlayer,332,182,514,38,8,Player A
1304,JointPQPlayer,257,212,469,29,20,Player A
1305,JointPQPlayer,264,204,468,34,22,Player A
1306,JointPQPlayer,291,191,482,39,19,Player A
1307,JointPQPlayer,156,256,412,14,34,JointPQPlayer
1308,JointPQPlayer,176,256,432,10,26,JointPQPlayer
1309,JointPQPlayer,315,190,505,35,10,Player A
1310,JointPQPlayer,300,195,495,34,13,Player A
1311,JointPQPlayer,313,188,501,37,12,Player A
1312,JointPQPlayer,118,268,386,12,42,JointPQPlayer
1313,JointPQPlayer,261,206,467,33,22,Player A
1314,JointPQPlayer,224,224,448,26,26,Tie
1315,JointPQPlayer,311,186,497,39,14,Player A
1316,JointPQPlayer,291,196,487,35,16,Player A
1317,JointPQPlayer,261,206,467,33,22,Player A
1318,JointPQPlayer,317,187,504,37,11,Player A
1319,JointPQPlayer,153,253,406,17,37,JointPQPlayer
1320,JointPQPlayer,303,193,496,35,13,Player A
1321,JointPQPlayer,303,193,496,35,13,Player A
1322,JointPQPlayer,291,196,487,35,16,Player A
1323,JointPQPlayer,316,181,497,42,15,Player A
1324,JointPQPlayer,301,191,492,37,15,Player A
1325,JointPQPlayer,317,187,504,37,11,Player A
1326,JointPQPlayer,289,194,483,37,18,Player A
1327,JointPQPlayer,230,220,450,28,26,Player A
1328,JointPQPlayer,311,181,492,43,17,Player A
1329,JointPQPlayer,267,202,469,35,22,Player A
1330,JointPQPlayer,161,256,417,13,32,JointPQPlayer
1331,JointPQPlayer,314,189,503,36,11,Player A
1332,JointPQPlayer,299,194,493,35,14,Player A
1333,JointPQPlayer,165,250,415,17,34,JointPQPlayer
1334,JointPQPlayer,257,212,469,29,20,Player A
1335,JointPQPlayer,252,217,469,26,19,Player A
1336,JointPQPlayer,316,186,502,38,12,Player A
1337,JointPQPlayer,225,230,455,21,22,JointPQPlayer
1338,JointPQPlayer,286,201,487,32,15,Player A
1339,JointPQPlayer,288,193,481,38,19,Player A
1340,JointPQPlayer,195,240,435,19,28,JointPQPlayer
1341,JointPQPlayer,320,180,500,42,14,Player A
1342,JointPQPlayer,302,192,494,36,14,Player A
1343,JointPQPlayer,278,198,476,36,20,Player A
1344,JointPQPlayer,281,201,482,33,17,Player A
1345,JointPQPlayer,292,192,484,38,18,Player A
1346,JointPQPlayer,144,264,408,10,34,JointPQPlayer
1347,JointPQPlayer,278,198,476,36,20,Player A
1348,JointPQPlayer,298,193,491,36,15,Player A
1349,JointPQPlayer,254,209,463,32,23,Player A
1350,JointPQPlayer,268,208,476,30,18,Player A
1351,JointPQPlayer,276,201,477,34,19,Player A
1352,JointPQPlayer,302,197,499,32,11,Player A
1353,JointPQPlayer,279,204,483,31,16,Player A
1354,JointPQPlayer,334,174,508,44,12,Player A
1355,JointPQPlayer,136,271,407,6,33,JointPQPlayer
1356,JointPQPlayer,299,194,493,35,14,Player A
1357,JointPQPlayer,309,189,498,37,13,Player A
1358,JointPQPlayer,149,254,403,17,38,JointPQPlayer
1359,JointPQPlayer,300,195,495,34,13,Player A
1360,JointPQPlayer,293,198,491,33,14,Player A
1361,JointPQPlayer,279,199,478,35,19,Player A
1362,JointPQPlayer,258,213,471,28,19,Player A
1363,JointPQPlayer,317,187,504,37,11,Player A
1364,JointPQPlayer,137,262,399,13,38,JointPQPlayer
1365,JointPQPlayer,138,268,406,8,34,JointPQPlayer
1366,JointPQPlayer,177,242,419,21,34,JointPQPlayer
1367,JointPQPlayer,293,198,491,33,14,Player A
1368,JointPQPlayer,305,190,495,37,14,Player A
1369,JointPQPlayer,299,194,493,35,14,Player A
1370,JointPQPlayer,292,197,489,34,15,Player A
1371,JointPQPlayer,303,198,501,31,10,Player A
1372,JointPQPlayer,270,200,470,36,22,Player A
1373,JointPQPlayer,285,200,485,33,16,Player A
1374,JointPQPlayer,285,200,485,33,16,Player A
1375,JointPQPlayer,297,192,489,37,16,Player A
1376,JointPQPlayer,127,262,389,15,42,JointPQPlayer
1377,JointPQPlayer,301,196,497,33,12,Player A
1378,JointPQPlayer,301,196,497,33,12,Player A
1379,JointPQPlayer,269,204,473,33,20,Player A
1380,JointPQPlayer,316,186,502,38,12,Player A
1381,JointPQPlayer,302,197,499,32,11,Player A
1382,JointPQPlayer,287,202,489,31,14,Player A
1383,JointPQPlayer,197,237,434,21,29,JointPQPlayer
1384,JointPQPlayer,141,261,402,13,37,JointPQPlayer
1385,JointPQPlayer,200,230,430,26,32,JointPQPlayer
1386,JointPQPlayer,296,196,492,34,14,Player A
1387,JointPQPlayer,303,193,496,35,13,Player A
1388,JointPQPlayer,166,251,417,16,33,JointPQPlayer
1389,JointPQPlayer,293,193,486,37,17,Player A
1390,JointPQPlayer,311,191,502,35,11,Player A
1391,JointPQPlayer,305,190,495,37,14,Player A
1392,JointPQPlayer,155,260,415,11,32,JointPQPlayer
1393,JointPQPlayer,306,191,497,36,13,Player A
1394,JointPQPlayer,310,185,495,40,15,Player A
1395,JointPQPlayer,309,194,503,33,10,Player A
1396,JointPQPlayer,163,253,416,15,33,JointPQPlayer
1397,JointPQPlayer,298,198,496,32,12,Player A
1398,JointPQPlayer,294,194,488,36,16,Player A
1399,JointPQPlayer,300,190,490,38,16,Player A
1400,JointPQPlayer,120,265,385,14,43,JointPQPlayer
1401,JointPQPlayer,284,194,478,38,20,Player A
1402,JointPQPlayer,255,210,465,31,22,Player A
1403,JointPQPlayer,187,242,429,19,30,JointPQPlayer
1404,JointPQPlayer,130,260,390,16,42,JointPQPlayer
1405,JointPQPlayer,139,259,398,15,39,JointPQPlayer
1406,JointPQPlayer,312,187,499,38,13,Player A
1407,JointPQPlayer,314,189,503,36,11,Player A
1408,JointPQPlayer,246,216,462,28,22,Player A
1409,JointPQPlayer,277,202,479,33,18,Player A
1410,JointPQPlayer,299,194,493,35,14,Player A
1411,JointPQPlayer,118,268,386,12,42,JointPQPlayer
1412,JointPQPlayer,148,263,411,10,33,JointPQPlayer
1413,JointPQPlayer,193,233,426,25,33,JointPQPlayer
1414,JointPQPlayer,155,255,410,15,35,JointPQPlayer
1415,JointPQPlayer,294,194,488,36,16,Player A
1416,JointPQPlayer,305,190,495,37,14,Player A
1417,JointPQPlayer,149,259,408,13,35,JointPQPlayer
1418,JointPQPlayer,133,263,396,13,39,JointPQPlayer
1419,JointPQPlayer,301,191,492,37,15,Player A
1420,JointPQPlayer,140,260,400,14,38,JointPQPlayer
1421,JointPQPlayer,297,192,489,37,16,Player A
1422,JointPQPlayer,298,198,496,32,12,Player A
1423,JointPQPlayer,279,204,483,31,16,Player A
1424,JointPQPlayer,301,191,492,37,15,Player A
1425,JointPQPlayer,295,195,490,35,15,Player A
1426,JointPQPlayer,294,199,493,32,13,Player A
1427,JointPQPlayer,320,185,505,38,11,Player A
1428,JointPQPlayer,319,184,503,39,12,Player A
1429,JointPQPlayer,324,184,508,38,10,Player A
1430,JointPQPlayer,262,207,469,32,21,Player A
1431,JointPQPlayer,251,216,467,27,20,Player A
1432,JointPQPlayer,278,203,481,32,17,Player A
1433,JointPQPlayer,298,193,491,36,15,Player A
1434,JointPQPlayer,339,179,518,39,7,Player A
1435,JointPQPlayer,284,199,483,34,17,Player A
1436,JointPQPlayer,202,232,434,24,30,JointPQPlayer
1437,JointPQPlayer,281,201,482,33,17,Player A
1438,JointPQPlayer,300,195,495,34,13,Player A
1439,JointPQPlayer,259,219,478,23,15,Player A
1440,JointPQPlayer,280,205,485,30,15,Player A
1441,JointPQPlayer,152,257,409,14,35,JointPQPlayer
1442,JointPQPlayer,290,195,485,36,17,Player A
1443,JointPQPlayer,318,188,506,36,10,Player A
1444,JointPQPlayer,149,259,408,13,35,JointPQPlayer
1445,JointPQPlayer,292,197,489,34,15,Player A
1446,JointPQPlayer,307,192,499,35,12,Player A
1447,JointPQPlayer,285,195,480,37,19,Player A
1448,JointPQPlayer,307,192,499,35,12,Player A
1449,JointPQPlayer,274,204,478,32,18,Player A
1450,JointPQPlayer,279,194,473,39,22,Player A
1451,JointPQPlayer,145,255,400,17,39,JointPQPlayer
1452,JointPQPlayer,312,187,499,38,13,Player A
1453,JointPQPlayer,293,193,486,37,17,Player A
1454,JointPQPlayer,296,191,487,38,17,Player A
1455,JointPQPlayer,303,188,491,39,16,Player A
1456,JointPQPlayer,139,259,398,15,39,JointPQPlayer
1457,JointPQPlayer,292,197,489,34,15,Player A
1458,JointPQPlayer,279,199,478,35,19,Player A
1459,JointPQPlayer,288,198,486,34,16,Player A
1460,JointPQPlayer,299,194,493,35,14,Player A
1461,JointPQPlayer,302,187,489,40,17,Player A
1462,JointPQPlayer,250,215,465,28,21,Player A
1463,JointPQPlayer,144,259,403,14,37,JointPQPlayer
1464,JointPQPlayer,134,274,408,4,32,JointPQPlayer
1465,JointPQPlayer,294,194,488,36,16,Player A
1466,JointPQPlayer,298,193,491,36,15,Player A
1467,JointPQPlayer,293,198,491,33,14,Player A
1468,JointPQPlayer,277,202,479,33,18,Player A
1469,JointPQPlayer,270,210,480,28,16,Player A
1470,JointPQPlayer,283,203,486,31,15,Player A
1471,JointPQPlayer,147,257,404,15,37,JointPQPlayer
1472,JointPQPlayer,289,199,488,33,15,Player A
1473,JointPQPlayer,170,250,420,16,32,JointPQPlayer
1474,JointPQPlayer,138,263,401,12,37,JointPQPlayer
1475,JointPQPlayer,307,187,494,39,15,Player A
1476,JointPQPlayer,317,187,504,37,11,Player A
1477,JointPQPlayer,149,254,403,17,38,JointPQPlayer
1478,JointPQPlayer,311,186,497,39,14,Player A
1479,JointPQPlayer,276,201,477,34,19,Player A
1480,JointPQPlayer,281,201,482,33,17,Player A
1481,JointPQPlayer,255,210,465,31,22,Player A
1482,JointPQPlayer,279,199,478,35,19,Player A
1483,JointPQPlayer,254,214,468,28,20,Player A
1484,JointPQPlayer,158,258,416,12,32,JointPQPlayer
1485,JointPQPlayer,305,195,500,33,11,Player A
1486,JointPQPlayer,280,195,475,38,21,Player A
1487,JointPQPlayer,150,260,410,12,34,JointPQPlayer
1488,JointPQPlayer,246,221,467,24,19,Player A
1489,JointPQPlayer,280,200,480,34,18,Player A
1490,JointPQPlayer,160,250,410,18,36,JointPQPlayer
1491,JointPQPlayer,163,248,411,19,36,JointPQPlayer
1492,JointPQPlayer,154,259,413,12,33,JointPQPlayer
1493,JointPQPlayer,156,256,412,14,34,JointPQPlayer
1494,JointPQPlayer,275,200,475,35,20,Player A
1495,JointPQPlayer,286,196,482,36,18,Player A
1496,JointPQPlayer,144,259,403,14,37,JointPQPlayer
1497,JointPQPlayer,286,201,487,32,15,Player A
1498,JointPQPlayer,284,199,483,34,17,Player A
1499,JointPQPlayer,319,184,503,39,12,Player A
1500,JointPQPlayer,144,254,398,18,40,JointPQPlayer
1501,JointPQPlayer,158,253,411,16,35,JointPQPlayer
1502,JointPQPlayer,182,242,424,20,32,JointPQPlayer
1503,JointPQPlayer,278,203,481,32,17,Player A
1504,JointPQPlayer,304,194,498,34,12,Player A
1505,JointPQPlayer,292,197,489,34,15,Player A
1506,JointPQPlayer,300,195,495,34,13,Player A
1507,JointPQPlayer,311,196,507,31,8,Player A
1508,JointPQPlayer,283,203,486,31,15,Player A
1509,JointPQPlayer,286,201,487,32,15,Player A
1510,JointPQPlayer,299,194,493,35,14,Player A
1511,JointPQPlayer,288,203,491,30,13,Player A
1512,JointPQPlayer,153,253,406,17,37,JointPQPlayer
1513,JointPQPlayer,241,216,457,29,24,Player A
1514,JointPQPlayer,149,264,413,9,32,JointPQPlayer
1515,JointPQPlayer,285,200,485,33,16,Player A
1516,JointPQPlayer,295,190,485,39,18,Player A
1517,JointPQPlayer,282,202,484,32,16,Player A
1518,JointPQPlayer,297,192,489,37,16,Player A
1519,JointPQPlayer,277,207,484,29,15,Player A
1520,JointPQPlayer,281,201,482,33,17,Player A
1521,JointPQPlayer,295,195,490,35,15,Player A
1522,JointPQPlayer,138,263,401,12,37,JointPQPlayer
1523,JointPQPlayer,277,202,479,33,18,Player A
1524,JointPQPlayer,263,208,471,31,20,Player A
1525,JointPQPlayer,262,212,474,28,18,Player A
1526,JointPQPlayer,313,188,501,37,12,Player A
1527,JointPQPlayer,280,200,480,34,18,Player A
1528,JointPQPlayer,320,180,500,42,14,Player A
1529,JointPQPlayer,286,196,482,36,18,Player A
1530,JointPQPlayer,289,199,488,33,15,Player A
1531,JointPQPlayer,299,189,488,39,17,Player A
1532,JointPQPlayer,327,182,509,39,10,Player A
1533,JointPQPlayer,299,189,488,39,17,Player A
1534,JointPQPlayer,325,185,510,37,9,Player A
1535,JointPQPlayer,157,252,409,17,36,JointPQPlayer
1536,JointPQPlayer,286,196,482,36,18,Player A
1537,JointPQPlayer,276,196,472,38,22,Player A
1538,JointPQPlayer,317,187,504,37,11,Player A
1539,JointPQPlayer,324,184,508,38,10,Player A
1540,JointPQPlayer,281,201,482,33,17,Player A
1541,JointPQPlayer,312,192,504,34,10,Player A
1542,JointPQPlayer,125,265,390,13,41,JointPQPlayer
1543,JointPQPlayer,291,196,487,35,16,Player A
1544,JointPQPlayer,190,240,430,20,30,JointPQPlayer
1545,JointPQPlayer,308,188,496,38,14,Player A
1546,JointPQPlayer,279,199,478,35,19,Player A
1547,JointPQPlayer,139,259,398,15,39,JointPQPlayer
1548,JointPQPlayer,300,195,495,34,13,Player A
1549,JointPQPlayer,278,203,481,32,17,Player A
1550,JointPQPlayer,291,201,492,31,13,Player A
1551,JointPQPlayer,294,199,493,32,13,Player A
1552,JointPQPlayer,277,207,484,29,15,Player A
1553,JointPQPlayer,128,263,391,14,41,JointPQPlayer
1554,JointPQPlayer,153,263,416,9,31,JointPQPlayer
1555,JointPQPlayer,205,235,440,21,27,JointPQPlayer
1556,JointPQPlayer,299,189,488,39,17,Player A
1557,JointPQPlayer,288,198,486,34,16,Player A
1558,JointPQPlayer,284,199,483,34,17,Player A
1559,JointPQPlayer,322,177,499,44,15,Player A
1560,JointPQPlayer,306,191,497,36,13,Player A
1561,JointPQPlayer,314,184,498,40,14,Player A
1562,JointPQPlayer,310,185,495,40,15,Player A
1563,JointPQPlayer,131,261,392,15,41,JointPQPlayer
1564,JointPQPlayer,294,199,493,32,13,Player A
1565,JointPQPlayer,231,221,452,27,25,Player A
1566,JointPQPlayer,312,192,504,34,10,Player A
1567,JointPQPlayer,313,193,506,33,9,Player A
1568,JointPQPlayer,144,264,408,10,34,JointPQPlayer
1569,JointPQPlayer,309,189,498,37,13,Player A
1570,JointPQPlayer,293,193,486,37,17,Player A
1571,JointPQPlayer,288,198,486,34,16,Player A
1572,JointPQPlayer,276,206,482,30,16,Player A
1573,JointPQPlayer,272,197,469,38,23,Player A
1574,JointPQPlayer,212,232,444,22,26,JointPQPlayer
1575,JointPQPlayer,227,222,449,27,26,Player A
1576,JointPQPlayer,291,191,482,39,19,Player A
1577,JointPQPlayer,252,217,469,26,19,Player A
1578,JointPQPlayer,303,193,496,35,13,Player A
1579,JointPQPlayer,148,258,406,14,36,JointPQPlayer
1580,JointPQPlayer,260,205,465,34,23,Player A
1581,JointPQPlayer,300,195,495,34,13,Player A
1582,JointPQPlayer,308,188,496,38,14,Player A
1583,JointPQPlayer,263,208,471,31,20,Player A
1584,JointPQPlayer,115,270,385,11,42,JointPQPlayer
1585,JointPQPlayer,149,259,408,13,35,JointPQPlayer
1586,JointPQPlayer,287,197,484,35,17,Player A
1587,JointPQPlayer,289,199,488,33,15,Player A
1588,JointPQPlayer,298,198,496,32,12,Player A
1589,JointPQPlayer,151,256,407,15,36,JointPQPlayer
1590,JointPQPlayer,163,248,411,19,36,JointPQPlayer
1591,JointPQPlayer,267,212,479,27,16,Player A
1592,JointPQPlayer,277,202,479,33,18,Player A
1593,JointPQPlayer,176,251,427,14,29,JointPQPlayer
1594,JointPQPlayer,274,204,478,32,18,Player A
1595,JointPQPlayer,149,259,408,13,35,JointPQPlayer
1596,JointPQPlayer,308,188,496,38,14,Player A
1597,JointPQPlayer,287,202,489,31,14,Player A
1598,JointPQPlayer,290,195,485,36,17,Player A
1599,JointPQPlayer,306,191,497,36,13,Player A
1600,JointPQPlayer,325,185,510,37,9,Player A
1601,JointPQPlayer,163,248,411,19,36,JointPQPlayer
1602,JointPQPlayer,148,263,411,10,33,JointPQPlayer
1603,JointPQPlayer,267,197,464,39,25,Player A
1604,JointPQPlayer,231,221,452,27,25,Player A
1605,JointPQPlayer,260,205,465,34,23,Player A
1606,JointPQPlayer,268,203,471,34,21,Player A
1607,JointPQPlayer,290,195,485,36,17,Player A
1608,JointPQPlayer,281,206,487,29,14,Player A
1609,JointPQPlayer,132,267,399,10,37,JointPQPlayer
1610,JointPQPlayer,301,196,497,33,12,Player A
1611,JointPQPlayer,307,192,499,35,12,Player A
1612,JointPQPlayer,295,190,485,39,18,Player A
1613,JointPQPlayer,319,184,503,39,12,Player A
1614,JointPQPlayer,247,212,459,31,24,Player A
1615,JointPQPlayer,158,243,401,24,41,JointPQPlayer
1616,JointPQPlayer,155,255,410,15,35,JointPQPlayer
1617,JointPQPlayer,317,182,499,41,14,Player A
1618,JointPQPlayer,263,208,471,31,20,Player A
1619,JointPQPlayer,291,191,482,39,19,Player A
1620,JointPQPlayer,301,196,497,33,12,Player A
1621,JointPQPlayer,147,257,404,15,37,JointPQPlayer
1622,JointPQPlayer,121,266,387,13,42,JointPQPlayer
1623,JointPQPlayer,282,202,484,32,16,Player A
1624,JointPQPlayer,168,248,416,18,34,JointPQPlayer
1625,JointPQPlayer,287,197,484,35,17,Player A
1626,JointPQPlayer,294,194,488,36,16,Player A
1627,JointPQPlayer,322,187,509,36,9,Player A
1628,JointPQPlayer,275,200,475,35,20,Player A
1629,JointPQPlayer,310,190,500,36,12,Player A
1630,JointPQPlayer,269,214,483,25,14,Player A
1631,JointPQPlayer,269,209,478,29,17,Player A
1632,JointPQPlayer,308,193,501,34,11,Player A
1633,JointPQPlayer,213,228,441,25,28,JointPQPlayer
1634,JointPQPlayer,283,203,486,31,15,Player A
1635,JointPQPlayer,322,187,509,36,9,Player A
1636,JointPQPlayer,140,265,405,10,35,JointPQPlayer
1637,JointPQPlayer,302,187,489,40,17,Player A
1638,JointPQPlayer,288,198,486,34,16,Player A
1639,JointPQPlayer,266,201,467,36,23,Player A
1640,JointPQPlayer,312,182,494,42,16,Player A
1641,JointPQPlayer,294,194,488,36,16,Player A
1642,JointPQPlayer,290,200,490,32,14,Player A
1643,JointPQPlayer,280,205,485,30,15,Player A
1644,JointPQPlayer,266,206,472,32,20,Player A
1645,JointPQPlayer,283,198,481,35,18,Player A
1646,JointPQPlayer,311,191,502,35,11,Player A
1647,JointPQPlayer,288,198,486,34,16,Player A
1648,JointPQPlayer,252,212,464,30,22,Player A
1649,JointPQPlayer,260,200,460,38,26,Player A
1650,JointPQPlayer,224,224,448,26,26,Tie
1651,JointPQPlayer,245,215,460,29,23,Player A
1652,JointPQPlayer,276,201,477,34,19,Player A
1653,JointPQPlayer,290,200,490,32,14,Player A
1654,JointPQPlayer,295,195,490,35,15,Player A
1655,JointPQPlayer,297,192,489,37,16,Player A
1656,JointPQPlayer,297,192,489,37,16,Player A
1657,JointPQPlayer,268,208,476,30,18,Player A
1658,JointPQPlayer,282,202,484,32,16,Player A
1659,JointPQPlayer,284,194,478,38,20,Player A
1660,JointPQPlayer,140,260,400,14,38,JointPQPlayer
1661,JointPQPlayer,270,205,475,32,19,Player A
1662,JointPQPlayer,295,195,490,35,15,Player A
1663,JointPQPlayer,288,198,486,34,16,Player A
1664,JointPQPlayer,310,195,505,32,9,Player A
1665,JointPQPlayer,262,207,469,32,21,Player A
1666,JointPQPlayer,134,264,398,12,38,JointPQPlayer
1667,JointPQPlayer,285,195,480,37,19,Player A
1668,JointPQPlayer,154,249,403,20,39,JointPQPlayer
1669,JointPQPlayer,322,187,509,36,9,Player A
1670,JointPQPlayer,149,259,408,13,35,JointPQPlayer
1671,JointPQPlayer,174,244,418,20,34,JointPQPlayer
1672,JointPQPlayer,320,185,505,38,11,Player A
1673,JointPQPlayer,288,198,486,34,16,Player A
1674,JointPQPlayer,280,210,490,26,12,Player A
1675,JointPQPlayer,288,203,491,30,13,Player A
1676,JointPQPlayer,294,204,498,28,10,Player A
1677,JointPQPlayer,166,246,412,20,36,JointPQPlayer
1678,JointPQPlayer,159,254,413,15,34,JointPQPlayer
1679,JointPQPlayer,150,250,400,20,40,JointPQPlayer
1680,JointPQPlayer,290,190,480,40,20,Player A
1681,JointPQPlayer,293,198,491,33,14,Player A
1682,JointPQPlayer,264,214,478,26,16,Player A
1683,JointPQPlayer,145,260,405,13,36,JointPQPlayer
1684,JointPQPlayer,318,183,501,40,13,Player A
1685,JointPQPlayer,139,259,398,15,39,JointPQPlayer
1686,JointPQPlayer,307,187,494,39,15,Player A
1687,JointPQPlayer,128,263,391,14,41,JointPQPlayer
1688,JointPQPlayer,271,211,482,27,15,Player A
1689,JointPQPlayer,271,201,472,35,21,Player A
1690,JointPQPlayer,145,260,405,13,36,JointPQPlayer
1691,JointPQPlayer,141,256,397,17,40,JointPQPlayer
1692,JointPQPlayer,282,197,479,36,19,Player A
1693,JointPQPlayer,303,188,491,39,16,Player A
1694,JointPQPlayer,141,261,402,13,37,JointPQPlayer
1695,JointPQPlayer,311,186,497,39,14,Player A
1696,JointPQPlayer,275,205,480,31,17,Player A
1697,JointPQPlayer,247,212,459,31,24,Player A
1698,JointPQPlayer,302,187,489,40,17,Player A
1699,JointPQPlayer,278,203,481,32,17,Player A
1700,JointPQPlayer,294,189,483,40,19,Player A
1701,JointPQPlayer,152,252,404,18,38,JointPQPlayer
1702,JointPQPlayer,304,189,493,38,15,Player A
1703,JointPQPlayer,188,243,431,18,29,JointPQPlayer
1704,JointPQPlayer,295,195,490,35,15,Player A
1705,JointPQPlayer,282,197,479,36,19,Player A
1706,JointPQPlayer,283,203,486,31,15,Player A
1707,JointPQPlayer,283,198,481,35,18,Player A
1708,JointPQPlayer,286,196,482,36,18,Player A
1709,JointPQPlayer,150,260,410,12,34,JointPQPlayer
1710,JointPQPlayer,149,259,408,13,35,JointPQPlayer
1711,JointPQPlayer,292,202,494,30,12,Player A
1712,JointPQPlayer,318,193,511,32,7,Player A
1713,JointPQPlayer,299,189,488,39,17,Player A
1714,JointPQPlayer,272,197,469,38,23,Player A
1715,JointPQPlayer,306,191,497,36,13,Player A
1716,JointPQPlayer,288,193,481,38,19,Player A
1717,JointPQPlayer,275,205,480,31,17,Player A
1718,JointPQPlayer,253,213,466,29,21,Player A
1719,JointPQPlayer,285,205,490,29,13,Player A
1720,JointPQPlayer,208,228,436,26,30,JointPQPlayer
1721,JointPQPlayer,302,192,494,36,14,Player A
1722,JointPQPlayer,294,194,488,36,16,Player A
1723,JointPQPlayer,268,208,476,30,18,Player A
1724,JointPQPlayer,266,206,472,32,20,Player A
1725,JointPQPlayer,298,193,491,36,15,Player A
1726,JointPQPlayer,293,193,486,37,17,Player A
1727,JointPQPlayer,317,187,504,37,11,Player A
1728,JointPQPlayer,279,199,478,35,19,Player A
1729,JointPQPlayer,313,193,506,33,9,Player A
1730,JointPQPlayer,240,220,460,26,22,Player A
1731,JointPQPlayer,221,226,447,25,26,JointPQPlayer
1732,JointPQPlayer,307,187,494,39,15,Player A
1733,JointPQPlayer,292,197,489,34,15,Player A
1734,JointPQPlayer,252,212,464,30,22,Player A
1735,JointPQPlayer,286,201,487,32,15,Player A
1736,JointPQPlayer,300,195,495,34,13,Player A
1737,JointPQPlayer,298,193,491,36,15,Player A
1738,JointPQPlayer,311,186,497,39,14,Player A
1739,JointPQPlayer,282,197,479,36,19,Player A
1740,JointPQPlayer,304,189,493,38,15,Player A
1741,JointPQPlayer,156,256,412,14,34,JointPQPlayer
1742,JointPQPlayer,286,191,477,40,21,Player A
1743,JointPQPlayer,277,202,479,33,18,Player A
1744,JointPQPlayer,148,263,411,10,33,JointPQPlayer
1745,JointPQPlayer,138,263,401,12,37,JointPQPlayer
1746,JointPQPlayer,155,250,405,19,38,JointPQPlayer
1747,JointPQPlayer,264,204,468,34,22,Player A
1748,JointPQPlayer,286,201,487,32,15,Player A
1749,JointPQPlayer,312,187,499,38,13,Player A
1750,JointPQPlayer,277,202,479,33,18,Player A
1751,JointPQPlayer,140,255,395,18,41,JointPQPlayer
1752,JointPQPlayer,328,183,511,38,9,Player A
1753,JointPQPlayer,278,203,481,32,17,Player A
1754,JointPQPlayer,309,189,498,37,13,Player A
1755,JointPQPlayer,158,248,406,20,38,JointPQPlayer
1756,JointPQPlayer,304,194,498,34,12,Player A
1757,JointPQPlayer,290,200,490,32,14,Player A
1758,JointPQPlayer,349,179,528,37,3,Player A
1759,JointPQPlayer,285,200,485,33,16,Player A
1760,JointPQPlayer,285,200,485,33,16,Player A
1761,JointPQPlayer,281,201,482,33,17,Player A
1762,JointPQPlayer,279,194,473,39,22,Player A
1763,JointPQPlayer,153,253,406,17,37,JointPQPlayer
1764,JointPQPlayer,298,193,491,36,15,Player A
1765,JointPQPlayer,277,202,479,33,18,Player A
1766,JointPQPlayer,283,198,481,35,18,Player A
1767,JointPQPlayer,308,188,496,38,14,Player A
1768,JointPQPlayer,300,190,490,38,16,Player A
1769,JointPQPlayer,141,261,402,13,37,JointPQPlayer
1770,JointPQPlayer,291,196,487,35,16,Player A
1771,JointPQPlayer,287,202,489,31,14,Player A
1772,JointPQPlayer,191,241,432,19,29,JointPQPlayer
1773,JointPQPlayer,302,192,494,36,14,Player A
1774,JointPQPlayer,270,205,475,32,19,Player A
1775,JointPQPlayer,283,198,481,35,18,Player A
1776,JointPQPlayer,281,196,477,37,20,Player A
1777,JointPQPlayer,276,206,482,30,16,Player A
1778,JointPQPlayer,267,207,474,31,19,Player A
1779,JointPQPlayer,279,204,483,31,16,Player A
1780,JointPQPlayer,291,196,487,35,16,Player A
1781,JointPQPlayer,136,266,402,10,36,JointPQPlayer
1782,JointPQPlayer,263,208,471,31,20,Player A
1783,JointPQPlayer,268,208,476,30,18,Player A
1784,JointPQPlayer,294,194,488,36,16,Player A
1785,JointPQPlayer,185,255,440,9,23,JointPQPlayer
1786,JointPQPlayer,262,207,469,32,21,Player A
1787,JointPQPlayer,318,188,506,36,10,Player A
1788,JointPQPlayer,156,256,412,14,34,JointPQPlayer
1789,JointPQPlayer,316,186,502,38,12,Player A
1790,JointPQPlayer,291,191,482,39,19,Player A
1791,JointPQPlayer,317,182,499,41,14,Player A
1792,JointPQPlayer,138,263,401,12,37,JointPQPlayer
1793,JointPQPlayer,299,189,488,39,17,Player A
1794,JointPQPlayer,131,261,392,15,41,JointPQPlayer
1795,JointPQPlayer,299,194,493,35,14,Player A
1796,JointPQPlayer,252,217,469,26,19,Player A
1797,JointPQPlayer,264,209,473,30,19,Player A
1798,JointPQPlayer,303,193,496,35,13,Player A
1799,JointPQPlayer,158,258,416,12,32,JointPQPlayer
1800,JointPQPlayer,282,202,484,32,16,Player A
1801,JointPQPlayer,278,203,481,32,17,Player A
1802,JointPQPlayer,297,197,494,33,13,Player A
1803,JointPQPlayer,141,256,397,17,40,JointPQPlayer
1804,JointPQPlayer,303,193,496,35,13,Player A
1805,JointPQPlayer,295,195,490,35,15,Player A
1806,JointPQPlayer,295,190,485,39,18,Player A
1807,JointPQPlayer,143,263,406,11,35,JointPQPlayer
1808,JointPQPlayer,328,178,506,42,12,Player A
1809,JointPQPlayer,307,187,494,39,15,Player A
1810,JointPQPlayer,300,195,495,34,13,Player A
1811,JointPQPlayer,308,193,501,34,11,Player A
1812,JointPQPlayer,121,266,387,13,42,JointPQPlayer
1813,JointPQPlayer,254,204,458,36,26,Player A
1814,JointPQPlayer,116,271,387,10,41,JointPQPlayer
1815,JointPQPlayer,262,212,474,28,18,Player A
1816,JointPQPlayer,142,257,399,16,39,JointPQPlayer
1817,JointPQPlayer,307,187,494,39,15,Player A
1818,JointPQPlayer,138,258,396,16,40,JointPQPlayer
1819,JointPQPlayer,142,257,399,16,39,JointPQPlayer
1820,JointPQPlayer,217,227,444,25,27,JointPQPlayer
1821,JointPQPlayer,284,194,478,38,20,Player A
1822,JointPQPlayer,296,191,487,38,17,Player A
1823,JointPQPlayer,287,197,484,35,17,Player A
1824,JointPQPlayer,157,257,414,13,33,JointPQPlayer
1825,JointPQPlayer,286,201,487,32,15,Player A
1826,JointPQPlayer,290,195,485,36,17,Player A
1827,JointPQPlayer,156,261,417,10,31,JointPQPlayer
1828,JointPQPlayer,291,196,487,35,16,Player A
1829,JointPQPlayer,149,254,403,17,38,JointPQPlayer
1830,JointPQPlayer,148,253,401,18,39,JointPQPlayer
1831,JointPQPlayer,266,201,467,36,23,Player A
1832,JointPQPlayer,227,227,454,23,23,Tie
1833,JointPQPlayer,161,251,412,17,35,JointPQPlayer
1834,JointPQPlayer,286,196,482,36,18,Player A
1835,JointPQPlayer,286,196,482,36,18,Player A
1836,JointPQPlayer,287,197,484,35,17,Player A
1837,JointPQPlayer,326,181,507,40,11,Player A
1838,JointPQPlayer,271,206,477,31,18,Player A
1839,JointPQPlayer,133,263,396,13,39,JointPQPlayer
1840,JointPQPlayer,139,254,393,19,42,JointPQPlayer
1841,JointPQPlayer,270,210,480,28,16,Player A
1842,JointPQPlayer,161,256,417,13,32,JointPQPlayer
1843,JointPQPlayer,249,214,463,29,22,Player A
1844,JointPQPlayer,310,185,495,40,15,Player A
1845,JointPQPlayer,305,195,500,33,11,Player A
1846,JointPQPlayer,118,268,386,12,42,JointPQPlayer
1847,JointPQPlayer,273,203,476,33,19,Player A
1848,JointPQPlayer,301,186,487,41,18,Player A
1849,JointPQPlayer,264,214,478,26,16,Player A
1850,JointPQPlayer,261,211,472,29,19,Player A
1851,JointPQPlayer,274,204,478,32,18,Player A
1852,JointPQPlayer,306,191,497,36,13,Player A
1853,JointPQPlayer,262,207,469,32,21,Player A
1854,JointPQPlayer,267,202,469,35,22,Player A
1855,JointPQPlayer,288,198,486,34,16,Player A
1856,JointPQPlayer,284,199,483,34,17,Player A
1857,JointPQPlayer,226,226,452,24,24,Tie
1858,JointPQPlayer,312,192,504,34,10,Player A
1859,JointPQPlayer,302,192,494,36,14,Player A
1860,JointPQPlayer,313,183,496,41,15,Player A
1861,JointPQPlayer,309,194,503,33,10,Player A
1862,JointPQPlayer,326,176,502,44,14,Player A
1863,JointPQPlayer,221,226,447,25,26,JointPQPlayer
1864,JointPQPlayer,295,195,490,35,15,Player A
1865,JointPQPlayer,311,186,497,39,14,Player A
1866,JointPQPlayer,292,197,489,34,15,Player A
1867,JointPQPlayer,279,199,478,35,19,Player A
1868,JointPQPlayer,307,187,494,39,15,Player A
1869,JointPQPlayer,285,200,485,33,16,Player A
1870,JointPQPlayer,284,204,488,30,14,Player A
1871,JointPQPlayer,301,191,492,37,15,Player A
1872,JointPQPlayer,314,184,498,40,14,Player A
1873,JointPQPlayer,299,194,493,35,14,Player A
1874,JointPQPlayer,123,263,386,15,43,JointPQPlayer
1875,JointPQPlayer,317,187,504,37,11,Player A
1876,JointPQPlayer,283,203,486,31,15,Player A
1877,JointPQPlayer,153,258,411,13,34,JointPQPlayer
1878,JointPQPlayer,139,264,403,11,36,JointPQPlayer
1879,JointPQPlayer,291,196,487,35,16,Player A
1880,JointPQPlayer,295,195,490,35,15,Player A
1881,JointPQPlayer,130,265,395,12,39,JointPQPlayer
1882,JointPQPlayer,322,182,504,40,12,Player A
1883,JointPQPlayer,294,199,493,32,13,Player A
1884,JointPQPlayer,147,257,404,15,37,JointPQPlayer
1885,JointPQPlayer,283,193,476,39,21,Player A
1886,JointPQPlayer,245,210,455,33,26,Player A
1887,JointPQPlayer,252,217,469,26,19,Player A
1888,JointPQPlayer,148,258,406,14,36,JointPQPlayer
1889,JointPQPlayer,136,261,397,14,39,JointPQPlayer
1890,JointPQPlayer,311,191,502,35,11,Player A
1891,JointPQPlayer,151,256,407,15,36,JointPQPlayer
1892,JointPQPlayer,302,192,494,36,14,Player A
1893,JointPQPlayer,290,195,485,36,17,Player A
1894,JointPQPlayer,149,259,408,13,35,JointPQPlayer
1895,JointPQPlayer,156,256,412,14,34,JointPQPlayer
1896,JointPQPlayer,126,266,392,12,40,JointPQPlayer
1897,JointPQPlayer,291,201,492,31,13,Player A
1898,JointPQPlayer,298,188,486,40,18,Player A
1899,JointPQPlayer,283,198,481,35,18,Player A
1900,JointPQPlayer,303,198,501,31,10,Player A
1901,JointPQPlayer,297,192,489,37,16,Player A
1902,JointPQPlayer,286,196,482,36,18,Player A
1903,JointPQPlayer,269,209,478,29,17,Player A
1904,JointPQPlayer,308,183,491,42,17,Player A
1905,JointPQPlayer,293,193,486,37,17,Player A
1906,JointPQPlayer,303,193,496,35,13,Player A
1907,JointPQPlayer,302,197,499,32,11,Player A
1908,JointPQPlayer,291,201,492,31,13,Player A
1909,JointPQPlayer,291,196,487,35,16,Player A
1910,JointPQPlayer,277,202,479,33,18,Player A
1911,JointPQPlayer,290,195,485,36,17,Player A
1912,JointPQPlayer,316,191,507,34,9,Player A
1913,JointPQPlayer,289,194,483,37,18,Player A
1914,JointPQPlayer,248,218,466,26,20,Player A
1915,JointPQPlayer,286,196,482,36,18,Player A
1916,JointPQPlayer,269,204,473,33,20,Player A
1917,JointPQPlayer,288,203,491,30,13,Player A
1918,JointPQPlayer,283,208,491,27,12,Player A
1919,JointPQPlayer,271,211,482,27,15,Player A
1920,JointPQPlayer,250,215,465,28,21,Player A
1921,JointPQPlayer,282,197,479,36,19,Player A
1922,JointPQPlayer,278,203,481,32,17,Player A
1923,JointPQPlayer,286,196,482,36,18,Player A
1924,JointPQPlayer,165,250,415,17,34,JointPQPlayer
1925,JointPQPlayer,304,189,493,38,15,Player A
1926,JointPQPlayer,134,264,398,12,38,JointPQPlayer
1927,JointPQPlayer,275,205,480,31,17,Player A
1928,JointPQPlayer,304,194,498,34,12,Player A
1929,JointPQPlayer,282,202,484,32,16,Player A
1930,JointPQPlayer,306,191,497,36,13,Player A
1931,JointPQPlayer,230,220,450,28,26,Player A
1932,JointPQPlayer,287,202,489,31,14,Player A
1933,JointPQPlayer,268,203,471,34,21,Player A
1934,JointPQPlayer,315,180,495,43,16,Player A
1935,JointPQPlayer,287,197,484,35,17,Player A
1936,JointPQPlayer,258,208,466,32,22,Player A
1937,JointPQPlayer,108,273,381,10,43,JointPQPlayer
1938,JointPQPlayer,132,262,394,14,40,JointPQPlayer
1939,JointPQPlayer,159,249,408,19,37,JointPQPlayer
1940,JointPQPlayer,299,199,498,31,11,Player A
1941,JointPQPlayer,283,203,486,31,15,Player A
1942,JointPQPlayer,281,201,482,33,17,Player A
1943,JointPQPlayer,289,194,483,37,18,Player A
1944,JointPQPlayer,288,198,486,34,16,Player A
1945,JointPQPlayer,216,231,447,22,25,JointPQPlayer
1946,JointPQPlayer,290,195,485,36,17,Player A
1947,JointPQPlayer,282,202,484,32,16,Player A
1948,JointPQPlayer,270,205,475,32,19,Player A
1949,JointPQPlayer,131,266,397,11,38,JointPQPlayer
1950,JointPQPlayer,325,180,505,41,12,Player A
1951,JointPQPlayer,264,204,468,34,22,Player A
1952,JointPQPlayer,142,257,399,16,39,JointPQPlayer
1953,JointPQPlayer,281,206,487,29,14,Player A
1954,JointPQPlayer,127,267,394,11,39,JointPQPlayer
1955,JointPQPlayer,307,192,499,35,12,Player A
1956,JointPQPlayer,288,198,486,34,16,Player A
1957,JointPQPlayer,247,212,459,31,24,Player A
1958,JointPQPlayer,275,200,475,35,20,Player A
1959,JointPQPlayer,211,226,437,27,30,JointPQPlayer
1960,JointPQPlayer,283,198,481,35,18,Player A
1961,JointPQPlayer,269,199,468,37,23,Player A
1962,JointPQPlayer,204,234,438,22,28,JointPQPlayer
1963,JointPQPlayer,288,198,486,34,16,Player A
1964,JointPQPlayer,305,190,495,37,14,Player A
1965,JointPQPlayer,305,185,490,41,17,Player A
1966,JointPQPlayer,127,267,394,11,39,JointPQPlayer
1967,JointPQPlayer,277,207,484,29,15,Player A
1968,JointPQPlayer,288,193,481,38,19,Player A
1969,JointPQPlayer,288,198,486,34,16,Player A
1970,JointPQPlayer,141,261,402,13,37,JointPQPlayer
1971,JointPQPlayer,158,258,416,12,32,JointPQPlayer
1972,JointPQPlayer,282,202,484,32,16,Player A
1973,JointPQPlayer,293,193,486,37,17,Player A
1974,JointPQPlayer,231,226,457,23,22,Player A
1975,JointPQPlayer,129,269,398,9,37,JointPQPlayer
1976,JointPQPlayer,321,186,507,37,10,Player A
1977,JointPQPlayer,131,261,392,15,41,JointPQPlayer
1978,JointPQPlayer,226,226,452,24,24,Tie
1979,JointPQPlayer,272,202,474,34,20,Player A
1980,JointPQPlayer,304,189,493,38,15,Player A
1981,JointPQPlayer,144,259,403,14,37,JointPQPlayer
1982,JointPQPlayer,291,196,487,35,16,Player A
1983,JointPQPlayer,303,198,501,31,10,Player A
1984,JointPQPlayer,309,194,503,33,10,Player A
1985,JointPQPlayer,304,189,493,38,15,Player A
1986,JointPQPlayer,288,198,486,34,16,Player A
1987,JointPQPlayer,261,206,467,33,22,Player A
1988,JointPQPlayer,316,186,502,38,12,Player A
1989,JointPQPlayer,319,184,503,39,12,Player A
1990,JointPQPlayer,293,198,491,33,14,Player A
1991,JointPQPlayer,158,253,411,16,35,JointPQPlayer
1992,JointPQPlayer,297,192,489,37,16,Player A
1993,JointPQPlayer,300,195,495,34,13,Player A
1994,JointPQPlayer,259,204,463,35,24,Player A
1995,JointPQPlayer,304,194,498,34,12,Player A
1996,JointPQPlayer,149,259,408,13,35,JointPQPlayer
1997,JointPQPlayer,313,188,501,37,12,Player A
1998,JointPQPlayer,302,197,499,32,11,Player A
1999,JointPQPlayer,286,201,487,32,15,Player A
2000,JointPQPlayer,281,206,487,29,14,Player A
2001,JointPQPlayer,256,211,467,30,21,Player A
2002,JointPQPlayer,219,224,443,27,28,JointPQPlayer
2003,JointPQPlayer,283,203,486,31,15,Player A
2004,JointPQPlayer,309,189,498,37,13,Player A
2005,JointPQPlayer,297,192,489,37,16,Player A
2006,JointPQPlayer,298,193,491,36,15,Player A
2007,JointPQPlayer,293,198,491,33,14,Player A
2008,JointPQPlayer,288,198,486,34,16,Player A
2009,JointPQPlayer,272,202,474,34,20,Player A
2010,JointPQPlayer,280,200,480,34,18,Player A
2011,JointPQPlayer,308,188,496,38,14,Player A
2012,JointPQPlayer,298,193,491,36,15,Player A
2013,JointPQPlayer,281,201,482,33,17,Player A
2014,JointPQPlayer,264,204,468,34,22,Player A
2015,JointPQPlayer,267,207,474,31,19,Player A
2016,JointPQPlayer,131,266,397,11,38,JointPQPlayer
2017,JointPQPlayer,283,198,481,35,18,Player A
2018,JointPQPlayer,291,196,487,35,16,Player A
2019,JointPQPlayer,275,205,480,31,17,Player A
2020,JointPQPlayer,243,223,466,23,19,Player A
2021,JointPQPlayer,169,254,423,13,30,JointPQPlayer
2022,JointPQPlayer,177,247,424,17,31,JointPQPlayer
2023,JointPQPlayer,302,192,494,36,14,Player A
2024,JointPQPlayer,306,191,497,36,13,Player A
2025,JointPQPlayer,149,259,408,13,35,JointPQPlayer
2026,JointPQPlayer,287,202,489,31,14,Player A
2027,JointPQPlayer,251,211,462,31,23,Player A
2028,JointPQPlayer,258,203,461,36,25,Player A
2029,JointPQPlayer,289,194,483,37,18,Player A
2030,JointPQPlayer,270,210,480,28,16,Player A
2031,JointPQPlayer,308,188,496,38,14,Player A
2032,JointPQPlayer,265,205,470,33,21,Player A
2033,JointPQPlayer,293,193,486,37,17,Player A
2034,JointPQPlayer,259,214,473,27,18,Player A
2035,JointPQPlayer,137,262,399,13,38,JointPQPlayer
2036,JointPQPlayer,274,199,473,36,21,Player A
2037,JointPQPlayer,146,261,407,12,35,JointPQPlayer
2038,JointPQPlayer,158,253,411,16,35,JointPQPlayer
2039,JointPQPlayer,309,189,498,37,13,Player A
2040,JointPQPlayer,300,190,490,38,16,Player A
2041,JointPQPlayer,277,202,479,33,18,Player A
2042,JointPQPlayer,304,194,498,34,12,Player A
2043,JointPQPlayer,321,181,502,41,13,Player A
2044,JointPQPlayer,169,244,413,21,36,JointPQPlayer
2045,JointPQPlayer,300,195,495,34,13,Player A
2046,JointPQPlayer,160,250,410,18,36,JointPQPlayer
2047,JointPQPlayer,287,197,484,35,17,Player A
2048,JointPQPlayer,308,193,501,34,11,Player A
2049,JointPQPlayer,312,187,499,38,13,Player A
2050,JointPQPlayer,308,183,491,42,17,Player A
2051,JointPQPlayer,290,190,480,40,20,Player A
2052,JointPQPlayer,251,211,462,31,23,Player A
2053,JointPQPlayer,266,201,467,36,23,Player A
2054,JointPQPlayer,144,259,403,14,37,JointPQPlayer
2055,JointPQPlayer,300,190,490,38,16,Player A
2056,JointPQPlayer,117,267,384,13,43,JointPQPlayer
2057,JointPQPlayer,140,265,405,10,35,JointPQPlayer
2058,JointPQPlayer,291,196,487,35,16,Player A
2059,JointPQPlayer,133,263,396,13,39,JointPQPlayer
2060,JointPQPlayer,298,198,496,32,12,Player A
2061,JointPQPlayer,274,199,473,36,21,Player A
2062,JointPQPlayer,197,242,439,17,26,JointPQPlayer
2063,JointPQPlayer,306,191,497,36,13,Player A
2064,JointPQPlayer,155,255,410,15,35,JointPQPlayer
2065,JointPQPlayer,296,196,492,34,14,Player A
2066,JointPQPlayer,285,195,480,37,19,Player A
2067,JointPQPlayer,255,215,470,27,19,Player A
2068,JointPQPlayer,287,202,489,31,14,Player A
2069,JointPQPlayer,258,213,471,28,19,Player A
2070,JointPQPlayer,254,214,468,28,20,Player A
2071,JointPQPlayer,303,193,496,35,13,Player A
2072,JointPQPlayer,154,249,403,20,39,JointPQPlayer
2073,JointPQPlayer,297,192,489,37,16,Player A
2074,JointPQPlayer,293,193,486,37,17,Player A
2075,JointPQPlayer,152,257,409,14,35,JointPQPlayer
2076,JointPQPlayer,153,258,411,13,34,JointPQPlayer
2077,JointPQPlayer,281,201,482,33,17,Player A
2078,JointPQPlayer,307,192,499,35,12,Player A
2079,JointPQPlayer,183,248,431,15,28,JointPQPlayer
2080,JointPQPlayer,254,214,468,28,20,Player A
2081,JointPQPlayer,154,259,413,12,33,JointPQPlayer
2082,JointPQPlayer,278,203,481,32,17,Player A
2083,JointPQPlayer,232,227,459,22,21,Player A
2084,JointPQPlayer,302,192,494,36,14,Player A
2085,JointPQPlayer,293,198,491,33,14,Player A
2086,JointPQPlayer,140,265,405,10,35,JointPQPlayer
2087,JointPQPlayer,276,201,477,34,19,Player A
2088,JointPQPlayer,282,197,479,36,19,Player A
2089,JointPQPlayer,280,200,480,34,18,Player A
2090,JointPQPlayer,318,183,501,40,13,Player A
2091,JointPQPlayer,272,202,474,34,20,Player A
2092,JointPQPlayer,287,202,489,31,14,Player A
2093,JointPQPlayer,210,230,440,24,28,JointPQPlayer
2094,JointPQPlayer,275,210,485,27,14,Player A
2095,JointPQPlayer,286,191,477,40,21,Player A
2096,JointPQPlayer,227,222,449,27,26,Player A
2097,JointPQPlayer,275,200,475,35,20,Player A
2098,JointPQPlayer,264,199,463,38,25,Player A
2099,JointPQPlayer,314,194,508,32,8,Player A
2100,JointPQPlayer,127,267,394,11,39,JointPQPlayer
2101,JointPQPlayer,295,195,490,35,15,Player A
2102,JointPQPlayer,250,220,470,24,18,Player A
2103,JointPQPlayer,306,191,497,36,13,Player A
2104,JointPQPlayer,293,198,491,33,14,Player A
2105,JointPQPlayer,336,181,517,38,7,Player A
2106,JointPQPlayer,302,192,494,36,14,Player A
2107,JointPQPlayer,284,199,483,34,17,Player A
2108,JointPQPlayer,164,254,418,14,32,JointPQPlayer
2109,JointPQPlayer,142,257,399,16,39,JointPQPlayer
2110,JointPQPlayer,257,207,464,33,23,Player A
2111,JointPQPlayer,284,204,488,30,14,Player A
2112,JointPQPlayer,127,267,394,11,39,JointPQPlayer
2113,JointPQPlayer,306,191,497,36,13,Player A
2114,JointPQPlayer,302,192,494,36,14,Player A
2115,JointPQPlayer,307,192,499,35,12,Player A
2116,JointPQPlayer,303,198,501,31,10,Player A
2117,JointPQPlayer,271,201,472,35,21,Player A
2118,JointPQPlayer,328,178,506,42,12,Player A
2119,JointPQPlayer,155,265,420,7,29,JointPQPlayer
2120,JointPQPlayer,153,258,411,13,34,JointPQPlayer
2121,JointPQPlayer,148,263,411,10,33,JointPQPlayer
2122,JointPQPlayer,136,261,397,14,39,JointPQPlayer
2123,JointPQPlayer,161,256,417,13,32,JointPQPlayer
2124,JointPQPlayer,310,190,500,36,12,Player A
2125,JointPQPlayer,314,189,503,36,11,Player A
2126,JointPQPlayer,284,199,483,34,17,Player A
2127,JointPQPlayer,298,198,496,32,12,Player A
2128,JointPQPlayer,311,186,497,39,14,Player A
2129,JointPQPlayer,312,192,504,34,10,Player A
2130,JointPQPlayer,288,193,481,38,19,Player A
2131,JointPQPlayer,299,189,488,39,17,Player A
2132,JointPQPlayer,141,261,402,13,37,JointPQPlayer
2133,JointPQPlayer,149,259,408,13,35,JointPQPlayer
2134,JointPQPlayer,150,260,410,12,34,JointPQPlayer
2135,JointPQPlayer,258,208,466,32,22,Player A
2136,JointPQPlayer,311,186,497,39,14,Player A
2137,JointPQPlayer,221,221,442,29,29,Tie
2138,JointPQPlayer,296,196,492,34,14,Player A
2139,JointPQPlayer,305,190,495,37,14,Player A
2140,JointPQPlayer,296,196,492,34,14,Player A
2141,JointPQPlayer,309,189,498,37,13,Player A
2142,JointPQPlayer,265,205,470,33,21,Player A
2143,JointPQPlayer,292,192,484,38,18,Player A
2144,JointPQPlayer,264,209,473,30,19,Player A
2145,JointPQPlayer,149,259,408,13,35,JointPQPlayer
2146,JointPQPlayer,299,194,493,35,14,Player A
2147,JointPQPlayer,282,202,484,32,16,Player A
2148,JointPQPlayer,290,200,490,32,14,Player A
2149,JointPQPlayer,281,196,477,37,20,Player A
2150,JointPQPlayer,124,269,393,10,39,JointPQPlayer
2151,JointPQPlayer,165,250,415,17,34,JointPQPlayer
2152,JointPQPlayer,295,195,490,35,15,Player A
2153,JointPQPlayer,272,202,474,34,20,Player A
2154,JointPQPlayer,294,199,493,32,13,Player A
2155,JointPQPlayer,298,193,491,36,15,Player A
2156,JointPQPlayer,140,265,405,10,35,JointPQPlayer
2157,JointPQPlayer,241,216,457,29,24,Player A
2158,JointPQPlayer,148,258,406,14,36,JointPQPlayer
2159,JointPQPlayer,303,193,496,35,13,Player A
2160,JointPQPlayer,294,199,493,32,13,Player A
2161,JointPQPlayer,301,191,492,37,15,Player A
2162,JointPQPlayer,272,197,469,38,23,Player A
2163,JointPQPlayer,275,205,480,31,17,Player A
2164,JointPQPlayer,317,187,504,37,11,Player A
2165,JointPQPlayer,300,200,500,30,10,Player A
2166,JointPQPlayer,305,195,500,33,11,Player A
2167,JointPQPlayer,163,253,416,15,33,JointPQPlayer
2168,JointPQPlayer,301,191,492,37,15,Player A
2169,JointPQPlayer,290,195,485,36,17,Player A
2170,JointPQPlayer,308,193,501,34,11,Player A
2171,JointPQPlayer,249,219,468,25,19,Player A
2172,JointPQPlayer,157,257,414,13,33,JointPQPlayer
2173,JointPQPlayer,153,258,411,13,34,JointPQPlayer
2174,JointPQPlayer,320,185,505,38,11,Player A
2175,JointPQPlayer,293,193,486,37,17,Player A
2176,JointPQPlayer,149,264,413,9,32,JointPQPlayer
2177,JointPQPlayer,300,195,495,34,13,Player A
2178,JointPQPlayer,293,193,486,37,17,Player A
2179,JointPQPlayer,290,195,485,36,17,Player A
2180,JointPQPlayer,326,181,507,40,11,Player A
2181,JointPQPlayer,274,199,473,36,21,Player A
2182,JointPQPlayer,292,202,494,30,12,Player A
2183,JointPQPlayer,295,205,500,27,9,Player A
2184,JointPQPlayer,293,198,491,33,14,Player A
2185,JointPQPlayer,285,200,485,33,16,Player A
2186,JointPQPlayer,284,199,483,34,17,Player A
2187,JointPQPlayer,316,186,502,38,12,Player A
2188,JointPQPlayer,315,190,505,35,10,Player A
2189,JointPQPlayer,306,191,497,36,13,Player A
2190,JointPQPlayer,153,253,406,17,37,JointPQPlayer
2191,JointPQPlayer,141,266,407,9,34,JointPQPlayer
2192,JointPQPlayer,112,272,384,10,42,JointPQPlayer
2193,JointPQPlayer,253,208,461,33,24,Player A
2194,JointPQPlayer,303,188,491,39,16,Player A
2195,JointPQPlayer,285,200,485,33,16,Player A
2196,JointPQPlayer,153,258,411,13,34,JointPQPlayer
2197,JointPQPlayer,252,212,464,30,22,Player A
2198,JointPQPlayer,143,253,396,19,41,JointPQPlayer
2199,JointPQPlayer,289,204,493,29,12,Player A
2200,JointPQPlayer,334,174,508,44,12,Player A
2201,JointPQPlayer,315,190,505,35,10,Player A
2202,JointPQPlayer,261,211,472,29,19,Player A
2203,JointPQPlayer,129,264,393,13,40,JointPQPlayer
2204,JointPQPlayer,299,194,493,35,14,Player A
2205,JointPQPlayer,310,190,500,36,12,Player A
2206,JointPQPlayer,149,254,403,17,38,JointPQPlayer
2207,JointPQPlayer,278,203,481,32,17,Player A
2208,JointPQPlayer,147,257,404,15,37,JointPQPlayer
2209,JointPQPlayer,266,206,472,32,20,Player A
2210,JointPQPlayer,278,203,481,32,17,Player A
2211,JointPQPlayer,275,205,480,31,17,Player A
2212,JointPQPlayer,291,191,482,39,19,Player A
2213,JointPQPlayer,302,197,499,32,11,Player A
2214,JointPQPlayer,294,194,488,36,16,Player A
2215,JointPQPlayer,295,195,490,35,15,Player A
2216,JointPQPlayer,136,266,402,10,36,JointPQPlayer
2217,JointPQPlayer,329,184,513,37,8,Player A
2218,JointPQPlayer,149,254,403,17,38,JointPQPlayer
2219,JointPQPlayer,315,190,505,35,10,Player A
2220,JointPQPlayer,295,195,490,35,15,Player A
2221,JointPQPlayer,290,200,490,32,14,Player A
2222,JointPQPlayer,232,222,454,26,24,Player A
2223,JointPQPlayer,135,260,395,15,40,JointPQPlayer
2224,JointPQPlayer,251,206,457,35,26,Player A
2225,JointPQPlayer,323,183,506,39,11,Player A
2226,JointPQPlayer,302,187,489,40,17,Player A
2227,JointPQPlayer,317,182,499,41,14,Player A
2228,JointPQPlayer,283,203,486,31,15,Player A
2229,JointPQPlayer,256,206,462,34,24,Player A
2230,JointPQPlayer,255,210,465,31,22,Player A
2231,JointPQPlayer,190,245,435,16,27,JointPQPlayer
2232,JointPQPlayer,225,220,445,29,28,Player A
2233,JointPQPlayer,145,255,400,17,39,JointPQPlayer
2234,JointPQPlayer,298,193,491,36,15,Player A
2235,JointPQPlayer,280,195,475,38,21,Player A
2236,JointPQPlayer,297,202,499,29,10,Player A
2237,JointPQPlayer,304,199,503,30,9,Player A
2238,JointPQPlayer,157,252,409,17,36,JointPQPlayer
2239,JointPQPlayer,275,205,480,31,17,Player A
2240,JointPQPlayer,306,186,492,40,16,Player A
2241,JointPQPlayer,299,194,493,35,14,Player A
2242,JointPQPlayer,310,190,500,36,12,Player A
2243,JointPQPlayer,256,211,467,30,21,Player A
2244,JointPQPlayer,296,196,492,34,14,Player A
2245,JointPQPlayer,235,220,455,27,24,Player A
2246,JointPQPlayer,147,257,404,15,37,JointPQPlayer
2247,JointPQPlayer,304,189,493,38,15,Player A
2248,JointPQPlayer,332,182,514,38,8,Player A
2249,JointPQPlayer,255,215,470,27,19,Player A
2250,JointPQPlayer,137,267,404,9,35,JointPQPlayer
2251,JointPQPlayer,289,199,488,33,15,Player A
2252,JointPQPlayer,135,265,400,11,37,JointPQPlayer
2253,JointPQPlayer,289,194,483,37,18,Player A
2254,JointPQPlayer,260,205,465,34,23,Player A
2255,JointPQPlayer,284,199,483,34,17,Player A
2256,JointPQPlayer,270,205,475,32,19,Player A
2257,JointPQPlayer,268,208,476,30,18,Player A
2258,JointPQPlayer,286,196,482,36,18,Player A
2259,JointPQPlayer,321,181,502,41,13,Player A
2260,JointPQPlayer,200,235,435,22,29,JointPQPlayer
2261,JointPQPlayer,146,256,402,16,38,JointPQPlayer
2262,JointPQPlayer,294,194,488,36,16,Player A
2263,JointPQPlayer,303,193,496,35,13,Player A
2264,JointPQPlayer,254,214,468,28,20,Player A
2265,JointPQPlayer,312,187,499,38,13,Player A
2266,JointPQPlayer,145,260,405,13,36,JointPQPlayer
2267,JointPQPlayer,287,197,484,35,17,Player A
2268,JointPQPlayer,269,209,478,29,17,Player A
2269,JointPQPlayer,281,206,487,29,14,Player A
2270,JointPQPlayer,328,183,511,38,9,Player A
2271,JointPQPlayer,299,194,493,35,14,Player A
2272,JointPQPlayer,337,172,509,45,12,Player A
2273,JointPQPlayer,145,260,405,13,36,JointPQPlayer
2274,JointPQPlayer,151,261,412,11,33,JointPQPlayer
2275,JointPQPlayer,299,189,488,39,17,Player A
2276,JointPQPlayer,147,262,409,11,34,JointPQPlayer
2277,JointPQPlayer,297,197,494,33,13,Player A
2278,JointPQPlayer,124,264,388,14,42,JointPQPlayer
2279,JointPQPlayer,311,191,502,35,11,Player A
2280,JointPQPlayer,296,191,487,38,17,Player A
2281,JointPQPlayer,281,201,482,33,17,Player A
2282,JointPQPlayer,307,182,489,43,18,Player A
2283,JointPQPlayer,299,199,498,31,11,Player A
2284,JointPQPlayer,275,200,475,35,20,Player A
2285,JointPQPlayer,301,196,497,33,12,Player A
2286,JointPQPlayer,143,263,406,11,35,JointPQPlayer
2287,JointPQPlayer,285,200,485,33,16,Player A
2288,JointPQPlayer,299,199,498,31,11,Player A
2289,JointPQPlayer,276,201,477,34,19,Player A
2290,JointPQPlayer,305,190,495,37,14,Player A
2291,JointPQPlayer,319,179,498,43,15,Player A
2292,JointPQPlayer,297,192,489,37,16,Player A
2293,JointPQPlayer,309,194,503,33,10,Player A
2294,JointPQPlayer,290,190,480,40,20,Player A
2295,JointPQPlayer,305,195,500,33,11,Player A
2296,JointPQPlayer,130,265,395,12,39,JointPQPlayer
2297,JointPQPlayer,292,207,499,26,9,Player A
2298,JointPQPlayer,282,202,484,32,16,Player A
2299,JointPQPlayer,314,184,498,40,14,Player A
2300,JointPQPlayer,292,192,484,38,18,Player A
2301,JointPQPlayer,279,199,478,35,19,Player A
2302,JointPQPlayer,307,192,499,35,12,Player A
2303,JointPQPlayer,297,197,494,33,13,Player A
2304,JointPQPlayer,279,199,478,35,19,Player A
2305,JointPQPlayer,163,253,416,15,33,JointPQPlayer
2306,JointPQPlayer,301,196,497,33,12,Player A
2307,JointPQPlayer,281,201,482,33,17,Player A
2308,JointPQPlayer,294,194,488,36,16,Player A
2309,JointPQPlayer,276,206,482,30,16,Player A
2310,JointPQPlayer,312,187,499,38,13,Player A
2311,JointPQPlayer,311,186,497,39,14,Player A
2312,JointPQPlayer,142,257,399,16,39,JointPQPlayer
2313,JointPQPlayer,267,207,474,31,19,Player A
2314,JointPQPlayer,322,182,504,40,12,Player A
2315,JointPQPlayer,143,263,406,11,35,JointPQPlayer
2316,JointPQPlayer,301,196,497,33,12,Player A
2317,JointPQPlayer,291,196,487,35,16,Player A
2318,JointPQPlayer,284,204,488,30,14,Player A
2319,JointPQPlayer,262,217,479,24,15,Player A
2320,JointPQPlayer,291,196,487,35,16,Player A
2321,JointPQPlayer,145,260,405,13,36,JointPQPlayer
2322,JointPQPlayer,189,239,428,21,31,JointPQPlayer
2323,JointPQPlayer,263,208,471,31,20,Player A
2324,JointPQPlayer,287,197,484,35,17,Player A
2325,JointPQPlayer,312,192,504,34,10,Player A
2326,JointPQPlayer,299,194,493,35,14,Player A
2327,JointPQPlayer,295,195,490,35,15,Player A
2328,JointPQPlayer,280,200,480,34,18,Player A
2329,JointPQPlayer,140,260,400,14,38,JointPQPlayer
2330,JointPQPlayer,269,204,473,33,20,Player A
2331,JointPQPlayer,306,186,492,40,16,Player A
2332,JointPQPlayer,292,202,494,30,12,Player A
2333,JointPQPlayer,306,191,497,36,13,Player A
2334,JointPQPlayer,116,271,387,10,41,JointPQPlayer
2335,JointPQPlayer,138,263,401,12,37,JointPQPlayer
2336,JointPQPlayer,299,194,493,35,14,Player A
2337,JointPQPlayer,288,198,486,34,16,Player A
2338,JointPQPlayer,220,225,445,26,27,JointPQPlayer
2339,JointPQPlayer,289,199,488,33,15,Player A
2340,JointPQPlayer,307,187,494,39,15,Player A
2341,JointPQPlayer,250,215,465,28,21,Player A
2342,JointPQPlayer,297,192,489,37,16,Player A
2343,JointPQPlayer,302,192,494,36,14,Player A
2344,JointPQPlayer,297,197,494,33,13,Player A
2345,JointPQPlayer,134,264,398,12,38,JointPQPlayer
2346,JointPQPlayer,272,207,479,30,17,Player A
2347,JointPQPlayer,180,245,425,18,31,JointPQPlayer
2348,JointPQPlayer,155,260,415,11,32,JointPQPlayer
2349,JointPQPlayer,324,179,503,42,13,Player A
2350,JointPQPlayer,125,265,390,13,41,JointPQPlayer
2351,JointPQPlayer,187,237,424,23,33,JointPQPlayer
2352,JointPQPlayer,303,193,496,35,13,Player A
2353,JointPQPlayer,304,194,498,34,12,Player A
2354,JointPQPlayer,298,193,491,36,15,Player A
2355,JointPQPlayer,327,182,509,39,10,Player A
2356,JointPQPlayer,279,204,483,31,16,Player A
2357,JointPQPlayer,286,196,482,36,18,Player A
2358,JointPQPlayer,292,197,489,34,15,Player A
2359,JointPQPlayer,217,222,439,29,30,JointPQPlayer
2360,JointPQPlayer,286,196,482,36,18,Player A
2361,JointPQPlayer,311,191,502,35,11,Player A
2362,JointPQPlayer,279,204,483,31,16,Player A
2363,JointPQPlayer,316,186,502,38,12,Player A
2364,JointPQPlayer,309,189,498,37,13,Player A
2365,JointPQPlayer,273,203,476,33,19,Player A
2366,JointPQPlayer,252,212,464,30,22,Player A
2367,JointPQPlayer,310,190,500,36,12,Player A
2368,JointPQPlayer,294,194,488,36,16,Player A
2369,JointPQPlayer,300,195,495,34,13,Player A
2370,JointPQPlayer,268,203,471,34,21,Player A
2371,JointPQPlayer,261,211,472,29,19,Player A
2372,JointPQPlayer,248,213,461,30,23,Player A
2373,JointPQPlayer,284,204,488,30,14,Player A
2374,JointPQPlayer,289,199,488,33,15,Player A
2375,JointPQPlayer,291,201,492,31,13,Player A
2376,JointPQPlayer,275,200,475,35,20,Player A
2377,JointPQPlayer,307,187,494,39,15,Player A
2378,JointPQPlayer,288,193,481,38,19,Player A
2379,JointPQPlayer,304,194,498,34,12,Player A
2380,JointPQPlayer,301,196,497,33,12,Player A
2381,JointPQPlayer,280,205,485,30,15,Player A
2382,JointPQPlayer,282,197,479,36,19,Player A
2383,JointPQPlayer,303,193,496,35,13,Player A
2384,JointPQPlayer,180,245,425,18,31,JointPQPlayer
2385,JointPQPlayer,280,205,485,30,15,Player A
2386,JointPQPlayer,309,189,498,37,13,Player A
2387,JointPQPlayer,310,180,490,44,18,Player A
2388,JointPQPlayer,320,185,505,38,11,Player A
2389,JointPQPlayer,260,210,470,30,20,Player A
2390,JointPQPlayer,141,261,402,13,37,JointPQPlayer
2391,JointPQPlayer,322,187,509,36,9,Player A
2392,JointPQPlayer,302,187,489,40,17,Player A
2393,JointPQPlayer,319,184,503,39,12,Player A
2394,JointPQPlayer,308,188,496,38,14,Player A
2395,JointPQPlayer,224,224,448,26,26,Tie
2396,JointPQPlayer,262,207,469,32,21,Player A
2397,JointPQPlayer,315,185,500,39,13,Player A
2398,JointPQPlayer,284,204,488,30,14,Player A
2399,JointPQPlayer,160,250,410,18,36,JointPQPlayer
2400,JointPQPlayer,259,214,473,27,18,Player A
2401,JointPQPlayer,273,203,476,33,19,Player A
2402,JointPQPlayer,247,212,459,31,24,Player A
2403,JointPQPlayer,164,254,418,14,32,JointPQPlayer
2404,JointPQPlayer,140,265,405,10,35,JointPQPlayer
2405,JointPQPlayer,297,197,494,33,13,Player A
2406,JointPQPlayer,283,198,481,35,18,Player A
2407,JointPQPlayer,307,192,499,35,12,Player A
2408,JointPQPlayer,300,195,495,34,13,Player A
2409,JointPQPlayer,287,197,484,35,17,Player A
2410,JointPQPlayer,309,189,498,37,13,Player A
2411,JointPQPlayer,279,199,478,35,19,Player A
2412,JointPQPlayer,297,192,489,37,16,Player A
2413,JointPQPlayer,146,261,407,12,35,JointPQPlayer
2414,JointPQPlayer,333,178,511,41,10,Player A
2415,JointPQPlayer,279,199,478,35,19,Player A
2416,JointPQPlayer,283,203,486,31,15,Player A
2417,JointPQPlayer,256,216,472,26,18,Player A
2418,JointPQPlayer,283,203,486,31,15,Player A
2419,JointPQPlayer,323,183,506,39,11,Player A
2420,JointPQPlayer,138,263,401,12,37,JointPQPlayer
2421,JointPQPlayer,291,196,487,35,16,Player A
2422,JointPQPlayer,270,205,475,32,19,Player A
2423,JointPQPlayer,314,189,503,36,11,Player A
2424,JointPQPlayer,149,259,408,13,35,JointPQPlayer
2425,JointPQPlayer,282,197,479,36,19,Player A
2426,JointPQPlayer,149,259,408,13,35,JointPQPlayer
2427,JointPQPlayer,300,195,495,34,13,Player A
2428,JointPQPlayer,297,197,494,33,13,Player A
2429,JointPQPlayer,315,180,495,43,16,Player A
2430,JointPQPlayer,301,191,492,37,15,Player A
2431,JointPQPlayer,286,201,487,32,15,Player A
2432,JointPQPlayer,146,256,402,16,38,JointPQPlayer
2433,JointPQPlayer,310,195,505,32,9,Player A
2434,JointPQPlayer,292,197,489,34,15,Player A
2435,JointPQPlayer,285,200,485,33,16,Player A
2436,JointPQPlayer,301,186,487,41,18,Player A
2437,JointPQPlayer,291,196,487,35,16,Player A
2438,JointPQPlayer,283,203,486,31,15,Player A
2439,JointPQPlayer,127,267,394,11,39,JointPQPlayer
2440,JointPQPlayer,297,192,489,37,16,Player A
2441,JointPQPlayer,254,214,468,28,20,Player A
2442,JointPQPlayer,310,190,500,36,12,Player A
2443,JointPQPlayer,281,201,482,33,17,Player A
2444,JointPQPlayer,293,198,491,33,14,Player A
2445,JointPQPlayer,290,200,490,32,14,Player A
2446,JointPQPlayer,309,189,498,37,13,Player A
2447,JointPQPlayer,278,198,476,36,20,Player A
2448,JointPQPlayer,141,256,397,17,40,JointPQPlayer
2449,JointPQPlayer,157,252,409,17,36,JointPQPlayer
2450,JointPQPlayer,150,255,405,16,37,JointPQPlayer
2451,JointPQPlayer,297,192,489,37,16,Player A
2452,JointPQPlayer,260,205,465,34,23,Player A
2453,JointPQPlayer,292,197,489,34,15,Player A
2454,JointPQPlayer,146,256,402,16,38,JointPQPlayer
2455,JointPQPlayer,144,259,403,14,37,JointPQPlayer
2456,JointPQPlayer,285,195,480,37,19,Player A
2457,JointPQPlayer,150,255,405,16,37,JointPQPlayer
2458,JointPQPlayer,296,201,497,30,11,Player A
2459,JointPQPlayer,147,257,404,15,37,JointPQPlayer
2460,JointPQPlayer,301,191,492,37,15,Player A
2461,JointPQPlayer,261,211,472,29,19,Player A
2462,JointPQPlayer,300,195,495,34,13,Player A
2463,JointPQPlayer,248,218,466,26,20,Player A
2464,JointPQPlayer,313,188,501,37,12,Player A
2465,JointPQPlayer,265,205,470,33,21,Player A
2466,JointPQPlayer,288,198,486,34,16,Player A
2467,JointPQPlayer,282,197,479,36,19,Player A
2468,JointPQPlayer,306,191,497,36,13,Player A
2469,JointPQPlayer,311,186,497,39,14,Player A
2470,JointPQPlayer,144,259,403,14,37,JointPQPlayer
2471,JointPQPlayer,269,204,473,33,20,Player A
2472,JointPQPlayer,299,189,488,39,17,Player A
2473,JointPQPlayer,167,247,414,19,35,JointPQPlayer
2474,JointPQPlayer,296,196,492,34,14,Player A
2475,JointPQPlayer,233,228,461,21,20,Player A
2476,JointPQPlayer,143,263,406,11,35,JointPQPlayer
2477,JointPQPlayer,292,192,484,38,18,Player A
2478,JointPQPlayer,153,263,416,9,31,JointPQPlayer
2479,JointPQPlayer,307,182,489,43,18,Player A
2480,JointPQPlayer,213,228,441,25,28,JointPQPlayer
2481,JointPQPlayer,300,190,490,38,16,Player A
2482,JointPQPlayer,303,188,491,39,16,Player A
2483,JointPQPlayer,301,191,492,37,15,Player A
2484,JointPQPlayer,125,270,395,9,38,JointPQPlayer
2485,JointPQPlayer,157,257,414,13,33,JointPQPlayer
2486,JointPQPlayer,289,199,488,33,15,Player A
2487,JointPQPlayer,290,195,485,36,17,Player A
2488,JointPQPlayer,287,197,484,35,17,Player A
2489,JointPQPlayer,280,200,480,34,18,Player A
2490,JointPQPlayer,148,263,411,10,33,JointPQPlayer
2491,JointPQPlayer,315,185,500,39,13,Player A
2492,JointPQPlayer,284,199,483,34,17,Player A
2493,JointPQPlayer,298,198,496,32,12,Player A
2494,JointPQPlayer,303,193,496,35,13,Player A
2495,JointPQPlayer,296,201,497,30,11,Player A
2496,JointPQPlayer,283,203,486,31,15,Player A
2497,JointPQPlayer,313,188,501,37,12,Player A
2498,JointPQPlayer,308,193,501,34,11,Player A
2499,JointPQPlayer,138,263,401,12,37,JointPQPlayer
2500,JointPQPlayer,302,197,499,32,11,Player A
2501,JointPQPlayer,129,264,393,13,40,JointPQPlayer
2502,JointPQPlayer,284,199,483,34,17,Player A
2503,JointPQPlayer,307,197,504,31,9,Player A
2504,JointPQPlayer,285,200,485,33,16,Player A
2505,JointPQPlayer,322,187,509,36,9,Player A
2506,JointPQPlayer,232,227,459,22,21,Player A
2507,JointPQPlayer,281,201,482,33,17,Player A
2508,JointPQPlayer,276,201,477,34,19,Player A
2509,JointPQPlayer,158,253,411,16,35,JointPQPlayer
2510,JointPQPlayer,202,237,439,20,27,JointPQPlayer
2511,JointPQPlayer,293,188,481,41,20,Player A
2512,JointPQPlayer,280,205,485,30,15,Player A
2513,JointPQPlayer,312,192,504,34,10,Player A
2514,JointPQPlayer,253,218,471,25,18,Player A
2515,JointPQPlayer,206,236,442,20,26,JointPQPlayer
2516,JointPQPlayer,314,184,498,40,14,Player A
2517,JointPQPlayer,284,199,483,34,17,Player A
2518,JointPQPlayer,156,256,412,14,34,JointPQPlayer
2519,JointPQPlayer,283,198,481,35,18,Player A
2520,JointPQPlayer,301,191,492,37,15,Player A
2521,JointPQPlayer,299,194,493,35,14,Player A
2522,JointPQPlayer,260,210,470,30,20,Player A
2523,JointPQPlayer,310,190,500,36,12,Player A
2524,JointPQPlayer,158,253,411,16,35,JointPQPlayer
2525,JointPQPlayer,132,267,399,10,37,JointPQPlayer
2526,JointPQPlayer,284,194,478,38,20,Player A
2527,JointPQPlayer,214,229,443,24,27,JointPQPlayer
2528,JointPQPlayer,162,257,419,12,31,JointPQPlayer
2529,JointPQPlayer,309,194,503,33,10,Player A
2530,JointPQPlayer,323,178,501,43,14,Player A
2531,JointPQPlayer,277,197,474,37,21,Player A
2532,JointPQPlayer,288,198,486,34,16,Player A
2533,JointPQPlayer,305,190,495,37,14,Player A
2534,JointPQPlayer,266,206,472,32,20,Player A
2535,JointPQPlayer,326,186,512,36,8,Player A
2536,JointPQPlayer,304,189,493,38,15,Player A
2537,JointPQPlayer,162,252,414,16,34,JointPQPlayer
2538,JointPQPlayer,308,188,496,38,14,Player A
2539,JointPQPlayer,288,198,486,34,16,Player A
2540,JointPQPlayer,304,194,498,34,12,Player A
2541,JointPQPlayer,293,198,491,33,14,Player A
2542,JointPQPlayer,295,195,490,35,15,Player A
2543,JointPQPlayer,133,268,401,9,36,JointPQPlayer
2544,JointPQPlayer,281,211,492,25,11,Player A
2545,JointPQPlayer,148,263,411,10,33,JointPQPlayer
2546,JointPQPlayer,275,200,475,35,20,Player A
2547,JointPQPlayer,297,192,489,37,16,Player A
2548,JointPQPlayer,287,202,489,31,14,Player A
2549,JointPQPlayer,160,255,415,14,33,JointPQPlayer
2550,JointPQPlayer,290,195,485,36,17,Player A
2551,JointPQPlayer,291,196,487,35,16,Player A
2552,JointPQPlayer,309,189,498,37,13,Player A
2553,JointPQPlayer,271,206,477,31,18,Player A
2554,JointPQPlayer,302,197,499,32,11,Player A
2555,JointPQPlayer,241,211,452,33,27,Player A
2556,JointPQPlayer,309,189,498,37,13,Player A
2557,JointPQPlayer,268,203,471,34,21,Player A
2558,JointPQPlayer,323,183,506,39,11,Player A
2559,JointPQPlayer,285,200,485,33,16,Player A
2560,JointPQPlayer,320,185,505,38,11,Player A
2561,JointPQPlayer,228,223,451,26,25,Player A
2562,JointPQPlayer,283,203,486,31,15,Player A
2563,JointPQPlayer,315,185,500,39,13,Player A
2564,JointPQPlayer,166,251,417,16,33,JointPQPlayer
2565,JointPQPlayer,276,206,482,30,16,Player A
2566,JointPQPlayer,295,190,485,39,18,Player A
2567,JointPQPlayer,290,190,480,40,20,Player A
2568,JointPQPlayer,297,192,489,37,16,Player A
2569,JointPQPlayer,274,199,473,36,21,Player A
2570,JointPQPlayer,109,279,388,5,39,JointPQPlayer
2571,JointPQPlayer,295,200,495,31,12,Player A
2572,JointPQPlayer,152,262,414,10,32,JointPQPlayer
2573,JointPQPlayer,292,192,484,38,18,Player A
2574,JointPQPlayer,155,250,405,19,38,JointPQPlayer
2575,JointPQPlayer,315,190,505,35,10,Player A
2576,JointPQPlayer,301,186,487,41,18,Player A
2577,JointPQPlayer,286,201,487,32,15,Player A
2578,JointPQPlayer,291,196,487,35,16,Player A
2579,JointPQPlayer,309,184,493,41,16,Player A
2580,JointPQPlayer,198,243,441,16,25,JointPQPlayer
2581,JointPQPlayer,159,254,413,15,34,JointPQPlayer
2582,JointPQPlayer,303,193,496,35,13,Player A
2583,JointPQPlayer,224,224,448,26,26,Tie
2584,JointPQPlayer,204,234,438,22,28,JointPQPlayer
2585,JointPQPlayer,267,207,474,31,19,Player A
2586,JointPQPlayer,223,223,446,27,27,Tie
2587,JointPQPlayer,144,259,403,14,37,JointPQPlayer
2588,JointPQPlayer,319,184,503,39,12,Player A
2589,JointPQPlayer,144,254,398,18,40,JointPQPlayer
2590,JointPQPlayer,153,253,406,17,37,JointPQPlayer
2591,JointPQPlayer,294,189,483,40,19,Player A
2592,JointPQPlayer,303,193,496,35,13,Player A
2593,JointPQPlayer,277,202,479,33,18,Player A
2594,JointPQPlayer,317,182,499,41,14,Player A
2595,JointPQPlayer,292,187,479,42,21,Player A
2596,JointPQPlayer,139,259,398,15,39,JointPQPlayer
2597,JointPQPlayer,275,200,475,35,20,Player A
2598,JointPQPlayer,301,186,487,41,18,Player A
2599,JointPQPlayer,151,256,407,15,36,JointPQPlayer
2600,JointPQPlayer,289,194,483,37,18,Player A
2601,JointPQPlayer,138,263,401,12,37,JointPQPlayer
2602,JointPQPlayer,183,243,426,19,31,JointPQPlayer
2603,JointPQPlayer,276,206,482,30,16,Player A
2604,JointPQPlayer,171,251,422,15,31,JointPQPlayer
2605,JointPQPlayer,134,264,398,12,38,JointPQPlayer
2606,JointPQPlayer,155,260,415,11,32,JointPQPlayer
2607,JointPQPlayer,146,256,402,16,38,JointPQPlayer
2608,JointPQPlayer,289,199,488,33,15,Player A
2609,JointPQPlayer,258,208,466,32,22,Player A
2610,JointPQPlayer,301,196,497,33,12,Player A
2611,JointPQPlayer,276,201,477,34,19,Player A
2612,JointPQPlayer,283,198,481,35,18,Player A
2613,JointPQPlayer,296,196,492,34,14,Player A
2614,JointPQPlayer,163,253,416,15,33,JointPQPlayer
2615,JointPQPlayer,166,256,422,12,30,JointPQPlayer
2616,JointPQPlayer,291,201,492,31,13,Player A
2617,JointPQPlayer,145,255,400,17,39,JointPQPlayer
2618,JointPQPlayer,260,210,470,30,20,Player A
2619,JointPQPlayer,299,194,493,35,14,Player A
2620,JointPQPlayer,212,227,439,26,29,JointPQPlayer
2621,JointPQPlayer,301,196,497,33,12,Player A
2622,JointPQPlayer,304,194,498,34,12,Player A
2623,JointPQPlayer,325,185,510,37,9,Player A
2624,JointPQPlayer,269,209,478,29,17,Player A
2625,JointPQPlayer,327,182,509,39,10,Player A
2626,JointPQPlayer,271,211,482,27,15,Player A
2627,JointPQPlayer,143,258,401,15,38,JointPQPlayer
2628,JointPQPlayer,277,202,479,33,18,Player A
2629,JointPQPlayer,275,210,485,27,14,Player A
2630,JointPQPlayer,130,265,395,12,39,JointPQPlayer
2631,JointPQPlayer,283,193,476,39,21,Player A
2632,JointPQPlayer,285,195,480,37,19,Player A
2633,JointPQPlayer,290,200,490,32,14,Player A
2634,JointPQPlayer,313,188,501,37,12,Player A
2635,JointPQPlayer,267,207,474,31,19,Player A
2636,JointPQPlayer,198,238,436,20,28,JointPQPlayer
2637,JointPQPlayer,293,193,486,37,17,Player A
2638,JointPQPlayer,289,199,488,33,15,Player A
2639,JointPQPlayer,210,230,440,24,28,JointPQPlayer
2640,JointPQPlayer,287,197,484,35,17,Player A
2641,JointPQPlayer,287,197,484,35,17,Player A
2642,JointPQPlayer,320,185,505,38,11,Player A
2643,JointPQPlayer,308,193,501,34,11,Player A
2644,JointPQPlayer,304,189,493,38,15,Player A
2645,JointPQPlayer,146,256,402,16,38,JointPQPlayer
2646,JointPQPlayer,136,261,397,14,39,JointPQPlayer
2647,JointPQPlayer,184,244,428,18,30,JointPQPlayer
2648,JointPQPlayer,319,184,503,39,12,Player A
2649,JointPQPlayer,136,266,402,10,36,JointPQPlayer
2650,JointPQPlayer,131,261,392,15,41,JointPQPlayer
2651,JointPQPlayer,221,226,447,25,26,JointPQPlayer
2652,JointPQPlayer,127,267,394,11,39,JointPQPlayer
2653,JointPQPlayer,142,262,404,12,36,JointPQPlayer
2654,JointPQPlayer,157,257,414,13,33,JointPQPlayer
2655,JointPQPlayer,285,195,480,37,19,Player A
2656,JointPQPlayer,271,206,477,31,18,Player A
2657,JointPQPlayer,193,238,431,21,30,JointPQPlayer
2658,JointPQPlayer,284,204,488,30,14,Player A
2659,JointPQPlayer,156,261,417,10,31,JointPQPlayer
2660,JointPQPlayer,268,208,476,30,18,Player A
2661,JointPQPlayer,282,202,484,32,16,Player A
2662,JointPQPlayer,276,206,482,30,16,Player A
2663,JointPQPlayer,287,197,484,35,17,Player A
2664,JointPQPlayer,283,203,486,31,15,Player A
2665,JointPQPlayer,173,248,421,17,32,JointPQPlayer
2666,JointPQPlayer,137,262,399,13,38,JointPQPlayer
2667,JointPQPlayer,151,256,407,15,36,JointPQPlayer
2668,JointPQPlayer,208,228,436,26,30,JointPQPlayer
2669,JointPQPlayer,239,219,458,27,23,Player A
2670,JointPQPlayer,133,263,396,13,39,JointPQPlayer
2671,JointPQPlayer,313,193,506,33,9,Player A
2672,JointPQPlayer,290,200,490,32,14,Player A
2673,JointPQPlayer,301,196,497,33,12,Player A
2674,JointPQPlayer,322,182,504,40,12,Player A
2675,JointPQPlayer,248,213,461,30,23,Player A
2676,JointPQPlayer,296,201,497,30,11,Player A
2677,JointPQPlayer,169,249,418,17,33,JointPQPlayer
2678,JointPQPlayer,319,184,503,39,12,Player A
2679,JointPQPlayer,296,196,492,34,14,Player A
2680,JointPQPlayer,155,255,410,15,35,JointPQPlayer
2681,JointPQPlayer,141,261,402,13,37,JointPQPlayer
2682,JointPQPlayer,149,259,408,13,35,JointPQPlayer
2683,JointPQPlayer,295,190,485,39,18,Player A
2684,JointPQPlayer,293,193,486,37,17,Player A
2685,JointPQPlayer,281,201,482,33,17,Player A
2686,JointPQPlayer,301,196,497,33,12,Player A
2687,JointPQPlayer,277,202,479,33,18,Player A
2688,JointPQPlayer,146,261,407,12,35,JointPQPlayer
2689,JointPQPlayer,298,188,486,40,18,Player A
2690,JointPQPlayer,298,193,491,36,15,Player A
2691,JointPQPlayer,296,191,487,38,17,Player A
2692,JointPQPlayer,277,202,479,33,18,Player A
2693,JointPQPlayer,292,192,484,38,18,Player A
2694,JointPQPlayer,304,184,488,42,18,Player A
2695,JointPQPlayer,136,261,397,14,39,JointPQPlayer
2696,JointPQPlayer,292,202,494,30,12,Player A
2697,JointPQPlayer,277,197,474,37,21,Player A
2698,JointPQPlayer,312,192,504,34,10,Player A
2699,JointPQPlayer,278,198,476,36,20,Player A
2700,JointPQPlayer,259,209,468,31,21,Player A
2701,JointPQPlayer,302,192,494,36,14,Player A
2702,JointPQPlayer,309,194,503,33,10,Player A
2703,JointPQPlayer,124,264,388,14,42,JointPQPlayer
2704,JointPQPlayer,295,190,485,39,18,Player A
2705,JointPQPlayer,294,194,488,36,16,Player A
2706,JointPQPlayer,266,206,472,32,20,Player A
2707,JointPQPlayer,305,190,495,37,14,Player A
2708,JointPQPlayer,133,263,396,13,39,JointPQPlayer
2709,JointPQPlayer,287,202,489,31,14,Player A
2710,JointPQPlayer,303,193,496,35,13,Player A
2711,JointPQPlayer,285,200,485,33,16,Player A
2712,JointPQPlayer,322,182,504,40,12,Player A
2713,JointPQPlayer,284,199,483,34,17,Player A
2714,JointPQPlayer,323,183,506,39,11,Player A
2715,JointPQPlayer,284,199,483,34,17,Player A
2716,JointPQPlayer,267,202,469,35,22,Player A
2717,JointPQPlayer,189,239,428,21,31,JointPQPlayer
2718,JointPQPlayer,285,195,480,37,19,Player A
2719,JointPQPlayer,159,259,418,11,31,JointPQPlayer
2720,JointPQPlayer,295,200,495,31,12,Player A
2721,JointPQPlayer,136,261,397,14,39,JointPQPlayer
2722,JointPQPlayer,284,199,483,34,17,Player A
2723,JointPQPlayer,287,197,484,35,17,Player A
2724,JointPQPlayer,124,269,393,10,39,JointPQPlayer
2725,JointPQPlayer,317,187,504,37,11,Player A
2726,JointPQPlayer,149,259,408,13,35,JointPQPlayer
2727,JointPQPlayer,310,185,495,40,15,Player A
2728,JointPQPlayer,137,262,399,13,38,JointPQPlayer
2729,JointPQPlayer,216,226,442,26,28,JointPQPlayer
2730,JointPQPlayer,311,191,502,35,11,Player A
2731,JointPQPlayer,281,201,482,33,17,Player A
2732,JointPQPlayer,232,227,459,22,21,Player A
2733,JointPQPlayer,301,191,492,37,15,Player A
2734,JointPQPlayer,324,184,508,38,10,Player A
2735,JointPQPlayer,151,251,402,19,39,JointPQPlayer
2736,JointPQPlayer,125,260,385,17,44,JointPQPlayer
2737,JointPQPlayer,279,204,483,31,16,Player A
2738,JointPQPlayer,287,192,479,39,20,Player A
2739,JointPQPlayer,233,223,456,25,23,Player A
2740,JointPQPlayer,296,196,492,34,14,Player A
2741,JointPQPlayer,271,206,477,31,18,Player A
2742,JointPQPlayer,274,199,473,36,21,Player A
2743,JointPQPlayer,203,233,436,23,29,JointPQPlayer
2744,JointPQPlayer,137,257,394,17,41,JointPQPlayer
2745,JointPQPlayer,308,193,501,34,11,Player A
2746,JointPQPlayer,151,261,412,11,33,JointPQPlayer
2747,JointPQPlayer,303,198,501,31,10,Player A
2748,JointPQPlayer,282,202,484,32,16,Player A
2749,JointPQPlayer,301,181,482,45,21,Player A
2750,JointPQPlayer,310,190,500,36,12,Player A
2751,JointPQPlayer,310,190,500,36,12,Player A
2752,JointPQPlayer,294,194,488,36,16,Player A
2753,JointPQPlayer,291,201,492,31,13,Player A
2754,JointPQPlayer,151,256,407,15,36,JointPQPlayer
2755,JointPQPlayer,294,194,488,36,16,Player A
2756,JointPQPlayer,300,190,490,38,16,Player A
2757,JointPQPlayer,267,207,474,31,19,Player A
2758,JointPQPlayer,300,190,490,38,16,Player A
2759,JointPQPlayer,285,200,485,33,16,Player A
2760,JointPQPlayer,298,193,491,36,15,Player A
2761,JointPQPlayer,322,182,504,40,12,Player A
2762,JointPQPlayer,175,245,420,19,33,JointPQPlayer
2763,JointPQPlayer,144,259,403,14,37,JointPQPlayer
2764,JointPQPlayer,303,193,496,35,13,Player A
2765,JointPQPlayer,276,201,477,34,19,Player A
2766,JointPQPlayer,148,258,406,14,36,JointPQPlayer
2767,JointPQPlayer,298,193,491,36,15,Player A
2768,JointPQPlayer,250,210,460,32,24,Player A
2769,JointPQPlayer,132,267,399,10,37,JointPQPlayer
2770,JointPQPlayer,305,195,500,33,11,Player A
2771,JointPQPlayer,149,264,413,9,32,JointPQPlayer
2772,JointPQPlayer,296,196,492,34,14,Player A
2773,JointPQPlayer,145,265,410,9,33,JointPQPlayer
2774,JointPQPlayer,293,193,486,37,17,Player A
2775,JointPQPlayer,247,212,459,31,24,Player A
2776,JointPQPlayer,286,196,482,36,18,Player A
2777,JointPQPlayer,295,195,490,35,15,Player A
2778,JointPQPlayer,303,193,496,35,13,Player A
2779,JointPQPlayer,217,227,444,25,27,JointPQPlayer
2780,JointPQPlayer,277,197,474,37,21,Player A
2781,JointPQPlayer,304,194,498,34,12,Player A
2782,JointPQPlayer,127,267,394,11,39,JointPQPlayer
2783,JointPQPlayer,152,262,414,10,32,JointPQPlayer
2784,JointPQPlayer,138,263,401,12,37,JointPQPlayer
2785,JointPQPlayer,296,196,492,34,14,Player A
2786,JointPQPlayer,264,209,473,30,19,Player A
2787,JointPQPlayer,287,197,484,35,17,Player A
2788,JointPQPlayer,285,200,485,33,16,Player A
2789,JointPQPlayer,315,180,495,43,16,Player A
2790,JointPQPlayer,267,202,469,35,22,Player A
2791,JointPQPlayer,303,193,496,35,13,Player A
2792,JointPQPlayer,313,193,506,33,9,Player A
2793,JointPQPlayer,298,198,496,32,12,Player A
2794,JointPQPlayer,258,208,466,32,22,Player A
2795,JointPQPlayer,299,194,493,35,14,Player A
2796,JointPQPlayer,288,193,481,38,19,Player A
2797,JointPQPlayer,271,206,477,31,18,Player A
2798,JointPQPlayer,276,201,477,34,19,Player A
2799,JointPQPlayer,243,213,456,31,25,Player A
2800,JointPQPlayer,174,249,423,16,31,JointPQPlayer
2801,JointPQPlayer,304,189,493,38,15,Player A
2802,JointPQPlayer,310,190,500,36,12,Player A
2803,JointPQPlayer,163,258,421,11,30,JointPQPlayer
2804,JointPQPlayer,335,180,515,39,8,Player A
2805,JointPQPlayer,259,209,468,31,21,Player A
2806,JointPQPlayer,276,196,472,38,22,Player A
2807,JointPQPlayer,319,184,503,39,12,Player A
2808,JointPQPlayer,314,189,503,36,11,Player A
2809,JointPQPlayer,161,251,412,17,35,JointPQPlayer
2810,JointPQPlayer,286,196,482,36,18,Player A
2811,JointPQPlayer,156,261,417,10,31,JointPQPlayer
2812,JointPQPlayer,281,201,482,33,17,Player A
2813,JointPQPlayer,276,201,477,34,19,Player A
2814,JointPQPlayer,304,189,493,38,15,Player A
2815,JointPQPlayer,292,197,489,34,15,Player A
2816,JointPQPlayer,266,211,477,28,17,Player A
2817,JointPQPlayer,291,196,487,35,16,Player A
2818,JointPQPlayer,127,272,399,7,36,JointPQPlayer
2819,JointPQPlayer,321,191,512,33,7,Player A
2820,JointPQPlayer,303,193,496,35,13,Player A
2821,JointPQPlayer,291,196,487,35,16,Player A
2822,JointPQPlayer,175,245,420,19,33,JointPQPlayer
2823,JointPQPlayer,276,206,482,30,16,Player A
2824,JointPQPlayer,319,184,503,39,12,Player A
2825,JointPQPlayer,143,258,401,15,38,JointPQPlayer
2826,JointPQPlayer,287,197,484,35,17,Player A
2827,JointPQPlayer,273,203,476,33,19,Player A
2828,JointPQPlayer,261,201,462,37,25,Player A
2829,JointPQPlayer,146,266,412,8,32,JointPQPlayer
2830,JointPQPlayer,273,208,481,29,16,Player A
2831,JointPQPlayer,135,265,400,11,37,JointPQPlayer
2832,JointPQPlayer,292,197,489,34,15,Player A
2833,JointPQPlayer,300,195,495,34,13,Player A
2834,JointPQPlayer,289,194,483,37,18,Player A
2835,JointPQPlayer,289,194,483,37,18,Player A
2836,JointPQPlayer,164,254,418,14,32,JointPQPlayer
2837,JointPQPlayer,267,202,469,35,22,Player A
2838,JointPQPlayer,321,186,507,37,10,Player A
2839,JointPQPlayer,295,200,495,31,12,Player A
2840,JointPQPlayer,298,198,496,32,12,Player A
2841,JointPQPlayer,200,240,440,18,26,JointPQPlayer
2842,JointPQPlayer,319,184,503,39,12,Player A
2843,JointPQPlayer,296,191,487,38,17,Player A
2844,JointPQPlayer,255,210,465,31,22,Player A
2845,JointPQPlayer,278,203,481,32,17,Player A
2846,JointPQPlayer,281,196,477,37,20,Player A
2847,JointPQPlayer,145,260,405,13,36,JointPQPlayer
2848,JointPQPlayer,305,190,495,37,14,Player A
2849,JointPQPlayer,311,191,502,35,11,Player A
2850,JointPQPlayer,265,205,470,33,21,Player A
2851,JointPQPlayer,262,212,474,28,18,Player A
2852,JointPQPlayer,323,178,501,43,14,Player A
2853,JointPQPlayer,290,195,485,36,17,Player A
2854,JointPQPlayer,272,212,484,26,14,Player A
2855,JointPQPlayer,140,260,400,14,38,JointPQPlayer
2856,JointPQPlayer,250,215,465,28,21,Player A
2857,JointPQPlayer,234,224,458,24,22,Player A
2858,JointPQPlayer,305,190,495,37,14,Player A
2859,JointPQPlayer,311,196,507,31,8,Player A
2860,JointPQPlayer,239,219,458,27,23,Player A
2861,JointPQPlayer,292,192,484,38,18,Player A
2862,JointPQPlayer,284,204,488,30,14,Player A
2863,JointPQPlayer,279,209,488,27,13,Player A
2864,JointPQPlayer,301,196,497,33,12,Player A
2865,JointPQPlayer,249,214,463,29,22,Player A
2866,JointPQPlayer,307,192,499,35,12,Player A
2867,JointPQPlayer,290,195,485,36,17,Player A
2868,JointPQPlayer,280,210,490,26,12,Player A
2869,JointPQPlayer,257,212,469,29,20,Player A
2870,JointPQPlayer,269,209,478,29,17,Player A
2871,JointPQPlayer,280,205,485,30,15,Player A
2872,JointPQPlayer,289,199,488,33,15,Player A
2873,JointPQPlayer,257,207,464,33,23,Player A
2874,JointPQPlayer,169,249,418,17,33,JointPQPlayer
2875,JointPQPlayer,147,262,409,11,34,JointPQPlayer
2876,JointPQPlayer,142,257,399,16,39,JointPQPlayer
2877,JointPQPlayer,302,192,494,36,14,Player A
2878,JointPQPlayer,134,259,393,16,41,JointPQPlayer
2879,JointPQPlayer,286,196,482,36,18,Player A
2880,JointPQPlayer,132,267,399,10,37,JointPQPlayer
2881,JointPQPlayer,286,206,492,28,12,Player A
2882,JointPQPlayer,305,185,490,41,17,Player A
2883,JointPQPlayer,310,185,495,40,15,Player A
2884,JointPQPlayer,270,205,475,32,19,Player A
2885,JointPQPlayer,287,202,489,31,14,Player A
2886,JointPQPlayer,313,188,501,37,12,Player A
2887,JointPQPlayer,263,213,476,27,17,Player A
2888,JointPQPlayer,307,187,494,39,15,Player A
2889,JointPQPlayer,286,201,487,32,15,Player A
2890,JointPQPlayer,286,196,482,36,18,Player A
2891,JointPQPlayer,277,197,474,37,21,Player A
2892,JointPQPlayer,192,242,434,18,28,JointPQPlayer
2893,JointPQPlayer,309,194,503,33,10,Player A
2894,JointPQPlayer,241,216,457,29,24,Player A
2895,JointPQPlayer,153,263,416,9,31,JointPQPlayer
2896,JointPQPlayer,270,205,475,32,19,Player A
2897,JointPQPlayer,140,260,400,14,38,JointPQPlayer
2898,JointPQPlayer,233,228,461,21,20,Player A
2899,JointPQPlayer,306,191,497,36,13,Player A
2900,JointPQPlayer,302,192,494,36,14,Player A
2901,JointPQPlayer,184,244,428,18,30,JointPQPlayer
2902,JointPQPlayer,164,254,418,14,32,JointPQPlayer
2903,JointPQPlayer,188,243,431,18,29,JointPQPlayer
2904,JointPQPlayer,287,197,484,35,17,Player A
2905,JointPQPlayer,210,230,440,24,28,JointPQPlayer
2906,JointPQPlayer,150,255,405,16,37,JointPQPlayer
2907,JointPQPlayer,307,192,499,35,12,Player A
2908,JointPQPlayer,318,183,501,40,13,Player A
2909,JointPQPlayer,298,198,496,32,12,Player A
2910,JointPQPlayer,128,263,391,14,41,JointPQPlayer
2911,JointPQPlayer,269,209,478,29,17,Player A
2912,JointPQPlayer,262,207,469,32,21,Player A
2913,JointPQPlayer,254,214,468,28,20,Player A
2914,JointPQPlayer,291,196,487,35,16,Player A
2915,JointPQPlayer,136,261,397,14,39,JointPQPlayer
2916,JointPQPlayer,111,271,382,11,43,JointPQPlayer
2917,JointPQPlayer,137,262,399,13,38,JointPQPlayer
2918,JointPQPlayer,286,196,482,36,18,Player A
2919,JointPQPlayer,127,262,389,15,42,JointPQPlayer
2920,JointPQPlayer,296,196,492,34,14,Player A
2921,JointPQPlayer,285,200,485,33,16,Player A
2922,JointPQPlayer,131,261,392,15,41,JointPQPlayer
2923,JointPQPlayer,291,201,492,31,13,Player A
2924,JointPQPlayer,296,191,487,38,17,Player A
2925,JointPQPlayer,331,181,512,39,9,Player A
2926,JointPQPlayer,136,266,402,10,36,JointPQPlayer
2927,JointPQPlayer,303,188,491,39,16,Player A
2928,JointPQPlayer,292,202,494,30,12,Player A
2929,JointPQPlayer,130,265,395,12,39,JointPQPlayer
2930,JointPQPlayer,296,196,492,34,14,Player A
2931,JointPQPlayer,304,194,498,34,12,Player A
2932,JointPQPlayer,274,209,483,28,15,Player A
2933,JointPQPlayer,283,198,481,35,18,Player A
2934,JointPQPlayer,310,190,500,36,12,Player A
2935,JointPQPlayer,288,203,491,30,13,Player A
2936,JointPQPlayer,294,199,493,32,13,Player A
2937,JointPQPlayer,272,202,474,34,20,Player A
2938,JointPQPlayer,304,189,493,38,15,Player A
2939,JointPQPlayer,315,185,500,39,13,Player A
2940,JointPQPlayer,304,189,493,38,15,Player A
2941,JointPQPlayer,267,207,474,31,19,Player A
2942,JointPQPlayer,298,193,491,36,15,Player A
2943,JointPQPlayer,275,205,480,31,17,Player A
2944,JointPQPlayer,322,182,504,40,12,Player A
2945,JointPQPlayer,311,191,502,35,11,Player A
2946,JointPQPlayer,149,259,408,13,35,JointPQPlayer
2947,JointPQPlayer,283,198,481,35,18,Player A
2948,JointPQPlayer,302,192,494,36,14,Player A
2949,JointPQPlayer,228,218,446,30,28,Player A
2950,JointPQPlayer,286,201,487,32,15,Player A
2951,JointPQPlayer,292,197,489,34,15,Player A
2952,JointPQPlayer,157,257,414,13,33,JointPQPlayer
2953,JointPQPlayer,289,194,483,37,18,Player A
2954,JointPQPlayer,304,189,493,38,15,Player A
2955,JointPQPlayer,325,180,505,41,12,Player A
2956,JointPQPlayer,126,271,397,8,37,JointPQPlayer
2957,JointPQPlayer,290,200,490,32,14,Player A
2958,JointPQPlayer,264,209,473,30,19,Player A
2959,JointPQPlayer,291,201,492,31,13,Player A
2960,JointPQPlayer,275,205,480,31,17,Player A
2961,JointPQPlayer,293,193,486,37,17,Player A
2962,JointPQPlayer,293,198,491,33,14,Player A
2963,JointPQPlayer,313,188,501,37,12,Player A
2964,JointPQPlayer,315,195,510,31,7,Player A
2965,JointPQPlayer,136,266,402,10,36,JointPQPlayer
2966,JointPQPlayer,295,195,490,35,15,Player A
2967,JointPQPlayer,276,201,477,34,19,Player A
2968,JointPQPlayer,122,267,389,12,41,JointPQPlayer
2969,JointPQPlayer,313,183,496,41,15,Player A
2970,JointPQPlayer,302,192,494,36,14,Player A
2971,JointPQPlayer,301,191,492,37,15,Player A
2972,JointPQPlayer,266,211,477,28,17,Player A
2973,JointPQPlayer,222,227,449,24,25,JointPQPlayer
2974,JointPQPlayer,281,201,482,33,17,Player A
2975,JointPQPlayer,307,192,499,35,12,Player A
2976,JointPQPlayer,158,258,416,12,32,JointPQPlayer
2977,JointPQPlayer,305,195,500,33,11,Player A
2978,JointPQPlayer,250,215,465,28,21,Player A
2979,JointPQPlayer,211,231,442,23,27,JointPQPlayer
2980,JointPQPlayer,154,254,408,16,36,JointPQPlayer
2981,JointPQPlayer,304,189,493,38,15,Player A
2982,JointPQPlayer,259,209,468,31,21,Player A
2983,JointPQPlayer,326,181,507,40,11,Player A
2984,JointPQPlayer,304,194,498,34,12,Player A
2985,JointPQPlayer,278,203,481,32,17,Player A
2986,JointPQPlayer,276,206,482,30,16,Player A
2987,JointPQPlayer,281,206,487,29,14,Player A
2988,JointPQPlayer,295,195,490,35,15,Player A
2989,JointPQPlayer,291,206,497,27,10,Player A
2990,JointPQPlayer,282,202,484,32,16,Player A
2991,JointPQPlayer,302,187,489,40,17,Player A
2992,JointPQPlayer,146,256,402,16,38,JointPQPlayer
2993,JointPQPlayer,309,189,498,37,13,Player A
2994,JointPQPlayer,308,188,496,38,14,Player A
2995,JointPQPlayer,126,271,397,8,37,JointPQPlayer
2996,JointPQPlayer,330,175,505,44,13,Player A
2997,JointPQPlayer,187,242,429,19,30,JointPQPlayer
2998,JointPQPlayer,299,194,493,35,14,Player A
2999,JointPQPlayer,273,203,476,33,19,Player A
3000,JointPQPlayer,307,187,494,39,15,Player A
3001,JointPQPlayer,145,260,405,13,36,JointPQPlayer
3002,JointPQPlayer,305,200,505,29,8,Player A
3003,JointPQPlayer,265,210,475,29,18,Player A
3004,JointPQPlayer,126,266,392,12,40,JointPQPlayer
3005,JointPQPlayer,160,255,415,14,33,JointPQPlayer
3006,JointPQPlayer,290,195,485,36,17,Player A
3007,JointPQPlayer,257,207,464,33,23,Player A
3008,JointPQPlayer,304,194,498,34,12,Player A
3009,JointPQPlayer,333,178,511,41,10,Player A
3010,JointPQPlayer,140,260,400,14,38,JointPQPlayer
3011,JointPQPlayer,309,189,498,37,13,Player A
3012,JointPQPlayer,297,192,489,37,16,Player A
3013,JointPQPlayer,174,244,418,20,34,JointPQPlayer
3014,JointPQPlayer,242,212,454,32,26,Player A
3015,JointPQPlayer,142,257,399,16,39,JointPQPlayer
3016,JointPQPlayer,314,194,508,32,8,Player A
3017,JointPQPlayer,241,216,457,29,24,Player A
3018,JointPQPlayer,294,194,488,36,16,Player A
3019,JointPQPlayer,272,207,479,30,17,Player A
3020,JointPQPlayer,316,191,507,34,9,Player A
3021,JointPQPlayer,303,193,496,35,13,Player A
3022,JointPQPlayer,156,256,412,14,34,JointPQPlayer
3023,JointPQPlayer,149,259,408,13,35,JointPQPlayer
3024,JointPQPlayer,306,191,497,36,13,Player A
3025,JointPQPlayer,276,201,477,34,19,Player A
3026,JointPQPlayer,289,204,493,29,12,Player A
3027,JointPQPlayer,302,192,494,36,14,Player A
3028,JointPQPlayer,298,198,496,32,12,Player A
3029,JointPQPlayer,296,196,492,34,14,Player A
3030,JointPQPlayer,132,267,399,10,37,JointPQPlayer
3031,JointPQPlayer,241,221,462,25,21,Player A
3032,JointPQPlayer,325,185,510,37,9,Player A
3033,JointPQPlayer,284,199,483,34,17,Player A
3034,JointPQPlayer,151,261,412,11,33,JointPQPlayer
3035,JointPQPlayer,150,255,405,16,37,JointPQPlayer
3036,JointPQPlayer,278,203,481,32,17,Player A
3037,JointPQPlayer,299,194,493,35,14,Player A
3038,JointPQPlayer,249,214,463,29,22,Player A
3039,JointPQPlayer,257,207,464,33,23,Player A
3040,JointPQPlayer,230,225,455,24,23,Player A
3041,JointPQPlayer,165,250,415,17,34,JointPQPlayer
3042,JointPQPlayer,148,258,406,14,36,JointPQPlayer
3043,JointPQPlayer,301,196,497,33,12,Player A
3044,JointPQPlayer,216,231,447,22,25,JointPQPlayer
3045,JointPQPlayer,286,201,487,32,15,Player A
3046,JointPQPlayer,312,187,499,38,13,Player A
3047,JointPQPlayer,214,229,443,24,27,JointPQPlayer
3048,JointPQPlayer,278,208,486,28,14,Player A
3049,JointPQPlayer,298,198,496,32,12,Player A
3050,JointPQPlayer,290,200,490,32,14,Player A
3051,JointPQPlayer,269,204,473,33,20,Player A
3052,JointPQPlayer,286,196,482,36,18,Player A
3053,JointPQPlayer,145,260,405,13,36,JointPQPlayer
3054,JointPQPlayer,108,273,381,10,43,JointPQPlayer
3055,JointPQPlayer,134,264,398,12,38,JointPQPlayer
3056,JointPQPlayer,309,189,498,37,13,Player A
3057,JointPQPlayer,301,196,497,33,12,Player A
3058,JointPQPlayer,151,256,407,15,36,JointPQPlayer
3059,JointPQPlayer,279,199,478,35,19,Player A
3060,JointPQPlayer,277,202,479,33,18,Player A
3061,JointPQPlayer,291,196,487,35,16,Player A
3062,JointPQPlayer,294,194,488,36,16,Player A
3063,JointPQPlayer,309,189,498,37,13,Player A
3064,JointPQPlayer,179,244,423,19,32,JointPQPlayer
3065,JointPQPlayer,307,192,499,35,12,Player A
3066,JointPQPlayer,305,185,490,41,17,Player A
3067,JointPQPlayer,270,205,475,32,19,Player A
3068,JointPQPlayer,262,212,474,28,18,Player A
3069,JointPQPlayer,257,207,464,33,23,Player A
3070,JointPQPlayer,135,265,400,11,37,JointPQPlayer
3071,JointPQPlayer,134,264,398,12,38,JointPQPlayer
3072,JointPQPlayer,317,182,499,41,14,Player A
3073,JointPQPlayer,308,193,501,34,11,Player A
3074,JointPQPlayer,148,258,406,14,36,JointPQPlayer
3075,JointPQPlayer,308,193,501,34,11,Player A
3076,JointPQPlayer,289,199,488,33,15,Player A
3077,JointPQPlayer,137,262,399,13,38,JointPQPlayer
3078,JointPQPlayer,314,184,498,40,14,Player A
3079,JointPQPlayer,147,257,404,15,37,JointPQPlayer
3080,JointPQPlayer,147,257,404,15,37,JointPQPlayer
3081,JointPQPlayer,301,196,497,33,12,Player A
3082,JointPQPlayer,279,199,478,35,19,Player A
3083,JointPQPlayer,136,266,402,10,36,JointPQPlayer
3084,JointPQPlayer,296,196,492,34,14,Player A
3085,JointPQPlayer,276,201,477,34,19,Player A
3086,JointPQPlayer,297,192,489,37,16,Player A
3087,JointPQPlayer,182,247,429,16,29,JointPQPlayer
3088,JointPQPlayer,311,186,497,39,14,Player A
3089,JointPQPlayer,161,261,422,9,29,JointPQPlayer
3090,JointPQPlayer,295,195,490,35,15,Player A
3091,JointPQPlayer,140,265,405,10,35,JointPQPlayer
3092,JointPQPlayer,216,226,442,26,28,JointPQPlayer
3093,JointPQPlayer,283,203,486,31,15,Player A
3094,JointPQPlayer,281,201,482,33,17,Player A
3095,JointPQPlayer,155,255,410,15,35,JointPQPlayer
3096,JointPQPlayer,275,200,475,35,20,Player A
3097,JointPQPlayer,266,211,477,28,17,Player A
3098,JointPQPlayer,221,226,447,25,26,JointPQPlayer
3099,JointPQPlayer,312,192,504,34,10,Player A
3100,JointPQPlayer,221,221,442,29,29,Tie
3101,JointPQPlayer,280,200,480,34,18,Player A
3102,JointPQPlayer,287,197,484,35,17,Player A
3103,JointPQPlayer,297,197,494,33,13,Player A
3104,JointPQPlayer,286,196,482,36,18,Player A
3105,JointPQPlayer,339,174,513,43,10,Player A
3106,JointPQPlayer,314,189,503,36,11,Player A
3107,JointPQPlayer,289,194,483,37,18,Player A
3108,JointPQPlayer,301,191,492,37,15,Player A
3109,JointPQPlayer,285,200,485,33,16,Player A
3110,JointPQPlayer,284,199,483,34,17,Player A
3111,JointPQPlayer,274,204,478,32,18,Player A
3112,JointPQPlayer,307,187,494,39,15,Player A
3113,JointPQPlayer,301,191,492,37,15,Player A
3114,JointPQPlayer,283,203,486,31,15,Player A
3115,JointPQPlayer,269,204,473,33,20,Player A
3116,JointPQPlayer,307,192,499,35,12,Player A
3117,JointPQPlayer,279,204,483,31,16,Player A
3118,JointPQPlayer,309,194,503,33,10,Player A
3119,JointPQPlayer,294,194,488,36,16,Player A
3120,JointPQPlayer,304,189,493,38,15,Player A
3121,JointPQPlayer,164,249,413,18,35,JointPQPlayer
3122,JointPQPlayer,317,187,504,37,11,Player A
3123,JointPQPlayer,269,204,473,33,20,Player A
3124,JointPQPlayer,141,256,397,17,40,JointPQPlayer
3125,JointPQPlayer,293,198,491,33,14,Player A
3126,JointPQPlayer,325,180,505,41,12,Player A
3127,JointPQPlayer,327,182,509,39,10,Player A
3128,JointPQPlayer,302,197,499,32,11,Player A
3129,JointPQPlayer,244,214,458,30,24,Player A
3130,JointPQPlayer,124,264,388,14,42,JointPQPlayer
3131,JointPQPlayer,277,197,474,37,21,Player A
3132,JointPQPlayer,126,271,397,8,37,JointPQPlayer
3133,JointPQPlayer,145,260,405,13,36,JointPQPlayer
3134,JointPQPlayer,323,183,506,39,11,Player A
3135,JointPQPlayer,299,194,493,35,14,Player A
3136,JointPQPlayer,275,205,480,31,17,Player A
3137,JointPQPlayer,244,219,463,26,21,Player A
3138,JointPQPlayer,317,187,504,37,11,Player A
3139,JointPQPlayer,144,259,403,14,37,JointPQPlayer
3140,JointPQPlayer,151,261,412,11,33,JointPQPlayer
3141,JointPQPlayer,292,192,484,38,18,Player A
3142,JointPQPlayer,289,199,488,33,15,Player A
3143,JointPQPlayer,301,191,492,37,15,Player A
3144,JointPQPlayer,310,190,500,36,12,Player A
3145,JointPQPlayer,281,201,482,33,17,Player A
3146,JointPQPlayer,305,195,500,33,11,Player A
3147,JointPQPlayer,151,256,407,15,36,JointPQPlayer
3148,JointPQPlayer,163,248,411,19,36,JointPQPlayer
3149,JointPQPlayer,275,205,480,31,17,Player A
3150,JointPQPlayer,292,197,489,34,15,Player A
3151,JointPQPlayer,141,261,402,13,37,JointPQPlayer
3152,JointPQPlayer,302,197,499,32,11,Player A
3153,JointPQPlayer,279,199,478,35,19,Player A
3154,JointPQPlayer,309,189,498,37,13,Player A
3155,JointPQPlayer,263,208,471,31,20,Player A
3156,JointPQPlayer,285,200,485,33,16,Player A
3157,JointPQPlayer,298,193,491,36,15,Player A
3158,JointPQPlayer,319,184,503,39,12,Player A
3159,JointPQPlayer,122,272,394,8,38,JointPQPlayer
3160,JointPQPlayer,312,192,504,34,10,Player A
3161,JointPQPlayer,307,192,499,35,12,Player A
3162,JointPQPlayer,146,261,407,12,35,JointPQPlayer
3163,JointPQPlayer,279,199,478,35,19,Player A
3164,JointPQPlayer,294,194,488,36,16,Player A
3165,JointPQPlayer,309,184,493,41,16,Player A
3166,JointPQPlayer,300,195,495,34,13,Player A
3167,JointPQPlayer,249,214,463,29,22,Player A
3168,JointPQPlayer,316,186,502,38,12,Player A
3169,JointPQPlayer,300,190,490,38,16,Player A
3170,JointPQPlayer,219,224,443,27,28,JointPQPlayer
3171,JointPQPlayer,188,243,431,18,29,JointPQPlayer
3172,JointPQPlayer,270,210,480,28,16,Player A
3173,JointPQPlayer,234,219,453,28,25,Player A
3174,JointPQPlayer,151,256,407,15,36,JointPQPlayer
3175,JointPQPlayer,276,201,477,34,19,Player A
3176,JointPQPlayer,151,256,407,15,36,JointPQPlayer
3177,JointPQPlayer,300,190,490,38,16,Player A
3178,JointPQPlayer,308,188,496,38,14,Player A
3179,JointPQPlayer,145,260,405,13,36,JointPQPlayer
3180,JointPQPlayer,154,259,413,12,33,JointPQPlayer
3181,JointPQPlayer,302,192,494,36,14,Player A
3182,JointPQPlayer,277,202,479,33,18,Player A
3183,JointPQPlayer,301,196,497,33,12,Player A
3184,JointPQPlayer,131,266,397,11,38,JointPQPlayer
3185,JointPQPlayer,168,253,421,14,31,JointPQPlayer
3186,JointPQPlayer,305,190,495,37,14,Player A
3187,JointPQPlayer,258,213,471,28,19,Player A
3188,JointPQPlayer,335,180,515,39,8,Player A
3189,JointPQPlayer,296,201,497,30,11,Player A
3190,JointPQPlayer,306,191,497,36,13,Player A
3191,JointPQPlayer,183,243,426,19,31,JointPQPlayer
3192,JointPQPlayer,311,186,497,39,14,Player A
3193,JointPQPlayer,304,194,498,34,12,Player A
3194,JointPQPlayer,302,192,494,36,14,Player A
3195,JointPQPlayer,265,205,470,33,21,Player A
3196,JointPQPlayer,130,265,395,12,39,JointPQPlayer
3197,JointPQPlayer,130,265,395,12,39,JointPQPlayer
3198,JointPQPlayer,285,195,480,37,19,Player A
3199,JointPQPlayer,302,197,499,32,11,Player A
3200,JointPQPlayer,270,205,475,32,19,Player A
3201,JointPQPlayer,160,260,420,10,30,JointPQPlayer
3202,JointPQPlayer,286,196,482,36,18,Player A
3203,JointPQPlayer,145,260,405,13,36,JointPQPlayer
3204,JointPQPlayer,310,190,500,36,12,Player A
3205,JointPQPlayer,218,223,441,28,29,JointPQPlayer
3206,JointPQPlayer,299,189,488,39,17,Player A
3207,JointPQPlayer,166,251,417,16,33,JointPQPlayer
3208,JointPQPlayer,293,193,486,37,17,Player A
3209,JointPQPlayer,305,190,495,37,14,Player A
3210,JointPQPlayer,163,253,416,15,33,JointPQPlayer
3211,JointPQPlayer,285,195,480,37,19,Player A
3212,JointPQPlayer,302,192,494,36,14,Player A
3213,JointPQPlayer,300,190,490,38,16,Player A
3214,JointPQPlayer,299,199,498,31,11,Player A
3215,JointPQPlayer,283,193,476,39,21,Player A
3216,JointPQPlayer,294,194,488,36,16,Player A
3217,JointPQPlayer,321,181,502,41,13,Player A
3218,JointPQPlayer,272,202,474,34,20,Player A
3219,JointPQPlayer,248,218,466,26,20,Player A
3220,JointPQPlayer,245,220,465,25,20,Player A
3221,JointPQPlayer,155,250,405,19,38,JointPQPlayer
3222,JointPQPlayer,299,194,493,35,14,Player A
3223,JointPQPlayer,299,199,498,31,11,Player A
3224,JointPQPlayer,276,206,482,30,16,Player A
3225,JointPQPlayer,146,261,407,12,35,JointPQPlayer
3226,JointPQPlayer,128,263,391,14,41,JointPQPlayer
3227,JointPQPlayer,287,197,484,35,17,Player A
3228,JointPQPlayer,135,260,395,15,40,JointPQPlayer
3229,JointPQPlayer,306,191,497,36,13,Player A
3230,JointPQPlayer,294,194,488,36,16,Player A
3231,JointPQPlayer,271,206,477,31,18,Player A
3232,JointPQPlayer,285,205,490,29,13,Player A
3233,JointPQPlayer,294,199,493,32,13,Player A
3234,JointPQPlayer,325,180,505,41,12,Player A
3235,JointPQPlayer,265,205,470,33,21,Player A
3236,JointPQPlayer,160,255,415,14,33,JointPQPlayer
3237,JointPQPlayer,144,259,403,14,37,JointPQPlayer
3238,JointPQPlayer,312,187,499,38,13,Player A
3239,JointPQPlayer,299,194,493,35,14,Player A
3240,JointPQPlayer,164,249,413,18,35,JointPQPlayer
3241,JointPQPlayer,248,218,466,26,20,Player A
3242,JointPQPlayer,222,227,449,24,25,JointPQPlayer
3243,JointPQPlayer,155,260,415,11,32,JointPQPlayer
3244,JointPQPlayer,276,206,482,30,16,Player A
3245,JointPQPlayer,289,189,478,41,21,Player A
3246,JointPQPlayer,303,193,496,35,13,Player A
3247,JointPQPlayer,324,184,508,38,10,Player A
3248,JointPQPlayer,215,225,440,27,29,JointPQPlayer
3249,JointPQPlayer,197,237,434,21,29,JointPQPlayer
3250,JointPQPlayer,142,262,404,12,36,JointPQPlayer
3251,JointPQPlayer,314,189,503,36,11,Player A
3252,JointPQPlayer,278,203,481,32,17,Player A
3253,JointPQPlayer,279,204,483,31,16,Player A
3254,JointPQPlayer,282,202,484,32,16,Player A
3255,JointPQPlayer,187,247,434,15,27,JointPQPlayer
3256,JointPQPlayer,264,204,468,34,22,Player A
3257,JointPQPlayer,286,201,487,32,15,Player A
3258,JointPQPlayer,279,199,478,35,19,Player A
3259,JointPQPlayer,303,198,501,31,10,Player A
3260,JointPQPlayer,299,194,493,35,14,Player A
3261,JointPQPlayer,283,193,476,39,21,Player A
3262,JointPQPlayer,151,256,407,15,36,JointPQPlayer
3263,JointPQPlayer,288,198,486,34,16,Player A
3264,JointPQPlayer,290,195,485,36,17,Player A
3265,JointPQPlayer,279,204,483,31,16,Player A
3266,JointPQPlayer,301,191,492,37,15,Player A
3267,JointPQPlayer,279,204,483,31,16,Player A
3268,JointPQPlayer,323,183,506,39,11,Player A
3269,JointPQPlayer,135,265,400,11,37,JointPQPlayer
3270,JointPQPlayer,137,262,399,13,38,JointPQPlayer
3271,JointPQPlayer,158,258,416,12,32,JointPQPlayer
3272,JointPQPlayer,293,193,486,37,17,Player A
3273,JointPQPlayer,308,188,496,38,14,Player A
3274,JointPQPlayer,299,194,493,35,14,Player A
3275,JointPQPlayer,307,192,499,35,12,Player A
3276,JointPQPlayer,288,198,486,34,16,Player A
3277,JointPQPlayer,148,263,411,10,33,JointPQPlayer
3278,JointPQPlayer,275,200,475,35,20,Player A
3279,JointPQPlayer,130,265,395,12,39,JointPQPlayer
3280,JointPQPlayer,264,204,468,34,22,Player A
3281,JointPQPlayer,302,192,494,36,14,Player A
3282,JointPQPlayer,306,191,497,36,13,Player A
3283,JointPQPlayer,259,209,468,31,21,Player A
3284,JointPQPlayer,314,194,508,32,8,Player A
3285,JointPQPlayer,286,201,487,32,15,Player A
3286,JointPQPlayer,289,199,488,33,15,Player A
3287,JointPQPlayer,245,215,460,29,23,Player A
3288,JointPQPlayer,287,197,484,35,17,Player A
3289,JointPQPlayer,342,177,519,40,7,Player A
3290,JointPQPlayer,150,260,410,12,34,JointPQPlayer
3291,JointPQPlayer,299,194,493,35,14,Player A
3292,JointPQPlayer,303,198,501,31,10,Player A
3293,JointPQPlayer,267,207,474,31,19,Player A
3294,JointPQPlayer,285,195,480,37,19,Player A
3295,JointPQPlayer,302,187,489,40,17,Player A
3296,JointPQPlayer,324,189,513,34,7,Player A
3297,JointPQPlayer,151,256,407,15,36,JointPQPlayer
3298,JointPQPlayer,282,197,479,36,19,Player A
3299,JointPQPlayer,266,201,467,36,23,Player A
3300,JointPQPlayer,174,244,418,20,34,JointPQPlayer
3301,JointPQPlayer,308,193,501,34,11,Player A
3302,JointPQPlayer,145,260,405,13,36,JointPQPlayer
3303,JointPQPlayer,265,205,470,33,21,Player A
3304,JointPQPlayer,301,191,492,37,15,Player A
3305,JointPQPlayer,288,198,486,34,16,Player A
3306,JointPQPlayer,139,264,403,11,36,JointPQPlayer
3307,JointPQPlayer,291,201,492,31,13,Player A
3308,JointPQPlayer,302,187,489,40,17,Player A
3309,JointPQPlayer,322,182,504,40,12,Player A
3310,JointPQPlayer,291,201,492,31,13,Player A
3311,JointPQPlayer,132,262,394,14,40,JointPQPlayer
3312,JointPQPlayer,287,197,484,35,17,Player A
3313,JointPQPlayer,134,269,403,8,35,JointPQPlayer
3314,JointPQPlayer,301,191,492,37,15,Player A
3315,JointPQPlayer,262,212,474,28,18,Player A
3316,JointPQPlayer,291,196,487,35,16,Player A
3317,JointPQPlayer,153,258,411,13,34,JointPQPlayer
3318,JointPQPlayer,292,197,489,34,15,Player A
3319,JointPQPlayer,162,252,414,16,34,JointPQPlayer
3320,JointPQPlayer,290,195,485,36,17,Player A
3321,JointPQPlayer,281,211,492,25,11,Player A
3322,JointPQPlayer,290,195,485,36,17,Player A
3323,JointPQPlayer,133,263,396,13,39,JointPQPlayer
3324,JointPQPlayer,303,193,496,35,13,Player A
3325,JointPQPlayer,148,258,406,14,36,JointPQPlayer
3326,JointPQPlayer,298,193,491,36,15,Player A
3327,JointPQPlayer,310,190,500,36,12,Player A
3328,JointPQPlayer,298,193,491,36,15,Player A
3329,JointPQPlayer,146,261,407,12,35,JointPQPlayer
3330,JointPQPlayer,323,183,506,39,11,Player A
3331,JointPQPlayer,134,259,393,16,41,JointPQPlayer
3332,JointPQPlayer,156,256,412,14,34,JointPQPlayer
3333,JointPQPlayer,314,184,498,40,14,Player A
3334,JointPQPlayer,275,200,475,35,20,Player A
3335,JointPQPlayer,299,194,493,35,14,Player A
3336,JointPQPlayer,273,203,476,33,19,Player A
3337,JointPQPlayer,292,197,489,34,15,Player A
3338,JointPQPlayer,320,185,505,38,11,Player A
3339,JointPQPlayer,282,202,484,32,16,Player A
3340,JointPQPlayer,307,192,499,35,12,Player A
3341,JointPQPlayer,272,207,479,30,17,Player A
3342,JointPQPlayer,291,206,497,27,10,Player A
3343,JointPQPlayer,311,191,502,35,11,Player A
3344,JointPQPlayer,277,202,479,33,18,Player A
3345,JointPQPlayer,291,196,487,35,16,Player A
3346,JointPQPlayer,148,258,406,14,36,JointPQPlayer
3347,JointPQPlayer,293,193,486,37,17,Player A
3348,JointPQPlayer,291,196,487,35,16,Player A
3349,JointPQPlayer,134,264,398,12,38,JointPQPlayer
3350,JointPQPlayer,273,203,476,33,19,Player A
3351,JointPQPlayer,302,197,499,32,11,Player A
3352,JointPQPlayer,293,193,486,37,17,Player A
3353,JointPQPlayer,143,258,401,15,38,JointPQPlayer
3354,JointPQPlayer,298,188,486,40,18,Player A
3355,JointPQPlayer,296,196,492,34,14,Player A
3356,JointPQPlayer,302,197,499,32,11,Player A
3357,JointPQPlayer,287,197,484,35,17,Player A
3358,JointPQPlayer,289,199,488,33,15,Player A
3359,JointPQPlayer,288,198,486,34,16,Player A
3360,JointPQPlayer,313,188,501,37,12,Player A
3361,JointPQPlayer,157,252,409,17,36,JointPQPlayer
3362,JointPQPlayer,269,204,473,33,20,Player A
3363,JointPQPlayer,289,199,488,33,15,Player A
3364,JointPQPlayer,295,195,490,35,15,Player A
3365,JointPQPlayer,143,258,401,15,38,JointPQPlayer
3366,JointPQPlayer,142,257,399,16,39,JointPQPlayer
3367,JointPQPlayer,125,270,395,9,38,JointPQPlayer
3368,JointPQPlayer,131,266,397,11,38,JointPQPlayer
3369,JointPQPlayer,305,185,490,41,17,Player A
3370,JointPQPlayer,274,204,478,32,18,Player A
3371,JointPQPlayer,291,191,482,39,19,Player A
3372,JointPQPlayer,285,200,485,33,16,Player A
3373,JointPQPlayer,140,260,400,14,38,JointPQPlayer
3374,JointPQPlayer,160,250,410,18,36,JointPQPlayer
3375,JointPQPlayer,113,273,386,9,41,JointPQPlayer
3376,JointPQPlayer,299,189,488,39,17,Player A
3377,JointPQPlayer,145,265,410,9,33,JointPQPlayer
3378,JointPQPlayer,153,253,406,17,37,JointPQPlayer
3379,JointPQPlayer,319,189,508,35,9,Player A
3380,JointPQPlayer,128,263,391,14,41,JointPQPlayer
3381,JointPQPlayer,277,202,479,33,18,Player A
3382,JointPQPlayer,281,201,482,33,17,Player A
3383,JointPQPlayer,292,197,489,34,15,Player A
3384,JointPQPlayer,303,188,491,39,16,Player A
3385,JointPQPlayer,307,192,499,35,12,Player A
3386,JointPQPlayer,297,192,489,37,16,Player A
3387,JointPQPlayer,306,191,497,36,13,Player A
3388,JointPQPlayer,282,202,484,32,16,Player A
3389,JointPQPlayer,276,206,482,30,16,Player A
3390,JointPQPlayer,303,188,491,39,16,Player A
3391,JointPQPlayer,289,199,488,33,15,Player A
3392,JointPQPlayer,306,191,497,36,13,Player A
3393,JointPQPlayer,266,206,472,32,20,Player A
3394,JointPQPlayer,312,187,499,38,13,Player A
3395,JointPQPlayer,275,200,475,35,20,Player A
3396,JointPQPlayer,277,207,484,29,15,Player A
3397,JointPQPlayer,297,192,489,37,16,Player A
3398,JointPQPlayer,320,180,500,42,14,Player A
3399,JointPQPlayer,298,198,496,32,12,Player A
3400,JointPQPlayer,153,253,406,17,37,JointPQPlayer
3401,JointPQPlayer,159,254,413,15,34,JointPQPlayer
3402,JointPQPlayer,137,262,399,13,38,JointPQPlayer
3403,JointPQPlayer,305,190,495,37,14,Player A
3404,JointPQPlayer,192,237,429,22,31,JointPQPlayer
3405,JointPQPlayer,317,187,504,37,11,Player A
3406,JointPQPlayer,174,244,418,20,34,JointPQPlayer
3407,JointPQPlayer,306,186,492,40,16,Player A
3408,JointPQPlayer,295,200,495,31,12,Player A
3409,JointPQPlayer,318,178,496,44,16,Player A
3410,JointPQPlayer,126,271,397,8,37,JointPQPlayer
3411,JointPQPlayer,292,197,489,34,15,Player A
3412,JointPQPlayer,259,204,463,35,24,Player A
3413,JointPQPlayer,131,271,402,7,35,JointPQPlayer
3414,JointPQPlayer,299,194,493,35,14,Player A
3415,JointPQPlayer,170,250,420,16,32,JointPQPlayer
3416,JointPQPlayer,231,221,452,27,25,Player A
3417,JointPQPlayer,287,197,484,35,17,Player A
3418,JointPQPlayer,184,249,433,14,27,JointPQPlayer
3419,JointPQPlayer,307,187,494,39,15,Player A
3420,JointPQPlayer,283,203,486,31,15,Player A
3421,JointPQPlayer,322,182,504,40,12,Player A
3422,JointPQPlayer,284,199,483,34,17,Player A
3423,JointPQPlayer,310,190,500,36,12,Player A
3424,JointPQPlayer,303,193,496,35,13,Player A
3425,JointPQPlayer,287,202,489,31,14,Player A
3426,JointPQPlayer,299,189,488,39,17,Player A
3427,JointPQPlayer,145,260,405,13,36,JointPQPlayer
3428,JointPQPlayer,201,236,437,21,28,JointPQPlayer
3429,JointPQPlayer,280,200,480,34,18,Player A
3430,JointPQPlayer,310,190,500,36,12,Player A
3431,JointPQPlayer,321,186,507,37,10,Player A
3432,JointPQPlayer,279,199,478,35,19,Player A
3433,JointPQPlayer,274,209,483,28,15,Player A
3434,JointPQPlayer,283,203,486,31,15,Player A
3435,JointPQPlayer,266,206,472,32,20,Player A
3436,JointPQPlayer,149,254,403,17,38,JointPQPlayer
3437,JointPQPlayer,272,207,479,30,17,Player A
3438,JointPQPlayer,309,189,498,37,13,Player A
3439,JointPQPlayer,326,181,507,40,11,Player A
3440,JointPQPlayer,151,261,412,11,33,JointPQPlayer
3441,JointPQPlayer,311,191,502,35,11,Player A
3442,JointPQPlayer,265,200,465,37,24,Player A
3443,JointPQPlayer,152,252,404,18,38,JointPQPlayer
3444,JointPQPlayer,273,203,476,33,19,Player A
3445,JointPQPlayer,133,263,396,13,39,JointPQPlayer
3446,JointPQPlayer,294,194,488,36,16,Player A
3447,JointPQPlayer,281,201,482,33,17,Player A
3448,JointPQPlayer,263,208,471,31,20,Player A
3449,JointPQPlayer,193,238,431,21,30,JointPQPlayer
3450,JointPQPlayer,269,209,478,29,17,Player A
3451,JointPQPlayer,318,188,506,36,10,Player A
3452,JointPQPlayer,324,179,503,42,13,Player A
3453,JointPQPlayer,312,187,499,38,13,Player A
3454,JointPQPlayer,305,190,495,37,14,Player A
3455,JointPQPlayer,271,206,477,31,18,Player A
3456,JointPQPlayer,292,202,494,30,12,Player A
3457,JointPQPlayer,302,192,494,36,14,Player A
3458,JointPQPlayer,132,262,394,14,40,JointPQPlayer
3459,JointPQPlayer,299,189,488,39,17,Player A
3460,JointPQPlayer,293,198,491,33,14,Player A
3461,JointPQPlayer,301,191,492,37,15,Player A
3462,JointPQPlayer,298,193,491,36,15,Player A
3463,JointPQPlayer,304,184,488,42,18,Player A
3464,JointPQPlayer,127,262,389,15,42,JointPQPlayer
3465,JointPQPlayer,315,185,500,39,13,Player A
3466,JointPQPlayer,291,196,487,35,16,Player A
3467,JointPQPlayer,315,185,500,39,13,Player A
3468,JointPQPlayer,158,253,411,16,35,JointPQPlayer
3469,JointPQPlayer,249,209,458,33,25,Player A
3470,JointPQPlayer,289,199,488,33,15,Player A
3471,JointPQPlayer,320,185,505,38,11,Player A
3472,JointPQPlayer,175,250,425,15,30,JointPQPlayer
3473,JointPQPlayer,142,262,404,12,36,JointPQPlayer
3474,JointPQPlayer,289,199,488,33,15,Player A
3475,JointPQPlayer,311,186,497,39,14,Player A
3476,JointPQPlayer,278,198,476,36,20,Player A
3477,JointPQPlayer,288,198,486,34,16,Player A
3478,JointPQPlayer,296,196,492,34,14,Player A
3479,JointPQPlayer,149,259,408,13,35,JointPQPlayer
3480,JointPQPlayer,274,204,478,32,18,Player A
3481,JointPQPlayer,157,247,404,21,39,JointPQPlayer
3482,JointPQPlayer,302,187,489,40,17,Player A
3483,JointPQPlayer,240,220,460,26,22,Player A
3484,JointPQPlayer,306,186,492,40,16,Player A
3485,JointPQPlayer,301,191,492,37,15,Player A
3486,JointPQPlayer,169,249,418,17,33,JointPQPlayer
3487,JointPQPlayer,275,205,480,31,17,Player A
3488,JointPQPlayer,288,198,486,34,16,Player A
3489,JointPQPlayer,317,187,504,37,11,Player A
3490,JointPQPlayer,285,200,485,33,16,Player A
3491,JointPQPlayer,264,209,473,30,19,Player A
3492,JointPQPlayer,283,198,481,35,18,Player A
3493,JointPQPlayer,251,211,462,31,23,Player A
3494,JointPQPlayer,275,205,480,31,17,Player A
3495,JointPQPlayer,291,196,487,35,16,Player A
3496,JointPQPlayer,270,205,475,32,19,Player A
3497,JointPQPlayer,112,272,384,10,42,JointPQPlayer
3498,JointPQPlayer,317,182,499,41,14,Player A
3499,JointPQPlayer,147,257,404,15,37,JointPQPlayer
3500,JointPQPlayer,301,196,497,33,12,Player A
3501,JointPQPlayer,238,218,456,28,24,Player A
3502,JointPQPlayer,248,218,466,26,20,Player A
3503,JointPQPlayer,307,187,494,39,15,Player A
3504,JointPQPlayer,306,186,492,40,16,Player A
3505,JointPQPlayer,292,197,489,34,15,Player A
3506,JointPQPlayer,165,250,415,17,34,JointPQPlayer
3507,JointPQPlayer,128,268,396,10,38,JointPQPlayer
3508,JointPQPlayer,153,253,406,17,37,JointPQPlayer
3509,JointPQPlayer,137,262,399,13,38,JointPQPlayer
3510,JointPQPlayer,142,257,399,16,39,JointPQPlayer
3511,JointPQPlayer,309,189,498,37,13,Player A
3512,JointPQPlayer,310,185,495,40,15,Player A
3513,JointPQPlayer,251,211,462,31,23,Player A
3514,JointPQPlayer,142,262,404,12,36,JointPQPlayer
3515,JointPQPlayer,287,202,489,31,14,Player A
3516,JointPQPlayer,152,252,404,18,38,JointPQPlayer
3517,JointPQPlayer,267,207,474,31,19,Player A
3518,JointPQPlayer,250,215,465,28,21,Player A
3519,JointPQPlayer,279,194,473,39,22,Player A
3520,JointPQPlayer,307,192,499,35,12,Player A
3521,JointPQPlayer,174,249,423,16,31,JointPQPlayer
3522,JointPQPlayer,284,199,483,34,17,Player A
3523,JointPQPlayer,230,220,450,28,26,Player A
3524,JointPQPlayer,192,242,434,18,28,JointPQPlayer
3525,JointPQPlayer,195,245,440,15,25,JointPQPlayer
3526,JointPQPlayer,164,254,418,14,32,JointPQPlayer
3527,JointPQPlayer,285,195,480,37,19,Player A
3528,JointPQPlayer,146,256,402,16,38,JointPQPlayer
3529,JointPQPlayer,281,201,482,33,17,Player A
3530,JointPQPlayer,293,193,486,37,17,Player A
3531,JointPQPlayer,296,191,487,38,17,Player A
3532,JointPQPlayer,141,261,402,13,37,JointPQPlayer
3533,JointPQPlayer,159,254,413,15,34,JointPQPlayer
3534,JointPQPlayer,307,192,499,35,12,Player A
3535,JointPQPlayer,292,197,489,34,15,Player A
3536,JointPQPlayer,295,195,490,35,15,Player A
3537,JointPQPlayer,303,183,486,43,19,Player A
3538,JointPQPlayer,303,193,496,35,13,Player A
3539,JointPQPlayer,262,202,464,36,24,Player A
3540,JointPQPlayer,295,190,485,39,18,Player A
3541,JointPQPlayer,168,253,421,14,31,JointPQPlayer
3542,JointPQPlayer,244,214,458,30,24,Player A
3543,JointPQPlayer,294,199,493,32,13,Player A
3544,JointPQPlayer,312,182,494,42,16,Player A
3545,JointPQPlayer,205,225,430,29,33,JointPQPlayer
3546,JointPQPlayer,271,201,472,35,21,Player A
3547,JointPQPlayer,278,203,481,32,17,Player A
3548,JointPQPlayer,225,225,450,25,25,Tie
3549,JointPQPlayer,319,184,503,39,12,Player A
3550,JointPQPlayer,304,189,493,38,15,Player A
3551,JointPQPlayer,279,204,483,31,16,Player A
3552,JointPQPlayer,112,272,384,10,42,JointPQPlayer
3553,JointPQPlayer,162,252,414,16,34,JointPQPlayer
3554,JointPQPlayer,265,210,475,29,18,Player A
3555,JointPQPlayer,163,253,416,15,33,JointPQPlayer
3556,JointPQPlayer,278,203,481,32,17,Player A
3557,JointPQPlayer,306,186,492,40,16,Player A
3558,JointPQPlayer,220,230,450,22,24,JointPQPlayer
3559,JointPQPlayer,158,253,411,16,35,JointPQPlayer
3560,JointPQPlayer,143,258,401,15,38,JointPQPlayer
3561,JointPQPlayer,278,203,481,32,17,Player A
3562,JointPQPlayer,287,197,484,35,17,Player A
3563,JointPQPlayer,308,188,496,38,14,Player A
3564,JointPQPlayer,305,190,495,37,14,Player A
3565,JointPQPlayer,144,259,403,14,37,JointPQPlayer
3566,JointPQPlayer,163,253,416,15,33,JointPQPlayer
3567,JointPQPlayer,282,197,479,36,19,Player A
3568,JointPQPlayer,170,260,430,8,26,JointPQPlayer
3569,JointPQPlayer,273,203,476,33,19,Player A
3570,JointPQPlayer,240,215,455,30,25,Player A
3571,JointPQPlayer,306,191,497,36,13,Player A
3572,JointPQPlayer,276,201,477,34,19,Player A
3573,JointPQPlayer,225,225,450,25,25,Tie
3574,JointPQPlayer,300,195,495,34,13,Player A
3575,JointPQPlayer,312,187,499,38,13,Player A
3576,JointPQPlayer,145,255,400,17,39,JointPQPlayer
3577,JointPQPlayer,261,211,472,29,19,Player A
3578,JointPQPlayer,293,198,491,33,14,Player A
3579,JointPQPlayer,257,217,474,25,17,Player A
3580,JointPQPlayer,281,196,477,37,20,Player A
3581,JointPQPlayer,270,210,480,28,16,Player A
3582,JointPQPlayer,263,208,471,31,20,Player A
3583,JointPQPlayer,312,187,499,38,13,Player A
3584,JointPQPlayer,275,200,475,35,20,Player A
3585,JointPQPlayer,275,205,480,31,17,Player A
3586,JointPQPlayer,309,189,498,37,13,Player A
3587,JointPQPlayer,290,195,485,36,17,Player A
3588,JointPQPlayer,264,209,473,30,19,Player A
3589,JointPQPlayer,291,196,487,35,16,Player A
3590,JointPQPlayer,283,198,481,35,18,Player A
3591,JointPQPlayer,298,193,491,36,15,Player A
3592,JointPQPlayer,276,211,487,26,13,Player A
3593,JointPQPlayer,283,198,481,35,18,Player A
3594,JointPQPlayer,143,258,401,15,38,JointPQPlayer
3595,JointPQPlayer,123,263,386,15,43,JointPQPlayer
3596,JointPQPlayer,314,184,498,40,14,Player A
3597,JointPQPlayer,279,204,483,31,16,Player A
3598,JointPQPlayer,314,189,503,36,11,Player A
3599,JointPQPlayer,137,262,399,13,38,JointPQPlayer
3600,JointPQPlayer,276,206,482,30,16,Player A
3601,JointPQPlayer,137,262,399,13,38,JointPQPlayer
3602,JointPQPlayer,295,195,490,35,15,Player A
3603,JointPQPlayer,293,198,491,33,14,Player A
3604,JointPQPlayer,310,190,500,36,12,Player A
3605,JointPQPlayer,301,191,492,37,15,Player A
3606,JointPQPlayer,281,206,487,29,14,Player A
3607,JointPQPlayer,287,197,484,35,17,Player A
3608,JointPQPlayer,280,200,480,34,18,Player A
3609,JointPQPlayer,274,199,473,36,21,Player A
3610,JointPQPlayer,279,204,483,31,16,Player A
3611,JointPQPlayer,305,190,495,37,14,Player A
3612,JointPQPlayer,270,205,475,32,19,Player A
3613,JointPQPlayer,266,206,472,32,20,Player A
3614,JointPQPlayer,275,205,480,31,17,Player A
3615,JointPQPlayer,178,248,426,16,30,JointPQPlayer
3616,JointPQPlayer,302,192,494,36,14,Player A
3617,JointPQPlayer,299,194,493,35,14,Player A
3618,JointPQPlayer,309,184,493,41,16,Player A
3619,JointPQPlayer,272,207,479,30,17,Player A
3620,JointPQPlayer,272,207,479,30,17,Player A
3621,JointPQPlayer,143,263,406,11,35,JointPQPlayer
3622,JointPQPlayer,285,200,485,33,16,Player A
3623,JointPQPlayer,265,210,475,29,18,Player A
3624,JointPQPlayer,323,183,506,39,11,Player A
3625,JointPQPlayer,139,259,398,15,39,JointPQPlayer
3626,JointPQPlayer,297,187,484,41,19,Player A
3627,JointPQPlayer,318,188,506,36,10,Player A
3628,JointPQPlayer,298,193,491,36,15,Player A
3629,JointPQPlayer,274,199,473,36,21,Player A
3630,JointPQPlayer,286,196,482,36,18,Player A
3631,JointPQPlayer,299,189,488,39,17,Player A
3632,JointPQPlayer,245,215,460,29,23,Player A
3633,JointPQPlayer,279,204,483,31,16,Player A
3634,JointPQPlayer,260,200,460,38,26,Player A
3635,JointPQPlayer,285,195,480,37,19,Player A
3636,JointPQPlayer,293,198,491,33,14,Player A
3637,JointPQPlayer,281,196,477,37,20,Player A
3638,JointPQPlayer,132,262,394,14,40,JointPQPlayer
3639,JointPQPlayer,215,230,445,23,26,JointPQPlayer
3640,JointPQPlayer,239,219,458,27,23,Player A
3641,JointPQPlayer,255,210,465,31,22,Player A
3642,JointPQPlayer,285,205,490,29,13,Player A
3643,JointPQPlayer,261,211,472,29,19,Player A
3644,JointPQPlayer,295,195,490,35,15,Player A
3645,JointPQPlayer,289,199,488,33,15,Player A
3646,JointPQPlayer,274,209,483,28,15,Player A
3647,JointPQPlayer,295,195,490,35,15,Player A
3648,JointPQPlayer,291,196,487,35,16,Player A
3649,JointPQPlayer,152,262,414,10,32,JointPQPlayer
3650,JointPQPlayer,136,261,397,14,39,JointPQPlayer
3651,JointPQPlayer,315,190,505,35,10,Player A
3652,JointPQPlayer,155,250,405,19,38,JointPQPlayer
3653,JointPQPlayer,282,202,484,32,16,Player A
3654,JointPQPlayer,327,177,504,43,13,Player A
3655,JointPQPlayer,293,198,491,33,14,Player A
3656,JointPQPlayer,321,181,502,41,13,Player A
3657,JointPQPlayer,295,195,490,35,15,Player A
3658,JointPQPlayer,153,258,411,13,34,JointPQPlayer
3659,JointPQPlayer,299,194,493,35,14,Player A
3660,JointPQPlayer,288,198,486,34,16,Player A
3661,JointPQPlayer,284,199,483,34,17,Player A
3662,JointPQPlayer,295,190,485,39,18,Player A
3663,JointPQPlayer,118,268,386,12,42,JointPQPlayer
3664,JointPQPlayer,298,188,486,40,18,Player A
3665,JointPQPlayer,262,207,469,32,21,Player A
3666,JointPQPlayer,163,258,421,11,30,JointPQPlayer
3667,JointPQPlayer,273,203,476,33,19,Player A
3668,JointPQPlayer,274,199,473,36,21,Player A
3669,JointPQPlayer,293,198,491,33,14,Player A
3670,JointPQPlayer,283,198,481,35,18,Player A
3671,JointPQPlayer,276,201,477,34,19,Player A
3672,JointPQPlayer,284,199,483,34,17,Player A
3673,JointPQPlayer,298,193,491,36,15,Player A
3674,JointPQPlayer,340,175,515,42,9,Player A
3675,JointPQPlayer,284,204,488,30,14,Player A
3676,JointPQPlayer,311,186,497,39,14,Player A
3677,JointPQPlayer,304,194,498,34,12,Player A
3678,JointPQPlayer,275,195,470,39,23,Player A
3679,JointPQPlayer,243,218,461,27,22,Player A
3680,JointPQPlayer,147,257,404,15,37,JointPQPlayer
3681,JointPQPlayer,303,193,496,35,13,Player A
3682,JointPQPlayer,295,195,490,35,15,Player A
3683,JointPQPlayer,296,196,492,34,14,Player A
3684,JointPQPlayer,293,193,486,37,17,Player A
3685,JointPQPlayer,152,257,409,14,35,JointPQPlayer
3686,JointPQPlayer,330,185,515,36,7,Player A
3687,JointPQPlayer,301,196,497,33,12,Player A
3688,JointPQPlayer,126,261,387,16,43,JointPQPlayer
3689,JointPQPlayer,285,195,480,37,19,Player A
3690,JointPQPlayer,129,269,398,9,37,JointPQPlayer
3691,JointPQPlayer,309,184,493,41,16,Player A
3692,JointPQPlayer,288,193,481,38,19,Player A
3693,JointPQPlayer,265,205,470,33,21,Player A
3694,JointPQPlayer,280,200,480,34,18,Player A
3695,JointPQPlayer,304,189,493,38,15,Player A
3696,JointPQPlayer,293,198,491,33,14,Player A
3697,JointPQPlayer,289,199,488,33,15,Player A
3698,JointPQPlayer,150,255,405,16,37,JointPQPlayer
3699,JointPQPlayer,284,194,478,38,20,Player A
3700,JointPQPlayer,320,190,510,34,8,Player A
3701,JointPQPlayer,140,260,400,14,38,JointPQPlayer
3702,JointPQPlayer,319,184,503,39,12,Player A
3703,JointPQPlayer,303,188,491,39,16,Player A
3704,JointPQPlayer,313,183,496,41,15,Player A
3705,JointPQPlayer,285,200,485,33,16,Player A
3706,JointPQPlayer,263,208,471,31,20,Player A
3707,JointPQPlayer,159,254,413,15,34,JointPQPlayer
3708,JointPQPlayer,270,210,480,28,16,Player A
3709,JointPQPlayer,280,200,480,34,18,Player A
3710,JointPQPlayer,134,264,398,12,38,JointPQPlayer
3711,JointPQPlayer,334,179,513,40,9,Player A
3712,JointPQPlayer,259,209,468,31,21,Player A
3713,JointPQPlayer,303,188,491,39,16,Player A
3714,JointPQPlayer,263,208,471,31,20,Player A
3715,JointPQPlayer,304,189,493,38,15,Player A
3716,JointPQPlayer,288,193,481,38,19,Player A
3717,JointPQPlayer,308,188,496,38,14,Player A
3718,JointPQPlayer,149,249,398,21,41,JointPQPlayer
3719,JointPQPlayer,288,203,491,30,13,Player A
3720,JointPQPlayer,286,191,477,40,21,Player A
3721,JointPQPlayer,272,207,479,30,17,Player A
3722,JointPQPlayer,257,217,474,25,17,Player A
3723,JointPQPlayer,280,205,485,30,15,Player A
3724,JointPQPlayer,299,194,493,35,14,Player A
3725,JointPQPlayer,212,227,439,26,29,JointPQPlayer
3726,JointPQPlayer,281,201,482,33,17,Player A
3727,JointPQPlayer,274,204,478,32,18,Player A
3728,JointPQPlayer,285,200,485,33,16,Player A
3729,JointPQPlayer,289,194,483,37,18,Player A
3730,JointPQPlayer,288,198,486,34,16,Player A
3731,JointPQPlayer,140,265,405,10,35,JointPQPlayer
3732,JointPQPlayer,145,255,400,17,39,JointPQPlayer
3733,JointPQPlayer,332,177,509,42,11,Player A
3734,JointPQPlayer,294,189,483,40,19,Player A
3735,JointPQPlayer,316,186,502,38,12,Player A
3736,JointPQPlayer,309,184,493,41,16,Player A
3737,JointPQPlayer,159,259,418,11,31,JointPQPlayer
3738,JointPQPlayer,282,197,479,36,19,Player A
3739,JointPQPlayer,160,250,410,18,36,JointPQPlayer
3740,JointPQPlayer,139,259,398,15,39,JointPQPlayer
3741,JointPQPlayer,151,261,412,11,33,JointPQPlayer
3742,JointPQPlayer,285,195,480,37,19,Player A
3743,JointPQPlayer,148,263,411,10,33,JointPQPlayer
3744,JointPQPlayer,290,195,485,36,17,Player A
3745,JointPQPlayer,295,195,490,35,15,Player A
3746,JointPQPlayer,311,191,502,35,11,Player A
3747,JointPQPlayer,271,206,477,31,18,Player A
3748,JointPQPlayer,304,194,498,34,12,Player A
3749,JointPQPlayer,125,265,390,13,41,JointPQPlayer
3750,JointPQPlayer,300,185,485,42,19,Player A
3751,JointPQPlayer,304,189,493,38,15,Player A
3752,JointPQPlayer,305,195,500,33,11,Player A
3753,JointPQPlayer,143,258,401,15,38,JointPQPlayer
3754,JointPQPlayer,131,271,402,7,35,JointPQPlayer
3755,JointPQPlayer,230,220,450,28,26,Player A
3756,JointPQPlayer,295,195,490,35,15,Player A
3757,JointPQPlayer,267,202,469,35,22,Player A
3758,JointPQPlayer,266,206,472,32,20,Player A
3759,JointPQPlayer,308,193,501,34,11,Player A
3760,JointPQPlayer,290,195,485,36,17,Player A
3761,JointPQPlayer,260,205,465,34,23,Player A
3762,JointPQPlayer,290,195,485,36,17,Player A
3763,JointPQPlayer,127,262,389,15,42,JointPQPlayer
3764,JointPQPlayer,270,205,475,32,19,Player A
3765,JointPQPlayer,146,256,402,16,38,JointPQPlayer
3766,JointPQPlayer,306,191,497,36,13,Player A
3767,JointPQPlayer,137,262,399,13,38,JointPQPlayer
3768,JointPQPlayer,314,184,498,40,14,Player A
3769,JointPQPlayer,316,191,507,34,9,Player A
3770,JointPQPlayer,307,187,494,39,15,Player A
3771,JointPQPlayer,294,204,498,28,10,Player A
3772,JointPQPlayer,136,266,402,10,36,JointPQPlayer
3773,JointPQPlayer,216,226,442,26,28,JointPQPlayer
3774,JointPQPlayer,291,196,487,35,16,Player A
3775,JointPQPlayer,265,205,470,33,21,Player A
3776,JointPQPlayer,312,187,499,38,13,Player A
3777,JointPQPlayer,290,200,490,32,14,Player A
3778,JointPQPlayer,291,196,487,35,16,Player A
3779,JointPQPlayer,297,192,489,37,16,Player A
3780,JointPQPlayer,301,191,492,37,15,Player A
3781,JointPQPlayer,299,189,488,39,17,Player A
3782,JointPQPlayer,292,202,494,30,12,Player A
3783,JointPQPlayer,291,196,487,35,16,Player A
3784,JointPQPlayer,290,200,490,32,14,Player A
3785,JointPQPlayer,295,195,490,35,15,Player A
3786,JointPQPlayer,139,264,403,11,36,JointPQPlayer
3787,JointPQPlayer,295,195,490,35,15,Player A
3788,JointPQPlayer,287,202,489,31,14,Player A
3789,JointPQPlayer,176,246,422,18,32,JointPQPlayer
3790,JointPQPlayer,218,228,446,24,26,JointPQPlayer
3791,JointPQPlayer,297,197,494,33,13,Player A
3792,JointPQPlayer,204,229,433,26,31,JointPQPlayer
3793,JointPQPlayer,311,186,497,39,14,Player A
3794,JointPQPlayer,290,195,485,36,17,Player A
3795,JointPQPlayer,272,207,479,30,17,Player A
3796,JointPQPlayer,285,195,480,37,19,Player A
3797,JointPQPlayer,271,206,477,31,18,Player A
3798,JointPQPlayer,123,263,386,15,43,JointPQPlayer
3799,JointPQPlayer,306,186,492,40,16,Player A
3800,JointPQPlayer,139,264,403,11,36,JointPQPlayer
3801,JointPQPlayer,164,254,418,14,32,JointPQPlayer
3802,JointPQPlayer,159,254,413,15,34,JointPQPlayer
3803,JointPQPlayer,147,257,404,15,37,JointPQPlayer
3804,JointPQPlayer,307,192,499,35,12,Player A
3805,JointPQPlayer,279,199,478,35,19,Player A
3806,JointPQPlayer,298,198,496,32,12,Player A
3807,JointPQPlayer,331,181,512,39,9,Player A
3808,JointPQPlayer,276,201,477,34,19,Player A
3809,JointPQPlayer,311,186,497,39,14,Player A
3810,JointPQPlayer,264,204,468,34,22,Player A
3811,JointPQPlayer,310,190,500,36,12,Player A
3812,JointPQPlayer,325,185,510,37,9,Player A
3813,JointPQPlayer,302,187,489,40,17,Player A
3814,JointPQPlayer,319,184,503,39,12,Player A
3815,JointPQPlayer,140,255,395,18,41,JointPQPlayer
3816,JointPQPlayer,324,184,508,38,10,Player A
3817,JointPQPlayer,329,179,508,41,11,Player A
3818,JointPQPlayer,297,202,499,29,10,Player A
3819,JointPQPlayer,153,258,411,13,34,JointPQPlayer
3820,JointPQPlayer,292,197,489,34,15,Player A
3821,JointPQPlayer,252,212,464,30,22,Player A
3822,JointPQPlayer,289,199,488,33,15,Player A
3823,JointPQPlayer,319,184,503,39,12,Player A
3824,JointPQPlayer,302,192,494,36,14,Player A
3825,JointPQPlayer,292,197,489,34,15,Player A
3826,JointPQPlayer,264,209,473,30,19,Player A
3827,JointPQPlayer,292,197,489,34,15,Player A
3828,JointPQPlayer,299,199,498,31,11,Player A
3829,JointPQPlayer,293,198,491,33,14,Player A
3830,JointPQPlayer,264,209,473,30,19,Player A
3831,JointPQPlayer,289,194,483,37,18,Player A
3832,JointPQPlayer,269,209,478,29,17,Player A
3833,JointPQPlayer,287,197,484,35,17,Player A
3834,JointPQPlayer,310,190,500,36,12,Player A
3835,JointPQPlayer,288,193,481,38,19,Player A
3836,JointPQPlayer,146,256,402,16,38,JointPQPlayer
3837,JointPQPlayer,307,192,499,35,12,Player A
3838,JointPQPlayer,279,204,483,31,16,Player A
3839,JointPQPlayer,291,196,487,35,16,Player A
3840,JointPQPlayer,270,205,475,32,19,Player A
3841,JointPQPlayer,261,206,467,33,22,Player A
3842,JointPQPlayer,113,268,381,13,44,JointPQPlayer
3843,JointPQPlayer,302,192,494,36,14,Player A
3844,JointPQPlayer,133,258,391,17,42,JointPQPlayer
3845,JointPQPlayer,305,185,490,41,17,Player A
3846,JointPQPlayer,142,262,404,12,36,JointPQPlayer
3847,JointPQPlayer,161,256,417,13,32,JointPQPlayer
3848,JointPQPlayer,273,208,481,29,16,Player A
3849,JointPQPlayer,299,199,498,31,11,Player A
3850,JointPQPlayer,301,191,492,37,15,Player A
3851,JointPQPlayer,140,265,405,10,35,JointPQPlayer
3852,JointPQPlayer,156,256,412,14,34,JointPQPlayer
3853,JointPQPlayer,130,265,395,12,39,JointPQPlayer
3854,JointPQPlayer,252,212,464,30,22,Player A
3855,JointPQPlayer,309,184,493,41,16,Player A
3856,JointPQPlayer,119,269,388,11,41,JointPQPlayer
3857,JointPQPlayer,134,264,398,12,38,JointPQPlayer
3858,JointPQPlayer,295,190,485,39,18,Player A
3859,JointPQPlayer,137,262,399,13,38,JointPQPlayer
3860,JointPQPlayer,272,197,469,38,23,Player A
3861,JointPQPlayer,293,198,491,33,14,Player A
3862,JointPQPlayer,277,202,479,33,18,Player A
3863,JointPQPlayer,149,249,398,21,41,JointPQPlayer
3864,JointPQPlayer,334,179,513,40,9,Player A
3865,JointPQPlayer,214,229,443,24,27,JointPQPlayer
3866,JointPQPlayer,137,262,399,13,38,JointPQPlayer
3867,JointPQPlayer,300,190,490,38,16,Player A
3868,JointPQPlayer,266,206,472,32,20,Player A
3869,JointPQPlayer,287,197,484,35,17,Player A
3870,JointPQPlayer,267,202,469,35,22,Player A
3871,JointPQPlayer,286,196,482,36,18,Player A
3872,JointPQPlayer,279,199,478,35,19,Player A
3873,JointPQPlayer,277,197,474,37,21,Player A
3874,JointPQPlayer,291,196,487,35,16,Player A
3875,JointPQPlayer,275,210,485,27,14,Player A
3876,JointPQPlayer,285,195,480,37,19,Player A
3877,JointPQPlayer,302,187,489,40,17,Player A
3878,JointPQPlayer,317,182,499,41,14,Player A
3879,JointPQPlayer,305,190,495,37,14,Player A
3880,JointPQPlayer,219,224,443,27,28,JointPQPlayer
3881,JointPQPlayer,151,256,407,15,36,JointPQPlayer
3882,JointPQPlayer,156,251,407,18,37,JointPQPlayer
3883,JointPQPlayer,143,258,401,15,38,JointPQPlayer
3884,JointPQPlayer,295,195,490,35,15,Player A
3885,JointPQPlayer,269,204,473,33,20,Player A
3886,JointPQPlayer,140,260,400,14,38,JointPQPlayer
3887,JointPQPlayer,294,194,488,36,16,Player A
3888,JointPQPlayer,302,192,494,36,14,Player A
3889,JointPQPlayer,315,190,505,35,10,Player A
3890,JointPQPlayer,317,187,504,37,11,Player A
3891,JointPQPlayer,223,223,446,27,27,Tie
3892,JointPQPlayer,311,186,497,39,14,Player A
3893,JointPQPlayer,146,261,407,12,35,JointPQPlayer
3894,JointPQPlayer,308,193,501,34,11,Player A
3895,JointPQPlayer,269,204,473,33,20,Player A
3896,JointPQPlayer,270,210,480,28,16,Player A
3897,JointPQPlayer,269,204,473,33,20,Player A
3898,JointPQPlayer,310,185,495,40,15,Player A
3899,JointPQPlayer,285,200,485,33,16,Player A
3900,JointPQPlayer,159,254,413,15,34,JointPQPlayer
3901,JointPQPlayer,270,205,475,32,19,Player A
3902,JointPQPlayer,187,242,429,19,30,JointPQPlayer
3903,JointPQPlayer,333,178,511,41,10,Player A
3904,JointPQPlayer,183,243,426,19,31,JointPQPlayer
3905,JointPQPlayer,139,259,398,15,39,JointPQPlayer
3906,JointPQPlayer,275,205,480,31,17,Player A
3907,JointPQPlayer,266,206,472,32,20,Player A
3908,JointPQPlayer,296,201,497,30,11,Player A
3909,JointPQPlayer,292,197,489,34,15,Player A
3910,JointPQPlayer,273,208,481,29,16,Player A
3911,JointPQPlayer,153,258,411,13,34,JointPQPlayer
3912,JointPQPlayer,299,194,493,35,14,Player A
3913,JointPQPlayer,269,209,478,29,17,Player A
3914,JointPQPlayer,141,266,407,9,34,JointPQPlayer
3915,JointPQPlayer,288,198,486,34,16,Player A
3916,JointPQPlayer,284,199,483,34,17,Player A
3917,JointPQPlayer,286,201,487,32,15,Player A
3918,JointPQPlayer,275,200,475,35,20,Player A
3919,JointPQPlayer,258,213,471,28,19,Player A
3920,JointPQPlayer,286,201,487,32,15,Player A
3921,JointPQPlayer,307,187,494,39,15,Player A
3922,JointPQPlayer,261,201,462,37,25,Player A
3923,JointPQPlayer,246,216,462,28,22,Player A
3924,JointPQPlayer,288,198,486,34,16,Player A
3925,JointPQPlayer,149,254,403,17,38,JointPQPlayer
3926,JointPQPlayer,263,208,471,31,20,Player A
3927,JointPQPlayer,163,253,416,15,33,JointPQPlayer
3928,JointPQPlayer,140,255,395,18,41,JointPQPlayer
3929,JointPQPlayer,285,200,485,33,16,Player A
3930,JointPQPlayer,292,197,489,34,15,Player A
3931,JointPQPlayer,310,190,500,36,12,Player A
3932,JointPQPlayer,155,255,410,15,35,JointPQPlayer
3933,JointPQPlayer,283,203,486,31,15,Player A
3934,JointPQPlayer,313,188,501,37,12,Player A
3935,JointPQPlayer,280,200,480,34,18,Player A
3936,JointPQPlayer,160,255,415,14,33,JointPQPlayer
3937,JointPQPlayer,315,190,505,35,10,Player A
3938,JointPQPlayer,304,189,493,38,15,Player A
3939,JointPQPlayer,148,258,406,14,36,JointPQPlayer
3940,JointPQPlayer,283,198,481,35,18,Player A
3941,JointPQPlayer,255,215,470,27,19,Player A
3942,JointPQPlayer,289,194,483,37,18,Player A
3943,JointPQPlayer,324,184,508,38,10,Player A
3944,JointPQPlayer,301,191,492,37,15,Player A
3945,JointPQPlayer,270,205,475,32,19,Player A
3946,JointPQPlayer,273,208,481,29,16,Player A
3947,JointPQPlayer,236,221,457,26,23,Player A
3948,JointPQPlayer,265,210,475,29,18,Player A
3949,JointPQPlayer,282,197,479,36,19,Player A
3950,JointPQPlayer,283,203,486,31,15,Player A
3951,JointPQPlayer,282,202,484,32,16,Player A
3952,JointPQPlayer,283,208,491,27,12,Player A
3953,JointPQPlayer,162,257,419,12,31,JointPQPlayer
3954,JointPQPlayer,262,212,474,28,18,Player A
3955,JointPQPlayer,309,189,498,37,13,Player A
3956,JointPQPlayer,151,256,407,15,36,JointPQPlayer
3957,JointPQPlayer,308,193,501,34,11,Player A
3958,JointPQPlayer,287,197,484,35,17,Player A
3959,JointPQPlayer,255,210,465,31,22,Player A
3960,JointPQPlayer,287,202,489,31,14,Player A
3961,JointPQPlayer,215,230,445,23,26,JointPQPlayer
3962,JointPQPlayer,117,267,384,13,43,JointPQPlayer
3963,JointPQPlayer,312,187,499,38,13,Player A
3964,JointPQPlayer,291,191,482,39,19,Player A
3965,JointPQPlayer,200,235,435,22,29,JointPQPlayer
3966,JointPQPlayer,319,184,503,39,12,Player A
3967,JointPQPlayer,169,254,423,13,30,JointPQPlayer
3968,JointPQPlayer,289,194,483,37,18,Player A
3969,JointPQPlayer,310,190,500,36,12,Player A
3970,JointPQPlayer,292,197,489,34,15,Player A
3971,JointPQPlayer,138,258,396,16,40,JointPQPlayer
3972,JointPQPlayer,139,264,403,11,36,JointPQPlayer
3973,JointPQPlayer,284,199,483,34,17,Player A
3974,JointPQPlayer,275,205,480,31,17,Player A
3975,JointPQPlayer,288,198,486,34,16,Player A
3976,JointPQPlayer,139,259,398,15,39,JointPQPlayer
3977,JointPQPlayer,310,190,500,36,12,Player A
3978,JointPQPlayer,302,192,494,36,14,Player A
3979,JointPQPlayer,138,263,401,12,37,JointPQPlayer
3980,JointPQPlayer,145,260,405,13,36,JointPQPlayer
3981,JointPQPlayer,288,198,486,34,16,Player A
3982,JointPQPlayer,305,190,495,37,14,Player A
3983,JointPQPlayer,308,183,491,42,17,Player A
3984,JointPQPlayer,285,200,485,33,16,Player A
3985,JointPQPlayer,333,183,516,37,7,Player A
3986,JointPQPlayer,158,248,406,20,38,JointPQPlayer
3987,JointPQPlayer,299,194,493,35,14,Player A
3988,JointPQPlayer,135,265,400,11,37,JointPQPlayer
3989,JointPQPlayer,160,255,415,14,33,JointPQPlayer
3990,JointPQPlayer,224,224,448,26,26,Tie
3991,JointPQPlayer,323,188,511,35,8,Player A
3992,JointPQPlayer,276,206,482,30,16,Player A
3993,JointPQPlayer,304,189,493,38,15,Player A
3994,JointPQPlayer,270,205,475,32,19,Player A
3995,JointPQPlayer,285,205,490,29,13,Player A
3996,JointPQPlayer,267,207,474,31,19,Player A
3997,JointPQPlayer,300,200,500,30,10,Player A
3998,JointPQPlayer,288,193,481,38,19,Player A
3999,JointPQPlayer,266,206,472,32,20,Player A
4000,JointPQPlayer,315,190,505,35,10,Player A
4001,JointPQPlayer,134,264,398,12,38,JointPQPlayer
4002,JointPQPlayer,152,257,409,14,35,JointPQPlayer
4003,JointPQPlayer,285,205,490,29,13,Player A
4004,JointPQPlayer,281,201,482,33,17,Player A
4005,JointPQPlayer,286,201,487,32,15,Player A
4006,JointPQPlayer,273,203,476,33,19,Player A
4007,JointPQPlayer,128,268,396,10,38,JointPQPlayer
4008,JointPQPlayer,294,194,488,36,16,Player A
4009,JointPQPlayer,139,259,398,15,39,JointPQPlayer
4010,JointPQPlayer,325,175,500,45,15,Player A
4011,JointPQPlayer,320,190,510,34,8,Player A
4012,JointPQPlayer,145,255,400,17,39,JointPQPlayer
4013,JointPQPlayer,290,195,485,36,17,Player A
4014,JointPQPlayer,280,200,480,34,18,Player A
4015,JointPQPlayer,319,184,503,39,12,Player A
4016,JointPQPlayer,320,185,505,38,11,Player A
4017,JointPQPlayer,291,201,492,31,13,Player A
4018,JointPQPlayer,322,182,504,40,12,Player A
4019,JointPQPlayer,302,192,494,36,14,Player A
4020,JointPQPlayer,288,198,486,34,16,Player A
4021,JointPQPlayer,303,193,496,35,13,Player A
4022,JointPQPlayer,140,260,400,14,38,JointPQPlayer
4023,JointPQPlayer,309,189,498,37,13,Player A
4024,JointPQPlayer,299,194,493,35,14,Player A
4025,JointPQPlayer,292,192,484,38,18,Player A
4026,JointPQPlayer,147,257,404,15,37,JointPQPlayer
4027,JointPQPlayer,312,187,499,38,13,Player A
4028,JointPQPlayer,278,198,476,36,20,Player A
4029,JointPQPlayer,252,217,469,26,19,Player A
4030,JointPQPlayer,115,275,390,7,39,JointPQPlayer
4031,JointPQPlayer,301,196,497,33,12,Player A
4032,JointPQPlayer,304,194,498,34,12,Player A
4033,JointPQPlayer,143,258,401,15,38,JointPQPlayer
4034,JointPQPlayer,134,264,398,12,38,JointPQPlayer
4035,JointPQPlayer,285,200,485,33,16,Player A
4036,JointPQPlayer,299,199,498,31,11,Player A
4037,JointPQPlayer,267,207,474,31,19,Player A
4038,JointPQPlayer,216,231,447,22,25,JointPQPlayer
4039,JointPQPlayer,149,254,403,17,38,JointPQPlayer
4040,JointPQPlayer,320,185,505,38,11,Player A
4041,JointPQPlayer,309,189,498,37,13,Player A
4042,JointPQPlayer,287,197,484,35,17,Player A
4043,JointPQPlayer,310,190,500,36,12,Player A
4044,JointPQPlayer,291,201,492,31,13,Player A
4045,JointPQPlayer,259,214,473,27,18,Player A
4046,JointPQPlayer,231,226,457,23,22,Player A
4047,JointPQPlayer,300,195,495,34,13,Player A
4048,JointPQPlayer,142,262,404,12,36,JointPQPlayer
4049,JointPQPlayer,298,188,486,40,18,Player A
4050,JointPQPlayer,141,261,402,13,37,JointPQPlayer
4051,JointPQPlayer,300,195,495,34,13,Player A
4052,JointPQPlayer,289,194,483,37,18,Player A
4053,JointPQPlayer,265,210,475,29,18,Player A
4054,JointPQPlayer,144,259,403,14,37,JointPQPlayer
4055,JointPQPlayer,299,189,488,39,17,Player A
4056,JointPQPlayer,298,188,486,40,18,Player A
4057,JointPQPlayer,299,194,493,35,14,Player A
4058,JointPQPlayer,269,199,468,37,23,Player A
4059,JointPQPlayer,241,216,457,29,24,Player A
4060,JointPQPlayer,286,201,487,32,15,Player A
4061,JointPQPlayer,286,196,482,36,18,Player A
4062,JointPQPlayer,298,198,496,32,12,Player A
4063,JointPQPlayer,280,200,480,34,18,Player A
4064,JointPQPlayer,316,191,507,34,9,Player A
4065,JointPQPlayer,145,255,400,17,39,JointPQPlayer
4066,JointPQPlayer,151,251,402,19,39,JointPQPlayer
4067,JointPQPlayer,287,197,484,35,17,Player A
4068,JointPQPlayer,294,194,488,36,16,Player A
4069,JointPQPlayer,291,196,487,35,16,Player A
4070,JointPQPlayer,307,192,499,35,12,Player A
4071,JointPQPlayer,322,187,509,36,9,Player A
4072,JointPQPlayer,293,198,491,33,14,Player A
4073,JointPQPlayer,205,235,440,21,27,JointPQPlayer
4074,JointPQPlayer,300,195,495,34,13,Player A
4075,JointPQPlayer,205,235,440,21,27,JointPQPlayer
4076,JointPQPlayer,298,193,491,36,15,Player A
4077,JointPQPlayer,321,186,507,37,10,Player A
4078,JointPQPlayer,296,191,487,38,17,Player A
4079,JointPQPlayer,272,202,474,34,20,Player A
4080,JointPQPlayer,137,262,399,13,38,JointPQPlayer
4081,JointPQPlayer,335,180,515,39,8,Player A
4082,JointPQPlayer,202,232,434,24,30,JointPQPlayer
4083,JointPQPlayer,293,198,491,33,14,Player A
4084,JointPQPlayer,174,249,423,16,31,JointPQPlayer
4085,JointPQPlayer,316,186,502,38,12,Player A
4086,JointPQPlayer,269,209,478,29,17,Player A
4087,JointPQPlayer,250,215,465,28,21,Player A
4088,JointPQPlayer,129,264,393,13,40,JointPQPlayer
4089,JointPQPlayer,152,257,409,14,35,JointPQPlayer
4090,JointPQPlayer,218,233,451,20,23,JointPQPlayer
4091,JointPQPlayer,323,178,501,43,14,Player A
4092,JointPQPlayer,284,199,483,34,17,Player A
4093,JointPQPlayer,272,207,479,30,17,Player A
4094,JointPQPlayer,243,213,456,31,25,Player A
4095,JointPQPlayer,293,198,491,33,14,Player A
4096,JointPQPlayer,194,244,438,16,26,JointPQPlayer
4097,JointPQPlayer,320,185,505,38,11,Player A
4098,JointPQPlayer,309,184,493,41,16,Player A
4099,JointPQPlayer,288,198,486,34,16,Player A
4100,JointPQPlayer,207,237,444,19,25,JointPQPlayer
4101,JointPQPlayer,278,203,481,32,17,Player A
4102,JointPQPlayer,293,198,491,33,14,Player A
4103,JointPQPlayer,277,197,474,37,21,Player A
4104,JointPQPlayer,297,197,494,33,13,Player A
4105,JointPQPlayer,153,258,411,13,34,JointPQPlayer
4106,JointPQPlayer,153,248,401,21,40,JointPQPlayer
4107,JointPQPlayer,326,186,512,36,8,Player A
4108,JointPQPlayer,317,187,504,37,11,Player A
4109,JointPQPlayer,301,196,497,33,12,Player A
4110,JointPQPlayer,291,196,487,35,16,Player A
4111,JointPQPlayer,307,192,499,35,12,Player A
4112,JointPQPlayer,265,210,475,29,18,Player A
4113,JointPQPlayer,301,196,497,33,12,Player A
4114,JointPQPlayer,254,209,463,32,23,Player A
4115,JointPQPlayer,182,247,429,16,29,JointPQPlayer
4116,JointPQPlayer,310,185,495,40,15,Player A
4117,JointPQPlayer,315,185,500,39,13,Player A
4118,JointPQPlayer,133,263,396,13,39,JointPQPlayer
4119,JointPQPlayer,147,257,404,15,37,JointPQPlayer
4120,JointPQPlayer,215,230,445,23,26,JointPQPlayer
4121,JointPQPlayer,295,185,480,43,21,Player A
4122,JointPQPlayer,281,201,482,33,17,Player A
4123,JointPQPlayer,304,189,493,38,15,Player A
4124,JointPQPlayer,293,198,491,33,14,Player A
4125,JointPQPlayer,296,196,492,34,14,Player A
4126,JointPQPlayer,262,207,469,32,21,Player A
4127,JointPQPlayer,275,200,475,35,20,Player A
4128,JointPQPlayer,304,189,493,38,15,Player A
4129,JointPQPlayer,264,209,473,30,19,Player A
4130,JointPQPlayer,334,179,513,40,9,Player A
4131,JointPQPlayer,296,191,487,38,17,Player A
4132,JointPQPlayer,277,197,474,37,21,Player A
4133,JointPQPlayer,141,261,402,13,37,JointPQPlayer
4134,JointPQPlayer,329,189,518,33,5,Player A
4135,JointPQPlayer,244,219,463,26,21,Player A
4136,JointPQPlayer,284,199,483,34,17,Player A
4137,JointPQPlayer,267,202,469,35,22,Player A
4138,JointPQPlayer,302,192,494,36,14,Player A
4139,JointPQPlayer,294,194,488,36,16,Player A
4140,JointPQPlayer,279,204,483,31,16,Player A
4141,JointPQPlayer,146,261,407,12,35,JointPQPlayer
4142,JointPQPlayer,296,196,492,34,14,Player A
4143,JointPQPlayer,255,215,470,27,19,Player A
4144,JointPQPlayer,261,211,472,29,19,Player A
4145,JointPQPlayer,301,191,492,37,15,Player A
4146,JointPQPlayer,287,202,489,31,14,Player A
4147,JointPQPlayer,159,254,413,15,34,JointPQPlayer
4148,JointPQPlayer,306,191,497,36,13,Player A
4149,JointPQPlayer,294,199,493,32,13,Player A
4150,JointPQPlayer,282,197,479,36,19,Player A
4151,JointPQPlayer,305,190,495,37,14,Player A
4152,JointPQPlayer,317,192,509,33,8,Player A
4153,JointPQPlayer,138,268,406,8,34,JointPQPlayer
4154,JointPQPlayer,144,259,403,14,37,JointPQPlayer
4155,JointPQPlayer,279,204,483,31,16,Player A
4156,JointPQPlayer,297,187,484,41,19,Player A
4157,JointPQPlayer,140,260,400,14,38,JointPQPlayer
4158,JointPQPlayer,151,256,407,15,36,JointPQPlayer
4159,JointPQPlayer,133,263,396,13,39,JointPQPlayer
4160,JointPQPlayer,302,197,499,32,11,Player A
4161,JointPQPlayer,175,250,425,15,30,JointPQPlayer
4162,JointPQPlayer,295,200,495,31,12,Player A
4163,JointPQPlayer,253,213,466,29,21,Player A
4164,JointPQPlayer,279,204,483,31,16,Player A
4165,JointPQPlayer,291,196,487,35,16,Player A
4166,JointPQPlayer,283,198,481,35,18,Player A
4167,JointPQPlayer,294,199,493,32,13,Player A
4168,JointPQPlayer,289,194,483,37,18,Player A
4169,JointPQPlayer,268,208,476,30,18,Player A
4170,JointPQPlayer,145,260,405,13,36,JointPQPlayer
4171,JointPQPlayer,300,190,490,38,16,Player A
4172,JointPQPlayer,298,198,496,32,12,Player A
4173,JointPQPlayer,132,262,394,14,40,JointPQPlayer
4174,JointPQPlayer,295,195,490,35,15,Player A
4175,JointPQPlayer,286,201,487,32,15,Player A
4176,JointPQPlayer,317,182,499,41,14,Player A
4177,JointPQPlayer,211,231,442,23,27,JointPQPlayer
4178,JointPQPlayer,230,220,450,28,26,Player A
4179,JointPQPlayer,303,198,501,31,10,Player A
4180,JointPQPlayer,121,266,387,13,42,JointPQPlayer
4181,JointPQPlayer,284,204,488,30,14,Player A
4182,JointPQPlayer,234,219,453,28,25,Player A
4183,JointPQPlayer,288,198,486,34,16,Player A
4184,JointPQPlayer,300,195,495,34,13,Player A
4185,JointPQPlayer,303,188,491,39,16,Player A
4186,JointPQPlayer,246,216,462,28,22,Player A
4187,JointPQPlayer,341,176,517,41,8,Player A
4188,JointPQPlayer,204,234,438,22,28,JointPQPlayer
4189,JointPQPlayer,150,255,405,16,37,JointPQPlayer
4190,JointPQPlayer,156,261,417,10,31,JointPQPlayer
4191,JointPQPlayer,265,200,465,37,24,Player A
4192,JointPQPlayer,274,204,478,32,18,Player A
4193,JointPQPlayer,288,198,486,34,16,Player A
4194,JointPQPlayer,287,197,484,35,17,Player A
4195,JointPQPlayer,298,193,491,36,15,Player A
4196,JointPQPlayer,306,191,497,36,13,Player A
4197,JointPQPlayer,301,191,492,37,15,Player A
4198,JointPQPlayer,304,194,498,34,12,Player A
4199,JointPQPlayer,306,196,502,32,10,Player A
4200,JointPQPlayer,297,197,494,33,13,Player A
4201,JointPQPlayer,285,200,485,33,16,Player A
4202,JointPQPlayer,314,184,498,40,14,Player A
4203,JointPQPlayer,309,189,498,37,13,Player A
4204,JointPQPlayer,221,226,447,25,26,JointPQPlayer
4205,JointPQPlayer,251,216,467,27,20,Player A
4206,JointPQPlayer,135,270,405,7,34,JointPQPlayer
4207,JointPQPlayer,224,229,453,22,23,JointPQPlayer
4208,JointPQPlayer,281,201,482,33,17,Player A
4209,JointPQPlayer,267,212,479,27,16,Player A
4210,JointPQPlayer,329,184,513,37,8,Player A
4211,JointPQPlayer,282,197,479,36,19,Player A
4212,JointPQPlayer,310,190,500,36,12,Player A
4213,JointPQPlayer,285,195,480,37,19,Player A
4214,JointPQPlayer,283,198,481,35,18,Player A
4215,JointPQPlayer,272,207,479,30,17,Player A
4216,JointPQPlayer,297,192,489,37,16,Player A
4217,JointPQPlayer,299,194,493,35,14,Player A
4218,JointPQPlayer,302,187,489,40,17,Player A
4219,JointPQPlayer,280,205,485,30,15,Player A
4220,JointPQPlayer,221,226,447,25,26,JointPQPlayer
4221,JointPQPlayer,156,261,417,10,31,JointPQPlayer
4222,JointPQPlayer,301,191,492,37,15,Player A
4223,JointPQPlayer,305,195,500,33,11,Player A
4224,JointPQPlayer,133,258,391,17,42,JointPQPlayer
4225,JointPQPlayer,302,192,494,36,14,Player A
4226,JointPQPlayer,284,194,478,38,20,Player A
4227,JointPQPlayer,147,257,404,15,37,JointPQPlayer
4228,JointPQPlayer,210,230,440,24,28,JointPQPlayer
4229,JointPQPlayer,319,184,503,39,12,Player A
4230,JointPQPlayer,247,212,459,31,24,Player A
4231,JointPQPlayer,316,186,502,38,12,Player A
4232,JointPQPlayer,280,200,480,34,18,Player A
4233,JointPQPlayer,295,195,490,35,15,Player A
4234,JointPQPlayer,262,212,474,28,18,Player A
4235,JointPQPlayer,289,194,483,37,18,Player A
4236,JointPQPlayer,253,213,466,29,21,Player A
4237,JointPQPlayer,142,262,404,12,36,JointPQPlayer
4238,JointPQPlayer,303,188,491,39,16,Player A
4239,JointPQPlayer,165,260,425,9,28,JointPQPlayer
4240,JointPQPlayer,261,206,467,33,22,Player A
4241,JointPQPlayer,287,197,484,35,17,Player A
4242,JointPQPlayer,310,190,500,36,12,Player A
4243,JointPQPlayer,285,200,485,33,16,Player A
4244,JointPQPlayer,312,187,499,38,13,Player A
4245,JointPQPlayer,135,265,400,11,37,JointPQPlayer
4246,JointPQPlayer,150,260,410,12,34,JointPQPlayer
4247,JointPQPlayer,149,254,403,17,38,JointPQPlayer
4248,JointPQPlayer,288,193,481,38,19,Player A
4249,JointPQPlayer,321,181,502,41,13,Player A
4250,JointPQPlayer,180,240,420,22,34,JointPQPlayer
4251,JointPQPlayer,301,191,492,37,15,Player A
4252,JointPQPlayer,148,258,406,14,36,JointPQPlayer
4253,JointPQPlayer,301,191,492,37,15,Player A
4254,JointPQPlayer,301,196,497,33,12,Player A
4255,JointPQPlayer,304,189,493,38,15,Player A
4256,JointPQPlayer,279,204,483,31,16,Player A
4257,JointPQPlayer,265,205,470,33,21,Player A
4258,JointPQPlayer,261,211,472,29,19,Player A
4259,JointPQPlayer,302,197,499,32,11,Player A
4260,JointPQPlayer,170,255,425,12,29,JointPQPlayer
4261,JointPQPlayer,306,191,497,36,13,Player A
4262,JointPQPlayer,150,255,405,16,37,JointPQPlayer
4263,JointPQPlayer,280,205,485,30,15,Player A
4264,JointPQPlayer,279,209,488,27,13,Player A
4265,JointPQPlayer,294,194,488,36,16,Player A
4266,JointPQPlayer,135,265,400,11,37,JointPQPlayer
4267,JointPQPlayer,287,202,489,31,14,Player A
4268,JointPQPlayer,146,256,402,16,38,JointPQPlayer
4269,JointPQPlayer,274,204,478,32,18,Player A
4270,JointPQPlayer,333,183,516,37,7,Player A
4271,JointPQPlayer,287,192,479,39,20,Player A
4272,JointPQPlayer,301,191,492,37,15,Player A
4273,JointPQPlayer,281,201,482,33,17,Player A
4274,JointPQPlayer,142,257,399,16,39,JointPQPlayer
4275,JointPQPlayer,284,199,483,34,17,Player A
4276,JointPQPlayer,133,263,396,13,39,JointPQPlayer
4277,JointPQPlayer,327,182,509,39,10,Player A
4278,JointPQPlayer,139,264,403,11,36,JointPQPlayer
4279,JointPQPlayer,132,267,399,10,37,JointPQPlayer
4280,JointPQPlayer,314,189,503,36,11,Player A
4281,JointPQPlayer,284,199,483,34,17,Player A
4282,JointPQPlayer,311,196,507,31,8,Player A
4283,JointPQPlayer,311,186,497,39,14,Player A
4284,JointPQPlayer,305,190,495,37,14,Player A
4285,JointPQPlayer,241,221,462,25,21,Player A
4286,JointPQPlayer,309,194,503,33,10,Player A
4287,JointPQPlayer,310,190,500,36,12,Player A
4288,JointPQPlayer,299,194,493,35,14,Player A
4289,JointPQPlayer,318,188,506,36,10,Player A
4290,JointPQPlayer,300,195,495,34,13,Player A
4291,JointPQPlayer,298,198,496,32,12,Player A
4292,JointPQPlayer,301,186,487,41,18,Player A
4293,JointPQPlayer,305,195,500,33,11,Player A
4294,JointPQPlayer,135,260,395,15,40,JointPQPlayer
4295,JointPQPlayer,274,199,473,36,21,Player A
4296,JointPQPlayer,325,185,510,37,9,Player A
4297,JointPQPlayer,273,203,476,33,19,Player A
4298,JointPQPlayer,294,199,493,32,13,Player A
4299,JointPQPlayer,320,180,500,42,14,Player A
4300,JointPQPlayer,273,203,476,33,19,Player A
4301,JointPQPlayer,302,192,494,36,14,Player A
4302,JointPQPlayer,299,194,493,35,14,Player A
4303,JointPQPlayer,302,187,489,40,17,Player A
4304,JointPQPlayer,291,191,482,39,19,Player A
4305,JointPQPlayer,298,193,491,36,15,Player A
4306,JointPQPlayer,266,211,477,28,17,Player A
4307,JointPQPlayer,291,196,487,35,16,Player A
4308,JointPQPlayer,308,188,496,38,14,Player A
4309,JointPQPlayer,263,203,466,35,23,Player A
4310,JointPQPlayer,204,229,433,26,31,JointPQPlayer
4311,JointPQPlayer,270,200,470,36,22,Player A
4312,JointPQPlayer,139,259,398,15,39,JointPQPlayer
4313,JointPQPlayer,148,258,406,14,36,JointPQPlayer
4314,JointPQPlayer,271,206,477,31,18,Player A
4315,JointPQPlayer,295,195,490,35,15,Player A
4316,JointPQPlayer,295,195,490,35,15,Player A
4317,JointPQPlayer,256,211,467,30,21,Player A
4318,JointPQPlayer,294,199,493,32,13,Player A
4319,JointPQPlayer,305,190,495,37,14,Player A
4320,JointPQPlayer,298,198,496,32,12,Player A
4321,JointPQPlayer,316,191,507,34,9,Player A
4322,JointPQPlayer,293,193,486,37,17,Player A
4323,JointPQPlayer,284,204,488,30,14,Player A
4324,JointPQPlayer,255,215,470,27,19,Player A
4325,JointPQPlayer,159,254,413,15,34,JointPQPlayer
4326,JointPQPlayer,299,199,498,31,11,Player A
4327,JointPQPlayer,262,207,469,32,21,Player A
4328,JointPQPlayer,292,197,489,34,15,Player A
4329,JointPQPlayer,302,192,494,36,14,Player A
4330,JointPQPlayer,294,194,488,36,16,Player A
4331,JointPQPlayer,302,192,494,36,14,Player A
4332,JointPQPlayer,289,194,483,37,18,Player A
4333,JointPQPlayer,267,207,474,31,19,Player A
4334,JointPQPlayer,270,205,475,32,19,Player A
4335,JointPQPlayer,289,199,488,33,15,Player A
4336,JointPQPlayer,279,194,473,39,22,Player A
4337,JointPQPlayer,155,255,410,15,35,JointPQPlayer
4338,JointPQPlayer,296,196,492,34,14,Player A
4339,JointPQPlayer,166,241,407,24,39,JointPQPlayer
4340,JointPQPlayer,298,188,486,40,18,Player A
4341,JointPQPlayer,277,202,479,33,18,Player A
4342,JointPQPlayer,276,201,477,34,19,Player A
4343,JointPQPlayer,294,199,493,32,13,Player A
4344,JointPQPlayer,274,204,478,32,18,Player A
4345,JointPQPlayer,284,199,483,34,17,Player A
4346,JointPQPlayer,256,211,467,30,21,Player A
4347,JointPQPlayer,165,250,415,17,34,JointPQPlayer
4348,JointPQPlayer,295,200,495,31,12,Player A
4349,JointPQPlayer,305,195,500,33,11,Player A
4350,JointPQPlayer,298,193,491,36,15,Player A
4351,JointPQPlayer,291,196,487,35,16,Player A
4352,JointPQPlayer,307,197,504,31,9,Player A
4353,JointPQPlayer,299,194,493,35,14,Player A
4354,JointPQPlayer,310,185,495,40,15,Player A
4355,JointPQPlayer,269,204,473,33,20,Player A
4356,JointPQPlayer,282,202,484,32,16,Player A
4357,JointPQPlayer,264,204,468,34,22,Player A
4358,JointPQPlayer,303,193,496,35,13,Player A
4359,JointPQPlayer,300,190,490,38,16,Player A
4360,JointPQPlayer,264,214,478,26,16,Player A
4361,JointPQPlayer,270,205,475,32,19,Player A
4362,JointPQPlayer,290,195,485,36,17,Player A
4363,JointPQPlayer,296,191,487,38,17,Player A
4364,JointPQPlayer,286,196,482,36,18,Player A
4365,JointPQPlayer,286,196,482,36,18,Player A
4366,JointPQPlayer,283,198,481,35,18,Player A
4367,JointPQPlayer,278,208,486,28,14,Player A
4368,JointPQPlayer,326,181,507,40,11,Player A
4369,JointPQPlayer,298,193,491,36,15,Player A
4370,JointPQPlayer,279,199,478,35,19,Player A
4371,JointPQPlayer,287,202,489,31,14,Player A
4372,JointPQPlayer,271,206,477,31,18,Player A
4373,JointPQPlayer,290,195,485,36,17,Player A
4374,JointPQPlayer,260,210,470,30,20,Player A
4375,JointPQPlayer,271,201,472,35,21,Player A
4376,JointPQPlayer,307,192,499,35,12,Player A
4377,JointPQPlayer,263,203,466,35,23,Player A
4378,JointPQPlayer,323,183,506,39,11,Player A
4379,JointPQPlayer,148,258,406,14,36,JointPQPlayer
4380,JointPQPlayer,288,198,486,34,16,Player A
4381,JointPQPlayer,266,201,467,36,23,Player A
4382,JointPQPlayer,290,195,485,36,17,Player A
4383,JointPQPlayer,195,230,425,27,34,JointPQPlayer
4384,JointPQPlayer,294,194,488,36,16,Player A
4385,JointPQPlayer,314,184,498,40,14,Player A
4386,JointPQPlayer,287,192,479,39,20,Player A
4387,JointPQPlayer,313,188,501,37,12,Player A
4388,JointPQPlayer,297,192,489,37,16,Player A
4389,JointPQPlayer,293,193,486,37,17,Player A
4390,JointPQPlayer,170,250,420,16,32,JointPQPlayer
4391,JointPQPlayer,263,213,476,27,17,Player A
4392,JointPQPlayer,283,198,481,35,18,Player A
4393,JointPQPlayer,286,191,477,40,21,Player A
4394,JointPQPlayer,275,200,475,35,20,Player A
4395,JointPQPlayer,256,201,457,38,27,Player A
4396,JointPQPlayer,293,203,496,29,11,Player A
4397,JointPQPlayer,176,246,422,18,32,JointPQPlayer
4398,JointPQPlayer,300,195,495,34,13,Player A
4399,JointPQPlayer,286,201,487,32,15,Player A
4400,JointPQPlayer,274,204,478,32,18,Player A
4401,JointPQPlayer,309,189,498,37,13,Player A
4402,JointPQPlayer,194,244,438,16,26,JointPQPlayer
4403,JointPQPlayer,285,195,480,37,19,Player A
4404,JointPQPlayer,150,260,410,12,34,JointPQPlayer
4405,JointPQPlayer,305,185,490,41,17,Player A
4406,JointPQPlayer,162,247,409,20,37,JointPQPlayer
4407,JointPQPlayer,279,204,483,31,16,Player A
4408,JointPQPlayer,133,258,391,17,42,JointPQPlayer
4409,JointPQPlayer,300,190,490,38,16,Player A
4410,JointPQPlayer,134,264,398,12,38,JointPQPlayer
4411,JointPQPlayer,302,192,494,36,14,Player A
4412,JointPQPlayer,278,203,481,32,17,Player A
4413,JointPQPlayer,146,256,402,16,38,JointPQPlayer
4414,JointPQPlayer,302,192,494,36,14,Player A
4415,JointPQPlayer,286,196,482,36,18,Player A
4416,JointPQPlayer,154,254,408,16,36,JointPQPlayer
4417,JointPQPlayer,280,205,485,30,15,Player A
4418,JointPQPlayer,292,192,484,38,18,Player A
4419,JointPQPlayer,314,189,503,36,11,Player A
4420,JointPQPlayer,254,209,463,32,23,Player A
4421,JointPQPlayer,321,186,507,37,10,Player A
4422,JointPQPlayer,294,194,488,36,16,Player A
4423,JointPQPlayer,321,181,502,41,13,Player A
4424,JointPQPlayer,293,198,491,33,14,Player A
4425,JointPQPlayer,269,209,478,29,17,Player A
4426,JointPQPlayer,308,188,496,38,14,Player A
4427,JointPQPlayer,259,209,468,31,21,Player A
4428,JointPQPlayer,306,191,497,36,13,Player A
4429,JointPQPlayer,294,199,493,32,13,Player A
4430,JointPQPlayer,154,254,408,16,36,JointPQPlayer
4431,JointPQPlayer,313,193,506,33,9,Player A
4432,JointPQPlayer,302,192,494,36,14,Player A
4433,JointPQPlayer,289,194,483,37,18,Player A
4434,JointPQPlayer,167,242,409,23,38,JointPQPlayer
4435,JointPQPlayer,119,264,383,15,44,JointPQPlayer
4436,JointPQPlayer,283,203,486,31,15,Player A
4437,JointPQPlayer,280,205,485,30,15,Player A
4438,JointPQPlayer,148,253,401,18,39,JointPQPlayer
4439,JointPQPlayer,296,196,492,34,14,Player A
4440,JointPQPlayer,148,258,406,14,36,JointPQPlayer
4441,JointPQPlayer,298,198,496,32,12,Player A
4442,JointPQPlayer,276,201,477,34,19,Player A
4443,JointPQPlayer,272,207,479,30,17,Player A
4444,JointPQPlayer,154,259,413,12,33,JointPQPlayer
4445,JointPQPlayer,265,200,465,37,24,Player A
4446,JointPQPlayer,287,202,489,31,14,Player A
4447,JointPQPlayer,125,265,390,13,41,JointPQPlayer
4448,JointPQPlayer,282,207,489,28,13,Player A
4449,JointPQPlayer,305,185,490,41,17,Player A
4450,JointPQPlayer,294,194,488,36,16,Player A
4451,JointPQPlayer,284,199,483,34,17,Player A
4452,JointPQPlayer,293,203,496,29,11,Player A
4453,JointPQPlayer,150,260,410,12,34,JointPQPlayer
4454,JointPQPlayer,311,191,502,35,11,Player A
4455,JointPQPlayer,167,252,419,15,32,JointPQPlayer
4456,JointPQPlayer,324,179,503,42,13,Player A
4457,JointPQPlayer,281,201,482,33,17,Player A
4458,JointPQPlayer,313,188,501,37,12,Player A
4459,JointPQPlayer,276,206,482,30,16,Player A
4460,JointPQPlayer,151,261,412,11,33,JointPQPlayer
4461,JointPQPlayer,305,190,495,37,14,Player A
4462,JointPQPlayer,285,200,485,33,16,Player A
4463,JointPQPlayer,308,183,491,42,17,Player A
4464,JointPQPlayer,241,221,462,25,21,Player A
4465,JointPQPlayer,322,182,504,40,12,Player A
4466,JointPQPlayer,291,201,492,31,13,Player A
4467,JointPQPlayer,297,197,494,33,13,Player A
4468,JointPQPlayer,267,207,474,31,19,Player A
4469,JointPQPlayer,188,243,431,18,29,JointPQPlayer
4470,JointPQPlayer,126,266,392,12,40,JointPQPlayer
4471,JointPQPlayer,281,206,487,29,14,Player A
4472,JointPQPlayer,288,198,486,34,16,Player A
4473,JointPQPlayer,155,255,410,15,35,JointPQPlayer
4474,JointPQPlayer,145,260,405,13,36,JointPQPlayer
4475,JointPQPlayer,289,199,488,33,15,Player A
4476,JointPQPlayer,139,264,403,11,36,JointPQPlayer
4477,JointPQPlayer,293,198,491,33,14,Player A
4478,JointPQPlayer,299,194,493,35,14,Player A
4479,JointPQPlayer,256,211,467,30,21,Player A
4480,JointPQPlayer,275,195,470,39,23,Player A
4481,JointPQPlayer,154,259,413,12,33,JointPQPlayer
4482,JointPQPlayer,220,225,445,26,27,JointPQPlayer
4483,JointPQPlayer,296,196,492,34,14,Player A
4484,JointPQPlayer,151,261,412,11,33,JointPQPlayer
4485,JointPQPlayer,319,184,503,39,12,Player A
4486,JointPQPlayer,282,197,479,36,19,Player A
4487,JointPQPlayer,269,204,473,33,20,Player A
4488,JointPQPlayer,302,192,494,36,14,Player A
4489,JointPQPlayer,132,267,399,10,37,JointPQPlayer
4490,JointPQPlayer,156,251,407,18,37,JointPQPlayer
4491,JointPQPlayer,251,211,462,31,23,Player A
4492,JointPQPlayer,297,192,489,37,16,Player A
4493,JointPQPlayer,281,201,482,33,17,Player A
4494,JointPQPlayer,303,188,491,39,16,Player A
4495,JointPQPlayer,311,186,497,39,14,Player A
4496,JointPQPlayer,302,197,499,32,11,Player A
4497,JointPQPlayer,287,197,484,35,17,Player A
4498,JointPQPlayer,277,197,474,37,21,Player A
4499,JointPQPlayer,268,203,471,34,21,Player A
4500,JointPQPlayer,295,190,485,39,18,Player A
4501,JointPQPlayer,306,191,497,36,13,Player A
4502,JointPQPlayer,291,191,482,39,19,Player A
4503,JointPQPlayer,267,202,469,35,22,Player A
4504,JointPQPlayer,164,249,413,18,35,JointPQPlayer
4505,JointPQPlayer,306,191,497,36,13,Player A
4506,JointPQPlayer,137,262,399,13,38,JointPQPlayer
4507,JointPQPlayer,314,189,503,36,11,Player A
4508,JointPQPlayer,155,260,415,11,32,JointPQPlayer
4509,JointPQPlayer,331,176,507,43,12,Player A
4510,JointPQPlayer,248,218,466,26,20,Player A
4511,JointPQPlayer,295,190,485,39,18,Player A
4512,JointPQPlayer,301,191,492,37,15,Player A
4513,JointPQPlayer,314,194,508,32,8,Player A
4514,JointPQPlayer,157,252,409,17,36,JointPQPlayer
4515,JointPQPlayer,277,197,474,37,21,Player A
4516,JointPQPlayer,301,191,492,37,15,Player A
4517,JointPQPlayer,254,209,463,32,23,Player A
4518,JointPQPlayer,295,195,490,35,15,Player A
4519,JointPQPlayer,290,195,485,36,17,Player A
4520,JointPQPlayer,297,197,494,33,13,Player A
4521,JointPQPlayer,278,203,481,32,17,Player A
4522,JointPQPlayer,289,199,488,33,15,Player A
4523,JointPQPlayer,318,183,501,40,13,Player A
4524,JointPQPlayer,322,182,504,40,12,Player A
4525,JointPQPlayer,134,264,398,12,38,JointPQPlayer
4526,JointPQPlayer,296,196,492,34,14,Player A
4527,JointPQPlayer,306,186,492,40,16,Player A
4528,JointPQPlayer,196,236,432,22,30,JointPQPlayer
4529,JointPQPlayer,291,201,492,31,13,Player A
4530,JointPQPlayer,283,193,476,39,21,Player A
4531,JointPQPlayer,232,222,454,26,24,Player A
4532,JointPQPlayer,274,204,478,32,18,Player A
4533,JointPQPlayer,293,198,491,33,14,Player A
4534,JointPQPlayer,313,183,496,41,15,Player A
4535,JointPQPlayer,309,189,498,37,13,Player A
4536,JointPQPlayer,292,197,489,34,15,Player A
4537,JointPQPlayer,285,200,485,33,16,Player A
4538,JointPQPlayer,306,196,502,32,10,Player A
4539,JointPQPlayer,306,191,497,36,13,Player A
4540,JointPQPlayer,297,197,494,33,13,Player A
4541,JointPQPlayer,124,264,388,14,42,JointPQPlayer
4542,JointPQPlayer,305,185,490,41,17,Player A
4543,JointPQPlayer,150,260,410,12,34,JointPQPlayer
4544,JointPQPlayer,281,201,482,33,17,Player A
4545,JointPQPlayer,284,199,483,34,17,Player A
4546,JointPQPlayer,300,190,490,38,16,Player A
4547,JointPQPlayer,266,206,472,32,20,Player A
4548,JointPQPlayer,132,262,394,14,40,JointPQPlayer
4549,JointPQPlayer,284,204,488,30,14,Player A
4550,JointPQPlayer,286,201,487,32,15,Player A
4551,JointPQPlayer,297,197,494,33,13,Player A
4552,JointPQPlayer,287,197,484,35,17,Player A
4553,JointPQPlayer,296,191,487,38,17,Player A
4554,JointPQPlayer,292,197,489,34,15,Player A
4555,JointPQPlayer,292,192,484,38,18,Player A
4556,JointPQPlayer,121,271,392,9,39,JointPQPlayer
4557,JointPQPlayer,323,183,506,39,11,Player A
4558,JointPQPlayer,309,189,498,37,13,Player A
4559,JointPQPlayer,304,194,498,34,12,Player A
4560,JointPQPlayer,136,266,402,10,36,JointPQPlayer
4561,JointPQPlayer,304,194,498,34,12,Player A
4562,JointPQPlayer,307,192,499,35,12,Player A
4563,JointPQPlayer,297,197,494,33,13,Player A
4564,JointPQPlayer,292,192,484,38,18,Player A
4565,JointPQPlayer,269,199,468,37,23,Player A
4566,JointPQPlayer,143,263,406,11,35,JointPQPlayer
4567,JointPQPlayer,288,193,481,38,19,Player A
4568,JointPQPlayer,299,199,498,31,11,Player A
4569,JointPQPlayer,286,196,482,36,18,Player A
4570,JointPQPlayer,272,202,474,34,20,Player A
4571,JointPQPlayer,155,255,410,15,35,JointPQPlayer
4572,JointPQPlayer,279,194,473,39,22,Player A
4573,JointPQPlayer,261,206,467,33,22,Player A
4574,JointPQPlayer,293,193,486,37,17,Player A
4575,JointPQPlayer,290,200,490,32,14,Player A
4576,JointPQPlayer,134,264,398,12,38,JointPQPlayer
4577,JointPQPlayer,270,210,480,28,16,Player A
4578,JointPQPlayer,311,191,502,35,11,Player A
4579,JointPQPlayer,252,217,469,26,19,Player A
4580,JointPQPlayer,294,194,488,36,16,Player A
4581,JointPQPlayer,265,210,475,29,18,Player A
4582,JointPQPlayer,285,200,485,33,16,Player A
4583,JointPQPlayer,298,188,486,40,18,Player A
4584,JointPQPlayer,294,194,488,36,16,Player A
4585,JointPQPlayer,286,196,482,36,18,Player A
4586,JointPQPlayer,190,240,430,20,30,JointPQPlayer
4587,JointPQPlayer,219,229,448,23,25,JointPQPlayer
4588,JointPQPlayer,300,190,490,38,16,Player A
4589,JointPQPlayer,185,245,430,17,29,JointPQPlayer
4590,JointPQPlayer,137,262,399,13,38,JointPQPlayer
4591,JointPQPlayer,156,256,412,14,34,JointPQPlayer
4592,JointPQPlayer,277,202,479,33,18,Player A
4593,JointPQPlayer,293,198,491,33,14,Player A
4594,JointPQPlayer,280,205,485,30,15,Player A
4595,JointPQPlayer,139,259,398,15,39,JointPQPlayer
4596,JointPQPlayer,313,183,496,41,15,Player A
4597,JointPQPlayer,285,195,480,37,19,Player A
4598,JointPQPlayer,268,203,471,34,21,Player A
4599,JointPQPlayer,283,203,486,31,15,Player A
4600,JointPQPlayer,304,194,498,34,12,Player A
4601,JointPQPlayer,301,191,492,37,15,Player A
4602,JointPQPlayer,142,262,404,12,36,JointPQPlayer
4603,JointPQPlayer,278,198,476,36,20,Player A
4604,JointPQPlayer,154,254,408,16,36,JointPQPlayer
4605,JointPQPlayer,309,189,498,37,13,Player A
4606,JointPQPlayer,296,191,487,38,17,Player A
4607,JointPQPlayer,272,202,474,34,20,Player A
4608,JointPQPlayer,300,195,495,34,13,Player A
4609,JointPQPlayer,265,200,465,37,24,Player A
4610,JointPQPlayer,155,255,410,15,35,JointPQPlayer
4611,JointPQPlayer,147,257,404,15,37,JointPQPlayer
4612,JointPQPlayer,309,189,498,37,13,Player A
4613,JointPQPlayer,268,203,471,34,21,Player A
4614,JointPQPlayer,151,256,407,15,36,JointPQPlayer
4615,JointPQPlayer,262,202,464,36,24,Player A
4616,JointPQPlayer,133,268,401,9,36,JointPQPlayer
4617,JointPQPlayer,325,180,505,41,12,Player A
4618,JointPQPlayer,271,206,477,31,18,Player A
4619,JointPQPlayer,174,244,418,20,34,JointPQPlayer
4620,JointPQPlayer,340,175,515,42,9,Player A
4621,JointPQPlayer,303,193,496,35,13,Player A
4622,JointPQPlayer,286,196,482,36,18,Player A
4623,JointPQPlayer,254,209,463,32,23,Player A
4624,JointPQPlayer,148,258,406,14,36,JointPQPlayer
4625,JointPQPlayer,297,197,494,33,13,Player A
4626,JointPQPlayer,149,259,408,13,35,JointPQPlayer
4627,JointPQPlayer,108,273,381,10,43,JointPQPlayer
4628,JointPQPlayer,324,184,508,38,10,Player A
4629,JointPQPlayer,289,194,483,37,18,Player A
4630,JointPQPlayer,282,197,479,36,19,Player A
4631,JointPQPlayer,293,198,491,33,14,Player A
4632,JointPQPlayer,280,200,480,34,18,Player A
4633,JointPQPlayer,172,247,419,18,33,JointPQPlayer
4634,JointPQPlayer,304,194,498,34,12,Player A
4635,JointPQPlayer,293,193,486,37,17,Player A
4636,JointPQPlayer,153,253,406,17,37,JointPQPlayer
4637,JointPQPlayer,266,211,477,28,17,Player A
4638,JointPQPlayer,155,250,405,19,38,JointPQPlayer
4639,JointPQPlayer,286,196,482,36,18,Player A
4640,JointPQPlayer,290,200,490,32,14,Player A
4641,JointPQPlayer,153,258,411,13,34,JointPQPlayer
4642,JointPQPlayer,306,191,497,36,13,Player A
4643,JointPQPlayer,161,251,412,17,35,JointPQPlayer
4644,JointPQPlayer,297,197,494,33,13,Player A
4645,JointPQPlayer,125,270,395,9,38,JointPQPlayer
4646,JointPQPlayer,160,255,415,14,33,JointPQPlayer
4647,JointPQPlayer,139,259,398,15,39,JointPQPlayer
4648,JointPQPlayer,294,199,493,32,13,Player A
4649,JointPQPlayer,185,240,425,21,32,JointPQPlayer
4650,JointPQPlayer,288,198,486,34,16,Player A
4651,JointPQPlayer,274,199,473,36,21,Player A
4652,JointPQPlayer,294,194,488,36,16,Player A
4653,JointPQPlayer,258,218,476,24,16,Player A
4654,JointPQPlayer,277,202,479,33,18,Player A
4655,JointPQPlayer,281,206,487,29,14,Player A
4656,JointPQPlayer,235,215,450,31,27,Player A
4657,JointPQPlayer,266,206,472,32,20,Player A
4658,JointPQPlayer,273,208,481,29,16,Player A
4659,JointPQPlayer,260,205,465,34,23,Player A
4660,JointPQPlayer,178,248,426,16,30,JointPQPlayer
4661,JointPQPlayer,321,186,507,37,10,Player A
4662,JointPQPlayer,308,188,496,38,14,Player A
4663,JointPQPlayer,287,192,479,39,20,Player A
4664,JointPQPlayer,308,188,496,38,14,Player A
4665,JointPQPlayer,276,201,477,34,19,Player A
4666,JointPQPlayer,297,192,489,37,16,Player A
4667,JointPQPlayer,271,201,472,35,21,Player A
4668,JointPQPlayer,222,222,444,28,28,Tie
4669,JointPQPlayer,282,202,484,32,16,Player A
4670,JointPQPlayer,142,262,404,12,36,JointPQPlayer
4671,JointPQPlayer,269,204,473,33,20,Player A
4672,JointPQPlayer,263,208,471,31,20,Player A
4673,JointPQPlayer,293,193,486,37,17,Player A
4674,JointPQPlayer,151,256,407,15,36,JointPQPlayer
4675,JointPQPlayer,133,263,396,13,39,JointPQPlayer
4676,JointPQPlayer,316,181,497,42,15,Player A
4677,JointPQPlayer,281,201,482,33,17,Player A
4678,JointPQPlayer,304,189,493,38,15,Player A
4679,JointPQPlayer,317,187,504,37,11,Player A
4680,JointPQPlayer,328,178,506,42,12,Player A
4681,JointPQPlayer,269,199,468,37,23,Player A
4682,JointPQPlayer,279,204,483,31,16,Player A
4683,JointPQPlayer,139,264,403,11,36,JointPQPlayer
4684,JointPQPlayer,170,255,425,12,29,JointPQPlayer
4685,JointPQPlayer,314,184,498,40,14,Player A
4686,JointPQPlayer,158,253,411,16,35,JointPQPlayer
4687,JointPQPlayer,305,190,495,37,14,Player A
4688,JointPQPlayer,273,208,481,29,16,Player A
4689,JointPQPlayer,275,205,480,31,17,Player A
4690,JointPQPlayer,301,191,492,37,15,Player A
4691,JointPQPlayer,299,194,493,35,14,Player A
4692,JointPQPlayer,138,263,401,12,37,JointPQPlayer
4693,JointPQPlayer,257,207,464,33,23,Player A
4694,JointPQPlayer,159,254,413,15,34,JointPQPlayer
4695,JointPQPlayer,294,194,488,36,16,Player A
4696,JointPQPlayer,126,271,397,8,37,JointPQPlayer
4697,JointPQPlayer,157,252,409,17,36,JointPQPlayer
4698,JointPQPlayer,275,200,475,35,20,Player A
4699,JointPQPlayer,279,199,478,35,19,Player A
4700,JointPQPlayer,141,256,397,17,40,JointPQPlayer
4701,JointPQPlayer,300,190,490,38,16,Player A
4702,JointPQPlayer,152,257,409,14,35,JointPQPlayer
4703,JointPQPlayer,285,195,480,37,19,Player A
4704,JointPQPlayer,255,210,465,31,22,Player A
4705,JointPQPlayer,147,262,409,11,34,JointPQPlayer
4706,JointPQPlayer,283,198,481,35,18,Player A
4707,JointPQPlayer,284,194,478,38,20,Player A
4708,JointPQPlayer,154,254,408,16,36,JointPQPlayer
4709,JointPQPlayer,305,190,495,37,14,Player A
4710,JointPQPlayer,292,197,489,34,15,Player A
4711,JointPQPlayer,155,255,410,15,35,JointPQPlayer
4712,JointPQPlayer,282,197,479,36,19,Player A
4713,JointPQPlayer,288,203,491,30,13,Player A
4714,JointPQPlayer,155,260,415,11,32,JointPQPlayer
4715,JointPQPlayer,316,186,502,38,12,Player A
4716,JointPQPlayer,275,205,480,31,17,Player A
4717,JointPQPlayer,157,252,409,17,36,JointPQPlayer
4718,JointPQPlayer,154,254,408,16,36,JointPQPlayer
4719,JointPQPlayer,267,207,474,31,19,Player A
4720,JointPQPlayer,307,187,494,39,15,Player A
4721,JointPQPlayer,302,192,494,36,14,Player A
4722,JointPQPlayer,305,195,500,33,11,Player A
4723,JointPQPlayer,319,189,508,35,9,Player A
4724,JointPQPlayer,148,258,406,14,36,JointPQPlayer
4725,JointPQPlayer,270,205,475,32,19,Player A
4726,JointPQPlayer,301,196,497,33,12,Player A
4727,JointPQPlayer,161,261,422,9,29,JointPQPlayer
4728,JointPQPlayer,287,197,484,35,17,Player A
4729,JointPQPlayer,301,196,497,33,12,Player A
4730,JointPQPlayer,264,209,473,30,19,Player A
4731,JointPQPlayer,133,268,401,9,36,JointPQPlayer
4732,JointPQPlayer,226,226,452,24,24,Tie
4733,JointPQPlayer,331,181,512,39,9,Player A
4734,JointPQPlayer,306,186,492,40,16,Player A
4735,JointPQPlayer,230,220,450,28,26,Player A
4736,JointPQPlayer,313,188,501,37,12,Player A
4737,JointPQPlayer,153,258,411,13,34,JointPQPlayer
4738,JointPQPlayer,140,260,400,14,38,JointPQPlayer
4739,JointPQPlayer,135,260,395,15,40,JointPQPlayer
4740,JointPQPlayer,310,190,500,36,12,Player A
4741,JointPQPlayer,299,189,488,39,17,Player A
4742,JointPQPlayer,282,207,489,28,13,Player A
4743,JointPQPlayer,148,253,401,18,39,JointPQPlayer
4744,JointPQPlayer,281,201,482,33,17,Player A
4745,JointPQPlayer,153,253,406,17,37,JointPQPlayer
4746,JointPQPlayer,271,201,472,35,21,Player A
4747,JointPQPlayer,279,204,483,31,16,Player A
4748,JointPQPlayer,287,202,489,31,14,Player A
4749,JointPQPlayer,308,193,501,34,11,Player A
4750,JointPQPlayer,290,195,485,36,17,Player A
4751,JointPQPlayer,209,229,438,25,29,JointPQPlayer
4752,JointPQPlayer,318,183,501,40,13,Player A
4753,JointPQPlayer,204,234,438,22,28,JointPQPlayer
4754,JointPQPlayer,320,190,510,34,8,Player A
4755,JointPQPlayer,294,194,488,36,16,Player A
4756,JointPQPlayer,300,195,495,34,13,Player A
4757,JointPQPlayer,291,196,487,35,16,Player A
4758,JointPQPlayer,278,208,486,28,14,Player A
4759,JointPQPlayer,175,245,420,19,33,JointPQPlayer
4760,JointPQPlayer,302,187,489,40,17,Player A
4761,JointPQPlayer,247,217,464,27,21,Player A
4762,JointPQPlayer,296,196,492,34,14,Player A
4763,JointPQPlayer,282,202,484,32,16,Player A
4764,JointPQPlayer,295,190,485,39,18,Player A
4765,JointPQPlayer,247,212,459,31,24,Player A
4766,JointPQPlayer,244,214,458,30,24,Player A
4767,JointPQPlayer,305,190,495,37,14,Player A
4768,JointPQPlayer,281,196,477,37,20,Player A
4769,JointPQPlayer,308,188,496,38,14,Player A
4770,JointPQPlayer,294,194,488,36,16,Player A
4771,JointPQPlayer,284,204,488,30,14,Player A
4772,JointPQPlayer,319,184,503,39,12,Player A
4773,JointPQPlayer,158,258,416,12,32,JointPQPlayer
4774,JointPQPlayer,311,186,497,39,14,Player A
4775,JointPQPlayer,156,256,412,14,34,JointPQPlayer
4776,JointPQPlayer,299,199,498,31,11,Player A
4777,JointPQPlayer,169,254,423,13,30,JointPQPlayer
4778,JointPQPlayer,307,187,494,39,15,Player A
4779,JointPQPlayer,317,192,509,33,8,Player A
4780,JointPQPlayer,277,202,479,33,18,Player A
4781,JointPQPlayer,158,253,411,16,35,JointPQPlayer
4782,JointPQPlayer,274,204,478,32,18,Player A
4783,JointPQPlayer,279,199,478,35,19,Player A
4784,JointPQPlayer,157,257,414,13,33,JointPQPlayer
4785,JointPQPlayer,293,198,491,33,14,Player A
4786,JointPQPlayer,157,252,409,17,36,JointPQPlayer
4787,JointPQPlayer,299,194,493,35,14,Player A
4788,JointPQPlayer,289,199,488,33,15,Player A
4789,JointPQPlayer,254,209,463,32,23,Player A
4790,JointPQPlayer,259,214,473,27,18,Player A
4791,JointPQPlayer,276,206,482,30,16,Player A
4792,JointPQPlayer,130,265,395,12,39,JointPQPlayer
4793,JointPQPlayer,308,188,496,38,14,Player A
4794,JointPQPlayer,122,272,394,8,38,JointPQPlayer
4795,JointPQPlayer,305,190,495,37,14,Player A
4796,JointPQPlayer,151,261,412,11,33,JointPQPlayer
4797,JointPQPlayer,315,185,500,39,13,Player A
4798,JointPQPlayer,305,190,495,37,14,Player A
4799,JointPQPlayer,120,270,390,10,40,JointPQPlayer
4800,JointPQPlayer,256,211,467,30,21,Player A
4801,JointPQPlayer,312,187,499,38,13,Player A
4802,JointPQPlayer,150,265,415,8,31,JointPQPlayer
4803,JointPQPlayer,164,249,413,18,35,JointPQPlayer
4804,JointPQPlayer,135,260,395,15,40,JointPQPlayer
4805,JointPQPlayer,143,263,406,11,35,JointPQPlayer
4806,JointPQPlayer,297,187,484,41,19,Player A
4807,JointPQPlayer,290,200,490,32,14,Player A
4808,JointPQPlayer,271,206,477,31,18,Player A
4809,JointPQPlayer,276,201,477,34,19,Player A
4810,JointPQPlayer,261,206,467,33,22,Player A
4811,JointPQPlayer,116,266,382,14,44,JointPQPlayer
4812,JointPQPlayer,151,261,412,11,33,JointPQPlayer
4813,JointPQPlayer,146,261,407,12,35,JointPQPlayer
4814,JointPQPlayer,319,184,503,39,12,Player A
4815,JointPQPlayer,278,198,476,36,20,Player A
4816,JointPQPlayer,290,195,485,36,17,Player A
4817,JointPQPlayer,268,213,481,26,15,Player A
4818,JointPQPlayer,132,267,399,10,37,JointPQPlayer
4819,JointPQPlayer,328,183,511,38,9,Player A
4820,JointPQPlayer,148,258,406,14,36,JointPQPlayer
4821,JointPQPlayer,318,188,506,36,10,Player A
4822,JointPQPlayer,292,197,489,34,15,Player A
4823,JointPQPlayer,162,252,414,16,34,JointPQPlayer
4824,JointPQPlayer,145,260,405,13,36,JointPQPlayer
4825,JointPQPlayer,283,203,486,31,15,Player A
4826,JointPQPlayer,302,192,494,36,14,Player A
4827,JointPQPlayer,192,242,434,18,28,JointPQPlayer
4828,JointPQPlayer,160,250,410,18,36,JointPQPlayer
4829,JointPQPlayer,298,193,491,36,15,Player A
4830,JointPQPlayer,243,213,456,31,25,Player A
4831,JointPQPlayer,302,192,494,36,14,Player A
4832,JointPQPlayer,303,198,501,31,10,Player A
4833,JointPQPlayer,315,185,500,39,13,Player A
4834,JointPQPlayer,307,187,494,39,15,Player A
4835,JointPQPlayer,135,265,400,11,37,JointPQPlayer
4836,JointPQPlayer,175,255,430,11,27,JointPQPlayer
4837,JointPQPlayer,300,190,490,38,16,Player A
4838,JointPQPlayer,304,189,493,38,15,Player A
4839,JointPQPlayer,128,268,396,10,38,JointPQPlayer
4840,JointPQPlayer,284,199,483,34,17,Player A
4841,JointPQPlayer,135,265,400,11,37,JointPQPlayer
4842,JointPQPlayer,140,260,400,14,38,JointPQPlayer
4843,JointPQPlayer,305,185,490,41,17,Player A
4844,JointPQPlayer,310,190,500,36,12,Player A
4845,JointPQPlayer,290,195,485,36,17,Player A
4846,JointPQPlayer,320,185,505,38,11,Player A
4847,JointPQPlayer,287,197,484,35,17,Player A
4848,JointPQPlayer,296,196,492,34,14,Player A
4849,JointPQPlayer,301,196,497,33,12,Player A
4850,JointPQPlayer,302,192,494,36,14,Player A
4851,JointPQPlayer,288,198,486,34,16,Player A
4852,JointPQPlayer,280,205,485,30,15,Player A
4853,JointPQPlayer,302,192,494,36,14,Player A
4854,JointPQPlayer,275,205,480,31,17,Player A
4855,JointPQPlayer,290,200,490,32,14,Player A
4856,JointPQPlayer,288,198,486,34,16,Player A
4857,JointPQPlayer,329,179,508,41,11,Player A
4858,JointPQPlayer,262,212,474,28,18,Player A
4859,JointPQPlayer,313,183,496,41,15,Player A
4860,JointPQPlayer,210,230,440,24,28,JointPQPlayer
4861,JointPQPlayer,271,201,472,35,21,Player A
4862,JointPQPlayer,304,189,493,38,15,Player A
4863,JointPQPlayer,297,192,489,37,16,Player A
4864,JointPQPlayer,279,204,483,31,16,Player A
4865,JointPQPlayer,150,260,410,12,34,JointPQPlayer
4866,JointPQPlayer,294,189,483,40,19,Player A
4867,JointPQPlayer,311,186,497,39,14,Player A
4868,JointPQPlayer,265,200,465,37,24,Player A
4869,JointPQPlayer,272,202,474,34,20,Player A
4870,JointPQPlayer,296,191,487,38,17,Player A
4871,JointPQPlayer,313,188,501,37,12,Player A
4872,JointPQPlayer,154,254,408,16,36,JointPQPlayer
4873,JointPQPlayer,200,230,430,26,32,JointPQPlayer
4874,JointPQPlayer,237,222,459,25,22,Player A
4875,JointPQPlayer,293,193,486,37,17,Player A
4876,JointPQPlayer,310,185,495,40,15,Player A
4877,JointPQPlayer,281,206,487,29,14,Player A
4878,JointPQPlayer,327,177,504,43,13,Player A
4879,JointPQPlayer,157,257,414,13,33,JointPQPlayer
4880,JointPQPlayer,203,228,431,27,32,JointPQPlayer
4881,JointPQPlayer,312,187,499,38,13,Player A
4882,JointPQPlayer,297,197,494,33,13,Player A
4883,JointPQPlayer,193,238,431,21,30,JointPQPlayer
4884,JointPQPlayer,292,197,489,34,15,Player A
4885,JointPQPlayer,294,199,493,32,13,Player A
4886,JointPQPlayer,278,198,476,36,20,Player A
4887,JointPQPlayer,297,197,494,33,13,Player A
4888,JointPQPlayer,314,189,503,36,11,Player A
4889,JointPQPlayer,281,201,482,33,17,Player A
4890,JointPQPlayer,290,195,485,36,17,Player A
4891,JointPQPlayer,143,258,401,15,38,JointPQPlayer
4892,JointPQPlayer,323,188,511,35,8,Player A
4893,JointPQPlayer,282,202,484,32,16,Player A
4894,JointPQPlayer,278,198,476,36,20,Player A
4895,JointPQPlayer,306,196,502,32,10,Player A
4896,JointPQPlayer,297,197,494,33,13,Player A
4897,JointPQPlayer,306,191,497,36,13,Player A
4898,JointPQPlayer,142,262,404,12,36,JointPQPlayer
4899,JointPQPlayer,296,191,487,38,17,Player A
4900,JointPQPlayer,245,215,460,29,23,Player A
4901,JointPQPlayer,294,189,483,40,19,Player A
4902,JointPQPlayer,309,194,503,33,10,Player A
4903,JointPQPlayer,150,260,410,12,34,JointPQPlayer
4904,JointPQPlayer,292,197,489,34,15,Player A
4905,JointPQPlayer,291,196,487,35,16,Player A
4906,JointPQPlayer,291,196,487,35,16,Player A
4907,JointPQPlayer,130,260,390,16,42,JointPQPlayer
4908,JointPQPlayer,265,205,470,33,21,Player A
4909,JointPQPlayer,283,198,481,35,18,Player A
4910,JointPQPlayer,257,202,459,37,26,Player A
4911,JointPQPlayer,288,193,481,38,19,Player A
4912,JointPQPlayer,164,254,418,14,32,JointPQPlayer
4913,JointPQPlayer,319,184,503,39,12,Player A
4914,JointPQPlayer,282,197,479,36,19,Player A
4915,JointPQPlayer,303,193,496,35,13,Player A
4916,JointPQPlayer,261,211,472,29,19,Player A
4917,JointPQPlayer,281,196,477,37,20,Player A
4918,JointPQPlayer,321,186,507,37,10,Player A
4919,JointPQPlayer,304,189,493,38,15,Player A
4920,JointPQPlayer,276,201,477,34,19,Player A
4921,JointPQPlayer,278,203,481,32,17,Player A
4922,JointPQPlayer,177,247,424,17,31,JointPQPlayer
4923,JointPQPlayer,320,190,510,34,8,Player A
4924,JointPQPlayer,305,190,495,37,14,Player A
4925,JointPQPlayer,286,201,487,32,15,Player A
4926,JointPQPlayer,153,258,411,13,34,JointPQPlayer
4927,JointPQPlayer,286,196,482,36,18,Player A
4928,JointPQPlayer,288,198,486,34,16,Player A
4929,JointPQPlayer,304,189,493,38,15,Player A
4930,JointPQPlayer,158,258,416,12,32,JointPQPlayer
4931,JointPQPlayer,293,193,486,37,17,Player A
4932,JointPQPlayer,298,193,491,36,15,Player A
4933,JointPQPlayer,292,197,489,34,15,Player A
4934,JointPQPlayer,283,198,481,35,18,Player A
4935,JointPQPlayer,292,197,489,34,15,Player A
4936,JointPQPlayer,271,206,477,31,18,Player A
4937,JointPQPlayer,154,259,413,12,33,JointPQPlayer
4938,JointPQPlayer,311,191,502,35,11,Player A
4939,JointPQPlayer,155,250,405,19,38,JointPQPlayer
4940,JointPQPlayer,163,253,416,15,33,JointPQPlayer
4941,JointPQPlayer,308,188,496,38,14,Player A
4942,JointPQPlayer,278,198,476,36,20,Player A
4943,JointPQPlayer,292,202,494,30,12,Player A
4944,JointPQPlayer,301,186,487,41,18,Player A
4945,JointPQPlayer,272,202,474,34,20,Player A
4946,JointPQPlayer,317,182,499,41,14,Player A
4947,JointPQPlayer,306,191,497,36,13,Player A
4948,JointPQPlayer,286,196,482,36,18,Player A
4949,JointPQPlayer,322,182,504,40,12,Player A
4950,JointPQPlayer,317,187,504,37,11,Player A
4951,JointPQPlayer,115,275,390,7,39,JointPQPlayer
4952,JointPQPlayer,321,186,507,37,10,Player A
4953,JointPQPlayer,325,180,505,41,12,Player A
4954,JointPQPlayer,313,183,496,41,15,Player A
4955,JointPQPlayer,303,193,496,35,13,Player A
4956,JointPQPlayer,297,192,489,37,16,Player A
4957,JointPQPlayer,286,196,482,36,18,Player A
4958,JointPQPlayer,294,194,488,36,16,Player A
4959,JointPQPlayer,149,259,408,13,35,JointPQPlayer
4960,JointPQPlayer,284,189,473,42,23,Player A
4961,JointPQPlayer,311,186,497,39,14,Player A
4962,JointPQPlayer,291,196,487,35,16,Player A
4963,JointPQPlayer,316,191,507,34,9,Player A
4964,JointPQPlayer,264,214,478,26,16,Player A
4965,JointPQPlayer,135,265,400,11,37,JointPQPlayer
4966,JointPQPlayer,158,258,416,12,32,JointPQPlayer
4967,JointPQPlayer,293,198,491,33,14,Player A
4968,JointPQPlayer,304,189,493,38,15,Player A
4969,JointPQPlayer,293,193,486,37,17,Player A
4970,JointPQPlayer,295,195,490,35,15,Player A
4971,JointPQPlayer,212,232,444,22,26,JointPQPlayer
4972,JointPQPlayer,159,259,418,11,31,JointPQPlayer
4973,JointPQPlayer,131,261,392,15,41,JointPQPlayer
4974,JointPQPlayer,312,187,499,38,13,Player A
4975,JointPQPlayer,327,182,509,39,10,Player A
4976,JointPQPlayer,319,189,508,35,9,Player A
4977,JointPQPlayer,275,205,480,31,17,Player A
4978,JointPQPlayer,262,207,469,32,21,Player A
4979,JointPQPlayer,286,196,482,36,18,Player A
4980,JointPQPlayer,133,263,396,13,39,JointPQPlayer
4981,JointPQPlayer,293,198,491,33,14,Player A
4982,JointPQPlayer,303,188,491,39,16,Player A
4983,JointPQPlayer,270,205,475,32,19,Player A
4984,JointPQPlayer,281,206,487,29,14,Player A
4985,JointPQPlayer,289,199,488,33,15,Player A
4986,JointPQPlayer,258,208,466,32,22,Player A
4987,JointPQPlayer,231,221,452,27,25,Player A
4988,JointPQPlayer,318,188,506,36,10,Player A
4989,JointPQPlayer,147,257,404,15,37,JointPQPlayer
4990,JointPQPlayer,128,273,401,6,35,JointPQPlayer
4991,JointPQPlayer,321,186,507,37,10,Player A
4992,JointPQPlayer,324,179,503,42,13,Player A
4993,JointPQPlayer,136,261,397,14,39,JointPQPlayer
4994,JointPQPlayer,308,188,496,38,14,Player A
4995,JointPQPlayer,159,259,418,11,31,JointPQPlayer
4996,JointPQPlayer,256,211,467,30,21,Player A
4997,JointPQPlayer,269,204,473,33,20,Player A
4998,JointPQPlayer,303,193,496,35,13,Player A
4999,JointPQPlayer,125,270,395,9,38,JointPQPlayer
5000,JointPQPlayer,143,263,406,11,35,JointPQPlayer
5001,JointPQPlayer,283,203,486,31,15,Player A
5002,JointPQPlayer,297,197,494,33,13,Player A
5003,JointPQPlayer,264,209,473,30,19,Player A
5004,JointPQPlayer,320,185,505,38,11,Player A
5005,JointPQPlayer,272,207,479,30,17,Player A
5006,JointPQPlayer,250,205,455,36,27,Player A
5007,JointPQPlayer,299,199,498,31,11,Player A
5008,JointPQPlayer,124,269,393,10,39,JointPQPlayer
5009,JointPQPlayer,281,201,482,33,17,Player A
5010,JointPQPlayer,305,190,495,37,14,Player A
5011,JointPQPlayer,281,196,477,37,20,Player A
5012,JointPQPlayer,276,206,482,30,16,Player A
5013,JointPQPlayer,317,187,504,37,11,Player A
5014,JointPQPlayer,317,187,504,37,11,Player A
5015,JointPQPlayer,288,203,491,30,13,Player A
5016,JointPQPlayer,269,204,473,33,20,Player A
5017,JointPQPlayer,260,210,470,30,20,Player A
5018,JointPQPlayer,173,248,421,17,32,JointPQPlayer
5019,JointPQPlayer,288,203,491,30,13,Player A
5020,JointPQPlayer,144,264,408,10,34,JointPQPlayer
5021,JointPQPlayer,307,187,494,39,15,Player A
5022,JointPQPlayer,276,201,477,34,19,Player A
5023,JointPQPlayer,290,200,490,32,14,Player A
5024,JointPQPlayer,277,202,479,33,18,Player A
5025,JointPQPlayer,309,199,508,29,7,Player A
5026,JointPQPlayer,212,232,444,22,26,JointPQPlayer
5027,JointPQPlayer,285,195,480,37,19,Player A
5028,JointPQPlayer,316,186,502,38,12,Player A
5029,JointPQPlayer,297,197,494,33,13,Player A
5030,JointPQPlayer,285,200,485,33,16,Player A
5031,JointPQPlayer,284,199,483,34,17,Player A
5032,JointPQPlayer,321,186,507,37,10,Player A
5033,JointPQPlayer,151,261,412,11,33,JointPQPlayer
5034,JointPQPlayer,288,198,486,34,16,Player A
5035,JointPQPlayer,285,200,485,33,16,Player A
5036,JointPQPlayer,316,186,502,38,12,Player A
5037,JointPQPlayer,128,263,391,14,41,JointPQPlayer
5038,JointPQPlayer,286,201,487,32,15,Player A
5039,JointPQPlayer,279,204,483,31,16,Player A
5040,JointPQPlayer,296,196,492,34,14,Player A
5041,JointPQPlayer,143,263,406,11,35,JointPQPlayer
5042,JointPQPlayer,268,208,476,30,18,Player A
5043,JointPQPlayer,138,258,396,16,40,JointPQPlayer
5044,JointPQPlayer,281,201,482,33,17,Player A
5045,JointPQPlayer,312,187,499,38,13,Player A
5046,JointPQPlayer,311,186,497,39,14,Player A
5047,JointPQPlayer,284,199,483,34,17,Player A
5048,JointPQPlayer,302,187,489,40,17,Player A
5049,JointPQPlayer,317,187,504,37,11,Player A
5050,JointPQPlayer,215,225,440,27,29,JointPQPlayer
5051,JointPQPlayer,266,206,472,32,20,Player A
5052,JointPQPlayer,145,260,405,13,36,JointPQPlayer
5053,JointPQPlayer,145,250,395,21,42,JointPQPlayer
5054,JointPQPlayer,294,194,488,36,16,Player A
5055,JointPQPlayer,251,216,467,27,20,Player A
5056,JointPQPlayer,147,257,404,15,37,JointPQPlayer
5057,JointPQPlayer,292,197,489,34,15,Player A
5058,JointPQPlayer,293,198,491,33,14,Player A
5059,JointPQPlayer,305,195,500,33,11,Player A
5060,JointPQPlayer,317,192,509,33,8,Player A
5061,JointPQPlayer,320,185,505,38,11,Player A
5062,JointPQPlayer,289,204,493,29,12,Player A
5063,JointPQPlayer,282,202,484,32,16,Player A
5064,JointPQPlayer,301,191,492,37,15,Player A
5065,JointPQPlayer,241,216,457,29,24,Player A
5066,JointPQPlayer,326,186,512,36,8,Player A
5067,JointPQPlayer,224,229,453,22,23,JointPQPlayer
5068,JointPQPlayer,146,256,402,16,38,JointPQPlayer
5069,JointPQPlayer,296,201,497,30,11,Player A
5070,JointPQPlayer,282,197,479,36,19,Player A
5071,JointPQPlayer,316,186,502,38,12,Player A
5072,JointPQPlayer,158,258,416,12,32,JointPQPlayer
5073,JointPQPlayer,230,225,455,24,23,Player A
5074,JointPQPlayer,291,196,487,35,16,Player A
5075,JointPQPlayer,308,188,496,38,14,Player A
5076,JointPQPlayer,159,259,418,11,31,JointPQPlayer
5077,JointPQPlayer,310,185,495,40,15,Player A
5078,JointPQPlayer,313,188,501,37,12,Player A
5079,JointPQPlayer,277,202,479,33,18,Player A
5080,JointPQPlayer,297,192,489,37,16,Player A
5081,JointPQPlayer,319,179,498,43,15,Player A
5082,JointPQPlayer,136,261,397,14,39,JointPQPlayer
5083,JointPQPlayer,308,188,496,38,14,Player A
5084,JointPQPlayer,291,191,482,39,19,Player A
5085,JointPQPlayer,281,201,482,33,17,Player A
5086,JointPQPlayer,278,203,481,32,17,Player A
5087,JointPQPlayer,306,191,497,36,13,Player A
5088,JointPQPlayer,307,187,494,39,15,Player A
5089,JointPQPlayer,289,199,488,33,15,Player A
5090,JointPQPlayer,279,204,483,31,16,Player A
5091,JointPQPlayer,308,188,496,38,14,Player A
5092,JointPQPlayer,290,195,485,36,17,Player A
5093,JointPQPlayer,153,263,416,9,31,JointPQPlayer
5094,JointPQPlayer,304,194,498,34,12,Player A
5095,JointPQPlayer,301,191,492,37,15,Player A
5096,JointPQPlayer,226,226,452,24,24,Tie
5097,JointPQPlayer,290,195,485,36,17,Player A
5098,JointPQPlayer,288,193,481,38,19,Player A
5099,JointPQPlayer,269,204,473,33,20,Player A
5100,JointPQPlayer,297,192,489,37,16,Player A
5101,JointPQPlayer,129,269,398,9,37,JointPQPlayer
5102,JointPQPlayer,304,189,493,38,15,Player A
5103,JointPQPlayer,326,181,507,40,11,Player A
5104,JointPQPlayer,300,190,490,38,16,Player A
5105,JointPQPlayer,157,262,419,9,30,JointPQPlayer
5106,JointPQPlayer,295,195,490,35,15,Player A
5107,JointPQPlayer,298,193,491,36,15,Player A
5108,JointPQPlayer,303,193,496,35,13,Player A
5109,JointPQPlayer,283,203,486,31,15,Player A
5110,JointPQPlayer,163,253,416,15,33,JointPQPlayer
5111,JointPQPlayer,285,200,485,33,16,Player A
5112,JointPQPlayer,270,205,475,32,19,Player A
5113,JointPQPlayer,303,188,491,39,16,Player A
5114,JointPQPlayer,293,193,486,37,17,Player A
5115,JointPQPlayer,145,265,410,9,33,JointPQPlayer
5116,JointPQPlayer,155,255,410,15,35,JointPQPlayer
5117,JointPQPlayer,293,193,486,37,17,Player A
5118,JointPQPlayer,246,216,462,28,22,Player A
5119,JointPQPlayer,303,188,491,39,16,Player A
5120,JointPQPlayer,257,202,459,37,26,Player A
5121,JointPQPlayer,129,269,398,9,37,JointPQPlayer
5122,JointPQPlayer,310,185,495,40,15,Player A
5123,JointPQPlayer,297,192,489,37,16,Player A
5124,JointPQPlayer,295,195,490,35,15,Player A
5125,JointPQPlayer,296,191,487,38,17,Player A
5126,JointPQPlayer,187,237,424,23,33,JointPQPlayer
5127,JointPQPlayer,270,205,475,32,19,Player A
5128,JointPQPlayer,321,186,507,37,10,Player A
5129,JointPQPlayer,158,258,416,12,32,JointPQPlayer
5130,JointPQPlayer,293,193,486,37,17,Player A
5131,JointPQPlayer,281,201,482,33,17,Player A
5132,JointPQPlayer,290,195,485,36,17,Player A
5133,JointPQPlayer,224,224,448,26,26,Tie
5134,JointPQPlayer,158,258,416,12,32,JointPQPlayer
5135,JointPQPlayer,273,198,471,37,22,Player A
5136,JointPQPlayer,276,206,482,30,16,Player A
5137,JointPQPlayer,304,194,498,34,12,Player A
5138,JointPQPlayer,291,196,487,35,16,Player A
5139,JointPQPlayer,290,190,480,40,20,Player A
5140,JointPQPlayer,282,202,484,32,16,Player A
5141,JointPQPlayer,230,220,450,28,26,Player A
5142,JointPQPlayer,265,205,470,33,21,Player A
5143,JointPQPlayer,309,189,498,37,13,Player A
5144,JointPQPlayer,302,192,494,36,14,Player A
5145,JointPQPlayer,163,253,416,15,33,JointPQPlayer
5146,JointPQPlayer,271,201,472,35,21,Player A
5147,JointPQPlayer,303,193,496,35,13,Player A
5148,JointPQPlayer,275,195,470,39,23,Player A
5149,JointPQPlayer,148,263,411,10,33,JointPQPlayer
5150,JointPQPlayer,243,213,456,31,25,Player A
5151,JointPQPlayer,169,254,423,13,30,JointPQPlayer
5152,JointPQPlayer,320,185,505,38,11,Player A
5153,JointPQPlayer,279,204,483,31,16,Player A
5154,JointPQPlayer,321,186,507,37,10,Player A
5155,JointPQPlayer,282,202,484,32,16,Player A
5156,JointPQPlayer,297,197,494,33,13,Player A
5157,JointPQPlayer,156,246,402,22,40,JointPQPlayer
5158,JointPQPlayer,297,187,484,41,19,Player A
5159,JointPQPlayer,278,203,481,32,17,Player A
5160,JointPQPlayer,306,196,502,32,10,Player A
5161,JointPQPlayer,281,201,482,33,17,Player A
5162,JointPQPlayer,175,245,420,19,33,JointPQPlayer
5163,JointPQPlayer,282,192,474,40,22,Player A
5164,JointPQPlayer,290,205,495,28,11,Player A
5165,JointPQPlayer,292,197,489,34,15,Player A
5166,JointPQPlayer,287,192,479,39,20,Player A
5167,JointPQPlayer,300,195,495,34,13,Player A
5168,JointPQPlayer,151,261,412,11,33,JointPQPlayer
5169,JointPQPlayer,227,222,449,27,26,Player A
5170,JointPQPlayer,276,206,482,30,16,Player A
5171,JointPQPlayer,304,194,498,34,12,Player A
5172,JointPQPlayer,259,204,463,35,24,Player A
5173,JointPQPlayer,282,197,479,36,19,Player A
5174,JointPQPlayer,306,191,497,36,13,Player A
5175,JointPQPlayer,313,188,501,37,12,Player A
5176,JointPQPlayer,327,182,509,39,10,Player A
5177,JointPQPlayer,142,262,404,12,36,JointPQPlayer
5178,JointPQPlayer,249,219,468,25,19,Player A
5179,JointPQPlayer,237,222,459,25,22,Player A
5180,JointPQPlayer,293,193,486,37,17,Player A
5181,JointPQPlayer,151,251,402,19,39,JointPQPlayer
5182,JointPQPlayer,140,260,400,14,38,JointPQPlayer
5183,JointPQPlayer,272,202,474,34,20,Player A
5184,JointPQPlayer,146,261,407,12,35,JointPQPlayer
5185,JointPQPlayer,305,190,495,37,14,Player A
5186,JointPQPlayer,312,187,499,38,13,Player A
5187,JointPQPlayer,312,187,499,38,13,Player A
5188,JointPQPlayer,301,186,487,41,18,Player A
5189,JointPQPlayer,250,210,460,32,24,Player A
5190,JointPQPlayer,307,187,494,39,15,Player A
5191,JointPQPlayer,273,198,471,37,22,Player A
5192,JointPQPlayer,133,268,401,9,36,JointPQPlayer
5193,JointPQPlayer,238,218,456,28,24,Player A
5194,JointPQPlayer,178,243,421,20,33,JointPQPlayer
5195,JointPQPlayer,296,196,492,34,14,Player A
5196,JointPQPlayer,329,179,508,41,11,Player A
5197,JointPQPlayer,255,205,460,35,25,Player A
5198,JointPQPlayer,323,183,506,39,11,Player A
5199,JointPQPlayer,306,191,497,36,13,Player A
5200,JointPQPlayer,288,193,481,38,19,Player A
5201,JointPQPlayer,273,203,476,33,19,Player A
5202,JointPQPlayer,280,205,485,30,15,Player A
5203,JointPQPlayer,303,193,496,35,13,Player A
5204,JointPQPlayer,250,215,465,28,21,Player A
5205,JointPQPlayer,267,207,474,31,19,Player A
5206,JointPQPlayer,270,205,475,32,19,Player A
5207,JointPQPlayer,274,204,478,32,18,Player A
5208,JointPQPlayer,273,203,476,33,19,Player A
5209,JointPQPlayer,123,268,391,11,40,JointPQPlayer
5210,JointPQPlayer,235,220,455,27,24,Player A
5211,JointPQPlayer,311,191,502,35,11,Player A
5212,JointPQPlayer,316,181,497,42,15,Player A
5213,JointPQPlayer,301,196,497,33,12,Player A
5214,JointPQPlayer,284,199,483,34,17,Player A
5215,JointPQPlayer,162,257,419,12,31,JointPQPlayer
5216,JointPQPlayer,309,194,503,33,10,Player A
5217,JointPQPlayer,291,196,487,35,16,Player A
5218,JointPQPlayer,305,195,500,33,11,Player A
5219,JointPQPlayer,271,201,472,35,21,Player A
5220,JointPQPlayer,297,197,494,33,13,Player A
5221,JointPQPlayer,281,201,482,33,17,Player A
5222,JointPQPlayer,278,203,481,32,17,Player A
5223,JointPQPlayer,255,210,465,31,22,Player A
5224,JointPQPlayer,264,209,473,30,19,Player A
5225,JointPQPlayer,297,197,494,33,13,Player A
5226,JointPQPlayer,291,196,487,35,16,Player A
5227,JointPQPlayer,154,264,418,8,30,JointPQPlayer
5228,JointPQPlayer,270,205,475,32,19,Player A
5229,JointPQPlayer,201,236,437,21,28,JointPQPlayer
5230,JointPQPlayer,265,205,470,33,21,Player A
5231,JointPQPlayer,322,187,509,36,9,Player A
5232,JointPQPlayer,305,190,495,37,14,Player A
5233,JointPQPlayer,298,193,491,36,15,Player A
5234,JointPQPlayer,265,200,465,37,24,Player A
5235,JointPQPlayer,273,203,476,33,19,Player A
5236,JointPQPlayer,271,211,482,27,15,Player A
5237,JointPQPlayer,138,268,406,8,34,JointPQPlayer
5238,JointPQPlayer,287,197,484,35,17,Player A
5239,JointPQPlayer,151,256,407,15,36,JointPQPlayer
5240,JointPQPlayer,328,183,511,38,9,Player A
5241,JointPQPlayer,137,267,404,9,35,JointPQPlayer
5242,JointPQPlayer,307,192,499,35,12,Player A
5243,JointPQPlayer,294,199,493,32,13,Player A
5244,JointPQPlayer,275,205,480,31,17,Player A
5245,JointPQPlayer,148,258,406,14,36,JointPQPlayer
5246,JointPQPlayer,255,210,465,31,22,Player A
5247,JointPQPlayer,250,210,460,32,24,Player A
5248,JointPQPlayer,288,198,486,34,16,Player A
5249,JointPQPlayer,285,205,490,29,13,Player A
5250,JointPQPlayer,291,196,487,35,16,Player A
5251,JointPQPlayer,283,203,486,31,15,Player A
5252,JointPQPlayer,307,192,499,35,12,Player A
5253,JointPQPlayer,277,197,474,37,21,Player A
5254,JointPQPlayer,143,258,401,15,38,JointPQPlayer
5255,JointPQPlayer,286,201,487,32,15,Player A
5256,JointPQPlayer,138,268,406,8,34,JointPQPlayer
5257,JointPQPlayer,308,183,491,42,17,Player A
5258,JointPQPlayer,291,201,492,31,13,Player A
5259,JointPQPlayer,284,199,483,34,17,Player A
5260,JointPQPlayer,131,266,397,11,38,JointPQPlayer
5261,JointPQPlayer,276,201,477,34,19,Player A
5262,JointPQPlayer,325,185,510,37,9,Player A
5263,JointPQPlayer,234,214,448,32,28,Player A
5264,JointPQPlayer,308,188,496,38,14,Player A
5265,JointPQPlayer,311,186,497,39,14,Player A
5266,JointPQPlayer,142,257,399,16,39,JointPQPlayer
5267,JointPQPlayer,297,197,494,33,13,Player A
5268,JointPQPlayer,288,198,486,34,16,Player A
5269,JointPQPlayer,296,196,492,34,14,Player A
5270,JointPQPlayer,279,199,478,35,19,Player A
5271,JointPQPlayer,285,200,485,33,16,Player A
5272,JointPQPlayer,245,220,465,25,20,Player A
5273,JointPQPlayer,292,197,489,34,15,Player A
5274,JointPQPlayer,149,254,403,17,38,JointPQPlayer
5275,JointPQPlayer,138,263,401,12,37,JointPQPlayer
5276,JointPQPlayer,289,199,488,33,15,Player A
5277,JointPQPlayer,246,221,467,24,19,Player A
5278,JointPQPlayer,281,201,482,33,17,Player A
5279,JointPQPlayer,230,220,450,28,26,Player A
5280,JointPQPlayer,287,202,489,31,14,Player A
5281,JointPQPlayer,288,198,486,34,16,Player A
5282,JointPQPlayer,288,198,486,34,16,Player A
5283,JointPQPlayer,265,205,470,33,21,Player A
5284,JointPQPlayer,189,244,433,17,28,JointPQPlayer
5285,JointPQPlayer,300,190,490,38,16,Player A
5286,JointPQPlayer,141,261,402,13,37,JointPQPlayer
5287,JointPQPlayer,282,202,484,32,16,Player A
5288,JointPQPlayer,303,193,496,35,13,Player A
5289,JointPQPlayer,255,215,470,27,19,Player A
5290,JointPQPlayer,276,201,477,34,19,Player A
5291,JointPQPlayer,281,201,482,33,17,Player A
5292,JointPQPlayer,151,261,412,11,33,JointPQPlayer
5293,JointPQPlayer,302,187,489,40,17,Player A
5294,JointPQPlayer,264,204,468,34,22,Player A
5295,JointPQPlayer,254,214,468,28,20,Player A
5296,JointPQPlayer,291,191,482,39,19,Player A
5297,JointPQPlayer,268,208,476,30,18,Player A
5298,JointPQPlayer,287,202,489,31,14,Player A
5299,JointPQPlayer,272,207,479,30,17,Player A
5300,JointPQPlayer,136,266,402,10,36,JointPQPlayer
5301,JointPQPlayer,274,209,483,28,15,Player A
5302,JointPQPlayer,130,260,390,16,42,JointPQPlayer
5303,JointPQPlayer,323,183,506,39,11,Player A
5304,JointPQPlayer,164,249,413,18,35,JointPQPlayer
5305,JointPQPlayer,223,228,451,23,24,JointPQPlayer
5306,JointPQPlayer,296,191,487,38,17,Player A
5307,JointPQPlayer,313,188,501,37,12,Player A
5308,JointPQPlayer,306,191,497,36,13,Player A
5309,JointPQPlayer,275,205,480,31,17,Player A
5310,JointPQPlayer,301,191,492,37,15,Player A
5311,JointPQPlayer,301,191,492,37,15,Player A
5312,JointPQPlayer,276,206,482,30,16,Player A
5313,JointPQPlayer,264,209,473,30,19,Player A
5314,JointPQPlayer,120,270,390,10,40,JointPQPlayer
5315,JointPQPlayer,294,194,488,36,16,Player A
5316,JointPQPlayer,290,200,490,32,14,Player A
5317,JointPQPlayer,292,197,489,34,15,Player A
5318,JointPQPlayer,296,201,497,30,11,Player A
5319,JointPQPlayer,321,181,502,41,13,Player A
5320,JointPQPlayer,281,201,482,33,17,Player A
5321,JointPQPlayer,148,258,406,14,36,JointPQPlayer
5322,JointPQPlayer,276,201,477,34,19,Player A
5323,JointPQPlayer,292,197,489,34,15,Player A
5324,JointPQPlayer,221,226,447,25,26,JointPQPlayer
5325,JointPQPlayer,311,191,502,35,11,Player A
5326,JointPQPlayer,276,201,477,34,19,Player A
5327,JointPQPlayer,253,213,466,29,21,Player A
5328,JointPQPlayer,294,189,483,40,19,Player A
5329,JointPQPlayer,305,190,495,37,14,Player A
5330,JointPQPlayer,294,194,488,36,16,Player A
5331,JointPQPlayer,278,208,486,28,14,Player A
5332,JointPQPlayer,295,195,490,35,15,Player A
5333,JointPQPlayer,153,258,411,13,34,JointPQPlayer
5334,JointPQPlayer,305,190,495,37,14,Player A
5335,JointPQPlayer,273,198,471,37,22,Player A
5336,JointPQPlayer,283,203,486,31,15,Player A
5337,JointPQPlayer,288,198,486,34,16,Player A
5338,JointPQPlayer,288,198,486,34,16,Player A
5339,JointPQPlayer,237,222,459,25,22,Player A
5340,JointPQPlayer,267,207,474,31,19,Player A
5341,JointPQPlayer,296,196,492,34,14,Player A
5342,JointPQPlayer,286,196,482,36,18,Player A
5343,JointPQPlayer,288,198,486,34,16,Player A
5344,JointPQPlayer,249,219,468,25,19,Player A
5345,JointPQPlayer,285,195,480,37,19,Player A
5346,JointPQPlayer,291,191,482,39,19,Player A
5347,JointPQPlayer,251,211,462,31,23,Player A
5348,JointPQPlayer,314,189,503,36,11,Player A
5349,JointPQPlayer,242,212,454,32,26,Player A
5350,JointPQPlayer,308,188,496,38,14,Player A
5351,JointPQPlayer,149,259,408,13,35,JointPQPlayer
5352,JointPQPlayer,265,205,470,33,21,Player A
5353,JointPQPlayer,271,206,477,31,18,Player A
5354,JointPQPlayer,276,201,477,34,19,Player A
5355,JointPQPlayer,301,186,487,41,18,Player A
5356,JointPQPlayer,300,195,495,34,13,Player A
5357,JointPQPlayer,311,186,497,39,14,Player A
5358,JointPQPlayer,197,237,434,21,29,JointPQPlayer
5359,JointPQPlayer,309,194,503,33,10,Player A
5360,JointPQPlayer,154,259,413,12,33,JointPQPlayer
5361,JointPQPlayer,262,212,474,28,18,Player A
5362,JointPQPlayer,225,230,455,21,22,JointPQPlayer
5363,JointPQPlayer,282,202,484,32,16,Player A
5364,JointPQPlayer,286,196,482,36,18,Player A
5365,JointPQPlayer,316,191,507,34,9,Player A
5366,JointPQPlayer,271,211,482,27,15,Player A
5367,JointPQPlayer,284,199,483,34,17,Player A
5368,JointPQPlayer,296,196,492,34,14,Player A
5369,JointPQPlayer,285,195,480,37,19,Player A
5370,JointPQPlayer,309,189,498,37,13,Player A
5371,JointPQPlayer,156,251,407,18,37,JointPQPlayer
5372,JointPQPlayer,289,194,483,37,18,Player A
5373,JointPQPlayer,269,209,478,29,17,Player A
5374,JointPQPlayer,292,192,484,38,18,Player A
5375,JointPQPlayer,150,255,405,16,37,JointPQPlayer
5376,JointPQPlayer,316,186,502,38,12,Player A
5377,JointPQPlayer,141,256,397,17,40,JointPQPlayer
5378,JointPQPlayer,155,260,415,11,32,JointPQPlayer
5379,JointPQPlayer,281,201,482,33,17,Player A
5380,JointPQPlayer,294,189,483,40,19,Player A
5381,JointPQPlayer,280,200,480,34,18,Player A
5382,JointPQPlayer,278,198,476,36,20,Player A
5383,JointPQPlayer,311,191,502,35,11,Player A
5384,JointPQPlayer,265,205,470,33,21,Player A
5385,JointPQPlayer,293,198,491,33,14,Player A
5386,JointPQPlayer,306,191,497,36,13,Player A
5387,JointPQPlayer,295,190,485,39,18,Player A
5388,JointPQPlayer,283,203,486,31,15,Player A
5389,JointPQPlayer,164,249,413,18,35,JointPQPlayer
5390,JointPQPlayer,282,202,484,32,16,Player A
5391,JointPQPlayer,290,200,490,32,14,Player A
5392,JointPQPlayer,137,262,399,13,38,JointPQPlayer
5393,JointPQPlayer,277,207,484,29,15,Player A
5394,JointPQPlayer,284,194,478,38,20,Player A
5395,JointPQPlayer,302,187,489,40,17,Player A
5396,JointPQPlayer,269,199,468,37,23,Player A
5397,JointPQPlayer,284,209,493,26,11,Player A
5398,JointPQPlayer,285,200,485,33,16,Player A
5399,JointPQPlayer,187,242,429,19,30,JointPQPlayer
5400,JointPQPlayer,291,196,487,35,16,Player A
5401,JointPQPlayer,268,203,471,34,21,Player A
5402,JointPQPlayer,152,252,404,18,38,JointPQPlayer
5403,JointPQPlayer,304,189,493,38,15,Player A
5404,JointPQPlayer,280,200,480,34,18,Player A
5405,JointPQPlayer,161,256,417,13,32,JointPQPlayer
5406,JointPQPlayer,296,196,492,34,14,Player A
5407,JointPQPlayer,331,176,507,43,12,Player A
5408,JointPQPlayer,144,264,408,10,34,JointPQPlayer
5409,JointPQPlayer,277,207,484,29,15,Player A
5410,JointPQPlayer,307,192,499,35,12,Player A
5411,JointPQPlayer,286,201,487,32,15,Player A
5412,JointPQPlayer,158,253,411,16,35,JointPQPlayer
5413,JointPQPlayer,307,192,499,35,12,Player A
5414,JointPQPlayer,277,202,479,33,18,Player A
5415,JointPQPlayer,306,191,497,36,13,Player A
5416,JointPQPlayer,142,257,399,16,39,JointPQPlayer
5417,JointPQPlayer,268,208,476,30,18,Player A
5418,JointPQPlayer,156,256,412,14,34,JointPQPlayer
5419,JointPQPlayer,140,265,405,10,35,JointPQPlayer
5420,JointPQPlayer,256,216,472,26,18,Player A
5421,JointPQPlayer,262,212,474,28,18,Player A
5422,JointPQPlayer,152,257,409,14,35,JointPQPlayer
5423,JointPQPlayer,291,196,487,35,16,Player A
5424,JointPQPlayer,148,258,406,14,36,JointPQPlayer
5425,JointPQPlayer,118,268,386,12,42,JointPQPlayer
5426,JointPQPlayer,292,192,484,38,18,Player A
5427,JointPQPlayer,309,194,503,33,10,Player A
5428,JointPQPlayer,281,201,482,33,17,Player A
5429,JointPQPlayer,307,187,494,39,15,Player A
5430,JointPQPlayer,296,196,492,34,14,Player A
5431,JointPQPlayer,263,213,476,27,17,Player A
5432,JointPQPlayer,300,190,490,38,16,Player A
5433,JointPQPlayer,140,265,405,10,35,JointPQPlayer
5434,JointPQPlayer,197,237,434,21,29,JointPQPlayer
5435,JointPQPlayer,155,260,415,11,32,JointPQPlayer
5436,JointPQPlayer,307,187,494,39,15,Player A
5437,JointPQPlayer,128,263,391,14,41,JointPQPlayer
5438,JointPQPlayer,285,200,485,33,16,Player A
5439,JointPQPlayer,292,197,489,34,15,Player A
5440,JointPQPlayer,302,197,499,32,11,Player A
5441,JointPQPlayer,120,265,385,14,43,JointPQPlayer
5442,JointPQPlayer,292,192,484,38,18,Player A
5443,JointPQPlayer,131,266,397,11,38,JointPQPlayer
5444,JointPQPlayer,148,263,411,10,33,JointPQPlayer
5445,JointPQPlayer,302,192,494,36,14,Player A
5446,JointPQPlayer,293,198,491,33,14,Player A
5447,JointPQPlayer,138,258,396,16,40,JointPQPlayer
5448,JointPQPlayer,294,199,493,32,13,Player A
5449,JointPQPlayer,304,189,493,38,15,Player A
5450,JointPQPlayer,159,254,413,15,34,JointPQPlayer
5451,JointPQPlayer,340,175,515,42,9,Player A
5452,JointPQPlayer,316,186,502,38,12,Player A
5453,JointPQPlayer,294,189,483,40,19,Player A
5454,JointPQPlayer,226,221,447,28,27,Player A
5455,JointPQPlayer,277,202,479,33,18,Player A
5456,JointPQPlayer,165,250,415,17,34,JointPQPlayer
5457,JointPQPlayer,277,202,479,33,18,Player A
5458,JointPQPlayer,294,189,483,40,19,Player A
5459,JointPQPlayer,278,203,481,32,17,Player A
5460,JointPQPlayer,132,267,399,10,37,JointPQPlayer
5461,JointPQPlayer,298,198,496,32,12,Player A
5462,JointPQPlayer,291,201,492,31,13,Player A
5463,JointPQPlayer,167,252,419,15,32,JointPQPlayer
5464,JointPQPlayer,307,192,499,35,12,Player A
5465,JointPQPlayer,279,204,483,31,16,Player A
5466,JointPQPlayer,301,201,502,29,9,Player A
5467,JointPQPlayer,300,190,490,38,16,Player A
5468,JointPQPlayer,141,261,402,13,37,JointPQPlayer
5469,JointPQPlayer,281,196,477,37,20,Player A
5470,JointPQPlayer,260,215,475,26,17,Player A
5471,JointPQPlayer,296,196,492,34,14,Player A
5472,JointPQPlayer,252,212,464,30,22,Player A
5473,JointPQPlayer,307,192,499,35,12,Player A
5474,JointPQPlayer,273,208,481,29,16,Player A
5475,JointPQPlayer,344,179,523,38,5,Player A
5476,JointPQPlayer,159,259,418,11,31,JointPQPlayer
5477,JointPQPlayer,273,203,476,33,19,Player A
5478,JointPQPlayer,291,196,487,35,16,Player A
5479,JointPQPlayer,297,197,494,33,13,Player A
5480,JointPQPlayer,283,198,481,35,18,Player A
5481,JointPQPlayer,210,235,445,20,25,JointPQPlayer
5482,JointPQPlayer,151,261,412,11,33,JointPQPlayer
5483,JointPQPlayer,135,265,400,11,37,JointPQPlayer
5484,JointPQPlayer,265,215,480,25,15,Player A
5485,JointPQPlayer,247,212,459,31,24,Player A
5486,JointPQPlayer,276,201,477,34,19,Player A
5487,JointPQPlayer,118,268,386,12,42,JointPQPlayer
5488,JointPQPlayer,135,265,400,11,37,JointPQPlayer
5489,JointPQPlayer,287,197,484,35,17,Player A
5490,JointPQPlayer,305,185,490,41,17,Player A
5491,JointPQPlayer,288,198,486,34,16,Player A
5492,JointPQPlayer,299,199,498,31,11,Player A
5493,JointPQPlayer,308,193,501,34,11,Player A
5494,JointPQPlayer,291,196,487,35,16,Player A
5495,JointPQPlayer,316,186,502,38,12,Player A
5496,JointPQPlayer,299,194,493,35,14,Player A
5497,JointPQPlayer,281,201,482,33,17,Player A
5498,JointPQPlayer,312,187,499,38,13,Player A
5499,JointPQPlayer,254,214,468,28,20,Player A
5500,JointPQPlayer,269,199,468,37,23,Player A
5501,JointPQPlayer,131,266,397,11,38,JointPQPlayer
5502,JointPQPlayer,293,193,486,37,17,Player A
5503,JointPQPlayer,149,254,403,17,38,JointPQPlayer
5504,JointPQPlayer,149,264,413,9,32,JointPQPlayer
5505,JointPQPlayer,291,206,497,27,10,Player A
5506,JointPQPlayer,147,262,409,11,34,JointPQPlayer
5507,JointPQPlayer,143,253,396,19,41,JointPQPlayer
5508,JointPQPlayer,294,194,488,36,16,Player A
5509,JointPQPlayer,143,258,401,15,38,JointPQPlayer
5510,JointPQPlayer,307,192,499,35,12,Player A
5511,JointPQPlayer,131,261,392,15,41,JointPQPlayer
5512,JointPQPlayer,314,194,508,32,8,Player A
5513,JointPQPlayer,305,190,495,37,14,Player A
5514,JointPQPlayer,132,267,399,10,37,JointPQPlayer
5515,JointPQPlayer,275,205,480,31,17,Player A
5516,JointPQPlayer,263,208,471,31,20,Player A
5517,JointPQPlayer,151,256,407,15,36,JointPQPlayer
5518,JointPQPlayer,262,217,479,24,15,Player A
5519,JointPQPlayer,278,198,476,36,20,Player A
5520,JointPQPlayer,313,188,501,37,12,Player A
5521,JointPQPlayer,265,205,470,33,21,Player A
5522,JointPQPlayer,291,196,487,35,16,Player A
5523,JointPQPlayer,301,191,492,37,15,Player A
5524,JointPQPlayer,296,196,492,34,14,Player A
5525,JointPQPlayer,144,264,408,10,34,JointPQPlayer
5526,JointPQPlayer,306,186,492,40,16,Player A
5527,JointPQPlayer,278,203,481,32,17,Player A
5528,JointPQPlayer,242,222,464,24,20,Player A
5529,JointPQPlayer,305,195,500,33,11,Player A
5530,JointPQPlayer,177,247,424,17,31,JointPQPlayer
5531,JointPQPlayer,298,193,491,36,15,Player A
5532,JointPQPlayer,307,192,499,35,12,Player A
5533,JointPQPlayer,302,197,499,32,11,Player A
5534,JointPQPlayer,166,256,422,12,30,JointPQPlayer
5535,JointPQPlayer,293,193,486,37,17,Player A
5536,JointPQPlayer,293,198,491,33,14,Player A
5537,JointPQPlayer,260,210,470,30,20,Player A
5538,JointPQPlayer,294,194,488,36,16,Player A
5539,JointPQPlayer,307,187,494,39,15,Player A
5540,JointPQPlayer,275,195,470,39,23,Player A
5541,JointPQPlayer,276,206,482,30,16,Player A
5542,JointPQPlayer,290,195,485,36,17,Player A
5543,JointPQPlayer,273,208,481,29,16,Player A
5544,JointPQPlayer,279,209,488,27,13,Player A
5545,JointPQPlayer,276,206,482,30,16,Player A
5546,JointPQPlayer,262,212,474,28,18,Player A
5547,JointPQPlayer,322,187,509,36,9,Player A
5548,JointPQPlayer,297,197,494,33,13,Player A
5549,JointPQPlayer,285,205,490,29,13,Player A
5550,JointPQPlayer,285,195,480,37,19,Player A
5551,JointPQPlayer,297,197,494,33,13,Player A
5552,JointPQPlayer,296,196,492,34,14,Player A
5553,JointPQPlayer,252,212,464,30,22,Player A
5554,JointPQPlayer,302,197,499,32,11,Player A
5555,JointPQPlayer,330,185,515,36,7,Player A
5556,JointPQPlayer,114,274,388,8,40,JointPQPlayer
5557,JointPQPlayer,296,196,492,34,14,Player A
5558,JointPQPlayer,301,191,492,37,15,Player A
5559,JointPQPlayer,293,193,486,37,17,Player A
5560,JointPQPlayer,231,221,452,27,25,Player A
5561,JointPQPlayer,124,264,388,14,42,JointPQPlayer
5562,JointPQPlayer,249,209,458,33,25,Player A
5563,JointPQPlayer,310,195,505,32,9,Player A
5564,JointPQPlayer,290,195,485,36,17,Player A
5565,JointPQPlayer,213,228,441,25,28,JointPQPlayer
5566,JointPQPlayer,289,204,493,29,12,Player A
5567,JointPQPlayer,288,198,486,34,16,Player A
5568,JointPQPlayer,145,260,405,13,36,JointPQPlayer
5569,JointPQPlayer,295,190,485,39,18,Player A
5570,JointPQPlayer,300,190,490,38,16,Player A
5571,JointPQPlayer,159,254,413,15,34,JointPQPlayer
5572,JointPQPlayer,150,255,405,16,37,JointPQPlayer
5573,JointPQPlayer,276,201,477,34,19,Player A
5574,JointPQPlayer,282,202,484,32,16,Player A
5575,JointPQPlayer,170,255,425,12,29,JointPQPlayer
5576,JointPQPlayer,301,186,487,41,18,Player A
5577,JointPQPlayer,157,257,414,13,33,JointPQPlayer
5578,JointPQPlayer,318,183,501,40,13,Player A
5579,JointPQPlayer,285,190,475,41,22,Player A
5580,JointPQPlayer,278,203,481,32,17,Player A
5581,JointPQPlayer,292,192,484,38,18,Player A
5582,JointPQPlayer,135,260,395,15,40,JointPQPlayer
5583,JointPQPlayer,294,194,488,36,16,Player A
5584,JointPQPlayer,158,258,416,12,32,JointPQPlayer
5585,JointPQPlayer,322,187,509,36,9,Player A
5586,JointPQPlayer,274,204,478,32,18,Player A
5587,JointPQPlayer,291,201,492,31,13,Player A
5588,JointPQPlayer,133,263,396,13,39,JointPQPlayer
5589,JointPQPlayer,325,180,505,41,12,Player A
5590,JointPQPlayer,339,179,518,39,7,Player A
5591,JointPQPlayer,301,196,497,33,12,Player A
5592,JointPQPlayer,323,188,511,35,8,Player A
5593,JointPQPlayer,285,200,485,33,16,Player A
5594,JointPQPlayer,306,191,497,36,13,Player A
5595,JointPQPlayer,286,196,482,36,18,Player A
5596,JointPQPlayer,155,250,405,19,38,JointPQPlayer
5597,JointPQPlayer,250,210,460,32,24,Player A
5598,JointPQPlayer,157,252,409,17,36,JointPQPlayer
5599,JointPQPlayer,294,194,488,36,16,Player A
5600,JointPQPlayer,319,189,508,35,9,Player A
5601,JointPQPlayer,163,253,416,15,33,JointPQPlayer
5602,JointPQPlayer,136,266,402,10,36,JointPQPlayer
5603,JointPQPlayer,140,255,395,18,41,JointPQPlayer
5604,JointPQPlayer,273,203,476,33,19,Player A
5605,JointPQPlayer,142,262,404,12,36,JointPQPlayer
5606,JointPQPlayer,131,266,397,11,38,JointPQPlayer
5607,JointPQPlayer,297,192,489,37,16,Player A
5608,JointPQPlayer,275,200,475,35,20,Player A
5609,JointPQPlayer,276,206,482,30,16,Player A
5610,JointPQPlayer,329,184,513,37,8,Player A
5611,JointPQPlayer,311,191,502,35,11,Player A
5612,JointPQPlayer,285,200,485,33,16,Player A
5613,JointPQPlayer,160,255,415,14,33,JointPQPlayer
5614,JointPQPlayer,302,192,494,36,14,Player A
5615,JointPQPlayer,313,188,501,37,12,Player A
5616,JointPQPlayer,315,190,505,35,10,Player A
5617,JointPQPlayer,279,204,483,31,16,Player A
5618,JointPQPlayer,285,200,485,33,16,Player A
5619,JointPQPlayer,320,185,505,38,11,Player A
5620,JointPQPlayer,313,188,501,37,12,Player A
5621,JointPQPlayer,293,193,486,37,17,Player A
5622,JointPQPlayer,120,265,385,14,43,JointPQPlayer
5623,JointPQPlayer,128,263,391,14,41,JointPQPlayer
5624,JointPQPlayer,314,189,503,36,11,Player A
5625,JointPQPlayer,264,204,468,34,22,Player A
5626,JointPQPlayer,143,263,406,11,35,JointPQPlayer
5627,JointPQPlayer,137,262,399,13,38,JointPQPlayer
5628,JointPQPlayer,280,195,475,38,21,Player A
5629,JointPQPlayer,277,202,479,33,18,Player A
5630,JointPQPlayer,275,200,475,35,20,Player A
5631,JointPQPlayer,125,270,395,9,38,JointPQPlayer
5632,JointPQPlayer,292,192,484,38,18,Player A
5633,JointPQPlayer,311,191,502,35,11,Player A
5634,JointPQPlayer,274,204,478,32,18,Player A
5635,JointPQPlayer,132,262,394,14,40,JointPQPlayer
5636,JointPQPlayer,146,261,407,12,35,JointPQPlayer
5637,JointPQPlayer,149,254,403,17,38,JointPQPlayer
5638,JointPQPlayer,285,195,480,37,19,Player A
5639,JointPQPlayer,298,193,491,36,15,Player A
5640,JointPQPlayer,286,201,487,32,15,Player A
5641,JointPQPlayer,140,265,405,10,35,JointPQPlayer
5642,JointPQPlayer,290,195,485,36,17,Player A
5643,JointPQPlayer,282,202,484,32,16,Player A
5644,JointPQPlayer,327,182,509,39,10,Player A
5645,JointPQPlayer,303,193,496,35,13,Player A
5646,JointPQPlayer,159,254,413,15,34,JointPQPlayer
5647,JointPQPlayer,261,206,467,33,22,Player A
5648,JointPQPlayer,307,192,499,35,12,Player A
5649,JointPQPlayer,302,197,499,32,11,Player A
5650,JointPQPlayer,324,179,503,42,13,Player A
5651,JointPQPlayer,137,257,394,17,41,JointPQPlayer
5652,JointPQPlayer,301,191,492,37,15,Player A
5653,JointPQPlayer,141,266,407,9,34,JointPQPlayer
5654,JointPQPlayer,280,205,485,30,15,Player A
5655,JointPQPlayer,291,196,487,35,16,Player A
5656,JointPQPlayer,311,186,497,39,14,Player A
5657,JointPQPlayer,287,197,484,35,17,Player A
5658,JointPQPlayer,171,251,422,15,31,JointPQPlayer
5659,JointPQPlayer,127,272,399,7,36,JointPQPlayer
5660,JointPQPlayer,137,267,404,9,35,JointPQPlayer
5661,JointPQPlayer,324,179,503,42,13,Player A
5662,JointPQPlayer,332,182,514,38,8,Player A
5663,JointPQPlayer,313,193,506,33,9,Player A
5664,JointPQPlayer,283,198,481,35,18,Player A
5665,JointPQPlayer,147,257,404,15,37,JointPQPlayer
5666,JointPQPlayer,286,196,482,36,18,Player A
5667,JointPQPlayer,156,256,412,14,34,JointPQPlayer
5668,JointPQPlayer,132,267,399,10,37,JointPQPlayer
5669,JointPQPlayer,267,207,474,31,19,Player A
5670,JointPQPlayer,321,186,507,37,10,Player A
5671,JointPQPlayer,278,198,476,36,20,Player A
5672,JointPQPlayer,147,262,409,11,34,JointPQPlayer
5673,JointPQPlayer,279,204,483,31,16,Player A
5674,JointPQPlayer,159,249,408,19,37,JointPQPlayer
5675,JointPQPlayer,293,198,491,33,14,Player A
5676,JointPQPlayer,307,192,499,35,12,Player A
5677,JointPQPlayer,279,204,483,31,16,Player A
5678,JointPQPlayer,344,179,523,38,5,Player A
5679,JointPQPlayer,125,265,390,13,41,JointPQPlayer
5680,JointPQPlayer,149,259,408,13,35,JointPQPlayer
5681,JointPQPlayer,299,194,493,35,14,Player A
5682,JointPQPlayer,291,196,487,35,16,Player A
5683,JointPQPlayer,273,198,471,37,22,Player A
5684,JointPQPlayer,295,200,495,31,12,Player A
5685,JointPQPlayer,276,201,477,34,19,Player A
5686,JointPQPlayer,304,199,503,30,9,Player A
5687,JointPQPlayer,286,201,487,32,15,Player A
5688,JointPQPlayer,149,259,408,13,35,JointPQPlayer
5689,JointPQPlayer,143,263,406,11,35,JointPQPlayer
5690,JointPQPlayer,276,206,482,30,16,Player A
5691,JointPQPlayer,275,200,475,35,20,Player A
5692,JointPQPlayer,300,200,500,30,10,Player A
5693,JointPQPlayer,305,195,500,33,11,Player A
5694,JointPQPlayer,297,197,494,33,13,Player A
5695,JointPQPlayer,147,257,404,15,37,JointPQPlayer
5696,JointPQPlayer,275,200,475,35,20,Player A
5697,JointPQPlayer,284,199,483,34,17,Player A
5698,JointPQPlayer,304,189,493,38,15,Player A
5699,JointPQPlayer,222,227,449,24,25,JointPQPlayer
5700,JointPQPlayer,150,255,405,16,37,JointPQPlayer
5701,JointPQPlayer,272,207,479,30,17,Player A
5702,JointPQPlayer,303,188,491,39,16,Player A
5703,JointPQPlayer,234,224,458,24,22,Player A
5704,JointPQPlayer,294,189,483,40,19,Player A
5705,JointPQPlayer,188,238,426,22,32,JointPQPlayer
5706,JointPQPlayer,288,198,486,34,16,Player A
5707,JointPQPlayer,148,258,406,14,36,JointPQPlayer
5708,JointPQPlayer,212,232,444,22,26,JointPQPlayer
5709,JointPQPlayer,296,191,487,38,17,Player A
5710,JointPQPlayer,294,194,488,36,16,Player A
5711,JointPQPlayer,303,188,491,39,16,Player A
5712,JointPQPlayer,284,194,478,38,20,Player A
5713,JointPQPlayer,155,255,410,15,35,JointPQPlayer
5714,JointPQPlayer,269,204,473,33,20,Player A
5715,JointPQPlayer,145,265,410,9,33,JointPQPlayer
5716,JointPQPlayer,223,228,451,23,24,JointPQPlayer
5717,JointPQPlayer,332,177,509,42,11,Player A
5718,JointPQPlayer,150,255,405,16,37,JointPQPlayer
5719,JointPQPlayer,282,202,484,32,16,Player A
5720,JointPQPlayer,142,262,404,12,36,JointPQPlayer
5721,JointPQPlayer,307,192,499,35,12,Player A
5722,JointPQPlayer,293,198,491,33,14,Player A
5723,JointPQPlayer,306,191,497,36,13,Player A
5724,JointPQPlayer,136,261,397,14,39,JointPQPlayer
5725,JointPQPlayer,172,252,424,14,30,JointPQPlayer
5726,JointPQPlayer,287,197,484,35,17,Player A
5727,JointPQPlayer,256,206,462,34,24,Player A
5728,JointPQPlayer,142,262,404,12,36,JointPQPlayer
5729,JointPQPlayer,291,196,487,35,16,Player A
5730,JointPQPlayer,124,269,393,10,39,JointPQPlayer
5731,JointPQPlayer,316,186,502,38,12,Player A
5732,JointPQPlayer,266,206,472,32,20,Player A
5733,JointPQPlayer,286,196,482,36,18,Player A
5734,JointPQPlayer,292,192,484,38,18,Player A
5735,JointPQPlayer,146,261,407,12,35,JointPQPlayer
5736,JointPQPlayer,284,204,488,30,14,Player A
5737,JointPQPlayer,315,185,500,39,13,Player A
5738,JointPQPlayer,276,206,482,30,16,Player A
5739,JointPQPlayer,325,185,510,37,9,Player A
5740,JointPQPlayer,309,194,503,33,10,Player A
5741,JointPQPlayer,298,198,496,32,12,Player A
5742,JointPQPlayer,295,190,485,39,18,Player A
5743,JointPQPlayer,280,200,480,34,18,Player A
5744,JointPQPlayer,248,218,466,26,20,Player A
5745,JointPQPlayer,160,250,410,18,36,JointPQPlayer
5746,JointPQPlayer,279,199,478,35,19,Player A
5747,JointPQPlayer,271,206,477,31,18,Player A
5748,JointPQPlayer,308,188,496,38,14,Player A
5749,JointPQPlayer,150,260,410,12,34,JointPQPlayer
5750,JointPQPlayer,131,266,397,11,38,JointPQPlayer
5751,JointPQPlayer,306,186,492,40,16,Player A
5752,JointPQPlayer,314,189,503,36,11,Player A
5753,JointPQPlayer,297,192,489,37,16,Player A
5754,JointPQPlayer,290,200,490,32,14,Player A
5755,JointPQPlayer,269,199,468,37,23,Player A
5756,JointPQPlayer,313,198,511,29,6,Player A
5757,JointPQPlayer,146,256,402,16,38,JointPQPlayer
5758,JointPQPlayer,226,226,452,24,24,Tie
5759,JointPQPlayer,306,186,492,40,16,Player A
5760,JointPQPlayer,240,220,460,26,22,Player A
5761,JointPQPlayer,331,181,512,39,9,Player A
5762,JointPQPlayer,159,254,413,15,34,JointPQPlayer
5763,JointPQPlayer,270,200,470,36,22,Player A
5764,JointPQPlayer,308,188,496,38,14,Player A
5765,JointPQPlayer,302,192,494,36,14,Player A
5766,JointPQPlayer,268,203,471,34,21,Player A
5767,JointPQPlayer,270,205,475,32,19,Player A
5768,JointPQPlayer,152,257,409,14,35,JointPQPlayer
5769,JointPQPlayer,297,197,494,33,13,Player A
5770,JointPQPlayer,311,186,497,39,14,Player A
5771,JointPQPlayer,293,198,491,33,14,Player A
5772,JointPQPlayer,281,206,487,29,14,Player A
5773,JointPQPlayer,307,192,499,35,12,Player A
5774,JointPQPlayer,305,185,490,41,17,Player A
5775,JointPQPlayer,311,186,497,39,14,Player A
5776,JointPQPlayer,288,198,486,34,16,Player A
5777,JointPQPlayer,253,213,466,29,21,Player A
5778,JointPQPlayer,286,196,482,36,18,Player A
5779,JointPQPlayer,245,215,460,29,23,Player A
5780,JointPQPlayer,262,207,469,32,21,Player A
5781,JointPQPlayer,291,201,492,31,13,Player A
5782,JointPQPlayer,165,250,415,17,34,JointPQPlayer
5783,JointPQPlayer,269,199,468,37,23,Player A
5784,JointPQPlayer,267,212,479,27,16,Player A
5785,JointPQPlayer,152,252,404,18,38,JointPQPlayer
5786,JointPQPlayer,278,198,476,36,20,Player A
5787,JointPQPlayer,292,192,484,38,18,Player A
5788,JointPQPlayer,294,199,493,32,13,Player A
5789,JointPQPlayer,298,193,491,36,15,Player A
5790,JointPQPlayer,268,203,471,34,21,Player A
5791,JointPQPlayer,285,205,490,29,13,Player A
5792,JointPQPlayer,141,261,402,13,37,JointPQPlayer
5793,JointPQPlayer,266,201,467,36,23,Player A
5794,JointPQPlayer,266,206,472,32,20,Player A
5795,JointPQPlayer,281,196,477,37,20,Player A
5796,JointPQPlayer,310,185,495,40,15,Player A
5797,JointPQPlayer,264,204,468,34,22,Player A
5798,JointPQPlayer,287,197,484,35,17,Player A
5799,JointPQPlayer,265,205,470,33,21,Player A
5800,JointPQPlayer,298,193,491,36,15,Player A
5801,JointPQPlayer,297,192,489,37,16,Player A
5802,JointPQPlayer,226,226,452,24,24,Tie
5803,JointPQPlayer,262,212,474,28,18,Player A
5804,JointPQPlayer,165,260,425,9,28,JointPQPlayer
5805,JointPQPlayer,229,219,448,29,27,Player A
5806,JointPQPlayer,172,247,419,18,33,JointPQPlayer
5807,JointPQPlayer,320,185,505,38,11,Player A
5808,JointPQPlayer,297,192,489,37,16,Player A
5809,JointPQPlayer,302,192,494,36,14,Player A
5810,JointPQPlayer,296,196,492,34,14,Player A
5811,JointPQPlayer,261,211,472,29,19,Player A
5812,JointPQPlayer,309,189,498,37,13,Player A
5813,JointPQPlayer,195,235,430,23,31,JointPQPlayer
5814,JointPQPlayer,296,196,492,34,14,Player A
5815,JointPQPlayer,265,205,470,33,21,Player A
5816,JointPQPlayer,301,191,492,37,15,Player A
5817,JointPQPlayer,296,196,492,34,14,Player A
5818,JointPQPlayer,308,193,501,34,11,Player A
5819,JointPQPlayer,319,189,508,35,9,Player A
5820,JointPQPlayer,297,192,489,37,16,Player A
5821,JointPQPlayer,313,188,501,37,12,Player A
5822,JointPQPlayer,293,193,486,37,17,Player A
5823,JointPQPlayer,170,250,420,16,32,JointPQPlayer
5824,JointPQPlayer,118,268,386,12,42,JointPQPlayer
5825,JointPQPlayer,289,204,493,29,12,Player A
5826,JointPQPlayer,320,185,505,38,11,Player A
5827,JointPQPlayer,277,197,474,37,21,Player A
5828,JointPQPlayer,304,194,498,34,12,Player A
5829,JointPQPlayer,229,224,453,25,24,Player A
5830,JointPQPlayer,265,205,470,33,21,Player A
5831,JointPQPlayer,290,195,485,36,17,Player A
5832,JointPQPlayer,299,194,493,35,14,Player A
5833,JointPQPlayer,151,256,407,15,36,JointPQPlayer
5834,JointPQPlayer,290,195,485,36,17,Player A
5835,JointPQPlayer,309,184,493,41,16,Player A
5836,JointPQPlayer,290,200,490,32,14,Player A
5837,JointPQPlayer,296,191,487,38,17,Player A
5838,JointPQPlayer,287,197,484,35,17,Player A
5839,JointPQPlayer,287,207,494,27,11,Player A
5840,JointPQPlayer,159,249,408,19,37,JointPQPlayer
5841,JointPQPlayer,265,200,465,37,24,Player A
5842,JointPQPlayer,301,191,492,37,15,Player A
5843,JointPQPlayer,266,211,477,28,17,Player A
5844,JointPQPlayer,320,185,505,38,11,Player A
5845,JointPQPlayer,275,200,475,35,20,Player A
5846,JointPQPlayer,252,217,469,26,19,Player A
5847,JointPQPlayer,284,199,483,34,17,Player A
5848,JointPQPlayer,284,199,483,34,17,Player A
5849,JointPQPlayer,147,257,404,15,37,JointPQPlayer
5850,JointPQPlayer,293,198,491,33,14,Player A
5851,JointPQPlayer,203,233,436,23,29,JointPQPlayer
5852,JointPQPlayer,283,198,481,35,18,Player A
5853,JointPQPlayer,170,245,415,20,35,JointPQPlayer
5854,JointPQPlayer,276,206,482,30,16,Player A
5855,JointPQPlayer,283,208,491,27,12,Player A
5856,JointPQPlayer,315,185,500,39,13,Player A
5857,JointPQPlayer,340,180,520,38,6,Player A
5858,JointPQPlayer,143,253,396,19,41,JointPQPlayer
5859,JointPQPlayer,114,269,383,12,43,JointPQPlayer
5860,JointPQPlayer,275,205,480,31,17,Player A
5861,JointPQPlayer,251,211,462,31,23,Player A
5862,JointPQPlayer,255,210,465,31,22,Player A
5863,JointPQPlayer,312,187,499,38,13,Player A
5864,JointPQPlayer,285,205,490,29,13,Player A
5865,JointPQPlayer,206,236,442,20,26,JointPQPlayer
5866,JointPQPlayer,158,253,411,16,35,JointPQPlayer
5867,JointPQPlayer,122,267,389,12,41,JointPQPlayer
5868,JointPQPlayer,305,195,500,33,11,Player A
5869,JointPQPlayer,291,196,487,35,16,Player A
5870,JointPQPlayer,326,181,507,40,11,Player A
5871,JointPQPlayer,309,189,498,37,13,Player A
5872,JointPQPlayer,284,199,483,34,17,Player A
5873,JointPQPlayer,150,260,410,12,34,JointPQPlayer
5874,JointPQPlayer,282,202,484,32,16,Player A
5875,JointPQPlayer,288,198,486,34,16,Player A
5876,JointPQPlayer,304,184,488,42,18,Player A
5877,JointPQPlayer,271,201,472,35,21,Player A
5878,JointPQPlayer,120,270,390,10,40,JointPQPlayer
5879,JointPQPlayer,315,185,500,39,13,Player A
5880,JointPQPlayer,165,260,425,9,28,JointPQPlayer
5881,JointPQPlayer,297,197,494,33,13,Player A
5882,JointPQPlayer,294,194,488,36,16,Player A
5883,JointPQPlayer,123,268,391,11,40,JointPQPlayer
5884,JointPQPlayer,273,203,476,33,19,Player A
5885,JointPQPlayer,279,204,483,31,16,Player A
5886,JointPQPlayer,314,184,498,40,14,Player A
5887,JointPQPlayer,285,200,485,33,16,Player A
5888,JointPQPlayer,249,214,463,29,22,Player A
5889,JointPQPlayer,245,220,465,25,20,Player A
5890,JointPQPlayer,254,214,468,28,20,Player A
5891,JointPQPlayer,232,222,454,26,24,Player A
5892,JointPQPlayer,254,209,463,32,23,Player A
5893,JointPQPlayer,145,260,405,13,36,JointPQPlayer
5894,JointPQPlayer,291,201,492,31,13,Player A
5895,JointPQPlayer,135,270,405,7,34,JointPQPlayer
5896,JointPQPlayer,290,195,485,36,17,Player A
5897,JointPQPlayer,318,183,501,40,13,Player A
5898,JointPQPlayer,265,210,475,29,18,Player A
5899,JointPQPlayer,286,206,492,28,12,Player A
5900,JointPQPlayer,307,187,494,39,15,Player A
5901,JointPQPlayer,130,265,395,12,39,JointPQPlayer
5902,JointPQPlayer,278,198,476,36,20,Player A
5903,JointPQPlayer,301,191,492,37,15,Player A
5904,JointPQPlayer,270,210,480,28,16,Player A
5905,JointPQPlayer,299,199,498,31,11,Player A
5906,JointPQPlayer,311,186,497,39,14,Player A
5907,JointPQPlayer,287,192,479,39,20,Player A
5908,JointPQPlayer,311,186,497,39,14,Player A
5909,JointPQPlayer,280,205,485,30,15,Player A
5910,JointPQPlayer,308,193,501,34,11,Player A
5911,JointPQPlayer,164,249,413,18,35,JointPQPlayer
5912,JointPQPlayer,129,269,398,9,37,JointPQPlayer
5913,JointPQPlayer,302,187,489,40,17,Player A
5914,JointPQPlayer,279,199,478,35,19,Player A
5915,JointPQPlayer,151,256,407,15,36,JointPQPlayer
5916,JointPQPlayer,281,201,482,33,17,Player A
5917,JointPQPlayer,304,189,493,38,15,Player A
5918,JointPQPlayer,310,185,495,40,15,Player A
5919,JointPQPlayer,149,259,408,13,35,JointPQPlayer
5920,JointPQPlayer,232,227,459,22,21,Player A
5921,JointPQPlayer,171,246,417,19,34,JointPQPlayer
5922,JointPQPlayer,264,209,473,30,19,Player A
5923,JointPQPlayer,293,198,491,33,14,Player A
5924,JointPQPlayer,298,193,491,36,15,Player A
5925,JointPQPlayer,288,198,486,34,16,Player A
5926,JointPQPlayer,290,200,490,32,14,Player A
5927,JointPQPlayer,280,200,480,34,18,Player A
5928,JointPQPlayer,308,193,501,34,11,Player A
5929,JointPQPlayer,306,191,497,36,13,Player A
5930,JointPQPlayer,152,257,409,14,35,JointPQPlayer
5931,JointPQPlayer,277,207,484,29,15,Player A
5932,JointPQPlayer,142,262,404,12,36,JointPQPlayer
5933,JointPQPlayer,266,211,477,28,17,Player A
5934,JointPQPlayer,288,203,491,30,13,Player A
5935,JointPQPlayer,330,180,510,40,10,Player A
5936,JointPQPlayer,289,199,488,33,15,Player A
5937,JointPQPlayer,271,206,477,31,18,Player A
5938,JointPQPlayer,153,253,406,17,37,JointPQPlayer
5939,JointPQPlayer,134,264,398,12,38,JointPQPlayer
5940,JointPQPlayer,311,186,497,39,14,Player A
5941,JointPQPlayer,310,185,495,40,15,Player A
5942,JointPQPlayer,312,187,499,38,13,Player A
5943,JointPQPlayer,262,207,469,32,21,Player A
5944,JointPQPlayer,145,255,400,17,39,JointPQPlayer
5945,JointPQPlayer,262,212,474,28,18,Player A
5946,JointPQPlayer,280,205,485,30,15,Player A
5947,JointPQPlayer,154,254,408,16,36,JointPQPlayer
5948,JointPQPlayer,284,194,478,38,20,Player A
5949,JointPQPlayer,276,206,482,30,16,Player A
5950,JointPQPlayer,296,196,492,34,14,Player A
5951,JointPQPlayer,136,261,397,14,39,JointPQPlayer
5952,JointPQPlayer,289,199,488,33,15,Player A
5953,JointPQPlayer,327,177,504,43,13,Player A
5954,JointPQPlayer,281,196,477,37,20,Player A
5955,JointPQPlayer,308,188,496,38,14,Player A
5956,JointPQPlayer,303,193,496,35,13,Player A
5957,JointPQPlayer,264,209,473,30,19,Player A
5958,JointPQPlayer,289,204,493,29,12,Player A
5959,JointPQPlayer,275,200,475,35,20,Player A
5960,JointPQPlayer,311,191,502,35,11,Player A
5961,JointPQPlayer,271,206,477,31,18,Player A
5962,JointPQPlayer,269,204,473,33,20,Player A
5963,JointPQPlayer,300,195,495,34,13,Player A
5964,JointPQPlayer,312,187,499,38,13,Player A
5965,JointPQPlayer,282,202,484,32,16,Player A
5966,JointPQPlayer,302,192,494,36,14,Player A
5967,JointPQPlayer,246,216,462,28,22,Player A
5968,JointPQPlayer,266,206,472,32,20,Player A
5969,JointPQPlayer,296,196,492,34,14,Player A
5970,JointPQPlayer,309,189,498,37,13,Player A
5971,JointPQPlayer,164,259,423,10,29,JointPQPlayer
5972,JointPQPlayer,323,183,506,39,11,Player A
5973,JointPQPlayer,276,201,477,34,19,Player A
5974,JointPQPlayer,274,204,478,32,18,Player A
5975,JointPQPlayer,294,199,493,32,13,Player A
5976,JointPQPlayer,293,198,491,33,14,Player A
5977,JointPQPlayer,145,260,405,13,36,JointPQPlayer
5978,JointPQPlayer,290,200,490,32,14,Player A
5979,JointPQPlayer,210,235,445,20,25,JointPQPlayer
5980,JointPQPlayer,149,254,403,17,38,JointPQPlayer
5981,JointPQPlayer,292,197,489,34,15,Player A
5982,JointPQPlayer,282,202,484,32,16,Player A
5983,JointPQPlayer,285,195,480,37,19,Player A
5984,JointPQPlayer,324,184,508,38,10,Player A
5985,JointPQPlayer,257,212,469,29,20,Player A
5986,JointPQPlayer,261,211,472,29,19,Player A
5987,JointPQPlayer,292,192,484,38,18,Player A
5988,JointPQPlayer,276,196,472,38,22,Player A
5989,JointPQPlayer,266,211,477,28,17,Player A
5990,JointPQPlayer,239,214,453,31,26,Player A
5991,JointPQPlayer,304,194,498,34,12,Player A
5992,JointPQPlayer,289,194,483,37,18,Player A
5993,JointPQPlayer,282,202,484,32,16,Player A
5994,JointPQPlayer,315,185,500,39,13,Player A
5995,JointPQPlayer,311,186,497,39,14,Player A
5996,JointPQPlayer,296,191,487,38,17,Player A
5997,JointPQPlayer,294,194,488,36,16,Player A
5998,JointPQPlayer,310,185,495,40,15,Player A
5999,JointPQPlayer,289,189,478,41,21,Player A
6000,JointPQPlayer,310,190,500,36,12,Player A
6001,JointPQPlayer,277,202,479,33,18,Player A
6002,JointPQPlayer,315,185,500,39,13,Player A
6003,JointPQPlayer,310,190,500,36,12,Player A
6004,JointPQPlayer,303,193,496,35,13,Player A
6005,JointPQPlayer,270,205,475,32,19,Player A
6006,JointPQPlayer,317,187,504,37,11,Player A
6007,JointPQPlayer,300,190,490,38,16,Player A
6008,JointPQPlayer,286,201,487,32,15,Player A
6009,JointPQPlayer,302,197,499,32,11,Player A
6010,JointPQPlayer,254,209,463,32,23,Player A
6011,JointPQPlayer,313,188,501,37,12,Player A
6012,JointPQPlayer,139,264,403,11,36,JointPQPlayer
6013,JointPQPlayer,310,185,495,40,15,Player A
6014,JointPQPlayer,173,248,421,17,32,JointPQPlayer
6015,JointPQPlayer,284,199,483,34,17,Player A
6016,JointPQPlayer,284,199,483,34,17,Player A
6017,JointPQPlayer,264,209,473,30,19,Player A
6018,JointPQPlayer,259,209,468,31,21,Player A
6019,JointPQPlayer,291,201,492,31,13,Player A
6020,JointPQPlayer,311,191,502,35,11,Player A
6021,JointPQPlayer,283,198,481,35,18,Player A
6022,JointPQPlayer,298,193,491,36,15,Player A
6023,JointPQPlayer,145,260,405,13,36,JointPQPlayer
6024,JointPQPlayer,294,199,493,32,13,Player A
6025,JointPQPlayer,273,208,481,29,16,Player A
6026,JointPQPlayer,292,197,489,34,15,Player A
6027,JointPQPlayer,269,209,478,29,17,Player A
6028,JointPQPlayer,220,230,450,22,24,JointPQPlayer
6029,JointPQPlayer,135,260,395,15,40,JointPQPlayer
6030,JointPQPlayer,140,260,400,14,38,JointPQPlayer
6031,JointPQPlayer,298,193,491,36,15,Player A
6032,JointPQPlayer,256,211,467,30,21,Player A
6033,JointPQPlayer,299,194,493,35,14,Player A
6034,JointPQPlayer,291,196,487,35,16,Player A
6035,JointPQPlayer,166,251,417,16,33,JointPQPlayer
6036,JointPQPlayer,146,261,407,12,35,JointPQPlayer
6037,JointPQPlayer,154,254,408,16,36,JointPQPlayer
6038,JointPQPlayer,281,206,487,29,14,Player A
6039,JointPQPlayer,130,260,390,16,42,JointPQPlayer
6040,JointPQPlayer,320,180,500,42,14,Player A
6041,JointPQPlayer,140,270,410,6,32,JointPQPlayer
6042,JointPQPlayer,177,247,424,17,31,JointPQPlayer
6043,JointPQPlayer,154,254,408,16,36,JointPQPlayer
6044,JointPQPlayer,146,266,412,8,32,JointPQPlayer
6045,JointPQPlayer,306,196,502,32,10,Player A
6046,JointPQPlayer,139,259,398,15,39,JointPQPlayer
6047,JointPQPlayer,307,187,494,39,15,Player A
6048,JointPQPlayer,286,196,482,36,18,Player A
6049,JointPQPlayer,207,232,439,23,28,JointPQPlayer
6050,JointPQPlayer,304,194,498,34,12,Player A
6051,JointPQPlayer,304,194,498,34,12,Player A
6052,JointPQPlayer,297,192,489,37,16,Player A
6053,JointPQPlayer,126,266,392,12,40,JointPQPlayer
6054,JointPQPlayer,295,190,485,39,18,Player A
6055,JointPQPlayer,274,199,473,36,21,Player A
6056,JointPQPlayer,269,204,473,33,20,Player A
6057,JointPQPlayer,286,201,487,32,15,Player A
6058,JointPQPlayer,288,203,491,30,13,Player A
6059,JointPQPlayer,271,201,472,35,21,Player A
6060,JointPQPlayer,254,214,468,28,20,Player A
6061,JointPQPlayer,288,198,486,34,16,Player A
6062,JointPQPlayer,292,192,484,38,18,Player A
6063,JointPQPlayer,121,266,387,13,42,JointPQPlayer
6064,JointPQPlayer,328,183,511,38,9,Player A
6065,JointPQPlayer,295,195,490,35,15,Player A
6066,JointPQPlayer,285,200,485,33,16,Player A
6067,JointPQPlayer,122,267,389,12,41,JointPQPlayer
6068,JointPQPlayer,303,188,491,39,16,Player A
6069,JointPQPlayer,133,268,401,9,36,JointPQPlayer
6070,JointPQPlayer,271,201,472,35,21,Player A
6071,JointPQPlayer,279,204,483,31,16,Player A
6072,JointPQPlayer,142,262,404,12,36,JointPQPlayer
6073,JointPQPlayer,135,260,395,15,40,JointPQPlayer
6074,JointPQPlayer,297,197,494,33,13,Player A
6075,JointPQPlayer,303,193,496,35,13,Player A
6076,JointPQPlayer,292,192,484,38,18,Player A
6077,JointPQPlayer,253,213,466,29,21,Player A
6078,JointPQPlayer,299,189,488,39,17,Player A
6079,JointPQPlayer,287,202,489,31,14,Player A
6080,JointPQPlayer,299,194,493,35,14,Player A
6081,JointPQPlayer,276,206,482,30,16,Player A
6082,JointPQPlayer,141,261,402,13,37,JointPQPlayer
6083,JointPQPlayer,302,197,499,32,11,Player A
6084,JointPQPlayer,302,192,494,36,14,Player A
6085,JointPQPlayer,271,206,477,31,18,Player A
6086,JointPQPlayer,287,197,484,35,17,Player A
6087,JointPQPlayer,263,208,471,31,20,Player A
6088,JointPQPlayer,269,209,478,29,17,Player A
6089,JointPQPlayer,213,233,446,21,25,JointPQPlayer
6090,JointPQPlayer,305,190,495,37,14,Player A
6091,JointPQPlayer,155,255,410,15,35,JointPQPlayer
6092,JointPQPlayer,278,203,481,32,17,Player A
6093,JointPQPlayer,242,217,459,28,23,Player A
6094,JointPQPlayer,154,249,403,20,39,JointPQPlayer
6095,JointPQPlayer,204,234,438,22,28,JointPQPlayer
6096,JointPQPlayer,306,191,497,36,13,Player A
6097,JointPQPlayer,303,188,491,39,16,Player A
6098,JointPQPlayer,285,200,485,33,16,Player A
6099,JointPQPlayer,299,194,493,35,14,Player A
6100,JointPQPlayer,290,205,495,28,11,Player A
6101,JointPQPlayer,300,195,495,34,13,Player A
6102,JointPQPlayer,297,192,489,37,16,Player A
6103,JointPQPlayer,164,244,408,22,38,JointPQPlayer
6104,JointPQPlayer,274,204,478,32,18,Player A
6105,JointPQPlayer,153,258,411,13,34,JointPQPlayer
6106,JointPQPlayer,215,230,445,23,26,JointPQPlayer
6107,JointPQPlayer,253,213,466,29,21,Player A
6108,JointPQPlayer,268,208,476,30,18,Player A
6109,JointPQPlayer,325,185,510,37,9,Player A
6110,JointPQPlayer,291,196,487,35,16,Player A
6111,JointPQPlayer,300,200,500,30,10,Player A
6112,JointPQPlayer,272,197,469,38,23,Player A
6113,JointPQPlayer,296,196,492,34,14,Player A
6114,JointPQPlayer,337,177,514,41,9,Player A
6115,JointPQPlayer,290,200,490,32,14,Player A
6116,JointPQPlayer,284,194,478,38,20,Player A
6117,JointPQPlayer,316,186,502,38,12,Player A
6118,JointPQPlayer,145,260,405,13,36,JointPQPlayer
6119,JointPQPlayer,228,223,451,26,25,Player A
6120,JointPQPlayer,284,199,483,34,17,Player A
6121,JointPQPlayer,288,203,491,30,13,Player A
6122,JointPQPlayer,239,224,463,23,20,Player A
6123,JointPQPlayer,231,226,457,23,22,Player A
6124,JointPQPlayer,140,265,405,10,35,JointPQPlayer
6125,JointPQPlayer,285,205,490,29,13,Player A
6126,JointPQPlayer,167,252,419,15,32,JointPQPlayer
6127,JointPQPlayer,299,199,498,31,11,Player A
6128,JointPQPlayer,269,204,473,33,20,Player A
6129,JointPQPlayer,135,265,400,11,37,JointPQPlayer
6130,JointPQPlayer,308,188,496,38,14,Player A
6131,JointPQPlayer,130,265,395,12,39,JointPQPlayer
6132,JointPQPlayer,268,203,471,34,21,Player A
6133,JointPQPlayer,282,202,484,32,16,Player A
6134,JointPQPlayer,133,263,396,13,39,JointPQPlayer
6135,JointPQPlayer,309,189,498,37,13,Player A
6136,JointPQPlayer,274,199,473,36,21,Player A
6137,JointPQPlayer,288,203,491,30,13,Player A
6138,JointPQPlayer,321,181,502,41,13,Player A
6139,JointPQPlayer,278,193,471,40,23,Player A
6140,JointPQPlayer,315,185,500,39,13,Player A
6141,JointPQPlayer,263,208,471,31,20,Player A
6142,JointPQPlayer,326,181,507,40,11,Player A
6143,JointPQPlayer,330,185,515,36,7,Player A
6144,JointPQPlayer,318,188,506,36,10,Player A
6145,JointPQPlayer,230,220,450,28,26,Player A
6146,JointPQPlayer,184,249,433,14,27,JointPQPlayer
6147,JointPQPlayer,255,210,465,31,22,Player A
6148,JointPQPlayer,148,253,401,18,39,JointPQPlayer
6149,JointPQPlayer,157,252,409,17,36,JointPQPlayer
6150,JointPQPlayer,241,221,462,25,21,Player A
6151,JointPQPlayer,250,210,460,32,24,Player A
6152,JointPQPlayer,295,195,490,35,15,Player A
6153,JointPQPlayer,290,195,485,36,17,Player A
6154,JointPQPlayer,249,214,463,29,22,Player A
6155,JointPQPlayer,292,192,484,38,18,Player A
6156,JointPQPlayer,136,261,397,14,39,JointPQPlayer
6157,JointPQPlayer,301,191,492,37,15,Player A
6158,JointPQPlayer,142,262,404,12,36,JointPQPlayer
6159,JointPQPlayer,302,192,494,36,14,Player A
6160,JointPQPlayer,294,199,493,32,13,Player A
6161,JointPQPlayer,278,203,481,32,17,Player A
6162,JointPQPlayer,289,199,488,33,15,Player A
6163,JointPQPlayer,305,190,495,37,14,Player A
6164,JointPQPlayer,285,200,485,33,16,Player A
6165,JointPQPlayer,261,211,472,29,19,Player A
6166,JointPQPlayer,307,187,494,39,15,Player A
6167,JointPQPlayer,309,199,508,29,7,Player A
6168,JointPQPlayer,231,221,452,27,25,Player A
6169,JointPQPlayer,154,254,408,16,36,JointPQPlayer
6170,JointPQPlayer,232,222,454,26,24,Player A
6171,JointPQPlayer,301,191,492,37,15,Player A
6172,JointPQPlayer,214,234,448,20,24,JointPQPlayer
6173,JointPQPlayer,260,210,470,30,20,Player A
6174,JointPQPlayer,290,195,485,36,17,Player A
6175,JointPQPlayer,293,193,486,37,17,Player A
6176,JointPQPlayer,247,207,454,35,27,Player A
6177,JointPQPlayer,277,202,479,33,18,Player A
6178,JointPQPlayer,301,191,492,37,15,Player A
6179,JointPQPlayer,292,197,489,34,15,Player A
6180,JointPQPlayer,281,201,482,33,17,Player A
6181,JointPQPlayer,272,207,479,30,17,Player A
6182,JointPQPlayer,308,188,496,38,14,Player A
6183,JointPQPlayer,289,199,488,33,15,Player A
6184,JointPQPlayer,315,185,500,39,13,Player A
6185,JointPQPlayer,297,192,489,37,16,Player A
6186,JointPQPlayer,300,195,495,34,13,Player A
6187,JointPQPlayer,287,192,479,39,20,Player A
6188,JointPQPlayer,279,204,483,31,16,Player A
6189,JointPQPlayer,155,255,410,15,35,JointPQPlayer
6190,JointPQPlayer,304,194,498,34,12,Player A
6191,JointPQPlayer,316,186,502,38,12,Player A
6192,JointPQPlayer,162,252,414,16,34,JointPQPlayer
6193,JointPQPlayer,263,208,471,31,20,Player A
6194,JointPQPlayer,137,267,404,9,35,JointPQPlayer
6195,JointPQPlayer,142,262,404,12,36,JointPQPlayer
6196,JointPQPlayer,306,191,497,36,13,Player A
6197,JointPQPlayer,295,195,490,35,15,Player A
6198,JointPQPlayer,171,256,427,11,28,JointPQPlayer
6199,JointPQPlayer,276,201,477,34,19,Player A
6200,JointPQPlayer,286,201,487,32,15,Player A
6201,JointPQPlayer,291,196,487,35,16,Player A
6202,JointPQPlayer,270,210,480,28,16,Player A
6203,JointPQPlayer,237,227,464,21,19,Player A
6204,JointPQPlayer,272,202,474,34,20,Player A
6205,JointPQPlayer,278,203,481,32,17,Player A
6206,JointPQPlayer,332,177,509,42,11,Player A
6207,JointPQPlayer,281,201,482,33,17,Player A
6208,JointPQPlayer,281,201,482,33,17,Player A
6209,JointPQPlayer,240,220,460,26,22,Player A
6210,JointPQPlayer,303,193,496,35,13,Player A
6211,JointPQPlayer,273,203,476,33,19,Player A
6212,JointPQPlayer,307,187,494,39,15,Player A
6213,JointPQPlayer,267,207,474,31,19,Player A
6214,JointPQPlayer,283,193,476,39,21,Player A
6215,JointPQPlayer,313,188,501,37,12,Player A
6216,JointPQPlayer,269,204,473,33,20,Player A
6217,JointPQPlayer,133,263,396,13,39,JointPQPlayer
6218,JointPQPlayer,324,184,508,38,10,Player A
6219,JointPQPlayer,131,266,397,11,38,JointPQPlayer
6220,JointPQPlayer,275,205,480,31,17,Player A
6221,JointPQPlayer,301,196,497,33,12,Player A
6222,JointPQPlayer,288,193,481,38,19,Player A
6223,JointPQPlayer,306,191,497,36,13,Player A
6224,JointPQPlayer,279,199,478,35,19,Player A
6225,JointPQPlayer,145,260,405,13,36,JointPQPlayer
6226,JointPQPlayer,276,206,482,30,16,Player A
6227,JointPQPlayer,145,260,405,13,36,JointPQPlayer
6228,JointPQPlayer,279,204,483,31,16,Player A
6229,JointPQPlayer,257,207,464,33,23,Player A
6230,JointPQPlayer,296,196,492,34,14,Player A
6231,JointPQPlayer,283,198,481,35,18,Player A
6232,JointPQPlayer,295,195,490,35,15,Player A
6233,JointPQPlayer,314,184,498,40,14,Player A
6234,JointPQPlayer,296,191,487,38,17,Player A
6235,JointPQPlayer,288,203,491,30,13,Player A
6236,JointPQPlayer,187,242,429,19,30,JointPQPlayer
6237,JointPQPlayer,244,214,458,30,24,Player A
6238,JointPQPlayer,299,194,493,35,14,Player A
6239,JointPQPlayer,260,205,465,34,23,Player A
6240,JointPQPlayer,318,183,501,40,13,Player A
6241,JointPQPlayer,276,201,477,34,19,Player A
6242,JointPQPlayer,117,272,389,9,40,JointPQPlayer
6243,JointPQPlayer,278,208,486,28,14,Player A
6244,JointPQPlayer,322,182,504,40,12,Player A
6245,JointPQPlayer,304,194,498,34,12,Player A
6246,JointPQPlayer,289,194,483,37,18,Player A
6247,JointPQPlayer,290,205,495,28,11,Player A
6248,JointPQPlayer,319,189,508,35,9,Player A
6249,JointPQPlayer,282,202,484,32,16,Player A
6250,JointPQPlayer,154,254,408,16,36,JointPQPlayer
6251,JointPQPlayer,283,198,481,35,18,Player A
6252,JointPQPlayer,135,260,395,15,40,JointPQPlayer
6253,JointPQPlayer,300,195,495,34,13,Player A
6254,JointPQPlayer,318,183,501,40,13,Player A
6255,JointPQPlayer,284,199,483,34,17,Player A
6256,JointPQPlayer,282,192,474,40,22,Player A
6257,JointPQPlayer,291,196,487,35,16,Player A
6258,JointPQPlayer,285,200,485,33,16,Player A
6259,JointPQPlayer,311,186,497,39,14,Player A
6260,JointPQPlayer,158,253,411,16,35,JointPQPlayer
6261,JointPQPlayer,317,187,504,37,11,Player A
6262,JointPQPlayer,261,206,467,33,22,Player A
6263,JointPQPlayer,299,194,493,35,14,Player A
6264,JointPQPlayer,304,189,493,38,15,Player A
6265,JointPQPlayer,286,196,482,36,18,Player A
6266,JointPQPlayer,127,267,394,11,39,JointPQPlayer
6267,JointPQPlayer,279,204,483,31,16,Player A
6268,JointPQPlayer,279,204,483,31,16,Player A
6269,JointPQPlayer,282,202,484,32,16,Player A
6270,JointPQPlayer,297,197,494,33,13,Player A
6271,JointPQPlayer,159,259,418,11,31,JointPQPlayer
6272,JointPQPlayer,251,211,462,31,23,Player A
6273,JointPQPlayer,281,201,482,33,17,Player A
6274,JointPQPlayer,161,256,417,13,32,JointPQPlayer
6275,JointPQPlayer,139,264,403,11,36,JointPQPlayer
6276,JointPQPlayer,317,187,504,37,11,Player A
6277,JointPQPlayer,267,202,469,35,22,Player A
6278,JointPQPlayer,240,220,460,26,22,Player A
6279,JointPQPlayer,299,194,493,35,14,Player A
6280,JointPQPlayer,279,199,478,35,19,Player A
6281,JointPQPlayer,319,184,503,39,12,Player A
6282,JointPQPlayer,226,221,447,28,27,Player A
6283,JointPQPlayer,314,184,498,40,14,Player A
6284,JointPQPlayer,149,259,408,13,35,JointPQPlayer
6285,JointPQPlayer,296,196,492,34,14,Player A
6286,JointPQPlayer,291,201,492,31,13,Player A
6287,JointPQPlayer,321,186,507,37,10,Player A
6288,JointPQPlayer,254,214,468,28,20,Player A
6289,JointPQPlayer,307,187,494,39,15,Player A
6290,JointPQPlayer,298,188,486,40,18,Player A
6291,JointPQPlayer,255,210,465,31,22,Player A
6292,JointPQPlayer,130,265,395,12,39,JointPQPlayer
6293,JointPQPlayer,315,190,505,35,10,Player A
6294,JointPQPlayer,254,214,468,28,20,Player A
6295,JointPQPlayer,302,192,494,36,14,Player A
6296,JointPQPlayer,147,257,404,15,37,JointPQPlayer
6297,JointPQPlayer,275,200,475,35,20,Player A
6298,JointPQPlayer,269,199,468,37,23,Player A
6299,JointPQPlayer,320,185,505,38,11,Player A
6300,JointPQPlayer,289,199,488,33,15,Player A
6301,JointPQPlayer,289,199,488,33,15,Player A
6302,JointPQPlayer,280,200,480,34,18,Player A
6303,JointPQPlayer,282,202,484,32,16,Player A
6304,JointPQPlayer,137,257,394,17,41,JointPQPlayer
6305,JointPQPlayer,286,196,482,36,18,Player A
6306,JointPQPlayer,295,190,485,39,18,Player A
6307,JointPQPlayer,320,180,500,42,14,Player A
6308,JointPQPlayer,278,198,476,36,20,Player A
6309,JointPQPlayer,286,191,477,40,21,Player A
6310,JointPQPlayer,308,193,501,34,11,Player A
6311,JointPQPlayer,145,260,405,13,36,JointPQPlayer
6312,JointPQPlayer,270,195,465,40,25,Player A
6313,JointPQPlayer,308,193,501,34,11,Player A
6314,JointPQPlayer,246,211,457,32,25,Player A
6315,JointPQPlayer,304,194,498,34,12,Player A
6316,JointPQPlayer,145,260,405,13,36,JointPQPlayer
6317,JointPQPlayer,136,266,402,10,36,JointPQPlayer
6318,JointPQPlayer,275,195,470,39,23,Player A
6319,JointPQPlayer,285,195,480,37,19,Player A
6320,JointPQPlayer,139,259,398,15,39,JointPQPlayer
6321,JointPQPlayer,302,187,489,40,17,Player A
6322,JointPQPlayer,207,232,439,23,28,JointPQPlayer
6323,JointPQPlayer,264,204,468,34,22,Player A
6324,JointPQPlayer,301,196,497,33,12,Player A
6325,JointPQPlayer,268,203,471,34,21,Player A
6326,JointPQPlayer,281,201,482,33,17,Player A
6327,JointPQPlayer,291,201,492,31,13,Player A
6328,JointPQPlayer,137,262,399,13,38,JointPQPlayer
6329,JointPQPlayer,291,196,487,35,16,Player A
6330,JointPQPlayer,284,194,478,38,20,Player A
6331,JointPQPlayer,253,218,471,25,18,Player A
6332,JointPQPlayer,274,209,483,28,15,Player A
6333,JointPQPlayer,278,203,481,32,17,Player A
6334,JointPQPlayer,261,211,472,29,19,Player A
6335,JointPQPlayer,303,188,491,39,16,Player A
6336,JointPQPlayer,320,180,500,42,14,Player A
6337,JointPQPlayer,292,197,489,34,15,Player A
6338,JointPQPlayer,288,198,486,34,16,Player A
6339,JointPQPlayer,143,263,406,11,35,JointPQPlayer
6340,JointPQPlayer,307,187,494,39,15,Player A
6341,JointPQPlayer,257,207,464,33,23,Player A
6342,JointPQPlayer,266,206,472,32,20,Player A
6343,JointPQPlayer,245,215,460,29,23,Player A
6344,JointPQPlayer,282,202,484,32,16,Player A
6345,JointPQPlayer,313,193,506,33,9,Player A
6346,JointPQPlayer,177,247,424,17,31,JointPQPlayer
6347,JointPQPlayer,310,190,500,36,12,Player A
6348,JointPQPlayer,160,250,410,18,36,JointPQPlayer
6349,JointPQPlayer,154,259,413,12,33,JointPQPlayer
6350,JointPQPlayer,282,197,479,36,19,Player A
6351,JointPQPlayer,134,264,398,12,38,JointPQPlayer
6352,JointPQPlayer,266,206,472,32,20,Player A
6353,JointPQPlayer,266,206,472,32,20,Player A
6354,JointPQPlayer,296,196,492,34,14,Player A
6355,JointPQPlayer,144,259,403,14,37,JointPQPlayer
6356,JointPQPlayer,264,209,473,30,19,Player A
6357,JointPQPlayer,319,189,508,35,9,Player A
6358,JointPQPlayer,133,263,396,13,39,JointPQPlayer
6359,JointPQPlayer,278,203,481,32,17,Player A
6360,JointPQPlayer,281,201,482,33,17,Player A
6361,JointPQPlayer,310,190,500,36,12,Player A
6362,JointPQPlayer,175,250,425,15,30,JointPQPlayer
6363,JointPQPlayer,169,254,423,13,30,JointPQPlayer
6364,JointPQPlayer,286,201,487,32,15,Player A
6365,JointPQPlayer,310,185,495,40,15,Player A
6366,JointPQPlayer,143,263,406,11,35,JointPQPlayer
6367,JointPQPlayer,305,190,495,37,14,Player A
6368,JointPQPlayer,293,193,486,37,17,Player A
6369,JointPQPlayer,297,197,494,33,13,Player A
6370,JointPQPlayer,289,199,488,33,15,Player A
6371,JointPQPlayer,156,251,407,18,37,JointPQPlayer
6372,JointPQPlayer,279,199,478,35,19,Player A
6373,JointPQPlayer,301,191,492,37,15,Player A
6374,JointPQPlayer,288,193,481,38,19,Player A
6375,JointPQPlayer,168,243,411,22,37,JointPQPlayer
6376,JointPQPlayer,311,191,502,35,11,Player A
6377,JointPQPlayer,299,194,493,35,14,Player A
6378,JointPQPlayer,284,194,478,38,20,Player A
6379,JointPQPlayer,312,192,504,34,10,Player A
6380,JointPQPlayer,306,191,497,36,13,Player A
6381,JointPQPlayer,296,196,492,34,14,Player A
6382,JointPQPlayer,300,195,495,34,13,Player A
6383,JointPQPlayer,273,203,476,33,19,Player A
6384,JointPQPlayer,193,238,431,21,30,JointPQPlayer
6385,JointPQPlayer,261,206,467,33,22,Player A
6386,JointPQPlayer,310,180,490,44,18,Player A
6387,JointPQPlayer,295,190,485,39,18,Player A
6388,JointPQPlayer,136,266,402,10,36,JointPQPlayer
6389,JointPQPlayer,279,204,483,31,16,Player A
6390,JointPQPlayer,293,193,486,37,17,Player A
6391,JointPQPlayer,306,191,497,36,13,Player A
6392,JointPQPlayer,285,205,490,29,13,Player A
6393,JointPQPlayer,283,203,486,31,15,Player A
6394,JointPQPlayer,161,256,417,13,32,JointPQPlayer
6395,JointPQPlayer,295,195,490,35,15,Player A
6396,JointPQPlayer,142,262,404,12,36,JointPQPlayer
6397,JointPQPlayer,166,256,422,12,30,JointPQPlayer
6398,JointPQPlayer,286,201,487,32,15,Player A
6399,JointPQPlayer,286,196,482,36,18,Player A
6400,JointPQPlayer,198,233,431,24,31,JointPQPlayer
6401,JointPQPlayer,246,216,462,28,22,Player A
6402,JointPQPlayer,149,254,403,17,38,JointPQPlayer
6403,JointPQPlayer,315,190,505,35,10,Player A
6404,JointPQPlayer,179,244,423,19,32,JointPQPlayer
6405,JointPQPlayer,297,192,489,37,16,Player A
6406,JointPQPlayer,150,260,410,12,34,JointPQPlayer
6407,JointPQPlayer,160,255,415,14,33,JointPQPlayer
6408,JointPQPlayer,130,265,395,12,39,JointPQPlayer
6409,JointPQPlayer,267,207,474,31,19,Player A
6410,JointPQPlayer,326,181,507,40,11,Player A
6411,JointPQPlayer,144,254,398,18,40,JointPQPlayer
6412,JointPQPlayer,259,214,473,27,18,Player A
6413,JointPQPlayer,288,198,486,34,16,Player A
6414,JointPQPlayer,301,191,492,37,15,Player A
6415,JointPQPlayer,260,205,465,34,23,Player A
6416,JointPQPlayer,287,202,489,31,14,Player A
6417,JointPQPlayer,117,272,389,9,40,JointPQPlayer
6418,JointPQPlayer,311,186,497,39,14,Player A
6419,JointPQPlayer,299,194,493,35,14,Player A
6420,JointPQPlayer,312,192,504,34,10,Player A
6421,JointPQPlayer,302,187,489,40,17,Player A
6422,JointPQPlayer,212,237,449,18,23,JointPQPlayer
6423,JointPQPlayer,144,259,403,14,37,JointPQPlayer
6424,JointPQPlayer,287,192,479,39,20,Player A
6425,JointPQPlayer,279,199,478,35,19,Player A
6426,JointPQPlayer,275,205,480,31,17,Player A
6427,JointPQPlayer,247,212,459,31,24,Player A
6428,JointPQPlayer,311,196,507,31,8,Player A
6429,JointPQPlayer,283,203,486,31,15,Player A
6430,JointPQPlayer,305,190,495,37,14,Player A
6431,JointPQPlayer,281,201,482,33,17,Player A
6432,JointPQPlayer,299,194,493,35,14,Player A
6433,JointPQPlayer,287,197,484,35,17,Player A
6434,JointPQPlayer,297,192,489,37,16,Player A
6435,JointPQPlayer,141,266,407,9,34,JointPQPlayer
6436,JointPQPlayer,296,196,492,34,14,Player A
6437,JointPQPlayer,312,187,499,38,13,Player A
6438,JointPQPlayer,163,248,411,19,36,JointPQPlayer
6439,JointPQPlayer,272,202,474,34,20,Player A
6440,JointPQPlayer,245,220,465,25,20,Player A
6441,JointPQPlayer,142,257,399,16,39,JointPQPlayer
6442,JointPQPlayer,287,197,484,35,17,Player A
6443,JointPQPlayer,267,197,464,39,25,Player A
6444,JointPQPlayer,273,208,481,29,16,Player A
6445,JointPQPlayer,300,190,490,38,16,Player A
6446,JointPQPlayer,147,257,404,15,37,JointPQPlayer
6447,JointPQPlayer,269,204,473,33,20,Player A
6448,JointPQPlayer,301,191,492,37,15,Player A
6449,JointPQPlayer,291,196,487,35,16,Player A
6450,JointPQPlayer,325,180,505,41,12,Player A
6451,JointPQPlayer,290,200,490,32,14,Player A
6452,JointPQPlayer,259,209,468,31,21,Player A
6453,JointPQPlayer,233,223,456,25,23,Player A
6454,JointPQPlayer,155,255,410,15,35,JointPQPlayer
6455,JointPQPlayer,331,181,512,39,9,Player A
6456,JointPQPlayer,273,208,481,29,16,Player A
6457,JointPQPlayer,268,208,476,30,18,Player A
6458,JointPQPlayer,317,187,504,37,11,Player A
6459,JointPQPlayer,291,196,487,35,16,Player A
6460,JointPQPlayer,260,200,460,38,26,Player A
6461,JointPQPlayer,286,196,482,36,18,Player A
6462,JointPQPlayer,296,196,492,34,14,Player A
6463,JointPQPlayer,299,189,488,39,17,Player A
6464,JointPQPlayer,294,194,488,36,16,Player A
6465,JointPQPlayer,292,197,489,34,15,Player A
6466,JointPQPlayer,298,193,491,36,15,Player A
6467,JointPQPlayer,157,257,414,13,33,JointPQPlayer
6468,JointPQPlayer,278,198,476,36,20,Player A
6469,JointPQPlayer,306,186,492,40,16,Player A
6470,JointPQPlayer,135,265,400,11,37,JointPQPlayer
6471,JointPQPlayer,143,263,406,11,35,JointPQPlayer
0,revTitforTat,204,199,403,50,49,Player A
1,revTitforTat,200,200,400,50,50,Tie
2,revTitforTat,200,200,400,50,50,Tie
3,revTitforTat,200,200,400,50,50,Tie
4,revTitforTat,200,200,400,50,50,Tie
5,revTitforTat,200,200,400,50,50,Tie
6,revTitforTat,200,200,400,50,50,Tie
7,revTitforTat,200,200,400,50,50,Tie
8,revTitforTat,200,200,400,50,50,Tie
9,revTitforTat,200,200,400,50,50,Tie
10,revTitforTat,200,200,400,50,50,Tie
0,PatternPlayer,217,217,434,33,33,Tie
1,PatternPlayer,217,217,434,33,33,Tie
2,PatternPlayer,216,216,432,34,34,Tie
3,PatternPlayer,217,217,434,33,33,Tie
4,PatternPlayer,217,217,434,33,33,Tie
5,PatternPlayer,216,216,432,34,34,Tie
6,PatternPlayer,217,217,434,33,33,Tie
7,PatternPlayer,217,217,434,33,33,Tie
8,PatternPlayer,216,216,432,34,34,Tie
9,PatternPlayer,217,217,434,33,33,Tie
10,PatternPlayer,217,217,434,33,33,Tie
0,GrudgePlayer,54,299,353,0,49,GrudgePlayer
1,GrudgePlayer,50,300,350,0,50,GrudgePlayer
2,GrudgePlayer,50,300,350,0,50,GrudgePlayer
3,GrudgePlayer,50,300,350,0,50,GrudgePlayer
4,GrudgePlayer,50,300,350,0,50,GrudgePlayer
5,GrudgePlayer,50,300,350,0,50,GrudgePlayer
6,GrudgePlayer,50,300,350,0,50,GrudgePlayer
7,GrudgePlayer,50,300,350,0,50,GrudgePlayer
8,GrudgePlayer,50,300,350,0,50,GrudgePlayer
9,GrudgePlayer,50,300,350,0,50,GrudgePlayer
10,GrudgePlayer,50,300,350,0,50,GrudgePlayer
0,Gullible,400,150,550,50,0,Player A
1,Gullible,400,150,550,50,0,Player A
2,Gullible,400,150,550,50,0,Player A
3,Gullible,400,150,550,50,0,Player A
4,Gullible,400,150,550,50,0,Player A
5,Gullible,400,150,550,50,0,Player A
6,Gullible,400,150,550,50,0,Player A
7,Gullible,400,150,550,50,0,Player A
8,Gullible,400,150,550,50,0,Player A
9,Gullible,400,150,550,50,0,Player A
10,Gullible,400,150,550,50,0,Player A
0,Sly Fox,50,300,350,0,50,Sly Fox
1,Sly Fox,50,300,350,0,50,Sly Fox
2,Sly Fox,50,300,350,0,50,Sly Fox
3,Sly Fox,50,300,350,0,50,Sly Fox
4,Sly Fox,50,300,350,0,50,Sly Fox
5,Sly Fox,50,300,350,0,50,Sly Fox
6,Sly Fox,50,300,350,0,50,Sly Fox
7,Sly Fox,50,300,350,0,50,Sly Fox
8,Sly Fox,50,300,350,0,50,Sly Fox
9,Sly Fox,50,300,350,0,50,Sly Fox
10,Sly Fox,50,300,350,0,50,Sly Fox
0,Evan,200,200,400,50,50,Tie
1,Evan,200,200,400,50,50,Tie
2,Evan,200,200,400,50,50,Tie
3,Evan,200,200,400,50,50,Tie
4,Evan,200,200,400,50,50,Tie
5,Evan,200,200,400,50,50,Tie
6,Evan,200,200,400,50,50,Tie
7,Evan,200,200,400,50,50,Tie
8,Evan,200,200,400,50,50,Tie
9,Evan,200,200,400,50,50,Tie
10,Evan,200,200,400,50,50,Tie
0,Randy,226,221,447,28,27,Player A
1,Randy,232,222,454,26,24,Player A
2,Randy,233,223,456,25,23,Player A
3,Randy,217,227,444,25,27,Randy
4,Randy,232,222,454,26,24,Player A
5,Randy,209,229,438,25,29,Randy
6,Randy,236,226,462,22,20,Player A
7,Randy,217,227,444,25,27,Randy
8,Randy,235,220,455,27,24,Player A
9,Randy,208,233,441,22,27,Randy
10,Randy,208,233,441,22,27,Randy
11,Randy,226,226,452,24,24,Tie
12,Randy,211,226,437,27,30,Randy
13,Randy,234,224,458,24,22,Player A
14,Randy,208,228,436,26,30,Randy
15,Randy,229,224,453,25,24,Player A
16,Randy,220,230,450,22,24,Randy
17,Randy,246,211,457,32,25,Player A
18,Randy,242,212,454,32,26,Player A
19,Randy,226,226,452,24,24,Tie
20,Randy,214,224,438,28,30,Randy
21,Randy,209,229,438,25,29,Randy
22,Randy,228,218,446,30,28,Player A
23,Randy,231,226,457,23,22,Player A
24,Randy,246,216,462,28,22,Player A
25,Randy,243,213,456,31,25,Player A
26,Randy,254,214,468,28,20,Player A
27,Randy,247,222,469,23,18,Player A
28,Randy,250,210,460,32,24,Player A
29,Randy,223,228,451,23,24,Randy
30,Randy,232,227,459,22,21,Player A
31,Randy,233,223,456,25,23,Player A
32,Randy,215,230,445,23,26,Randy
33,Randy,204,229,433,26,31,Randy
34,Randy,227,227,454,23,23,Tie
35,Randy,225,230,455,21,22,Randy
36,Randy,230,225,455,24,23,Player A
37,Randy,243,218,461,27,22,Player A
38,Randy,247,212,459,31,24,Player A
39,Randy,248,213,461,30,23,Player A
40,Randy,252,212,464,30,22,Player A
41,Randy,214,229,443,24,27,Randy
42,Randy,248,218,466,26,20,Player A
43,Randy,201,231,432,25,31,Randy
44,Randy,240,220,460,26,22,Player A
45,Randy,222,232,454,20,22,Randy
46,Randy,228,223,451,26,25,Player A
47,Randy,208,233,441,22,27,Randy
48,Randy,220,220,440,30,30,Tie
49,Randy,243,218,461,27,22,Player A
50,Randy,235,220,455,27,24,Player A
51,Randy,236,221,457,26,23,Player A
52,Randy,242,217,459,28,23,Player A
53,Randy,227,227,454,23,23,Tie
54,Randy,272,202,474,34,20,Player A
55,Randy,222,227,449,24,25,Randy
56,Randy,210,230,440,24,28,Randy
57,Randy,242,222,464,24,20,Player A
58,Randy,239,219,458,27,23,Player A
59,Randy,199,234,433,23,30,Randy
60,Randy,213,228,441,25,28,Randy
61,Randy,234,224,458,24,22,Player A
62,Randy,212,232,444,22,26,Randy
63,Randy,207,227,434,27,31,Randy
64,Randy,228,228,456,22,22,Tie
65,Randy,221,231,452,21,23,Randy
66,Randy,186,236,422,24,34,Randy
67,Randy,263,213,476,27,17,Player A
68,Randy,212,222,434,30,32,Randy
69,Randy,200,235,435,22,29,Randy
70,Randy,245,220,465,25,20,Player A
71,Randy,237,217,454,29,25,Player A
72,Randy,217,232,449,21,24,Randy
73,Randy,220,225,445,26,27,Randy
74,Randy,216,226,442,26,28,Randy
75,Randy,227,222,449,27,26,Player A
76,Randy,219,229,448,23,25,Randy
77,Randy,218,228,446,24,26,Randy
78,Randy,229,219,448,29,27,Player A
79,Randy,229,224,453,25,24,Player A
80,Randy,211,231,442,23,27,Randy
81,Randy,230,225,455,24,23,Player A
82,Randy,247,217,464,27,21,Player A
83,Randy,190,230,420,28,36,Randy
84,Randy,221,226,447,25,26,Randy
85,Randy,238,218,456,28,24,Player A
86,Randy,207,232,439,23,28,Randy
87,Randy,231,221,452,27,25,Player A
88,Randy,209,229,438,25,29,Randy
89,Randy,253,218,471,25,18,Player A
90,Randy,261,211,472,29,19,Player A
91,Randy,239,214,453,31,26,Player A
92,Randy,201,236,437,21,28,Randy
93,Randy,197,237,434,21,29,Randy
94,Randy,200,235,435,22,29,Randy
95,Randy,212,232,444,22,26,Randy
96,Randy,210,235,445,20,25,Randy
97,Randy,283,203,486,31,15,Player A
98,Randy,208,228,436,26,30,Randy
99,Randy,278,203,481,32,17,Player A
100,Randy,226,226,452,24,24,Tie
101,Randy,221,226,447,25,26,Randy
102,Randy,196,236,432,22,30,Randy
103,Randy,217,232,449,21,24,Randy
104,Randy,240,215,455,30,25,Player A
105,Randy,221,221,442,29,29,Tie
106,Randy,243,223,466,23,19,Player A
107,Randy,247,222,469,23,18,Player A
108,Randy,200,240,440,18,26,Randy
109,Randy,208,233,441,22,27,Randy
110,Randy,216,226,442,26,28,Randy
111,Randy,213,228,441,25,28,Randy
112,Randy,231,226,457,23,22,Player A
113,Randy,221,226,447,25,26,Randy
114,Randy,226,226,452,24,24,Tie
115,Randy,216,221,437,30,31,Randy
116,Randy,229,224,453,25,24,Player A
117,Randy,207,232,439,23,28,Randy
118,Randy,197,237,434,21,29,Randy
119,Randy,197,237,434,21,29,Randy
120,Randy,220,230,450,22,24,Randy
121,Randy,214,224,438,28,30,Randy
122,Randy,234,219,453,28,25,Player A
123,Randy,227,217,444,31,29,Player A
124,Randy,226,221,447,28,27,Player A
125,Randy,220,220,440,30,30,Tie
126,Randy,184,244,428,18,30,Randy
127,Randy,230,220,450,28,26,Player A
128,Randy,198,243,441,16,25,Randy
129,Randy,229,224,453,25,24,Player A
130,Randy,212,232,444,22,26,Randy
131,Randy,222,217,439,32,31,Player A
132,Randy,231,226,457,23,22,Player A
133,Randy,245,215,460,29,23,Player A
134,Randy,244,219,463,26,21,Player A
135,Randy,202,237,439,20,27,Randy
136,Randy,257,217,474,25,17,Player A
137,Randy,207,237,444,19,25,Randy
138,Randy,189,239,428,21,31,Randy
139,Randy,254,209,463,32,23,Player A
140,Randy,236,216,452,30,26,Player A
141,Randy,235,225,460,23,21,Player A
142,Randy,229,219,448,29,27,Player A
143,Randy,247,222,469,23,18,Player A
144,Randy,225,225,450,25,25,Tie
145,Randy,223,228,451,23,24,Randy
146,Randy,250,215,465,28,21,Player A
147,Randy,235,225,460,23,21,Player A
148,Randy,233,223,456,25,23,Player A
149,Randy,212,237,449,18,23,Randy
150,Randy,212,232,444,22,26,Randy
151,Randy,242,217,459,28,23,Player A
152,Randy,202,232,434,24,30,Randy
153,Randy,190,240,430,20,30,Randy
154,Randy,219,224,443,27,28,Randy
155,Randy,248,213,461,30,23,Player A
156,Randy,276,206,482,30,16,Player A
157,Randy,239,214,453,31,26,Player A
158,Randy,242,212,454,32,26,Player A
159,Randy,218,223,441,28,29,Randy
160,Randy,231,226,457,23,22,Player A
161,Randy,248,213,461,30,23,Player A
162,Randy,242,212,454,32,26,Player A
163,Randy,220,225,445,26,27,Randy
164,Randy,215,225,440,27,29,Randy
165,Randy,233,223,456,25,23,Player A
166,Randy,230,220,450,28,26,Player A
167,Randy,210,230,440,24,28,Randy
168,Randy,229,224,453,25,24,Player A
169,Randy,220,230,450,22,24,Randy
170,Randy,228,223,451,26,25,Player A
171,Randy,235,220,455,27,24,Player A
172,Randy,244,214,458,30,24,Player A
173,Randy,206,231,437,24,29,Randy
174,Randy,193,238,431,21,30,Randy
175,Randy,250,210,460,32,24,Player A
176,Randy,245,220,465,25,20,Player A
177,Randy,230,225,455,24,23,Player A
178,Randy,231,226,457,23,22,Player A
179,Randy,256,216,472,26,18,Player A
180,Randy,233,218,451,29,26,Player A
181,Randy,226,221,447,28,27,Player A
182,Randy,247,217,464,27,21,Player A
183,Randy,218,228,446,24,26,Randy
184,Randy,219,229,448,23,25,Randy
185,Randy,234,219,453,28,25,Player A
186,Randy,205,230,435,25,30,Randy
187,Randy,232,222,454,26,24,Player A
188,Randy,218,228,446,24,26,Randy
189,Randy,272,207,479,30,17,Player A
190,Randy,234,219,453,28,25,Player A
191,Randy,229,229,458,21,21,Tie
192,Randy,234,214,448,32,28,Player A
193,Randy,249,219,468,25,19,Player A
194,Randy,238,223,461,24,21,Player A
195,Randy,225,215,440,33,31,Player A
196,Randy,212,237,449,18,23,Randy
197,Randy,200,240,440,18,26,Randy
198,Randy,244,214,458,30,24,Player A
199,Randy,210,230,440,24,28,Randy
200,Randy,238,218,456,28,24,Player A
201,Randy,234,224,458,24,22,Player A
202,Randy,243,213,456,31,25,Player A
203,Randy,230,225,455,24,23,Player A
204,Randy,236,221,457,26,23,Player A
205,Randy,208,233,441,22,27,Randy
206,Randy,231,226,457,23,22,Player A
207,Randy,248,218,466,26,20,Player A
208,Randy,231,226,457,23,22,Player A
209,Randy,244,209,453,34,27,Player A
210,Randy,221,226,447,25,26,Randy
211,Randy,240,220,460,26,22,Player A
212,Randy,217,232,449,21,24,Randy
213,Randy,222,232,454,20,22,Randy
214,Randy,223,223,446,27,27,Tie
215,Randy,250,210,460,32,24,Player A
216,Randy,252,212,464,30,22,Player A
217,Randy,216,231,447,22,25,Randy
218,Randy,217,227,444,25,27,Randy
219,Randy,218,223,441,28,29,Randy
220,Randy,235,220,455,27,24,Player A
221,Randy,226,226,452,24,24,Tie
222,Randy,223,233,456,19,21,Randy
223,Randy,225,235,460,17,19,Randy
224,Randy,214,229,443,24,27,Randy
225,Randy,220,230,450,22,24,Randy
226,Randy,224,224,448,26,26,Tie
227,Randy,231,226,457,23,22,Player A
228,Randy,232,222,454,26,24,Player A
229,Randy,217,232,449,21,24,Randy
230,Randy,199,239,438,19,27,Randy
