Game,Opponent,PlayerA_Score,PlayerB_Score,Cumulative_Score,CCs,DDs,Winner
0,QLearningPlayer,231,221,452,27,25,Player A
1,QLearningPlayer,220,230,450,22,24,QLearningPlayer
2,QLearningPlayer,203,228,431,27,32,QLearningPlayer
3,QLearningPlayer,216,231,447,22,25,QLearningPlayer
4,QLearningPlayer,191,241,432,19,29,QLearningPlayer
5,QLearningPlayer,210,235,445,20,25,QLearningPlayer
6,QLearningPlayer,203,238,441,19,26,QLearningPlayer
7,QLearningPlayer,187,232,419,27,36,QLearningPlayer
8,QLearningPlayer,248,218,466,26,20,Player A
9,QLearningPlayer,235,220,455,27,24,Player A
10,QLearningPlayer,264,209,473,30,19,Player A
11,QLearningPlayer,209,234,443,21,26,QLearningPlayer
12,QLearningPlayer,251,211,462,31,23,Player A
13,QLearningPlayer,210,230,440,24,28,QLearningPlayer
14,QLearningPlayer,201,241,442,17,25,QLearningPlayer
15,QLearningPlayer,215,225,440,27,29,QLearningPlayer
16,QLearningPlayer,216,226,442,26,28,QLearningPlayer
17,QLearningPlayer,236,221,457,26,23,Player A
18,QLearningPlayer,224,224,448,26,26,Tie
19,QLearningPlayer,214,224,438,28,30,QLearningPlayer
20,QLearningPlayer,209,229,438,25,29,QLearningPlayer
21,QLearningPlayer,225,225,450,25,25,Tie
22,QLearningPlayer,228,223,451,26,25,Player A
23,QLearningPlayer,232,222,454,26,24,Player A
24,QLearningPlayer,250,215,465,28,21,Player A
25,QLearningPlayer,230,225,455,24,23,Player A
26,QLearningPlayer,188,238,426,22,32,QLearningPlayer
27,QLearningPlayer,241,221,462,25,21,Player A
28,QLearningPlayer,222,227,449,24,25,QLearningPlayer
29,QLearningPlayer,247,217,464,27,21,Player A
30,QLearningPlayer,241,226,467,21,18,Player A
31,QLearningPlayer,219,229,448,23,25,QLearningPlayer
32,QLearningPlayer,252,212,464,30,22,Player A
33,QLearningPlayer,191,236,427,23,32,QLearningPlayer
34,QLearningPlayer,226,226,452,24,24,Tie
35,QLearningPlayer,213,228,441,25,28,QLearningPlayer
36,QLearningPlayer,245,215,460,29,23,Player A
37,QLearningPlayer,216,226,442,26,28,QLearningPlayer
38,QLearningPlayer,191,241,432,19,29,QLearningPlayer
39,QLearningPlayer,223,233,456,19,21,QLearningPlayer
40,QLearningPlayer,250,220,470,24,18,Player A
41,QLearningPlayer,203,238,441,19,26,QLearningPlayer
42,QLearningPlayer,227,222,449,27,26,Player A
43,QLearningPlayer,227,227,454,23,23,Tie
44,QLearningPlayer,204,239,443,18,25,QLearningPlayer
45,QLearningPlayer,222,222,444,28,28,Tie
46,QLearningPlayer,269,209,478,29,17,Player A
47,QLearningPlayer,259,219,478,23,15,Player A
48,QLearningPlayer,223,223,446,27,27,Tie
49,QLearningPlayer,217,227,444,25,27,QLearningPlayer
50,QLearningPlayer,213,228,441,25,28,QLearningPlayer
51,QLearningPlayer,225,225,450,25,25,Tie
52,QLearningPlayer,225,225,450,25,25,Tie
53,QLearningPlayer,203,238,441,19,26,QLearningPlayer
54,QLearningPlayer,240,220,460,26,22,Player A
55,QLearningPlayer,216,231,447,22,25,QLearningPlayer
56,QLearningPlayer,246,216,462,28,22,Player A
57,QLearningPlayer,233,228,461,21,20,Player A
58,QLearningPlayer,213,238,451,17,22,QLearningPlayer
59,QLearningPlayer,220,230,450,22,24,QLearningPlayer
60,QLearningPlayer,178,243,421,20,33,QLearningPlayer
61,QLearningPlayer,207,232,439,23,28,QLearningPlayer
62,QLearningPlayer,196,236,432,22,30,QLearningPlayer
63,QLearningPlayer,220,225,445,26,27,QLearningPlayer
64,QLearningPlayer,234,219,453,28,25,Player A
65,QLearningPlayer,242,222,464,24,20,Player A
66,QLearningPlayer,233,218,451,29,26,Player A
67,QLearningPlayer,213,228,441,25,28,QLearningPlayer
68,QLearningPlayer,254,204,458,36,26,Player A
69,QLearningPlayer,251,216,467,27,20,Player A
70,QLearningPlayer,221,226,447,25,26,QLearningPlayer
71,QLearningPlayer,253,218,471,25,18,Player A
72,QLearningPlayer,276,206,482,30,16,Player A
73,QLearningPlayer,263,208,471,31,20,Player A
74,QLearningPlayer,234,219,453,28,25,Player A
75,QLearningPlayer,224,224,448,26,26,Tie
76,QLearningPlayer,225,225,450,25,25,Tie
77,QLearningPlayer,208,233,441,22,27,QLearningPlayer
78,QLearningPlayer,201,231,432,25,31,QLearningPlayer
79,QLearningPlayer,224,229,453,22,23,QLearningPlayer
80,QLearningPlayer,203,238,441,19,26,QLearningPlayer
81,QLearningPlayer,212,227,439,26,29,QLearningPlayer
82,QLearningPlayer,229,219,448,29,27,Player A
83,QLearningPlayer,210,225,435,28,31,QLearningPlayer
84,QLearningPlayer,260,210,470,30,20,Player A
85,QLearningPlayer,189,244,433,17,28,QLearningPlayer
86,QLearningPlayer,233,213,446,33,29,Player A
87,QLearningPlayer,220,230,450,22,24,QLearningPlayer
88,QLearningPlayer,246,216,462,28,22,Player A
89,QLearningPlayer,245,215,460,29,23,Player A
90,QLearningPlayer,203,228,431,27,32,QLearningPlayer
91,QLearningPlayer,206,236,442,20,26,QLearningPlayer
92,QLearningPlayer,224,224,448,26,26,Tie
93,QLearningPlayer,218,228,446,24,26,QLearningPlayer
94,QLearningPlayer,225,230,455,21,22,QLearningPlayer
95,QLearningPlayer,252,212,464,30,22,Player A
96,QLearningPlayer,221,221,442,29,29,Tie
97,QLearningPlayer,247,217,464,27,21,Player A
98,QLearningPlayer,239,219,458,27,23,Player A
99,QLearningPlayer,214,229,443,24,27,QLearningPlayer
100,QLearningPlayer,235,225,460,23,21,Player A
101,QLearningPlayer,218,228,446,24,26,QLearningPlayer
102,QLearningPlayer,201,231,432,25,31,QLearningPlayer
103,QLearningPlayer,216,216,432,34,34,Tie
104,QLearningPlayer,223,228,451,23,24,QLearningPlayer
105,QLearningPlayer,220,235,455,18,21,QLearningPlayer
106,QLearningPlayer,207,232,439,23,28,QLearningPlayer
107,QLearningPlayer,221,231,452,21,23,QLearningPlayer
108,QLearningPlayer,225,220,445,29,28,Player A
109,QLearningPlayer,219,229,448,23,25,QLearningPlayer
110,QLearningPlayer,239,219,458,27,23,Player A
111,QLearningPlayer,230,220,450,28,26,Player A
112,QLearningPlayer,198,233,431,24,31,QLearningPlayer
113,QLearningPlayer,247,217,464,27,21,Player A
114,QLearningPlayer,223,223,446,27,27,Tie
115,QLearningPlayer,237,212,449,33,28,Player A
116,QLearningPlayer,226,226,452,24,24,Tie
117,QLearningPlayer,212,237,449,18,23,QLearningPlayer
118,QLearningPlayer,210,225,435,28,31,QLearningPlayer
119,QLearningPlayer,197,237,434,21,29,QLearningPlayer
120,QLearningPlayer,225,225,450,25,25,Tie
121,QLearningPlayer,244,219,463,26,21,Player A
122,QLearningPlayer,218,228,446,24,26,QLearningPlayer
123,QLearningPlayer,247,217,464,27,21,Player A
124,QLearningPlayer,232,227,459,22,21,Player A
125,QLearningPlayer,204,239,443,18,25,QLearningPlayer
126,QLearningPlayer,250,215,465,28,21,Player A
127,QLearningPlayer,248,213,461,30,23,Player A
128,QLearningPlayer,226,226,452,24,24,Tie
129,QLearningPlayer,221,226,447,25,26,QLearningPlayer
130,QLearningPlayer,215,235,450,19,23,QLearningPlayer
131,QLearningPlayer,253,213,466,29,21,Player A
132,QLearningPlayer,240,220,460,26,22,Player A
133,QLearningPlayer,210,230,440,24,28,QLearningPlayer
134,QLearningPlayer,195,235,430,23,31,QLearningPlayer
135,QLearningPlayer,199,234,433,23,30,QLearningPlayer
136,QLearningPlayer,202,232,434,24,30,QLearningPlayer
137,QLearningPlayer,214,229,443,24,27,QLearningPlayer
138,QLearningPlayer,254,214,468,28,20,Player A
139,QLearningPlayer,230,220,450,28,26,Player A
140,QLearningPlayer,207,232,439,23,28,QLearningPlayer
141,QLearningPlayer,203,238,441,19,26,QLearningPlayer
142,QLearningPlayer,217,227,444,25,27,QLearningPlayer
143,QLearningPlayer,223,233,456,19,21,QLearningPlayer
144,QLearningPlayer,167,252,419,15,32,QLearningPlayer
145,QLearningPlayer,229,219,448,29,27,Player A
146,QLearningPlayer,235,215,450,31,27,Player A
147,QLearningPlayer,225,225,450,25,25,Tie
148,QLearningPlayer,207,232,439,23,28,QLearningPlayer
149,QLearningPlayer,220,230,450,22,24,QLearningPlayer
150,QLearningPlayer,209,229,438,25,29,QLearningPlayer
151,QLearningPlayer,229,224,453,25,24,Player A
152,QLearningPlayer,206,231,437,24,29,QLearningPlayer
153,QLearningPlayer,213,228,441,25,28,QLearningPlayer
154,QLearningPlayer,249,219,468,25,19,Player A
155,QLearningPlayer,196,231,427,26,33,QLearningPlayer
156,QLearningPlayer,213,228,441,25,28,QLearningPlayer
157,QLearningPlayer,204,239,443,18,25,QLearningPlayer
158,QLearningPlayer,235,220,455,27,24,Player A
159,QLearningPlayer,199,239,438,19,27,QLearningPlayer
160,QLearningPlayer,210,230,440,24,28,QLearningPlayer
161,QLearningPlayer,198,228,426,28,34,QLearningPlayer
162,QLearningPlayer,254,219,473,24,17,Player A
163,QLearningPlayer,220,225,445,26,27,QLearningPlayer
164,QLearningPlayer,196,236,432,22,30,QLearningPlayer
165,QLearningPlayer,223,228,451,23,24,QLearningPlayer
166,QLearningPlayer,188,243,431,18,29,QLearningPlayer
167,QLearningPlayer,255,210,465,31,22,Player A
168,QLearningPlayer,231,221,452,27,25,Player A
169,QLearningPlayer,229,224,453,25,24,Player A
170,QLearningPlayer,219,224,443,27,28,QLearningPlayer
171,QLearningPlayer,197,232,429,25,32,QLearningPlayer
172,QLearningPlayer,209,234,443,21,26,QLearningPlayer
173,QLearningPlayer,233,223,456,25,23,Player A
174,QLearningPlayer,258,208,466,32,22,Player A
175,QLearningPlayer,217,232,449,21,24,QLearningPlayer
176,QLearningPlayer,215,225,440,27,29,QLearningPlayer
177,QLearningPlayer,257,212,469,29,20,Player A
178,QLearningPlayer,245,215,460,29,23,Player A
179,QLearningPlayer,224,224,448,26,26,Tie
180,QLearningPlayer,218,228,446,24,26,QLearningPlayer
181,QLearningPlayer,225,230,455,21,22,QLearningPlayer
182,QLearningPlayer,213,233,446,21,25,QLearningPlayer
183,QLearningPlayer,237,212,449,33,28,Player A
184,QLearningPlayer,259,214,473,27,18,Player A
185,QLearningPlayer,237,222,459,25,22,Player A
186,QLearningPlayer,218,223,441,28,29,QLearningPlayer
187,QLearningPlayer,212,227,439,26,29,QLearningPlayer
188,QLearningPlayer,220,230,450,22,24,QLearningPlayer
189,QLearningPlayer,208,228,436,26,30,QLearningPlayer
190,QLearningPlayer,228,218,446,30,28,Player A
191,QLearningPlayer,214,229,443,24,27,QLearningPlayer
192,QLearningPlayer,195,240,435,19,28,QLearningPlayer
193,QLearningPlayer,246,211,457,32,25,Player A
194,QLearningPlayer,244,219,463,26,21,Player A
195,QLearningPlayer,205,230,435,25,30,QLearningPlayer
196,QLearningPlayer,220,230,450,22,24,QLearningPlayer
197,QLearningPlayer,215,225,440,27,29,QLearningPlayer
198,QLearningPlayer,250,215,465,28,21,Player A
199,QLearningPlayer,203,233,436,23,29,QLearningPlayer
200,QLearningPlayer,227,227,454,23,23,Tie
201,QLearningPlayer,242,217,459,28,23,Player A
202,QLearningPlayer,218,228,446,24,26,QLearningPlayer
203,QLearningPlayer,233,223,456,25,23,Player A
204,QLearningPlayer,249,214,463,29,22,Player A
205,QLearningPlayer,233,223,456,25,23,Player A
206,QLearningPlayer,181,241,422,21,33,QLearningPlayer
207,QLearningPlayer,235,220,455,27,24,Player A
208,QLearningPlayer,235,220,455,27,24,Player A
209,QLearningPlayer,220,220,440,30,30,Tie
210,QLearningPlayer,216,236,452,18,22,QLearningPlayer
211,QLearningPlayer,214,234,448,20,24,QLearningPlayer
212,QLearningPlayer,197,237,434,21,29,QLearningPlayer
213,QLearningPlayer,204,234,438,22,28,QLearningPlayer
214,QLearningPlayer,208,233,441,22,27,QLearningPlayer
215,QLearningPlayer,231,226,457,23,22,Player A
216,QLearningPlayer,223,228,451,23,24,QLearningPlayer
217,QLearningPlayer,199,234,433,23,30,QLearningPlayer
218,QLearningPlayer,228,223,451,26,25,Player A
219,QLearningPlayer,196,241,437,18,27,QLearningPlayer
220,QLearningPlayer,190,245,435,16,27,QLearningPlayer
221,QLearningPlayer,236,226,462,22,20,Player A
222,QLearningPlayer,214,234,448,20,24,QLearningPlayer
223,QLearningPlayer,229,224,453,25,24,Player A
224,QLearningPlayer,226,226,452,24,24,Tie
225,QLearningPlayer,213,223,436,29,31,QLearningPlayer
226,QLearningPlayer,200,235,435,22,29,QLearningPlayer
227,QLearningPlayer,258,213,471,28,19,Player A
228,QLearningPlayer,236,216,452,30,26,Player A
229,QLearningPlayer,210,225,435,28,31,QLearningPlayer
230,QLearningPlayer,218,223,441,28,29,QLearningPlayer
231,QLearningPlayer,232,222,454,26,24,Player A
232,QLearningPlayer,229,224,453,25,24,Player A
233,QLearningPlayer,241,216,457,29,24,Player A
234,QLearningPlayer,222,227,449,24,25,QLearningPlayer
235,QLearningPlayer,184,249,433,14,27,QLearningPlayer
236,QLearningPlayer,231,226,457,23,22,Player A
237,QLearningPlayer,222,232,454,20,22,QLearningPlayer
238,QLearningPlayer,258,208,466,32,22,Player A
239,QLearningPlayer,218,223,441,28,29,QLearningPlayer
240,QLearningPlayer,243,218,461,27,22,Player A
241,QLearningPlayer,217,232,449,21,24,QLearningPlayer
242,QLearningPlayer,237,217,454,29,25,Player A
243,QLearningPlayer,249,214,463,29,22,Player A
244,QLearningPlayer,234,219,453,28,25,Player A
245,QLearningPlayer,271,206,477,31,18,Player A
246,QLearningPlayer,195,230,425,27,34,QLearningPlayer
247,QLearningPlayer,238,218,456,28,24,Player A
248,QLearningPlayer,239,214,453,31,26,Player A
249,QLearningPlayer,257,217,474,25,17,Player A
250,QLearningPlayer,219,229,448,23,25,QLearningPlayer
251,QLearningPlayer,230,230,460,20,20,Tie
252,QLearningPlayer,219,229,448,23,25,QLearningPlayer
253,QLearningPlayer,196,236,432,22,30,QLearningPlayer
254,QLearningPlayer,205,230,435,25,30,QLearningPlayer
255,QLearningPlayer,224,224,448,26,26,Tie
256,QLearningPlayer,234,219,453,28,25,Player A
257,QLearningPlayer,260,210,470,30,20,Player A
258,QLearningPlayer,221,221,442,29,29,Tie
259,QLearningPlayer,244,219,463,26,21,Player A
260,QLearningPlayer,209,229,438,25,29,QLearningPlayer
261,QLearningPlayer,222,227,449,24,25,QLearningPlayer
262,QLearningPlayer,218,228,446,24,26,QLearningPlayer
263,QLearningPlayer,234,224,458,24,22,Player A
264,QLearningPlayer,239,219,458,27,23,Player A
265,QLearningPlayer,236,226,462,22,20,Player A
266,QLearningPlayer,223,228,451,23,24,QLearningPlayer
267,QLearningPlayer,238,228,466,20,18,Player A
268,QLearningPlayer,226,226,452,24,24,Tie
269,QLearningPlayer,266,211,477,28,17,Player A
270,QLearningPlayer,244,214,458,30,24,Player A
271,QLearningPlayer,194,239,433,20,29,QLearningPlayer
272,QLearningPlayer,202,237,439,20,27,QLearningPlayer
273,QLearningPlayer,231,226,457,23,22,Player A
274,QLearningPlayer,208,228,436,26,30,QLearningPlayer
275,QLearningPlayer,228,223,451,26,25,Player A
276,QLearningPlayer,225,215,440,33,31,Player A
277,QLearningPlayer,236,226,462,22,20,Player A
278,QLearningPlayer,243,213,456,31,25,Player A
279,QLearningPlayer,232,222,454,26,24,Player A
280,QLearningPlayer,204,234,438,22,28,QLearningPlayer
281,QLearningPlayer,236,216,452,30,26,Player A
282,QLearningPlayer,243,218,461,27,22,Player A
283,QLearningPlayer,253,218,471,25,18,Player A
284,QLearningPlayer,210,230,440,24,28,QLearningPlayer
285,QLearningPlayer,238,223,461,24,21,Player A
286,QLearningPlayer,190,240,430,20,30,QLearningPlayer
287,QLearningPlayer,189,244,433,17,28,QLearningPlayer
288,QLearningPlayer,222,222,444,28,28,Tie
289,QLearningPlayer,198,238,436,20,28,QLearningPlayer
290,QLearningPlayer,219,224,443,27,28,QLearningPlayer
291,QLearningPlayer,239,219,458,27,23,Player A
292,QLearningPlayer,215,225,440,27,29,QLearningPlayer
293,QLearningPlayer,244,209,453,34,27,Player A
294,QLearningPlayer,233,223,456,25,23,Player A
295,QLearningPlayer,215,230,445,23,26,QLearningPlayer
296,QLearningPlayer,212,237,449,18,23,QLearningPlayer
297,QLearningPlayer,238,213,451,32,27,Player A
298,QLearningPlayer,201,236,437,21,28,QLearningPlayer
299,QLearningPlayer,241,216,457,29,24,Player A
300,QLearningPlayer,211,231,442,23,27,QLearningPlayer
301,QLearningPlayer,233,223,456,25,23,Player A
302,QLearningPlayer,227,222,449,27,26,Player A
303,QLearningPlayer,262,207,469,32,21,Player A
304,QLearningPlayer,228,228,456,22,22,Tie
305,QLearningPlayer,219,229,448,23,25,QLearningPlayer
306,QLearningPlayer,231,221,452,27,25,Player A
307,QLearningPlayer,230,220,450,28,26,Player A
308,QLearningPlayer,228,228,456,22,22,Tie
309,QLearningPlayer,200,235,435,22,29,QLearningPlayer
310,QLearningPlayer,226,231,457,20,21,QLearningPlayer
311,QLearningPlayer,217,232,449,21,24,QLearningPlayer
312,QLearningPlayer,218,228,446,24,26,QLearningPlayer
313,QLearningPlayer,237,217,454,29,25,Player A
314,QLearningPlayer,205,235,440,21,27,QLearningPlayer
315,QLearningPlayer,236,221,457,26,23,Player A
316,QLearningPlayer,225,225,450,25,25,Tie
317,QLearningPlayer,190,235,425,24,33,QLearningPlayer
318,QLearningPlayer,206,236,442,20,26,QLearningPlayer
319,QLearningPlayer,225,225,450,25,25,Tie
320,QLearningPlayer,239,214,453,31,26,Player A
321,QLearningPlayer,189,234,423,25,34,QLearningPlayer
322,QLearningPlayer,206,231,437,24,29,QLearningPlayer
323,QLearningPlayer,231,226,457,23,22,Player A
324,QLearningPlayer,201,236,437,21,28,QLearningPlayer
325,QLearningPlayer,201,236,437,21,28,QLearningPlayer
326,QLearningPlayer,240,220,460,26,22,Player A
327,QLearningPlayer,240,220,460,26,22,Player A
328,QLearningPlayer,202,237,439,20,27,QLearningPlayer
329,QLearningPlayer,230,225,455,24,23,Player A
330,QLearningPlayer,230,220,450,28,26,Player A
331,QLearningPlayer,253,213,466,29,21,Player A
332,QLearningPlayer,223,228,451,23,24,QLearningPlayer
333,QLearningPlayer,221,226,447,25,26,QLearningPlayer
334,QLearningPlayer,221,226,447,25,26,QLearningPlayer
335,QLearningPlayer,250,215,465,28,21,Player A
336,QLearningPlayer,224,224,448,26,26,Tie
337,QLearningPlayer,255,220,475,23,16,Player A
338,QLearningPlayer,227,227,454,23,23,Tie
339,QLearningPlayer,236,226,462,22,20,Player A
340,QLearningPlayer,239,219,458,27,23,Player A
341,QLearningPlayer,204,234,438,22,28,QLearningPlayer
342,QLearningPlayer,200,230,430,26,32,QLearningPlayer
343,QLearningPlayer,234,224,458,24,22,Player A
344,QLearningPlayer,203,238,441,19,26,QLearningPlayer
345,QLearningPlayer,206,231,437,24,29,QLearningPlayer
346,QLearningPlayer,226,226,452,24,24,Tie
347,QLearningPlayer,235,220,455,27,24,Player A
348,QLearningPlayer,234,219,453,28,25,Player A
349,QLearningPlayer,237,227,464,21,19,Player A
350,QLearningPlayer,213,228,441,25,28,QLearningPlayer
351,QLearningPlayer,224,229,453,22,23,QLearningPlayer
352,QLearningPlayer,234,224,458,24,22,Player A
353,QLearningPlayer,200,240,440,18,26,QLearningPlayer
354,QLearningPlayer,245,225,470,21,17,Player A
355,QLearningPlayer,201,236,437,21,28,QLearningPlayer
356,QLearningPlayer,195,235,430,23,31,QLearningPlayer
357,QLearningPlayer,204,239,443,18,25,QLearningPlayer
358,QLearningPlayer,213,228,441,25,28,QLearningPlayer
359,QLearningPlayer,214,234,448,20,24,QLearningPlayer
360,QLearningPlayer,199,234,433,23,30,QLearningPlayer
361,QLearningPlayer,232,227,459,22,21,Player A
362,QLearningPlayer,237,217,454,29,25,Player A
363,QLearningPlayer,239,219,458,27,23,Player A
364,QLearningPlayer,242,222,464,24,20,Player A
365,QLearningPlayer,228,228,456,22,22,Tie
366,QLearningPlayer,206,231,437,24,29,QLearningPlayer
367,QLearningPlayer,223,228,451,23,24,QLearningPlayer
368,QLearningPlayer,243,218,461,27,22,Player A
369,QLearningPlayer,232,222,454,26,24,Player A
370,QLearningPlayer,221,231,452,21,23,QLearningPlayer
371,QLearningPlayer,236,216,452,30,26,Player A
372,QLearningPlayer,234,224,458,24,22,Player A
373,QLearningPlayer,211,231,442,23,27,QLearningPlayer
374,QLearningPlayer,236,226,462,22,20,Player A
375,QLearningPlayer,240,215,455,30,25,Player A
376,QLearningPlayer,216,231,447,22,25,QLearningPlayer
377,QLearningPlayer,222,222,444,28,28,Tie
378,QLearningPlayer,228,223,451,26,25,Player A
379,QLearningPlayer,207,232,439,23,28,QLearningPlayer
380,QLearningPlayer,233,223,456,25,23,Player A
381,QLearningPlayer,208,228,436,26,30,QLearningPlayer
382,QLearningPlayer,245,220,465,25,20,Player A
383,QLearningPlayer,247,217,464,27,21,Player A
384,QLearningPlayer,218,228,446,24,26,QLearningPlayer
385,QLearningPlayer,217,227,444,25,27,QLearningPlayer
386,QLearningPlayer,217,227,444,25,27,QLearningPlayer
387,QLearningPlayer,226,226,452,24,24,Tie
388,QLearningPlayer,230,225,455,24,23,Player A
389,QLearningPlayer,243,213,456,31,25,Player A
390,QLearningPlayer,212,227,439,26,29,QLearningPlayer
391,QLearningPlayer,237,212,449,33,28,Player A
392,QLearningPlayer,228,218,446,30,28,Player A
393,QLearningPlayer,203,238,441,19,26,QLearningPlayer
394,QLearningPlayer,211,231,442,23,27,QLearningPlayer
395,QLearningPlayer,211,236,447,19,24,QLearningPlayer
396,QLearningPlayer,216,231,447,22,25,QLearningPlayer
397,QLearningPlayer,205,230,435,25,30,QLearningPlayer
398,QLearningPlayer,203,233,436,23,29,QLearningPlayer
399,QLearningPlayer,234,219,453,28,25,Player A
400,QLearningPlayer,259,209,468,31,21,Player A
401,QLearningPlayer,241,216,457,29,24,Player A
402,QLearningPlayer,242,222,464,24,20,Player A
403,QLearningPlayer,234,219,453,28,25,Player A
404,QLearningPlayer,228,223,451,26,25,Player A
405,QLearningPlayer,213,238,451,17,22,QLearningPlayer
406,QLearningPlayer,233,223,456,25,23,Player A
407,QLearningPlayer,268,208,476,30,18,Player A
408,QLearningPlayer,208,233,441,22,27,QLearningPlayer
409,QLearningPlayer,211,231,442,23,27,QLearningPlayer
410,QLearningPlayer,224,224,448,26,26,Tie
411,QLearningPlayer,245,220,465,25,20,Player A
412,QLearningPlayer,250,210,460,32,24,Player A
413,QLearningPlayer,220,225,445,26,27,QLearningPlayer
414,QLearningPlayer,235,215,450,31,27,Player A
415,QLearningPlayer,216,226,442,26,28,QLearningPlayer
416,QLearningPlayer,189,239,428,21,31,QLearningPlayer
417,QLearningPlayer,233,223,456,25,23,Player A
418,QLearningPlayer,206,231,437,24,29,QLearningPlayer
419,QLearningPlayer,206,236,442,20,26,QLearningPlayer
420,QLearningPlayer,211,236,447,19,24,QLearningPlayer
421,QLearningPlayer,203,233,436,23,29,QLearningPlayer
422,QLearningPlayer,241,216,457,29,24,Player A
423,QLearningPlayer,230,225,455,24,23,Player A
424,QLearningPlayer,216,231,447,22,25,QLearningPlayer
425,QLearningPlayer,223,228,451,23,24,QLearningPlayer
426,QLearningPlayer,217,222,439,29,30,QLearningPlayer
427,QLearningPlayer,237,222,459,25,22,Player A
428,QLearningPlayer,234,224,458,24,22,Player A
429,QLearningPlayer,244,214,458,30,24,Player A
430,QLearningPlayer,223,228,451,23,24,QLearningPlayer
431,QLearningPlayer,232,222,454,26,24,Player A
432,QLearningPlayer,240,215,455,30,25,Player A
433,QLearningPlayer,236,226,462,22,20,Player A
434,QLearningPlayer,219,234,453,19,22,QLearningPlayer
435,QLearningPlayer,257,212,469,29,20,Player A
436,QLearningPlayer,239,219,458,27,23,Player A
437,QLearningPlayer,219,234,453,19,22,QLearningPlayer
438,QLearningPlayer,197,237,434,21,29,QLearningPlayer
439,QLearningPlayer,209,229,438,25,29,QLearningPlayer
440,QLearningPlayer,205,240,445,17,24,QLearningPlayer
441,QLearningPlayer,246,216,462,28,22,Player A
442,QLearningPlayer,218,228,446,24,26,QLearningPlayer
443,QLearningPlayer,225,230,455,21,22,QLearningPlayer
444,QLearningPlayer,214,229,443,24,27,QLearningPlayer
445,QLearningPlayer,238,223,461,24,21,Player A
446,QLearningPlayer,217,227,444,25,27,QLearningPlayer
447,QLearningPlayer,233,223,456,25,23,Player A
448,QLearningPlayer,233,228,461,21,20,Player A
449,QLearningPlayer,225,230,455,21,22,QLearningPlayer
450,QLearningPlayer,222,227,449,24,25,QLearningPlayer
451,QLearningPlayer,217,227,444,25,27,QLearningPlayer
452,QLearningPlayer,221,231,452,21,23,QLearningPlayer
453,QLearningPlayer,200,235,435,22,29,QLearningPlayer
454,QLearningPlayer,241,211,452,33,27,Player A
455,QLearningPlayer,226,226,452,24,24,Tie
456,QLearningPlayer,205,225,430,29,33,QLearningPlayer
457,QLearningPlayer,194,234,428,24,32,QLearningPlayer
458,QLearningPlayer,202,237,439,20,27,QLearningPlayer
459,QLearningPlayer,231,226,457,23,22,Player A
460,QLearningPlayer,229,224,453,25,24,Player A
461,QLearningPlayer,249,209,458,33,25,Player A
462,QLearningPlayer,226,221,447,28,27,Player A
463,QLearningPlayer,215,230,445,23,26,QLearningPlayer
464,QLearningPlayer,234,219,453,28,25,Player A
465,QLearningPlayer,237,217,454,29,25,Player A
466,QLearningPlayer,219,234,453,19,22,QLearningPlayer
467,QLearningPlayer,221,221,442,29,29,Tie
468,QLearningPlayer,226,226,452,24,24,Tie
469,QLearningPlayer,202,232,434,24,30,QLearningPlayer
470,QLearningPlayer,195,235,430,23,31,QLearningPlayer
471,QLearningPlayer,201,231,432,25,31,QLearningPlayer
472,QLearningPlayer,231,226,457,23,22,Player A
473,QLearningPlayer,232,222,454,26,24,Player A
474,QLearningPlayer,221,231,452,21,23,QLearningPlayer
475,QLearningPlayer,240,215,455,30,25,Player A
476,QLearningPlayer,227,217,444,31,29,Player A
477,QLearningPlayer,212,232,444,22,26,QLearningPlayer
478,QLearningPlayer,245,215,460,29,23,Player A
479,QLearningPlayer,214,229,443,24,27,QLearningPlayer
480,QLearningPlayer,207,227,434,27,31,QLearningPlayer
481,QLearningPlayer,193,238,431,21,30,QLearningPlayer
482,QLearningPlayer,262,212,474,28,18,Player A
483,QLearningPlayer,208,233,441,22,27,QLearningPlayer
484,QLearningPlayer,223,223,446,27,27,Tie
485,QLearningPlayer,184,244,428,18,30,QLearningPlayer
486,QLearningPlayer,218,228,446,24,26,QLearningPlayer
487,QLearningPlayer,238,223,461,24,21,Player A
488,QLearningPlayer,236,226,462,22,20,Player A
489,QLearningPlayer,226,226,452,24,24,Tie
490,QLearningPlayer,214,229,443,24,27,QLearningPlayer
491,QLearningPlayer,241,216,457,29,24,Player A
492,QLearningPlayer,234,219,453,28,25,Player A
493,QLearningPlayer,199,244,443,15,24,QLearningPlayer
494,QLearningPlayer,249,209,458,33,25,Player A
495,QLearningPlayer,212,232,444,22,26,QLearningPlayer
496,QLearningPlayer,188,238,426,22,32,QLearningPlayer
497,QLearningPlayer,182,242,424,20,32,QLearningPlayer
498,QLearningPlayer,232,222,454,26,24,Player A
499,QLearningPlayer,230,225,455,24,23,Player A
500,QLearningPlayer,224,224,448,26,26,Tie
501,QLearningPlayer,233,223,456,25,23,Player A
502,QLearningPlayer,220,230,450,22,24,QLearningPlayer
503,QLearningPlayer,232,217,449,30,27,Player A
504,QLearningPlayer,230,220,450,28,26,Player A
505,QLearningPlayer,222,222,444,28,28,Tie
506,QLearningPlayer,208,233,441,22,27,QLearningPlayer
507,QLearningPlayer,227,222,449,27,26,Player A
508,QLearningPlayer,242,217,459,28,23,Player A
509,QLearningPlayer,213,233,446,21,25,QLearningPlayer
510,QLearningPlayer,217,222,439,29,30,QLearningPlayer
511,QLearningPlayer,218,228,446,24,26,QLearningPlayer
512,QLearningPlayer,277,202,479,33,18,Player A
513,QLearningPlayer,228,218,446,30,28,Player A
514,QLearningPlayer,193,238,431,21,30,QLearningPlayer
515,QLearningPlayer,237,222,459,25,22,Player A
516,QLearningPlayer,230,220,450,28,26,Player A
517,QLearningPlayer,195,240,435,19,28,QLearningPlayer
518,QLearningPlayer,216,231,447,22,25,QLearningPlayer
519,QLearningPlayer,235,220,455,27,24,Player A
520,QLearningPlayer,252,212,464,30,22,Player A
521,QLearningPlayer,229,214,443,33,30,Player A
522,QLearningPlayer,212,227,439,26,29,QLearningPlayer
523,QLearningPlayer,223,228,451,23,24,QLearningPlayer
524,QLearningPlayer,211,231,442,23,27,QLearningPlayer
525,QLearningPlayer,220,225,445,26,27,QLearningPlayer
526,QLearningPlayer,237,217,454,29,25,Player A
527,QLearningPlayer,235,215,450,31,27,Player A
528,QLearningPlayer,236,221,457,26,23,Player A
529,QLearningPlayer,247,217,464,27,21,Player A
530,QLearningPlayer,181,241,422,21,33,QLearningPlayer
531,QLearningPlayer,212,227,439,26,29,QLearningPlayer
532,QLearningPlayer,223,223,446,27,27,Tie
533,QLearningPlayer,241,216,457,29,24,Player A
534,QLearningPlayer,226,221,447,28,27,Player A
535,QLearningPlayer,199,239,438,19,27,QLearningPlayer
536,QLearningPlayer,232,227,459,22,21,Player A
537,QLearningPlayer,210,225,435,28,31,QLearningPlayer
538,QLearningPlayer,253,213,466,29,21,Player A
539,QLearningPlayer,236,226,462,22,20,Player A
540,QLearningPlayer,252,212,464,30,22,Player A
541,QLearningPlayer,226,221,447,28,27,Player A
542,QLearningPlayer,212,222,434,30,32,QLearningPlayer
543,QLearningPlayer,244,214,458,30,24,Player A
544,QLearningPlayer,239,219,458,27,23,Player A
545,QLearningPlayer,216,231,447,22,25,QLearningPlayer
546,QLearningPlayer,221,231,452,21,23,QLearningPlayer
547,QLearningPlayer,233,223,456,25,23,Player A
548,QLearningPlayer,235,225,460,23,21,Player A
549,QLearningPlayer,213,228,441,25,28,QLearningPlayer
550,QLearningPlayer,211,236,447,19,24,QLearningPlayer
551,QLearningPlayer,202,232,434,24,30,QLearningPlayer
552,QLearningPlayer,221,226,447,25,26,QLearningPlayer
553,QLearningPlayer,230,225,455,24,23,Player A
554,QLearningPlayer,251,211,462,31,23,Player A
555,QLearningPlayer,195,235,430,23,31,QLearningPlayer
556,QLearningPlayer,248,218,466,26,20,Player A
557,QLearningPlayer,226,221,447,28,27,Player A
558,QLearningPlayer,248,218,466,26,20,Player A
559,QLearningPlayer,242,222,464,24,20,Player A
560,QLearningPlayer,243,218,461,27,22,Player A
561,QLearningPlayer,231,226,457,23,22,Player A
562,QLearningPlayer,173,243,416,21,35,QLearningPlayer
563,QLearningPlayer,230,220,450,28,26,Player A
564,QLearningPlayer,209,234,443,21,26,QLearningPlayer
565,QLearningPlayer,232,227,459,22,21,Player A
566,QLearningPlayer,263,208,471,31,20,Player A
567,QLearningPlayer,220,235,455,18,21,QLearningPlayer
568,QLearningPlayer,220,230,450,22,24,QLearningPlayer
569,QLearningPlayer,225,225,450,25,25,Tie
570,QLearningPlayer,230,225,455,24,23,Player A
571,QLearningPlayer,207,237,444,19,25,QLearningPlayer
572,QLearningPlayer,222,222,444,28,28,Tie
573,QLearningPlayer,221,226,447,25,26,QLearningPlayer
574,QLearningPlayer,225,230,455,21,22,QLearningPlayer
575,QLearningPlayer,214,224,438,28,30,QLearningPlayer
576,QLearningPlayer,212,227,439,26,29,QLearningPlayer
577,QLearningPlayer,190,235,425,24,33,QLearningPlayer
578,QLearningPlayer,246,216,462,28,22,Player A
579,QLearningPlayer,236,216,452,30,26,Player A
580,QLearningPlayer,254,219,473,24,17,Player A
581,QLearningPlayer,194,234,428,24,32,QLearningPlayer
582,QLearningPlayer,266,211,477,28,17,Player A
583,QLearningPlayer,239,219,458,27,23,Player A
584,QLearningPlayer,244,214,458,30,24,Player A
585,QLearningPlayer,225,225,450,25,25,Tie
586,QLearningPlayer,207,237,444,19,25,QLearningPlayer
587,QLearningPlayer,206,231,437,24,29,QLearningPlayer
588,QLearningPlayer,258,223,481,20,13,Player A
589,QLearningPlayer,242,217,459,28,23,Player A
590,QLearningPlayer,208,233,441,22,27,QLearningPlayer
591,QLearningPlayer,227,222,449,27,26,Player A
592,QLearningPlayer,196,236,432,22,30,QLearningPlayer
593,QLearningPlayer,187,242,429,19,30,QLearningPlayer
594,QLearningPlayer,233,218,451,29,26,Player A
595,QLearningPlayer,238,223,461,24,21,Player A
596,QLearningPlayer,206,231,437,24,29,QLearningPlayer
597,QLearningPlayer,229,219,448,29,27,Player A
598,QLearningPlayer,238,223,461,24,21,Player A
599,QLearningPlayer,230,220,450,28,26,Player A
600,QLearningPlayer,252,217,469,26,19,Player A
601,QLearningPlayer,237,222,459,25,22,Player A
602,QLearningPlayer,226,226,452,24,24,Tie
603,QLearningPlayer,206,231,437,24,29,QLearningPlayer
604,QLearningPlayer,257,207,464,33,23,Player A
605,QLearningPlayer,196,241,437,18,27,QLearningPlayer
606,QLearningPlayer,193,238,431,21,30,QLearningPlayer
607,QLearningPlayer,227,222,449,27,26,Player A
608,QLearningPlayer,211,231,442,23,27,QLearningPlayer
609,QLearningPlayer,213,233,446,21,25,QLearningPlayer
610,QLearningPlayer,230,225,455,24,23,Player A
611,QLearningPlayer,224,229,453,22,23,QLearningPlayer
612,QLearningPlayer,228,233,461,18,19,QLearningPlayer
613,QLearningPlayer,247,212,459,31,24,Player A
614,QLearningPlayer,233,228,461,21,20,Player A
615,QLearningPlayer,226,221,447,28,27,Player A
616,QLearningPlayer,206,226,432,28,32,QLearningPlayer
617,QLearningPlayer,223,228,451,23,24,QLearningPlayer
618,QLearningPlayer,214,224,438,28,30,QLearningPlayer
619,QLearningPlayer,209,234,443,21,26,QLearningPlayer
620,QLearningPlayer,226,221,447,28,27,Player A
621,QLearningPlayer,207,232,439,23,28,QLearningPlayer
622,QLearningPlayer,221,226,447,25,26,QLearningPlayer
623,QLearningPlayer,217,227,444,25,27,QLearningPlayer
624,QLearningPlayer,236,221,457,26,23,Player A
625,QLearningPlayer,244,219,463,26,21,Player A
626,QLearningPlayer,176,241,417,22,35,QLearningPlayer
627,QLearningPlayer,231,221,452,27,25,Player A
628,QLearningPlayer,226,226,452,24,24,Tie
629,QLearningPlayer,183,243,426,19,31,QLearningPlayer
630,QLearningPlayer,250,225,475,20,15,Player A
631,QLearningPlayer,212,232,444,22,26,QLearningPlayer
632,QLearningPlayer,225,220,445,29,28,Player A
633,QLearningPlayer,235,225,460,23,21,Player A
634,QLearningPlayer,205,230,435,25,30,QLearningPlayer
635,QLearningPlayer,226,221,447,28,27,Player A
636,QLearningPlayer,221,236,457,17,20,QLearningPlayer
637,QLearningPlayer,224,229,453,22,23,QLearningPlayer
638,QLearningPlayer,233,223,456,25,23,Player A
639,QLearningPlayer,232,227,459,22,21,Player A
640,QLearningPlayer,266,206,472,32,20,Player A
641,QLearningPlayer,218,218,436,32,32,Tie
642,QLearningPlayer,224,229,453,22,23,QLearningPlayer
643,QLearningPlayer,239,224,463,23,20,Player A
644,QLearningPlayer,228,228,456,22,22,Tie
645,QLearningPlayer,226,226,452,24,24,Tie
646,QLearningPlayer,237,217,454,29,25,Player A
647,QLearningPlayer,234,219,453,28,25,Player A
648,QLearningPlayer,205,225,430,29,33,QLearningPlayer
649,QLearningPlayer,210,230,440,24,28,QLearningPlayer
650,QLearningPlayer,198,233,431,24,31,QLearningPlayer
651,QLearningPlayer,218,228,446,24,26,QLearningPlayer
652,QLearningPlayer,209,229,438,25,29,QLearningPlayer
653,QLearningPlayer,240,215,455,30,25,Player A
654,QLearningPlayer,267,207,474,31,19,Player A
655,QLearningPlayer,207,232,439,23,28,QLearningPlayer
656,QLearningPlayer,240,220,460,26,22,Player A
657,QLearningPlayer,199,244,443,15,24,QLearningPlayer
658,QLearningPlayer,225,220,445,29,28,Player A
659,QLearningPlayer,233,228,461,21,20,Player A
660,QLearningPlayer,242,222,464,24,20,Player A
661,QLearningPlayer,220,235,455,18,21,QLearningPlayer
662,QLearningPlayer,213,238,451,17,22,QLearningPlayer
663,QLearningPlayer,218,223,441,28,29,QLearningPlayer
664,QLearningPlayer,226,226,452,24,24,Tie
665,QLearningPlayer,232,222,454,26,24,Player A
666,QLearningPlayer,214,224,438,28,30,QLearningPlayer
667,QLearningPlayer,233,218,451,29,26,Player A
668,QLearningPlayer,242,217,459,28,23,Player A
669,QLearningPlayer,228,228,456,22,22,Tie
670,QLearningPlayer,196,241,437,18,27,QLearningPlayer
671,QLearningPlayer,228,223,451,26,25,Player A
672,QLearningPlayer,204,234,438,22,28,QLearningPlayer
673,QLearningPlayer,233,218,451,29,26,Player A
674,QLearningPlayer,224,224,448,26,26,Tie
675,QLearningPlayer,230,225,455,24,23,Player A
676,QLearningPlayer,231,221,452,27,25,Player A
677,QLearningPlayer,221,231,452,21,23,QLearningPlayer
678,QLearningPlayer,205,235,440,21,27,QLearningPlayer
679,QLearningPlayer,206,231,437,24,29,QLearningPlayer
680,QLearningPlayer,205,235,440,21,27,QLearningPlayer
681,QLearningPlayer,246,216,462,28,22,Player A
682,QLearningPlayer,217,227,444,25,27,QLearningPlayer
683,QLearningPlayer,197,242,439,17,26,QLearningPlayer
684,QLearningPlayer,202,232,434,24,30,QLearningPlayer
685,QLearningPlayer,219,234,453,19,22,QLearningPlayer
686,QLearningPlayer,212,232,444,22,26,QLearningPlayer
687,QLearningPlayer,243,218,461,27,22,Player A
688,QLearningPlayer,218,228,446,24,26,QLearningPlayer
689,QLearningPlayer,239,219,458,27,23,Player A
690,QLearningPlayer,234,219,453,28,25,Player A
691,QLearningPlayer,231,221,452,27,25,Player A
692,QLearningPlayer,235,225,460,23,21,Player A
693,QLearningPlayer,226,226,452,24,24,Tie
694,QLearningPlayer,221,231,452,21,23,QLearningPlayer
695,QLearningPlayer,225,220,445,29,28,Player A
696,QLearningPlayer,198,233,431,24,31,QLearningPlayer
697,QLearningPlayer,249,214,463,29,22,Player A
698,QLearningPlayer,210,235,445,20,25,QLearningPlayer
699,QLearningPlayer,241,216,457,29,24,Player A
700,QLearningPlayer,252,217,469,26,19,Player A
701,QLearningPlayer,226,226,452,24,24,Tie
702,QLearningPlayer,211,236,447,19,24,QLearningPlayer
703,QLearningPlayer,255,210,465,31,22,Player A
704,QLearningPlayer,239,219,458,27,23,Player A
705,QLearningPlayer,240,220,460,26,22,Player A
706,QLearningPlayer,227,217,444,31,29,Player A
707,QLearningPlayer,217,232,449,21,24,QLearningPlayer
708,QLearningPlayer,232,222,454,26,24,Player A
709,QLearningPlayer,226,221,447,28,27,Player A
0,PatternLearningPlayer,216,196,412,50,46,Player A
1,PatternLearningPlayer,212,197,409,50,47,Player A
2,PatternLearningPlayer,210,200,410,48,46,Player A
3,PatternLearningPlayer,217,197,414,49,45,Player A
4,PatternLearningPlayer,212,197,409,50,47,Player A
5,PatternLearningPlayer,206,201,407,48,47,Player A
6,PatternLearningPlayer,216,196,412,50,46,Player A
7,PatternLearningPlayer,212,197,409,50,47,Player A
8,PatternLearningPlayer,212,197,409,50,47,Player A
9,PatternLearningPlayer,217,197,414,49,45,Player A
10,PatternLearningPlayer,209,199,408,49,47,Player A
11,PatternLearningPlayer,209,199,408,49,47,Player A
12,PatternLearningPlayer,209,199,408,49,47,Player A
13,PatternLearningPlayer,209,199,408,49,47,Player A
14,PatternLearningPlayer,213,198,411,49,46,Player A
15,PatternLearningPlayer,217,197,414,49,45,Player A
16,PatternLearningPlayer,216,196,412,50,46,Player A
17,PatternLearningPlayer,209,199,408,49,47,Player A
18,PatternLearningPlayer,216,196,412,50,46,Player A
19,PatternLearningPlayer,216,196,412,50,46,Player A
20,PatternLearningPlayer,213,198,411,49,46,Player A
21,PatternLearningPlayer,216,196,412,50,46,Player A
0,TitForTat,233,233,466,17,17,Tie
1,TitForTat,237,232,469,17,16,Player A
2,TitForTat,230,235,465,16,17,TitForTat
3,TitForTat,233,233,466,17,17,Tie
4,TitForTat,237,232,469,17,16,Player A
5,TitForTat,230,235,465,16,17,TitForTat
6,TitForTat,233,233,466,17,17,Tie
7,TitForTat,237,232,469,17,16,Player A
8,TitForTat,230,235,465,16,17,TitForTat
9,TitForTat,233,233,466,17,17,Tie
10,TitForTat,237,232,469,17,16,Player A
11,TitForTat,230,235,465,16,17,TitForTat
0,Bayesian,221,221,442,29,29,Tie
1,Bayesian,216,226,442,26,28,Bayesian
2,Bayesian,218,223,441,28,29,Bayesian
3,Bayesian,244,224,468,22,18,Player A
4,Bayesian,222,222,444,28,28,Tie
5,Bayesian,219,229,448,23,25,Bayesian
6,Bayesian,226,226,452,24,24,Tie
7,Bayesian,223,228,451,23,24,Bayesian
8,Bayesian,228,223,451,26,25,Player A
9,Bayesian,205,230,435,25,30,Bayesian
10,Bayesian,223,223,446,27,27,Tie
11,Bayesian,220,230,450,22,24,Bayesian
12,Bayesian,232,222,454,26,24,Player A
13,Bayesian,224,234,458,18,20,Bayesian
14,Bayesian,201,226,427,29,34,Bayesian
15,Bayesian,211,236,447,19,24,Bayesian
16,Bayesian,236,221,457,26,23,Player A
17,Bayesian,205,230,435,25,30,Bayesian
18,Bayesian,217,232,449,21,24,Bayesian
19,Bayesian,193,233,426,25,33,Bayesian
20,Bayesian,245,215,460,29,23,Player A
21,Bayesian,224,229,453,22,23,Bayesian
22,Bayesian,230,220,450,28,26,Player A
23,Bayesian,199,239,438,19,27,Bayesian
24,Bayesian,224,229,453,22,23,Bayesian
25,Bayesian,236,221,457,26,23,Player A
26,Bayesian,198,238,436,20,28,Bayesian
27,Bayesian,252,212,464,30,22,Player A
28,Bayesian,218,228,446,24,26,Bayesian
29,Bayesian,221,226,447,25,26,Bayesian
30,Bayesian,232,227,459,22,21,Player A
31,Bayesian,217,227,444,25,27,Bayesian
32,Bayesian,206,231,437,24,29,Bayesian
33,Bayesian,240,220,460,26,22,Player A
34,Bayesian,233,223,456,25,23,Player A
35,Bayesian,236,221,457,26,23,Player A
36,Bayesian,221,226,447,25,26,Bayesian
37,Bayesian,242,222,464,24,20,Player A
38,Bayesian,241,221,462,25,21,Player A
39,Bayesian,222,222,444,28,28,Tie
40,Bayesian,212,227,439,26,29,Bayesian
41,Bayesian,213,228,441,25,28,Bayesian
42,Bayesian,207,227,434,27,31,Bayesian
43,Bayesian,217,227,444,25,27,Bayesian
44,Bayesian,253,213,466,29,21,Player A
45,Bayesian,233,218,451,29,26,Player A
46,Bayesian,197,237,434,21,29,Bayesian
47,Bayesian,238,223,461,24,21,Player A
48,Bayesian,224,224,448,26,26,Tie
49,Bayesian,226,226,452,24,24,Tie
50,Bayesian,243,223,466,23,19,Player A
51,Bayesian,233,228,461,21,20,Player A
52,Bayesian,229,224,453,25,24,Player A
53,Bayesian,212,227,439,26,29,Bayesian
54,Bayesian,189,239,428,21,31,Bayesian
55,Bayesian,208,238,446,18,24,Bayesian
56,Bayesian,222,227,449,24,25,Bayesian
57,Bayesian,211,236,447,19,24,Bayesian
58,Bayesian,216,226,442,26,28,Bayesian
59,Bayesian,210,230,440,24,28,Bayesian
60,Bayesian,227,222,449,27,26,Player A
61,Bayesian,201,236,437,21,28,Bayesian
62,Bayesian,212,227,439,26,29,Bayesian
63,Bayesian,223,223,446,27,27,Tie
64,Bayesian,189,244,433,17,28,Bayesian
65,Bayesian,228,218,446,30,28,Player A
66,Bayesian,227,227,454,23,23,Tie
67,Bayesian,228,223,451,26,25,Player A
68,Bayesian,232,222,454,26,24,Player A
69,Bayesian,242,217,459,28,23,Player A
70,Bayesian,241,216,457,29,24,Player A
71,Bayesian,191,241,432,19,29,Bayesian
72,Bayesian,233,223,456,25,23,Player A
73,Bayesian,211,231,442,23,27,Bayesian
74,Bayesian,230,230,460,20,20,Tie
75,Bayesian,230,225,455,24,23,Player A
76,Bayesian,197,232,429,25,32,Bayesian
77,Bayesian,206,231,437,24,29,Bayesian
78,Bayesian,224,224,448,26,26,Tie
79,Bayesian,239,224,463,23,20,Player A
80,Bayesian,217,222,439,29,30,Bayesian
81,Bayesian,224,219,443,30,29,Player A
82,Bayesian,232,222,454,26,24,Player A
83,Bayesian,248,223,471,22,17,Player A
84,Bayesian,228,223,451,26,25,Player A
85,Bayesian,222,222,444,28,28,Tie
86,Bayesian,193,233,426,25,33,Bayesian
87,Bayesian,233,218,451,29,26,Player A
88,Bayesian,227,227,454,23,23,Tie
89,Bayesian,241,216,457,29,24,Player A
90,Bayesian,190,240,430,20,30,Bayesian
91,Bayesian,229,219,448,29,27,Player A
92,Bayesian,239,224,463,23,20,Player A
93,Bayesian,235,220,455,27,24,Player A
94,Bayesian,239,224,463,23,20,Player A
95,Bayesian,243,218,461,27,22,Player A
96,Bayesian,211,231,442,23,27,Bayesian
97,Bayesian,225,225,450,25,25,Tie
98,Bayesian,201,236,437,21,28,Bayesian
99,Bayesian,215,230,445,23,26,Bayesian
100,Bayesian,226,221,447,28,27,Player A
101,Bayesian,230,225,455,24,23,Player A
102,Bayesian,224,224,448,26,26,Tie
103,Bayesian,235,230,465,19,18,Player A
104,Bayesian,201,226,427,29,34,Bayesian
105,Bayesian,209,229,438,25,29,Bayesian
106,Bayesian,224,224,448,26,26,Tie
107,Bayesian,223,233,456,19,21,Bayesian
108,Bayesian,205,235,440,21,27,Bayesian
109,Bayesian,210,230,440,24,28,Bayesian
110,Bayesian,242,212,454,32,26,Player A
111,Bayesian,226,226,452,24,24,Tie
112,Bayesian,224,224,448,26,26,Tie
113,Bayesian,220,225,445,26,27,Bayesian
114,Bayesian,239,214,453,31,26,Player A
115,Bayesian,188,233,421,26,35,Bayesian
116,Bayesian,249,214,463,29,22,Player A
117,Bayesian,235,225,460,23,21,Player A
118,Bayesian,228,228,456,22,22,Tie
119,Bayesian,235,215,450,31,27,Player A
120,Bayesian,223,228,451,23,24,Bayesian
121,Bayesian,238,218,456,28,24,Player A
122,Bayesian,230,220,450,28,26,Player A
123,Bayesian,240,220,460,26,22,Player A
124,Bayesian,217,227,444,25,27,Bayesian
125,Bayesian,202,232,434,24,30,Bayesian
126,Bayesian,216,226,442,26,28,Bayesian
127,Bayesian,223,223,446,27,27,Tie
128,Bayesian,225,225,450,25,25,Tie
129,Bayesian,244,214,458,30,24,Player A
130,Bayesian,218,228,446,24,26,Bayesian
131,Bayesian,224,229,453,22,23,Bayesian
132,Bayesian,221,231,452,21,23,Bayesian
133,Bayesian,211,231,442,23,27,Bayesian
134,Bayesian,210,230,440,24,28,Bayesian
135,Bayesian,230,225,455,24,23,Player A
136,Bayesian,200,230,430,26,32,Bayesian
137,Bayesian,225,225,450,25,25,Tie
138,Bayesian,218,223,441,28,29,Bayesian
139,Bayesian,216,226,442,26,28,Bayesian
140,Bayesian,232,222,454,26,24,Player A
141,Bayesian,211,236,447,19,24,Bayesian
142,Bayesian,202,237,439,20,27,Bayesian
143,Bayesian,237,217,454,29,25,Player A
144,Bayesian,183,243,426,19,31,Bayesian
145,Bayesian,244,224,468,22,18,Player A
146,Bayesian,222,227,449,24,25,Bayesian
147,Bayesian,219,229,448,23,25,Bayesian
148,Bayesian,201,231,432,25,31,Bayesian
149,Bayesian,213,233,446,21,25,Bayesian
150,Bayesian,240,220,460,26,22,Player A
151,Bayesian,261,211,472,29,19,Player A
152,Bayesian,213,223,436,29,31,Bayesian
153,Bayesian,211,231,442,23,27,Bayesian
154,Bayesian,240,215,455,30,25,Player A
155,Bayesian,198,233,431,24,31,Bayesian
156,Bayesian,215,230,445,23,26,Bayesian
157,Bayesian,237,217,454,29,25,Player A
158,Bayesian,217,227,444,25,27,Bayesian
159,Bayesian,241,221,462,25,21,Player A
160,Bayesian,264,209,473,30,19,Player A
161,Bayesian,232,212,444,34,30,Player A
162,Bayesian,217,232,449,21,24,Bayesian
163,Bayesian,219,224,443,27,28,Bayesian
164,Bayesian,231,226,457,23,22,Player A
165,Bayesian,230,220,450,28,26,Player A
166,Bayesian,232,222,454,26,24,Player A
167,Bayesian,230,220,450,28,26,Player A
168,Bayesian,219,229,448,23,25,Bayesian
169,Bayesian,232,227,459,22,21,Player A
170,Bayesian,236,226,462,22,20,Player A
171,Bayesian,222,227,449,24,25,Bayesian
172,Bayesian,229,219,448,29,27,Player A
173,Bayesian,218,228,446,24,26,Bayesian
174,Bayesian,210,230,440,24,28,Bayesian
175,Bayesian,220,225,445,26,27,Bayesian
176,Bayesian,265,210,475,29,18,Player A
177,Bayesian,209,229,438,25,29,Bayesian
178,Bayesian,206,236,442,20,26,Bayesian
179,Bayesian,249,224,473,21,16,Player A
180,Bayesian,241,221,462,25,21,Player A
181,Bayesian,234,224,458,24,22,Player A
182,Bayesian,231,221,452,27,25,Player A
183,Bayesian,235,220,455,27,24,Player A
184,Bayesian,213,233,446,21,25,Bayesian
185,Bayesian,231,221,452,27,25,Player A
186,Bayesian,247,212,459,31,24,Player A
187,Bayesian,219,229,448,23,25,Bayesian
188,Bayesian,258,213,471,28,19,Player A
189,Bayesian,215,230,445,23,26,Bayesian
190,Bayesian,238,218,456,28,24,Player A
191,Bayesian,240,215,455,30,25,Player A
192,Bayesian,219,229,448,23,25,Bayesian
193,Bayesian,195,240,435,19,28,Bayesian
194,Bayesian,188,238,426,22,32,Bayesian
195,Bayesian,242,217,459,28,23,Player A
196,Bayesian,198,233,431,24,31,Bayesian
197,Bayesian,209,234,443,21,26,Bayesian
198,Bayesian,245,220,465,25,20,Player A
199,Bayesian,246,216,462,28,22,Player A
200,Bayesian,228,228,456,22,22,Tie
201,Bayesian,228,228,456,22,22,Tie
202,Bayesian,228,228,456,22,22,Tie
203,Bayesian,198,238,436,20,28,Bayesian
204,Bayesian,215,230,445,23,26,Bayesian
205,Bayesian,240,215,455,30,25,Player A
206,Bayesian,208,233,441,22,27,Bayesian
207,Bayesian,214,229,443,24,27,Bayesian
208,Bayesian,222,232,454,20,22,Bayesian
209,Bayesian,233,223,456,25,23,Player A
210,Bayesian,219,234,453,19,22,Bayesian
211,Bayesian,237,212,449,33,28,Player A
212,Bayesian,237,222,459,25,22,Player A
213,Bayesian,231,216,447,31,28,Player A
214,Bayesian,234,224,458,24,22,Player A
215,Bayesian,218,228,446,24,26,Bayesian
216,Bayesian,204,234,438,22,28,Bayesian
217,Bayesian,236,216,452,30,26,Player A
218,Bayesian,178,248,426,16,30,Bayesian
219,Bayesian,256,211,467,30,21,Player A
220,Bayesian,211,231,442,23,27,Bayesian
221,Bayesian,219,229,448,23,25,Bayesian
222,Bayesian,245,215,460,29,23,Player A
223,Bayesian,213,228,441,25,28,Bayesian
224,Bayesian,204,229,433,26,31,Bayesian
225,Bayesian,247,217,464,27,21,Player A
226,Bayesian,214,229,443,24,27,Bayesian
227,Bayesian,258,218,476,24,16,Player A
228,Bayesian,212,232,444,22,26,Bayesian
229,Bayesian,194,239,433,20,29,Bayesian
230,Bayesian,201,231,432,25,31,Bayesian
231,Bayesian,257,217,474,25,17,Player A
232,Bayesian,243,223,466,23,19,Player A
233,Bayesian,256,211,467,30,21,Player A
234,Bayesian,229,219,448,29,27,Player A
235,Bayesian,237,217,454,29,25,Player A
236,Bayesian,201,236,437,21,28,Bayesian
237,Bayesian,246,221,467,24,19,Player A
238,Bayesian,240,220,460,26,22,Player A
239,Bayesian,211,231,442,23,27,Bayesian
240,Bayesian,261,206,467,33,22,Player A
241,Bayesian,249,214,463,29,22,Player A
242,Bayesian,188,238,426,22,32,Bayesian
243,Bayesian,253,213,466,29,21,Player A
244,Bayesian,218,223,441,28,29,Bayesian
245,Bayesian,216,226,442,26,28,Bayesian
246,Bayesian,222,222,444,28,28,Tie
247,Bayesian,254,214,468,28,20,Player A
248,Bayesian,251,216,467,27,20,Player A
249,Bayesian,200,235,435,22,29,Bayesian
250,Bayesian,199,234,433,23,30,Bayesian
251,Bayesian,205,240,445,17,24,Bayesian
252,Bayesian,224,229,453,22,23,Bayesian
253,Bayesian,246,221,467,24,19,Player A
254,Bayesian,248,208,456,34,26,Player A
255,Bayesian,243,218,461,27,22,Player A
256,Bayesian,203,228,431,27,32,Bayesian
257,Bayesian,218,228,446,24,26,Bayesian
258,Bayesian,205,230,435,25,30,Bayesian
259,Bayesian,230,220,450,28,26,Player A
260,Bayesian,229,224,453,25,24,Player A
261,Bayesian,239,219,458,27,23,Player A
262,Bayesian,197,237,434,21,29,Bayesian
263,Bayesian,238,218,456,28,24,Player A
264,Bayesian,220,225,445,26,27,Bayesian
265,Bayesian,202,242,444,16,24,Bayesian
266,Bayesian,201,231,432,25,31,Bayesian
267,Bayesian,241,226,467,21,18,Player A
268,Bayesian,230,225,455,24,23,Player A
269,Bayesian,271,206,477,31,18,Player A
270,Bayesian,205,230,435,25,30,Bayesian
271,Bayesian,229,224,453,25,24,Player A
272,Bayesian,210,235,445,20,25,Bayesian
273,Bayesian,220,225,445,26,27,Bayesian
274,Bayesian,241,226,467,21,18,Player A
275,Bayesian,197,237,434,21,29,Bayesian
276,Bayesian,219,234,453,19,22,Bayesian
277,Bayesian,234,219,453,28,25,Player A
278,Bayesian,193,233,426,25,33,Bayesian
279,Bayesian,244,219,463,26,21,Player A
280,Bayesian,247,207,454,35,27,Player A
281,Bayesian,215,235,450,19,23,Bayesian
282,Bayesian,188,243,431,18,29,Bayesian
283,Bayesian,239,224,463,23,20,Player A
284,Bayesian,216,231,447,22,25,Bayesian
285,Bayesian,238,213,451,32,27,Player A
286,Bayesian,221,231,452,21,23,Bayesian
287,Bayesian,237,222,459,25,22,Player A
288,Bayesian,250,215,465,28,21,Player A
289,Bayesian,195,240,435,19,28,Bayesian
290,Bayesian,254,209,463,32,23,Player A
291,Bayesian,237,217,454,29,25,Player A
292,Bayesian,234,219,453,28,25,Player A
293,Bayesian,252,217,469,26,19,Player A
294,Bayesian,232,217,449,30,27,Player A
295,Bayesian,244,219,463,26,21,Player A
296,Bayesian,259,214,473,27,18,Player A
297,Bayesian,238,218,456,28,24,Player A
298,Bayesian,227,227,454,23,23,Tie
299,Bayesian,210,235,445,20,25,Bayesian
300,Bayesian,234,219,453,28,25,Player A
301,Bayesian,247,212,459,31,24,Player A
302,Bayesian,236,221,457,26,23,Player A
303,Bayesian,232,222,454,26,24,Player A
304,Bayesian,240,215,455,30,25,Player A
305,Bayesian,214,229,443,24,27,Bayesian
306,Bayesian,240,220,460,26,22,Player A
307,Bayesian,229,219,448,29,27,Player A
308,Bayesian,212,232,444,22,26,Bayesian
309,Bayesian,228,223,451,26,25,Player A
310,Bayesian,211,226,437,27,30,Bayesian
311,Bayesian,231,226,457,23,22,Player A
312,Bayesian,227,227,454,23,23,Tie
313,Bayesian,255,215,470,27,19,Player A
314,Bayesian,230,225,455,24,23,Player A
0,UCBPlayer,81,286,367,5,46,UCBPlayer
1,UCBPlayer,81,286,367,5,46,UCBPlayer
2,UCBPlayer,81,286,367,5,46,UCBPlayer
3,UCBPlayer,81,286,367,5,46,UCBPlayer
4,UCBPlayer,81,286,367,5,46,UCBPlayer
5,UCBPlayer,81,286,367,5,46,UCBPlayer
6,UCBPlayer,81,286,367,5,46,UCBPlayer
7,UCBPlayer,81,286,367,5,46,UCBPlayer
8,UCBPlayer,81,286,367,5,46,UCBPlayer
9,UCBPlayer,81,286,367,5,46,UCBPlayer
10,UCBPlayer,81,286,367,5,46,UCBPlayer
0,JointPQPlayer,314,184,498,40,14,Player A
1,JointPQPlayer,292,197,489,34,15,Player A
2,JointPQPlayer,304,189,493,38,15,Player A
3,JointPQPlayer,303,193,496,35,13,Player A
4,JointPQPlayer,261,211,472,29,19,Player A
5,JointPQPlayer,318,193,511,32,7,Player A
6,JointPQPlayer,275,200,475,35,20,Player A
7,JointPQPlayer,139,259,398,15,39,JointPQPlayer
8,JointPQPlayer,273,203,476,33,19,Player A
9,JointPQPlayer,311,186,497,39,14,Player A
10,JointPQPlayer,235,220,455,27,24,Player A
11,JointPQPlayer,291,196,487,35,16,Player A
12,JointPQPlayer,297,197,494,33,13,Player A
13,JointPQPlayer,151,256,407,15,36,JointPQPlayer
14,JointPQPlayer,130,265,395,12,39,JointPQPlayer
15,JointPQPlayer,127,267,394,11,39,JointPQPlayer
16,JointPQPlayer,294,194,488,36,16,Player A
17,JointPQPlayer,165,250,415,17,34,JointPQPlayer
18,JointPQPlayer,147,257,404,15,37,JointPQPlayer
19,JointPQPlayer,274,204,478,32,18,Player A
20,JointPQPlayer,306,191,497,36,13,Player A
21,JointPQPlayer,150,255,405,16,37,JointPQPlayer
22,JointPQPlayer,330,180,510,40,10,Player A
23,JointPQPlayer,155,260,415,11,32,JointPQPlayer
24,JointPQPlayer,295,195,490,35,15,Player A
25,JointPQPlayer,301,191,492,37,15,Player A
26,JointPQPlayer,309,189,498,37,13,Player A
27,JointPQPlayer,323,183,506,39,11,Player A
28,JointPQPlayer,322,182,504,40,12,Player A
29,JointPQPlayer,173,248,421,17,32,JointPQPlayer
30,JointPQPlayer,153,258,411,13,34,JointPQPlayer
31,JointPQPlayer,240,220,460,26,22,Player A
32,JointPQPlayer,285,200,485,33,16,Player A
33,JointPQPlayer,279,199,478,35,19,Player A
34,JointPQPlayer,311,191,502,35,11,Player A
35,JointPQPlayer,151,261,412,11,33,JointPQPlayer
36,JointPQPlayer,305,195,500,33,11,Player A
37,JointPQPlayer,293,193,486,37,17,Player A
38,JointPQPlayer,308,188,496,38,14,Player A
39,JointPQPlayer,144,259,403,14,37,JointPQPlayer
40,JointPQPlayer,292,197,489,34,15,Player A
41,JointPQPlayer,311,186,497,39,14,Player A
42,JointPQPlayer,270,205,475,32,19,Player A
43,JointPQPlayer,288,203,491,30,13,Player A
44,JointPQPlayer,317,187,504,37,11,Player A
45,JointPQPlayer,296,196,492,34,14,Player A
46,JointPQPlayer,293,193,486,37,17,Player A
47,JointPQPlayer,306,191,497,36,13,Player A
48,JointPQPlayer,267,207,474,31,19,Player A
49,JointPQPlayer,298,193,491,36,15,Player A
50,JointPQPlayer,187,242,429,19,30,JointPQPlayer
51,JointPQPlayer,243,223,466,23,19,Player A
52,JointPQPlayer,291,196,487,35,16,Player A
53,JointPQPlayer,314,194,508,32,8,Player A
54,JointPQPlayer,299,189,488,39,17,Player A
55,JointPQPlayer,301,191,492,37,15,Player A
56,JointPQPlayer,276,206,482,30,16,Player A
57,JointPQPlayer,294,189,483,40,19,Player A
58,JointPQPlayer,148,258,406,14,36,JointPQPlayer
59,JointPQPlayer,297,192,489,37,16,Player A
60,JointPQPlayer,307,192,499,35,12,Player A
61,JointPQPlayer,147,257,404,15,37,JointPQPlayer
62,JointPQPlayer,304,189,493,38,15,Player A
63,JointPQPlayer,152,257,409,14,35,JointPQPlayer
64,JointPQPlayer,276,196,472,38,22,Player A
65,JointPQPlayer,293,193,486,37,17,Player A
66,JointPQPlayer,127,262,389,15,42,JointPQPlayer
67,JointPQPlayer,281,201,482,33,17,Player A
68,JointPQPlayer,276,206,482,30,16,Player A
69,JointPQPlayer,273,203,476,33,19,Player A
70,JointPQPlayer,341,181,522,37,5,Player A
71,JointPQPlayer,313,188,501,37,12,Player A
72,JointPQPlayer,283,198,481,35,18,Player A
73,JointPQPlayer,264,204,468,34,22,Player A
74,JointPQPlayer,258,213,471,28,19,Player A
75,JointPQPlayer,280,200,480,34,18,Player A
76,JointPQPlayer,308,188,496,38,14,Player A
77,JointPQPlayer,298,193,491,36,15,Player A
78,JointPQPlayer,153,258,411,13,34,JointPQPlayer
79,JointPQPlayer,282,197,479,36,19,Player A
80,JointPQPlayer,291,196,487,35,16,Player A
81,JointPQPlayer,298,193,491,36,15,Player A
82,JointPQPlayer,312,187,499,38,13,Player A
83,JointPQPlayer,289,199,488,33,15,Player A
84,JointPQPlayer,156,251,407,18,37,JointPQPlayer
85,JointPQPlayer,324,184,508,38,10,Player A
86,JointPQPlayer,251,216,467,27,20,Player A
87,JointPQPlayer,239,219,458,27,23,Player A
88,JointPQPlayer,219,229,448,23,25,JointPQPlayer
89,JointPQPlayer,278,203,481,32,17,Player A
90,JointPQPlayer,299,194,493,35,14,Player A
91,JointPQPlayer,262,212,474,28,18,Player A
92,JointPQPlayer,278,203,481,32,17,Player A
93,JointPQPlayer,300,190,490,38,16,Player A
94,JointPQPlayer,299,199,498,31,11,Player A
95,JointPQPlayer,285,200,485,33,16,Player A
96,JointPQPlayer,231,226,457,23,22,Player A
97,JointPQPlayer,259,209,468,31,21,Player A
98,JointPQPlayer,271,201,472,35,21,Player A
99,JointPQPlayer,168,253,421,14,31,JointPQPlayer
100,JointPQPlayer,286,196,482,36,18,Player A
101,JointPQPlayer,261,206,467,33,22,Player A
102,JointPQPlayer,282,202,484,32,16,Player A
103,JointPQPlayer,297,197,494,33,13,Player A
104,JointPQPlayer,266,211,477,28,17,Player A
105,JointPQPlayer,293,198,491,33,14,Player A
106,JointPQPlayer,305,190,495,37,14,Player A
107,JointPQPlayer,152,257,409,14,35,JointPQPlayer
108,JointPQPlayer,297,192,489,37,16,Player A
109,JointPQPlayer,290,200,490,32,14,Player A
110,JointPQPlayer,304,189,493,38,15,Player A
111,JointPQPlayer,309,189,498,37,13,Player A
112,JointPQPlayer,145,260,405,13,36,JointPQPlayer
113,JointPQPlayer,279,194,473,39,22,Player A
114,JointPQPlayer,288,203,491,30,13,Player A
115,JointPQPlayer,284,199,483,34,17,Player A
116,JointPQPlayer,279,199,478,35,19,Player A
117,JointPQPlayer,240,215,455,30,25,Player A
118,JointPQPlayer,314,184,498,40,14,Player A
119,JointPQPlayer,311,186,497,39,14,Player A
120,JointPQPlayer,202,237,439,20,27,JointPQPlayer
121,JointPQPlayer,293,193,486,37,17,Player A
122,JointPQPlayer,276,206,482,30,16,Player A
123,JointPQPlayer,143,258,401,15,38,JointPQPlayer
124,JointPQPlayer,146,256,402,16,38,JointPQPlayer
125,JointPQPlayer,306,196,502,32,10,Player A
126,JointPQPlayer,320,190,510,34,8,Player A
127,JointPQPlayer,214,229,443,24,27,JointPQPlayer
128,JointPQPlayer,257,212,469,29,20,Player A
129,JointPQPlayer,317,182,499,41,14,Player A
130,JointPQPlayer,282,197,479,36,19,Player A
131,JointPQPlayer,301,191,492,37,15,Player A
132,JointPQPlayer,296,191,487,38,17,Player A
133,JointPQPlayer,268,208,476,30,18,Player A
134,JointPQPlayer,278,203,481,32,17,Player A
135,JointPQPlayer,314,189,503,36,11,Player A
136,JointPQPlayer,307,187,494,39,15,Player A
137,JointPQPlayer,129,269,398,9,37,JointPQPlayer
138,JointPQPlayer,272,207,479,30,17,Player A
139,JointPQPlayer,169,249,418,17,33,JointPQPlayer
140,JointPQPlayer,308,188,496,38,14,Player A
141,JointPQPlayer,324,184,508,38,10,Player A
142,JointPQPlayer,290,200,490,32,14,Player A
143,JointPQPlayer,280,200,480,34,18,Player A
144,JointPQPlayer,311,191,502,35,11,Player A
145,JointPQPlayer,122,267,389,12,41,JointPQPlayer
146,JointPQPlayer,303,188,491,39,16,Player A
147,JointPQPlayer,272,202,474,34,20,Player A
148,JointPQPlayer,286,196,482,36,18,Player A
149,JointPQPlayer,269,209,478,29,17,Player A
150,JointPQPlayer,306,191,497,36,13,Player A
151,JointPQPlayer,318,183,501,40,13,Player A
152,JointPQPlayer,285,200,485,33,16,Player A
153,JointPQPlayer,295,195,490,35,15,Player A
154,JointPQPlayer,285,200,485,33,16,Player A
155,JointPQPlayer,251,211,462,31,23,Player A
156,JointPQPlayer,146,256,402,16,38,JointPQPlayer
157,JointPQPlayer,268,203,471,34,21,Player A
158,JointPQPlayer,291,201,492,31,13,Player A
159,JointPQPlayer,274,199,473,36,21,Player A
160,JointPQPlayer,307,192,499,35,12,Player A
161,JointPQPlayer,136,261,397,14,39,JointPQPlayer
162,JointPQPlayer,255,215,470,27,19,Player A
163,JointPQPlayer,275,205,480,31,17,Player A
164,JointPQPlayer,254,214,468,28,20,Player A
165,JointPQPlayer,301,196,497,33,12,Player A
166,JointPQPlayer,279,204,483,31,16,Player A
167,JointPQPlayer,171,251,422,15,31,JointPQPlayer
168,JointPQPlayer,301,196,497,33,12,Player A
169,JointPQPlayer,295,195,490,35,15,Player A
170,JointPQPlayer,276,206,482,30,16,Player A
171,JointPQPlayer,141,256,397,17,40,JointPQPlayer
172,JointPQPlayer,309,189,498,37,13,Player A
173,JointPQPlayer,287,197,484,35,17,Player A
174,JointPQPlayer,269,209,478,29,17,Player A
175,JointPQPlayer,144,264,408,10,34,JointPQPlayer
176,JointPQPlayer,226,221,447,28,27,Player A
177,JointPQPlayer,139,259,398,15,39,JointPQPlayer
178,JointPQPlayer,288,193,481,38,19,Player A
179,JointPQPlayer,288,193,481,38,19,Player A
180,JointPQPlayer,155,250,405,19,38,JointPQPlayer
181,JointPQPlayer,271,206,477,31,18,Player A
182,JointPQPlayer,297,192,489,37,16,Player A
183,JointPQPlayer,156,251,407,18,37,JointPQPlayer
184,JointPQPlayer,112,272,384,10,42,JointPQPlayer
185,JointPQPlayer,268,208,476,30,18,Player A
186,JointPQPlayer,150,260,410,12,34,JointPQPlayer
187,JointPQPlayer,285,195,480,37,19,Player A
188,JointPQPlayer,139,264,403,11,36,JointPQPlayer
189,JointPQPlayer,145,255,400,17,39,JointPQPlayer
190,JointPQPlayer,285,195,480,37,19,Player A
191,JointPQPlayer,292,197,489,34,15,Player A
192,JointPQPlayer,251,216,467,27,20,Player A
193,JointPQPlayer,296,196,492,34,14,Player A
194,JointPQPlayer,255,215,470,27,19,Player A
195,JointPQPlayer,162,257,419,12,31,JointPQPlayer
196,JointPQPlayer,289,194,483,37,18,Player A
197,JointPQPlayer,314,189,503,36,11,Player A
198,JointPQPlayer,267,207,474,31,19,Player A
199,JointPQPlayer,157,257,414,13,33,JointPQPlayer
200,JointPQPlayer,295,190,485,39,18,Player A
201,JointPQPlayer,161,256,417,13,32,JointPQPlayer
202,JointPQPlayer,299,194,493,35,14,Player A
203,JointPQPlayer,295,195,490,35,15,Player A
204,JointPQPlayer,197,237,434,21,29,JointPQPlayer
205,JointPQPlayer,223,223,446,27,27,Tie
206,JointPQPlayer,283,198,481,35,18,Player A
207,JointPQPlayer,153,253,406,17,37,JointPQPlayer
208,JointPQPlayer,301,196,497,33,12,Player A
209,JointPQPlayer,282,202,484,32,16,Player A
210,JointPQPlayer,315,190,505,35,10,Player A
211,JointPQPlayer,282,202,484,32,16,Player A
212,JointPQPlayer,294,194,488,36,16,Player A
213,JointPQPlayer,286,201,487,32,15,Player A
214,JointPQPlayer,325,185,510,37,9,Player A
215,JointPQPlayer,280,200,480,34,18,Player A
216,JointPQPlayer,287,202,489,31,14,Player A
217,JointPQPlayer,289,199,488,33,15,Player A
218,JointPQPlayer,292,192,484,38,18,Player A
219,JointPQPlayer,292,197,489,34,15,Player A
220,JointPQPlayer,138,258,396,16,40,JointPQPlayer
221,JointPQPlayer,147,262,409,11,34,JointPQPlayer
222,JointPQPlayer,298,198,496,32,12,Player A
223,JointPQPlayer,292,197,489,34,15,Player A
224,JointPQPlayer,155,250,405,19,38,JointPQPlayer
225,JointPQPlayer,319,184,503,39,12,Player A
226,JointPQPlayer,171,246,417,19,34,JointPQPlayer
227,JointPQPlayer,294,194,488,36,16,Player A
228,JointPQPlayer,249,214,463,29,22,Player A
229,JointPQPlayer,288,198,486,34,16,Player A
230,JointPQPlayer,303,188,491,39,16,Player A
231,JointPQPlayer,284,204,488,30,14,Player A
232,JointPQPlayer,212,227,439,26,29,JointPQPlayer
233,JointPQPlayer,178,248,426,16,30,JointPQPlayer
234,JointPQPlayer,152,252,404,18,38,JointPQPlayer
235,JointPQPlayer,314,194,508,32,8,Player A
236,JointPQPlayer,213,228,441,25,28,JointPQPlayer
237,JointPQPlayer,285,200,485,33,16,Player A
238,JointPQPlayer,283,198,481,35,18,Player A
239,JointPQPlayer,264,209,473,30,19,Player A
240,JointPQPlayer,289,199,488,33,15,Player A
241,JointPQPlayer,290,195,485,36,17,Player A
242,JointPQPlayer,141,266,407,9,34,JointPQPlayer
243,JointPQPlayer,168,248,416,18,34,JointPQPlayer
244,JointPQPlayer,310,190,500,36,12,Player A
245,JointPQPlayer,298,193,491,36,15,Player A
246,JointPQPlayer,251,211,462,31,23,Player A
247,JointPQPlayer,269,204,473,33,20,Player A
248,JointPQPlayer,142,257,399,16,39,JointPQPlayer
249,JointPQPlayer,283,198,481,35,18,Player A
250,JointPQPlayer,306,191,497,36,13,Player A
251,JointPQPlayer,303,193,496,35,13,Player A
252,JointPQPlayer,295,200,495,31,12,Player A
253,JointPQPlayer,145,260,405,13,36,JointPQPlayer
254,JointPQPlayer,303,193,496,35,13,Player A
255,JointPQPlayer,300,190,490,38,16,Player A
256,JointPQPlayer,185,240,425,21,32,JointPQPlayer
257,JointPQPlayer,263,213,476,27,17,Player A
258,JointPQPlayer,147,262,409,11,34,JointPQPlayer
259,JointPQPlayer,311,186,497,39,14,Player A
260,JointPQPlayer,158,258,416,12,32,JointPQPlayer
261,JointPQPlayer,316,186,502,38,12,Player A
262,JointPQPlayer,152,262,414,10,32,JointPQPlayer
263,JointPQPlayer,328,178,506,42,12,Player A
264,JointPQPlayer,264,209,473,30,19,Player A
265,JointPQPlayer,156,256,412,14,34,JointPQPlayer
266,JointPQPlayer,310,195,505,32,9,Player A
267,JointPQPlayer,310,180,490,44,18,Player A
268,JointPQPlayer,288,193,481,38,19,Player A
269,JointPQPlayer,206,236,442,20,26,JointPQPlayer
270,JointPQPlayer,174,244,418,20,34,JointPQPlayer
271,JointPQPlayer,289,194,483,37,18,Player A
272,JointPQPlayer,311,181,492,43,17,Player A
273,JointPQPlayer,156,251,407,18,37,JointPQPlayer
274,JointPQPlayer,282,197,479,36,19,Player A
275,JointPQPlayer,265,210,475,29,18,Player A
276,JointPQPlayer,314,184,498,40,14,Player A
277,JointPQPlayer,298,193,491,36,15,Player A
278,JointPQPlayer,264,209,473,30,19,Player A
279,JointPQPlayer,291,196,487,35,16,Player A
280,JointPQPlayer,276,201,477,34,19,Player A
281,JointPQPlayer,232,212,444,34,30,Player A
282,JointPQPlayer,285,205,490,29,13,Player A
283,JointPQPlayer,313,188,501,37,12,Player A
284,JointPQPlayer,290,205,495,28,11,Player A
285,JointPQPlayer,298,198,496,32,12,Player A
286,JointPQPlayer,296,196,492,34,14,Player A
287,JointPQPlayer,323,183,506,39,11,Player A
288,JointPQPlayer,291,196,487,35,16,Player A
289,JointPQPlayer,245,215,460,29,23,Player A
290,JointPQPlayer,279,209,488,27,13,Player A
291,JointPQPlayer,305,195,500,33,11,Player A
292,JointPQPlayer,159,259,418,11,31,JointPQPlayer
293,JointPQPlayer,289,199,488,33,15,Player A
294,JointPQPlayer,310,185,495,40,15,Player A
295,JointPQPlayer,184,244,428,18,30,JointPQPlayer
296,JointPQPlayer,307,192,499,35,12,Player A
297,JointPQPlayer,156,256,412,14,34,JointPQPlayer
298,JointPQPlayer,298,188,486,40,18,Player A
299,JointPQPlayer,315,185,500,39,13,Player A
300,JointPQPlayer,303,193,496,35,13,Player A
301,JointPQPlayer,285,195,480,37,19,Player A
302,JointPQPlayer,299,194,493,35,14,Player A
303,JointPQPlayer,304,194,498,34,12,Player A
304,JointPQPlayer,297,197,494,33,13,Player A
305,JointPQPlayer,318,188,506,36,10,Player A
306,JointPQPlayer,308,193,501,34,11,Player A
307,JointPQPlayer,304,194,498,34,12,Player A
308,JointPQPlayer,259,209,468,31,21,Player A
309,JointPQPlayer,271,211,482,27,15,Player A
310,JointPQPlayer,272,207,479,30,17,Player A
311,JointPQPlayer,281,201,482,33,17,Player A
312,JointPQPlayer,336,181,517,38,7,Player A
313,JointPQPlayer,313,188,501,37,12,Player A
314,JointPQPlayer,271,206,477,31,18,Player A
315,JointPQPlayer,266,201,467,36,23,Player A
316,JointPQPlayer,286,201,487,32,15,Player A
317,JointPQPlayer,307,187,494,39,15,Player A
318,JointPQPlayer,170,250,420,16,32,JointPQPlayer
319,JointPQPlayer,299,184,483,43,20,Player A
320,JointPQPlayer,273,203,476,33,19,Player A
321,JointPQPlayer,120,265,385,14,43,JointPQPlayer
322,JointPQPlayer,289,199,488,33,15,Player A
323,JointPQPlayer,310,185,495,40,15,Player A
324,JointPQPlayer,138,263,401,12,37,JointPQPlayer
325,JointPQPlayer,303,188,491,39,16,Player A
326,JointPQPlayer,306,191,497,36,13,Player A
327,JointPQPlayer,306,191,497,36,13,Player A
328,JointPQPlayer,311,191,502,35,11,Player A
329,JointPQPlayer,289,194,483,37,18,Player A
330,JointPQPlayer,288,198,486,34,16,Player A
331,JointPQPlayer,306,191,497,36,13,Player A
332,JointPQPlayer,291,191,482,39,19,Player A
333,JointPQPlayer,274,204,478,32,18,Player A
334,JointPQPlayer,129,264,393,13,40,JointPQPlayer
335,JointPQPlayer,300,195,495,34,13,Player A
336,JointPQPlayer,297,192,489,37,16,Player A
337,JointPQPlayer,290,195,485,36,17,Player A
338,JointPQPlayer,140,265,405,10,35,JointPQPlayer
339,JointPQPlayer,164,254,418,14,32,JointPQPlayer
340,JointPQPlayer,297,197,494,33,13,Player A
341,JointPQPlayer,299,194,493,35,14,Player A
342,JointPQPlayer,323,188,511,35,8,Player A
343,JointPQPlayer,292,197,489,34,15,Player A
344,JointPQPlayer,328,183,511,38,9,Player A
345,JointPQPlayer,265,210,475,29,18,Player A
346,JointPQPlayer,316,186,502,38,12,Player A
347,JointPQPlayer,252,217,469,26,19,Player A
348,JointPQPlayer,314,189,503,36,11,Player A
349,JointPQPlayer,277,207,484,29,15,Player A
350,JointPQPlayer,159,254,413,15,34,JointPQPlayer
351,JointPQPlayer,232,217,449,30,27,Player A
352,JointPQPlayer,259,209,468,31,21,Player A
353,JointPQPlayer,257,217,474,25,17,Player A
354,JointPQPlayer,209,229,438,25,29,JointPQPlayer
355,JointPQPlayer,273,203,476,33,19,Player A
356,JointPQPlayer,312,187,499,38,13,Player A
357,JointPQPlayer,192,242,434,18,28,JointPQPlayer
358,JointPQPlayer,255,210,465,31,22,Player A
359,JointPQPlayer,305,190,495,37,14,Player A
360,JointPQPlayer,283,198,481,35,18,Player A
361,JointPQPlayer,154,259,413,12,33,JointPQPlayer
362,JointPQPlayer,333,178,511,41,10,Player A
363,JointPQPlayer,282,202,484,32,16,Player A
364,JointPQPlayer,284,199,483,34,17,Player A
365,JointPQPlayer,233,218,451,29,26,Player A
366,JointPQPlayer,300,190,490,38,16,Player A
367,JointPQPlayer,312,187,499,38,13,Player A
368,JointPQPlayer,304,189,493,38,15,Player A
369,JointPQPlayer,277,207,484,29,15,Player A
370,JointPQPlayer,287,197,484,35,17,Player A
371,JointPQPlayer,226,221,447,28,27,Player A
372,JointPQPlayer,294,194,488,36,16,Player A
373,JointPQPlayer,314,189,503,36,11,Player A
374,JointPQPlayer,168,253,421,14,31,JointPQPlayer
375,JointPQPlayer,304,189,493,38,15,Player A
376,JointPQPlayer,160,255,415,14,33,JointPQPlayer
377,JointPQPlayer,293,193,486,37,17,Player A
378,JointPQPlayer,170,245,415,20,35,JointPQPlayer
379,JointPQPlayer,305,190,495,37,14,Player A
380,JointPQPlayer,269,209,478,29,17,Player A
381,JointPQPlayer,225,230,455,21,22,JointPQPlayer
382,JointPQPlayer,270,200,470,36,22,Player A
383,JointPQPlayer,278,198,476,36,20,Player A
384,JointPQPlayer,313,188,501,37,12,Player A
385,JointPQPlayer,293,198,491,33,14,Player A
386,JointPQPlayer,319,184,503,39,12,Player A
387,JointPQPlayer,308,193,501,34,11,Player A
388,JointPQPlayer,261,206,467,33,22,Player A
389,JointPQPlayer,301,196,497,33,12,Player A
390,JointPQPlayer,159,254,413,15,34,JointPQPlayer
391,JointPQPlayer,299,194,493,35,14,Player A
392,JointPQPlayer,178,248,426,16,30,JointPQPlayer
393,JointPQPlayer,118,263,381,16,45,JointPQPlayer
394,JointPQPlayer,269,209,478,29,17,Player A
395,JointPQPlayer,158,253,411,16,35,JointPQPlayer
396,JointPQPlayer,245,210,455,33,26,Player A
397,JointPQPlayer,297,197,494,33,13,Player A
398,JointPQPlayer,275,205,480,31,17,Player A
399,JointPQPlayer,147,257,404,15,37,JointPQPlayer
400,JointPQPlayer,309,189,498,37,13,Player A
401,JointPQPlayer,296,196,492,34,14,Player A
402,JointPQPlayer,248,208,456,34,26,Player A
403,JointPQPlayer,291,196,487,35,16,Player A
404,JointPQPlayer,303,193,496,35,13,Player A
405,JointPQPlayer,166,251,417,16,33,JointPQPlayer
406,JointPQPlayer,270,200,470,36,22,Player A
407,JointPQPlayer,274,209,483,28,15,Player A
408,JointPQPlayer,282,202,484,32,16,Player A
409,JointPQPlayer,307,192,499,35,12,Player A
410,JointPQPlayer,276,206,482,30,16,Player A
411,JointPQPlayer,295,195,490,35,15,Player A
412,JointPQPlayer,131,266,397,11,38,JointPQPlayer
413,JointPQPlayer,290,205,495,28,11,Player A
414,JointPQPlayer,286,201,487,32,15,Player A
415,JointPQPlayer,309,189,498,37,13,Player A
416,JointPQPlayer,302,192,494,36,14,Player A
417,JointPQPlayer,269,209,478,29,17,Player A
418,JointPQPlayer,207,232,439,23,28,JointPQPlayer
419,JointPQPlayer,312,187,499,38,13,Player A
420,JointPQPlayer,224,224,448,26,26,Tie
421,JointPQPlayer,308,188,496,38,14,Player A
422,JointPQPlayer,279,199,478,35,19,Player A
423,JointPQPlayer,295,195,490,35,15,Player A
424,JointPQPlayer,286,196,482,36,18,Player A
425,JointPQPlayer,230,225,455,24,23,Player A
426,JointPQPlayer,270,205,475,32,19,Player A
427,JointPQPlayer,301,186,487,41,18,Player A
428,JointPQPlayer,296,196,492,34,14,Player A
429,JointPQPlayer,280,200,480,34,18,Player A
430,JointPQPlayer,293,198,491,33,14,Player A
431,JointPQPlayer,301,191,492,37,15,Player A
432,JointPQPlayer,141,261,402,13,37,JointPQPlayer
433,JointPQPlayer,288,198,486,34,16,Player A
434,JointPQPlayer,306,191,497,36,13,Player A
435,JointPQPlayer,298,193,491,36,15,Player A
436,JointPQPlayer,130,265,395,12,39,JointPQPlayer
437,JointPQPlayer,311,191,502,35,11,Player A
438,JointPQPlayer,308,188,496,38,14,Player A
439,JointPQPlayer,308,188,496,38,14,Player A
440,JointPQPlayer,124,264,388,14,42,JointPQPlayer
441,JointPQPlayer,154,249,403,20,39,JointPQPlayer
442,JointPQPlayer,306,186,492,40,16,Player A
443,JointPQPlayer,289,199,488,33,15,Player A
444,JointPQPlayer,311,186,497,39,14,Player A
445,JointPQPlayer,201,236,437,21,28,JointPQPlayer
446,JointPQPlayer,290,195,485,36,17,Player A
447,JointPQPlayer,278,203,481,32,17,Player A
448,JointPQPlayer,292,192,484,38,18,Player A
449,JointPQPlayer,134,264,398,12,38,JointPQPlayer
450,JointPQPlayer,275,200,475,35,20,Player A
451,JointPQPlayer,146,261,407,12,35,JointPQPlayer
452,JointPQPlayer,279,194,473,39,22,Player A
453,JointPQPlayer,275,210,485,27,14,Player A
454,JointPQPlayer,288,198,486,34,16,Player A
455,JointPQPlayer,263,213,476,27,17,Player A
456,JointPQPlayer,306,191,497,36,13,Player A
457,JointPQPlayer,163,253,416,15,33,JointPQPlayer
458,JointPQPlayer,313,188,501,37,12,Player A
459,JointPQPlayer,164,254,418,14,32,JointPQPlayer
460,JointPQPlayer,262,212,474,28,18,Player A
461,JointPQPlayer,299,189,488,39,17,Player A
462,JointPQPlayer,149,259,408,13,35,JointPQPlayer
463,JointPQPlayer,123,268,391,11,40,JointPQPlayer
464,JointPQPlayer,317,187,504,37,11,Player A
465,JointPQPlayer,295,195,490,35,15,Player A
466,JointPQPlayer,281,196,477,37,20,Player A
467,JointPQPlayer,299,194,493,35,14,Player A
468,JointPQPlayer,307,192,499,35,12,Player A
469,JointPQPlayer,160,250,410,18,36,JointPQPlayer
470,JointPQPlayer,313,193,506,33,9,Player A
471,JointPQPlayer,148,258,406,14,36,JointPQPlayer
472,JointPQPlayer,298,193,491,36,15,Player A
473,JointPQPlayer,279,199,478,35,19,Player A
474,JointPQPlayer,279,204,483,31,16,Player A
475,JointPQPlayer,275,200,475,35,20,Player A
476,JointPQPlayer,132,262,394,14,40,JointPQPlayer
477,JointPQPlayer,279,199,478,35,19,Player A
478,JointPQPlayer,239,219,458,27,23,Player A
479,JointPQPlayer,271,206,477,31,18,Player A
480,JointPQPlayer,287,192,479,39,20,Player A
481,JointPQPlayer,266,211,477,28,17,Player A
482,JointPQPlayer,299,194,493,35,14,Player A
483,JointPQPlayer,299,189,488,39,17,Player A
484,JointPQPlayer,250,215,465,28,21,Player A
485,JointPQPlayer,274,204,478,32,18,Player A
486,JointPQPlayer,325,185,510,37,9,Player A
487,JointPQPlayer,135,265,400,11,37,JointPQPlayer
488,JointPQPlayer,266,206,472,32,20,Player A
489,JointPQPlayer,133,263,396,13,39,JointPQPlayer
490,JointPQPlayer,310,185,495,40,15,Player A
491,JointPQPlayer,144,264,408,10,34,JointPQPlayer
492,JointPQPlayer,131,266,397,11,38,JointPQPlayer
493,JointPQPlayer,133,263,396,13,39,JointPQPlayer
494,JointPQPlayer,314,184,498,40,14,Player A
495,JointPQPlayer,159,254,413,15,34,JointPQPlayer
496,JointPQPlayer,256,211,467,30,21,Player A
497,JointPQPlayer,296,196,492,34,14,Player A
498,JointPQPlayer,285,205,490,29,13,Player A
499,JointPQPlayer,139,264,403,11,36,JointPQPlayer
500,JointPQPlayer,269,204,473,33,20,Player A
501,JointPQPlayer,307,192,499,35,12,Player A
502,JointPQPlayer,284,199,483,34,17,Player A
503,JointPQPlayer,140,260,400,14,38,JointPQPlayer
504,JointPQPlayer,286,201,487,32,15,Player A
505,JointPQPlayer,284,204,488,30,14,Player A
506,JointPQPlayer,314,184,498,40,14,Player A
507,JointPQPlayer,147,257,404,15,37,JointPQPlayer
508,JointPQPlayer,293,193,486,37,17,Player A
509,JointPQPlayer,266,206,472,32,20,Player A
510,JointPQPlayer,256,216,472,26,18,Player A
511,JointPQPlayer,153,258,411,13,34,JointPQPlayer
512,JointPQPlayer,252,212,464,30,22,Player A
513,JointPQPlayer,265,210,475,29,18,Player A
514,JointPQPlayer,277,202,479,33,18,Player A
515,JointPQPlayer,311,191,502,35,11,Player A
516,JointPQPlayer,138,258,396,16,40,JointPQPlayer
517,JointPQPlayer,180,250,430,14,28,JointPQPlayer
518,JointPQPlayer,124,269,393,10,39,JointPQPlayer
519,JointPQPlayer,126,271,397,8,37,JointPQPlayer
520,JointPQPlayer,287,197,484,35,17,Player A
521,JointPQPlayer,328,183,511,38,9,Player A
522,JointPQPlayer,166,246,412,20,36,JointPQPlayer
523,JointPQPlayer,267,212,479,27,16,Player A
524,JointPQPlayer,266,211,477,28,17,Player A
525,JointPQPlayer,222,227,449,24,25,JointPQPlayer
526,JointPQPlayer,266,206,472,32,20,Player A
527,JointPQPlayer,295,195,490,35,15,Player A
528,JointPQPlayer,211,231,442,23,27,JointPQPlayer
529,JointPQPlayer,308,188,496,38,14,Player A
530,JointPQPlayer,149,259,408,13,35,JointPQPlayer
531,JointPQPlayer,314,184,498,40,14,Player A
532,JointPQPlayer,292,192,484,38,18,Player A
533,JointPQPlayer,205,235,440,21,27,JointPQPlayer
534,JointPQPlayer,292,197,489,34,15,Player A
535,JointPQPlayer,295,190,485,39,18,Player A
536,JointPQPlayer,292,192,484,38,18,Player A
537,JointPQPlayer,301,191,492,37,15,Player A
538,JointPQPlayer,163,248,411,19,36,JointPQPlayer
539,JointPQPlayer,297,192,489,37,16,Player A
540,JointPQPlayer,265,205,470,33,21,Player A
541,JointPQPlayer,304,194,498,34,12,Player A
542,JointPQPlayer,212,232,444,22,26,JointPQPlayer
543,JointPQPlayer,285,200,485,33,16,Player A
544,JointPQPlayer,289,194,483,37,18,Player A
545,JointPQPlayer,151,256,407,15,36,JointPQPlayer
546,JointPQPlayer,301,186,487,41,18,Player A
547,JointPQPlayer,273,208,481,29,16,Player A
548,JointPQPlayer,290,195,485,36,17,Player A
549,JointPQPlayer,282,202,484,32,16,Player A
550,JointPQPlayer,331,176,507,43,12,Player A
551,JointPQPlayer,279,204,483,31,16,Player A
552,JointPQPlayer,289,194,483,37,18,Player A
553,JointPQPlayer,270,210,480,28,16,Player A
554,JointPQPlayer,300,190,490,38,16,Player A
555,JointPQPlayer,284,199,483,34,17,Player A
556,JointPQPlayer,296,196,492,34,14,Player A
557,JointPQPlayer,138,268,406,8,34,JointPQPlayer
558,JointPQPlayer,299,189,488,39,17,Player A
559,JointPQPlayer,280,205,485,30,15,Player A
560,JointPQPlayer,292,197,489,34,15,Player A
561,JointPQPlayer,315,185,500,39,13,Player A
562,JointPQPlayer,278,198,476,36,20,Player A
563,JointPQPlayer,302,187,489,40,17,Player A
564,JointPQPlayer,163,253,416,15,33,JointPQPlayer
565,JointPQPlayer,136,261,397,14,39,JointPQPlayer
566,JointPQPlayer,313,188,501,37,12,Player A
567,JointPQPlayer,286,196,482,36,18,Player A
568,JointPQPlayer,293,198,491,33,14,Player A
569,JointPQPlayer,297,197,494,33,13,Player A
570,JointPQPlayer,280,200,480,34,18,Player A
571,JointPQPlayer,149,259,408,13,35,JointPQPlayer
572,JointPQPlayer,300,195,495,34,13,Player A
573,JointPQPlayer,307,192,499,35,12,Player A
574,JointPQPlayer,163,248,411,19,36,JointPQPlayer
575,JointPQPlayer,142,257,399,16,39,JointPQPlayer
576,JointPQPlayer,282,202,484,32,16,Player A
577,JointPQPlayer,134,264,398,12,38,JointPQPlayer
578,JointPQPlayer,307,187,494,39,15,Player A
579,JointPQPlayer,236,216,452,30,26,Player A
580,JointPQPlayer,291,196,487,35,16,Player A
581,JointPQPlayer,279,204,483,31,16,Player A
582,JointPQPlayer,309,189,498,37,13,Player A
583,JointPQPlayer,237,217,454,29,25,Player A
584,JointPQPlayer,295,200,495,31,12,Player A
585,JointPQPlayer,254,214,468,28,20,Player A
586,JointPQPlayer,162,247,409,20,37,JointPQPlayer
587,JointPQPlayer,163,253,416,15,33,JointPQPlayer
588,JointPQPlayer,156,256,412,14,34,JointPQPlayer
589,JointPQPlayer,292,197,489,34,15,Player A
590,JointPQPlayer,300,195,495,34,13,Player A
591,JointPQPlayer,139,264,403,11,36,JointPQPlayer
592,JointPQPlayer,231,221,452,27,25,Player A
593,JointPQPlayer,312,192,504,34,10,Player A
594,JointPQPlayer,275,205,480,31,17,Player A
595,JointPQPlayer,298,198,496,32,12,Player A
596,JointPQPlayer,278,203,481,32,17,Player A
597,JointPQPlayer,303,193,496,35,13,Player A
598,JointPQPlayer,273,203,476,33,19,Player A
599,JointPQPlayer,318,183,501,40,13,Player A
600,JointPQPlayer,287,202,489,31,14,Player A
601,JointPQPlayer,248,218,466,26,20,Player A
602,JointPQPlayer,323,188,511,35,8,Player A
603,JointPQPlayer,235,220,455,27,24,Player A
604,JointPQPlayer,298,188,486,40,18,Player A
605,JointPQPlayer,300,195,495,34,13,Player A
606,JointPQPlayer,287,202,489,31,14,Player A
607,JointPQPlayer,302,192,494,36,14,Player A
608,JointPQPlayer,157,252,409,17,36,JointPQPlayer
609,JointPQPlayer,190,245,435,16,27,JointPQPlayer
610,JointPQPlayer,273,208,481,29,16,Player A
611,JointPQPlayer,251,211,462,31,23,Player A
612,JointPQPlayer,320,185,505,38,11,Player A
613,JointPQPlayer,279,204,483,31,16,Player A
614,JointPQPlayer,324,184,508,38,10,Player A
615,JointPQPlayer,278,203,481,32,17,Player A
616,JointPQPlayer,295,195,490,35,15,Player A
617,JointPQPlayer,296,196,492,34,14,Player A
618,JointPQPlayer,281,201,482,33,17,Player A
619,JointPQPlayer,329,184,513,37,8,Player A
620,JointPQPlayer,137,262,399,13,38,JointPQPlayer
621,JointPQPlayer,306,186,492,40,16,Player A
622,JointPQPlayer,303,188,491,39,16,Player A
623,JointPQPlayer,284,199,483,34,17,Player A
624,JointPQPlayer,248,213,461,30,23,Player A
625,JointPQPlayer,308,193,501,34,11,Player A
626,JointPQPlayer,279,199,478,35,19,Player A
627,JointPQPlayer,300,185,485,42,19,Player A
628,JointPQPlayer,304,194,498,34,12,Player A
629,JointPQPlayer,170,250,420,16,32,JointPQPlayer
630,JointPQPlayer,139,264,403,11,36,JointPQPlayer
631,JointPQPlayer,250,220,470,24,18,Player A
632,JointPQPlayer,304,189,493,38,15,Player A
633,JointPQPlayer,205,240,445,17,24,JointPQPlayer
634,JointPQPlayer,164,254,418,14,32,JointPQPlayer
635,JointPQPlayer,294,199,493,32,13,Player A
636,JointPQPlayer,246,216,462,28,22,Player A
637,JointPQPlayer,304,194,498,34,12,Player A
638,JointPQPlayer,321,191,512,33,7,Player A
639,JointPQPlayer,137,262,399,13,38,JointPQPlayer
640,JointPQPlayer,258,208,466,32,22,Player A
641,JointPQPlayer,149,254,403,17,38,JointPQPlayer
642,JointPQPlayer,282,207,489,28,13,Player A
643,JointPQPlayer,229,224,453,25,24,Player A
644,JointPQPlayer,327,182,509,39,10,Player A
645,JointPQPlayer,283,198,481,35,18,Player A
646,JointPQPlayer,293,198,491,33,14,Player A
647,JointPQPlayer,305,190,495,37,14,Player A
648,JointPQPlayer,285,200,485,33,16,Player A
649,JointPQPlayer,267,207,474,31,19,Player A
650,JointPQPlayer,251,211,462,31,23,Player A
651,JointPQPlayer,129,269,398,9,37,JointPQPlayer
652,JointPQPlayer,161,251,412,17,35,JointPQPlayer
653,JointPQPlayer,282,197,479,36,19,Player A
654,JointPQPlayer,290,195,485,36,17,Player A
655,JointPQPlayer,151,256,407,15,36,JointPQPlayer
656,JointPQPlayer,262,207,469,32,21,Player A
657,JointPQPlayer,294,194,488,36,16,Player A
658,JointPQPlayer,313,193,506,33,9,Player A
659,JointPQPlayer,148,258,406,14,36,JointPQPlayer
660,JointPQPlayer,302,197,499,32,11,Player A
661,JointPQPlayer,306,186,492,40,16,Player A
662,JointPQPlayer,136,266,402,10,36,JointPQPlayer
663,JointPQPlayer,308,188,496,38,14,Player A
664,JointPQPlayer,149,259,408,13,35,JointPQPlayer
665,JointPQPlayer,270,200,470,36,22,Player A
666,JointPQPlayer,302,192,494,36,14,Player A
667,JointPQPlayer,153,253,406,17,37,JointPQPlayer
668,JointPQPlayer,156,256,412,14,34,JointPQPlayer
669,JointPQPlayer,273,198,471,37,22,Player A
670,JointPQPlayer,150,260,410,12,34,JointPQPlayer
671,JointPQPlayer,305,195,500,33,11,Player A
672,JointPQPlayer,304,184,488,42,18,Player A
673,JointPQPlayer,133,258,391,17,42,JointPQPlayer
674,JointPQPlayer,264,204,468,34,22,Player A
675,JointPQPlayer,293,198,491,33,14,Player A
676,JointPQPlayer,295,195,490,35,15,Player A
677,JointPQPlayer,275,205,480,31,17,Player A
678,JointPQPlayer,322,187,509,36,9,Player A
679,JointPQPlayer,297,197,494,33,13,Player A
680,JointPQPlayer,151,256,407,15,36,JointPQPlayer
681,JointPQPlayer,295,195,490,35,15,Player A
682,JointPQPlayer,313,188,501,37,12,Player A
683,JointPQPlayer,308,193,501,34,11,Player A
684,JointPQPlayer,317,187,504,37,11,Player A
685,JointPQPlayer,138,263,401,12,37,JointPQPlayer
686,JointPQPlayer,286,196,482,36,18,Player A
687,JointPQPlayer,176,241,417,22,35,JointPQPlayer
688,JointPQPlayer,270,200,470,36,22,Player A
689,JointPQPlayer,291,196,487,35,16,Player A
690,JointPQPlayer,271,211,482,27,15,Player A
691,JointPQPlayer,276,206,482,30,16,Player A
692,JointPQPlayer,142,262,404,12,36,JointPQPlayer
693,JointPQPlayer,282,202,484,32,16,Player A
694,JointPQPlayer,295,200,495,31,12,Player A
695,JointPQPlayer,306,191,497,36,13,Player A
696,JointPQPlayer,163,258,421,11,30,JointPQPlayer
697,JointPQPlayer,282,212,494,24,10,Player A
698,JointPQPlayer,273,203,476,33,19,Player A
699,JointPQPlayer,306,191,497,36,13,Player A
700,JointPQPlayer,240,215,455,30,25,Player A
701,JointPQPlayer,169,244,413,21,36,JointPQPlayer
702,JointPQPlayer,313,183,496,41,15,Player A
703,JointPQPlayer,249,214,463,29,22,Player A
704,JointPQPlayer,293,198,491,33,14,Player A
705,JointPQPlayer,290,195,485,36,17,Player A
706,JointPQPlayer,135,265,400,11,37,JointPQPlayer
707,JointPQPlayer,158,258,416,12,32,JointPQPlayer
708,JointPQPlayer,278,203,481,32,17,Player A
709,JointPQPlayer,207,232,439,23,28,JointPQPlayer
710,JointPQPlayer,270,205,475,32,19,Player A
711,JointPQPlayer,276,201,477,34,19,Player A
712,JointPQPlayer,256,211,467,30,21,Player A
713,JointPQPlayer,277,202,479,33,18,Player A
714,JointPQPlayer,221,226,447,25,26,JointPQPlayer
715,JointPQPlayer,309,194,503,33,10,Player A
716,JointPQPlayer,169,254,423,13,30,JointPQPlayer
717,JointPQPlayer,180,245,425,18,31,JointPQPlayer
718,JointPQPlayer,297,202,499,29,10,Player A
719,JointPQPlayer,275,205,480,31,17,Player A
720,JointPQPlayer,293,198,491,33,14,Player A
721,JointPQPlayer,241,216,457,29,24,Player A
722,JointPQPlayer,253,208,461,33,24,Player A
723,JointPQPlayer,289,199,488,33,15,Player A
724,JointPQPlayer,299,194,493,35,14,Player A
725,JointPQPlayer,266,206,472,32,20,Player A
726,JointPQPlayer,282,202,484,32,16,Player A
727,JointPQPlayer,299,199,498,31,11,Player A
728,JointPQPlayer,303,198,501,31,10,Player A
729,JointPQPlayer,292,192,484,38,18,Player A
730,JointPQPlayer,294,199,493,32,13,Player A
731,JointPQPlayer,133,263,396,13,39,JointPQPlayer
732,JointPQPlayer,295,195,490,35,15,Player A
733,JointPQPlayer,265,205,470,33,21,Player A
734,JointPQPlayer,302,192,494,36,14,Player A
735,JointPQPlayer,273,203,476,33,19,Player A
736,JointPQPlayer,136,261,397,14,39,JointPQPlayer
737,JointPQPlayer,181,246,427,17,30,JointPQPlayer
738,JointPQPlayer,304,194,498,34,12,Player A
739,JointPQPlayer,147,257,404,15,37,JointPQPlayer
740,JointPQPlayer,287,202,489,31,14,Player A
741,JointPQPlayer,294,194,488,36,16,Player A
742,JointPQPlayer,300,195,495,34,13,Player A
743,JointPQPlayer,293,193,486,37,17,Player A
744,JointPQPlayer,306,191,497,36,13,Player A
745,JointPQPlayer,296,191,487,38,17,Player A
746,JointPQPlayer,297,192,489,37,16,Player A
747,JointPQPlayer,292,197,489,34,15,Player A
748,JointPQPlayer,128,263,391,14,41,JointPQPlayer
749,JointPQPlayer,300,190,490,38,16,Player A
750,JointPQPlayer,294,194,488,36,16,Player A
751,JointPQPlayer,130,265,395,12,39,JointPQPlayer
752,JointPQPlayer,134,264,398,12,38,JointPQPlayer
753,JointPQPlayer,304,189,493,38,15,Player A
754,JointPQPlayer,144,259,403,14,37,JointPQPlayer
755,JointPQPlayer,146,256,402,16,38,JointPQPlayer
756,JointPQPlayer,309,189,498,37,13,Player A
757,JointPQPlayer,254,214,468,28,20,Player A
758,JointPQPlayer,163,248,411,19,36,JointPQPlayer
759,JointPQPlayer,295,195,490,35,15,Player A
760,JointPQPlayer,291,201,492,31,13,Player A
761,JointPQPlayer,293,198,491,33,14,Player A
762,JointPQPlayer,182,242,424,20,32,JointPQPlayer
763,JointPQPlayer,150,255,405,16,37,JointPQPlayer
764,JointPQPlayer,267,207,474,31,19,Player A
765,JointPQPlayer,152,257,409,14,35,JointPQPlayer
766,JointPQPlayer,277,202,479,33,18,Player A
767,JointPQPlayer,162,252,414,16,34,JointPQPlayer
768,JointPQPlayer,229,229,458,21,21,Tie
769,JointPQPlayer,302,197,499,32,11,Player A
770,JointPQPlayer,160,255,415,14,33,JointPQPlayer
771,JointPQPlayer,150,260,410,12,34,JointPQPlayer
772,JointPQPlayer,281,201,482,33,17,Player A
773,JointPQPlayer,271,206,477,31,18,Player A
774,JointPQPlayer,241,216,457,29,24,Player A
775,JointPQPlayer,273,203,476,33,19,Player A
776,JointPQPlayer,210,230,440,24,28,JointPQPlayer
777,JointPQPlayer,161,256,417,13,32,JointPQPlayer
778,JointPQPlayer,278,203,481,32,17,Player A
779,JointPQPlayer,293,198,491,33,14,Player A
780,JointPQPlayer,330,180,510,40,10,Player A
781,JointPQPlayer,297,192,489,37,16,Player A
782,JointPQPlayer,298,198,496,32,12,Player A
783,JointPQPlayer,301,191,492,37,15,Player A
784,JointPQPlayer,135,265,400,11,37,JointPQPlayer
785,JointPQPlayer,278,203,481,32,17,Player A
786,JointPQPlayer,281,206,487,29,14,Player A
787,JointPQPlayer,311,186,497,39,14,Player A
788,JointPQPlayer,326,181,507,40,11,Player A
789,JointPQPlayer,154,254,408,16,36,JointPQPlayer
790,JointPQPlayer,287,197,484,35,17,Player A
791,JointPQPlayer,244,214,458,30,24,Player A
792,JointPQPlayer,308,198,506,30,8,Player A
793,JointPQPlayer,297,197,494,33,13,Player A
794,JointPQPlayer,299,189,488,39,17,Player A
795,JointPQPlayer,287,197,484,35,17,Player A
796,JointPQPlayer,145,255,400,17,39,JointPQPlayer
797,JointPQPlayer,314,194,508,32,8,Player A
798,JointPQPlayer,157,252,409,17,36,JointPQPlayer
799,JointPQPlayer,313,188,501,37,12,Player A
800,JointPQPlayer,297,192,489,37,16,Player A
801,JointPQPlayer,318,188,506,36,10,Player A
802,JointPQPlayer,301,191,492,37,15,Player A
803,JointPQPlayer,294,199,493,32,13,Player A
804,JointPQPlayer,292,192,484,38,18,Player A
805,JointPQPlayer,310,190,500,36,12,Player A
806,JointPQPlayer,291,196,487,35,16,Player A
807,JointPQPlayer,164,249,413,18,35,JointPQPlayer
808,JointPQPlayer,319,184,503,39,12,Player A
809,JointPQPlayer,297,187,484,41,19,Player A
810,JointPQPlayer,166,251,417,16,33,JointPQPlayer
811,JointPQPlayer,293,198,491,33,14,Player A
812,JointPQPlayer,320,185,505,38,11,Player A
813,JointPQPlayer,281,201,482,33,17,Player A
814,JointPQPlayer,284,199,483,34,17,Player A
815,JointPQPlayer,305,190,495,37,14,Player A
816,JointPQPlayer,282,202,484,32,16,Player A
817,JointPQPlayer,310,190,500,36,12,Player A
818,JointPQPlayer,128,263,391,14,41,JointPQPlayer
819,JointPQPlayer,282,197,479,36,19,Player A
820,JointPQPlayer,164,259,423,10,29,JointPQPlayer
821,JointPQPlayer,319,189,508,35,9,Player A
822,JointPQPlayer,171,251,422,15,31,JointPQPlayer
823,JointPQPlayer,282,197,479,36,19,Player A
824,JointPQPlayer,272,202,474,34,20,Player A
825,JointPQPlayer,320,185,505,38,11,Player A
826,JointPQPlayer,257,207,464,33,23,Player A
827,JointPQPlayer,144,259,403,14,37,JointPQPlayer
828,JointPQPlayer,259,209,468,31,21,Player A
829,JointPQPlayer,241,211,452,33,27,Player A
830,JointPQPlayer,298,193,491,36,15,Player A
831,JointPQPlayer,306,186,492,40,16,Player A
832,JointPQPlayer,300,190,490,38,16,Player A
833,JointPQPlayer,314,194,508,32,8,Player A
834,JointPQPlayer,246,211,457,32,25,Player A
835,JointPQPlayer,273,203,476,33,19,Player A
836,JointPQPlayer,279,204,483,31,16,Player A
837,JointPQPlayer,303,193,496,35,13,Player A
838,JointPQPlayer,304,194,498,34,12,Player A
839,JointPQPlayer,285,200,485,33,16,Player A
840,JointPQPlayer,257,212,469,29,20,Player A
841,JointPQPlayer,323,188,511,35,8,Player A
842,JointPQPlayer,281,201,482,33,17,Player A
843,JointPQPlayer,305,190,495,37,14,Player A
844,JointPQPlayer,262,202,464,36,24,Player A
845,JointPQPlayer,283,203,486,31,15,Player A
846,JointPQPlayer,318,183,501,40,13,Player A
847,JointPQPlayer,287,197,484,35,17,Player A
848,JointPQPlayer,302,192,494,36,14,Player A
849,JointPQPlayer,310,185,495,40,15,Player A
850,JointPQPlayer,155,255,410,15,35,JointPQPlayer
851,JointPQPlayer,144,259,403,14,37,JointPQPlayer
852,JointPQPlayer,157,257,414,13,33,JointPQPlayer
853,JointPQPlayer,279,194,473,39,22,Player A
854,JointPQPlayer,275,195,470,39,23,Player A
855,JointPQPlayer,223,228,451,23,24,JointPQPlayer
856,JointPQPlayer,324,184,508,38,10,Player A
857,JointPQPlayer,147,262,409,11,34,JointPQPlayer
858,JointPQPlayer,305,190,495,37,14,Player A
859,JointPQPlayer,305,190,495,37,14,Player A
860,JointPQPlayer,305,195,500,33,11,Player A
861,JointPQPlayer,262,207,469,32,21,Player A
862,JointPQPlayer,263,208,471,31,20,Player A
863,JointPQPlayer,301,196,497,33,12,Player A
864,JointPQPlayer,300,195,495,34,13,Player A
865,JointPQPlayer,313,183,496,41,15,Player A
866,JointPQPlayer,269,204,473,33,20,Player A
867,JointPQPlayer,285,200,485,33,16,Player A
868,JointPQPlayer,313,178,491,45,18,Player A
869,JointPQPlayer,301,196,497,33,12,Player A
870,JointPQPlayer,263,208,471,31,20,Player A
871,JointPQPlayer,313,183,496,41,15,Player A
872,JointPQPlayer,273,203,476,33,19,Player A
873,JointPQPlayer,259,214,473,27,18,Player A
874,JointPQPlayer,274,209,483,28,15,Player A
875,JointPQPlayer,291,201,492,31,13,Player A
876,JointPQPlayer,167,247,414,19,35,JointPQPlayer
877,JointPQPlayer,157,257,414,13,33,JointPQPlayer
878,JointPQPlayer,307,192,499,35,12,Player A
879,JointPQPlayer,279,209,488,27,13,Player A
880,JointPQPlayer,290,205,495,28,11,Player A
881,JointPQPlayer,278,203,481,32,17,Player A
882,JointPQPlayer,287,197,484,35,17,Player A
883,JointPQPlayer,270,205,475,32,19,Player A
884,JointPQPlayer,291,196,487,35,16,Player A
885,JointPQPlayer,127,267,394,11,39,JointPQPlayer
886,JointPQPlayer,210,230,440,24,28,JointPQPlayer
887,JointPQPlayer,147,262,409,11,34,JointPQPlayer
888,JointPQPlayer,265,205,470,33,21,Player A
889,JointPQPlayer,262,207,469,32,21,Player A
890,JointPQPlayer,301,201,502,29,9,Player A
891,JointPQPlayer,268,208,476,30,18,Player A
892,JointPQPlayer,130,265,395,12,39,JointPQPlayer
893,JointPQPlayer,283,203,486,31,15,Player A
894,JointPQPlayer,333,178,511,41,10,Player A
895,JointPQPlayer,287,197,484,35,17,Player A
896,JointPQPlayer,269,209,478,29,17,Player A
897,JointPQPlayer,330,180,510,40,10,Player A
898,JointPQPlayer,320,185,505,38,11,Player A
899,JointPQPlayer,162,252,414,16,34,JointPQPlayer
900,JointPQPlayer,312,192,504,34,10,Player A
901,JointPQPlayer,312,187,499,38,13,Player A
902,JointPQPlayer,283,198,481,35,18,Player A
903,JointPQPlayer,311,191,502,35,11,Player A
904,JointPQPlayer,129,264,393,13,40,JointPQPlayer
905,JointPQPlayer,275,200,475,35,20,Player A
906,JointPQPlayer,255,210,465,31,22,Player A
907,JointPQPlayer,294,199,493,32,13,Player A
908,JointPQPlayer,274,209,483,28,15,Player A
909,JointPQPlayer,140,260,400,14,38,JointPQPlayer
910,JointPQPlayer,273,203,476,33,19,Player A
911,JointPQPlayer,277,207,484,29,15,Player A
912,JointPQPlayer,305,195,500,33,11,Player A
913,JointPQPlayer,149,259,408,13,35,JointPQPlayer
914,JointPQPlayer,128,268,396,10,38,JointPQPlayer
915,JointPQPlayer,318,188,506,36,10,Player A
916,JointPQPlayer,267,212,479,27,16,Player A
917,JointPQPlayer,162,252,414,16,34,JointPQPlayer
918,JointPQPlayer,147,267,414,7,31,JointPQPlayer
919,JointPQPlayer,290,195,485,36,17,Player A
920,JointPQPlayer,281,201,482,33,17,Player A
921,JointPQPlayer,311,191,502,35,11,Player A
922,JointPQPlayer,273,203,476,33,19,Player A
923,JointPQPlayer,236,226,462,22,20,Player A
924,JointPQPlayer,276,201,477,34,19,Player A
925,JointPQPlayer,299,194,493,35,14,Player A
926,JointPQPlayer,158,258,416,12,32,JointPQPlayer
927,JointPQPlayer,153,258,411,13,34,JointPQPlayer
928,JointPQPlayer,323,188,511,35,8,Player A
929,JointPQPlayer,279,199,478,35,19,Player A
930,JointPQPlayer,313,193,506,33,9,Player A
931,JointPQPlayer,266,211,477,28,17,Player A
932,JointPQPlayer,261,206,467,33,22,Player A
933,JointPQPlayer,296,196,492,34,14,Player A
934,JointPQPlayer,292,197,489,34,15,Player A
935,JointPQPlayer,158,258,416,12,32,JointPQPlayer
936,JointPQPlayer,301,191,492,37,15,Player A
937,JointPQPlayer,301,191,492,37,15,Player A
938,JointPQPlayer,281,201,482,33,17,Player A
939,JointPQPlayer,134,264,398,12,38,JointPQPlayer
940,JointPQPlayer,252,207,459,34,25,Player A
941,JointPQPlayer,300,190,490,38,16,Player A
942,JointPQPlayer,286,196,482,36,18,Player A
943,JointPQPlayer,322,182,504,40,12,Player A
944,JointPQPlayer,226,221,447,28,27,Player A
945,JointPQPlayer,283,203,486,31,15,Player A
946,JointPQPlayer,287,202,489,31,14,Player A
947,JointPQPlayer,157,252,409,17,36,JointPQPlayer
948,JointPQPlayer,328,183,511,38,9,Player A
949,JointPQPlayer,292,202,494,30,12,Player A
950,JointPQPlayer,300,195,495,34,13,Player A
951,JointPQPlayer,304,194,498,34,12,Player A
952,JointPQPlayer,322,187,509,36,9,Player A
953,JointPQPlayer,153,253,406,17,37,JointPQPlayer
954,JointPQPlayer,216,226,442,26,28,JointPQPlayer
955,JointPQPlayer,303,193,496,35,13,Player A
956,JointPQPlayer,267,202,469,35,22,Player A
957,JointPQPlayer,301,191,492,37,15,Player A
958,JointPQPlayer,151,256,407,15,36,JointPQPlayer
959,JointPQPlayer,303,188,491,39,16,Player A
960,JointPQPlayer,289,199,488,33,15,Player A
961,JointPQPlayer,291,196,487,35,16,Player A
962,JointPQPlayer,283,198,481,35,18,Player A
963,JointPQPlayer,254,209,463,32,23,Player A
964,JointPQPlayer,266,206,472,32,20,Player A
965,JointPQPlayer,127,267,394,11,39,JointPQPlayer
966,JointPQPlayer,151,256,407,15,36,JointPQPlayer
967,JointPQPlayer,316,186,502,38,12,Player A
968,JointPQPlayer,281,206,487,29,14,Player A
969,JointPQPlayer,296,196,492,34,14,Player A
970,JointPQPlayer,174,244,418,20,34,JointPQPlayer
971,JointPQPlayer,301,191,492,37,15,Player A
972,JointPQPlayer,168,253,421,14,31,JointPQPlayer
973,JointPQPlayer,251,211,462,31,23,Player A
974,JointPQPlayer,135,265,400,11,37,JointPQPlayer
975,JointPQPlayer,268,208,476,30,18,Player A
976,JointPQPlayer,277,207,484,29,15,Player A
977,JointPQPlayer,304,189,493,38,15,Player A
978,JointPQPlayer,313,188,501,37,12,Player A
979,JointPQPlayer,309,189,498,37,13,Player A
980,JointPQPlayer,266,206,472,32,20,Player A
981,JointPQPlayer,142,262,404,12,36,JointPQPlayer
982,JointPQPlayer,155,255,410,15,35,JointPQPlayer
983,JointPQPlayer,126,266,392,12,40,JointPQPlayer
984,JointPQPlayer,268,208,476,30,18,Player A
985,JointPQPlayer,162,252,414,16,34,JointPQPlayer
986,JointPQPlayer,309,184,493,41,16,Player A
987,JointPQPlayer,284,199,483,34,17,Player A
988,JointPQPlayer,305,185,490,41,17,Player A
989,JointPQPlayer,158,253,411,16,35,JointPQPlayer
990,JointPQPlayer,306,191,497,36,13,Player A
991,JointPQPlayer,311,191,502,35,11,Player A
992,JointPQPlayer,313,188,501,37,12,Player A
993,JointPQPlayer,284,194,478,38,20,Player A
994,JointPQPlayer,257,212,469,29,20,Player A
995,JointPQPlayer,288,198,486,34,16,Player A
996,JointPQPlayer,287,197,484,35,17,Player A
997,JointPQPlayer,136,261,397,14,39,JointPQPlayer
998,JointPQPlayer,228,223,451,26,25,Player A
999,JointPQPlayer,285,200,485,33,16,Player A
1000,JointPQPlayer,290,195,485,36,17,Player A
1001,JointPQPlayer,304,189,493,38,15,Player A
1002,JointPQPlayer,332,177,509,42,11,Player A
1003,JointPQPlayer,138,263,401,12,37,JointPQPlayer
1004,JointPQPlayer,283,198,481,35,18,Player A
1005,JointPQPlayer,296,191,487,38,17,Player A
1006,JointPQPlayer,272,197,469,38,23,Player A
1007,JointPQPlayer,151,251,402,19,39,JointPQPlayer
1008,JointPQPlayer,290,190,480,40,20,Player A
1009,JointPQPlayer,293,198,491,33,14,Player A
1010,JointPQPlayer,292,197,489,34,15,Player A
1011,JointPQPlayer,279,204,483,31,16,Player A
1012,JointPQPlayer,316,186,502,38,12,Player A
1013,JointPQPlayer,160,255,415,14,33,JointPQPlayer
1014,JointPQPlayer,302,192,494,36,14,Player A
1015,JointPQPlayer,287,202,489,31,14,Player A
1016,JointPQPlayer,275,200,475,35,20,Player A
1017,JointPQPlayer,310,190,500,36,12,Player A
1018,JointPQPlayer,312,187,499,38,13,Player A
1019,JointPQPlayer,298,193,491,36,15,Player A
1020,JointPQPlayer,157,252,409,17,36,JointPQPlayer
1021,JointPQPlayer,321,186,507,37,10,Player A
1022,JointPQPlayer,299,194,493,35,14,Player A
1023,JointPQPlayer,161,251,412,17,35,JointPQPlayer
1024,JointPQPlayer,159,259,418,11,31,JointPQPlayer
1025,JointPQPlayer,302,192,494,36,14,Player A
1026,JointPQPlayer,146,261,407,12,35,JointPQPlayer
1027,JointPQPlayer,164,254,418,14,32,JointPQPlayer
1028,JointPQPlayer,165,255,420,13,31,JointPQPlayer
1029,JointPQPlayer,169,249,418,17,33,JointPQPlayer
1030,JointPQPlayer,286,201,487,32,15,Player A
1031,JointPQPlayer,254,214,468,28,20,Player A
1032,JointPQPlayer,297,192,489,37,16,Player A
1033,JointPQPlayer,116,271,387,10,41,JointPQPlayer
1034,JointPQPlayer,309,194,503,33,10,Player A
1035,JointPQPlayer,316,186,502,38,12,Player A
1036,JointPQPlayer,306,186,492,40,16,Player A
1037,JointPQPlayer,244,214,458,30,24,Player A
1038,JointPQPlayer,157,252,409,17,36,JointPQPlayer
1039,JointPQPlayer,279,199,478,35,19,Player A
1040,JointPQPlayer,144,254,398,18,40,JointPQPlayer
1041,JointPQPlayer,220,230,450,22,24,JointPQPlayer
1042,JointPQPlayer,285,200,485,33,16,Player A
1043,JointPQPlayer,297,197,494,33,13,Player A
1044,JointPQPlayer,261,211,472,29,19,Player A
1045,JointPQPlayer,300,195,495,34,13,Player A
1046,JointPQPlayer,210,230,440,24,28,JointPQPlayer
1047,JointPQPlayer,324,184,508,38,10,Player A
1048,JointPQPlayer,281,201,482,33,17,Player A
1049,JointPQPlayer,148,258,406,14,36,JointPQPlayer
1050,JointPQPlayer,299,194,493,35,14,Player A
1051,JointPQPlayer,289,194,483,37,18,Player A
1052,JointPQPlayer,267,207,474,31,19,Player A
1053,JointPQPlayer,295,200,495,31,12,Player A
1054,JointPQPlayer,290,195,485,36,17,Player A
1055,JointPQPlayer,279,199,478,35,19,Player A
1056,JointPQPlayer,283,193,476,39,21,Player A
1057,JointPQPlayer,308,188,496,38,14,Player A
1058,JointPQPlayer,305,190,495,37,14,Player A
1059,JointPQPlayer,329,184,513,37,8,Player A
1060,JointPQPlayer,249,209,458,33,25,Player A
1061,JointPQPlayer,126,261,387,16,43,JointPQPlayer
1062,JointPQPlayer,174,249,423,16,31,JointPQPlayer
1063,JointPQPlayer,164,254,418,14,32,JointPQPlayer
1064,JointPQPlayer,289,199,488,33,15,Player A
1065,JointPQPlayer,284,204,488,30,14,Player A
1066,JointPQPlayer,296,196,492,34,14,Player A
1067,JointPQPlayer,309,189,498,37,13,Player A
1068,JointPQPlayer,283,208,491,27,12,Player A
1069,JointPQPlayer,144,264,408,10,34,JointPQPlayer
1070,JointPQPlayer,279,199,478,35,19,Player A
1071,JointPQPlayer,328,188,516,34,6,Player A
1072,JointPQPlayer,270,205,475,32,19,Player A
1073,JointPQPlayer,273,198,471,37,22,Player A
1074,JointPQPlayer,140,260,400,14,38,JointPQPlayer
1075,JointPQPlayer,288,198,486,34,16,Player A
1076,JointPQPlayer,312,187,499,38,13,Player A
1077,JointPQPlayer,272,202,474,34,20,Player A
1078,JointPQPlayer,271,206,477,31,18,Player A
1079,JointPQPlayer,299,199,498,31,11,Player A
1080,JointPQPlayer,270,205,475,32,19,Player A
1081,JointPQPlayer,124,269,393,10,39,JointPQPlayer
1082,JointPQPlayer,294,194,488,36,16,Player A
1083,JointPQPlayer,291,196,487,35,16,Player A
1084,JointPQPlayer,304,199,503,30,9,Player A
1085,JointPQPlayer,287,202,489,31,14,Player A
1086,JointPQPlayer,293,198,491,33,14,Player A
1087,JointPQPlayer,163,248,411,19,36,JointPQPlayer
1088,JointPQPlayer,267,212,479,27,16,Player A
1089,JointPQPlayer,315,185,500,39,13,Player A
1090,JointPQPlayer,290,200,490,32,14,Player A
1091,JointPQPlayer,329,174,503,45,14,Player A
1092,JointPQPlayer,315,185,500,39,13,Player A
1093,JointPQPlayer,300,190,490,38,16,Player A
1094,JointPQPlayer,140,255,395,18,41,JointPQPlayer
1095,JointPQPlayer,308,193,501,34,11,Player A
1096,JointPQPlayer,145,260,405,13,36,JointPQPlayer
1097,JointPQPlayer,283,198,481,35,18,Player A
1098,JointPQPlayer,325,180,505,41,12,Player A
1099,JointPQPlayer,331,181,512,39,9,Player A
1100,JointPQPlayer,150,255,405,16,37,JointPQPlayer
1101,JointPQPlayer,140,255,395,18,41,JointPQPlayer
1102,JointPQPlayer,292,197,489,34,15,Player A
1103,JointPQPlayer,161,256,417,13,32,JointPQPlayer
1104,JointPQPlayer,291,201,492,31,13,Player A
1105,JointPQPlayer,316,181,497,42,15,Player A
1106,JointPQPlayer,122,272,394,8,38,JointPQPlayer
1107,JointPQPlayer,291,201,492,31,13,Player A
1108,JointPQPlayer,318,183,501,40,13,Player A
1109,JointPQPlayer,278,198,476,36,20,Player A
1110,JointPQPlayer,305,190,495,37,14,Player A
1111,JointPQPlayer,260,205,465,34,23,Player A
1112,JointPQPlayer,265,210,475,29,18,Player A
1113,JointPQPlayer,160,245,405,22,39,JointPQPlayer
1114,JointPQPlayer,294,194,488,36,16,Player A
1115,JointPQPlayer,145,265,410,9,33,JointPQPlayer
1116,JointPQPlayer,281,201,482,33,17,Player A
1117,JointPQPlayer,245,220,465,25,20,Player A
1118,JointPQPlayer,285,200,485,33,16,Player A
1119,JointPQPlayer,299,189,488,39,17,Player A
1120,JointPQPlayer,158,258,416,12,32,JointPQPlayer
1121,JointPQPlayer,307,197,504,31,9,Player A
1122,JointPQPlayer,320,180,500,42,14,Player A
1123,JointPQPlayer,309,189,498,37,13,Player A
1124,JointPQPlayer,134,264,398,12,38,JointPQPlayer
1125,JointPQPlayer,263,213,476,27,17,Player A
1126,JointPQPlayer,317,187,504,37,11,Player A
1127,JointPQPlayer,287,202,489,31,14,Player A
1128,JointPQPlayer,248,218,466,26,20,Player A
1129,JointPQPlayer,154,259,413,12,33,JointPQPlayer
1130,JointPQPlayer,291,196,487,35,16,Player A
1131,JointPQPlayer,300,195,495,34,13,Player A
1132,JointPQPlayer,131,266,397,11,38,JointPQPlayer
1133,JointPQPlayer,305,190,495,37,14,Player A
1134,JointPQPlayer,186,246,432,16,28,JointPQPlayer
1135,JointPQPlayer,300,195,495,34,13,Player A
1136,JointPQPlayer,292,197,489,34,15,Player A
1137,JointPQPlayer,122,272,394,8,38,JointPQPlayer
1138,JointPQPlayer,282,202,484,32,16,Player A
1139,JointPQPlayer,158,258,416,12,32,JointPQPlayer
1140,JointPQPlayer,277,207,484,29,15,Player A
1141,JointPQPlayer,251,211,462,31,23,Player A
1142,JointPQPlayer,302,192,494,36,14,Player A
1143,JointPQPlayer,252,217,469,26,19,Player A
1144,JointPQPlayer,324,189,513,34,7,Player A
1145,JointPQPlayer,297,192,489,37,16,Player A
1146,JointPQPlayer,270,205,475,32,19,Player A
1147,JointPQPlayer,164,254,418,14,32,JointPQPlayer
1148,JointPQPlayer,297,197,494,33,13,Player A
1149,JointPQPlayer,309,189,498,37,13,Player A
1150,JointPQPlayer,265,210,475,29,18,Player A
1151,JointPQPlayer,286,201,487,32,15,Player A
1152,JointPQPlayer,304,189,493,38,15,Player A
1153,JointPQPlayer,297,192,489,37,16,Player A
1154,JointPQPlayer,195,240,435,19,28,JointPQPlayer
1155,JointPQPlayer,274,204,478,32,18,Player A
1156,JointPQPlayer,295,190,485,39,18,Player A
1157,JointPQPlayer,302,192,494,36,14,Player A
1158,JointPQPlayer,296,196,492,34,14,Player A
1159,JointPQPlayer,162,262,424,8,28,JointPQPlayer
1160,JointPQPlayer,287,202,489,31,14,Player A
1161,JointPQPlayer,288,198,486,34,16,Player A
1162,JointPQPlayer,286,191,477,40,21,Player A
1163,JointPQPlayer,297,192,489,37,16,Player A
1164,JointPQPlayer,257,212,469,29,20,Player A
1165,JointPQPlayer,329,179,508,41,11,Player A
1166,JointPQPlayer,275,200,475,35,20,Player A
1167,JointPQPlayer,282,197,479,36,19,Player A
1168,JointPQPlayer,286,201,487,32,15,Player A
1169,JointPQPlayer,150,255,405,16,37,JointPQPlayer
1170,JointPQPlayer,252,212,464,30,22,Player A
1171,JointPQPlayer,276,201,477,34,19,Player A
1172,JointPQPlayer,299,194,493,35,14,Player A
1173,JointPQPlayer,276,201,477,34,19,Player A
1174,JointPQPlayer,252,217,469,26,19,Player A
1175,JointPQPlayer,310,190,500,36,12,Player A
1176,JointPQPlayer,278,203,481,32,17,Player A
1177,JointPQPlayer,299,194,493,35,14,Player A
1178,JointPQPlayer,244,219,463,26,21,Player A
1179,JointPQPlayer,270,200,470,36,22,Player A
1180,JointPQPlayer,292,197,489,34,15,Player A
1181,JointPQPlayer,231,221,452,27,25,Player A
1182,JointPQPlayer,305,195,500,33,11,Player A
1183,JointPQPlayer,271,206,477,31,18,Player A
1184,JointPQPlayer,292,197,489,34,15,Player A
1185,JointPQPlayer,305,190,495,37,14,Player A
1186,JointPQPlayer,138,263,401,12,37,JointPQPlayer
1187,JointPQPlayer,152,257,409,14,35,JointPQPlayer
1188,JointPQPlayer,160,250,410,18,36,JointPQPlayer
1189,JointPQPlayer,121,266,387,13,42,JointPQPlayer
1190,JointPQPlayer,303,193,496,35,13,Player A
1191,JointPQPlayer,311,186,497,39,14,Player A
1192,JointPQPlayer,284,199,483,34,17,Player A
1193,JointPQPlayer,309,189,498,37,13,Player A
1194,JointPQPlayer,156,256,412,14,34,JointPQPlayer
1195,JointPQPlayer,165,255,420,13,31,JointPQPlayer
1196,JointPQPlayer,313,188,501,37,12,Player A
1197,JointPQPlayer,307,192,499,35,12,Player A
1198,JointPQPlayer,334,179,513,40,9,Player A
1199,JointPQPlayer,280,200,480,34,18,Player A
1200,JointPQPlayer,304,189,493,38,15,Player A
1201,JointPQPlayer,292,192,484,38,18,Player A
1202,JointPQPlayer,287,197,484,35,17,Player A
1203,JointPQPlayer,308,188,496,38,14,Player A
1204,JointPQPlayer,169,244,413,21,36,JointPQPlayer
1205,JointPQPlayer,260,210,470,30,20,Player A
1206,JointPQPlayer,285,200,485,33,16,Player A
1207,JointPQPlayer,136,266,402,10,36,JointPQPlayer
1208,JointPQPlayer,290,195,485,36,17,Player A
1209,JointPQPlayer,159,259,418,11,31,JointPQPlayer
1210,JointPQPlayer,313,183,496,41,15,Player A
1211,JointPQPlayer,307,187,494,39,15,Player A
1212,JointPQPlayer,273,203,476,33,19,Player A
1213,JointPQPlayer,267,212,479,27,16,Player A
1214,JointPQPlayer,121,266,387,13,42,JointPQPlayer
1215,JointPQPlayer,291,201,492,31,13,Player A
1216,JointPQPlayer,291,201,492,31,13,Player A
1217,JointPQPlayer,287,197,484,35,17,Player A
1218,JointPQPlayer,306,201,507,28,7,Player A
1219,JointPQPlayer,282,197,479,36,19,Player A
1220,JointPQPlayer,249,214,463,29,22,Player A
1221,JointPQPlayer,141,261,402,13,37,JointPQPlayer
1222,JointPQPlayer,279,199,478,35,19,Player A
1223,JointPQPlayer,251,216,467,27,20,Player A
1224,JointPQPlayer,280,205,485,30,15,Player A
1225,JointPQPlayer,289,194,483,37,18,Player A
1226,JointPQPlayer,309,194,503,33,10,Player A
1227,JointPQPlayer,231,221,452,27,25,Player A
1228,JointPQPlayer,262,202,464,36,24,Player A
1229,JointPQPlayer,303,193,496,35,13,Player A
1230,JointPQPlayer,297,197,494,33,13,Player A
1231,JointPQPlayer,285,200,485,33,16,Player A
1232,JointPQPlayer,279,204,483,31,16,Player A
1233,JointPQPlayer,300,190,490,38,16,Player A
1234,JointPQPlayer,261,206,467,33,22,Player A
1235,JointPQPlayer,258,208,466,32,22,Player A
1236,JointPQPlayer,270,205,475,32,19,Player A
1237,JointPQPlayer,220,230,450,22,24,JointPQPlayer
1238,JointPQPlayer,249,219,468,25,19,Player A
1239,JointPQPlayer,320,185,505,38,11,Player A
1240,JointPQPlayer,169,244,413,21,36,JointPQPlayer
1241,JointPQPlayer,280,205,485,30,15,Player A
1242,JointPQPlayer,289,199,488,33,15,Player A
1243,JointPQPlayer,289,199,488,33,15,Player A
1244,JointPQPlayer,286,196,482,36,18,Player A
1245,JointPQPlayer,285,195,480,37,19,Player A
1246,JointPQPlayer,289,194,483,37,18,Player A
1247,JointPQPlayer,273,208,481,29,16,Player A
1248,JointPQPlayer,309,189,498,37,13,Player A
1249,JointPQPlayer,295,190,485,39,18,Player A
1250,JointPQPlayer,256,211,467,30,21,Player A
1251,JointPQPlayer,302,192,494,36,14,Player A
1252,JointPQPlayer,273,203,476,33,19,Player A
1253,JointPQPlayer,280,200,480,34,18,Player A
1254,JointPQPlayer,270,205,475,32,19,Player A
1255,JointPQPlayer,308,183,491,42,17,Player A
1256,JointPQPlayer,162,247,409,20,37,JointPQPlayer
1257,JointPQPlayer,265,210,475,29,18,Player A
1258,JointPQPlayer,321,186,507,37,10,Player A
1259,JointPQPlayer,275,200,475,35,20,Player A
1260,JointPQPlayer,204,234,438,22,28,JointPQPlayer
1261,JointPQPlayer,272,207,479,30,17,Player A
1262,JointPQPlayer,322,182,504,40,12,Player A
1263,JointPQPlayer,319,184,503,39,12,Player A
1264,JointPQPlayer,168,253,421,14,31,JointPQPlayer
1265,JointPQPlayer,313,188,501,37,12,Player A
1266,JointPQPlayer,297,197,494,33,13,Player A
1267,JointPQPlayer,156,256,412,14,34,JointPQPlayer
1268,JointPQPlayer,313,183,496,41,15,Player A
1269,JointPQPlayer,266,201,467,36,23,Player A
1270,JointPQPlayer,147,257,404,15,37,JointPQPlayer
1271,JointPQPlayer,301,191,492,37,15,Player A
1272,JointPQPlayer,295,195,490,35,15,Player A
1273,JointPQPlayer,304,189,493,38,15,Player A
1274,JointPQPlayer,269,204,473,33,20,Player A
1275,JointPQPlayer,263,203,466,35,23,Player A
1276,JointPQPlayer,289,199,488,33,15,Player A
1277,JointPQPlayer,247,212,459,31,24,Player A
1278,JointPQPlayer,149,259,408,13,35,JointPQPlayer
1279,JointPQPlayer,290,195,485,36,17,Player A
1280,JointPQPlayer,282,202,484,32,16,Player A
1281,JointPQPlayer,311,196,507,31,8,Player A
1282,JointPQPlayer,138,258,396,16,40,JointPQPlayer
1283,JointPQPlayer,266,201,467,36,23,Player A
1284,JointPQPlayer,308,198,506,30,8,Player A
1285,JointPQPlayer,301,196,497,33,12,Player A
1286,JointPQPlayer,136,261,397,14,39,JointPQPlayer
1287,JointPQPlayer,273,203,476,33,19,Player A
1288,JointPQPlayer,301,191,492,37,15,Player A
1289,JointPQPlayer,286,201,487,32,15,Player A
1290,JointPQPlayer,260,210,470,30,20,Player A
1291,JointPQPlayer,291,196,487,35,16,Player A
1292,JointPQPlayer,139,269,408,7,33,JointPQPlayer
1293,JointPQPlayer,306,196,502,32,10,Player A
1294,JointPQPlayer,281,201,482,33,17,Player A
1295,JointPQPlayer,283,193,476,39,21,Player A
1296,JointPQPlayer,300,195,495,34,13,Player A
1297,JointPQPlayer,152,257,409,14,35,JointPQPlayer
1298,JointPQPlayer,300,190,490,38,16,Player A
1299,JointPQPlayer,317,192,509,33,8,Player A
1300,JointPQPlayer,310,190,500,36,12,Player A
1301,JointPQPlayer,269,204,473,33,20,Player A
1302,JointPQPlayer,283,198,481,35,18,Player A
1303,JointPQPlayer,311,191,502,35,11,Player A
1304,JointPQPlayer,323,183,506,39,11,Player A
1305,JointPQPlayer,271,211,482,27,15,Player A
1306,JointPQPlayer,273,203,476,33,19,Player A
1307,JointPQPlayer,309,189,498,37,13,Player A
1308,JointPQPlayer,185,245,430,17,29,JointPQPlayer
1309,JointPQPlayer,255,210,465,31,22,Player A
1310,JointPQPlayer,303,193,496,35,13,Player A
1311,JointPQPlayer,298,198,496,32,12,Player A
1312,JointPQPlayer,139,264,403,11,36,JointPQPlayer
1313,JointPQPlayer,303,193,496,35,13,Player A
1314,JointPQPlayer,283,198,481,35,18,Player A
1315,JointPQPlayer,297,192,489,37,16,Player A
1316,JointPQPlayer,314,184,498,40,14,Player A
1317,JointPQPlayer,280,200,480,34,18,Player A
1318,JointPQPlayer,238,218,456,28,24,Player A
1319,JointPQPlayer,276,206,482,30,16,Player A
1320,JointPQPlayer,260,205,465,34,23,Player A
1321,JointPQPlayer,253,208,461,33,24,Player A
1322,JointPQPlayer,282,202,484,32,16,Player A
1323,JointPQPlayer,306,186,492,40,16,Player A
1324,JointPQPlayer,252,207,459,34,25,Player A
1325,JointPQPlayer,154,254,408,16,36,JointPQPlayer
1326,JointPQPlayer,252,212,464,30,22,Player A
1327,JointPQPlayer,255,215,470,27,19,Player A
1328,JointPQPlayer,289,199,488,33,15,Player A
1329,JointPQPlayer,151,256,407,15,36,JointPQPlayer
1330,JointPQPlayer,297,192,489,37,16,Player A
1331,JointPQPlayer,273,208,481,29,16,Player A
1332,JointPQPlayer,245,215,460,29,23,Player A
1333,JointPQPlayer,332,177,509,42,11,Player A
1334,JointPQPlayer,293,198,491,33,14,Player A
1335,JointPQPlayer,255,210,465,31,22,Player A
1336,JointPQPlayer,302,187,489,40,17,Player A
1337,JointPQPlayer,146,256,402,16,38,JointPQPlayer
1338,JointPQPlayer,169,249,418,17,33,JointPQPlayer
1339,JointPQPlayer,257,212,469,29,20,Player A
1340,JointPQPlayer,295,190,485,39,18,Player A
1341,JointPQPlayer,153,253,406,17,37,JointPQPlayer
1342,JointPQPlayer,273,203,476,33,19,Player A
1343,JointPQPlayer,287,202,489,31,14,Player A
1344,JointPQPlayer,279,204,483,31,16,Player A
1345,JointPQPlayer,314,189,503,36,11,Player A
1346,JointPQPlayer,238,218,456,28,24,Player A
1347,JointPQPlayer,292,197,489,34,15,Player A
1348,JointPQPlayer,262,207,469,32,21,Player A
1349,JointPQPlayer,211,226,437,27,30,JointPQPlayer
1350,JointPQPlayer,269,199,468,37,23,Player A
1351,JointPQPlayer,293,198,491,33,14,Player A
1352,JointPQPlayer,307,187,494,39,15,Player A
1353,JointPQPlayer,290,195,485,36,17,Player A
1354,JointPQPlayer,273,203,476,33,19,Player A
1355,JointPQPlayer,284,204,488,30,14,Player A
1356,JointPQPlayer,297,192,489,37,16,Player A
1357,JointPQPlayer,287,202,489,31,14,Player A
1358,JointPQPlayer,286,196,482,36,18,Player A
1359,JointPQPlayer,129,269,398,9,37,JointPQPlayer
1360,JointPQPlayer,261,206,467,33,22,Player A
1361,JointPQPlayer,197,237,434,21,29,JointPQPlayer
1362,JointPQPlayer,143,258,401,15,38,JointPQPlayer
1363,JointPQPlayer,260,210,470,30,20,Player A
1364,JointPQPlayer,294,199,493,32,13,Player A
1365,JointPQPlayer,300,190,490,38,16,Player A
1366,JointPQPlayer,295,195,490,35,15,Player A
1367,JointPQPlayer,269,209,478,29,17,Player A
1368,JointPQPlayer,281,201,482,33,17,Player A
1369,JointPQPlayer,269,199,468,37,23,Player A
1370,JointPQPlayer,250,215,465,28,21,Player A
1371,JointPQPlayer,119,274,393,7,38,JointPQPlayer
1372,JointPQPlayer,146,256,402,16,38,JointPQPlayer
1373,JointPQPlayer,156,256,412,14,34,JointPQPlayer
1374,JointPQPlayer,292,197,489,34,15,Player A
1375,JointPQPlayer,280,205,485,30,15,Player A
1376,JointPQPlayer,300,195,495,34,13,Player A
1377,JointPQPlayer,258,213,471,28,19,Player A
1378,JointPQPlayer,296,191,487,38,17,Player A
1379,JointPQPlayer,271,201,472,35,21,Player A
1380,JointPQPlayer,310,185,495,40,15,Player A
1381,JointPQPlayer,296,196,492,34,14,Player A
1382,JointPQPlayer,276,201,477,34,19,Player A
1383,JointPQPlayer,295,190,485,39,18,Player A
1384,JointPQPlayer,149,254,403,17,38,JointPQPlayer
1385,JointPQPlayer,295,195,490,35,15,Player A
1386,JointPQPlayer,314,189,503,36,11,Player A
1387,JointPQPlayer,284,204,488,30,14,Player A
1388,JointPQPlayer,293,193,486,37,17,Player A
1389,JointPQPlayer,278,203,481,32,17,Player A
1390,JointPQPlayer,250,215,465,28,21,Player A
1391,JointPQPlayer,158,253,411,16,35,JointPQPlayer
1392,JointPQPlayer,295,200,495,31,12,Player A
1393,JointPQPlayer,308,188,496,38,14,Player A
1394,JointPQPlayer,287,202,489,31,14,Player A
1395,JointPQPlayer,297,197,494,33,13,Player A
1396,JointPQPlayer,293,193,486,37,17,Player A
1397,JointPQPlayer,295,200,495,31,12,Player A
1398,JointPQPlayer,268,203,471,34,21,Player A
1399,JointPQPlayer,231,221,452,27,25,Player A
1400,JointPQPlayer,134,264,398,12,38,JointPQPlayer
1401,JointPQPlayer,279,204,483,31,16,Player A
1402,JointPQPlayer,322,187,509,36,9,Player A
1403,JointPQPlayer,265,205,470,33,21,Player A
1404,JointPQPlayer,145,255,400,17,39,JointPQPlayer
1405,JointPQPlayer,281,201,482,33,17,Player A
1406,JointPQPlayer,283,198,481,35,18,Player A
1407,JointPQPlayer,288,198,486,34,16,Player A
1408,JointPQPlayer,300,200,500,30,10,Player A
1409,JointPQPlayer,158,253,411,16,35,JointPQPlayer
1410,JointPQPlayer,325,180,505,41,12,Player A
1411,JointPQPlayer,305,190,495,37,14,Player A
1412,JointPQPlayer,268,208,476,30,18,Player A
1413,JointPQPlayer,152,262,414,10,32,JointPQPlayer
1414,JointPQPlayer,253,213,466,29,21,Player A
1415,JointPQPlayer,301,196,497,33,12,Player A
1416,JointPQPlayer,139,259,398,15,39,JointPQPlayer
1417,JointPQPlayer,305,190,495,37,14,Player A
1418,JointPQPlayer,286,196,482,36,18,Player A
1419,JointPQPlayer,301,196,497,33,12,Player A
1420,JointPQPlayer,255,210,465,31,22,Player A
1421,JointPQPlayer,276,201,477,34,19,Player A
1422,JointPQPlayer,306,191,497,36,13,Player A
1423,JointPQPlayer,142,262,404,12,36,JointPQPlayer
1424,JointPQPlayer,298,193,491,36,15,Player A
1425,JointPQPlayer,310,190,500,36,12,Player A
1426,JointPQPlayer,276,196,472,38,22,Player A
1427,JointPQPlayer,300,195,495,34,13,Player A
1428,JointPQPlayer,299,194,493,35,14,Player A
1429,JointPQPlayer,309,189,498,37,13,Player A
1430,JointPQPlayer,137,262,399,13,38,JointPQPlayer
1431,JointPQPlayer,149,259,408,13,35,JointPQPlayer
1432,JointPQPlayer,281,201,482,33,17,Player A
1433,JointPQPlayer,166,251,417,16,33,JointPQPlayer
1434,JointPQPlayer,277,202,479,33,18,Player A
1435,JointPQPlayer,268,203,471,34,21,Player A
1436,JointPQPlayer,294,194,488,36,16,Player A
1437,JointPQPlayer,319,184,503,39,12,Player A
1438,JointPQPlayer,131,266,397,11,38,JointPQPlayer
1439,JointPQPlayer,281,206,487,29,14,Player A
1440,JointPQPlayer,254,209,463,32,23,Player A
1441,JointPQPlayer,329,179,508,41,11,Player A
1442,JointPQPlayer,290,195,485,36,17,Player A
1443,JointPQPlayer,276,206,482,30,16,Player A
1444,JointPQPlayer,289,199,488,33,15,Player A
1445,JointPQPlayer,292,192,484,38,18,Player A
1446,JointPQPlayer,292,197,489,34,15,Player A
1447,JointPQPlayer,303,193,496,35,13,Player A
1448,JointPQPlayer,320,190,510,34,8,Player A
1449,JointPQPlayer,311,186,497,39,14,Player A
1450,JointPQPlayer,311,191,502,35,11,Player A
1451,JointPQPlayer,298,188,486,40,18,Player A
1452,JointPQPlayer,306,186,492,40,16,Player A
1453,JointPQPlayer,301,191,492,37,15,Player A
1454,JointPQPlayer,293,203,496,29,11,Player A
1455,JointPQPlayer,336,181,517,38,7,Player A
1456,JointPQPlayer,297,197,494,33,13,Player A
1457,JointPQPlayer,279,199,478,35,19,Player A
1458,JointPQPlayer,294,199,493,32,13,Player A
1459,JointPQPlayer,306,186,492,40,16,Player A
1460,JointPQPlayer,305,190,495,37,14,Player A
1461,JointPQPlayer,180,245,425,18,31,JointPQPlayer
1462,JointPQPlayer,269,204,473,33,20,Player A
1463,JointPQPlayer,290,195,485,36,17,Player A
1464,JointPQPlayer,154,259,413,12,33,JointPQPlayer
1465,JointPQPlayer,288,198,486,34,16,Player A
1466,JointPQPlayer,228,228,456,22,22,Tie
1467,JointPQPlayer,300,190,490,38,16,Player A
1468,JointPQPlayer,281,196,477,37,20,Player A
1469,JointPQPlayer,279,194,473,39,22,Player A
1470,JointPQPlayer,293,198,491,33,14,Player A
1471,JointPQPlayer,295,200,495,31,12,Player A
1472,JointPQPlayer,146,261,407,12,35,JointPQPlayer
1473,JointPQPlayer,289,189,478,41,21,Player A
1474,JointPQPlayer,162,252,414,16,34,JointPQPlayer
1475,JointPQPlayer,308,193,501,34,11,Player A
1476,JointPQPlayer,148,258,406,14,36,JointPQPlayer
1477,JointPQPlayer,290,205,495,28,11,Player A
1478,JointPQPlayer,151,261,412,11,33,JointPQPlayer
1479,JointPQPlayer,267,207,474,31,19,Player A
1480,JointPQPlayer,305,190,495,37,14,Player A
1481,JointPQPlayer,279,204,483,31,16,Player A
1482,JointPQPlayer,315,190,505,35,10,Player A
1483,JointPQPlayer,275,205,480,31,17,Player A
1484,JointPQPlayer,135,270,405,7,34,JointPQPlayer
1485,JointPQPlayer,304,194,498,34,12,Player A
1486,JointPQPlayer,292,197,489,34,15,Player A
1487,JointPQPlayer,284,199,483,34,17,Player A
1488,JointPQPlayer,299,189,488,39,17,Player A
1489,JointPQPlayer,295,200,495,31,12,Player A
1490,JointPQPlayer,289,199,488,33,15,Player A
1491,JointPQPlayer,312,187,499,38,13,Player A
1492,JointPQPlayer,298,193,491,36,15,Player A
1493,JointPQPlayer,271,206,477,31,18,Player A
1494,JointPQPlayer,285,200,485,33,16,Player A
1495,JointPQPlayer,303,198,501,31,10,Player A
1496,JointPQPlayer,131,266,397,11,38,JointPQPlayer
1497,JointPQPlayer,287,202,489,31,14,Player A
1498,JointPQPlayer,148,258,406,14,36,JointPQPlayer
1499,JointPQPlayer,284,199,483,34,17,Player A
1500,JointPQPlayer,302,192,494,36,14,Player A
1501,JointPQPlayer,116,266,382,14,44,JointPQPlayer
1502,JointPQPlayer,274,204,478,32,18,Player A
1503,JointPQPlayer,293,198,491,33,14,Player A
1504,JointPQPlayer,146,261,407,12,35,JointPQPlayer
1505,JointPQPlayer,303,188,491,39,16,Player A
1506,JointPQPlayer,284,194,478,38,20,Player A
1507,JointPQPlayer,268,203,471,34,21,Player A
1508,JointPQPlayer,277,207,484,29,15,Player A
1509,JointPQPlayer,288,203,491,30,13,Player A
1510,JointPQPlayer,175,250,425,15,30,JointPQPlayer
1511,JointPQPlayer,140,260,400,14,38,JointPQPlayer
1512,JointPQPlayer,135,260,395,15,40,JointPQPlayer
1513,JointPQPlayer,308,198,506,30,8,Player A
1514,JointPQPlayer,281,201,482,33,17,Player A
1515,JointPQPlayer,290,195,485,36,17,Player A
1516,JointPQPlayer,309,189,498,37,13,Player A
1517,JointPQPlayer,281,191,472,41,23,Player A
1518,JointPQPlayer,302,187,489,40,17,Player A
1519,JointPQPlayer,296,196,492,34,14,Player A
1520,JointPQPlayer,280,200,480,34,18,Player A
1521,JointPQPlayer,295,200,495,31,12,Player A
1522,JointPQPlayer,153,258,411,13,34,JointPQPlayer
1523,JointPQPlayer,307,187,494,39,15,Player A
1524,JointPQPlayer,306,191,497,36,13,Player A
1525,JointPQPlayer,156,251,407,18,37,JointPQPlayer
1526,JointPQPlayer,303,193,496,35,13,Player A
1527,JointPQPlayer,252,212,464,30,22,Player A
1528,JointPQPlayer,163,248,411,19,36,JointPQPlayer
1529,JointPQPlayer,297,192,489,37,16,Player A
1530,JointPQPlayer,325,185,510,37,9,Player A
1531,JointPQPlayer,134,264,398,12,38,JointPQPlayer
1532,JointPQPlayer,226,226,452,24,24,Tie
1533,JointPQPlayer,292,197,489,34,15,Player A
1534,JointPQPlayer,300,195,495,34,13,Player A
1535,JointPQPlayer,304,194,498,34,12,Player A
1536,JointPQPlayer,181,246,427,17,30,JointPQPlayer
1537,JointPQPlayer,307,187,494,39,15,Player A
1538,JointPQPlayer,267,207,474,31,19,Player A
1539,JointPQPlayer,133,263,396,13,39,JointPQPlayer
1540,JointPQPlayer,317,187,504,37,11,Player A
1541,JointPQPlayer,273,203,476,33,19,Player A
1542,JointPQPlayer,314,189,503,36,11,Player A
1543,JointPQPlayer,303,198,501,31,10,Player A
1544,JointPQPlayer,292,202,494,30,12,Player A
1545,JointPQPlayer,278,203,481,32,17,Player A
1546,JointPQPlayer,327,182,509,39,10,Player A
1547,JointPQPlayer,294,199,493,32,13,Player A
1548,JointPQPlayer,306,186,492,40,16,Player A
1549,JointPQPlayer,145,260,405,13,36,JointPQPlayer
1550,JointPQPlayer,292,197,489,34,15,Player A
1551,JointPQPlayer,119,269,388,11,41,JointPQPlayer
1552,JointPQPlayer,310,190,500,36,12,Player A
1553,JointPQPlayer,282,197,479,36,19,Player A
1554,JointPQPlayer,316,186,502,38,12,Player A
1555,JointPQPlayer,270,205,475,32,19,Player A
1556,JointPQPlayer,143,263,406,11,35,JointPQPlayer
1557,JointPQPlayer,291,196,487,35,16,Player A
1558,JointPQPlayer,151,251,402,19,39,JointPQPlayer
1559,JointPQPlayer,286,196,482,36,18,Player A
1560,JointPQPlayer,208,233,441,22,27,JointPQPlayer
1561,JointPQPlayer,309,189,498,37,13,Player A
1562,JointPQPlayer,267,207,474,31,19,Player A
1563,JointPQPlayer,307,187,494,39,15,Player A
1564,JointPQPlayer,283,198,481,35,18,Player A
1565,JointPQPlayer,252,217,469,26,19,Player A
1566,JointPQPlayer,142,262,404,12,36,JointPQPlayer
1567,JointPQPlayer,253,213,466,29,21,Player A
1568,JointPQPlayer,296,196,492,34,14,Player A
1569,JointPQPlayer,305,190,495,37,14,Player A
1570,JointPQPlayer,256,211,467,30,21,Player A
1571,JointPQPlayer,284,199,483,34,17,Player A
1572,JointPQPlayer,264,214,478,26,16,Player A
1573,JointPQPlayer,297,197,494,33,13,Player A
1574,JointPQPlayer,278,203,481,32,17,Player A
1575,JointPQPlayer,310,195,505,32,9,Player A
1576,JointPQPlayer,299,194,493,35,14,Player A
1577,JointPQPlayer,157,252,409,17,36,JointPQPlayer
1578,JointPQPlayer,287,197,484,35,17,Player A
1579,JointPQPlayer,131,261,392,15,41,JointPQPlayer
1580,JointPQPlayer,263,213,476,27,17,Player A
1581,JointPQPlayer,278,198,476,36,20,Player A
1582,JointPQPlayer,147,262,409,11,34,JointPQPlayer
1583,JointPQPlayer,296,196,492,34,14,Player A
1584,JointPQPlayer,289,199,488,33,15,Player A
1585,JointPQPlayer,267,207,474,31,19,Player A
1586,JointPQPlayer,146,261,407,12,35,JointPQPlayer
1587,JointPQPlayer,240,215,455,30,25,Player A
1588,JointPQPlayer,291,201,492,31,13,Player A
1589,JointPQPlayer,278,203,481,32,17,Player A
1590,JointPQPlayer,175,240,415,23,36,JointPQPlayer
1591,JointPQPlayer,213,228,441,25,28,JointPQPlayer
1592,JointPQPlayer,306,191,497,36,13,Player A
1593,JointPQPlayer,266,206,472,32,20,Player A
1594,JointPQPlayer,301,196,497,33,12,Player A
1595,JointPQPlayer,267,207,474,31,19,Player A
1596,JointPQPlayer,258,208,466,32,22,Player A
1597,JointPQPlayer,279,199,478,35,19,Player A
1598,JointPQPlayer,303,193,496,35,13,Player A
1599,JointPQPlayer,307,187,494,39,15,Player A
1600,JointPQPlayer,216,226,442,26,28,JointPQPlayer
1601,JointPQPlayer,297,192,489,37,16,Player A
1602,JointPQPlayer,129,269,398,9,37,JointPQPlayer
1603,JointPQPlayer,149,264,413,9,32,JointPQPlayer
1604,JointPQPlayer,138,258,396,16,40,JointPQPlayer
1605,JointPQPlayer,158,258,416,12,32,JointPQPlayer
1606,JointPQPlayer,148,258,406,14,36,JointPQPlayer
1607,JointPQPlayer,318,188,506,36,10,Player A
1608,JointPQPlayer,288,193,481,38,19,Player A
1609,JointPQPlayer,154,254,408,16,36,JointPQPlayer
1610,JointPQPlayer,258,203,461,36,25,Player A
1611,JointPQPlayer,135,265,400,11,37,JointPQPlayer
1612,JointPQPlayer,254,219,473,24,17,Player A
1613,JointPQPlayer,266,206,472,32,20,Player A
1614,JointPQPlayer,306,191,497,36,13,Player A
1615,JointPQPlayer,301,191,492,37,15,Player A
1616,JointPQPlayer,266,206,472,32,20,Player A
1617,JointPQPlayer,326,181,507,40,11,Player A
1618,JointPQPlayer,283,198,481,35,18,Player A
1619,JointPQPlayer,277,202,479,33,18,Player A
1620,JointPQPlayer,293,198,491,33,14,Player A
1621,JointPQPlayer,328,188,516,34,6,Player A
1622,JointPQPlayer,170,250,420,16,32,JointPQPlayer
1623,JointPQPlayer,318,188,506,36,10,Player A
1624,JointPQPlayer,144,259,403,14,37,JointPQPlayer
1625,JointPQPlayer,296,186,482,42,20,Player A
1626,JointPQPlayer,149,254,403,17,38,JointPQPlayer
1627,JointPQPlayer,137,262,399,13,38,JointPQPlayer
1628,JointPQPlayer,224,229,453,22,23,JointPQPlayer
1629,JointPQPlayer,292,202,494,30,12,Player A
1630,JointPQPlayer,301,191,492,37,15,Player A
1631,JointPQPlayer,302,192,494,36,14,Player A
1632,JointPQPlayer,323,183,506,39,11,Player A
1633,JointPQPlayer,278,198,476,36,20,Player A
1634,JointPQPlayer,280,205,485,30,15,Player A
1635,JointPQPlayer,276,201,477,34,19,Player A
1636,JointPQPlayer,295,185,480,43,21,Player A
1637,JointPQPlayer,284,199,483,34,17,Player A
1638,JointPQPlayer,281,201,482,33,17,Player A
1639,JointPQPlayer,316,191,507,34,9,Player A
1640,JointPQPlayer,261,211,472,29,19,Player A
1641,JointPQPlayer,285,200,485,33,16,Player A
1642,JointPQPlayer,278,198,476,36,20,Player A
1643,JointPQPlayer,294,194,488,36,16,Player A
1644,JointPQPlayer,120,270,390,10,40,JointPQPlayer
1645,JointPQPlayer,304,189,493,38,15,Player A
1646,JointPQPlayer,288,198,486,34,16,Player A
1647,JointPQPlayer,273,203,476,33,19,Player A
1648,JointPQPlayer,175,245,420,19,33,JointPQPlayer
1649,JointPQPlayer,271,206,477,31,18,Player A
1650,JointPQPlayer,157,257,414,13,33,JointPQPlayer
1651,JointPQPlayer,271,201,472,35,21,Player A
1652,JointPQPlayer,146,261,407,12,35,JointPQPlayer
1653,JointPQPlayer,308,188,496,38,14,Player A
1654,JointPQPlayer,302,192,494,36,14,Player A
1655,JointPQPlayer,334,179,513,40,9,Player A
1656,JointPQPlayer,281,196,477,37,20,Player A
1657,JointPQPlayer,298,188,486,40,18,Player A
1658,JointPQPlayer,340,175,515,42,9,Player A
1659,JointPQPlayer,304,189,493,38,15,Player A
1660,JointPQPlayer,255,210,465,31,22,Player A
1661,JointPQPlayer,279,204,483,31,16,Player A
1662,JointPQPlayer,323,188,511,35,8,Player A
1663,JointPQPlayer,285,195,480,37,19,Player A
1664,JointPQPlayer,286,196,482,36,18,Player A
1665,JointPQPlayer,313,188,501,37,12,Player A
1666,JointPQPlayer,279,199,478,35,19,Player A
1667,JointPQPlayer,297,192,489,37,16,Player A
1668,JointPQPlayer,268,208,476,30,18,Player A
1669,JointPQPlayer,281,201,482,33,17,Player A
1670,JointPQPlayer,310,185,495,40,15,Player A
1671,JointPQPlayer,295,190,485,39,18,Player A
1672,JointPQPlayer,303,193,496,35,13,Player A
1673,JointPQPlayer,179,244,423,19,32,JointPQPlayer
1674,JointPQPlayer,264,209,473,30,19,Player A
1675,JointPQPlayer,294,194,488,36,16,Player A
1676,JointPQPlayer,156,256,412,14,34,JointPQPlayer
1677,JointPQPlayer,167,252,419,15,32,JointPQPlayer
1678,JointPQPlayer,142,257,399,16,39,JointPQPlayer
1679,JointPQPlayer,277,202,479,33,18,Player A
1680,JointPQPlayer,317,187,504,37,11,Player A
1681,JointPQPlayer,284,204,488,30,14,Player A
1682,JointPQPlayer,205,240,445,17,24,JointPQPlayer
1683,JointPQPlayer,290,200,490,32,14,Player A
1684,JointPQPlayer,325,180,505,41,12,Player A
1685,JointPQPlayer,267,202,469,35,22,Player A
1686,JointPQPlayer,319,189,508,35,9,Player A
1687,JointPQPlayer,157,257,414,13,33,JointPQPlayer
1688,JointPQPlayer,169,249,418,17,33,JointPQPlayer
1689,JointPQPlayer,160,255,415,14,33,JointPQPlayer
1690,JointPQPlayer,150,255,405,16,37,JointPQPlayer
1691,JointPQPlayer,302,197,499,32,11,Player A
1692,JointPQPlayer,293,193,486,37,17,Player A
1693,JointPQPlayer,287,202,489,31,14,Player A
1694,JointPQPlayer,120,270,390,10,40,JointPQPlayer
1695,JointPQPlayer,229,224,453,25,24,Player A
1696,JointPQPlayer,261,206,467,33,22,Player A
1697,JointPQPlayer,145,260,405,13,36,JointPQPlayer
1698,JointPQPlayer,288,193,481,38,19,Player A
1699,JointPQPlayer,253,213,466,29,21,Player A
1700,JointPQPlayer,304,194,498,34,12,Player A
1701,JointPQPlayer,275,205,480,31,17,Player A
1702,JointPQPlayer,157,257,414,13,33,JointPQPlayer
1703,JointPQPlayer,309,194,503,33,10,Player A
1704,JointPQPlayer,265,205,470,33,21,Player A
1705,JointPQPlayer,132,267,399,10,37,JointPQPlayer
1706,JointPQPlayer,303,193,496,35,13,Player A
1707,JointPQPlayer,305,190,495,37,14,Player A
1708,JointPQPlayer,270,210,480,28,16,Player A
1709,JointPQPlayer,289,199,488,33,15,Player A
1710,JointPQPlayer,288,198,486,34,16,Player A
1711,JointPQPlayer,329,179,508,41,11,Player A
1712,JointPQPlayer,282,202,484,32,16,Player A
1713,JointPQPlayer,310,185,495,40,15,Player A
1714,JointPQPlayer,296,191,487,38,17,Player A
1715,JointPQPlayer,303,188,491,39,16,Player A
1716,JointPQPlayer,163,248,411,19,36,JointPQPlayer
1717,JointPQPlayer,281,201,482,33,17,Player A
1718,JointPQPlayer,287,197,484,35,17,Player A
1719,JointPQPlayer,168,253,421,14,31,JointPQPlayer
1720,JointPQPlayer,313,188,501,37,12,Player A
1721,JointPQPlayer,137,262,399,13,38,JointPQPlayer
1722,JointPQPlayer,214,229,443,24,27,JointPQPlayer
1723,JointPQPlayer,256,211,467,30,21,Player A
1724,JointPQPlayer,308,183,491,42,17,Player A
1725,JointPQPlayer,285,200,485,33,16,Player A
1726,JointPQPlayer,289,199,488,33,15,Player A
1727,JointPQPlayer,304,189,493,38,15,Player A
1728,JointPQPlayer,305,195,500,33,11,Player A
1729,JointPQPlayer,247,217,464,27,21,Player A
1730,JointPQPlayer,153,258,411,13,34,JointPQPlayer
1731,JointPQPlayer,308,193,501,34,11,Player A
1732,JointPQPlayer,277,207,484,29,15,Player A
1733,JointPQPlayer,150,260,410,12,34,JointPQPlayer
1734,JointPQPlayer,270,205,475,32,19,Player A
1735,JointPQPlayer,277,202,479,33,18,Player A
1736,JointPQPlayer,266,211,477,28,17,Player A
1737,JointPQPlayer,315,185,500,39,13,Player A
1738,JointPQPlayer,330,180,510,40,10,Player A
1739,JointPQPlayer,276,201,477,34,19,Player A
1740,JointPQPlayer,229,219,448,29,27,Player A
1741,JointPQPlayer,236,226,462,22,20,Player A
1742,JointPQPlayer,306,191,497,36,13,Player A
1743,JointPQPlayer,146,256,402,16,38,JointPQPlayer
1744,JointPQPlayer,302,192,494,36,14,Player A
1745,JointPQPlayer,292,197,489,34,15,Player A
1746,JointPQPlayer,252,217,469,26,19,Player A
1747,JointPQPlayer,266,206,472,32,20,Player A
1748,JointPQPlayer,302,192,494,36,14,Player A
1749,JointPQPlayer,156,261,417,10,31,JointPQPlayer
1750,JointPQPlayer,278,198,476,36,20,Player A
1751,JointPQPlayer,161,246,407,21,38,JointPQPlayer
1752,JointPQPlayer,295,195,490,35,15,Player A
1753,JointPQPlayer,314,184,498,40,14,Player A
1754,JointPQPlayer,290,195,485,36,17,Player A
1755,JointPQPlayer,278,203,481,32,17,Player A
1756,JointPQPlayer,288,198,486,34,16,Player A
1757,JointPQPlayer,295,190,485,39,18,Player A
1758,JointPQPlayer,261,201,462,37,25,Player A
1759,JointPQPlayer,301,191,492,37,15,Player A
1760,JointPQPlayer,143,258,401,15,38,JointPQPlayer
1761,JointPQPlayer,259,204,463,35,24,Player A
1762,JointPQPlayer,321,186,507,37,10,Player A
1763,JointPQPlayer,310,190,500,36,12,Player A
1764,JointPQPlayer,242,217,459,28,23,Player A
1765,JointPQPlayer,140,260,400,14,38,JointPQPlayer
1766,JointPQPlayer,169,249,418,17,33,JointPQPlayer
1767,JointPQPlayer,318,188,506,36,10,Player A
1768,JointPQPlayer,279,199,478,35,19,Player A
1769,JointPQPlayer,303,193,496,35,13,Player A
1770,JointPQPlayer,279,204,483,31,16,Player A
1771,JointPQPlayer,283,198,481,35,18,Player A
1772,JointPQPlayer,282,202,484,32,16,Player A
1773,JointPQPlayer,247,217,464,27,21,Player A
1774,JointPQPlayer,333,178,511,41,10,Player A
1775,JointPQPlayer,143,258,401,15,38,JointPQPlayer
1776,JointPQPlayer,284,199,483,34,17,Player A
1777,JointPQPlayer,153,258,411,13,34,JointPQPlayer
1778,JointPQPlayer,289,199,488,33,15,Player A
1779,JointPQPlayer,267,202,469,35,22,Player A
1780,JointPQPlayer,299,194,493,35,14,Player A
1781,JointPQPlayer,300,195,495,34,13,Player A
1782,JointPQPlayer,236,221,457,26,23,Player A
1783,JointPQPlayer,149,259,408,13,35,JointPQPlayer
1784,JointPQPlayer,272,202,474,34,20,Player A
1785,JointPQPlayer,262,207,469,32,21,Player A
1786,JointPQPlayer,289,194,483,37,18,Player A
1787,JointPQPlayer,305,190,495,37,14,Player A
1788,JointPQPlayer,300,190,490,38,16,Player A
1789,JointPQPlayer,288,198,486,34,16,Player A
1790,JointPQPlayer,320,185,505,38,11,Player A
1791,JointPQPlayer,270,205,475,32,19,Player A
1792,JointPQPlayer,293,198,491,33,14,Player A
1793,JointPQPlayer,292,197,489,34,15,Player A
1794,JointPQPlayer,306,191,497,36,13,Player A
1795,JointPQPlayer,292,197,489,34,15,Player A
1796,JointPQPlayer,264,209,473,30,19,Player A
1797,JointPQPlayer,282,202,484,32,16,Player A
1798,JointPQPlayer,149,259,408,13,35,JointPQPlayer
1799,JointPQPlayer,294,194,488,36,16,Player A
1800,JointPQPlayer,290,200,490,32,14,Player A
1801,JointPQPlayer,291,201,492,31,13,Player A
1802,JointPQPlayer,289,204,493,29,12,Player A
1803,JointPQPlayer,261,206,467,33,22,Player A
1804,JointPQPlayer,322,182,504,40,12,Player A
1805,JointPQPlayer,312,192,504,34,10,Player A
1806,JointPQPlayer,290,200,490,32,14,Player A
1807,JointPQPlayer,139,259,398,15,39,JointPQPlayer
1808,JointPQPlayer,290,195,485,36,17,Player A
1809,JointPQPlayer,140,255,395,18,41,JointPQPlayer
1810,JointPQPlayer,259,209,468,31,21,Player A
1811,JointPQPlayer,294,194,488,36,16,Player A
1812,JointPQPlayer,271,201,472,35,21,Player A
1813,JointPQPlayer,271,206,477,31,18,Player A
1814,JointPQPlayer,287,197,484,35,17,Player A
1815,JointPQPlayer,263,208,471,31,20,Player A
1816,JointPQPlayer,321,186,507,37,10,Player A
1817,JointPQPlayer,266,211,477,28,17,Player A
1818,JointPQPlayer,144,259,403,14,37,JointPQPlayer
1819,JointPQPlayer,282,202,484,32,16,Player A
1820,JointPQPlayer,141,266,407,9,34,JointPQPlayer
1821,JointPQPlayer,162,252,414,16,34,JointPQPlayer
1822,JointPQPlayer,303,188,491,39,16,Player A
1823,JointPQPlayer,288,198,486,34,16,Player A
1824,JointPQPlayer,283,203,486,31,15,Player A
1825,JointPQPlayer,207,232,439,23,28,JointPQPlayer
1826,JointPQPlayer,292,197,489,34,15,Player A
1827,JointPQPlayer,226,221,447,28,27,Player A
1828,JointPQPlayer,221,226,447,25,26,JointPQPlayer
1829,JointPQPlayer,291,201,492,31,13,Player A
1830,JointPQPlayer,248,218,466,26,20,Player A
1831,JointPQPlayer,275,200,475,35,20,Player A
1832,JointPQPlayer,289,194,483,37,18,Player A
1833,JointPQPlayer,309,189,498,37,13,Player A
1834,JointPQPlayer,304,189,493,38,15,Player A
1835,JointPQPlayer,254,209,463,32,23,Player A
1836,JointPQPlayer,192,242,434,18,28,JointPQPlayer
1837,JointPQPlayer,287,197,484,35,17,Player A
1838,JointPQPlayer,181,246,427,17,30,JointPQPlayer
1839,JointPQPlayer,205,235,440,21,27,JointPQPlayer
1840,JointPQPlayer,284,199,483,34,17,Player A
1841,JointPQPlayer,163,248,411,19,36,JointPQPlayer
1842,JointPQPlayer,310,190,500,36,12,Player A
1843,JointPQPlayer,294,194,488,36,16,Player A
1844,JointPQPlayer,289,199,488,33,15,Player A
1845,JointPQPlayer,150,255,405,16,37,JointPQPlayer
1846,JointPQPlayer,257,212,469,29,20,Player A
1847,JointPQPlayer,259,209,468,31,21,Player A
1848,JointPQPlayer,242,217,459,28,23,Player A
1849,JointPQPlayer,287,202,489,31,14,Player A
1850,JointPQPlayer,291,196,487,35,16,Player A
1851,JointPQPlayer,277,202,479,33,18,Player A
1852,JointPQPlayer,297,192,489,37,16,Player A
1853,JointPQPlayer,291,196,487,35,16,Player A
1854,JointPQPlayer,234,224,458,24,22,Player A
1855,JointPQPlayer,130,265,395,12,39,JointPQPlayer
1856,JointPQPlayer,309,189,498,37,13,Player A
1857,JointPQPlayer,140,265,405,10,35,JointPQPlayer
1858,JointPQPlayer,299,194,493,35,14,Player A
1859,JointPQPlayer,283,203,486,31,15,Player A
1860,JointPQPlayer,295,195,490,35,15,Player A
1861,JointPQPlayer,296,191,487,38,17,Player A
1862,JointPQPlayer,181,241,422,21,33,JointPQPlayer
1863,JointPQPlayer,315,185,500,39,13,Player A
1864,JointPQPlayer,146,261,407,12,35,JointPQPlayer
1865,JointPQPlayer,316,186,502,38,12,Player A
1866,JointPQPlayer,156,261,417,10,31,JointPQPlayer
1867,JointPQPlayer,308,198,506,30,8,Player A
1868,JointPQPlayer,316,186,502,38,12,Player A
1869,JointPQPlayer,273,203,476,33,19,Player A
1870,JointPQPlayer,289,199,488,33,15,Player A
1871,JointPQPlayer,135,260,395,15,40,JointPQPlayer
1872,JointPQPlayer,290,195,485,36,17,Player A
1873,JointPQPlayer,272,207,479,30,17,Player A
1874,JointPQPlayer,312,192,504,34,10,Player A
1875,JointPQPlayer,132,262,394,14,40,JointPQPlayer
1876,JointPQPlayer,300,195,495,34,13,Player A
1877,JointPQPlayer,153,253,406,17,37,JointPQPlayer
1878,JointPQPlayer,325,185,510,37,9,Player A
1879,JointPQPlayer,275,200,475,35,20,Player A
1880,JointPQPlayer,120,270,390,10,40,JointPQPlayer
1881,JointPQPlayer,306,191,497,36,13,Player A
1882,JointPQPlayer,287,202,489,31,14,Player A
1883,JointPQPlayer,272,207,479,30,17,Player A
1884,JointPQPlayer,298,188,486,40,18,Player A
1885,JointPQPlayer,305,190,495,37,14,Player A
1886,JointPQPlayer,303,193,496,35,13,Player A
1887,JointPQPlayer,288,198,486,34,16,Player A
1888,JointPQPlayer,140,265,405,10,35,JointPQPlayer
1889,JointPQPlayer,332,182,514,38,8,Player A
1890,JointPQPlayer,266,201,467,36,23,Player A
1891,JointPQPlayer,322,187,509,36,9,Player A
1892,JointPQPlayer,280,200,480,34,18,Player A
1893,JointPQPlayer,307,187,494,39,15,Player A
1894,JointPQPlayer,290,200,490,32,14,Player A
1895,JointPQPlayer,306,191,497,36,13,Player A
1896,JointPQPlayer,218,233,451,20,23,JointPQPlayer
1897,JointPQPlayer,316,186,502,38,12,Player A
1898,JointPQPlayer,286,201,487,32,15,Player A
1899,JointPQPlayer,162,252,414,16,34,JointPQPlayer
1900,JointPQPlayer,296,201,497,30,11,Player A
1901,JointPQPlayer,282,197,479,36,19,Player A
1902,JointPQPlayer,267,207,474,31,19,Player A
1903,JointPQPlayer,277,202,479,33,18,Player A
1904,JointPQPlayer,309,189,498,37,13,Player A
1905,JointPQPlayer,280,200,480,34,18,Player A
1906,JointPQPlayer,317,192,509,33,8,Player A
1907,JointPQPlayer,287,197,484,35,17,Player A
1908,JointPQPlayer,289,194,483,37,18,Player A
1909,JointPQPlayer,320,185,505,38,11,Player A
1910,JointPQPlayer,289,199,488,33,15,Player A
1911,JointPQPlayer,282,202,484,32,16,Player A
1912,JointPQPlayer,162,252,414,16,34,JointPQPlayer
1913,JointPQPlayer,244,214,458,30,24,Player A
1914,JointPQPlayer,282,202,484,32,16,Player A
1915,JointPQPlayer,141,261,402,13,37,JointPQPlayer
1916,JointPQPlayer,290,200,490,32,14,Player A
1917,JointPQPlayer,167,252,419,15,32,JointPQPlayer
1918,JointPQPlayer,268,208,476,30,18,Player A
1919,JointPQPlayer,298,193,491,36,15,Player A
1920,JointPQPlayer,262,207,469,32,21,Player A
1921,JointPQPlayer,280,200,480,34,18,Player A
1922,JointPQPlayer,277,202,479,33,18,Player A
1923,JointPQPlayer,278,203,481,32,17,Player A
1924,JointPQPlayer,261,216,477,25,16,Player A
1925,JointPQPlayer,179,244,423,19,32,JointPQPlayer
1926,JointPQPlayer,295,195,490,35,15,Player A
1927,JointPQPlayer,139,264,403,11,36,JointPQPlayer
1928,JointPQPlayer,265,210,475,29,18,Player A
1929,JointPQPlayer,279,204,483,31,16,Player A
1930,JointPQPlayer,286,196,482,36,18,Player A
1931,JointPQPlayer,301,191,492,37,15,Player A
1932,JointPQPlayer,123,273,396,7,37,JointPQPlayer
1933,JointPQPlayer,167,247,414,19,35,JointPQPlayer
1934,JointPQPlayer,259,209,468,31,21,Player A
1935,JointPQPlayer,149,259,408,13,35,JointPQPlayer
1936,JointPQPlayer,308,193,501,34,11,Player A
1937,JointPQPlayer,327,182,509,39,10,Player A
1938,JointPQPlayer,306,186,492,40,16,Player A
1939,JointPQPlayer,276,201,477,34,19,Player A
1940,JointPQPlayer,270,205,475,32,19,Player A
1941,JointPQPlayer,209,239,448,17,23,JointPQPlayer
1942,JointPQPlayer,280,205,485,30,15,Player A
1943,JointPQPlayer,287,197,484,35,17,Player A
1944,JointPQPlayer,312,187,499,38,13,Player A
1945,JointPQPlayer,135,260,395,15,40,JointPQPlayer
1946,JointPQPlayer,259,209,468,31,21,Player A
1947,JointPQPlayer,268,203,471,34,21,Player A
1948,JointPQPlayer,303,188,491,39,16,Player A
1949,JointPQPlayer,130,265,395,12,39,JointPQPlayer
1950,JointPQPlayer,314,189,503,36,11,Player A
1951,JointPQPlayer,301,191,492,37,15,Player A
1952,JointPQPlayer,294,194,488,36,16,Player A
1953,JointPQPlayer,145,260,405,13,36,JointPQPlayer
1954,JointPQPlayer,148,258,406,14,36,JointPQPlayer
1955,JointPQPlayer,272,202,474,34,20,Player A
1956,JointPQPlayer,293,193,486,37,17,Player A
1957,JointPQPlayer,278,203,481,32,17,Player A
1958,JointPQPlayer,272,207,479,30,17,Player A
1959,JointPQPlayer,307,187,494,39,15,Player A
1960,JointPQPlayer,297,197,494,33,13,Player A
1961,JointPQPlayer,154,259,413,12,33,JointPQPlayer
1962,JointPQPlayer,162,247,409,20,37,JointPQPlayer
1963,JointPQPlayer,311,191,502,35,11,Player A
1964,JointPQPlayer,274,204,478,32,18,Player A
1965,JointPQPlayer,296,196,492,34,14,Player A
1966,JointPQPlayer,141,266,407,9,34,JointPQPlayer
1967,JointPQPlayer,295,195,490,35,15,Player A
1968,JointPQPlayer,295,195,490,35,15,Player A
1969,JointPQPlayer,303,188,491,39,16,Player A
1970,JointPQPlayer,291,196,487,35,16,Player A
1971,JointPQPlayer,304,194,498,34,12,Player A
1972,JointPQPlayer,145,255,400,17,39,JointPQPlayer
1973,JointPQPlayer,164,249,413,18,35,JointPQPlayer
1974,JointPQPlayer,141,261,402,13,37,JointPQPlayer
1975,JointPQPlayer,282,207,489,28,13,Player A
1976,JointPQPlayer,270,205,475,32,19,Player A
1977,JointPQPlayer,169,254,423,13,30,JointPQPlayer
1978,JointPQPlayer,284,199,483,34,17,Player A
1979,JointPQPlayer,261,206,467,33,22,Player A
1980,JointPQPlayer,308,193,501,34,11,Player A
1981,JointPQPlayer,259,214,473,27,18,Player A
1982,JointPQPlayer,301,191,492,37,15,Player A
1983,JointPQPlayer,301,191,492,37,15,Player A
1984,JointPQPlayer,307,192,499,35,12,Player A
1985,JointPQPlayer,303,188,491,39,16,Player A
1986,JointPQPlayer,258,213,471,28,19,Player A
1987,JointPQPlayer,287,197,484,35,17,Player A
1988,JointPQPlayer,290,200,490,32,14,Player A
1989,JointPQPlayer,315,190,505,35,10,Player A
1990,JointPQPlayer,295,195,490,35,15,Player A
1991,JointPQPlayer,278,198,476,36,20,Player A
1992,JointPQPlayer,284,199,483,34,17,Player A
1993,JointPQPlayer,247,217,464,27,21,Player A
1994,JointPQPlayer,287,197,484,35,17,Player A
1995,JointPQPlayer,277,202,479,33,18,Player A
1996,JointPQPlayer,272,207,479,30,17,Player A
1997,JointPQPlayer,165,255,420,13,31,JointPQPlayer
1998,JointPQPlayer,143,258,401,15,38,JointPQPlayer
1999,JointPQPlayer,271,211,482,27,15,Player A
2000,JointPQPlayer,291,196,487,35,16,Player A
2001,JointPQPlayer,281,201,482,33,17,Player A
2002,JointPQPlayer,145,260,405,13,36,JointPQPlayer
2003,JointPQPlayer,283,198,481,35,18,Player A
2004,JointPQPlayer,228,228,456,22,22,Tie
2005,JointPQPlayer,264,204,468,34,22,Player A
2006,JointPQPlayer,328,183,511,38,9,Player A
2007,JointPQPlayer,307,192,499,35,12,Player A
2008,JointPQPlayer,324,184,508,38,10,Player A
2009,JointPQPlayer,296,201,497,30,11,Player A
2010,JointPQPlayer,297,192,489,37,16,Player A
2011,JointPQPlayer,295,195,490,35,15,Player A
2012,JointPQPlayer,138,263,401,12,37,JointPQPlayer
2013,JointPQPlayer,277,207,484,29,15,Player A
2014,JointPQPlayer,305,190,495,37,14,Player A
2015,JointPQPlayer,141,261,402,13,37,JointPQPlayer
2016,JointPQPlayer,166,251,417,16,33,JointPQPlayer
2017,JointPQPlayer,292,197,489,34,15,Player A
2018,JointPQPlayer,316,186,502,38,12,Player A
2019,JointPQPlayer,305,185,490,41,17,Player A
2020,JointPQPlayer,258,218,476,24,16,Player A
2021,JointPQPlayer,298,188,486,40,18,Player A
2022,JointPQPlayer,333,183,516,37,7,Player A
2023,JointPQPlayer,321,181,502,41,13,Player A
2024,JointPQPlayer,304,194,498,34,12,Player A
2025,JointPQPlayer,279,209,488,27,13,Player A
2026,JointPQPlayer,316,191,507,34,9,Player A
2027,JointPQPlayer,314,184,498,40,14,Player A
2028,JointPQPlayer,211,231,442,23,27,JointPQPlayer
2029,JointPQPlayer,273,203,476,33,19,Player A
2030,JointPQPlayer,301,191,492,37,15,Player A
2031,JointPQPlayer,244,214,458,30,24,Player A
2032,JointPQPlayer,309,189,498,37,13,Player A
2033,JointPQPlayer,262,212,474,28,18,Player A
2034,JointPQPlayer,293,198,491,33,14,Player A
2035,JointPQPlayer,286,201,487,32,15,Player A
2036,JointPQPlayer,268,203,471,34,21,Player A
2037,JointPQPlayer,286,201,487,32,15,Player A
2038,JointPQPlayer,174,249,423,16,31,JointPQPlayer
2039,JointPQPlayer,297,192,489,37,16,Player A
2040,JointPQPlayer,299,189,488,39,17,Player A
2041,JointPQPlayer,284,199,483,34,17,Player A
2042,JointPQPlayer,301,191,492,37,15,Player A
2043,JointPQPlayer,268,203,471,34,21,Player A
2044,JointPQPlayer,284,194,478,38,20,Player A
2045,JointPQPlayer,300,195,495,34,13,Player A
2046,JointPQPlayer,282,197,479,36,19,Player A
2047,JointPQPlayer,281,201,482,33,17,Player A
2048,JointPQPlayer,281,196,477,37,20,Player A
2049,JointPQPlayer,132,257,389,18,43,JointPQPlayer
2050,JointPQPlayer,321,186,507,37,10,Player A
2051,JointPQPlayer,300,190,490,38,16,Player A
2052,JointPQPlayer,314,184,498,40,14,Player A
2053,JointPQPlayer,295,200,495,31,12,Player A
2054,JointPQPlayer,127,262,389,15,42,JointPQPlayer
2055,JointPQPlayer,296,196,492,34,14,Player A
2056,JointPQPlayer,280,200,480,34,18,Player A
2057,JointPQPlayer,275,210,485,27,14,Player A
2058,JointPQPlayer,307,187,494,39,15,Player A
2059,JointPQPlayer,269,204,473,33,20,Player A
2060,JointPQPlayer,297,197,494,33,13,Player A
2061,JointPQPlayer,274,204,478,32,18,Player A
2062,JointPQPlayer,127,262,389,15,42,JointPQPlayer
2063,JointPQPlayer,293,198,491,33,14,Player A
2064,JointPQPlayer,166,246,412,20,36,JointPQPlayer
2065,JointPQPlayer,307,187,494,39,15,Player A
2066,JointPQPlayer,164,254,418,14,32,JointPQPlayer
2067,JointPQPlayer,292,202,494,30,12,Player A
2068,JointPQPlayer,279,199,478,35,19,Player A
2069,JointPQPlayer,265,210,475,29,18,Player A
2070,JointPQPlayer,246,216,462,28,22,Player A
2071,JointPQPlayer,219,229,448,23,25,JointPQPlayer
2072,JointPQPlayer,269,204,473,33,20,Player A
2073,JointPQPlayer,301,196,497,33,12,Player A
2074,JointPQPlayer,316,181,497,42,15,Player A
2075,JointPQPlayer,300,195,495,34,13,Player A
2076,JointPQPlayer,294,199,493,32,13,Player A
2077,JointPQPlayer,303,193,496,35,13,Player A
2078,JointPQPlayer,272,207,479,30,17,Player A
2079,JointPQPlayer,317,187,504,37,11,Player A
2080,JointPQPlayer,249,219,468,25,19,Player A
2081,JointPQPlayer,305,195,500,33,11,Player A
2082,JointPQPlayer,287,197,484,35,17,Player A
2083,JointPQPlayer,200,235,435,22,29,JointPQPlayer
2084,JointPQPlayer,148,258,406,14,36,JointPQPlayer
2085,JointPQPlayer,330,180,510,40,10,Player A
2086,JointPQPlayer,283,203,486,31,15,Player A
2087,JointPQPlayer,288,198,486,34,16,Player A
2088,JointPQPlayer,289,199,488,33,15,Player A
2089,JointPQPlayer,287,202,489,31,14,Player A
2090,JointPQPlayer,146,256,402,16,38,JointPQPlayer
2091,JointPQPlayer,291,201,492,31,13,Player A
2092,JointPQPlayer,269,209,478,29,17,Player A
2093,JointPQPlayer,291,196,487,35,16,Player A
2094,JointPQPlayer,276,201,477,34,19,Player A
2095,JointPQPlayer,321,181,502,41,13,Player A
2096,JointPQPlayer,307,187,494,39,15,Player A
2097,JointPQPlayer,301,191,492,37,15,Player A
2098,JointPQPlayer,316,186,502,38,12,Player A
2099,JointPQPlayer,308,188,496,38,14,Player A
2100,JointPQPlayer,296,196,492,34,14,Player A
2101,JointPQPlayer,281,201,482,33,17,Player A
2102,JointPQPlayer,302,192,494,36,14,Player A
2103,JointPQPlayer,316,191,507,34,9,Player A
2104,JointPQPlayer,277,197,474,37,21,Player A
2105,JointPQPlayer,310,190,500,36,12,Player A
2106,JointPQPlayer,151,256,407,15,36,JointPQPlayer
2107,JointPQPlayer,300,195,495,34,13,Player A
2108,JointPQPlayer,283,198,481,35,18,Player A
2109,JointPQPlayer,296,191,487,38,17,Player A
2110,JointPQPlayer,281,201,482,33,17,Player A
2111,JointPQPlayer,303,193,496,35,13,Player A
2112,JointPQPlayer,154,254,408,16,36,JointPQPlayer
2113,JointPQPlayer,304,189,493,38,15,Player A
2114,JointPQPlayer,305,195,500,33,11,Player A
2115,JointPQPlayer,173,253,426,13,29,JointPQPlayer
2116,JointPQPlayer,283,203,486,31,15,Player A
2117,JointPQPlayer,146,256,402,16,38,JointPQPlayer
2118,JointPQPlayer,186,246,432,16,28,JointPQPlayer
2119,JointPQPlayer,279,199,478,35,19,Player A
2120,JointPQPlayer,237,222,459,25,22,Player A
2121,JointPQPlayer,237,217,454,29,25,Player A
2122,JointPQPlayer,289,194,483,37,18,Player A
2123,JointPQPlayer,280,205,485,30,15,Player A
2124,JointPQPlayer,288,203,491,30,13,Player A
2125,JointPQPlayer,302,187,489,40,17,Player A
2126,JointPQPlayer,223,223,446,27,27,Tie
2127,JointPQPlayer,142,262,404,12,36,JointPQPlayer
2128,JointPQPlayer,290,200,490,32,14,Player A
2129,JointPQPlayer,162,252,414,16,34,JointPQPlayer
2130,JointPQPlayer,296,191,487,38,17,Player A
2131,JointPQPlayer,269,204,473,33,20,Player A
2132,JointPQPlayer,286,201,487,32,15,Player A
2133,JointPQPlayer,276,201,477,34,19,Player A
2134,JointPQPlayer,293,203,496,29,11,Player A
2135,JointPQPlayer,154,254,408,16,36,JointPQPlayer
2136,JointPQPlayer,260,215,475,26,17,Player A
2137,JointPQPlayer,320,185,505,38,11,Player A
2138,JointPQPlayer,144,259,403,14,37,JointPQPlayer
2139,JointPQPlayer,277,202,479,33,18,Player A
2140,JointPQPlayer,288,198,486,34,16,Player A
2141,JointPQPlayer,138,263,401,12,37,JointPQPlayer
2142,JointPQPlayer,320,185,505,38,11,Player A
2143,JointPQPlayer,292,197,489,34,15,Player A
2144,JointPQPlayer,120,270,390,10,40,JointPQPlayer
2145,JointPQPlayer,321,186,507,37,10,Player A
2146,JointPQPlayer,287,197,484,35,17,Player A
2147,JointPQPlayer,231,226,457,23,22,Player A
2148,JointPQPlayer,265,215,480,25,15,Player A
2149,JointPQPlayer,257,212,469,29,20,Player A
2150,JointPQPlayer,291,191,482,39,19,Player A
2151,JointPQPlayer,309,184,493,41,16,Player A
2152,JointPQPlayer,142,262,404,12,36,JointPQPlayer
2153,JointPQPlayer,178,248,426,16,30,JointPQPlayer
2154,JointPQPlayer,299,194,493,35,14,Player A
2155,JointPQPlayer,294,194,488,36,16,Player A
2156,JointPQPlayer,270,200,470,36,22,Player A
2157,JointPQPlayer,205,235,440,21,27,JointPQPlayer
2158,JointPQPlayer,277,207,484,29,15,Player A
2159,JointPQPlayer,301,191,492,37,15,Player A
2160,JointPQPlayer,298,198,496,32,12,Player A
2161,JointPQPlayer,251,211,462,31,23,Player A
2162,JointPQPlayer,305,190,495,37,14,Player A
2163,JointPQPlayer,140,260,400,14,38,JointPQPlayer
2164,JointPQPlayer,293,193,486,37,17,Player A
2165,JointPQPlayer,153,253,406,17,37,JointPQPlayer
2166,JointPQPlayer,206,236,442,20,26,JointPQPlayer
2167,JointPQPlayer,277,197,474,37,21,Player A
2168,JointPQPlayer,311,186,497,39,14,Player A
2169,JointPQPlayer,293,198,491,33,14,Player A
2170,JointPQPlayer,316,186,502,38,12,Player A
2171,JointPQPlayer,278,198,476,36,20,Player A
2172,JointPQPlayer,152,262,414,10,32,JointPQPlayer
2173,JointPQPlayer,148,253,401,18,39,JointPQPlayer
2174,JointPQPlayer,234,224,458,24,22,Player A
2175,JointPQPlayer,310,185,495,40,15,Player A
2176,JointPQPlayer,326,186,512,36,8,Player A
2177,JointPQPlayer,297,192,489,37,16,Player A
2178,JointPQPlayer,306,186,492,40,16,Player A
2179,JointPQPlayer,300,195,495,34,13,Player A
2180,JointPQPlayer,283,198,481,35,18,Player A
2181,JointPQPlayer,269,209,478,29,17,Player A
2182,JointPQPlayer,300,195,495,34,13,Player A
2183,JointPQPlayer,285,195,480,37,19,Player A
2184,JointPQPlayer,147,257,404,15,37,JointPQPlayer
2185,JointPQPlayer,143,263,406,11,35,JointPQPlayer
2186,JointPQPlayer,275,200,475,35,20,Player A
2187,JointPQPlayer,302,192,494,36,14,Player A
2188,JointPQPlayer,310,185,495,40,15,Player A
2189,JointPQPlayer,312,187,499,38,13,Player A
2190,JointPQPlayer,283,198,481,35,18,Player A
2191,JointPQPlayer,302,192,494,36,14,Player A
2192,JointPQPlayer,154,254,408,16,36,JointPQPlayer
2193,JointPQPlayer,141,261,402,13,37,JointPQPlayer
2194,JointPQPlayer,151,256,407,15,36,JointPQPlayer
2195,JointPQPlayer,289,199,488,33,15,Player A
2196,JointPQPlayer,153,263,416,9,31,JointPQPlayer
2197,JointPQPlayer,160,250,410,18,36,JointPQPlayer
2198,JointPQPlayer,310,190,500,36,12,Player A
2199,JointPQPlayer,181,246,427,17,30,JointPQPlayer
2200,JointPQPlayer,256,211,467,30,21,Player A
2201,JointPQPlayer,300,190,490,38,16,Player A
2202,JointPQPlayer,302,192,494,36,14,Player A
2203,JointPQPlayer,298,198,496,32,12,Player A
2204,JointPQPlayer,270,205,475,32,19,Player A
2205,JointPQPlayer,165,250,415,17,34,JointPQPlayer
2206,JointPQPlayer,287,197,484,35,17,Player A
2207,JointPQPlayer,306,191,497,36,13,Player A
2208,JointPQPlayer,261,211,472,29,19,Player A
2209,JointPQPlayer,258,213,471,28,19,Player A
2210,JointPQPlayer,296,191,487,38,17,Player A
2211,JointPQPlayer,302,192,494,36,14,Player A
2212,JointPQPlayer,283,203,486,31,15,Player A
2213,JointPQPlayer,295,195,490,35,15,Player A
2214,JointPQPlayer,305,195,500,33,11,Player A
2215,JointPQPlayer,286,196,482,36,18,Player A
2216,JointPQPlayer,274,209,483,28,15,Player A
2217,JointPQPlayer,282,202,484,32,16,Player A
2218,JointPQPlayer,285,200,485,33,16,Player A
2219,JointPQPlayer,243,218,461,27,22,Player A
2220,JointPQPlayer,303,198,501,31,10,Player A
2221,JointPQPlayer,295,195,490,35,15,Player A
2222,JointPQPlayer,279,204,483,31,16,Player A
2223,JointPQPlayer,124,264,388,14,42,JointPQPlayer
2224,JointPQPlayer,314,189,503,36,11,Player A
2225,JointPQPlayer,295,195,490,35,15,Player A
2226,JointPQPlayer,270,205,475,32,19,Player A
2227,JointPQPlayer,290,195,485,36,17,Player A
2228,JointPQPlayer,336,181,517,38,7,Player A
2229,JointPQPlayer,275,205,480,31,17,Player A
2230,JointPQPlayer,316,191,507,34,9,Player A
2231,JointPQPlayer,161,251,412,17,35,JointPQPlayer
2232,JointPQPlayer,134,264,398,12,38,JointPQPlayer
2233,JointPQPlayer,324,179,503,42,13,Player A
2234,JointPQPlayer,280,205,485,30,15,Player A
2235,JointPQPlayer,121,271,392,9,39,JointPQPlayer
2236,JointPQPlayer,311,191,502,35,11,Player A
2237,JointPQPlayer,297,192,489,37,16,Player A
2238,JointPQPlayer,285,200,485,33,16,Player A
2239,JointPQPlayer,283,198,481,35,18,Player A
2240,JointPQPlayer,293,198,491,33,14,Player A
2241,JointPQPlayer,308,193,501,34,11,Player A
2242,JointPQPlayer,148,258,406,14,36,JointPQPlayer
2243,JointPQPlayer,279,199,478,35,19,Player A
2244,JointPQPlayer,316,191,507,34,9,Player A
2245,JointPQPlayer,151,256,407,15,36,JointPQPlayer
2246,JointPQPlayer,291,196,487,35,16,Player A
2247,JointPQPlayer,298,188,486,40,18,Player A
2248,JointPQPlayer,130,270,400,8,36,JointPQPlayer
2249,JointPQPlayer,298,193,491,36,15,Player A
2250,JointPQPlayer,146,261,407,12,35,JointPQPlayer
2251,JointPQPlayer,292,197,489,34,15,Player A
2252,JointPQPlayer,267,202,469,35,22,Player A
2253,JointPQPlayer,281,201,482,33,17,Player A
2254,JointPQPlayer,158,258,416,12,32,JointPQPlayer
2255,JointPQPlayer,312,187,499,38,13,Player A
2256,JointPQPlayer,192,242,434,18,28,JointPQPlayer
2257,JointPQPlayer,298,193,491,36,15,Player A
2258,JointPQPlayer,145,260,405,13,36,JointPQPlayer
2259,JointPQPlayer,150,250,400,20,40,JointPQPlayer
2260,JointPQPlayer,139,264,403,11,36,JointPQPlayer
2261,JointPQPlayer,114,274,388,8,40,JointPQPlayer
2262,JointPQPlayer,293,193,486,37,17,Player A
2263,JointPQPlayer,282,202,484,32,16,Player A
2264,JointPQPlayer,315,185,500,39,13,Player A
2265,JointPQPlayer,294,194,488,36,16,Player A
2266,JointPQPlayer,295,195,490,35,15,Player A
2267,JointPQPlayer,287,202,489,31,14,Player A
2268,JointPQPlayer,320,185,505,38,11,Player A
2269,JointPQPlayer,296,196,492,34,14,Player A
2270,JointPQPlayer,267,212,479,27,16,Player A
2271,JointPQPlayer,284,194,478,38,20,Player A
2272,JointPQPlayer,297,187,484,41,19,Player A
2273,JointPQPlayer,298,193,491,36,15,Player A
2274,JointPQPlayer,126,271,397,8,37,JointPQPlayer
2275,JointPQPlayer,321,181,502,41,13,Player A
2276,JointPQPlayer,300,195,495,34,13,Player A
2277,JointPQPlayer,287,202,489,31,14,Player A
2278,JointPQPlayer,309,189,498,37,13,Player A
2279,JointPQPlayer,158,258,416,12,32,JointPQPlayer
2280,JointPQPlayer,306,196,502,32,10,Player A
2281,JointPQPlayer,302,192,494,36,14,Player A
2282,JointPQPlayer,314,184,498,40,14,Player A
2283,JointPQPlayer,256,211,467,30,21,Player A
2284,JointPQPlayer,308,193,501,34,11,Player A
2285,JointPQPlayer,279,199,478,35,19,Player A
2286,JointPQPlayer,291,196,487,35,16,Player A
2287,JointPQPlayer,127,267,394,11,39,JointPQPlayer
2288,JointPQPlayer,281,201,482,33,17,Player A
2289,JointPQPlayer,241,221,462,25,21,Player A
2290,JointPQPlayer,260,205,465,34,23,Player A
2291,JointPQPlayer,300,195,495,34,13,Player A
2292,JointPQPlayer,252,217,469,26,19,Player A
2293,JointPQPlayer,298,193,491,36,15,Player A
2294,JointPQPlayer,287,197,484,35,17,Player A
2295,JointPQPlayer,322,182,504,40,12,Player A
2296,JointPQPlayer,226,221,447,28,27,Player A
2297,JointPQPlayer,194,234,428,24,32,JointPQPlayer
2298,JointPQPlayer,173,248,421,17,32,JointPQPlayer
2299,JointPQPlayer,285,205,490,29,13,Player A
2300,JointPQPlayer,146,256,402,16,38,JointPQPlayer
2301,JointPQPlayer,274,209,483,28,15,Player A
2302,JointPQPlayer,279,199,478,35,19,Player A
2303,JointPQPlayer,234,219,453,28,25,Player A
2304,JointPQPlayer,295,195,490,35,15,Player A
2305,JointPQPlayer,252,212,464,30,22,Player A
2306,JointPQPlayer,308,188,496,38,14,Player A
2307,JointPQPlayer,128,263,391,14,41,JointPQPlayer
2308,JointPQPlayer,298,193,491,36,15,Player A
2309,JointPQPlayer,299,194,493,35,14,Player A
2310,JointPQPlayer,282,202,484,32,16,Player A
2311,JointPQPlayer,292,192,484,38,18,Player A
2312,JointPQPlayer,273,208,481,29,16,Player A
2313,JointPQPlayer,293,198,491,33,14,Player A
2314,JointPQPlayer,120,265,385,14,43,JointPQPlayer
2315,JointPQPlayer,300,195,495,34,13,Player A
2316,JointPQPlayer,149,259,408,13,35,JointPQPlayer
2317,JointPQPlayer,293,198,491,33,14,Player A
2318,JointPQPlayer,198,233,431,24,31,JointPQPlayer
2319,JointPQPlayer,297,192,489,37,16,Player A
2320,JointPQPlayer,301,196,497,33,12,Player A
2321,JointPQPlayer,253,208,461,33,24,Player A
2322,JointPQPlayer,239,219,458,27,23,Player A
2323,JointPQPlayer,298,193,491,36,15,Player A
2324,JointPQPlayer,224,219,443,30,29,Player A
2325,JointPQPlayer,292,197,489,34,15,Player A
2326,JointPQPlayer,160,255,415,14,33,JointPQPlayer
2327,JointPQPlayer,306,191,497,36,13,Player A
2328,JointPQPlayer,297,192,489,37,16,Player A
2329,JointPQPlayer,286,196,482,36,18,Player A
2330,JointPQPlayer,160,255,415,14,33,JointPQPlayer
2331,JointPQPlayer,139,264,403,11,36,JointPQPlayer
2332,JointPQPlayer,269,214,483,25,14,Player A
2333,JointPQPlayer,272,202,474,34,20,Player A
2334,JointPQPlayer,272,202,474,34,20,Player A
2335,JointPQPlayer,308,193,501,34,11,Player A
2336,JointPQPlayer,318,188,506,36,10,Player A
2337,JointPQPlayer,278,203,481,32,17,Player A
2338,JointPQPlayer,295,200,495,31,12,Player A
2339,JointPQPlayer,287,197,484,35,17,Player A
2340,JointPQPlayer,136,261,397,14,39,JointPQPlayer
2341,JointPQPlayer,297,197,494,33,13,Player A
2342,JointPQPlayer,131,261,392,15,41,JointPQPlayer
2343,JointPQPlayer,313,183,496,41,15,Player A
2344,JointPQPlayer,274,204,478,32,18,Player A
2345,JointPQPlayer,162,252,414,16,34,JointPQPlayer
2346,JointPQPlayer,278,203,481,32,17,Player A
2347,JointPQPlayer,247,217,464,27,21,Player A
2348,JointPQPlayer,260,210,470,30,20,Player A
2349,JointPQPlayer,163,253,416,15,33,JointPQPlayer
2350,JointPQPlayer,330,185,515,36,7,Player A
2351,JointPQPlayer,284,194,478,38,20,Player A
2352,JointPQPlayer,278,203,481,32,17,Player A
2353,JointPQPlayer,153,263,416,9,31,JointPQPlayer
2354,JointPQPlayer,289,199,488,33,15,Player A
2355,JointPQPlayer,302,197,499,32,11,Player A
2356,JointPQPlayer,281,201,482,33,17,Player A
2357,JointPQPlayer,271,201,472,35,21,Player A
2358,JointPQPlayer,286,196,482,36,18,Player A
2359,JointPQPlayer,297,192,489,37,16,Player A
2360,JointPQPlayer,298,193,491,36,15,Player A
2361,JointPQPlayer,271,211,482,27,15,Player A
2362,JointPQPlayer,299,189,488,39,17,Player A
2363,JointPQPlayer,184,239,423,22,33,JointPQPlayer
2364,JointPQPlayer,312,187,499,38,13,Player A
2365,JointPQPlayer,263,203,466,35,23,Player A
2366,JointPQPlayer,299,194,493,35,14,Player A
2367,JointPQPlayer,204,239,443,18,25,JointPQPlayer
2368,JointPQPlayer,160,255,415,14,33,JointPQPlayer
2369,JointPQPlayer,232,222,454,26,24,Player A
2370,JointPQPlayer,281,201,482,33,17,Player A
2371,JointPQPlayer,159,254,413,15,34,JointPQPlayer
2372,JointPQPlayer,283,203,486,31,15,Player A
2373,JointPQPlayer,309,189,498,37,13,Player A
2374,JointPQPlayer,138,253,391,20,43,JointPQPlayer
2375,JointPQPlayer,297,197,494,33,13,Player A
2376,JointPQPlayer,302,192,494,36,14,Player A
2377,JointPQPlayer,289,204,493,29,12,Player A
2378,JointPQPlayer,309,194,503,33,10,Player A
2379,JointPQPlayer,284,199,483,34,17,Player A
2380,JointPQPlayer,159,254,413,15,34,JointPQPlayer
2381,JointPQPlayer,119,274,393,7,38,JointPQPlayer
2382,JointPQPlayer,282,197,479,36,19,Player A
2383,JointPQPlayer,276,206,482,30,16,Player A
2384,JointPQPlayer,277,202,479,33,18,Player A
2385,JointPQPlayer,288,198,486,34,16,Player A
2386,JointPQPlayer,292,197,489,34,15,Player A
2387,JointPQPlayer,290,195,485,36,17,Player A
2388,JointPQPlayer,313,193,506,33,9,Player A
2389,JointPQPlayer,123,273,396,7,37,JointPQPlayer
2390,JointPQPlayer,270,210,480,28,16,Player A
2391,JointPQPlayer,208,233,441,22,27,JointPQPlayer
2392,JointPQPlayer,243,218,461,27,22,Player A
2393,JointPQPlayer,163,253,416,15,33,JointPQPlayer
2394,JointPQPlayer,157,257,414,13,33,JointPQPlayer
2395,JointPQPlayer,302,192,494,36,14,Player A
2396,JointPQPlayer,318,188,506,36,10,Player A
2397,JointPQPlayer,312,187,499,38,13,Player A
2398,JointPQPlayer,259,204,463,35,24,Player A
2399,JointPQPlayer,257,212,469,29,20,Player A
2400,JointPQPlayer,138,263,401,12,37,JointPQPlayer
2401,JointPQPlayer,188,238,426,22,32,JointPQPlayer
2402,JointPQPlayer,159,254,413,15,34,JointPQPlayer
2403,JointPQPlayer,271,201,472,35,21,Player A
2404,JointPQPlayer,292,197,489,34,15,Player A
2405,JointPQPlayer,159,259,418,11,31,JointPQPlayer
2406,JointPQPlayer,156,256,412,14,34,JointPQPlayer
2407,JointPQPlayer,255,205,460,35,25,Player A
2408,JointPQPlayer,293,198,491,33,14,Player A
2409,JointPQPlayer,275,205,480,31,17,Player A
2410,JointPQPlayer,305,195,500,33,11,Player A
2411,JointPQPlayer,299,194,493,35,14,Player A
2412,JointPQPlayer,303,193,496,35,13,Player A
2413,JointPQPlayer,277,202,479,33,18,Player A
2414,JointPQPlayer,234,219,453,28,25,Player A
2415,JointPQPlayer,298,188,486,40,18,Player A
2416,JointPQPlayer,152,252,404,18,38,JointPQPlayer
2417,JointPQPlayer,159,254,413,15,34,JointPQPlayer
2418,JointPQPlayer,321,186,507,37,10,Player A
2419,JointPQPlayer,269,204,473,33,20,Player A
2420,JointPQPlayer,144,254,398,18,40,JointPQPlayer
2421,JointPQPlayer,307,192,499,35,12,Player A
2422,JointPQPlayer,284,199,483,34,17,Player A
2423,JointPQPlayer,279,199,478,35,19,Player A
2424,JointPQPlayer,283,198,481,35,18,Player A
2425,JointPQPlayer,295,195,490,35,15,Player A
2426,JointPQPlayer,248,218,466,26,20,Player A
2427,JointPQPlayer,286,196,482,36,18,Player A
2428,JointPQPlayer,274,199,473,36,21,Player A
2429,JointPQPlayer,122,267,389,12,41,JointPQPlayer
2430,JointPQPlayer,290,200,490,32,14,Player A
2431,JointPQPlayer,294,199,493,32,13,Player A
2432,JointPQPlayer,121,266,387,13,42,JointPQPlayer
2433,JointPQPlayer,147,257,404,15,37,JointPQPlayer
2434,JointPQPlayer,307,192,499,35,12,Player A
2435,JointPQPlayer,256,216,472,26,18,Player A
2436,JointPQPlayer,266,206,472,32,20,Player A
2437,JointPQPlayer,282,197,479,36,19,Player A
2438,JointPQPlayer,147,262,409,11,34,JointPQPlayer
2439,JointPQPlayer,298,193,491,36,15,Player A
2440,JointPQPlayer,309,189,498,37,13,Player A
2441,JointPQPlayer,287,202,489,31,14,Player A
2442,JointPQPlayer,252,212,464,30,22,Player A
2443,JointPQPlayer,308,188,496,38,14,Player A
2444,JointPQPlayer,259,214,473,27,18,Player A
2445,JointPQPlayer,290,195,485,36,17,Player A
2446,JointPQPlayer,141,261,402,13,37,JointPQPlayer
2447,JointPQPlayer,301,186,487,41,18,Player A
2448,JointPQPlayer,114,274,388,8,40,JointPQPlayer
2449,JointPQPlayer,308,188,496,38,14,Player A
2450,JointPQPlayer,266,211,477,28,17,Player A
2451,JointPQPlayer,319,189,508,35,9,Player A
2452,JointPQPlayer,333,178,511,41,10,Player A
2453,JointPQPlayer,172,247,419,18,33,JointPQPlayer
2454,JointPQPlayer,293,198,491,33,14,Player A
2455,JointPQPlayer,297,197,494,33,13,Player A
2456,JointPQPlayer,299,194,493,35,14,Player A
2457,JointPQPlayer,294,189,483,40,19,Player A
2458,JointPQPlayer,280,200,480,34,18,Player A
2459,JointPQPlayer,122,267,389,12,41,JointPQPlayer
2460,JointPQPlayer,291,196,487,35,16,Player A
2461,JointPQPlayer,157,252,409,17,36,JointPQPlayer
2462,JointPQPlayer,269,204,473,33,20,Player A
2463,JointPQPlayer,304,189,493,38,15,Player A
2464,JointPQPlayer,302,187,489,40,17,Player A
2465,JointPQPlayer,266,211,477,28,17,Player A
2466,JointPQPlayer,289,194,483,37,18,Player A
2467,JointPQPlayer,255,210,465,31,22,Player A
2468,JointPQPlayer,265,205,470,33,21,Player A
2469,JointPQPlayer,250,210,460,32,24,Player A
2470,JointPQPlayer,274,204,478,32,18,Player A
2471,JointPQPlayer,301,191,492,37,15,Player A
2472,JointPQPlayer,174,244,418,20,34,JointPQPlayer
2473,JointPQPlayer,301,191,492,37,15,Player A
2474,JointPQPlayer,286,201,487,32,15,Player A
2475,JointPQPlayer,293,193,486,37,17,Player A
2476,JointPQPlayer,127,267,394,11,39,JointPQPlayer
2477,JointPQPlayer,212,227,439,26,29,JointPQPlayer
2478,JointPQPlayer,140,265,405,10,35,JointPQPlayer
2479,JointPQPlayer,283,203,486,31,15,Player A
2480,JointPQPlayer,282,202,484,32,16,Player A
2481,JointPQPlayer,305,190,495,37,14,Player A
2482,JointPQPlayer,304,189,493,38,15,Player A
2483,JointPQPlayer,307,192,499,35,12,Player A
2484,JointPQPlayer,163,253,416,15,33,JointPQPlayer
2485,JointPQPlayer,298,193,491,36,15,Player A
2486,JointPQPlayer,145,255,400,17,39,JointPQPlayer
2487,JointPQPlayer,287,192,479,39,20,Player A
2488,JointPQPlayer,264,209,473,30,19,Player A
2489,JointPQPlayer,312,187,499,38,13,Player A
2490,JointPQPlayer,307,192,499,35,12,Player A
2491,JointPQPlayer,281,196,477,37,20,Player A
2492,JointPQPlayer,305,185,490,41,17,Player A
2493,JointPQPlayer,281,206,487,29,14,Player A
2494,JointPQPlayer,290,195,485,36,17,Player A
2495,JointPQPlayer,142,257,399,16,39,JointPQPlayer
2496,JointPQPlayer,322,182,504,40,12,Player A
2497,JointPQPlayer,319,189,508,35,9,Player A
2498,JointPQPlayer,262,212,474,28,18,Player A
2499,JointPQPlayer,292,197,489,34,15,Player A
2500,JointPQPlayer,272,207,479,30,17,Player A
2501,JointPQPlayer,285,200,485,33,16,Player A
2502,JointPQPlayer,303,188,491,39,16,Player A
2503,JointPQPlayer,132,267,399,10,37,JointPQPlayer
2504,JointPQPlayer,206,231,437,24,29,JointPQPlayer
2505,JointPQPlayer,299,194,493,35,14,Player A
2506,JointPQPlayer,177,247,424,17,31,JointPQPlayer
2507,JointPQPlayer,131,266,397,11,38,JointPQPlayer
2508,JointPQPlayer,287,197,484,35,17,Player A
2509,JointPQPlayer,330,180,510,40,10,Player A
2510,JointPQPlayer,300,195,495,34,13,Player A
2511,JointPQPlayer,283,203,486,31,15,Player A
2512,JointPQPlayer,150,260,410,12,34,JointPQPlayer
2513,JointPQPlayer,298,193,491,36,15,Player A
2514,JointPQPlayer,212,227,439,26,29,JointPQPlayer
2515,JointPQPlayer,264,209,473,30,19,Player A
2516,JointPQPlayer,302,192,494,36,14,Player A
2517,JointPQPlayer,268,208,476,30,18,Player A
2518,JointPQPlayer,233,223,456,25,23,Player A
2519,JointPQPlayer,264,204,468,34,22,Player A
2520,JointPQPlayer,145,255,400,17,39,JointPQPlayer
2521,JointPQPlayer,144,264,408,10,34,JointPQPlayer
2522,JointPQPlayer,134,264,398,12,38,JointPQPlayer
2523,JointPQPlayer,301,191,492,37,15,Player A
2524,JointPQPlayer,294,199,493,32,13,Player A
2525,JointPQPlayer,298,198,496,32,12,Player A
2526,JointPQPlayer,323,183,506,39,11,Player A
2527,JointPQPlayer,291,201,492,31,13,Player A
2528,JointPQPlayer,198,233,431,24,31,JointPQPlayer
2529,JointPQPlayer,313,193,506,33,9,Player A
2530,JointPQPlayer,264,214,478,26,16,Player A
2531,JointPQPlayer,303,188,491,39,16,Player A
2532,JointPQPlayer,237,217,454,29,25,Player A
2533,JointPQPlayer,134,264,398,12,38,JointPQPlayer
2534,JointPQPlayer,250,210,460,32,24,Player A
2535,JointPQPlayer,292,197,489,34,15,Player A
2536,JointPQPlayer,264,199,463,38,25,Player A
2537,JointPQPlayer,290,200,490,32,14,Player A
2538,JointPQPlayer,144,259,403,14,37,JointPQPlayer
2539,JointPQPlayer,312,187,499,38,13,Player A
2540,JointPQPlayer,299,194,493,35,14,Player A
2541,JointPQPlayer,324,184,508,38,10,Player A
2542,JointPQPlayer,287,192,479,39,20,Player A
2543,JointPQPlayer,286,201,487,32,15,Player A
2544,JointPQPlayer,295,195,490,35,15,Player A
2545,JointPQPlayer,328,178,506,42,12,Player A
2546,JointPQPlayer,285,200,485,33,16,Player A
2547,JointPQPlayer,290,200,490,32,14,Player A
2548,JointPQPlayer,299,189,488,39,17,Player A
2549,JointPQPlayer,298,193,491,36,15,Player A
2550,JointPQPlayer,292,202,494,30,12,Player A
2551,JointPQPlayer,269,204,473,33,20,Player A
2552,JointPQPlayer,303,198,501,31,10,Player A
2553,JointPQPlayer,300,190,490,38,16,Player A
2554,JointPQPlayer,291,201,492,31,13,Player A
2555,JointPQPlayer,126,266,392,12,40,JointPQPlayer
2556,JointPQPlayer,187,237,424,23,33,JointPQPlayer
2557,JointPQPlayer,150,265,415,8,31,JointPQPlayer
2558,JointPQPlayer,283,203,486,31,15,Player A
2559,JointPQPlayer,295,195,490,35,15,Player A
2560,JointPQPlayer,275,205,480,31,17,Player A
2561,JointPQPlayer,293,198,491,33,14,Player A
2562,JointPQPlayer,290,190,480,40,20,Player A
2563,JointPQPlayer,166,251,417,16,33,JointPQPlayer
2564,JointPQPlayer,303,193,496,35,13,Player A
2565,JointPQPlayer,314,184,498,40,14,Player A
2566,JointPQPlayer,330,180,510,40,10,Player A
2567,JointPQPlayer,288,198,486,34,16,Player A
2568,JointPQPlayer,294,194,488,36,16,Player A
2569,JointPQPlayer,279,204,483,31,16,Player A
2570,JointPQPlayer,278,198,476,36,20,Player A
2571,JointPQPlayer,288,198,486,34,16,Player A
2572,JointPQPlayer,277,202,479,33,18,Player A
2573,JointPQPlayer,197,237,434,21,29,JointPQPlayer
2574,JointPQPlayer,277,202,479,33,18,Player A
2575,JointPQPlayer,274,204,478,32,18,Player A
2576,JointPQPlayer,274,204,478,32,18,Player A
2577,JointPQPlayer,133,268,401,9,36,JointPQPlayer
2578,JointPQPlayer,159,254,413,15,34,JointPQPlayer
2579,JointPQPlayer,283,203,486,31,15,Player A
2580,JointPQPlayer,276,201,477,34,19,Player A
2581,JointPQPlayer,262,207,469,32,21,Player A
2582,JointPQPlayer,135,260,395,15,40,JointPQPlayer
2583,JointPQPlayer,289,204,493,29,12,Player A
2584,JointPQPlayer,329,184,513,37,8,Player A
2585,JointPQPlayer,293,198,491,33,14,Player A
2586,JointPQPlayer,317,187,504,37,11,Player A
2587,JointPQPlayer,282,202,484,32,16,Player A
2588,JointPQPlayer,304,189,493,38,15,Player A
2589,JointPQPlayer,312,182,494,42,16,Player A
2590,JointPQPlayer,295,195,490,35,15,Player A
2591,JointPQPlayer,254,209,463,32,23,Player A
2592,JointPQPlayer,160,250,410,18,36,JointPQPlayer
2593,JointPQPlayer,293,193,486,37,17,Player A
2594,JointPQPlayer,266,206,472,32,20,Player A
2595,JointPQPlayer,298,193,491,36,15,Player A
2596,JointPQPlayer,288,198,486,34,16,Player A
2597,JointPQPlayer,291,196,487,35,16,Player A
2598,JointPQPlayer,302,192,494,36,14,Player A
2599,JointPQPlayer,142,262,404,12,36,JointPQPlayer
2600,JointPQPlayer,273,198,471,37,22,Player A
2601,JointPQPlayer,277,207,484,29,15,Player A
2602,JointPQPlayer,302,192,494,36,14,Player A
2603,JointPQPlayer,235,225,460,23,21,Player A
2604,JointPQPlayer,292,192,484,38,18,Player A
2605,JointPQPlayer,303,193,496,35,13,Player A
2606,JointPQPlayer,272,207,479,30,17,Player A
2607,JointPQPlayer,110,270,380,12,44,JointPQPlayer
2608,JointPQPlayer,285,200,485,33,16,Player A
2609,JointPQPlayer,307,192,499,35,12,Player A
2610,JointPQPlayer,297,192,489,37,16,Player A
2611,JointPQPlayer,287,202,489,31,14,Player A
2612,JointPQPlayer,286,196,482,36,18,Player A
2613,JointPQPlayer,274,209,483,28,15,Player A
2614,JointPQPlayer,250,210,460,32,24,Player A
2615,JointPQPlayer,268,208,476,30,18,Player A
2616,JointPQPlayer,277,202,479,33,18,Player A
2617,JointPQPlayer,291,196,487,35,16,Player A
2618,JointPQPlayer,301,196,497,33,12,Player A
2619,JointPQPlayer,305,190,495,37,14,Player A
2620,JointPQPlayer,311,186,497,39,14,Player A
2621,JointPQPlayer,136,261,397,14,39,JointPQPlayer
2622,JointPQPlayer,281,201,482,33,17,Player A
2623,JointPQPlayer,285,195,480,37,19,Player A
2624,JointPQPlayer,267,207,474,31,19,Player A
2625,JointPQPlayer,299,194,493,35,14,Player A
2626,JointPQPlayer,301,196,497,33,12,Player A
2627,JointPQPlayer,155,250,405,19,38,JointPQPlayer
2628,JointPQPlayer,301,191,492,37,15,Player A
2629,JointPQPlayer,292,197,489,34,15,Player A
2630,JointPQPlayer,260,215,475,26,17,Player A
2631,JointPQPlayer,165,250,415,17,34,JointPQPlayer
2632,JointPQPlayer,309,189,498,37,13,Player A
2633,JointPQPlayer,309,189,498,37,13,Player A
2634,JointPQPlayer,305,185,490,41,17,Player A
2635,JointPQPlayer,146,261,407,12,35,JointPQPlayer
2636,JointPQPlayer,158,258,416,12,32,JointPQPlayer
2637,JointPQPlayer,251,216,467,27,20,Player A
2638,JointPQPlayer,292,197,489,34,15,Player A
2639,JointPQPlayer,275,200,475,35,20,Player A
2640,JointPQPlayer,273,208,481,29,16,Player A
2641,JointPQPlayer,304,189,493,38,15,Player A
2642,JointPQPlayer,290,195,485,36,17,Player A
2643,JointPQPlayer,310,190,500,36,12,Player A
2644,JointPQPlayer,274,204,478,32,18,Player A
2645,JointPQPlayer,215,230,445,23,26,JointPQPlayer
2646,JointPQPlayer,129,264,393,13,40,JointPQPlayer
2647,JointPQPlayer,252,212,464,30,22,Player A
2648,JointPQPlayer,270,205,475,32,19,Player A
2649,JointPQPlayer,302,192,494,36,14,Player A
2650,JointPQPlayer,293,193,486,37,17,Player A
2651,JointPQPlayer,146,261,407,12,35,JointPQPlayer
2652,JointPQPlayer,323,183,506,39,11,Player A
2653,JointPQPlayer,298,198,496,32,12,Player A
2654,JointPQPlayer,270,205,475,32,19,Player A
2655,JointPQPlayer,281,201,482,33,17,Player A
2656,JointPQPlayer,172,247,419,18,33,JointPQPlayer
2657,JointPQPlayer,293,193,486,37,17,Player A
2658,JointPQPlayer,193,238,431,21,30,JointPQPlayer
2659,JointPQPlayer,137,262,399,13,38,JointPQPlayer
2660,JointPQPlayer,282,197,479,36,19,Player A
2661,JointPQPlayer,242,212,454,32,26,Player A
2662,JointPQPlayer,293,198,491,33,14,Player A
2663,JointPQPlayer,133,268,401,9,36,JointPQPlayer
2664,JointPQPlayer,308,193,501,34,11,Player A
2665,JointPQPlayer,317,182,499,41,14,Player A
2666,JointPQPlayer,279,199,478,35,19,Player A
2667,JointPQPlayer,274,204,478,32,18,Player A
2668,JointPQPlayer,285,195,480,37,19,Player A
2669,JointPQPlayer,241,221,462,25,21,Player A
2670,JointPQPlayer,302,192,494,36,14,Player A
2671,JointPQPlayer,163,248,411,19,36,JointPQPlayer
2672,JointPQPlayer,171,246,417,19,34,JointPQPlayer
2673,JointPQPlayer,243,223,466,23,19,Player A
2674,JointPQPlayer,254,214,468,28,20,Player A
2675,JointPQPlayer,302,187,489,40,17,Player A
2676,JointPQPlayer,278,203,481,32,17,Player A
2677,JointPQPlayer,129,264,393,13,40,JointPQPlayer
2678,JointPQPlayer,273,203,476,33,19,Player A
2679,JointPQPlayer,173,248,421,17,32,JointPQPlayer
2680,JointPQPlayer,319,184,503,39,12,Player A
2681,JointPQPlayer,277,197,474,37,21,Player A
2682,JointPQPlayer,150,260,410,12,34,JointPQPlayer
2683,JointPQPlayer,287,197,484,35,17,Player A
2684,JointPQPlayer,280,205,485,30,15,Player A
2685,JointPQPlayer,296,196,492,34,14,Player A
2686,JointPQPlayer,299,189,488,39,17,Player A
2687,JointPQPlayer,282,197,479,36,19,Player A
2688,JointPQPlayer,150,255,405,16,37,JointPQPlayer
2689,JointPQPlayer,293,198,491,33,14,Player A
2690,JointPQPlayer,279,204,483,31,16,Player A
2691,JointPQPlayer,288,203,491,30,13,Player A
2692,JointPQPlayer,253,213,466,29,21,Player A
2693,JointPQPlayer,311,191,502,35,11,Player A
2694,JointPQPlayer,291,191,482,39,19,Player A
2695,JointPQPlayer,160,250,410,18,36,JointPQPlayer
2696,JointPQPlayer,264,209,473,30,19,Player A
2697,JointPQPlayer,229,219,448,29,27,Player A
2698,JointPQPlayer,283,208,491,27,12,Player A
2699,JointPQPlayer,136,261,397,14,39,JointPQPlayer
2700,JointPQPlayer,284,199,483,34,17,Player A
2701,JointPQPlayer,119,264,383,15,44,JointPQPlayer
2702,JointPQPlayer,284,199,483,34,17,Player A
2703,JointPQPlayer,298,193,491,36,15,Player A
2704,JointPQPlayer,277,207,484,29,15,Player A
2705,JointPQPlayer,148,263,411,10,33,JointPQPlayer
2706,JointPQPlayer,283,198,481,35,18,Player A
2707,JointPQPlayer,147,257,404,15,37,JointPQPlayer
2708,JointPQPlayer,278,203,481,32,17,Player A
2709,JointPQPlayer,288,193,481,38,19,Player A
2710,JointPQPlayer,302,192,494,36,14,Player A
2711,JointPQPlayer,261,211,472,29,19,Player A
2712,JointPQPlayer,165,250,415,17,34,JointPQPlayer
2713,JointPQPlayer,270,205,475,32,19,Player A
2714,JointPQPlayer,235,215,450,31,27,Player A
2715,JointPQPlayer,301,196,497,33,12,Player A
2716,JointPQPlayer,319,179,498,43,15,Player A
2717,JointPQPlayer,269,204,473,33,20,Player A
2718,JointPQPlayer,173,248,421,17,32,JointPQPlayer
2719,JointPQPlayer,275,200,475,35,20,Player A
2720,JointPQPlayer,286,201,487,32,15,Player A
2721,JointPQPlayer,329,179,508,41,11,Player A
2722,JointPQPlayer,317,182,499,41,14,Player A
2723,JointPQPlayer,283,198,481,35,18,Player A
2724,JointPQPlayer,283,198,481,35,18,Player A
2725,JointPQPlayer,269,209,478,29,17,Player A
2726,JointPQPlayer,143,258,401,15,38,JointPQPlayer
2727,JointPQPlayer,269,209,478,29,17,Player A
2728,JointPQPlayer,286,201,487,32,15,Player A
2729,JointPQPlayer,285,200,485,33,16,Player A
2730,JointPQPlayer,299,189,488,39,17,Player A
2731,JointPQPlayer,322,182,504,40,12,Player A
2732,JointPQPlayer,299,194,493,35,14,Player A
2733,JointPQPlayer,317,182,499,41,14,Player A
2734,JointPQPlayer,269,204,473,33,20,Player A
2735,JointPQPlayer,150,260,410,12,34,JointPQPlayer
2736,JointPQPlayer,313,183,496,41,15,Player A
2737,JointPQPlayer,152,252,404,18,38,JointPQPlayer
2738,JointPQPlayer,283,203,486,31,15,Player A
2739,JointPQPlayer,327,177,504,43,13,Player A
2740,JointPQPlayer,292,192,484,38,18,Player A
2741,JointPQPlayer,266,211,477,28,17,Player A
2742,JointPQPlayer,149,259,408,13,35,JointPQPlayer
2743,JointPQPlayer,301,191,492,37,15,Player A
2744,JointPQPlayer,277,202,479,33,18,Player A
2745,JointPQPlayer,295,200,495,31,12,Player A
2746,JointPQPlayer,132,267,399,10,37,JointPQPlayer
2747,JointPQPlayer,155,255,410,15,35,JointPQPlayer
2748,JointPQPlayer,284,204,488,30,14,Player A
2749,JointPQPlayer,296,196,492,34,14,Player A
2750,JointPQPlayer,145,260,405,13,36,JointPQPlayer
2751,JointPQPlayer,165,255,420,13,31,JointPQPlayer
2752,JointPQPlayer,166,251,417,16,33,JointPQPlayer
2753,JointPQPlayer,300,200,500,30,10,Player A
2754,JointPQPlayer,315,185,500,39,13,Player A
2755,JointPQPlayer,134,269,403,8,35,JointPQPlayer
2756,JointPQPlayer,284,199,483,34,17,Player A
2757,JointPQPlayer,324,184,508,38,10,Player A
2758,JointPQPlayer,301,191,492,37,15,Player A
2759,JointPQPlayer,312,192,504,34,10,Player A
2760,JointPQPlayer,281,206,487,29,14,Player A
2761,JointPQPlayer,299,194,493,35,14,Player A
2762,JointPQPlayer,245,220,465,25,20,Player A
2763,JointPQPlayer,217,227,444,25,27,JointPQPlayer
2764,JointPQPlayer,305,190,495,37,14,Player A
2765,JointPQPlayer,293,198,491,33,14,Player A
2766,JointPQPlayer,295,195,490,35,15,Player A
2767,JointPQPlayer,304,194,498,34,12,Player A
2768,JointPQPlayer,279,204,483,31,16,Player A
2769,JointPQPlayer,149,259,408,13,35,JointPQPlayer
2770,JointPQPlayer,296,196,492,34,14,Player A
2771,JointPQPlayer,282,197,479,36,19,Player A
2772,JointPQPlayer,287,197,484,35,17,Player A
2773,JointPQPlayer,150,255,405,16,37,JointPQPlayer
2774,JointPQPlayer,290,195,485,36,17,Player A
2775,JointPQPlayer,279,204,483,31,16,Player A
2776,JointPQPlayer,233,218,451,29,26,Player A
2777,JointPQPlayer,246,216,462,28,22,Player A
2778,JointPQPlayer,308,188,496,38,14,Player A
2779,JointPQPlayer,275,205,480,31,17,Player A
2780,JointPQPlayer,148,263,411,10,33,JointPQPlayer
2781,JointPQPlayer,297,192,489,37,16,Player A
2782,JointPQPlayer,283,198,481,35,18,Player A
2783,JointPQPlayer,314,184,498,40,14,Player A
2784,JointPQPlayer,143,258,401,15,38,JointPQPlayer
2785,JointPQPlayer,287,202,489,31,14,Player A
2786,JointPQPlayer,289,194,483,37,18,Player A
2787,JointPQPlayer,177,247,424,17,31,JointPQPlayer
2788,JointPQPlayer,289,204,493,29,12,Player A
2789,JointPQPlayer,305,195,500,33,11,Player A
2790,JointPQPlayer,285,200,485,33,16,Player A
2791,JointPQPlayer,305,195,500,33,11,Player A
2792,JointPQPlayer,299,194,493,35,14,Player A
2793,JointPQPlayer,284,194,478,38,20,Player A
2794,JointPQPlayer,289,199,488,33,15,Player A
2795,JointPQPlayer,294,199,493,32,13,Player A
2796,JointPQPlayer,201,241,442,17,25,JointPQPlayer
2797,JointPQPlayer,211,231,442,23,27,JointPQPlayer
2798,JointPQPlayer,146,261,407,12,35,JointPQPlayer
2799,JointPQPlayer,288,198,486,34,16,Player A
2800,JointPQPlayer,299,189,488,39,17,Player A
2801,JointPQPlayer,274,204,478,32,18,Player A
2802,JointPQPlayer,158,248,406,20,38,JointPQPlayer
2803,JointPQPlayer,136,266,402,10,36,JointPQPlayer
2804,JointPQPlayer,272,202,474,34,20,Player A
2805,JointPQPlayer,303,193,496,35,13,Player A
2806,JointPQPlayer,207,232,439,23,28,JointPQPlayer
2807,JointPQPlayer,180,250,430,14,28,JointPQPlayer
2808,JointPQPlayer,155,250,405,19,38,JointPQPlayer
2809,JointPQPlayer,289,199,488,33,15,Player A
2810,JointPQPlayer,311,191,502,35,11,Player A
2811,JointPQPlayer,279,199,478,35,19,Player A
2812,JointPQPlayer,290,195,485,36,17,Player A
2813,JointPQPlayer,293,193,486,37,17,Player A
2814,JointPQPlayer,296,196,492,34,14,Player A
2815,JointPQPlayer,297,192,489,37,16,Player A
2816,JointPQPlayer,281,206,487,29,14,Player A
2817,JointPQPlayer,315,185,500,39,13,Player A
2818,JointPQPlayer,309,194,503,33,10,Player A
2819,JointPQPlayer,293,193,486,37,17,Player A
2820,JointPQPlayer,279,199,478,35,19,Player A
2821,JointPQPlayer,306,186,492,40,16,Player A
2822,JointPQPlayer,296,196,492,34,14,Player A
2823,JointPQPlayer,261,206,467,33,22,Player A
2824,JointPQPlayer,280,205,485,30,15,Player A
2825,JointPQPlayer,297,192,489,37,16,Player A
2826,JointPQPlayer,284,204,488,30,14,Player A
2827,JointPQPlayer,195,240,435,19,28,JointPQPlayer
2828,JointPQPlayer,288,193,481,38,19,Player A
2829,JointPQPlayer,284,199,483,34,17,Player A
2830,JointPQPlayer,318,188,506,36,10,Player A
2831,JointPQPlayer,245,215,460,29,23,Player A
2832,JointPQPlayer,270,200,470,36,22,Player A
2833,JointPQPlayer,319,189,508,35,9,Player A
2834,JointPQPlayer,272,202,474,34,20,Player A
2835,JointPQPlayer,122,267,389,12,41,JointPQPlayer
2836,JointPQPlayer,132,267,399,10,37,JointPQPlayer
2837,JointPQPlayer,161,266,427,5,26,JointPQPlayer
2838,JointPQPlayer,279,199,478,35,19,Player A
2839,JointPQPlayer,286,196,482,36,18,Player A
2840,JointPQPlayer,264,209,473,30,19,Player A
2841,JointPQPlayer,149,259,408,13,35,JointPQPlayer
2842,JointPQPlayer,288,198,486,34,16,Player A
2843,JointPQPlayer,143,258,401,15,38,JointPQPlayer
2844,JointPQPlayer,310,190,500,36,12,Player A
2845,JointPQPlayer,284,204,488,30,14,Player A
2846,JointPQPlayer,309,189,498,37,13,Player A
2847,JointPQPlayer,302,197,499,32,11,Player A
2848,JointPQPlayer,124,264,388,14,42,JointPQPlayer
2849,JointPQPlayer,131,266,397,11,38,JointPQPlayer
2850,JointPQPlayer,255,210,465,31,22,Player A
2851,JointPQPlayer,289,194,483,37,18,Player A
2852,JointPQPlayer,318,183,501,40,13,Player A
2853,JointPQPlayer,302,197,499,32,11,Player A
2854,JointPQPlayer,272,202,474,34,20,Player A
2855,JointPQPlayer,150,255,405,16,37,JointPQPlayer
2856,JointPQPlayer,153,258,411,13,34,JointPQPlayer
2857,JointPQPlayer,304,189,493,38,15,Player A
2858,JointPQPlayer,307,187,494,39,15,Player A
2859,JointPQPlayer,289,199,488,33,15,Player A
2860,JointPQPlayer,299,194,493,35,14,Player A
2861,JointPQPlayer,282,202,484,32,16,Player A
2862,JointPQPlayer,141,261,402,13,37,JointPQPlayer
2863,JointPQPlayer,143,263,406,11,35,JointPQPlayer
2864,JointPQPlayer,267,207,474,31,19,Player A
2865,JointPQPlayer,156,251,407,18,37,JointPQPlayer
2866,JointPQPlayer,301,196,497,33,12,Player A
2867,JointPQPlayer,151,261,412,11,33,JointPQPlayer
2868,JointPQPlayer,299,199,498,31,11,Player A
2869,JointPQPlayer,146,261,407,12,35,JointPQPlayer
2870,JointPQPlayer,301,191,492,37,15,Player A
2871,JointPQPlayer,288,203,491,30,13,Player A
2872,JointPQPlayer,296,191,487,38,17,Player A
2873,JointPQPlayer,158,258,416,12,32,JointPQPlayer
2874,JointPQPlayer,332,177,509,42,11,Player A
2875,JointPQPlayer,274,204,478,32,18,Player A
2876,JointPQPlayer,319,184,503,39,12,Player A
2877,JointPQPlayer,312,187,499,38,13,Player A
2878,JointPQPlayer,304,189,493,38,15,Player A
2879,JointPQPlayer,144,259,403,14,37,JointPQPlayer
2880,JointPQPlayer,287,197,484,35,17,Player A
2881,JointPQPlayer,168,253,421,14,31,JointPQPlayer
2882,JointPQPlayer,159,254,413,15,34,JointPQPlayer
2883,JointPQPlayer,292,197,489,34,15,Player A
2884,JointPQPlayer,266,206,472,32,20,Player A
2885,JointPQPlayer,307,192,499,35,12,Player A
2886,JointPQPlayer,286,201,487,32,15,Player A
2887,JointPQPlayer,331,181,512,39,9,Player A
2888,JointPQPlayer,301,191,492,37,15,Player A
2889,JointPQPlayer,282,197,479,36,19,Player A
2890,JointPQPlayer,290,195,485,36,17,Player A
2891,JointPQPlayer,305,190,495,37,14,Player A
2892,JointPQPlayer,273,203,476,33,19,Player A
2893,JointPQPlayer,152,257,409,14,35,JointPQPlayer
2894,JointPQPlayer,279,209,488,27,13,Player A
2895,JointPQPlayer,254,209,463,32,23,Player A
2896,JointPQPlayer,277,202,479,33,18,Player A
2897,JointPQPlayer,159,249,408,19,37,JointPQPlayer
2898,JointPQPlayer,235,215,450,31,27,Player A
2899,JointPQPlayer,268,203,471,34,21,Player A
2900,JointPQPlayer,285,200,485,33,16,Player A
2901,JointPQPlayer,145,260,405,13,36,JointPQPlayer
2902,JointPQPlayer,240,215,455,30,25,Player A
2903,JointPQPlayer,291,196,487,35,16,Player A
2904,JointPQPlayer,248,213,461,30,23,Player A
2905,JointPQPlayer,135,265,400,11,37,JointPQPlayer
2906,JointPQPlayer,259,209,468,31,21,Player A
2907,JointPQPlayer,300,190,490,38,16,Player A
2908,JointPQPlayer,292,192,484,38,18,Player A
2909,JointPQPlayer,265,210,475,29,18,Player A
2910,JointPQPlayer,293,193,486,37,17,Player A
2911,JointPQPlayer,239,214,453,31,26,Player A
2912,JointPQPlayer,301,191,492,37,15,Player A
2913,JointPQPlayer,284,194,478,38,20,Player A
2914,JointPQPlayer,303,193,496,35,13,Player A
2915,JointPQPlayer,276,201,477,34,19,Player A
2916,JointPQPlayer,312,187,499,38,13,Player A
2917,JointPQPlayer,114,269,383,12,43,JointPQPlayer
2918,JointPQPlayer,274,204,478,32,18,Player A
2919,JointPQPlayer,309,189,498,37,13,Player A
2920,JointPQPlayer,273,203,476,33,19,Player A
2921,JointPQPlayer,311,191,502,35,11,Player A
2922,JointPQPlayer,300,195,495,34,13,Player A
2923,JointPQPlayer,269,209,478,29,17,Player A
2924,JointPQPlayer,288,198,486,34,16,Player A
2925,JointPQPlayer,280,200,480,34,18,Player A
2926,JointPQPlayer,295,200,495,31,12,Player A
2927,JointPQPlayer,289,199,488,33,15,Player A
2928,JointPQPlayer,285,195,480,37,19,Player A
2929,JointPQPlayer,284,199,483,34,17,Player A
2930,JointPQPlayer,295,195,490,35,15,Player A
2931,JointPQPlayer,291,201,492,31,13,Player A
2932,JointPQPlayer,320,185,505,38,11,Player A
2933,JointPQPlayer,308,188,496,38,14,Player A
2934,JointPQPlayer,257,207,464,33,23,Player A
2935,JointPQPlayer,158,258,416,12,32,JointPQPlayer
2936,JointPQPlayer,300,195,495,34,13,Player A
2937,JointPQPlayer,271,206,477,31,18,Player A
2938,JointPQPlayer,330,185,515,36,7,Player A
2939,JointPQPlayer,281,201,482,33,17,Player A
2940,JointPQPlayer,155,255,410,15,35,JointPQPlayer
2941,JointPQPlayer,196,236,432,22,30,JointPQPlayer
2942,JointPQPlayer,307,197,504,31,9,Player A
2943,JointPQPlayer,312,187,499,38,13,Player A
2944,JointPQPlayer,297,187,484,41,19,Player A
2945,JointPQPlayer,172,242,414,22,36,JointPQPlayer
2946,JointPQPlayer,124,269,393,10,39,JointPQPlayer
2947,JointPQPlayer,286,196,482,36,18,Player A
2948,JointPQPlayer,174,249,423,16,31,JointPQPlayer
2949,JointPQPlayer,277,202,479,33,18,Player A
2950,JointPQPlayer,289,194,483,37,18,Player A
2951,JointPQPlayer,281,201,482,33,17,Player A
2952,JointPQPlayer,292,197,489,34,15,Player A
2953,JointPQPlayer,282,202,484,32,16,Player A
2954,JointPQPlayer,165,250,415,17,34,JointPQPlayer
2955,JointPQPlayer,298,193,491,36,15,Player A
2956,JointPQPlayer,308,193,501,34,11,Player A
2957,JointPQPlayer,261,211,472,29,19,Player A
2958,JointPQPlayer,277,202,479,33,18,Player A
2959,JointPQPlayer,294,194,488,36,16,Player A
2960,JointPQPlayer,282,197,479,36,19,Player A
2961,JointPQPlayer,295,195,490,35,15,Player A
2962,JointPQPlayer,249,214,463,29,22,Player A
2963,JointPQPlayer,305,200,505,29,8,Player A
2964,JointPQPlayer,300,190,490,38,16,Player A
2965,JointPQPlayer,281,206,487,29,14,Player A
2966,JointPQPlayer,150,260,410,12,34,JointPQPlayer
2967,JointPQPlayer,321,186,507,37,10,Player A
2968,JointPQPlayer,300,195,495,34,13,Player A
2969,JointPQPlayer,288,198,486,34,16,Player A
2970,JointPQPlayer,284,199,483,34,17,Player A
2971,JointPQPlayer,293,193,486,37,17,Player A
2972,JointPQPlayer,275,200,475,35,20,Player A
2973,JointPQPlayer,291,201,492,31,13,Player A
2974,JointPQPlayer,259,204,463,35,24,Player A
2975,JointPQPlayer,277,202,479,33,18,Player A
2976,JointPQPlayer,137,262,399,13,38,JointPQPlayer
2977,JointPQPlayer,312,187,499,38,13,Player A
2978,JointPQPlayer,317,182,499,41,14,Player A
2979,JointPQPlayer,307,192,499,35,12,Player A
2980,JointPQPlayer,144,259,403,14,37,JointPQPlayer
2981,JointPQPlayer,145,260,405,13,36,JointPQPlayer
2982,JointPQPlayer,133,258,391,17,42,JointPQPlayer
2983,JointPQPlayer,292,192,484,38,18,Player A
2984,JointPQPlayer,303,193,496,35,13,Player A
2985,JointPQPlayer,286,196,482,36,18,Player A
2986,JointPQPlayer,285,200,485,33,16,Player A
2987,JointPQPlayer,135,265,400,11,37,JointPQPlayer
2988,JointPQPlayer,309,184,493,41,16,Player A
2989,JointPQPlayer,313,188,501,37,12,Player A
2990,JointPQPlayer,236,221,457,26,23,Player A
2991,JointPQPlayer,315,190,505,35,10,Player A
2992,JointPQPlayer,269,209,478,29,17,Player A
2993,JointPQPlayer,313,193,506,33,9,Player A
2994,JointPQPlayer,283,198,481,35,18,Player A
2995,JointPQPlayer,317,187,504,37,11,Player A
2996,JointPQPlayer,268,208,476,30,18,Player A
2997,JointPQPlayer,297,202,499,29,10,Player A
2998,JointPQPlayer,311,186,497,39,14,Player A
2999,JointPQPlayer,309,189,498,37,13,Player A
3000,JointPQPlayer,322,187,509,36,9,Player A
3001,JointPQPlayer,139,264,403,11,36,JointPQPlayer
3002,JointPQPlayer,275,200,475,35,20,Player A
3003,JointPQPlayer,300,190,490,38,16,Player A
3004,JointPQPlayer,299,194,493,35,14,Player A
3005,JointPQPlayer,244,219,463,26,21,Player A
3006,JointPQPlayer,217,227,444,25,27,JointPQPlayer
3007,JointPQPlayer,314,189,503,36,11,Player A
3008,JointPQPlayer,238,223,461,24,21,Player A
3009,JointPQPlayer,271,206,477,31,18,Player A
3010,JointPQPlayer,251,211,462,31,23,Player A
3011,JointPQPlayer,245,220,465,25,20,Player A
3012,JointPQPlayer,195,245,440,15,25,JointPQPlayer
3013,JointPQPlayer,263,203,466,35,23,Player A
3014,JointPQPlayer,164,254,418,14,32,JointPQPlayer
3015,JointPQPlayer,291,196,487,35,16,Player A
3016,JointPQPlayer,327,182,509,39,10,Player A
3017,JointPQPlayer,294,194,488,36,16,Player A
3018,JointPQPlayer,317,187,504,37,11,Player A
3019,JointPQPlayer,152,252,404,18,38,JointPQPlayer
3020,JointPQPlayer,124,269,393,10,39,JointPQPlayer
3021,JointPQPlayer,304,194,498,34,12,Player A
3022,JointPQPlayer,321,186,507,37,10,Player A
3023,JointPQPlayer,147,257,404,15,37,JointPQPlayer
3024,JointPQPlayer,274,199,473,36,21,Player A
3025,JointPQPlayer,211,231,442,23,27,JointPQPlayer
3026,JointPQPlayer,284,204,488,30,14,Player A
3027,JointPQPlayer,294,199,493,32,13,Player A
3028,JointPQPlayer,283,198,481,35,18,Player A
3029,JointPQPlayer,288,198,486,34,16,Player A
3030,JointPQPlayer,283,203,486,31,15,Player A
3031,JointPQPlayer,262,212,474,28,18,Player A
3032,JointPQPlayer,169,254,423,13,30,JointPQPlayer
3033,JointPQPlayer,308,188,496,38,14,Player A
3034,JointPQPlayer,124,269,393,10,39,JointPQPlayer
3035,JointPQPlayer,315,180,495,43,16,Player A
3036,JointPQPlayer,303,193,496,35,13,Player A
3037,JointPQPlayer,317,187,504,37,11,Player A
3038,JointPQPlayer,298,193,491,36,15,Player A
3039,JointPQPlayer,163,243,406,23,39,JointPQPlayer
3040,JointPQPlayer,301,191,492,37,15,Player A
3041,JointPQPlayer,255,205,460,35,25,Player A
3042,JointPQPlayer,180,245,425,18,31,JointPQPlayer
3043,JointPQPlayer,325,180,505,41,12,Player A
3044,JointPQPlayer,315,185,500,39,13,Player A
3045,JointPQPlayer,291,196,487,35,16,Player A
3046,JointPQPlayer,264,204,468,34,22,Player A
3047,JointPQPlayer,274,204,478,32,18,Player A
3048,JointPQPlayer,134,269,403,8,35,JointPQPlayer
3049,JointPQPlayer,163,258,421,11,30,JointPQPlayer
3050,JointPQPlayer,281,201,482,33,17,Player A
3051,JointPQPlayer,174,249,423,16,31,JointPQPlayer
3052,JointPQPlayer,163,248,411,19,36,JointPQPlayer
3053,JointPQPlayer,289,194,483,37,18,Player A
3054,JointPQPlayer,286,196,482,36,18,Player A
3055,JointPQPlayer,313,193,506,33,9,Player A
3056,JointPQPlayer,286,196,482,36,18,Player A
3057,JointPQPlayer,306,191,497,36,13,Player A
3058,JointPQPlayer,248,213,461,30,23,Player A
3059,JointPQPlayer,273,208,481,29,16,Player A
3060,JointPQPlayer,293,198,491,33,14,Player A
3061,JointPQPlayer,265,205,470,33,21,Player A
3062,JointPQPlayer,291,196,487,35,16,Player A
3063,JointPQPlayer,297,197,494,33,13,Player A
3064,JointPQPlayer,268,208,476,30,18,Player A
3065,JointPQPlayer,280,205,485,30,15,Player A
3066,JointPQPlayer,290,195,485,36,17,Player A
3067,JointPQPlayer,288,198,486,34,16,Player A
3068,JointPQPlayer,308,193,501,34,11,Player A
3069,JointPQPlayer,272,197,469,38,23,Player A
3070,JointPQPlayer,292,202,494,30,12,Player A
3071,JointPQPlayer,299,194,493,35,14,Player A
3072,JointPQPlayer,153,258,411,13,34,JointPQPlayer
3073,JointPQPlayer,191,246,437,15,26,JointPQPlayer
3074,JointPQPlayer,268,203,471,34,21,Player A
3075,JointPQPlayer,301,196,497,33,12,Player A
3076,JointPQPlayer,298,198,496,32,12,Player A
3077,JointPQPlayer,273,208,481,29,16,Player A
3078,JointPQPlayer,300,190,490,38,16,Player A
3079,JointPQPlayer,323,188,511,35,8,Player A
3080,JointPQPlayer,301,191,492,37,15,Player A
3081,JointPQPlayer,271,201,472,35,21,Player A
3082,JointPQPlayer,314,184,498,40,14,Player A
3083,JointPQPlayer,291,201,492,31,13,Player A
3084,JointPQPlayer,287,197,484,35,17,Player A
3085,JointPQPlayer,285,200,485,33,16,Player A
3086,JointPQPlayer,290,195,485,36,17,Player A
3087,JointPQPlayer,241,216,457,29,24,Player A
3088,JointPQPlayer,312,182,494,42,16,Player A
3089,JointPQPlayer,295,200,495,31,12,Player A
3090,JointPQPlayer,296,196,492,34,14,Player A
3091,JointPQPlayer,281,201,482,33,17,Player A
3092,JointPQPlayer,279,194,473,39,22,Player A
3093,JointPQPlayer,121,266,387,13,42,JointPQPlayer
3094,JointPQPlayer,174,244,418,20,34,JointPQPlayer
3095,JointPQPlayer,142,257,399,16,39,JointPQPlayer
3096,JointPQPlayer,213,233,446,21,25,JointPQPlayer
3097,JointPQPlayer,274,204,478,32,18,Player A
3098,JointPQPlayer,153,253,406,17,37,JointPQPlayer
3099,JointPQPlayer,276,201,477,34,19,Player A
3100,JointPQPlayer,119,274,393,7,38,JointPQPlayer
3101,JointPQPlayer,266,201,467,36,23,Player A
3102,JointPQPlayer,203,238,441,19,26,JointPQPlayer
3103,JointPQPlayer,295,195,490,35,15,Player A
3104,JointPQPlayer,301,201,502,29,9,Player A
3105,JointPQPlayer,151,256,407,15,36,JointPQPlayer
3106,JointPQPlayer,291,191,482,39,19,Player A
3107,JointPQPlayer,148,263,411,10,33,JointPQPlayer
3108,JointPQPlayer,307,192,499,35,12,Player A
3109,JointPQPlayer,297,192,489,37,16,Player A
3110,JointPQPlayer,294,199,493,32,13,Player A
3111,JointPQPlayer,292,197,489,34,15,Player A
3112,JointPQPlayer,237,222,459,25,22,Player A
3113,JointPQPlayer,266,206,472,32,20,Player A
3114,JointPQPlayer,248,208,456,34,26,Player A
3115,JointPQPlayer,291,201,492,31,13,Player A
3116,JointPQPlayer,253,218,471,25,18,Player A
3117,JointPQPlayer,142,262,404,12,36,JointPQPlayer
3118,JointPQPlayer,284,209,493,26,11,Player A
3119,JointPQPlayer,340,175,515,42,9,Player A
3120,JointPQPlayer,296,191,487,38,17,Player A
3121,JointPQPlayer,300,190,490,38,16,Player A
3122,JointPQPlayer,299,199,498,31,11,Player A
3123,JointPQPlayer,322,187,509,36,9,Player A
3124,JointPQPlayer,286,196,482,36,18,Player A
3125,JointPQPlayer,263,208,471,31,20,Player A
3126,JointPQPlayer,322,187,509,36,9,Player A
3127,JointPQPlayer,280,205,485,30,15,Player A
3128,JointPQPlayer,299,194,493,35,14,Player A
3129,JointPQPlayer,315,185,500,39,13,Player A
3130,JointPQPlayer,132,267,399,10,37,JointPQPlayer
3131,JointPQPlayer,272,207,479,30,17,Player A
3132,JointPQPlayer,248,213,461,30,23,Player A
3133,JointPQPlayer,337,177,514,41,9,Player A
3134,JointPQPlayer,261,211,472,29,19,Player A
3135,JointPQPlayer,309,184,493,41,16,Player A
3136,JointPQPlayer,269,209,478,29,17,Player A
3137,JointPQPlayer,300,195,495,34,13,Player A
3138,JointPQPlayer,278,208,486,28,14,Player A
3139,JointPQPlayer,298,193,491,36,15,Player A
3140,JointPQPlayer,154,254,408,16,36,JointPQPlayer
3141,JointPQPlayer,304,194,498,34,12,Player A
3142,JointPQPlayer,293,193,486,37,17,Player A
3143,JointPQPlayer,270,205,475,32,19,Player A
3144,JointPQPlayer,285,200,485,33,16,Player A
3145,JointPQPlayer,333,178,511,41,10,Player A
3146,JointPQPlayer,228,218,446,30,28,Player A
3147,JointPQPlayer,307,197,504,31,9,Player A
3148,JointPQPlayer,314,184,498,40,14,Player A
3149,JointPQPlayer,142,257,399,16,39,JointPQPlayer
3150,JointPQPlayer,156,261,417,10,31,JointPQPlayer
3151,JointPQPlayer,149,254,403,17,38,JointPQPlayer
3152,JointPQPlayer,281,196,477,37,20,Player A
3153,JointPQPlayer,265,205,470,33,21,Player A
3154,JointPQPlayer,299,189,488,39,17,Player A
3155,JointPQPlayer,294,194,488,36,16,Player A
3156,JointPQPlayer,248,213,461,30,23,Player A
3157,JointPQPlayer,291,196,487,35,16,Player A
3158,JointPQPlayer,301,191,492,37,15,Player A
3159,JointPQPlayer,259,204,463,35,24,Player A
3160,JointPQPlayer,288,193,481,38,19,Player A
3161,JointPQPlayer,294,194,488,36,16,Player A
3162,JointPQPlayer,309,189,498,37,13,Player A
3163,JointPQPlayer,271,206,477,31,18,Player A
3164,JointPQPlayer,273,208,481,29,16,Player A
3165,JointPQPlayer,296,191,487,38,17,Player A
3166,JointPQPlayer,162,252,414,16,34,JointPQPlayer
3167,JointPQPlayer,302,187,489,40,17,Player A
3168,JointPQPlayer,291,196,487,35,16,Player A
3169,JointPQPlayer,243,213,456,31,25,Player A
3170,JointPQPlayer,269,209,478,29,17,Player A
3171,JointPQPlayer,276,206,482,30,16,Player A
3172,JointPQPlayer,294,194,488,36,16,Player A
3173,JointPQPlayer,251,221,472,23,17,Player A
3174,JointPQPlayer,136,261,397,14,39,JointPQPlayer
3175,JointPQPlayer,148,258,406,14,36,JointPQPlayer
3176,JointPQPlayer,182,242,424,20,32,JointPQPlayer
3177,JointPQPlayer,315,185,500,39,13,Player A
3178,JointPQPlayer,149,259,408,13,35,JointPQPlayer
3179,JointPQPlayer,249,219,468,25,19,Player A
3180,JointPQPlayer,305,190,495,37,14,Player A
3181,JointPQPlayer,284,204,488,30,14,Player A
3182,JointPQPlayer,270,200,470,36,22,Player A
3183,JointPQPlayer,286,196,482,36,18,Player A
3184,JointPQPlayer,274,204,478,32,18,Player A
3185,JointPQPlayer,258,198,456,40,28,Player A
3186,JointPQPlayer,282,202,484,32,16,Player A
3187,JointPQPlayer,317,182,499,41,14,Player A
3188,JointPQPlayer,274,204,478,32,18,Player A
3189,JointPQPlayer,245,215,460,29,23,Player A
3190,JointPQPlayer,275,205,480,31,17,Player A
3191,JointPQPlayer,309,189,498,37,13,Player A
3192,JointPQPlayer,257,212,469,29,20,Player A
3193,JointPQPlayer,290,200,490,32,14,Player A
3194,JointPQPlayer,281,201,482,33,17,Player A
3195,JointPQPlayer,295,190,485,39,18,Player A
3196,JointPQPlayer,225,225,450,25,25,Tie
3197,JointPQPlayer,291,201,492,31,13,Player A
3198,JointPQPlayer,284,204,488,30,14,Player A
3199,JointPQPlayer,266,211,477,28,17,Player A
3200,JointPQPlayer,129,264,393,13,40,JointPQPlayer
3201,JointPQPlayer,276,211,487,26,13,Player A
3202,JointPQPlayer,296,196,492,34,14,Player A
3203,JointPQPlayer,168,248,416,18,34,JointPQPlayer
3204,JointPQPlayer,280,200,480,34,18,Player A
3205,JointPQPlayer,244,214,458,30,24,Player A
3206,JointPQPlayer,263,208,471,31,20,Player A
3207,JointPQPlayer,306,191,497,36,13,Player A
3208,JointPQPlayer,284,199,483,34,17,Player A
3209,JointPQPlayer,147,257,404,15,37,JointPQPlayer
3210,JointPQPlayer,146,251,397,20,41,JointPQPlayer
3211,JointPQPlayer,136,266,402,10,36,JointPQPlayer
3212,JointPQPlayer,281,201,482,33,17,Player A
3213,JointPQPlayer,302,192,494,36,14,Player A
3214,JointPQPlayer,300,195,495,34,13,Player A
3215,JointPQPlayer,268,208,476,30,18,Player A
3216,JointPQPlayer,225,220,445,29,28,Player A
3217,JointPQPlayer,157,257,414,13,33,JointPQPlayer
3218,JointPQPlayer,291,196,487,35,16,Player A
3219,JointPQPlayer,309,189,498,37,13,Player A
3220,JointPQPlayer,271,201,472,35,21,Player A
3221,JointPQPlayer,297,197,494,33,13,Player A
3222,JointPQPlayer,260,210,470,30,20,Player A
3223,JointPQPlayer,306,191,497,36,13,Player A
3224,JointPQPlayer,148,258,406,14,36,JointPQPlayer
3225,JointPQPlayer,281,206,487,29,14,Player A
3226,JointPQPlayer,256,216,472,26,18,Player A
3227,JointPQPlayer,312,182,494,42,16,Player A
3228,JointPQPlayer,300,195,495,34,13,Player A
3229,JointPQPlayer,256,211,467,30,21,Player A
3230,JointPQPlayer,300,190,490,38,16,Player A
3231,JointPQPlayer,279,204,483,31,16,Player A
3232,JointPQPlayer,282,202,484,32,16,Player A
3233,JointPQPlayer,329,179,508,41,11,Player A
3234,JointPQPlayer,250,215,465,28,21,Player A
3235,JointPQPlayer,300,195,495,34,13,Player A
3236,JointPQPlayer,163,253,416,15,33,JointPQPlayer
3237,JointPQPlayer,295,195,490,35,15,Player A
3238,JointPQPlayer,310,190,500,36,12,Player A
3239,JointPQPlayer,174,249,423,16,31,JointPQPlayer
3240,JointPQPlayer,264,209,473,30,19,Player A
3241,JointPQPlayer,255,210,465,31,22,Player A
3242,JointPQPlayer,122,267,389,12,41,JointPQPlayer
3243,JointPQPlayer,256,216,472,26,18,Player A
3244,JointPQPlayer,251,221,472,23,17,Player A
3245,JointPQPlayer,293,198,491,33,14,Player A
3246,JointPQPlayer,254,214,468,28,20,Player A
3247,JointPQPlayer,313,188,501,37,12,Player A
3248,JointPQPlayer,298,198,496,32,12,Player A
3249,JointPQPlayer,279,199,478,35,19,Player A
3250,JointPQPlayer,301,191,492,37,15,Player A
3251,JointPQPlayer,124,274,398,6,36,JointPQPlayer
3252,JointPQPlayer,166,251,417,16,33,JointPQPlayer
3253,JointPQPlayer,254,209,463,32,23,Player A
3254,JointPQPlayer,277,197,474,37,21,Player A
3255,JointPQPlayer,320,185,505,38,11,Player A
3256,JointPQPlayer,295,195,490,35,15,Player A
3257,JointPQPlayer,304,194,498,34,12,Player A
3258,JointPQPlayer,247,212,459,31,24,Player A
3259,JointPQPlayer,270,205,475,32,19,Player A
3260,JointPQPlayer,122,267,389,12,41,JointPQPlayer
3261,JointPQPlayer,296,191,487,38,17,Player A
3262,JointPQPlayer,252,212,464,30,22,Player A
3263,JointPQPlayer,126,266,392,12,40,JointPQPlayer
3264,JointPQPlayer,142,252,394,20,42,JointPQPlayer
3265,JointPQPlayer,297,192,489,37,16,Player A
3266,JointPQPlayer,308,193,501,34,11,Player A
3267,JointPQPlayer,254,219,473,24,17,Player A
3268,JointPQPlayer,293,198,491,33,14,Player A
3269,JointPQPlayer,308,188,496,38,14,Player A
3270,JointPQPlayer,183,243,426,19,31,JointPQPlayer
3271,JointPQPlayer,301,196,497,33,12,Player A
3272,JointPQPlayer,146,261,407,12,35,JointPQPlayer
3273,JointPQPlayer,123,263,386,15,43,JointPQPlayer
3274,JointPQPlayer,259,209,468,31,21,Player A
3275,JointPQPlayer,145,255,400,17,39,JointPQPlayer
3276,JointPQPlayer,141,261,402,13,37,JointPQPlayer
3277,JointPQPlayer,297,187,484,41,19,Player A
3278,JointPQPlayer,307,187,494,39,15,Player A
3279,JointPQPlayer,297,192,489,37,16,Player A
3280,JointPQPlayer,298,198,496,32,12,Player A
3281,JointPQPlayer,140,260,400,14,38,JointPQPlayer
3282,JointPQPlayer,304,194,498,34,12,Player A
3283,JointPQPlayer,291,196,487,35,16,Player A
3284,JointPQPlayer,285,200,485,33,16,Player A
3285,JointPQPlayer,278,203,481,32,17,Player A
3286,JointPQPlayer,326,181,507,40,11,Player A
3287,JointPQPlayer,297,197,494,33,13,Player A
3288,JointPQPlayer,311,191,502,35,11,Player A
3289,JointPQPlayer,300,195,495,34,13,Player A
3290,JointPQPlayer,113,268,381,13,44,JointPQPlayer
3291,JointPQPlayer,283,203,486,31,15,Player A
3292,JointPQPlayer,295,195,490,35,15,Player A
3293,JointPQPlayer,283,208,491,27,12,Player A
3294,JointPQPlayer,283,198,481,35,18,Player A
3295,JointPQPlayer,174,249,423,16,31,JointPQPlayer
3296,JointPQPlayer,271,211,482,27,15,Player A
3297,JointPQPlayer,154,254,408,16,36,JointPQPlayer
3298,JointPQPlayer,300,190,490,38,16,Player A
3299,JointPQPlayer,308,188,496,38,14,Player A
3300,JointPQPlayer,312,192,504,34,10,Player A
3301,JointPQPlayer,309,194,503,33,10,Player A
3302,JointPQPlayer,263,203,466,35,23,Player A
3303,JointPQPlayer,152,262,414,10,32,JointPQPlayer
3304,JointPQPlayer,244,219,463,26,21,Player A
3305,JointPQPlayer,156,256,412,14,34,JointPQPlayer
3306,JointPQPlayer,302,192,494,36,14,Player A
3307,JointPQPlayer,308,193,501,34,11,Player A
3308,JointPQPlayer,278,203,481,32,17,Player A
3309,JointPQPlayer,285,200,485,33,16,Player A
3310,JointPQPlayer,291,191,482,39,19,Player A
3311,JointPQPlayer,312,192,504,34,10,Player A
3312,JointPQPlayer,132,262,394,14,40,JointPQPlayer
3313,JointPQPlayer,292,197,489,34,15,Player A
3314,JointPQPlayer,173,248,421,17,32,JointPQPlayer
3315,JointPQPlayer,142,262,404,12,36,JointPQPlayer
3316,JointPQPlayer,276,206,482,30,16,Player A
3317,JointPQPlayer,327,177,504,43,13,Player A
3318,JointPQPlayer,305,185,490,41,17,Player A
3319,JointPQPlayer,126,266,392,12,40,JointPQPlayer
3320,JointPQPlayer,254,209,463,32,23,Player A
3321,JointPQPlayer,268,203,471,34,21,Player A
3322,JointPQPlayer,285,200,485,33,16,Player A
3323,JointPQPlayer,289,194,483,37,18,Player A
3324,JointPQPlayer,140,260,400,14,38,JointPQPlayer
3325,JointPQPlayer,293,193,486,37,17,Player A
3326,JointPQPlayer,290,195,485,36,17,Player A
3327,JointPQPlayer,325,180,505,41,12,Player A
3328,JointPQPlayer,306,191,497,36,13,Player A
3329,JointPQPlayer,145,260,405,13,36,JointPQPlayer
3330,JointPQPlayer,303,188,491,39,16,Player A
3331,JointPQPlayer,135,265,400,11,37,JointPQPlayer
3332,JointPQPlayer,295,200,495,31,12,Player A
3333,JointPQPlayer,262,212,474,28,18,Player A
3334,JointPQPlayer,287,197,484,35,17,Player A
3335,JointPQPlayer,269,209,478,29,17,Player A
3336,JointPQPlayer,148,258,406,14,36,JointPQPlayer
3337,JointPQPlayer,304,189,493,38,15,Player A
3338,JointPQPlayer,274,199,473,36,21,Player A
3339,JointPQPlayer,293,193,486,37,17,Player A
3340,JointPQPlayer,263,218,481,23,14,Player A
3341,JointPQPlayer,268,208,476,30,18,Player A
3342,JointPQPlayer,318,183,501,40,13,Player A
3343,JointPQPlayer,148,258,406,14,36,JointPQPlayer
3344,JointPQPlayer,307,192,499,35,12,Player A
3345,JointPQPlayer,324,179,503,42,13,Player A
3346,JointPQPlayer,292,192,484,38,18,Player A
3347,JointPQPlayer,263,208,471,31,20,Player A
3348,JointPQPlayer,313,188,501,37,12,Player A
3349,JointPQPlayer,290,200,490,32,14,Player A
3350,JointPQPlayer,292,197,489,34,15,Player A
3351,JointPQPlayer,281,201,482,33,17,Player A
3352,JointPQPlayer,308,188,496,38,14,Player A
3353,JointPQPlayer,302,187,489,40,17,Player A
3354,JointPQPlayer,158,253,411,16,35,JointPQPlayer
3355,JointPQPlayer,286,201,487,32,15,Player A
3356,JointPQPlayer,297,192,489,37,16,Player A
3357,JointPQPlayer,312,192,504,34,10,Player A
3358,JointPQPlayer,157,252,409,17,36,JointPQPlayer
3359,JointPQPlayer,328,183,511,38,9,Player A
3360,JointPQPlayer,155,255,410,15,35,JointPQPlayer
3361,JointPQPlayer,284,204,488,30,14,Player A
3362,JointPQPlayer,150,260,410,12,34,JointPQPlayer
3363,JointPQPlayer,276,206,482,30,16,Player A
3364,JointPQPlayer,276,196,472,38,22,Player A
3365,JointPQPlayer,275,200,475,35,20,Player A
3366,JointPQPlayer,258,208,466,32,22,Player A
3367,JointPQPlayer,151,261,412,11,33,JointPQPlayer
3368,JointPQPlayer,297,192,489,37,16,Player A
3369,JointPQPlayer,310,190,500,36,12,Player A
3370,JointPQPlayer,279,204,483,31,16,Player A
3371,JointPQPlayer,279,204,483,31,16,Player A
3372,JointPQPlayer,311,186,497,39,14,Player A
3373,JointPQPlayer,295,195,490,35,15,Player A
3374,JointPQPlayer,281,201,482,33,17,Player A
3375,JointPQPlayer,208,233,441,22,27,JointPQPlayer
3376,JointPQPlayer,109,274,383,9,42,JointPQPlayer
3377,JointPQPlayer,146,256,402,16,38,JointPQPlayer
3378,JointPQPlayer,289,199,488,33,15,Player A
3379,JointPQPlayer,308,188,496,38,14,Player A
3380,JointPQPlayer,305,190,495,37,14,Player A
3381,JointPQPlayer,288,193,481,38,19,Player A
3382,JointPQPlayer,126,266,392,12,40,JointPQPlayer
3383,JointPQPlayer,309,194,503,33,10,Player A
3384,JointPQPlayer,316,186,502,38,12,Player A
3385,JointPQPlayer,295,195,490,35,15,Player A
3386,JointPQPlayer,301,186,487,41,18,Player A
3387,JointPQPlayer,326,181,507,40,11,Player A
3388,JointPQPlayer,287,192,479,39,20,Player A
3389,JointPQPlayer,293,193,486,37,17,Player A
3390,JointPQPlayer,298,198,496,32,12,Player A
3391,JointPQPlayer,149,254,403,17,38,JointPQPlayer
3392,JointPQPlayer,297,192,489,37,16,Player A
3393,JointPQPlayer,283,198,481,35,18,Player A
3394,JointPQPlayer,272,207,479,30,17,Player A
3395,JointPQPlayer,283,198,481,35,18,Player A
3396,JointPQPlayer,141,261,402,13,37,JointPQPlayer
3397,JointPQPlayer,305,185,490,41,17,Player A
3398,JointPQPlayer,298,193,491,36,15,Player A
3399,JointPQPlayer,289,199,488,33,15,Player A
3400,JointPQPlayer,268,203,471,34,21,Player A
3401,JointPQPlayer,143,263,406,11,35,JointPQPlayer
3402,JointPQPlayer,288,203,491,30,13,Player A
3403,JointPQPlayer,297,197,494,33,13,Player A
3404,JointPQPlayer,256,211,467,30,21,Player A
3405,JointPQPlayer,228,223,451,26,25,Player A
3406,JointPQPlayer,292,197,489,34,15,Player A
3407,JointPQPlayer,312,192,504,34,10,Player A
3408,JointPQPlayer,312,187,499,38,13,Player A
3409,JointPQPlayer,312,187,499,38,13,Player A
3410,JointPQPlayer,308,188,496,38,14,Player A
3411,JointPQPlayer,291,196,487,35,16,Player A
3412,JointPQPlayer,321,186,507,37,10,Player A
3413,JointPQPlayer,258,213,471,28,19,Player A
3414,JointPQPlayer,293,198,491,33,14,Player A
3415,JointPQPlayer,296,196,492,34,14,Player A
3416,JointPQPlayer,291,196,487,35,16,Player A
3417,JointPQPlayer,300,195,495,34,13,Player A
3418,JointPQPlayer,294,194,488,36,16,Player A
3419,JointPQPlayer,294,194,488,36,16,Player A
3420,JointPQPlayer,157,252,409,17,36,JointPQPlayer
3421,JointPQPlayer,171,251,422,15,31,JointPQPlayer
3422,JointPQPlayer,295,195,490,35,15,Player A
3423,JointPQPlayer,293,198,491,33,14,Player A
3424,JointPQPlayer,312,187,499,38,13,Player A
3425,JointPQPlayer,149,259,408,13,35,JointPQPlayer
3426,JointPQPlayer,325,185,510,37,9,Player A
3427,JointPQPlayer,153,258,411,13,34,JointPQPlayer
3428,JointPQPlayer,175,250,425,15,30,JointPQPlayer
3429,JointPQPlayer,286,201,487,32,15,Player A
3430,JointPQPlayer,109,279,388,5,39,JointPQPlayer
3431,JointPQPlayer,158,253,411,16,35,JointPQPlayer
3432,JointPQPlayer,306,196,502,32,10,Player A
3433,JointPQPlayer,265,210,475,29,18,Player A
3434,JointPQPlayer,217,232,449,21,24,JointPQPlayer
3435,JointPQPlayer,280,205,485,30,15,Player A
3436,JointPQPlayer,281,201,482,33,17,Player A
3437,JointPQPlayer,290,200,490,32,14,Player A
3438,JointPQPlayer,210,235,445,20,25,JointPQPlayer
3439,JointPQPlayer,288,198,486,34,16,Player A
3440,JointPQPlayer,145,260,405,13,36,JointPQPlayer
3441,JointPQPlayer,261,211,472,29,19,Player A
3442,JointPQPlayer,297,192,489,37,16,Player A
3443,JointPQPlayer,274,204,478,32,18,Player A
3444,JointPQPlayer,149,254,403,17,38,JointPQPlayer
3445,JointPQPlayer,298,193,491,36,15,Player A
3446,JointPQPlayer,333,183,516,37,7,Player A
3447,JointPQPlayer,297,192,489,37,16,Player A
3448,JointPQPlayer,197,232,429,25,32,JointPQPlayer
3449,JointPQPlayer,287,197,484,35,17,Player A
3450,JointPQPlayer,218,228,446,24,26,JointPQPlayer
3451,JointPQPlayer,300,195,495,34,13,Player A
3452,JointPQPlayer,277,202,479,33,18,Player A
3453,JointPQPlayer,147,257,404,15,37,JointPQPlayer
3454,JointPQPlayer,311,186,497,39,14,Player A
3455,JointPQPlayer,162,252,414,16,34,JointPQPlayer
3456,JointPQPlayer,194,239,433,20,29,JointPQPlayer
3457,JointPQPlayer,286,201,487,32,15,Player A
3458,JointPQPlayer,283,203,486,31,15,Player A
3459,JointPQPlayer,300,190,490,38,16,Player A
3460,JointPQPlayer,283,198,481,35,18,Player A
3461,JointPQPlayer,294,194,488,36,16,Player A
3462,JointPQPlayer,322,187,509,36,9,Player A
3463,JointPQPlayer,325,185,510,37,9,Player A
3464,JointPQPlayer,235,220,455,27,24,Player A
3465,JointPQPlayer,182,247,429,16,29,JointPQPlayer
3466,JointPQPlayer,234,224,458,24,22,Player A
3467,JointPQPlayer,203,233,436,23,29,JointPQPlayer
3468,JointPQPlayer,290,200,490,32,14,Player A
3469,JointPQPlayer,303,193,496,35,13,Player A
3470,JointPQPlayer,308,193,501,34,11,Player A
3471,JointPQPlayer,287,197,484,35,17,Player A
3472,JointPQPlayer,281,201,482,33,17,Player A
3473,JointPQPlayer,304,184,488,42,18,Player A
3474,JointPQPlayer,265,210,475,29,18,Player A
3475,JointPQPlayer,135,255,390,19,43,JointPQPlayer
3476,JointPQPlayer,295,195,490,35,15,Player A
3477,JointPQPlayer,161,256,417,13,32,JointPQPlayer
3478,JointPQPlayer,310,185,495,40,15,Player A
3479,JointPQPlayer,161,251,412,17,35,JointPQPlayer
3480,JointPQPlayer,298,193,491,36,15,Player A
3481,JointPQPlayer,151,256,407,15,36,JointPQPlayer
3482,JointPQPlayer,285,200,485,33,16,Player A
3483,JointPQPlayer,292,192,484,38,18,Player A
3484,JointPQPlayer,270,205,475,32,19,Player A
3485,JointPQPlayer,280,200,480,34,18,Player A
3486,JointPQPlayer,257,207,464,33,23,Player A
3487,JointPQPlayer,150,260,410,12,34,JointPQPlayer
3488,JointPQPlayer,286,201,487,32,15,Player A
3489,JointPQPlayer,279,204,483,31,16,Player A
3490,JointPQPlayer,276,201,477,34,19,Player A
3491,JointPQPlayer,282,202,484,32,16,Player A
3492,JointPQPlayer,121,271,392,9,39,JointPQPlayer
3493,JointPQPlayer,274,204,478,32,18,Player A
3494,JointPQPlayer,290,195,485,36,17,Player A
3495,JointPQPlayer,279,204,483,31,16,Player A
3496,JointPQPlayer,276,206,482,30,16,Player A
3497,JointPQPlayer,310,190,500,36,12,Player A
3498,JointPQPlayer,270,210,480,28,16,Player A
3499,JointPQPlayer,310,190,500,36,12,Player A
3500,JointPQPlayer,280,200,480,34,18,Player A
3501,JointPQPlayer,303,193,496,35,13,Player A
3502,JointPQPlayer,267,207,474,31,19,Player A
3503,JointPQPlayer,292,197,489,34,15,Player A
3504,JointPQPlayer,317,182,499,41,14,Player A
3505,JointPQPlayer,214,224,438,28,30,JointPQPlayer
3506,JointPQPlayer,321,186,507,37,10,Player A
3507,JointPQPlayer,281,201,482,33,17,Player A
3508,JointPQPlayer,318,188,506,36,10,Player A
3509,JointPQPlayer,301,191,492,37,15,Player A
3510,JointPQPlayer,286,196,482,36,18,Player A
3511,JointPQPlayer,127,267,394,11,39,JointPQPlayer
3512,JointPQPlayer,292,197,489,34,15,Player A
3513,JointPQPlayer,296,196,492,34,14,Player A
3514,JointPQPlayer,198,233,431,24,31,JointPQPlayer
3515,JointPQPlayer,269,204,473,33,20,Player A
3516,JointPQPlayer,277,202,479,33,18,Player A
3517,JointPQPlayer,293,198,491,33,14,Player A
3518,JointPQPlayer,259,209,468,31,21,Player A
3519,JointPQPlayer,202,237,439,20,27,JointPQPlayer
3520,JointPQPlayer,282,197,479,36,19,Player A
3521,JointPQPlayer,137,262,399,13,38,JointPQPlayer
3522,JointPQPlayer,305,195,500,33,11,Player A
3523,JointPQPlayer,283,203,486,31,15,Player A
3524,JointPQPlayer,312,182,494,42,16,Player A
3525,JointPQPlayer,183,243,426,19,31,JointPQPlayer
3526,JointPQPlayer,292,197,489,34,15,Player A
3527,JointPQPlayer,127,267,394,11,39,JointPQPlayer
3528,JointPQPlayer,150,260,410,12,34,JointPQPlayer
3529,JointPQPlayer,285,200,485,33,16,Player A
3530,JointPQPlayer,260,205,465,34,23,Player A
3531,JointPQPlayer,257,212,469,29,20,Player A
3532,JointPQPlayer,296,196,492,34,14,Player A
3533,JointPQPlayer,262,212,474,28,18,Player A
3534,JointPQPlayer,305,190,495,37,14,Player A
3535,JointPQPlayer,295,200,495,31,12,Player A
3536,JointPQPlayer,270,205,475,32,19,Player A
3537,JointPQPlayer,126,261,387,16,43,JointPQPlayer
3538,JointPQPlayer,298,193,491,36,15,Player A
3539,JointPQPlayer,302,187,489,40,17,Player A
3540,JointPQPlayer,278,198,476,36,20,Player A
3541,JointPQPlayer,151,256,407,15,36,JointPQPlayer
3542,JointPQPlayer,294,194,488,36,16,Player A
3543,JointPQPlayer,309,189,498,37,13,Player A
3544,JointPQPlayer,296,191,487,38,17,Player A
3545,JointPQPlayer,282,202,484,32,16,Player A
3546,JointPQPlayer,290,200,490,32,14,Player A
3547,JointPQPlayer,296,196,492,34,14,Player A
3548,JointPQPlayer,335,180,515,39,8,Player A
3549,JointPQPlayer,144,259,403,14,37,JointPQPlayer
3550,JointPQPlayer,318,188,506,36,10,Player A
3551,JointPQPlayer,255,210,465,31,22,Player A
3552,JointPQPlayer,294,194,488,36,16,Player A
3553,JointPQPlayer,313,188,501,37,12,Player A
3554,JointPQPlayer,296,201,497,30,11,Player A
3555,JointPQPlayer,277,202,479,33,18,Player A
3556,JointPQPlayer,274,209,483,28,15,Player A
3557,JointPQPlayer,282,197,479,36,19,Player A
3558,JointPQPlayer,278,203,481,32,17,Player A
3559,JointPQPlayer,307,192,499,35,12,Player A
3560,JointPQPlayer,268,208,476,30,18,Player A
3561,JointPQPlayer,305,190,495,37,14,Player A
3562,JointPQPlayer,294,199,493,32,13,Player A
3563,JointPQPlayer,300,195,495,34,13,Player A
3564,JointPQPlayer,278,203,481,32,17,Player A
3565,JointPQPlayer,278,198,476,36,20,Player A
3566,JointPQPlayer,139,264,403,11,36,JointPQPlayer
3567,JointPQPlayer,153,248,401,21,40,JointPQPlayer
3568,JointPQPlayer,303,193,496,35,13,Player A
3569,JointPQPlayer,262,212,474,28,18,Player A
3570,JointPQPlayer,297,192,489,37,16,Player A
3571,JointPQPlayer,284,204,488,30,14,Player A
3572,JointPQPlayer,225,230,455,21,22,JointPQPlayer
3573,JointPQPlayer,249,214,463,29,22,Player A
3574,JointPQPlayer,161,251,412,17,35,JointPQPlayer
3575,JointPQPlayer,261,211,472,29,19,Player A
3576,JointPQPlayer,274,204,478,32,18,Player A
3577,JointPQPlayer,275,200,475,35,20,Player A
3578,JointPQPlayer,299,194,493,35,14,Player A
3579,JointPQPlayer,312,187,499,38,13,Player A
3580,JointPQPlayer,309,189,498,37,13,Player A
3581,JointPQPlayer,316,191,507,34,9,Player A
3582,JointPQPlayer,308,188,496,38,14,Player A
3583,JointPQPlayer,271,201,472,35,21,Player A
3584,JointPQPlayer,155,255,410,15,35,JointPQPlayer
3585,JointPQPlayer,274,204,478,32,18,Player A
3586,JointPQPlayer,295,195,490,35,15,Player A
3587,JointPQPlayer,269,204,473,33,20,Player A
3588,JointPQPlayer,278,198,476,36,20,Player A
3589,JointPQPlayer,303,193,496,35,13,Player A
3590,JointPQPlayer,286,196,482,36,18,Player A
3591,JointPQPlayer,135,260,395,15,40,JointPQPlayer
3592,JointPQPlayer,143,263,406,11,35,JointPQPlayer
3593,JointPQPlayer,275,200,475,35,20,Player A
3594,JointPQPlayer,277,197,474,37,21,Player A
3595,JointPQPlayer,276,201,477,34,19,Player A
3596,JointPQPlayer,304,194,498,34,12,Player A
3597,JointPQPlayer,290,195,485,36,17,Player A
3598,JointPQPlayer,199,234,433,23,30,JointPQPlayer
3599,JointPQPlayer,136,261,397,14,39,JointPQPlayer
3600,JointPQPlayer,324,184,508,38,10,Player A
3601,JointPQPlayer,292,197,489,34,15,Player A
3602,JointPQPlayer,288,198,486,34,16,Player A
3603,JointPQPlayer,292,197,489,34,15,Player A
3604,JointPQPlayer,304,189,493,38,15,Player A
3605,JointPQPlayer,309,194,503,33,10,Player A
3606,JointPQPlayer,270,205,475,32,19,Player A
3607,JointPQPlayer,309,194,503,33,10,Player A
3608,JointPQPlayer,295,195,490,35,15,Player A
3609,JointPQPlayer,297,197,494,33,13,Player A
3610,JointPQPlayer,286,201,487,32,15,Player A
3611,JointPQPlayer,310,185,495,40,15,Player A
3612,JointPQPlayer,291,196,487,35,16,Player A
3613,JointPQPlayer,300,195,495,34,13,Player A
3614,JointPQPlayer,297,192,489,37,16,Player A
3615,JointPQPlayer,302,192,494,36,14,Player A
3616,JointPQPlayer,142,257,399,16,39,JointPQPlayer
3617,JointPQPlayer,272,207,479,30,17,Player A
3618,JointPQPlayer,324,184,508,38,10,Player A
3619,JointPQPlayer,278,198,476,36,20,Player A
3620,JointPQPlayer,255,210,465,31,22,Player A
3621,JointPQPlayer,293,198,491,33,14,Player A
3622,JointPQPlayer,258,208,466,32,22,Player A
3623,JointPQPlayer,290,195,485,36,17,Player A
3624,JointPQPlayer,289,199,488,33,15,Player A
3625,JointPQPlayer,293,193,486,37,17,Player A
3626,JointPQPlayer,284,199,483,34,17,Player A
3627,JointPQPlayer,285,200,485,33,16,Player A
3628,JointPQPlayer,294,194,488,36,16,Player A
3629,JointPQPlayer,141,266,407,9,34,JointPQPlayer
3630,JointPQPlayer,314,189,503,36,11,Player A
3631,JointPQPlayer,255,210,465,31,22,Player A
3632,JointPQPlayer,293,193,486,37,17,Player A
3633,JointPQPlayer,293,198,491,33,14,Player A
3634,JointPQPlayer,156,256,412,14,34,JointPQPlayer
3635,JointPQPlayer,283,198,481,35,18,Player A
3636,JointPQPlayer,312,192,504,34,10,Player A
3637,JointPQPlayer,310,190,500,36,12,Player A
3638,JointPQPlayer,269,204,473,33,20,Player A
3639,JointPQPlayer,293,193,486,37,17,Player A
3640,JointPQPlayer,299,194,493,35,14,Player A
3641,JointPQPlayer,299,194,493,35,14,Player A
3642,JointPQPlayer,309,189,498,37,13,Player A
3643,JointPQPlayer,295,195,490,35,15,Player A
3644,JointPQPlayer,272,207,479,30,17,Player A
3645,JointPQPlayer,293,193,486,37,17,Player A
3646,JointPQPlayer,312,187,499,38,13,Player A
3647,JointPQPlayer,279,199,478,35,19,Player A
3648,JointPQPlayer,164,249,413,18,35,JointPQPlayer
3649,JointPQPlayer,310,190,500,36,12,Player A
3650,JointPQPlayer,274,199,473,36,21,Player A
3651,JointPQPlayer,277,202,479,33,18,Player A
3652,JointPQPlayer,280,195,475,38,21,Player A
3653,JointPQPlayer,149,259,408,13,35,JointPQPlayer
3654,JointPQPlayer,155,255,410,15,35,JointPQPlayer
3655,JointPQPlayer,314,184,498,40,14,Player A
3656,JointPQPlayer,262,212,474,28,18,Player A
3657,JointPQPlayer,159,249,408,19,37,JointPQPlayer
3658,JointPQPlayer,305,190,495,37,14,Player A
3659,JointPQPlayer,176,251,427,14,29,JointPQPlayer
3660,JointPQPlayer,191,236,427,23,32,JointPQPlayer
3661,JointPQPlayer,309,189,498,37,13,Player A
3662,JointPQPlayer,241,221,462,25,21,Player A
3663,JointPQPlayer,278,203,481,32,17,Player A
3664,JointPQPlayer,285,195,480,37,19,Player A
3665,JointPQPlayer,296,201,497,30,11,Player A
3666,JointPQPlayer,263,213,476,27,17,Player A
3667,JointPQPlayer,314,189,503,36,11,Player A
3668,JointPQPlayer,146,256,402,16,38,JointPQPlayer
3669,JointPQPlayer,260,205,465,34,23,Player A
3670,JointPQPlayer,137,257,394,17,41,JointPQPlayer
3671,JointPQPlayer,263,208,471,31,20,Player A
3672,JointPQPlayer,144,259,403,14,37,JointPQPlayer
3673,JointPQPlayer,310,195,505,32,9,Player A
3674,JointPQPlayer,163,253,416,15,33,JointPQPlayer
3675,JointPQPlayer,116,271,387,10,41,JointPQPlayer
3676,JointPQPlayer,324,184,508,38,10,Player A
3677,JointPQPlayer,284,199,483,34,17,Player A
3678,JointPQPlayer,287,197,484,35,17,Player A
3679,JointPQPlayer,274,204,478,32,18,Player A
3680,JointPQPlayer,299,194,493,35,14,Player A
3681,JointPQPlayer,222,232,454,20,22,JointPQPlayer
3682,JointPQPlayer,279,204,483,31,16,Player A
3683,JointPQPlayer,266,206,472,32,20,Player A
3684,JointPQPlayer,311,191,502,35,11,Player A
3685,JointPQPlayer,305,195,500,33,11,Player A
3686,JointPQPlayer,330,180,510,40,10,Player A
3687,JointPQPlayer,319,189,508,35,9,Player A
3688,JointPQPlayer,298,188,486,40,18,Player A
3689,JointPQPlayer,290,195,485,36,17,Player A
3690,JointPQPlayer,155,260,415,11,32,JointPQPlayer
3691,JointPQPlayer,277,202,479,33,18,Player A
3692,JointPQPlayer,286,201,487,32,15,Player A
3693,JointPQPlayer,281,201,482,33,17,Player A
3694,JointPQPlayer,253,208,461,33,24,Player A
3695,JointPQPlayer,317,187,504,37,11,Player A
3696,JointPQPlayer,295,200,495,31,12,Player A
3697,JointPQPlayer,295,195,490,35,15,Player A
3698,JointPQPlayer,175,245,420,19,33,JointPQPlayer
3699,JointPQPlayer,154,254,408,16,36,JointPQPlayer
3700,JointPQPlayer,192,242,434,18,28,JointPQPlayer
3701,JointPQPlayer,306,191,497,36,13,Player A
3702,JointPQPlayer,305,190,495,37,14,Player A
3703,JointPQPlayer,290,195,485,36,17,Player A
3704,JointPQPlayer,137,262,399,13,38,JointPQPlayer
3705,JointPQPlayer,282,197,479,36,19,Player A
3706,JointPQPlayer,284,204,488,30,14,Player A
3707,JointPQPlayer,266,206,472,32,20,Player A
3708,JointPQPlayer,272,197,469,38,23,Player A
3709,JointPQPlayer,301,191,492,37,15,Player A
3710,JointPQPlayer,234,219,453,28,25,Player A
3711,JointPQPlayer,277,202,479,33,18,Player A
3712,JointPQPlayer,271,211,482,27,15,Player A
3713,JointPQPlayer,286,196,482,36,18,Player A
3714,JointPQPlayer,302,187,489,40,17,Player A
3715,JointPQPlayer,302,192,494,36,14,Player A
3716,JointPQPlayer,183,243,426,19,31,JointPQPlayer
3717,JointPQPlayer,281,201,482,33,17,Player A
3718,JointPQPlayer,140,265,405,10,35,JointPQPlayer
3719,JointPQPlayer,309,189,498,37,13,Player A
3720,JointPQPlayer,312,182,494,42,16,Player A
3721,JointPQPlayer,290,190,480,40,20,Player A
3722,JointPQPlayer,149,259,408,13,35,JointPQPlayer
3723,JointPQPlayer,192,242,434,18,28,JointPQPlayer
3724,JointPQPlayer,285,200,485,33,16,Player A
3725,JointPQPlayer,156,256,412,14,34,JointPQPlayer
3726,JointPQPlayer,276,206,482,30,16,Player A
3727,JointPQPlayer,276,201,477,34,19,Player A
3728,JointPQPlayer,301,191,492,37,15,Player A
3729,JointPQPlayer,288,198,486,34,16,Player A
3730,JointPQPlayer,265,205,470,33,21,Player A
3731,JointPQPlayer,289,199,488,33,15,Player A
3732,JointPQPlayer,289,194,483,37,18,Player A
3733,JointPQPlayer,276,201,477,34,19,Player A
3734,JointPQPlayer,137,267,404,9,35,JointPQPlayer
3735,JointPQPlayer,222,227,449,24,25,JointPQPlayer
3736,JointPQPlayer,259,209,468,31,21,Player A
3737,JointPQPlayer,156,261,417,10,31,JointPQPlayer
3738,JointPQPlayer,281,201,482,33,17,Player A
3739,JointPQPlayer,211,231,442,23,27,JointPQPlayer
3740,JointPQPlayer,214,229,443,24,27,JointPQPlayer
3741,JointPQPlayer,270,205,475,32,19,Player A
3742,JointPQPlayer,261,211,472,29,19,Player A
3743,JointPQPlayer,121,266,387,13,42,JointPQPlayer
3744,JointPQPlayer,154,254,408,16,36,JointPQPlayer
3745,JointPQPlayer,286,201,487,32,15,Player A
3746,JointPQPlayer,294,194,488,36,16,Player A
3747,JointPQPlayer,144,259,403,14,37,JointPQPlayer
3748,JointPQPlayer,318,183,501,40,13,Player A
3749,JointPQPlayer,305,190,495,37,14,Player A
3750,JointPQPlayer,313,188,501,37,12,Player A
3751,JointPQPlayer,149,259,408,13,35,JointPQPlayer
3752,JointPQPlayer,238,213,451,32,27,Player A
3753,JointPQPlayer,173,248,421,17,32,JointPQPlayer
3754,JointPQPlayer,157,252,409,17,36,JointPQPlayer
3755,JointPQPlayer,291,196,487,35,16,Player A
3756,JointPQPlayer,246,221,467,24,19,Player A
3757,JointPQPlayer,323,183,506,39,11,Player A
3758,JointPQPlayer,288,198,486,34,16,Player A
3759,JointPQPlayer,316,186,502,38,12,Player A
3760,JointPQPlayer,293,193,486,37,17,Player A
3761,JointPQPlayer,111,271,382,11,43,JointPQPlayer
3762,JointPQPlayer,297,197,494,33,13,Player A
3763,JointPQPlayer,267,207,474,31,19,Player A
3764,JointPQPlayer,253,213,466,29,21,Player A
3765,JointPQPlayer,253,213,466,29,21,Player A
3766,JointPQPlayer,313,188,501,37,12,Player A
3767,JointPQPlayer,287,197,484,35,17,Player A
3768,JointPQPlayer,308,188,496,38,14,Player A
3769,JointPQPlayer,293,193,486,37,17,Player A
3770,JointPQPlayer,251,211,462,31,23,Player A
3771,JointPQPlayer,278,198,476,36,20,Player A
3772,JointPQPlayer,128,263,391,14,41,JointPQPlayer
3773,JointPQPlayer,148,258,406,14,36,JointPQPlayer
3774,JointPQPlayer,250,210,460,32,24,Player A
3775,JointPQPlayer,317,187,504,37,11,Player A
3776,JointPQPlayer,312,192,504,34,10,Player A
3777,JointPQPlayer,275,200,475,35,20,Player A
3778,JointPQPlayer,282,197,479,36,19,Player A
3779,JointPQPlayer,305,190,495,37,14,Player A
3780,JointPQPlayer,264,204,468,34,22,Player A
3781,JointPQPlayer,317,187,504,37,11,Player A
3782,JointPQPlayer,270,205,475,32,19,Player A
3783,JointPQPlayer,264,204,468,34,22,Player A
3784,JointPQPlayer,288,193,481,38,19,Player A
3785,JointPQPlayer,265,205,470,33,21,Player A
3786,JointPQPlayer,295,195,490,35,15,Player A
3787,JointPQPlayer,289,194,483,37,18,Player A
3788,JointPQPlayer,295,195,490,35,15,Player A
3789,JointPQPlayer,290,195,485,36,17,Player A
3790,JointPQPlayer,278,203,481,32,17,Player A
3791,JointPQPlayer,135,265,400,11,37,JointPQPlayer
3792,JointPQPlayer,280,195,475,38,21,Player A
3793,JointPQPlayer,292,197,489,34,15,Player A
3794,JointPQPlayer,213,228,441,25,28,JointPQPlayer
3795,JointPQPlayer,289,194,483,37,18,Player A
3796,JointPQPlayer,296,196,492,34,14,Player A
3797,JointPQPlayer,265,210,475,29,18,Player A
3798,JointPQPlayer,278,203,481,32,17,Player A
3799,JointPQPlayer,315,185,500,39,13,Player A
3800,JointPQPlayer,273,208,481,29,16,Player A
3801,JointPQPlayer,304,189,493,38,15,Player A
0,revTitforTat,220,215,435,34,33,Player A
1,revTitforTat,213,218,431,33,34,revTitforTat
2,revTitforTat,220,215,435,34,33,Player A
3,revTitforTat,217,217,434,33,33,Tie
4,revTitforTat,213,218,431,33,34,revTitforTat
5,revTitforTat,220,215,435,34,33,Player A
6,revTitforTat,217,217,434,33,33,Tie
7,revTitforTat,213,218,431,33,34,revTitforTat
8,revTitforTat,220,215,435,34,33,Player A
9,revTitforTat,217,217,434,33,33,Tie
10,revTitforTat,213,218,431,33,34,revTitforTat
11,revTitforTat,220,215,435,34,33,Player A
12,revTitforTat,217,217,434,33,33,Tie
0,PatternPlayer,234,234,468,16,16,Tie
1,PatternPlayer,233,233,466,17,17,Tie
2,PatternPlayer,233,233,466,17,17,Tie
3,PatternPlayer,234,234,468,16,16,Tie
4,PatternPlayer,233,233,466,17,17,Tie
5,PatternPlayer,233,233,466,17,17,Tie
6,PatternPlayer,234,234,468,16,16,Tie
7,PatternPlayer,233,233,466,17,17,Tie
8,PatternPlayer,233,233,466,17,17,Tie
9,PatternPlayer,234,234,468,16,16,Tie
10,PatternPlayer,233,233,466,17,17,Tie
0,GrudgePlayer,121,281,402,1,33,GrudgePlayer
1,GrudgePlayer,118,283,401,0,33,GrudgePlayer
2,GrudgePlayer,114,284,398,0,34,GrudgePlayer
3,GrudgePlayer,118,283,401,0,33,GrudgePlayer
4,GrudgePlayer,118,283,401,0,33,GrudgePlayer
5,GrudgePlayer,114,284,398,0,34,GrudgePlayer
6,GrudgePlayer,118,283,401,0,33,GrudgePlayer
7,GrudgePlayer,118,283,401,0,33,GrudgePlayer
8,GrudgePlayer,114,284,398,0,34,GrudgePlayer
9,GrudgePlayer,118,283,401,0,33,GrudgePlayer
10,GrudgePlayer,118,283,401,0,33,GrudgePlayer
0,Gullible,400,150,550,50,0,Player A
1,Gullible,400,150,550,50,0,Player A
2,Gullible,400,150,550,50,0,Player A
3,Gullible,400,150,550,50,0,Player A
4,Gullible,400,150,550,50,0,Player A
5,Gullible,400,150,550,50,0,Player A
6,Gullible,400,150,550,50,0,Player A
7,Gullible,400,150,550,50,0,Player A
8,Gullible,400,150,550,50,0,Player A
9,Gullible,400,150,550,50,0,Player A
10,Gullible,400,150,550,50,0,Player A
0,Sly Fox,50,300,350,0,50,Sly Fox
1,Sly Fox,50,300,350,0,50,Sly Fox
2,Sly Fox,50,300,350,0,50,Sly Fox
3,Sly Fox,50,300,350,0,50,Sly Fox
4,Sly Fox,50,300,350,0,50,Sly Fox
5,Sly Fox,50,300,350,0,50,Sly Fox
6,Sly Fox,50,300,350,0,50,Sly Fox
7,Sly Fox,50,300,350,0,50,Sly Fox
8,Sly Fox,50,300,350,0,50,Sly Fox
9,Sly Fox,50,300,350,0,50,Sly Fox
10,Sly Fox,50,300,350,0,50,Sly Fox
0,Evan,217,217,434,33,33,Tie
1,Evan,217,217,434,33,33,Tie
2,Evan,216,216,432,34,34,Tie
3,Evan,217,217,434,33,33,Tie
4,Evan,217,217,434,33,33,Tie
5,Evan,216,216,432,34,34,Tie
6,Evan,217,217,434,33,33,Tie
7,Evan,217,217,434,33,33,Tie
8,Evan,216,216,432,34,34,Tie
9,Evan,217,217,434,33,33,Tie
10,Evan,217,217,434,33,33,Tie
0,Randy,215,225,440,27,29,Randy
1,Randy,199,229,428,27,33,Randy
2,Randy,226,221,447,28,27,Player A
3,Randy,207,232,439,23,28,Randy
4,Randy,237,222,459,25,22,Player A
5,Randy,209,224,433,29,32,Randy
6,Randy,213,233,446,21,25,Randy
7,Randy,207,232,439,23,28,Randy
8,Randy,220,235,455,18,21,Randy
9,Randy,208,233,441,22,27,Randy
10,Randy,280,200,480,34,18,Player A
11,Randy,205,230,435,25,30,Randy
12,Randy,232,227,459,22,21,Player A
13,Randy,232,217,449,30,27,Player A
14,Randy,251,216,467,27,20,Player A
15,Randy,221,226,447,25,26,Randy
16,Randy,260,215,475,26,17,Player A
17,Randy,208,233,441,22,27,Randy
18,Randy,246,216,462,28,22,Player A
19,Randy,229,224,453,25,24,Player A
20,Randy,250,215,465,28,21,Player A
21,Randy,205,230,435,25,30,Randy
22,Randy,197,242,439,17,26,Randy
23,Randy,203,238,441,19,26,Randy
24,Randy,227,227,454,23,23,Tie
25,Randy,198,233,431,24,31,Randy
26,Randy,262,212,474,28,18,Player A
27,Randy,215,230,445,23,26,Randy
28,Randy,228,218,446,30,28,Player A
29,Randy,251,216,467,27,20,Player A
30,Randy,210,230,440,24,28,Randy
31,Randy,206,221,427,32,35,Randy
32,Randy,245,220,465,25,20,Player A
33,Randy,229,224,453,25,24,Player A
34,Randy,229,219,448,29,27,Player A
35,Randy,221,221,442,29,29,Tie
36,Randy,226,221,447,28,27,Player A
37,Randy,219,229,448,23,25,Randy
38,Randy,231,226,457,23,22,Player A
39,Randy,255,215,470,27,19,Player A
40,Randy,241,226,467,21,18,Player A
41,Randy,251,216,467,27,20,Player A
42,Randy,231,221,452,27,25,Player A
43,Randy,229,219,448,29,27,Player A
44,Randy,245,215,460,29,23,Player A
45,Randy,214,229,443,24,27,Randy
46,Randy,204,234,438,22,28,Randy
47,Randy,217,232,449,21,24,Randy
48,Randy,199,229,428,27,33,Randy
49,Randy,226,216,442,32,30,Player A
50,Randy,223,228,451,23,24,Randy
51,Randy,209,229,438,25,29,Randy
52,Randy,264,209,473,30,19,Player A
53,Randy,222,227,449,24,25,Randy
54,Randy,210,230,440,24,28,Randy
55,Randy,208,228,436,26,30,Randy
56,Randy,268,213,481,26,15,Player A
57,Randy,212,227,439,26,29,Randy
58,Randy,208,233,441,22,27,Randy
59,Randy,255,210,465,31,22,Player A
60,Randy,237,222,459,25,22,Player A
61,Randy,222,222,444,28,28,Tie
62,Randy,226,226,452,24,24,Tie
63,Randy,216,231,447,22,25,Randy
64,Randy,211,231,442,23,27,Randy
65,Randy,199,234,433,23,30,Randy
66,Randy,217,227,444,25,27,Randy
67,Randy,203,233,436,23,29,Randy
68,Randy,230,225,455,24,23,Player A
69,Randy,193,243,436,17,27,Randy
70,Randy,209,224,433,29,32,Randy
71,Randy,230,225,455,24,23,Player A
72,Randy,222,222,444,28,28,Tie
73,Randy,206,231,437,24,29,Randy
74,Randy,237,217,454,29,25,Player A
75,Randy,223,223,446,27,27,Tie
76,Randy,229,219,448,29,27,Player A
77,Randy,244,214,458,30,24,Player A
78,Randy,222,222,444,28,28,Tie
79,Randy,206,231,437,24,29,Randy
80,Randy,205,235,440,21,27,Randy
81,Randy,250,215,465,28,21,Player A
82,Randy,234,219,453,28,25,Player A
83,Randy,246,216,462,28,22,Player A
84,Randy,239,219,458,27,23,Player A
85,Randy,239,224,463,23,20,Player A
86,Randy,221,216,437,33,32,Player A
87,Randy,188,243,431,18,29,Randy
88,Randy,246,216,462,28,22,Player A
89,Randy,212,232,444,22,26,Randy
90,Randy,206,236,442,20,26,Randy
91,Randy,208,228,436,26,30,Randy
92,Randy,232,222,454,26,24,Player A
93,Randy,229,219,448,29,27,Player A
94,Randy,245,220,465,25,20,Player A
95,Randy,251,221,472,23,17,Player A
96,Randy,221,226,447,25,26,Randy
97,Randy,248,218,466,26,20,Player A
98,Randy,222,227,449,24,25,Randy
99,Randy,234,219,453,28,25,Player A
100,Randy,206,231,437,24,29,Randy
101,Randy,256,211,467,30,21,Player A
102,Randy,193,238,431,21,30,Randy
103,Randy,232,227,459,22,21,Player A
104,Randy,261,206,467,33,22,Player A
105,Randy,189,234,423,25,34,Randy
106,Randy,228,223,451,26,25,Player A
107,Randy,248,218,466,26,20,Player A
108,Randy,210,235,445,20,25,Randy
109,Randy,193,238,431,21,30,Randy
110,Randy,216,231,447,22,25,Randy
111,Randy,225,225,450,25,25,Tie
112,Randy,229,224,453,25,24,Player A
113,Randy,248,218,466,26,20,Player A
114,Randy,213,233,446,21,25,Randy
115,Randy,213,233,446,21,25,Randy
116,Randy,189,239,428,21,31,Randy
117,Randy,208,223,431,30,33,Randy
118,Randy,217,227,444,25,27,Randy
119,Randy,231,226,457,23,22,Player A
120,Randy,210,230,440,24,28,Randy
121,Randy,237,222,459,25,22,Player A
122,Randy,244,219,463,26,21,Player A
123,Randy,197,237,434,21,29,Randy
124,Randy,245,215,460,29,23,Player A
125,Randy,211,226,437,27,30,Randy
126,Randy,233,228,461,21,20,Player A
127,Randy,227,222,449,27,26,Player A
128,Randy,249,219,468,25,19,Player A
129,Randy,216,231,447,22,25,Randy
130,Randy,234,224,458,24,22,Player A
131,Randy,248,218,466,26,20,Player A
132,Randy,234,219,453,28,25,Player A
133,Randy,240,215,455,30,25,Player A
134,Randy,259,209,468,31,21,Player A
135,Randy,232,217,449,30,27,Player A
136,Randy,272,207,479,30,17,Player A
137,Randy,219,229,448,23,25,Randy
138,Randy,235,225,460,23,21,Player A
139,Randy,209,234,443,21,26,Randy
140,Randy,203,233,436,23,29,Randy
141,Randy,187,242,429,19,30,Randy
142,Randy,216,226,442,26,28,Randy
143,Randy,218,238,456,16,20,Randy
144,Randy,217,227,444,25,27,Randy
145,Randy,270,205,475,32,19,Player A
146,Randy,213,228,441,25,28,Randy
147,Randy,235,220,455,27,24,Player A
148,Randy,238,223,461,24,21,Player A
149,Randy,245,220,465,25,20,Player A
150,Randy,195,240,435,19,28,Randy
151,Randy,201,231,432,25,31,Randy
152,Randy,208,228,436,26,30,Randy
153,Randy,211,226,437,27,30,Randy
154,Randy,236,211,447,34,29,Player A
155,Randy,239,224,463,23,20,Player A
156,Randy,221,231,452,21,23,Randy
157,Randy,237,227,464,21,19,Player A
158,Randy,231,221,452,27,25,Player A
159,Randy,242,222,464,24,20,Player A
160,Randy,229,224,453,25,24,Player A
161,Randy,205,235,440,21,27,Randy
162,Randy,215,235,450,19,23,Randy
163,Randy,251,211,462,31,23,Player A
164,Randy,215,225,440,27,29,Randy
165,Randy,235,225,460,23,21,Player A
166,Randy,214,229,443,24,27,Randy
167,Randy,197,242,439,17,26,Randy
168,Randy,244,214,458,30,24,Player A
169,Randy,215,225,440,27,29,Randy
170,Randy,239,224,463,23,20,Player A
171,Randy,206,231,437,24,29,Randy
172,Randy,225,225,450,25,25,Tie
173,Randy,231,221,452,27,25,Player A
174,Randy,259,214,473,27,18,Player A
175,Randy,217,222,439,29,30,Randy
176,Randy,230,225,455,24,23,Player A
177,Randy,244,224,468,22,18,Player A
178,Randy,194,239,433,20,29,Randy
179,Randy,207,227,434,27,31,Randy
180,Randy,249,214,463,29,22,Player A
181,Randy,241,216,457,29,24,Player A
182,Randy,264,204,468,34,22,Player A
183,Randy,233,223,456,25,23,Player A
184,Randy,214,229,443,24,27,Randy
185,Randy,274,204,478,32,18,Player A
186,Randy,229,224,453,25,24,Player A
187,Randy,201,236,437,21,28,Randy
188,Randy,224,224,448,26,26,Tie
189,Randy,235,220,455,27,24,Player A
190,Randy,222,232,454,20,22,Randy
191,Randy,230,220,450,28,26,Player A
192,Randy,243,218,461,27,22,Player A
193,Randy,221,226,447,25,26,Randy
194,Randy,224,224,448,26,26,Tie
195,Randy,203,233,436,23,29,Randy
196,Randy,212,232,444,22,26,Randy
197,Randy,222,227,449,24,25,Randy
198,Randy,202,227,429,28,33,Randy
199,Randy,229,219,448,29,27,Player A
200,Randy,202,232,434,24,30,Randy
201,Randy,239,219,458,27,23,Player A
202,Randy,237,217,454,29,25,Player A
203,Randy,242,217,459,28,23,Player A
204,Randy,205,230,435,25,30,Randy
205,Randy,213,228,441,25,28,Randy
206,Randy,265,210,475,29,18,Player A
207,Randy,232,217,449,30,27,Player A
208,Randy,214,234,448,20,24,Randy
209,Randy,232,222,454,26,24,Player A
210,Randy,242,212,454,32,26,Player A
211,Randy,233,223,456,25,23,Player A
212,Randy,239,224,463,23,20,Player A
213,Randy,219,229,448,23,25,Randy
214,Randy,222,227,449,24,25,Randy
215,Randy,218,233,451,20,23,Randy
216,Randy,233,223,456,25,23,Player A
217,Randy,218,223,441,28,29,Randy
218,Randy,237,227,464,21,19,Player A
219,Randy,266,211,477,28,17,Player A
220,Randy,224,224,448,26,26,Tie
221,Randy,240,220,460,26,22,Player A
222,Randy,233,223,456,25,23,Player A
223,Randy,241,216,457,29,24,Player A
224,Randy,220,225,445,26,27,Randy
225,Randy,210,235,445,20,25,Randy
226,Randy,201,241,442,17,25,Randy
227,Randy,201,231,432,25,31,Randy
228,Randy,212,232,444,22,26,Randy
229,Randy,211,231,442,23,27,Randy
230,Randy,222,227,449,24,25,Randy
231,Randy,236,221,457,26,23,Player A
232,Randy,234,219,453,28,25,Player A
233,Randy,217,227,444,25,27,Randy
234,Randy,229,214,443,33,30,Player A
235,Randy,215,230,445,23,26,Randy
236,Randy,209,234,443,21,26,Randy
237,Randy,190,240,430,20,30,Randy
238,Randy,184,239,423,22,33,Randy
239,Randy,228,223,451,26,25,Player A
240,Randy,239,214,453,31,26,Player A
241,Randy,249,224,473,21,16,Player A
242,Randy,238,218,456,28,24,Player A
243,Randy,224,224,448,26,26,Tie
244,Randy,225,230,455,21,22,Randy
245,Randy,208,228,436,26,30,Randy
246,Randy,194,234,428,24,32,Randy
247,Randy,253,213,466,29,21,Player A
248,Randy,215,230,445,23,26,Randy
249,Randy,227,222,449,27,26,Player A
250,Randy,194,234,428,24,32,Randy
251,Randy,254,209,463,32,23,Player A
252,Randy,209,234,443,21,26,Randy
253,Randy,230,230,460,20,20,Tie
254,Randy,236,221,457,26,23,Player A
255,Randy,214,229,443,24,27,Randy
256,Randy,224,224,448,26,26,Tie
257,Randy,228,218,446,30,28,Player A
258,Randy,220,225,445,26,27,Randy
259,Randy,226,221,447,28,27,Player A
260,Randy,237,217,454,29,25,Player A
261,Randy,220,230,450,22,24,Randy
262,Randy,240,220,460,26,22,Player A
263,Randy,191,241,432,19,29,Randy
264,Randy,225,225,450,25,25,Tie
265,Randy,227,222,449,27,26,Player A
266,Randy,266,206,472,32,20,Player A
267,Randy,213,228,441,25,28,Randy
268,Randy,210,235,445,20,25,Randy
269,Randy,239,214,453,31,26,Player A
270,Randy,215,230,445,23,26,Randy
271,Randy,224,224,448,26,26,Tie
272,Randy,235,225,460,23,21,Player A
273,Randy,227,232,459,19,20,Randy
274,Randy,259,209,468,31,21,Player A
275,Randy,217,227,444,25,27,Randy
276,Randy,230,220,450,28,26,Player A
277,Randy,247,217,464,27,21,Player A
278,Randy,236,221,457,26,23,Player A
279,Randy,214,229,443,24,27,Randy
280,Randy,205,230,435,25,30,Randy
281,Randy,212,232,444,22,26,Randy
282,Randy,229,224,453,25,24,Player A
283,Randy,222,227,449,24,25,Randy
284,Randy,218,233,451,20,23,Randy
285,Randy,199,234,433,23,30,Randy
286,Randy,211,231,442,23,27,Randy
287,Randy,213,233,446,21,25,Randy
288,Randy,245,215,460,29,23,Player A
289,Randy,197,237,434,21,29,Randy
290,Randy,202,237,439,20,27,Randy
291,Randy,204,234,438,22,28,Randy
292,Randy,236,216,452,30,26,Player A
293,Randy,229,224,453,25,24,Player A
294,Randy,231,231,462,19,19,Tie
295,Randy,231,226,457,23,22,Player A
296,Randy,266,206,472,32,20,Player A
297,Randy,231,221,452,27,25,Player A
298,Randy,229,224,453,25,24,Player A
299,Randy,243,213,456,31,25,Player A
300,Randy,238,213,451,32,27,Player A
301,Randy,215,230,445,23,26,Randy
302,Randy,227,227,454,23,23,Tie
303,Randy,241,221,462,25,21,Player A
304,Randy,253,213,466,29,21,Player A
305,Randy,217,227,444,25,27,Randy
306,Randy,194,234,428,24,32,Randy
307,Randy,228,233,461,18,19,Randy
308,Randy,208,238,446,18,24,Randy
309,Randy,221,231,452,21,23,Randy
310,Randy,222,232,454,20,22,Randy
311,Randy,227,227,454,23,23,Tie
312,Randy,244,219,463,26,21,Player A
313,Randy,240,215,455,30,25,Player A
314,Randy,214,229,443,24,27,Randy
315,Randy,260,210,470,30,20,Player A
316,Randy,201,236,437,21,28,Randy
317,Randy,225,225,450,25,25,Tie
318,Randy,228,228,456,22,22,Tie
319,Randy,202,237,439,20,27,Randy
320,Randy,205,230,435,25,30,Randy
321,Randy,232,222,454,26,24,Player A
322,Randy,237,222,459,25,22,Player A
323,Randy,254,209,463,32,23,Player A
324,Randy,251,216,467,27,20,Player A
325,Randy,244,224,468,22,18,Player A
326,Randy,215,230,445,23,26,Randy
327,Randy,226,221,447,28,27,Player A
328,Randy,234,224,458,24,22,Player A
329,Randy,246,216,462,28,22,Player A
330,Randy,216,231,447,22,25,Randy
331,Randy,229,229,458,21,21,Tie
332,Randy,204,229,433,26,31,Randy
333,Randy,250,215,465,28,21,Player A
334,Randy,236,221,457,26,23,Player A
335,Randy,204,239,443,18,25,Randy
336,Randy,233,223,456,25,23,Player A
337,Randy,237,222,459,25,22,Player A
338,Randy,230,225,455,24,23,Player A
