Game,Opponent,PlayerA_Score,PlayerB_Score,Cumulative_Score,CCs,DDs,Winner
0,QLearningPlayer,241,216,457,26,23,Player A
1,QLearningPlayer,240,225,465,25,20,Player A
2,QLearningPlayer,221,236,457,29,24,QLearningPlayer
3,QLearningPlayer,208,228,436,23,29,QLearningPlayer
4,QLearningPlayer,236,216,452,21,23,Player A
5,QLearningPlayer,215,240,455,33,26,QLearningPlayer
6,QLearningPlayer,190,265,455,24,23,QLearningPlayer
7,QLearningPlayer,229,229,458,24,22,Tie
8,QLearningPlayer,242,207,449,27,26,Player A
9,QLearningPlayer,227,217,444,22,26,Player A
10,QLearningPlayer,223,218,441,25,28,Player A
11,QLearningPlayer,221,216,437,30,31,Player A
12,QLearningPlayer,245,185,430,20,30,Player A
13,QLearningPlayer,259,184,443,18,25,Player A
14,QLearningPlayer,219,224,443,21,26,QLearningPlayer
15,QLearningPlayer,216,211,427,17,30,Player A
16,QLearningPlayer,178,248,426,25,33,QLearningPlayer
17,QLearningPlayer,208,228,436,20,28,QLearningPlayer
18,QLearningPlayer,234,189,423,22,33,Player A
19,QLearningPlayer,229,234,463,26,21,QLearningPlayer
20,QLearningPlayer,214,234,448,20,24,QLearningPlayer
21,QLearningPlayer,212,237,449,30,27,QLearningPlayer
22,QLearningPlayer,238,213,451,26,25,Player A
23,QLearningPlayer,242,212,454,26,24,Player A
24,QLearningPlayer,235,220,455,27,24,Player A
25,QLearningPlayer,226,226,452,21,23,Tie
26,QLearningPlayer,267,202,469,23,18,Player A
27,QLearningPlayer,228,243,471,28,19,QLearningPlayer
28,QLearningPlayer,238,218,456,25,23,Player A
29,QLearningPlayer,240,215,455,27,24,Player A
30,QLearningPlayer,260,215,475,32,19,Player A
31,QLearningPlayer,232,247,479,36,19,QLearningPlayer
32,QLearningPlayer,237,237,474,28,18,Tie
33,QLearningPlayer,238,238,476,33,19,Tie
34,QLearningPlayer,205,250,455,33,26,QLearningPlayer
35,QLearningPlayer,236,206,442,29,29,Player A
36,QLearningPlayer,205,250,455,24,23,QLearningPlayer
37,QLearningPlayer,181,251,432,22,30,QLearningPlayer
38,QLearningPlayer,261,191,452,30,26,Player A
39,QLearningPlayer,226,231,457,26,23,QLearningPlayer
40,QLearningPlayer,208,228,436,23,29,QLearningPlayer
41,QLearningPlayer,230,245,475,29,18,QLearningPlayer
42,QLearningPlayer,216,226,442,23,27,QLearningPlayer
43,QLearningPlayer,206,231,437,18,27,QLearningPlayer
44,QLearningPlayer,224,224,448,23,25,Tie
45,QLearningPlayer,217,232,449,21,24,QLearningPlayer
46,QLearningPlayer,235,215,450,25,25,Player A
47,QLearningPlayer,202,247,449,21,24,QLearningPlayer
48,QLearningPlayer,234,229,463,29,22,Player A
49,QLearningPlayer,266,216,482,30,16,Player A
50,QLearningPlayer,248,218,466,26,20,Player A
51,QLearningPlayer,270,225,495,34,13,Player A
52,QLearningPlayer,183,253,436,20,28,QLearningPlayer
53,QLearningPlayer,211,216,427,17,30,QLearningPlayer
54,QLearningPlayer,240,200,440,24,28,Player A
55,QLearningPlayer,222,207,429,22,31,Player A
56,QLearningPlayer,216,241,457,26,23,QLearningPlayer
57,QLearningPlayer,250,190,440,30,30,Player A
58,QLearningPlayer,221,246,467,24,19,QLearningPlayer
59,QLearningPlayer,202,242,444,22,26,QLearningPlayer
60,QLearningPlayer,237,212,449,27,26,Player A
61,QLearningPlayer,228,233,461,27,22,QLearningPlayer
62,QLearningPlayer,233,193,426,22,32,Player A
63,QLearningPlayer,256,201,457,26,23,Player A
64,QLearningPlayer,227,212,439,26,29,Player A
65,QLearningPlayer,203,223,426,25,33,QLearningPlayer
66,QLearningPlayer,243,198,441,22,27,Player A
67,QLearningPlayer,249,219,468,31,21,Player A
68,QLearningPlayer,242,207,449,27,26,Player A
69,QLearningPlayer,225,230,455,30,25,QLearningPlayer
70,QLearningPlayer,231,236,467,30,21,QLearningPlayer
71,QLearningPlayer,253,208,461,24,21,Player A
72,QLearningPlayer,181,256,437,21,28,QLearningPlayer
73,QLearningPlayer,171,271,442,23,27,QLearningPlayer
74,QLearningPlayer,188,258,446,21,25,QLearningPlayer
75,QLearningPlayer,209,249,458,24,22,QLearningPlayer
76,QLearningPlayer,243,223,466,23,19,Player A
77,QLearningPlayer,239,219,458,21,21,Player A
78,QLearningPlayer,238,218,456,31,25,Player A
79,QLearningPlayer,233,213,446,21,25,Player A
80,QLearningPlayer,238,228,466,26,20,Player A
81,QLearningPlayer,222,237,459,28,23,QLearningPlayer
82,QLearningPlayer,222,232,454,20,22,QLearningPlayer
83,QLearningPlayer,196,261,457,20,21,QLearningPlayer
84,QLearningPlayer,288,188,476,24,16,Player A
85,QLearningPlayer,243,188,431,24,31,Player A
86,QLearningPlayer,227,212,439,20,27,Player A
87,QLearningPlayer,221,251,472,20,16,QLearningPlayer
88,QLearningPlayer,212,252,464,27,21,QLearningPlayer
89,QLearningPlayer,232,237,469,26,19,QLearningPlayer
90,QLearningPlayer,219,204,423,22,33,Player A
91,QLearningPlayer,197,252,449,33,28,QLearningPlayer
92,QLearningPlayer,265,215,480,25,15,Player A
93,QLearningPlayer,208,243,451,26,25,QLearningPlayer
94,QLearningPlayer,249,194,443,21,26,Player A
95,QLearningPlayer,210,235,445,26,27,QLearningPlayer
96,QLearningPlayer,211,241,452,24,24,QLearningPlayer
97,QLearningPlayer,206,251,457,26,23,QLearningPlayer
98,QLearningPlayer,260,205,465,31,22,Player A
99,QLearningPlayer,214,234,448,23,25,QLearningPlayer
100,QLearningPlayer,236,196,432,19,29,Player A
101,QLearningPlayer,204,224,428,30,34,QLearningPlayer
102,QLearningPlayer,193,253,446,27,27,QLearningPlayer
103,QLearningPlayer,256,196,452,24,24,Player A
104,QLearningPlayer,183,243,426,25,33,QLearningPlayer
105,QLearningPlayer,187,242,429,22,31,QLearningPlayer
106,QLearningPlayer,250,190,440,27,29,Player A
107,QLearningPlayer,195,245,440,21,27,QLearningPlayer
108,QLearningPlayer,194,239,433,20,29,QLearningPlayer
109,QLearningPlayer,231,196,427,26,33,Player A
110,QLearningPlayer,211,221,432,22,30,QLearningPlayer
111,QLearningPlayer,222,217,439,20,27,Player A
112,QLearningPlayer,186,236,422,21,33,QLearningPlayer
113,QLearningPlayer,218,228,446,18,24,QLearningPlayer
114,QLearningPlayer,211,236,447,28,27,QLearningPlayer
115,QLearningPlayer,233,193,426,22,32,Player A
116,QLearningPlayer,210,225,435,22,29,QLearningPlayer
117,QLearningPlayer,218,263,481,29,16,QLearningPlayer
118,QLearningPlayer,205,250,455,33,26,QLearningPlayer
119,QLearningPlayer,234,204,438,22,28,Player A
120,QLearningPlayer,209,229,438,22,28,QLearningPlayer
121,QLearningPlayer,232,222,454,32,26,Player A
122,QLearningPlayer,240,240,480,31,17,Tie
123,QLearningPlayer,233,203,436,26,30,Player A
124,QLearningPlayer,248,213,461,30,23,Player A
125,QLearningPlayer,206,231,437,21,28,QLearningPlayer
126,QLearningPlayer,201,236,437,18,27,QLearningPlayer
127,QLearningPlayer,230,205,435,13,26,Player A
128,QLearningPlayer,219,214,433,29,32,Player A
129,QLearningPlayer,210,245,455,27,24,QLearningPlayer
130,QLearningPlayer,181,251,432,22,30,QLearningPlayer
131,QLearningPlayer,211,256,467,27,20,QLearningPlayer
132,QLearningPlayer,260,205,465,19,18,Player A
133,QLearningPlayer,230,220,450,31,27,Player A
134,QLearningPlayer,223,218,441,22,27,Player A
135,QLearningPlayer,236,206,442,29,29,Player A
136,QLearningPlayer,239,234,473,36,21,Player A
137,QLearningPlayer,228,228,456,28,24,Tie
138,QLearningPlayer,185,225,410,24,38,QLearningPlayer
139,QLearningPlayer,258,203,461,30,23,Player A
140,QLearningPlayer,210,250,460,29,23,QLearningPlayer
141,QLearningPlayer,207,237,444,25,27,QLearningPlayer
142,QLearningPlayer,231,221,452,30,26,Player A
143,QLearningPlayer,209,239,448,32,28,QLearningPlayer
144,QLearningPlayer,236,226,462,22,20,Player A
145,QLearningPlayer,244,199,443,21,26,Player A
146,QLearningPlayer,203,228,431,21,30,QLearningPlayer
147,QLearningPlayer,244,209,453,25,24,Player A
148,QLearningPlayer,207,227,434,24,30,QLearningPlayer
149,QLearningPlayer,236,206,442,26,28,Player A
150,QLearningPlayer,223,223,446,21,25,Tie
151,QLearningPlayer,216,231,447,25,26,QLearningPlayer
152,QLearningPlayer,213,248,461,27,22,QLearningPlayer
153,QLearningPlayer,217,232,449,24,25,QLearningPlayer
154,QLearningPlayer,219,229,448,23,25,QLearningPlayer
155,QLearningPlayer,222,237,459,31,24,QLearningPlayer
156,QLearningPlayer,213,228,441,25,28,QLearningPlayer
157,QLearningPlayer,216,231,447,28,27,QLearningPlayer
158,QLearningPlayer,191,241,432,19,29,QLearningPlayer
159,QLearningPlayer,220,230,450,31,27,QLearningPlayer
160,QLearningPlayer,206,221,427,20,31,QLearningPlayer
161,QLearningPlayer,251,181,432,22,30,Player A
162,QLearningPlayer,220,245,465,22,19,QLearningPlayer
163,QLearningPlayer,253,213,466,29,21,Player A
164,QLearningPlayer,200,245,445,26,27,QLearningPlayer
165,QLearningPlayer,222,222,444,22,26,Tie
166,QLearningPlayer,222,252,474,31,19,QLearningPlayer
167,QLearningPlayer,250,200,450,31,27,Player A
168,QLearningPlayer,188,278,466,35,23,QLearningPlayer
169,QLearningPlayer,186,271,457,26,23,QLearningPlayer
170,QLearningPlayer,227,227,454,23,23,Tie
171,QLearningPlayer,241,186,427,14,29,Player A
172,QLearningPlayer,223,218,441,22,27,Player A
173,QLearningPlayer,206,231,437,21,28,QLearningPlayer
174,QLearningPlayer,210,215,425,27,34,QLearningPlayer
175,QLearningPlayer,233,233,466,23,19,Tie
176,QLearningPlayer,243,193,436,20,28,Player A
177,QLearningPlayer,188,248,436,26,30,QLearningPlayer
178,QLearningPlayer,205,215,420,13,31,QLearningPlayer
179,QLearningPlayer,243,208,451,23,24,Player A
180,QLearningPlayer,240,205,445,26,27,Player A
181,QLearningPlayer,234,234,468,28,20,Tie
182,QLearningPlayer,212,232,444,31,29,QLearningPlayer
183,QLearningPlayer,249,204,453,34,27,Player A
184,QLearningPlayer,247,222,469,23,18,Player A
185,QLearningPlayer,240,200,440,24,28,Player A
186,QLearningPlayer,229,219,448,20,24,Player A
187,QLearningPlayer,224,224,448,23,25,Tie
188,QLearningPlayer,231,196,427,14,29,Player A
189,QLearningPlayer,203,273,476,30,18,QLearningPlayer
190,QLearningPlayer,225,230,455,21,22,QLearningPlayer
191,QLearningPlayer,221,201,422,18,32,Player A
192,QLearningPlayer,220,240,460,26,22,QLearningPlayer
193,QLearningPlayer,220,230,450,22,24,QLearningPlayer
194,QLearningPlayer,206,226,432,19,29,QLearningPlayer
195,QLearningPlayer,218,248,466,26,20,QLearningPlayer
196,QLearningPlayer,238,208,446,27,27,Player A
197,QLearningPlayer,228,213,441,28,29,Player A
198,QLearningPlayer,232,212,444,19,25,Player A
199,QLearningPlayer,245,225,470,33,21,Player A
200,QLearningPlayer,210,200,410,21,37,Player A
201,QLearningPlayer,228,218,446,24,26,Player A
202,QLearningPlayer,211,251,462,25,21,QLearningPlayer
203,QLearningPlayer,204,239,443,27,28,QLearningPlayer
204,QLearningPlayer,253,213,466,26,20,Player A
205,QLearningPlayer,223,238,461,27,22,QLearningPlayer
206,QLearningPlayer,230,230,460,26,22,Tie
207,QLearningPlayer,253,178,431,21,30,Player A
208,QLearningPlayer,195,235,430,26,32,QLearningPlayer
209,QLearningPlayer,237,227,464,30,22,Player A
210,QLearningPlayer,199,224,423,22,33,QLearningPlayer
211,QLearningPlayer,240,215,455,24,23,Player A
212,QLearningPlayer,242,217,459,28,23,Player A
213,QLearningPlayer,199,254,453,22,23,QLearningPlayer
214,QLearningPlayer,218,213,431,21,30,Player A
215,QLearningPlayer,254,209,463,26,21,Player A
216,QLearningPlayer,232,232,464,27,21,Tie
217,QLearningPlayer,226,231,457,26,23,QLearningPlayer
218,QLearningPlayer,238,203,441,25,28,Player A
219,QLearningPlayer,241,226,467,24,19,Player A
220,QLearningPlayer,209,219,428,18,30,QLearningPlayer
221,QLearningPlayer,177,267,444,22,26,QLearningPlayer
222,QLearningPlayer,228,238,466,32,22,QLearningPlayer
223,QLearningPlayer,214,239,453,28,25,QLearningPlayer
224,QLearningPlayer,244,244,488,33,15,Tie
225,QLearningPlayer,248,208,456,25,23,Player A
226,QLearningPlayer,250,190,440,24,28,Player A
227,QLearningPlayer,229,244,473,30,19,QLearningPlayer
228,QLearningPlayer,244,219,463,26,21,Player A
229,QLearningPlayer,218,218,436,23,29,Tie
230,QLearningPlayer,221,236,457,23,22,QLearningPlayer
231,QLearningPlayer,219,249,468,25,19,QLearningPlayer
232,QLearningPlayer,225,205,430,23,31,Player A
233,QLearningPlayer,204,249,453,22,23,QLearningPlayer
234,QLearningPlayer,185,275,460,26,22,QLearningPlayer
235,QLearningPlayer,239,189,428,21,31,Player A
236,QLearningPlayer,245,225,470,27,19,Player A
237,QLearningPlayer,232,222,454,23,23,Player A
238,QLearningPlayer,241,221,462,25,21,Player A
239,QLearningPlayer,253,198,451,23,24,Player A
240,QLearningPlayer,213,233,446,24,26,QLearningPlayer
241,QLearningPlayer,209,224,433,23,30,QLearningPlayer
242,QLearningPlayer,212,237,449,21,24,QLearningPlayer
243,QLearningPlayer,226,201,427,17,30,Player A
244,QLearningPlayer,212,262,474,25,17,QLearningPlayer
245,QLearningPlayer,201,236,437,21,28,QLearningPlayer
246,QLearningPlayer,208,238,446,21,25,QLearningPlayer
247,QLearningPlayer,233,248,481,29,16,QLearningPlayer
248,QLearningPlayer,218,228,446,27,27,QLearningPlayer
249,QLearningPlayer,245,200,445,23,26,Player A
250,QLearningPlayer,215,260,475,35,20,QLearningPlayer
251,QLearningPlayer,191,246,437,24,29,QLearningPlayer
252,QLearningPlayer,223,218,441,19,26,Player A
253,QLearningPlayer,201,231,432,25,31,QLearningPlayer
254,QLearningPlayer,188,243,431,18,29,QLearningPlayer
0,PatternLearningPlayer,317,192,509,39,10,Player A
1,PatternLearningPlayer,241,211,452,27,25,Player A
2,PatternLearningPlayer,268,213,481,32,17,Player A
3,PatternLearningPlayer,251,221,472,29,19,Player A
4,PatternLearningPlayer,316,206,522,46,8,Player A
5,PatternLearningPlayer,324,194,518,39,7,Player A
6,PatternLearningPlayer,287,197,484,41,19,Player A
7,PatternLearningPlayer,281,226,507,40,11,Player A
8,PatternLearningPlayer,276,201,477,37,20,Player A
9,PatternLearningPlayer,253,213,466,26,20,Player A
10,PatternLearningPlayer,215,215,430,20,30,Tie
11,PatternLearningPlayer,275,210,485,30,15,Player A
12,PatternLearningPlayer,290,190,480,43,21,Player A
13,PatternLearningPlayer,248,218,466,26,20,Player A
14,PatternLearningPlayer,284,214,498,31,11,Player A
15,PatternLearningPlayer,304,209,513,40,9,Player A
16,PatternLearningPlayer,338,198,536,48,4,Player A
17,PatternLearningPlayer,339,199,538,50,4,Player A
18,PatternLearningPlayer,190,220,410,18,36,PatternLearningPlayer
19,PatternLearningPlayer,312,192,504,40,12,Player A
20,PatternLearningPlayer,313,198,511,35,8,Player A
21,PatternLearningPlayer,270,205,475,23,16,Player A
22,PatternLearningPlayer,260,210,470,27,19,Player A
23,PatternLearningPlayer,320,185,505,41,12,Player A
24,PatternLearningPlayer,236,196,432,19,29,Player A
25,PatternLearningPlayer,291,201,492,40,16,Player A
26,PatternLearningPlayer,261,221,482,33,17,Player A
27,PatternLearningPlayer,233,213,446,24,26,Player A
28,PatternLearningPlayer,285,180,465,31,22,Player A
29,PatternLearningPlayer,250,205,455,33,26,Player A
30,PatternLearningPlayer,225,215,440,15,25,Player A
31,PatternLearningPlayer,237,227,464,27,21,Player A
32,PatternLearningPlayer,272,192,464,27,21,Player A
33,PatternLearningPlayer,319,209,528,43,5,Player A
34,PatternLearningPlayer,263,193,456,34,26,Player A
35,PatternLearningPlayer,273,208,481,35,18,Player A
36,PatternLearningPlayer,201,221,422,18,32,PatternLearningPlayer
37,PatternLearningPlayer,215,220,435,25,30,PatternLearningPlayer
38,PatternLearningPlayer,278,198,476,30,18,Player A
39,PatternLearningPlayer,271,196,467,30,21,Player A
40,PatternLearningPlayer,201,221,422,18,32,PatternLearningPlayer
41,PatternLearningPlayer,282,202,484,35,17,Player A
42,PatternLearningPlayer,236,216,452,27,25,Player A
43,PatternLearningPlayer,214,209,423,19,32,Player A
44,PatternLearningPlayer,234,209,443,21,26,Player A
45,PatternLearningPlayer,134,229,363,7,48,PatternLearningPlayer
46,PatternLearningPlayer,291,221,512,42,10,Player A
47,PatternLearningPlayer,287,202,489,34,15,Player A
48,PatternLearningPlayer,282,207,489,31,14,Player A
49,PatternLearningPlayer,269,199,468,25,19,Player A
50,PatternLearningPlayer,240,205,445,26,27,Player A
51,PatternLearningPlayer,228,238,466,26,20,PatternLearningPlayer
52,PatternLearningPlayer,205,220,425,18,31,PatternLearningPlayer
53,PatternLearningPlayer,308,198,506,39,11,Player A
54,PatternLearningPlayer,218,218,436,26,30,Tie
55,PatternLearningPlayer,240,205,445,26,27,Player A
56,PatternLearningPlayer,212,237,449,27,26,PatternLearningPlayer
57,PatternLearningPlayer,276,221,497,33,12,Player A
58,PatternLearningPlayer,238,203,441,28,29,Player A
59,PatternLearningPlayer,255,210,465,25,20,Player A
60,PatternLearningPlayer,293,188,481,38,19,Player A
61,PatternLearningPlayer,269,214,483,31,16,Player A
62,PatternLearningPlayer,264,219,483,31,16,Player A
63,PatternLearningPlayer,249,219,468,22,18,Player A
64,PatternLearningPlayer,294,189,483,40,19,Player A
65,PatternLearningPlayer,231,216,447,22,25,Player A
66,PatternLearningPlayer,256,211,467,24,19,Player A
67,PatternLearningPlayer,233,218,451,23,24,Player A
68,PatternLearningPlayer,250,205,455,24,23,Player A
69,PatternLearningPlayer,213,233,446,21,25,PatternLearningPlayer
70,PatternLearningPlayer,277,202,479,33,18,Player A
71,PatternLearningPlayer,288,213,501,37,12,Player A
72,PatternLearningPlayer,181,216,397,17,40,PatternLearningPlayer
73,PatternLearningPlayer,310,205,515,42,9,Player A
74,PatternLearningPlayer,252,202,454,26,24,Player A
75,PatternLearningPlayer,287,197,484,32,16,Player A
76,PatternLearningPlayer,341,171,512,42,10,Player A
77,PatternLearningPlayer,308,213,521,51,10,Player A
78,PatternLearningPlayer,274,214,488,33,15,Player A
79,PatternLearningPlayer,223,213,436,20,28,Player A
80,PatternLearningPlayer,309,194,503,36,11,Player A
81,PatternLearningPlayer,264,224,488,33,15,Player A
82,PatternLearningPlayer,268,203,471,34,21,Player A
83,PatternLearningPlayer,232,212,444,19,25,Player A
84,PatternLearningPlayer,317,192,509,39,10,Player A
85,PatternLearningPlayer,218,233,451,23,24,PatternLearningPlayer
86,PatternLearningPlayer,301,196,497,39,14,Player A
87,PatternLearningPlayer,287,222,509,36,9,Player A
88,PatternLearningPlayer,275,200,475,29,18,Player A
89,PatternLearningPlayer,257,212,469,26,19,Player A
90,PatternLearningPlayer,249,219,468,34,22,Player A
91,PatternLearningPlayer,252,212,464,27,21,Player A
92,PatternLearningPlayer,297,197,494,33,13,Player A
93,PatternLearningPlayer,309,219,528,52,8,Player A
94,PatternLearningPlayer,320,175,495,46,17,Player A
95,PatternLearningPlayer,282,212,494,30,12,Player A
96,PatternLearningPlayer,263,208,471,34,21,Player A
97,PatternLearningPlayer,260,220,480,31,17,Player A
98,PatternLearningPlayer,229,209,438,25,29,Player A
99,PatternLearningPlayer,263,198,461,24,21,Player A
100,PatternLearningPlayer,248,213,461,30,23,Player A
101,PatternLearningPlayer,325,210,535,53,6,Player A
102,PatternLearningPlayer,252,207,459,25,22,Player A
103,PatternLearningPlayer,302,217,519,43,8,Player A
104,PatternLearningPlayer,193,248,441,28,29,PatternLearningPlayer
105,PatternLearningPlayer,250,220,470,30,20,Player A
106,PatternLearningPlayer,200,225,425,15,30,PatternLearningPlayer
107,PatternLearningPlayer,321,211,532,56,8,Player A
108,PatternLearningPlayer,254,214,468,31,21,Player A
109,PatternLearningPlayer,266,191,457,26,23,Player A
110,PatternLearningPlayer,329,209,538,50,4,Player A
111,PatternLearningPlayer,303,193,496,32,12,Player A
112,PatternLearningPlayer,287,187,474,34,20,Player A
113,PatternLearningPlayer,261,201,462,34,24,Player A
114,PatternLearningPlayer,236,231,467,24,19,Player A
115,PatternLearningPlayer,209,214,423,19,32,PatternLearningPlayer
116,PatternLearningPlayer,326,206,532,47,5,Player A
117,PatternLearningPlayer,258,188,446,24,26,Player A
118,PatternLearningPlayer,237,222,459,31,24,Player A
119,PatternLearningPlayer,246,236,482,33,17,Player A
120,PatternLearningPlayer,278,203,481,38,19,Player A
121,PatternLearningPlayer,277,217,494,36,14,Player A
122,PatternLearningPlayer,309,219,528,52,8,Player A
123,PatternLearningPlayer,258,203,461,27,22,Player A
124,PatternLearningPlayer,235,225,460,20,20,Player A
125,PatternLearningPlayer,309,199,508,38,10,Player A
126,PatternLearningPlayer,204,234,438,19,27,PatternLearningPlayer
127,PatternLearningPlayer,252,242,494,39,15,Player A
128,PatternLearningPlayer,253,208,461,30,23,Player A
129,PatternLearningPlayer,335,205,540,49,3,Player A
130,PatternLearningPlayer,322,182,504,43,13,Player A
131,PatternLearningPlayer,254,204,458,30,24,Player A
132,PatternLearningPlayer,242,192,434,27,31,Player A
133,PatternLearningPlayer,202,202,404,15,37,Tie
134,PatternLearningPlayer,245,195,440,18,26,Player A
135,PatternLearningPlayer,298,203,501,37,12,Player A
136,PatternLearningPlayer,228,218,446,27,27,Player A
137,PatternLearningPlayer,222,232,454,20,22,PatternLearningPlayer
138,PatternLearningPlayer,252,217,469,32,21,Player A
139,PatternLearningPlayer,301,206,507,40,11,Player A
140,PatternLearningPlayer,253,203,456,22,22,Player A
141,PatternLearningPlayer,222,217,439,20,27,Player A
142,PatternLearningPlayer,238,228,466,26,20,Player A
143,PatternLearningPlayer,202,217,419,15,32,PatternLearningPlayer
144,PatternLearningPlayer,289,189,478,35,19,Player A
145,PatternLearningPlayer,249,224,473,24,17,Player A
146,PatternLearningPlayer,238,223,461,27,22,Player A
147,PatternLearningPlayer,247,227,474,34,20,Player A
148,PatternLearningPlayer,310,200,510,40,10,Player A
149,PatternLearningPlayer,277,202,479,33,18,Player A
150,PatternLearningPlayer,310,205,515,33,6,Player A
151,PatternLearningPlayer,308,203,511,44,11,Player A
152,PatternLearningPlayer,276,186,462,34,24,Player A
153,PatternLearningPlayer,243,203,446,24,26,Player A
154,PatternLearningPlayer,295,205,500,39,13,Player A
155,PatternLearningPlayer,302,192,494,33,13,Player A
156,PatternLearningPlayer,290,210,500,36,12,Player A
157,PatternLearningPlayer,335,205,540,52,4,Player A
158,PatternLearningPlayer,270,210,480,31,17,Player A
159,PatternLearningPlayer,240,220,460,23,21,Player A
160,PatternLearningPlayer,203,193,396,16,40,Player A
161,PatternLearningPlayer,299,189,488,30,14,Player A
162,PatternLearningPlayer,235,215,450,28,26,Player A
163,PatternLearningPlayer,263,203,466,29,21,Player A
164,PatternLearningPlayer,192,217,409,17,36,PatternLearningPlayer
165,PatternLearningPlayer,259,204,463,23,20,Player A
166,PatternLearningPlayer,292,207,499,35,12,Player A
167,PatternLearningPlayer,282,207,489,37,16,Player A
168,PatternLearningPlayer,298,198,496,38,14,Player A
169,PatternLearningPlayer,251,221,472,29,19,Player A
170,PatternLearningPlayer,273,208,481,38,19,Player A
171,PatternLearningPlayer,225,220,445,17,24,Player A
172,PatternLearningPlayer,251,211,462,25,21,Player A
173,PatternLearningPlayer,276,196,472,29,19,Player A
174,PatternLearningPlayer,332,207,539,51,4,Player A
175,PatternLearningPlayer,284,209,493,32,13,Player A
176,PatternLearningPlayer,271,206,477,28,17,Player A
177,PatternLearningPlayer,299,204,503,42,13,Player A
178,PatternLearningPlayer,277,207,484,26,14,Player A
179,PatternLearningPlayer,230,205,435,19,28,Player A
180,PatternLearningPlayer,273,193,466,38,24,Player A
181,PatternLearningPlayer,241,206,447,22,25,Player A
182,PatternLearningPlayer,215,215,430,20,30,Tie
183,PatternLearningPlayer,230,220,450,19,23,Player A
184,PatternLearningPlayer,209,214,423,19,32,PatternLearningPlayer
185,PatternLearningPlayer,192,227,419,18,33,PatternLearningPlayer
186,PatternLearningPlayer,302,192,494,33,13,Player A
187,PatternLearningPlayer,277,207,484,35,17,Player A
188,PatternLearningPlayer,278,203,481,29,16,Player A
189,PatternLearningPlayer,215,235,450,22,24,PatternLearningPlayer
190,PatternLearningPlayer,271,201,472,35,21,Player A
191,PatternLearningPlayer,287,212,499,38,13,Player A
192,PatternLearningPlayer,281,201,482,33,17,Player A
193,PatternLearningPlayer,332,182,514,44,10,Player A
194,PatternLearningPlayer,241,191,432,19,29,Player A
195,PatternLearningPlayer,246,206,452,21,23,Player A
196,PatternLearningPlayer,217,212,429,25,32,Player A
197,PatternLearningPlayer,265,190,455,18,21,Player A
198,PatternLearningPlayer,246,226,472,32,20,Player A
199,PatternLearningPlayer,245,200,445,23,26,Player A
200,PatternLearningPlayer,197,217,414,16,34,PatternLearningPlayer
201,PatternLearningPlayer,290,210,500,42,14,Player A
202,PatternLearningPlayer,282,207,489,28,13,Player A
203,PatternLearningPlayer,296,206,502,32,10,Player A
204,PatternLearningPlayer,243,223,466,23,19,Player A
205,PatternLearningPlayer,286,211,497,36,13,Player A
206,PatternLearningPlayer,243,218,461,27,22,Player A
207,PatternLearningPlayer,181,211,392,12,40,PatternLearningPlayer
208,PatternLearningPlayer,319,209,528,46,6,Player A
209,PatternLearningPlayer,243,213,456,34,26,Player A
210,PatternLearningPlayer,302,172,474,28,18,Player A
211,PatternLearningPlayer,227,207,434,21,29,Player A
212,PatternLearningPlayer,204,214,418,11,31,PatternLearningPlayer
213,PatternLearningPlayer,268,183,451,26,25,Player A
214,PatternLearningPlayer,225,230,455,24,23,PatternLearningPlayer
215,PatternLearningPlayer,336,191,527,45,6,Player A
216,PatternLearningPlayer,259,214,473,27,18,Player A
217,PatternLearningPlayer,292,212,504,40,12,Player A
218,PatternLearningPlayer,296,201,497,30,11,Player A
219,PatternLearningPlayer,188,223,411,13,34,PatternLearningPlayer
220,PatternLearningPlayer,234,224,458,30,24,Player A
221,PatternLearningPlayer,278,213,491,36,15,Player A
222,PatternLearningPlayer,198,193,391,17,42,Player A
223,PatternLearningPlayer,259,214,473,33,20,Player A
224,PatternLearningPlayer,312,197,509,42,11,Player A
225,PatternLearningPlayer,316,196,512,39,9,Player A
226,PatternLearningPlayer,250,200,450,22,24,Player A
227,PatternLearningPlayer,217,217,434,21,29,Tie
228,PatternLearningPlayer,290,210,500,39,13,Player A
229,PatternLearningPlayer,238,208,446,18,24,Player A
230,PatternLearningPlayer,309,199,508,41,11,Player A
231,PatternLearningPlayer,291,216,507,46,13,Player A
232,PatternLearningPlayer,272,192,464,30,22,Player A
233,PatternLearningPlayer,294,194,488,36,16,Player A
234,PatternLearningPlayer,297,197,494,33,13,Player A
235,PatternLearningPlayer,276,216,492,37,15,Player A
236,PatternLearningPlayer,212,207,419,21,34,Player A
237,PatternLearningPlayer,232,212,444,19,25,Player A
238,PatternLearningPlayer,288,183,471,28,19,Player A
239,PatternLearningPlayer,284,214,498,31,11,Player A
240,PatternLearningPlayer,322,182,504,34,10,Player A
241,PatternLearningPlayer,261,211,472,32,20,Player A
242,PatternLearningPlayer,271,211,482,30,16,Player A
243,PatternLearningPlayer,247,202,449,30,27,Player A
244,PatternLearningPlayer,263,208,471,25,18,Player A
245,PatternLearningPlayer,272,202,474,37,21,Player A
246,PatternLearningPlayer,347,162,509,42,11,Player A
247,PatternLearningPlayer,283,203,486,37,17,Player A
248,PatternLearningPlayer,222,217,439,23,28,Player A
249,PatternLearningPlayer,247,212,459,22,21,Player A
250,PatternLearningPlayer,300,200,500,45,15,Player A
251,PatternLearningPlayer,291,211,502,41,13,Player A
252,PatternLearningPlayer,241,211,452,24,24,Player A
253,PatternLearningPlayer,262,212,474,28,18,Player A
254,PatternLearningPlayer,256,231,487,38,17,Player A
255,PatternLearningPlayer,292,192,484,35,17,Player A
256,PatternLearningPlayer,221,216,437,21,28,Player A
257,PatternLearningPlayer,229,199,428,18,30,Player A
258,PatternLearningPlayer,258,223,481,29,16,Player A
259,PatternLearningPlayer,264,224,488,39,17,Player A
260,PatternLearningPlayer,256,221,477,31,18,Player A
261,PatternLearningPlayer,269,214,483,34,17,Player A
262,PatternLearningPlayer,243,213,456,25,23,Player A
263,PatternLearningPlayer,280,195,475,29,18,Player A
264,PatternLearningPlayer,333,198,531,52,7,Player A
265,PatternLearningPlayer,258,208,466,26,20,Player A
266,PatternLearningPlayer,230,215,445,23,26,Player A
267,PatternLearningPlayer,232,222,454,23,23,Player A
268,PatternLearningPlayer,230,225,455,24,23,Player A
269,PatternLearningPlayer,303,203,506,39,11,Player A
270,PatternLearningPlayer,226,201,427,26,33,Player A
271,PatternLearningPlayer,290,225,515,45,10,Player A
272,PatternLearningPlayer,328,203,531,46,5,Player A
273,PatternLearningPlayer,241,201,442,23,27,Player A
274,PatternLearningPlayer,312,202,514,47,11,Player A
275,PatternLearningPlayer,254,204,458,24,22,Player A
276,PatternLearningPlayer,284,224,508,38,10,Player A
277,PatternLearningPlayer,263,208,471,34,21,Player A
278,PatternLearningPlayer,205,250,455,24,23,PatternLearningPlayer
279,PatternLearningPlayer,234,229,463,26,21,Player A
280,PatternLearningPlayer,288,198,486,28,14,Player A
281,PatternLearningPlayer,248,198,446,27,27,Player A
282,PatternLearningPlayer,284,204,488,42,18,Player A
283,PatternLearningPlayer,282,202,484,35,17,Player A
284,PatternLearningPlayer,187,212,399,19,40,PatternLearningPlayer
285,PatternLearningPlayer,220,205,425,24,33,Player A
286,PatternLearningPlayer,248,228,476,33,19,Player A
287,PatternLearningPlayer,297,207,504,40,12,Player A
288,PatternLearningPlayer,285,210,495,28,11,Player A
289,PatternLearningPlayer,291,201,492,37,15,Player A
290,PatternLearningPlayer,279,219,498,40,14,Player A
291,PatternLearningPlayer,272,227,499,38,13,Player A
292,PatternLearningPlayer,212,222,434,24,30,PatternLearningPlayer
293,PatternLearningPlayer,305,200,505,38,11,Player A
294,PatternLearningPlayer,294,204,498,34,12,Player A
295,PatternLearningPlayer,231,226,457,32,25,Player A
296,PatternLearningPlayer,299,214,513,40,9,Player A
297,PatternLearningPlayer,182,232,414,13,33,PatternLearningPlayer
298,PatternLearningPlayer,241,226,467,24,19,Player A
299,PatternLearningPlayer,244,214,458,21,21,Player A
300,PatternLearningPlayer,290,215,505,35,10,Player A
301,PatternLearningPlayer,240,205,445,23,26,Player A
302,PatternLearningPlayer,164,234,398,12,38,PatternLearningPlayer
303,PatternLearningPlayer,326,201,527,51,8,Player A
304,PatternLearningPlayer,270,235,505,38,11,Player A
305,PatternLearningPlayer,262,217,479,33,18,Player A
306,PatternLearningPlayer,239,214,453,22,23,Player A
307,PatternLearningPlayer,273,203,476,36,20,Player A
308,PatternLearningPlayer,299,209,508,32,8,Player A
309,PatternLearningPlayer,282,202,484,35,17,Player A
310,PatternLearningPlayer,235,235,470,36,22,Tie
311,PatternLearningPlayer,305,200,505,38,11,Player A
312,PatternLearningPlayer,325,205,530,48,6,Player A
313,PatternLearningPlayer,247,202,449,21,24,Player A
314,PatternLearningPlayer,242,207,449,24,25,Player A
315,PatternLearningPlayer,216,201,417,19,34,Player A
316,PatternLearningPlayer,296,201,497,36,13,Player A
317,PatternLearningPlayer,310,200,510,37,9,Player A
318,PatternLearningPlayer,336,196,532,44,4,Player A
319,PatternLearningPlayer,215,215,430,17,29,Tie
320,PatternLearningPlayer,270,195,465,31,22,Player A
321,PatternLearningPlayer,271,216,487,35,16,Player A
322,PatternLearningPlayer,266,216,482,39,19,Player A
323,PatternLearningPlayer,248,198,446,24,26,Player A
324,PatternLearningPlayer,170,215,385,11,42,PatternLearningPlayer
325,PatternLearningPlayer,273,203,476,30,18,Player A
326,PatternLearningPlayer,314,189,503,36,11,Player A
327,PatternLearningPlayer,273,203,476,36,20,Player A
328,PatternLearningPlayer,260,210,470,24,18,Player A
329,PatternLearningPlayer,308,183,491,39,16,Player A
330,PatternLearningPlayer,219,219,438,28,30,Tie
331,PatternLearningPlayer,269,194,463,29,22,Player A
332,PatternLearningPlayer,309,209,518,42,8,Player A
333,PatternLearningPlayer,306,196,502,35,11,Player A
334,PatternLearningPlayer,189,219,408,22,38,PatternLearningPlayer
335,PatternLearningPlayer,233,213,446,21,25,Player A
336,PatternLearningPlayer,280,195,475,29,18,Player A
337,PatternLearningPlayer,307,202,509,42,11,Player A
338,PatternLearningPlayer,289,199,488,39,17,Player A
339,PatternLearningPlayer,228,233,461,21,20,PatternLearningPlayer
340,PatternLearningPlayer,239,229,468,31,21,Player A
341,PatternLearningPlayer,269,209,478,26,16,Player A
342,PatternLearningPlayer,280,200,480,31,17,Player A
343,PatternLearningPlayer,241,201,442,23,27,Player A
344,PatternLearningPlayer,225,205,430,20,30,Player A
345,PatternLearningPlayer,298,213,511,41,10,Player A
346,PatternLearningPlayer,190,210,400,11,37,PatternLearningPlayer
347,PatternLearningPlayer,304,199,503,33,10,Player A
348,PatternLearningPlayer,248,193,441,19,26,Player A
349,PatternLearningPlayer,261,221,482,27,15,Player A
350,PatternLearningPlayer,229,229,458,24,22,Tie
351,PatternLearningPlayer,208,208,416,18,34,Tie
352,PatternLearningPlayer,302,212,514,41,9,Player A
353,PatternLearningPlayer,214,214,428,24,32,Tie
354,PatternLearningPlayer,268,218,486,40,18,Player A
355,PatternLearningPlayer,233,208,441,13,24,Player A
356,PatternLearningPlayer,253,203,456,28,24,Player A
357,PatternLearningPlayer,231,206,437,18,27,Player A
358,PatternLearningPlayer,245,220,465,31,22,Player A
359,PatternLearningPlayer,237,227,464,27,21,Player A
360,PatternLearningPlayer,264,199,463,26,21,Player A
361,PatternLearningPlayer,340,185,525,43,6,Player A
362,PatternLearningPlayer,216,206,422,12,30,Player A
363,PatternLearningPlayer,263,208,471,31,20,Player A
364,PatternLearningPlayer,286,196,482,39,19,Player A
365,PatternLearningPlayer,335,205,540,46,2,Player A
366,PatternLearningPlayer,319,214,533,54,7,Player A
367,PatternLearningPlayer,260,220,480,37,19,Player A
368,PatternLearningPlayer,236,206,442,23,27,Player A
369,PatternLearningPlayer,231,221,452,18,22,Player A
370,PatternLearningPlayer,253,218,471,25,18,Player A
371,PatternLearningPlayer,279,224,503,39,12,Player A
372,PatternLearningPlayer,236,206,442,26,28,Player A
373,PatternLearningPlayer,216,201,417,22,35,Player A
374,PatternLearningPlayer,255,210,465,22,19,Player A
375,PatternLearningPlayer,333,203,536,45,3,Player A
376,PatternLearningPlayer,306,191,497,36,13,Player A
377,PatternLearningPlayer,247,207,454,26,24,Player A
378,PatternLearningPlayer,246,196,442,20,26,Player A
379,PatternLearningPlayer,253,223,476,33,19,Player A
380,PatternLearningPlayer,201,216,417,22,35,PatternLearningPlayer
381,PatternLearningPlayer,289,194,483,37,18,Player A
382,PatternLearningPlayer,221,226,447,22,25,PatternLearningPlayer
383,PatternLearningPlayer,291,196,487,35,16,Player A
384,PatternLearningPlayer,175,230,405,13,36,PatternLearningPlayer
385,PatternLearningPlayer,197,202,399,19,40,PatternLearningPlayer
386,PatternLearningPlayer,229,214,443,30,29,Player A
387,PatternLearningPlayer,256,221,477,22,15,Player A
388,PatternLearningPlayer,256,196,452,24,24,Player A
389,PatternLearningPlayer,218,218,436,20,28,Tie
390,PatternLearningPlayer,270,205,475,29,18,Player A
391,PatternLearningPlayer,242,217,459,22,21,Player A
392,PatternLearningPlayer,258,208,466,26,20,Player A
393,PatternLearningPlayer,258,233,491,33,14,Player A
394,PatternLearningPlayer,235,205,440,24,28,Player A
395,PatternLearningPlayer,257,207,464,27,21,Player A
396,PatternLearningPlayer,284,209,493,35,14,Player A
397,PatternLearningPlayer,287,197,484,38,18,Player A
398,PatternLearningPlayer,206,231,437,21,28,PatternLearningPlayer
399,PatternLearningPlayer,330,205,535,44,3,Player A
400,PatternLearningPlayer,265,235,500,27,9,Player A
401,PatternLearningPlayer,262,212,474,28,18,Player A
402,PatternLearningPlayer,242,227,469,26,19,Player A
403,PatternLearningPlayer,357,187,544,47,1,Player A
404,PatternLearningPlayer,219,204,423,19,32,Player A
405,PatternLearningPlayer,276,221,497,42,15,Player A
406,PatternLearningPlayer,247,222,469,29,20,Player A
407,PatternLearningPlayer,230,210,440,24,28,Player A
408,PatternLearningPlayer,253,223,476,36,20,Player A
409,PatternLearningPlayer,270,195,465,28,21,Player A
410,PatternLearningPlayer,286,196,482,33,17,Player A
411,PatternLearningPlayer,261,206,467,30,21,Player A
412,PatternLearningPlayer,313,193,506,45,13,Player A
413,PatternLearningPlayer,222,217,439,20,27,Player A
414,PatternLearningPlayer,240,195,435,19,28,Player A
415,PatternLearningPlayer,261,211,472,35,21,Player A
416,PatternLearningPlayer,252,202,454,23,23,Player A
417,PatternLearningPlayer,170,240,410,15,35,PatternLearningPlayer
418,PatternLearningPlayer,246,216,462,31,23,Player A
419,PatternLearningPlayer,215,210,425,15,30,Player A
420,PatternLearningPlayer,220,220,440,21,27,Tie
421,PatternLearningPlayer,267,202,469,38,23,Player A
422,PatternLearningPlayer,260,210,470,33,21,Player A
423,PatternLearningPlayer,239,219,458,27,23,Player A
424,PatternLearningPlayer,325,195,520,41,7,Player A
425,PatternLearningPlayer,268,213,481,35,18,Player A
426,PatternLearningPlayer,260,200,460,29,23,Player A
427,PatternLearningPlayer,320,195,515,54,13,Player A
428,PatternLearningPlayer,250,210,460,26,22,Player A
429,PatternLearningPlayer,301,191,492,34,14,Player A
430,PatternLearningPlayer,219,229,448,20,24,PatternLearningPlayer
431,PatternLearningPlayer,254,199,453,28,25,Player A
432,PatternLearningPlayer,265,215,480,34,18,Player A
433,PatternLearningPlayer,305,200,505,35,10,Player A
434,PatternLearningPlayer,253,208,461,24,21,Player A
435,PatternLearningPlayer,249,214,463,35,24,Player A
436,PatternLearningPlayer,324,179,503,39,12,Player A
437,PatternLearningPlayer,291,211,502,32,10,Player A
438,PatternLearningPlayer,208,228,436,20,28,PatternLearningPlayer
439,PatternLearningPlayer,232,217,449,27,26,Player A
440,PatternLearningPlayer,192,212,404,15,37,PatternLearningPlayer
441,PatternLearningPlayer,261,221,482,33,17,Player A
442,PatternLearningPlayer,311,196,507,40,11,Player A
443,PatternLearningPlayer,215,210,425,15,30,Player A
444,PatternLearningPlayer,238,208,446,24,26,Player A
445,PatternLearningPlayer,174,254,428,18,30,PatternLearningPlayer
446,PatternLearningPlayer,261,181,442,23,27,Player A
447,PatternLearningPlayer,206,211,417,19,34,PatternLearningPlayer
448,PatternLearningPlayer,297,197,494,30,12,Player A
449,PatternLearningPlayer,296,206,502,35,11,Player A
450,PatternLearningPlayer,263,203,466,29,21,Player A
451,PatternLearningPlayer,276,206,482,39,19,Player A
452,PatternLearningPlayer,247,217,464,30,22,Player A
453,PatternLearningPlayer,311,211,522,49,9,Player A
454,PatternLearningPlayer,260,220,480,31,17,Player A
455,PatternLearningPlayer,222,222,444,22,26,Tie
456,PatternLearningPlayer,249,209,458,30,24,Player A
457,PatternLearningPlayer,275,205,480,31,17,Player A
458,PatternLearningPlayer,206,221,427,14,29,PatternLearningPlayer
459,PatternLearningPlayer,273,223,496,38,14,Player A
460,PatternLearningPlayer,298,213,511,44,11,Player A
461,PatternLearningPlayer,191,226,417,19,34,PatternLearningPlayer
462,PatternLearningPlayer,216,221,437,15,26,PatternLearningPlayer
463,PatternLearningPlayer,312,197,509,39,10,Player A
464,PatternLearningPlayer,280,210,490,35,15,Player A
465,PatternLearningPlayer,161,231,392,6,38,PatternLearningPlayer
466,PatternLearningPlayer,240,230,470,36,22,Player A
467,PatternLearningPlayer,296,216,512,45,11,Player A
468,PatternLearningPlayer,274,219,493,35,14,Player A
469,PatternLearningPlayer,189,219,408,16,36,PatternLearningPlayer
470,PatternLearningPlayer,236,206,442,20,26,Player A
471,PatternLearningPlayer,210,230,440,27,29,PatternLearningPlayer
472,PatternLearningPlayer,273,223,496,32,12,Player A
473,PatternLearningPlayer,232,207,439,20,27,Player A
474,PatternLearningPlayer,258,208,466,29,21,Player A
475,PatternLearningPlayer,218,213,431,24,31,Player A
476,PatternLearningPlayer,240,210,450,16,22,Player A
477,PatternLearningPlayer,243,208,451,29,26,Player A
478,PatternLearningPlayer,322,202,524,48,8,Player A
479,PatternLearningPlayer,299,199,498,40,14,Player A
480,PatternLearningPlayer,230,225,455,27,24,Player A
481,PatternLearningPlayer,303,193,496,35,13,Player A
482,PatternLearningPlayer,253,218,471,28,19,Player A
483,PatternLearningPlayer,202,212,414,10,32,PatternLearningPlayer
484,PatternLearningPlayer,244,199,443,21,26,Player A
485,PatternLearningPlayer,311,196,507,40,11,Player A
486,PatternLearningPlayer,240,215,455,24,23,Player A
487,PatternLearningPlayer,267,217,484,38,18,Player A
488,PatternLearningPlayer,277,202,479,30,17,Player A
489,PatternLearningPlayer,325,190,515,42,9,Player A
490,PatternLearningPlayer,255,190,445,23,26,Player A
491,PatternLearningPlayer,232,212,444,22,26,Player A
492,PatternLearningPlayer,248,198,446,27,27,Player A
493,PatternLearningPlayer,239,219,458,21,21,Player A
494,PatternLearningPlayer,315,200,515,42,9,Player A
495,PatternLearningPlayer,216,236,452,27,25,PatternLearningPlayer
496,PatternLearningPlayer,285,215,500,39,13,Player A
497,PatternLearningPlayer,232,222,454,29,25,Player A
498,PatternLearningPlayer,228,213,441,16,25,Player A
499,PatternLearningPlayer,234,229,463,26,21,Player A
500,PatternLearningPlayer,236,216,452,21,23,Player A
501,PatternLearningPlayer,283,203,486,34,16,Player A
502,PatternLearningPlayer,250,230,480,31,17,Player A
503,PatternLearningPlayer,303,198,501,46,15,Player A
504,PatternLearningPlayer,279,209,488,33,15,Player A
505,PatternLearningPlayer,227,232,459,25,22,PatternLearningPlayer
506,PatternLearningPlayer,295,205,500,33,11,Player A
507,PatternLearningPlayer,233,213,446,15,23,Player A
508,PatternLearningPlayer,269,189,458,21,21,Player A
509,PatternLearningPlayer,247,212,459,22,21,Player A
510,PatternLearningPlayer,246,201,447,28,27,Player A
511,PatternLearningPlayer,241,196,437,27,30,Player A
512,PatternLearningPlayer,267,202,469,29,20,Player A
513,PatternLearningPlayer,270,215,485,30,15,Player A
514,PatternLearningPlayer,282,187,469,26,19,Player A
515,PatternLearningPlayer,266,206,472,35,21,Player A
516,PatternLearningPlayer,188,228,416,12,32,PatternLearningPlayer
517,PatternLearningPlayer,315,210,525,46,7,Player A
518,PatternLearningPlayer,269,204,473,27,18,Player A
519,PatternLearningPlayer,257,222,479,30,17,Player A
520,PatternLearningPlayer,261,226,487,32,15,Player A
521,PatternLearningPlayer,332,182,514,44,10,Player A
522,PatternLearningPlayer,265,215,480,34,18,Player A
523,PatternLearningPlayer,249,204,453,22,23,Player A
524,PatternLearningPlayer,294,194,488,30,14,Player A
525,PatternLearningPlayer,253,203,456,25,23,Player A
526,PatternLearningPlayer,224,219,443,21,26,Player A
527,PatternLearningPlayer,275,215,490,32,14,Player A
528,PatternLearningPlayer,298,208,506,36,10,Player A
529,PatternLearningPlayer,331,216,547,59,4,Player A
530,PatternLearningPlayer,258,213,471,28,19,Player A
531,PatternLearningPlayer,243,203,446,21,25,Player A
532,PatternLearningPlayer,335,180,515,39,8,Player A
533,PatternLearningPlayer,222,202,424,17,31,Player A
534,PatternLearningPlayer,271,221,492,40,16,Player A
535,PatternLearningPlayer,220,220,440,24,28,Tie
536,PatternLearningPlayer,281,196,477,34,19,Player A
537,PatternLearningPlayer,179,214,393,13,40,PatternLearningPlayer
538,PatternLearningPlayer,275,185,460,29,23,Player A
539,PatternLearningPlayer,199,209,408,13,35,PatternLearningPlayer
540,PatternLearningPlayer,267,177,444,28,28,Player A
541,PatternLearningPlayer,285,195,480,37,19,Player A
542,PatternLearningPlayer,268,228,496,38,14,Player A
543,PatternLearningPlayer,306,201,507,49,14,Player A
544,PatternLearningPlayer,286,191,477,28,17,Player A
545,PatternLearningPlayer,321,206,527,45,6,Player A
546,PatternLearningPlayer,267,217,484,41,19,Player A
547,PatternLearningPlayer,286,221,507,34,9,Player A
548,PatternLearningPlayer,295,170,465,37,24,Player A
549,PatternLearningPlayer,236,226,462,22,20,Player A
550,PatternLearningPlayer,283,203,486,34,16,Player A
551,PatternLearningPlayer,212,227,439,17,26,PatternLearningPlayer
552,PatternLearningPlayer,265,225,490,32,14,Player A
553,PatternLearningPlayer,250,200,450,28,26,Player A
554,PatternLearningPlayer,237,222,459,19,20,Player A
555,PatternLearningPlayer,309,194,503,33,10,Player A
556,PatternLearningPlayer,350,195,545,51,2,Player A
557,PatternLearningPlayer,239,214,453,22,23,Player A
558,PatternLearningPlayer,200,225,425,24,33,PatternLearningPlayer
559,PatternLearningPlayer,273,208,481,32,17,Player A
560,PatternLearningPlayer,262,237,499,38,13,Player A
561,PatternLearningPlayer,260,205,465,34,23,Player A
562,PatternLearningPlayer,308,218,526,47,7,Player A
563,PatternLearningPlayer,273,223,496,35,13,Player A
564,PatternLearningPlayer,207,212,419,15,32,PatternLearningPlayer
565,PatternLearningPlayer,226,216,442,23,27,Player A
566,PatternLearningPlayer,240,215,455,30,25,Player A
567,PatternLearningPlayer,252,217,469,29,20,Player A
568,PatternLearningPlayer,264,199,463,23,20,Player A
569,PatternLearningPlayer,278,223,501,40,13,Player A
570,PatternLearningPlayer,258,208,466,32,22,Player A
571,PatternLearningPlayer,299,204,503,39,12,Player A
572,PatternLearningPlayer,206,206,412,17,35,Tie
573,PatternLearningPlayer,227,222,449,27,26,Player A
574,PatternLearningPlayer,254,224,478,29,17,Player A
575,PatternLearningPlayer,142,247,389,6,39,PatternLearningPlayer
576,PatternLearningPlayer,286,196,482,39,19,Player A
577,PatternLearningPlayer,236,206,442,23,27,Player A
578,PatternLearningPlayer,261,206,467,27,20,Player A
579,PatternLearningPlayer,237,212,449,21,24,Player A
580,PatternLearningPlayer,336,191,527,39,4,Player A
581,PatternLearningPlayer,280,210,490,32,14,Player A
582,PatternLearningPlayer,330,200,530,42,4,Player A
583,PatternLearningPlayer,260,210,470,33,21,Player A
584,PatternLearningPlayer,265,220,485,33,16,Player A
585,PatternLearningPlayer,256,206,462,31,23,Player A
586,PatternLearningPlayer,234,234,468,28,20,Tie
587,PatternLearningPlayer,271,206,477,28,17,Player A
588,PatternLearningPlayer,272,212,484,35,17,Player A
589,PatternLearningPlayer,284,209,493,35,14,Player A
590,PatternLearningPlayer,236,181,417,25,36,Player A
591,PatternLearningPlayer,322,187,509,45,12,Player A
592,PatternLearningPlayer,241,221,462,34,24,Player A
593,PatternLearningPlayer,268,198,466,32,22,Player A
594,PatternLearningPlayer,272,212,484,29,15,Player A
595,PatternLearningPlayer,270,185,455,27,24,Player A
596,PatternLearningPlayer,230,200,430,23,31,Player A
597,PatternLearningPlayer,322,187,509,42,11,Player A
598,PatternLearningPlayer,220,220,440,21,27,Tie
599,PatternLearningPlayer,257,212,469,29,20,Player A
600,PatternLearningPlayer,289,199,488,33,15,Player A
601,PatternLearningPlayer,273,193,466,32,22,Player A
602,PatternLearningPlayer,319,204,523,38,5,Player A
603,PatternLearningPlayer,206,231,437,12,25,PatternLearningPlayer
604,PatternLearningPlayer,215,220,435,28,31,PatternLearningPlayer
605,PatternLearningPlayer,273,223,496,44,16,Player A
606,PatternLearningPlayer,257,202,459,19,20,Player A
607,PatternLearningPlayer,317,207,524,45,7,Player A
608,PatternLearningPlayer,283,203,486,25,13,Player A
609,PatternLearningPlayer,247,202,449,24,25,Player A
610,PatternLearningPlayer,215,235,450,19,23,PatternLearningPlayer
611,PatternLearningPlayer,256,186,442,20,26,Player A
612,PatternLearningPlayer,220,180,400,14,38,Player A
613,PatternLearningPlayer,246,216,462,34,24,Player A
614,PatternLearningPlayer,302,202,504,49,15,Player A
615,PatternLearningPlayer,271,201,472,29,19,Player A
616,PatternLearningPlayer,272,227,499,38,13,Player A
617,PatternLearningPlayer,278,213,491,36,15,Player A
618,PatternLearningPlayer,223,208,431,21,30,Player A
619,PatternLearningPlayer,256,216,472,23,17,Player A
620,PatternLearningPlayer,241,216,457,17,20,Player A
621,PatternLearningPlayer,246,221,467,24,19,Player A
622,PatternLearningPlayer,281,191,472,35,21,Player A
623,PatternLearningPlayer,234,229,463,23,20,Player A
624,PatternLearningPlayer,214,224,438,19,27,PatternLearningPlayer
625,PatternLearningPlayer,297,202,499,44,15,Player A
626,PatternLearningPlayer,269,204,473,36,21,Player A
627,PatternLearningPlayer,289,209,498,34,12,Player A
628,PatternLearningPlayer,315,200,515,42,9,Player A
629,PatternLearningPlayer,293,198,491,33,14,Player A
630,PatternLearningPlayer,261,211,472,32,20,Player A
631,PatternLearningPlayer,228,238,466,32,22,PatternLearningPlayer
632,PatternLearningPlayer,294,204,498,37,13,Player A
633,PatternLearningPlayer,318,183,501,37,12,Player A
634,PatternLearningPlayer,334,204,538,56,6,Player A
635,PatternLearningPlayer,234,224,458,21,21,Player A
636,PatternLearningPlayer,231,221,452,27,25,Player A
637,PatternLearningPlayer,265,210,475,32,19,Player A
638,PatternLearningPlayer,244,214,458,21,21,Player A
639,PatternLearningPlayer,349,194,543,55,4,Player A
640,PatternLearningPlayer,251,216,467,24,19,Player A
641,PatternLearningPlayer,228,213,441,19,26,Player A
642,PatternLearningPlayer,281,211,492,31,13,Player A
643,PatternLearningPlayer,314,209,523,44,7,Player A
644,PatternLearningPlayer,278,198,476,30,18,Player A
645,PatternLearningPlayer,235,205,440,24,28,Player A
646,PatternLearningPlayer,285,225,510,40,10,Player A
647,PatternLearningPlayer,314,204,518,42,8,Player A
648,PatternLearningPlayer,269,204,473,30,19,Player A
649,PatternLearningPlayer,256,211,467,27,20,Player A
650,PatternLearningPlayer,237,212,449,24,25,Player A
651,PatternLearningPlayer,290,205,495,37,14,Player A
652,PatternLearningPlayer,227,202,429,16,29,Player A
653,PatternLearningPlayer,293,218,511,41,10,Player A
654,PatternLearningPlayer,248,233,481,35,18,Player A
655,PatternLearningPlayer,215,200,415,20,35,Player A
656,PatternLearningPlayer,329,199,528,46,6,Player A
657,PatternLearningPlayer,297,202,499,41,14,Player A
658,PatternLearningPlayer,311,201,512,42,10,Player A
659,PatternLearningPlayer,262,212,474,37,21,Player A
660,PatternLearningPlayer,250,205,455,24,23,Player A
661,PatternLearningPlayer,258,213,471,31,20,Player A
662,PatternLearningPlayer,257,207,464,30,22,Player A
663,PatternLearningPlayer,272,207,479,30,17,Player A
664,PatternLearningPlayer,276,201,477,31,18,Player A
665,PatternLearningPlayer,317,202,519,46,9,Player A
666,PatternLearningPlayer,280,205,485,27,14,Player A
667,PatternLearningPlayer,210,185,395,12,39,Player A
668,PatternLearningPlayer,315,190,505,35,10,Player A
669,PatternLearningPlayer,233,218,451,26,25,Player A
670,PatternLearningPlayer,301,196,497,36,13,Player A
671,PatternLearningPlayer,217,227,444,19,25,PatternLearningPlayer
672,PatternLearningPlayer,260,215,475,26,17,Player A
673,PatternLearningPlayer,315,205,520,44,8,Player A
674,PatternLearningPlayer,247,202,449,24,25,Player A
675,PatternLearningPlayer,287,207,494,39,15,Player A
676,PatternLearningPlayer,221,211,432,22,30,Player A
677,PatternLearningPlayer,208,213,421,20,33,PatternLearningPlayer
678,PatternLearningPlayer,269,219,488,36,16,Player A
679,PatternLearningPlayer,204,219,423,16,31,PatternLearningPlayer
680,PatternLearningPlayer,246,216,462,25,21,Player A
681,PatternLearningPlayer,258,218,476,27,17,Player A
682,PatternLearningPlayer,314,194,508,44,12,Player A
683,PatternLearningPlayer,282,197,479,36,19,Player A
684,PatternLearningPlayer,268,213,481,32,17,Player A
685,PatternLearningPlayer,264,189,453,28,25,Player A
686,PatternLearningPlayer,256,211,467,30,21,Player A
687,PatternLearningPlayer,225,210,435,22,29,Player A
688,PatternLearningPlayer,269,194,463,35,24,Player A
689,PatternLearningPlayer,265,215,480,34,18,Player A
690,PatternLearningPlayer,248,208,456,28,24,Player A
691,PatternLearningPlayer,228,203,431,24,31,Player A
692,PatternLearningPlayer,281,201,482,30,16,Player A
693,PatternLearningPlayer,252,207,459,28,23,Player A
694,PatternLearningPlayer,254,214,468,22,18,Player A
695,PatternLearningPlayer,323,188,511,44,11,Player A
696,PatternLearningPlayer,268,218,486,40,18,Player A
697,PatternLearningPlayer,263,223,486,28,14,Player A
698,PatternLearningPlayer,283,218,501,34,11,Player A
699,PatternLearningPlayer,269,214,483,40,19,Player A
700,PatternLearningPlayer,253,198,451,29,26,Player A
701,PatternLearningPlayer,279,214,493,32,13,Player A
702,PatternLearningPlayer,217,227,444,19,25,PatternLearningPlayer
703,PatternLearningPlayer,330,205,535,47,4,Player A
704,PatternLearningPlayer,332,197,529,47,6,Player A
705,PatternLearningPlayer,259,204,463,26,21,Player A
706,PatternLearningPlayer,250,215,465,22,19,Player A
707,PatternLearningPlayer,293,163,456,28,24,Player A
708,PatternLearningPlayer,208,213,421,14,31,PatternLearningPlayer
709,PatternLearningPlayer,304,214,518,45,9,Player A
710,PatternLearningPlayer,322,207,529,47,6,Player A
711,PatternLearningPlayer,320,180,500,39,13,Player A
712,PatternLearningPlayer,293,213,506,42,12,Player A
713,PatternLearningPlayer,315,195,510,34,8,Player A
714,PatternLearningPlayer,280,190,470,33,21,Player A
715,PatternLearningPlayer,276,211,487,29,14,Player A
716,PatternLearningPlayer,268,188,456,28,24,Player A
717,PatternLearningPlayer,250,220,470,33,21,Player A
718,PatternLearningPlayer,231,206,437,18,27,Player A
719,PatternLearningPlayer,241,221,462,25,21,Player A
720,PatternLearningPlayer,223,238,461,24,21,PatternLearningPlayer
721,PatternLearningPlayer,255,215,470,36,22,Player A
722,PatternLearningPlayer,255,225,480,34,18,Player A
723,PatternLearningPlayer,284,204,488,33,15,Player A
724,PatternLearningPlayer,305,200,505,41,12,Player A
725,PatternLearningPlayer,238,188,426,22,32,Player A
726,PatternLearningPlayer,342,197,539,48,3,Player A
727,PatternLearningPlayer,254,209,463,23,20,Player A
728,PatternLearningPlayer,285,215,500,36,12,Player A
729,PatternLearningPlayer,305,200,505,32,9,Player A
730,PatternLearningPlayer,279,209,488,30,14,Player A
731,PatternLearningPlayer,265,215,480,34,18,Player A
732,PatternLearningPlayer,300,210,510,37,9,Player A
733,PatternLearningPlayer,289,204,493,29,12,Player A
734,PatternLearningPlayer,232,207,439,26,29,Player A
735,PatternLearningPlayer,225,220,445,20,25,Player A
736,PatternLearningPlayer,233,233,466,23,19,Tie
737,PatternLearningPlayer,333,203,536,48,4,Player A
738,PatternLearningPlayer,216,196,412,20,36,Player A
739,PatternLearningPlayer,283,208,491,39,16,Player A
740,PatternLearningPlayer,219,214,433,20,29,Player A
741,PatternLearningPlayer,267,207,474,31,19,Player A
742,PatternLearningPlayer,260,210,470,24,18,Player A
743,PatternLearningPlayer,190,220,410,18,36,PatternLearningPlayer
744,PatternLearningPlayer,224,209,433,17,28,Player A
745,PatternLearningPlayer,287,207,494,33,13,Player A
746,PatternLearningPlayer,242,222,464,27,21,Player A
747,PatternLearningPlayer,290,190,480,31,17,Player A
748,PatternLearningPlayer,231,196,427,23,32,Player A
749,PatternLearningPlayer,252,197,449,30,27,Player A
750,PatternLearningPlayer,273,223,496,38,14,Player A
751,PatternLearningPlayer,229,219,448,26,26,Player A
752,PatternLearningPlayer,321,206,527,45,6,Player A
753,PatternLearningPlayer,250,230,480,28,16,Player A
754,PatternLearningPlayer,275,220,495,34,13,Player A
755,PatternLearningPlayer,296,201,497,33,12,Player A
756,PatternLearningPlayer,242,207,449,18,23,Player A
757,PatternLearningPlayer,242,222,464,24,20,Player A
758,PatternLearningPlayer,220,235,455,21,22,PatternLearningPlayer
759,PatternLearningPlayer,251,216,467,30,21,Player A
760,PatternLearningPlayer,260,210,470,30,20,Player A
761,PatternLearningPlayer,219,229,448,20,24,PatternLearningPlayer
762,PatternLearningPlayer,311,181,492,31,13,Player A
763,PatternLearningPlayer,271,196,467,27,20,Player A
764,PatternLearningPlayer,208,208,416,18,34,Tie
765,PatternLearningPlayer,222,212,434,18,28,Player A
766,PatternLearningPlayer,303,208,511,47,12,Player A
767,PatternLearningPlayer,236,211,447,16,23,Player A
768,PatternLearningPlayer,297,187,484,35,17,Player A
769,PatternLearningPlayer,237,227,464,30,22,Player A
770,PatternLearningPlayer,223,223,446,18,24,Tie
771,PatternLearningPlayer,287,212,499,41,14,Player A
772,PatternLearningPlayer,299,209,508,38,10,Player A
773,PatternLearningPlayer,210,220,430,14,28,PatternLearningPlayer
774,PatternLearningPlayer,191,216,407,12,35,PatternLearningPlayer
775,PatternLearningPlayer,275,205,480,28,16,Player A
776,PatternLearningPlayer,290,190,480,40,20,Player A
777,PatternLearningPlayer,286,206,492,46,18,Player A
778,PatternLearningPlayer,244,209,453,25,24,Player A
779,PatternLearningPlayer,322,192,514,50,12,Player A
780,PatternLearningPlayer,238,213,451,29,26,Player A
781,PatternLearningPlayer,210,250,460,32,24,PatternLearningPlayer
782,PatternLearningPlayer,184,229,413,15,34,PatternLearningPlayer
783,PatternLearningPlayer,252,222,474,28,18,Player A
784,PatternLearningPlayer,276,201,477,31,18,Player A
785,PatternLearningPlayer,228,223,451,26,25,Player A
786,PatternLearningPlayer,281,191,472,35,21,Player A
787,PatternLearningPlayer,236,216,452,18,22,Player A
788,PatternLearningPlayer,237,227,464,27,21,Player A
789,PatternLearningPlayer,263,198,461,30,23,Player A
790,PatternLearningPlayer,295,195,490,32,14,Player A
791,PatternLearningPlayer,250,205,455,21,22,Player A
792,PatternLearningPlayer,252,202,454,23,23,Player A
793,PatternLearningPlayer,128,208,336,1,55,PatternLearningPlayer
794,PatternLearningPlayer,276,221,497,30,11,Player A
795,PatternLearningPlayer,280,210,490,35,15,Player A
796,PatternLearningPlayer,266,211,477,28,17,Player A
797,PatternLearningPlayer,265,225,490,35,15,Player A
798,PatternLearningPlayer,286,201,487,29,14,Player A
799,PatternLearningPlayer,225,220,445,23,26,Player A
800,PatternLearningPlayer,278,198,476,27,17,Player A
801,PatternLearningPlayer,266,221,487,32,15,Player A
802,PatternLearningPlayer,269,214,483,34,17,Player A
803,PatternLearningPlayer,278,208,486,31,15,Player A
804,PatternLearningPlayer,229,209,438,25,29,Player A
805,PatternLearningPlayer,235,210,445,23,26,Player A
806,PatternLearningPlayer,279,199,478,26,16,Player A
807,PatternLearningPlayer,227,222,449,30,27,Player A
808,PatternLearningPlayer,249,229,478,29,17,Player A
809,PatternLearningPlayer,300,195,495,34,13,Player A
810,PatternLearningPlayer,222,227,449,21,24,PatternLearningPlayer
811,PatternLearningPlayer,280,205,485,30,15,Player A
812,PatternLearningPlayer,273,188,461,24,21,Player A
813,PatternLearningPlayer,278,223,501,34,11,Player A
814,PatternLearningPlayer,240,215,455,21,22,Player A
815,PatternLearningPlayer,241,216,457,23,22,Player A
816,PatternLearningPlayer,199,209,408,19,37,PatternLearningPlayer
817,PatternLearningPlayer,211,206,417,16,33,Player A
818,PatternLearningPlayer,255,210,465,28,21,Player A
819,PatternLearningPlayer,266,206,472,32,20,Player A
820,PatternLearningPlayer,243,193,436,26,30,Player A
821,PatternLearningPlayer,250,225,475,29,18,Player A
822,PatternLearningPlayer,223,218,441,16,25,Player A
823,PatternLearningPlayer,270,205,475,23,16,Player A
824,PatternLearningPlayer,237,222,459,31,24,Player A
825,PatternLearningPlayer,331,216,547,56,3,Player A
826,PatternLearningPlayer,189,229,418,20,34,PatternLearningPlayer
827,PatternLearningPlayer,229,199,428,21,31,Player A
828,PatternLearningPlayer,236,236,472,26,18,Tie
829,PatternLearningPlayer,246,196,442,29,29,Player A
830,PatternLearningPlayer,289,189,478,32,18,Player A
831,PatternLearningPlayer,303,223,526,53,9,Player A
832,PatternLearningPlayer,255,205,460,29,23,Player A
833,PatternLearningPlayer,277,177,454,26,24,Player A
834,PatternLearningPlayer,254,214,468,28,20,Player A
835,PatternLearningPlayer,247,232,479,30,17,Player A
836,PatternLearningPlayer,249,189,438,25,29,Player A
837,PatternLearningPlayer,269,219,488,33,15,Player A
838,PatternLearningPlayer,197,217,414,16,34,PatternLearningPlayer
839,PatternLearningPlayer,181,211,392,15,41,PatternLearningPlayer
840,PatternLearningPlayer,270,210,480,31,17,Player A
841,PatternLearningPlayer,298,218,516,46,10,Player A
842,PatternLearningPlayer,281,201,482,33,17,Player A
843,PatternLearningPlayer,230,210,440,15,25,Player A
844,PatternLearningPlayer,246,221,467,24,19,Player A
845,PatternLearningPlayer,275,195,470,27,19,Player A
846,PatternLearningPlayer,275,190,465,25,20,Player A
847,PatternLearningPlayer,232,207,439,17,26,Player A
848,PatternLearningPlayer,253,208,461,27,22,Player A
849,PatternLearningPlayer,232,212,444,22,26,Player A
850,PatternLearningPlayer,255,205,460,26,22,Player A
851,PatternLearningPlayer,210,225,435,22,29,PatternLearningPlayer
852,PatternLearningPlayer,239,219,458,21,21,Player A
853,PatternLearningPlayer,259,194,453,22,23,Player A
854,PatternLearningPlayer,289,199,488,39,17,Player A
855,PatternLearningPlayer,282,217,499,41,14,Player A
856,PatternLearningPlayer,232,222,454,20,22,Player A
857,PatternLearningPlayer,297,197,494,33,13,Player A
858,PatternLearningPlayer,299,219,518,42,8,Player A
859,PatternLearningPlayer,279,219,498,37,13,Player A
860,PatternLearningPlayer,256,201,457,23,22,Player A
861,PatternLearningPlayer,286,196,482,39,19,Player A
862,PatternLearningPlayer,266,216,482,30,16,Player A
863,PatternLearningPlayer,249,204,453,28,25,Player A
864,PatternLearningPlayer,341,181,522,43,7,Player A
865,PatternLearningPlayer,256,206,462,28,22,Player A
866,PatternLearningPlayer,253,213,466,29,21,Player A
867,PatternLearningPlayer,241,221,462,25,21,Player A
868,PatternLearningPlayer,232,217,449,24,25,Player A
869,PatternLearningPlayer,243,218,461,24,21,Player A
870,PatternLearningPlayer,355,190,545,48,1,Player A
871,PatternLearningPlayer,236,206,442,29,29,Player A
872,PatternLearningPlayer,324,204,528,43,5,Player A
873,PatternLearningPlayer,282,197,479,33,18,Player A
874,PatternLearningPlayer,243,223,466,32,22,Player A
875,PatternLearningPlayer,203,208,411,13,34,PatternLearningPlayer
876,PatternLearningPlayer,287,207,494,33,13,Player A
877,PatternLearningPlayer,205,210,415,11,32,PatternLearningPlayer
878,PatternLearningPlayer,220,200,420,13,31,Player A
879,PatternLearningPlayer,311,186,497,39,14,Player A
880,PatternLearningPlayer,280,200,480,34,18,Player A
881,PatternLearningPlayer,266,191,457,29,24,Player A
882,PatternLearningPlayer,296,221,517,47,10,Player A
883,PatternLearningPlayer,254,214,468,31,21,Player A
884,PatternLearningPlayer,212,222,434,21,29,PatternLearningPlayer
885,PatternLearningPlayer,293,198,491,33,14,Player A
886,PatternLearningPlayer,237,212,449,30,27,Player A
887,PatternLearningPlayer,274,209,483,34,17,Player A
888,PatternLearningPlayer,321,206,527,45,6,Player A
889,PatternLearningPlayer,284,214,498,37,13,Player A
890,PatternLearningPlayer,225,215,440,21,27,Player A
891,PatternLearningPlayer,327,207,534,49,5,Player A
892,PatternLearningPlayer,256,206,462,28,22,Player A
893,PatternLearningPlayer,288,208,496,35,13,Player A
894,PatternLearningPlayer,290,220,510,46,12,Player A
895,PatternLearningPlayer,261,221,482,33,17,Player A
896,PatternLearningPlayer,255,230,485,27,14,Player A
897,PatternLearningPlayer,291,191,482,33,17,Player A
898,PatternLearningPlayer,269,234,503,42,13,Player A
899,PatternLearningPlayer,260,205,465,31,22,Player A
900,PatternLearningPlayer,182,222,404,15,37,PatternLearningPlayer
901,PatternLearningPlayer,291,211,502,44,14,Player A
902,PatternLearningPlayer,243,223,466,29,21,Player A
903,PatternLearningPlayer,278,193,471,28,19,Player A
904,PatternLearningPlayer,297,217,514,41,9,Player A
905,PatternLearningPlayer,242,227,469,32,21,Player A
906,PatternLearningPlayer,311,201,512,39,9,Player A
907,PatternLearningPlayer,238,228,466,32,22,Player A
908,PatternLearningPlayer,309,194,503,36,11,Player A
909,PatternLearningPlayer,257,222,479,33,18,Player A
910,PatternLearningPlayer,222,217,439,23,28,Player A
911,PatternLearningPlayer,297,212,509,36,9,Player A
912,PatternLearningPlayer,242,227,469,26,19,Player A
913,PatternLearningPlayer,312,207,519,40,7,Player A
914,PatternLearningPlayer,201,236,437,18,27,PatternLearningPlayer
915,PatternLearningPlayer,281,196,477,37,20,Player A
916,PatternLearningPlayer,304,199,503,39,12,Player A
917,PatternLearningPlayer,294,209,503,36,11,Player A
918,PatternLearningPlayer,290,205,495,28,11,Player A
919,PatternLearningPlayer,333,208,541,44,1,Player A
920,PatternLearningPlayer,307,207,514,41,9,Player A
921,PatternLearningPlayer,294,219,513,43,10,Player A
922,PatternLearningPlayer,288,198,486,34,16,Player A
923,PatternLearningPlayer,234,219,453,25,24,Player A
924,PatternLearningPlayer,304,189,493,35,14,Player A
925,PatternLearningPlayer,258,218,476,33,19,Player A
926,PatternLearningPlayer,274,194,468,28,20,Player A
927,PatternLearningPlayer,239,219,458,30,24,Player A
928,PatternLearningPlayer,319,199,518,45,9,Player A
929,PatternLearningPlayer,242,222,464,39,25,Player A
930,PatternLearningPlayer,310,185,495,37,14,Player A
931,PatternLearningPlayer,259,209,468,28,20,Player A
932,PatternLearningPlayer,261,206,467,30,21,Player A
933,PatternLearningPlayer,225,220,445,35,30,Player A
934,PatternLearningPlayer,359,179,538,47,3,Player A
935,PatternLearningPlayer,279,189,468,34,22,Player A
936,PatternLearningPlayer,273,193,466,35,23,Player A
937,PatternLearningPlayer,303,213,516,40,8,Player A
938,PatternLearningPlayer,290,205,495,40,15,Player A
939,PatternLearningPlayer,301,206,507,37,10,Player A
940,PatternLearningPlayer,244,219,463,32,23,Player A
941,PatternLearningPlayer,225,225,450,19,23,Tie
942,PatternLearningPlayer,300,210,510,37,9,Player A
943,PatternLearningPlayer,246,211,457,23,22,Player A
944,PatternLearningPlayer,244,209,453,28,25,Player A
945,PatternLearningPlayer,314,189,503,42,13,Player A
946,PatternLearningPlayer,202,232,434,24,30,PatternLearningPlayer
947,PatternLearningPlayer,194,209,403,17,38,PatternLearningPlayer
948,PatternLearningPlayer,278,208,486,25,13,Player A
949,PatternLearningPlayer,218,213,431,24,31,Player A
950,PatternLearningPlayer,231,191,422,24,34,Player A
951,PatternLearningPlayer,276,196,472,29,19,Player A
952,PatternLearningPlayer,307,202,509,42,11,Player A
953,PatternLearningPlayer,325,195,520,41,7,Player A
954,PatternLearningPlayer,284,199,483,31,16,Player A
955,PatternLearningPlayer,272,217,489,37,16,Player A
956,PatternLearningPlayer,200,220,420,25,35,PatternLearningPlayer
957,PatternLearningPlayer,236,221,457,23,22,Player A
958,PatternLearningPlayer,258,213,471,34,21,Player A
959,PatternLearningPlayer,237,197,434,18,28,Player A
960,PatternLearningPlayer,256,201,457,26,23,Player A
961,PatternLearningPlayer,258,193,451,32,27,Player A
962,PatternLearningPlayer,312,217,529,44,5,Player A
963,PatternLearningPlayer,236,211,447,25,26,Player A
964,PatternLearningPlayer,316,201,517,38,7,Player A
965,PatternLearningPlayer,230,215,445,20,25,Player A
966,PatternLearningPlayer,277,222,499,41,14,Player A
967,PatternLearningPlayer,333,198,531,49,6,Player A
968,PatternLearningPlayer,294,204,498,37,13,Player A
969,PatternLearningPlayer,264,219,483,34,17,Player A
970,PatternLearningPlayer,271,216,487,35,16,Player A
971,PatternLearningPlayer,240,205,445,20,25,Player A
972,PatternLearningPlayer,204,234,438,22,28,PatternLearningPlayer
973,PatternLearningPlayer,262,192,454,26,24,Player A
974,PatternLearningPlayer,257,217,474,28,18,Player A
975,PatternLearningPlayer,243,218,461,30,23,Player A
976,PatternLearningPlayer,305,205,510,40,10,Player A
977,PatternLearningPlayer,209,224,433,20,29,PatternLearningPlayer
978,PatternLearningPlayer,255,195,450,25,25,Player A
979,PatternLearningPlayer,205,215,420,16,32,PatternLearningPlayer
980,PatternLearningPlayer,334,199,533,51,6,Player A
981,PatternLearningPlayer,290,205,495,40,15,Player A
982,PatternLearningPlayer,296,211,507,46,13,Player A
983,PatternLearningPlayer,270,215,485,39,18,Player A
984,PatternLearningPlayer,222,222,444,22,26,Tie
985,PatternLearningPlayer,259,204,463,32,23,Player A
986,PatternLearningPlayer,287,207,494,45,17,Player A
987,PatternLearningPlayer,242,217,459,34,25,Player A
988,PatternLearningPlayer,248,208,456,28,24,Player A
989,PatternLearningPlayer,307,197,504,34,10,Player A
990,PatternLearningPlayer,187,237,424,8,28,PatternLearningPlayer
991,PatternLearningPlayer,275,210,485,33,16,Player A
992,PatternLearningPlayer,247,212,459,28,23,Player A
993,PatternLearningPlayer,294,179,473,33,20,Player A
994,PatternLearningPlayer,280,225,505,38,11,Player A
995,PatternLearningPlayer,304,204,508,41,11,Player A
996,PatternLearningPlayer,228,218,446,27,27,Player A
997,PatternLearningPlayer,271,221,492,37,15,Player A
998,PatternLearningPlayer,291,206,497,36,13,Player A
999,PatternLearningPlayer,288,198,486,31,15,Player A
1000,PatternLearningPlayer,305,220,525,46,7,Player A
1001,PatternLearningPlayer,242,232,474,28,18,Player A
1002,PatternLearningPlayer,211,226,437,18,27,PatternLearningPlayer
1003,PatternLearningPlayer,272,212,484,29,15,Player A
1004,PatternLearningPlayer,238,223,461,30,23,Player A
1005,PatternLearningPlayer,264,189,453,22,23,Player A
1006,PatternLearningPlayer,222,212,434,15,27,Player A
1007,PatternLearningPlayer,320,195,515,39,8,Player A
1008,PatternLearningPlayer,278,208,486,34,16,Player A
1009,PatternLearningPlayer,210,210,420,19,33,Tie
1010,PatternLearningPlayer,223,228,451,20,23,PatternLearningPlayer
1011,PatternLearningPlayer,205,220,425,21,32,PatternLearningPlayer
1012,PatternLearningPlayer,279,224,503,45,14,Player A
1013,PatternLearningPlayer,278,193,471,28,19,Player A
1014,PatternLearningPlayer,255,220,475,35,20,Player A
1015,PatternLearningPlayer,218,213,431,21,30,Player A
1016,PatternLearningPlayer,288,198,486,34,16,Player A
1017,PatternLearningPlayer,334,204,538,50,4,Player A
1018,PatternLearningPlayer,259,189,448,26,26,Player A
1019,PatternLearningPlayer,276,201,477,31,18,Player A
1020,PatternLearningPlayer,248,208,456,22,22,Player A
1021,PatternLearningPlayer,271,201,472,32,20,Player A
1022,PatternLearningPlayer,306,201,507,43,12,Player A
1023,PatternLearningPlayer,247,222,469,32,21,Player A
1024,PatternLearningPlayer,202,222,424,14,30,PatternLearningPlayer
1025,PatternLearningPlayer,281,206,487,38,17,Player A
1026,PatternLearningPlayer,293,213,506,39,11,Player A
1027,PatternLearningPlayer,225,205,430,20,30,Player A
1028,PatternLearningPlayer,270,210,480,34,18,Player A
1029,PatternLearningPlayer,261,216,477,34,19,Player A
1030,PatternLearningPlayer,248,198,446,24,26,Player A
1031,PatternLearningPlayer,256,211,467,30,21,Player A
1032,PatternLearningPlayer,283,198,481,32,17,Player A
1033,PatternLearningPlayer,228,203,431,24,31,Player A
1034,PatternLearningPlayer,293,203,496,29,11,Player A
1035,PatternLearningPlayer,297,207,504,43,13,Player A
1036,PatternLearningPlayer,223,203,426,22,32,Player A
1037,PatternLearningPlayer,189,224,413,15,34,PatternLearningPlayer
1038,PatternLearningPlayer,276,216,492,34,14,Player A
1039,PatternLearningPlayer,214,224,438,22,28,PatternLearningPlayer
1040,PatternLearningPlayer,196,226,422,18,32,PatternLearningPlayer
1041,PatternLearningPlayer,260,225,485,33,16,Player A
1042,PatternLearningPlayer,245,215,460,26,22,Player A
1043,PatternLearningPlayer,204,219,423,16,31,PatternLearningPlayer
1044,PatternLearningPlayer,261,216,477,37,20,Player A
1045,PatternLearningPlayer,262,217,479,36,19,Player A
1046,PatternLearningPlayer,259,224,483,25,14,Player A
1047,PatternLearningPlayer,314,199,513,40,9,Player A
1048,PatternLearningPlayer,292,187,479,27,16,Player A
1049,PatternLearningPlayer,326,211,537,52,5,Player A
1050,PatternLearningPlayer,225,235,460,20,20,PatternLearningPlayer
1051,PatternLearningPlayer,233,218,451,20,23,Player A
1052,PatternLearningPlayer,257,212,469,35,22,Player A
1053,PatternLearningPlayer,345,190,535,50,5,Player A
1054,PatternLearningPlayer,251,211,462,31,23,Player A
1055,PatternLearningPlayer,263,208,471,34,21,Player A
1056,PatternLearningPlayer,286,206,492,37,15,Player A
1057,PatternLearningPlayer,268,213,481,35,18,Player A
1058,PatternLearningPlayer,292,202,494,36,14,Player A
1059,PatternLearningPlayer,200,225,425,12,29,PatternLearningPlayer
1060,PatternLearningPlayer,301,181,482,36,18,Player A
1061,PatternLearningPlayer,272,187,459,31,24,Player A
1062,PatternLearningPlayer,247,217,464,33,23,Player A
1063,PatternLearningPlayer,335,205,540,49,3,Player A
1064,PatternLearningPlayer,234,219,453,25,24,Player A
1065,PatternLearningPlayer,255,210,465,34,23,Player A
1066,PatternLearningPlayer,311,206,517,38,7,Player A
1067,PatternLearningPlayer,232,232,464,27,21,Tie
1068,PatternLearningPlayer,259,219,478,29,17,Player A
1069,PatternLearningPlayer,215,220,435,22,29,PatternLearningPlayer
1070,PatternLearningPlayer,260,205,465,28,21,Player A
1071,PatternLearningPlayer,278,188,466,29,21,Player A
1072,PatternLearningPlayer,249,194,443,24,27,Player A
1073,PatternLearningPlayer,259,219,478,32,18,Player A
1074,PatternLearningPlayer,250,205,455,30,25,Player A
1075,PatternLearningPlayer,221,211,432,25,31,Player A
1076,PatternLearningPlayer,238,233,471,25,18,Player A
1077,PatternLearningPlayer,277,217,494,30,12,Player A
1078,PatternLearningPlayer,335,185,520,38,6,Player A
1079,PatternLearningPlayer,270,210,480,34,18,Player A
1080,PatternLearningPlayer,250,210,460,26,22,Player A
1081,PatternLearningPlayer,266,216,482,33,17,Player A
1082,PatternLearningPlayer,280,220,500,33,11,Player A
1083,PatternLearningPlayer,225,205,430,20,30,Player A
1084,PatternLearningPlayer,273,213,486,34,16,Player A
1085,PatternLearningPlayer,223,213,436,20,28,Player A
1086,PatternLearningPlayer,281,201,482,27,15,Player A
1087,PatternLearningPlayer,285,185,470,36,22,Player A
1088,PatternLearningPlayer,235,220,455,24,23,Player A
1089,PatternLearningPlayer,285,200,485,33,16,Player A
1090,PatternLearningPlayer,263,218,481,32,17,Player A
1091,PatternLearningPlayer,295,210,505,41,12,Player A
1092,PatternLearningPlayer,242,202,444,22,26,Player A
1093,PatternLearningPlayer,256,221,477,37,20,Player A
1094,PatternLearningPlayer,247,227,474,34,20,Player A
1095,PatternLearningPlayer,335,190,525,49,8,Player A
1096,PatternLearningPlayer,181,231,412,17,35,PatternLearningPlayer
1097,PatternLearningPlayer,236,201,437,21,28,Player A
1098,PatternLearningPlayer,303,193,496,41,15,Player A
1099,PatternLearningPlayer,230,225,455,24,23,Player A
1100,PatternLearningPlayer,230,200,430,23,31,Player A
1101,PatternLearningPlayer,203,233,436,20,28,PatternLearningPlayer
1102,PatternLearningPlayer,236,231,467,30,21,Player A
1103,PatternLearningPlayer,271,211,482,27,15,Player A
1104,PatternLearningPlayer,265,205,470,30,20,Player A
1105,PatternLearningPlayer,247,212,459,16,19,Player A
1106,PatternLearningPlayer,267,217,484,35,17,Player A
1107,PatternLearningPlayer,256,216,472,32,20,Player A
1108,PatternLearningPlayer,283,213,496,35,13,Player A
1109,PatternLearningPlayer,176,221,397,11,38,PatternLearningPlayer
1110,PatternLearningPlayer,293,198,491,36,15,Player A
1111,PatternLearningPlayer,290,210,500,42,14,Player A
1112,PatternLearningPlayer,243,223,466,26,20,Player A
1113,PatternLearningPlayer,284,189,473,30,19,Player A
1114,PatternLearningPlayer,267,202,469,35,22,Player A
1115,PatternLearningPlayer,260,210,470,30,20,Player A
1116,PatternLearningPlayer,333,173,506,36,10,Player A
1117,PatternLearningPlayer,263,223,486,37,17,Player A
1118,PatternLearningPlayer,257,197,454,26,24,Player A
1119,PatternLearningPlayer,315,180,495,37,14,Player A
1120,PatternLearningPlayer,298,198,496,38,14,Player A
1121,PatternLearningPlayer,337,197,534,37,1,Player A
1122,PatternLearningPlayer,268,208,476,33,19,Player A
1123,PatternLearningPlayer,286,191,477,34,19,Player A
1124,PatternLearningPlayer,204,199,403,20,39,Player A
1125,PatternLearningPlayer,269,204,473,27,18,Player A
1126,PatternLearningPlayer,278,208,486,34,16,Player A
1127,PatternLearningPlayer,261,191,452,21,23,Player A
1128,PatternLearningPlayer,301,206,507,37,10,Player A
1129,PatternLearningPlayer,306,216,522,46,8,Player A
1130,PatternLearningPlayer,173,213,386,9,41,PatternLearningPlayer
1131,PatternLearningPlayer,232,202,434,24,30,Player A
1132,PatternLearningPlayer,231,196,427,26,33,Player A
1133,PatternLearningPlayer,236,206,442,26,28,Player A
1134,PatternLearningPlayer,288,198,486,34,16,Player A
1135,PatternLearningPlayer,210,210,420,19,33,Tie
1136,PatternLearningPlayer,300,195,495,40,15,Player A
1137,PatternLearningPlayer,263,198,461,33,24,Player A
1138,PatternLearningPlayer,276,226,502,35,11,Player A
1139,PatternLearningPlayer,200,230,430,17,29,PatternLearningPlayer
1140,PatternLearningPlayer,288,208,496,38,14,Player A
1141,PatternLearningPlayer,240,190,430,20,30,Player A
1142,PatternLearningPlayer,252,222,474,22,16,Player A
1143,PatternLearningPlayer,216,221,437,21,28,PatternLearningPlayer
1144,PatternLearningPlayer,312,187,499,32,11,Player A
1145,PatternLearningPlayer,299,204,503,42,13,Player A
1146,PatternLearningPlayer,279,209,488,33,15,Player A
1147,PatternLearningPlayer,262,187,449,27,26,Player A
1148,PatternLearningPlayer,282,207,489,34,15,Player A
1149,PatternLearningPlayer,227,217,444,25,27,Player A
1150,PatternLearningPlayer,270,220,490,29,13,Player A
1151,PatternLearningPlayer,292,202,494,36,14,Player A
1152,PatternLearningPlayer,271,211,482,30,16,Player A
1153,PatternLearningPlayer,244,204,448,20,24,Player A
1154,PatternLearningPlayer,224,214,438,19,27,Player A
1155,PatternLearningPlayer,216,211,427,20,31,Player A
1156,PatternLearningPlayer,268,208,476,33,19,Player A
1157,PatternLearningPlayer,306,196,502,35,11,Player A
1158,PatternLearningPlayer,287,192,479,30,17,Player A
1159,PatternLearningPlayer,284,204,488,39,17,Player A
1160,PatternLearningPlayer,185,210,395,15,40,PatternLearningPlayer
1161,PatternLearningPlayer,251,201,452,24,24,Player A
1162,PatternLearningPlayer,208,208,416,18,34,Tie
1163,PatternLearningPlayer,236,211,447,22,25,Player A
1164,PatternLearningPlayer,302,202,504,40,12,Player A
1165,PatternLearningPlayer,276,211,487,29,14,Player A
1166,PatternLearningPlayer,272,187,459,31,24,Player A
1167,PatternLearningPlayer,306,196,502,41,13,Player A
1168,PatternLearningPlayer,308,203,511,44,11,Player A
1169,PatternLearningPlayer,298,188,486,34,16,Player A
1170,PatternLearningPlayer,250,210,460,32,24,Player A
1171,PatternLearningPlayer,333,178,511,38,9,Player A
1172,PatternLearningPlayer,249,209,458,27,23,Player A
1173,PatternLearningPlayer,196,246,442,11,23,PatternLearningPlayer
1174,PatternLearningPlayer,212,222,434,18,28,PatternLearningPlayer
1175,PatternLearningPlayer,265,215,480,34,18,Player A
1176,PatternLearningPlayer,242,222,464,21,19,Player A
1177,PatternLearningPlayer,260,220,480,31,17,Player A
1178,PatternLearningPlayer,278,208,486,37,17,Player A
1179,PatternLearningPlayer,301,216,517,47,10,Player A
1180,PatternLearningPlayer,239,209,448,26,26,Player A
1181,PatternLearningPlayer,304,209,513,49,12,Player A
1182,PatternLearningPlayer,195,235,430,17,29,PatternLearningPlayer
1183,PatternLearningPlayer,258,213,471,25,18,Player A
1184,PatternLearningPlayer,257,182,439,26,29,Player A
1185,PatternLearningPlayer,230,220,450,19,23,Player A
1186,PatternLearningPlayer,297,212,509,42,11,Player A
1187,PatternLearningPlayer,227,217,444,19,25,Player A
1188,PatternLearningPlayer,218,223,441,22,27,PatternLearningPlayer
1189,PatternLearningPlayer,202,232,434,21,29,PatternLearningPlayer
1190,PatternLearningPlayer,317,192,509,42,11,Player A
1191,PatternLearningPlayer,277,227,504,40,12,Player A
1192,PatternLearningPlayer,214,219,433,23,30,PatternLearningPlayer
1193,PatternLearningPlayer,230,210,440,24,28,Player A
1194,PatternLearningPlayer,298,193,491,45,18,Player A
1195,PatternLearningPlayer,252,232,484,29,15,Player A
1196,PatternLearningPlayer,331,196,527,45,6,Player A
1197,PatternLearningPlayer,266,201,467,33,22,Player A
1198,PatternLearningPlayer,214,234,448,26,26,PatternLearningPlayer
1199,PatternLearningPlayer,289,204,493,35,14,Player A
1200,PatternLearningPlayer,258,213,471,34,21,Player A
1201,PatternLearningPlayer,328,203,531,52,7,Player A
1202,PatternLearningPlayer,280,210,490,35,15,Player A
1203,PatternLearningPlayer,283,198,481,35,18,Player A
1204,PatternLearningPlayer,264,214,478,38,20,Player A
1205,PatternLearningPlayer,282,202,484,35,17,Player A
1206,PatternLearningPlayer,318,193,511,44,11,Player A
1207,PatternLearningPlayer,244,214,458,27,23,Player A
1208,PatternLearningPlayer,252,207,459,25,22,Player A
1209,PatternLearningPlayer,213,218,431,27,32,PatternLearningPlayer
1210,PatternLearningPlayer,243,208,451,23,24,Player A
1211,PatternLearningPlayer,194,229,423,25,34,PatternLearningPlayer
1212,PatternLearningPlayer,320,195,515,45,10,Player A
1213,PatternLearningPlayer,191,236,427,20,31,PatternLearningPlayer
1214,PatternLearningPlayer,225,195,420,16,32,Player A
1215,PatternLearningPlayer,306,211,517,41,8,Player A
1216,PatternLearningPlayer,266,216,482,30,16,Player A
1217,PatternLearningPlayer,274,214,488,33,15,Player A
1218,PatternLearningPlayer,247,217,464,30,22,Player A
1219,PatternLearningPlayer,182,217,399,16,39,PatternLearningPlayer
1220,PatternLearningPlayer,194,199,393,19,42,PatternLearningPlayer
1221,PatternLearningPlayer,267,182,449,27,26,Player A
1222,PatternLearningPlayer,237,197,434,21,29,Player A
1223,PatternLearningPlayer,282,217,499,38,13,Player A
1224,PatternLearningPlayer,257,222,479,24,15,Player A
1225,PatternLearningPlayer,262,237,499,44,15,Player A
1226,PatternLearningPlayer,259,214,473,30,19,Player A
1227,PatternLearningPlayer,282,207,489,34,15,Player A
1228,PatternLearningPlayer,230,210,440,21,27,Player A
1229,PatternLearningPlayer,215,225,440,30,30,PatternLearningPlayer
1230,PatternLearningPlayer,291,196,487,35,16,Player A
1231,PatternLearningPlayer,196,231,427,17,30,PatternLearningPlayer
1232,PatternLearningPlayer,325,195,520,41,7,Player A
1233,PatternLearningPlayer,278,188,466,32,22,Player A
1234,PatternLearningPlayer,205,230,435,28,31,PatternLearningPlayer
1235,PatternLearningPlayer,232,212,444,19,25,Player A
1236,PatternLearningPlayer,244,224,468,28,20,Player A
1237,PatternLearningPlayer,284,199,483,40,19,Player A
1238,PatternLearningPlayer,211,216,427,14,29,PatternLearningPlayer
1239,PatternLearningPlayer,262,217,479,30,17,Player A
1240,PatternLearningPlayer,276,221,497,33,12,Player A
1241,PatternLearningPlayer,263,173,436,26,30,Player A
1242,PatternLearningPlayer,250,195,445,20,25,Player A
1243,PatternLearningPlayer,254,209,463,32,23,Player A
1244,PatternLearningPlayer,302,202,504,40,12,Player A
1245,PatternLearningPlayer,204,209,413,15,34,PatternLearningPlayer
1246,PatternLearningPlayer,228,193,421,23,34,Player A
1247,PatternLearningPlayer,273,218,491,36,15,Player A
1248,PatternLearningPlayer,305,185,490,35,15,Player A
1249,PatternLearningPlayer,305,200,505,35,10,Player A
1250,PatternLearningPlayer,203,218,421,20,33,PatternLearningPlayer
1251,PatternLearningPlayer,272,207,479,30,17,Player A
1252,PatternLearningPlayer,218,223,441,28,29,PatternLearningPlayer
1253,PatternLearningPlayer,285,200,485,33,16,Player A
1254,PatternLearningPlayer,258,213,471,34,21,Player A
1255,PatternLearningPlayer,237,212,449,30,27,Player A
1256,PatternLearningPlayer,185,235,420,13,31,PatternLearningPlayer
1257,PatternLearningPlayer,282,212,494,42,16,Player A
1258,PatternLearningPlayer,323,193,516,40,8,Player A
1259,PatternLearningPlayer,284,189,473,30,19,Player A
1260,PatternLearningPlayer,244,194,438,22,28,Player A
1261,PatternLearningPlayer,249,204,453,25,24,Player A
1262,PatternLearningPlayer,289,204,493,32,13,Player A
1263,PatternLearningPlayer,275,215,490,41,17,Player A
1264,PatternLearningPlayer,247,212,459,25,22,Player A
1265,PatternLearningPlayer,264,229,493,38,15,Player A
1266,PatternLearningPlayer,275,210,485,30,15,Player A
1267,PatternLearningPlayer,256,206,462,25,21,Player A
1268,PatternLearningPlayer,345,190,535,53,6,Player A
1269,PatternLearningPlayer,256,211,467,30,21,Player A
1270,PatternLearningPlayer,256,231,487,35,16,Player A
1271,PatternLearningPlayer,248,218,466,26,20,Player A
1272,PatternLearningPlayer,218,218,436,20,28,Tie
1273,PatternLearningPlayer,274,214,488,39,17,Player A
1274,PatternLearningPlayer,138,223,361,8,49,PatternLearningPlayer
1275,PatternLearningPlayer,290,215,505,38,11,Player A
1276,PatternLearningPlayer,272,222,494,39,15,Player A
1277,PatternLearningPlayer,296,191,487,35,16,Player A
1278,PatternLearningPlayer,286,201,487,35,16,Player A
1279,PatternLearningPlayer,226,201,427,17,30,Player A
1280,PatternLearningPlayer,253,203,456,22,22,Player A
1281,PatternLearningPlayer,305,195,500,36,12,Player A
1282,PatternLearningPlayer,254,199,453,34,27,Player A
1283,PatternLearningPlayer,244,204,448,17,23,Player A
1284,PatternLearningPlayer,249,209,458,30,24,Player A
1285,PatternLearningPlayer,261,221,482,33,17,Player A
1286,PatternLearningPlayer,290,205,495,40,15,Player A
1287,PatternLearningPlayer,242,227,469,32,21,Player A
1288,PatternLearningPlayer,263,213,476,24,16,Player A
1289,PatternLearningPlayer,285,215,500,39,13,Player A
1290,PatternLearningPlayer,318,193,511,44,11,Player A
1291,PatternLearningPlayer,181,221,402,10,36,PatternLearningPlayer
1292,PatternLearningPlayer,249,219,468,31,21,Player A
1293,PatternLearningPlayer,331,196,527,48,7,Player A
1294,PatternLearningPlayer,261,211,472,26,18,Player A
1295,PatternLearningPlayer,215,215,430,23,31,Tie
1296,PatternLearningPlayer,290,205,495,37,14,Player A
1297,PatternLearningPlayer,246,216,462,28,22,Player A
1298,PatternLearningPlayer,311,186,497,36,13,Player A
1299,PatternLearningPlayer,280,175,455,30,25,Player A
1300,PatternLearningPlayer,335,190,525,46,7,Player A
1301,PatternLearningPlayer,247,232,479,30,17,Player A
1302,PatternLearningPlayer,263,198,461,33,24,Player A
1303,PatternLearningPlayer,303,203,506,39,11,Player A
1304,PatternLearningPlayer,259,219,478,35,19,Player A
1305,PatternLearningPlayer,208,223,431,18,29,PatternLearningPlayer
1306,PatternLearningPlayer,192,247,439,17,26,PatternLearningPlayer
1307,PatternLearningPlayer,286,211,497,30,11,Player A
1308,PatternLearningPlayer,282,207,489,31,14,Player A
1309,PatternLearningPlayer,267,212,479,27,16,Player A
1310,PatternLearningPlayer,292,197,489,34,15,Player A
1311,PatternLearningPlayer,196,206,402,13,37,PatternLearningPlayer
1312,PatternLearningPlayer,280,210,490,32,14,Player A
1313,PatternLearningPlayer,246,206,452,24,24,Player A
1314,PatternLearningPlayer,209,224,433,17,28,PatternLearningPlayer
1315,PatternLearningPlayer,246,206,452,30,26,Player A
1316,PatternLearningPlayer,318,203,521,45,8,Player A
1317,PatternLearningPlayer,308,183,491,36,15,Player A
1318,PatternLearningPlayer,281,216,497,36,13,Player A
1319,PatternLearningPlayer,279,219,498,40,14,Player A
1320,PatternLearningPlayer,271,211,482,30,16,Player A
1321,PatternLearningPlayer,236,221,457,23,22,Player A
1322,PatternLearningPlayer,260,210,470,30,20,Player A
1323,PatternLearningPlayer,212,227,439,20,27,PatternLearningPlayer
1324,PatternLearningPlayer,234,214,448,23,25,Player A
1325,PatternLearningPlayer,245,215,460,23,21,Player A
1326,PatternLearningPlayer,296,196,492,34,14,Player A
1327,PatternLearningPlayer,220,210,430,23,31,Player A
1328,PatternLearningPlayer,343,188,531,43,4,Player A
1329,PatternLearningPlayer,239,214,453,25,24,Player A
1330,PatternLearningPlayer,230,195,425,21,32,Player A
1331,PatternLearningPlayer,285,210,495,40,15,Player A
1332,PatternLearningPlayer,231,226,457,26,23,Player A
1333,PatternLearningPlayer,309,204,513,40,9,Player A
1334,PatternLearningPlayer,313,198,511,47,12,Player A
1335,PatternLearningPlayer,308,223,531,46,5,Player A
1336,PatternLearningPlayer,238,203,441,19,26,Player A
1337,PatternLearningPlayer,303,198,501,34,11,Player A
1338,PatternLearningPlayer,270,200,470,30,20,Player A
1339,PatternLearningPlayer,205,225,430,20,30,PatternLearningPlayer
1340,PatternLearningPlayer,225,230,455,24,23,PatternLearningPlayer
1341,PatternLearningPlayer,251,216,467,36,23,Player A
1342,PatternLearningPlayer,270,185,455,27,24,Player A
1343,PatternLearningPlayer,254,209,463,20,19,Player A
1344,PatternLearningPlayer,278,218,496,32,12,Player A
1345,PatternLearningPlayer,278,193,471,31,20,Player A
1346,PatternLearningPlayer,288,223,511,35,8,Player A
1347,PatternLearningPlayer,249,219,468,28,20,Player A
1348,PatternLearningPlayer,216,221,437,15,26,PatternLearningPlayer
1349,PatternLearningPlayer,311,206,517,38,7,Player A
1350,PatternLearningPlayer,274,209,483,40,19,Player A
1351,PatternLearningPlayer,219,219,438,16,26,Tie
1352,PatternLearningPlayer,230,225,455,21,22,Player A
1353,PatternLearningPlayer,196,211,407,21,38,PatternLearningPlayer
1354,PatternLearningPlayer,278,223,501,34,11,Player A
1355,PatternLearningPlayer,300,215,515,36,7,Player A
1356,PatternLearningPlayer,226,206,432,19,29,Player A
1357,PatternLearningPlayer,348,193,541,53,4,Player A
1358,PatternLearningPlayer,231,226,457,20,21,Player A
1359,PatternLearningPlayer,284,199,483,40,19,Player A
1360,PatternLearningPlayer,217,227,444,22,26,PatternLearningPlayer
1361,PatternLearningPlayer,257,207,464,24,20,Player A
1362,PatternLearningPlayer,245,225,470,33,21,Player A
1363,PatternLearningPlayer,258,203,461,27,22,Player A
1364,PatternLearningPlayer,328,218,546,52,2,Player A
1365,PatternLearningPlayer,277,217,494,36,14,Player A
1366,PatternLearningPlayer,173,238,411,13,34,PatternLearningPlayer
1367,PatternLearningPlayer,222,222,444,25,27,Tie
1368,PatternLearningPlayer,202,217,419,15,32,PatternLearningPlayer
1369,PatternLearningPlayer,249,219,468,34,22,Player A
1370,PatternLearningPlayer,267,197,464,33,23,Player A
1371,PatternLearningPlayer,270,220,490,35,15,Player A
1372,PatternLearningPlayer,240,225,465,31,22,Player A
1373,PatternLearningPlayer,250,205,455,24,23,Player A
1374,PatternLearningPlayer,174,229,403,14,37,PatternLearningPlayer
1375,PatternLearningPlayer,279,199,478,29,17,Player A
1376,PatternLearningPlayer,267,212,479,27,16,Player A
1377,PatternLearningPlayer,309,204,513,43,10,Player A
1378,PatternLearningPlayer,288,203,491,42,17,Player A
1379,PatternLearningPlayer,265,200,465,28,21,Player A
1380,PatternLearningPlayer,278,218,496,35,13,Player A
1381,PatternLearningPlayer,214,219,433,23,30,PatternLearningPlayer
1382,PatternLearningPlayer,286,206,492,37,15,Player A
1383,PatternLearningPlayer,256,206,462,31,23,Player A
1384,PatternLearningPlayer,235,215,450,22,24,Player A
1385,PatternLearningPlayer,274,209,483,34,17,Player A
1386,PatternLearningPlayer,267,227,494,30,12,Player A
1387,PatternLearningPlayer,291,216,507,40,11,Player A
1388,PatternLearningPlayer,181,226,407,15,36,PatternLearningPlayer
1389,PatternLearningPlayer,215,210,425,15,30,Player A
1390,PatternLearningPlayer,205,195,400,14,38,Player A
1391,PatternLearningPlayer,310,195,505,41,12,Player A
1392,PatternLearningPlayer,200,225,425,15,30,PatternLearningPlayer
1393,PatternLearningPlayer,225,235,460,23,21,PatternLearningPlayer
1394,PatternLearningPlayer,189,229,418,14,32,PatternLearningPlayer
1395,PatternLearningPlayer,256,211,467,27,20,Player A
1396,PatternLearningPlayer,232,212,444,22,26,Player A
1397,PatternLearningPlayer,253,208,461,24,21,Player A
1398,PatternLearningPlayer,268,198,466,26,20,Player A
1399,PatternLearningPlayer,276,221,497,30,11,Player A
1400,PatternLearningPlayer,251,206,457,29,24,Player A
1401,PatternLearningPlayer,260,230,490,29,13,Player A
1402,PatternLearningPlayer,324,204,528,49,7,Player A
1403,PatternLearningPlayer,285,225,510,34,8,Player A
1404,PatternLearningPlayer,304,209,513,43,10,Player A
1405,PatternLearningPlayer,271,206,477,28,17,Player A
1406,PatternLearningPlayer,296,206,502,38,12,Player A
1407,PatternLearningPlayer,290,200,490,23,11,Player A
1408,PatternLearningPlayer,281,211,492,34,14,Player A
1409,PatternLearningPlayer,261,211,472,35,21,Player A
1410,PatternLearningPlayer,291,196,487,38,17,Player A
1411,PatternLearningPlayer,286,206,492,34,14,Player A
1412,PatternLearningPlayer,323,203,526,44,6,Player A
1413,PatternLearningPlayer,246,216,462,28,22,Player A
1414,PatternLearningPlayer,269,209,478,35,19,Player A
1415,PatternLearningPlayer,273,213,486,37,17,Player A
1416,PatternLearningPlayer,258,228,486,37,17,Player A
1417,PatternLearningPlayer,319,214,533,45,4,Player A
1418,PatternLearningPlayer,253,223,476,27,17,Player A
1419,PatternLearningPlayer,240,215,455,24,23,Player A
1420,PatternLearningPlayer,216,206,422,18,32,Player A
1421,PatternLearningPlayer,294,209,503,45,14,Player A
1422,PatternLearningPlayer,298,213,511,38,9,Player A
1423,PatternLearningPlayer,222,207,429,19,30,Player A
1424,PatternLearningPlayer,228,223,451,17,22,Player A
1425,PatternLearningPlayer,288,203,491,33,14,Player A
1426,PatternLearningPlayer,274,219,493,41,16,Player A
1427,PatternLearningPlayer,230,210,440,21,27,Player A
1428,PatternLearningPlayer,245,205,450,28,26,Player A
1429,PatternLearningPlayer,232,222,454,26,24,Player A
1430,PatternLearningPlayer,256,211,467,33,22,Player A
1431,PatternLearningPlayer,312,172,484,38,18,Player A
1432,PatternLearningPlayer,294,189,483,31,16,Player A
1433,PatternLearningPlayer,268,188,456,28,24,Player A
1434,PatternLearningPlayer,236,226,462,31,23,Player A
1435,PatternLearningPlayer,251,211,462,25,21,Player A
1436,PatternLearningPlayer,233,208,441,22,27,Player A
1437,PatternLearningPlayer,259,214,473,36,21,Player A
1438,PatternLearningPlayer,239,224,463,23,20,Player A
1439,PatternLearningPlayer,301,201,502,38,12,Player A
1440,PatternLearningPlayer,192,237,429,22,31,PatternLearningPlayer
1441,PatternLearningPlayer,186,241,427,17,30,PatternLearningPlayer
1442,PatternLearningPlayer,301,201,502,41,13,Player A
1443,PatternLearningPlayer,271,216,487,38,17,Player A
1444,PatternLearningPlayer,301,191,492,34,14,Player A
1445,PatternLearningPlayer,220,225,445,23,26,PatternLearningPlayer
1446,PatternLearningPlayer,284,204,488,33,15,Player A
1447,PatternLearningPlayer,241,211,452,21,23,Player A
1448,PatternLearningPlayer,262,197,459,22,21,Player A
1449,PatternLearningPlayer,237,202,439,32,31,Player A
1450,PatternLearningPlayer,238,213,451,26,25,Player A
1451,PatternLearningPlayer,202,222,424,26,34,PatternLearningPlayer
1452,PatternLearningPlayer,264,214,478,29,17,Player A
1453,PatternLearningPlayer,254,199,453,19,22,Player A
1454,PatternLearningPlayer,271,211,482,30,16,Player A
1455,PatternLearningPlayer,287,212,499,38,13,Player A
1456,PatternLearningPlayer,240,210,450,28,26,Player A
1457,PatternLearningPlayer,152,242,394,11,39,PatternLearningPlayer
1458,PatternLearningPlayer,316,196,512,39,9,Player A
1459,PatternLearningPlayer,322,207,529,44,5,Player A
1460,PatternLearningPlayer,291,191,482,30,16,Player A
1461,PatternLearningPlayer,240,195,435,22,29,Player A
1462,PatternLearningPlayer,244,234,478,26,16,Player A
1463,PatternLearningPlayer,304,194,498,37,13,Player A
1464,PatternLearningPlayer,265,220,485,27,14,Player A
1465,PatternLearningPlayer,288,203,491,33,14,Player A
1466,PatternLearningPlayer,290,200,490,32,14,Player A
1467,PatternLearningPlayer,267,207,474,28,18,Player A
1468,PatternLearningPlayer,249,224,473,27,18,Player A
1469,PatternLearningPlayer,220,220,440,21,27,Tie
1470,PatternLearningPlayer,273,188,461,30,23,Player A
1471,PatternLearningPlayer,300,205,505,44,13,Player A
1472,PatternLearningPlayer,292,207,499,38,13,Player A
1473,PatternLearningPlayer,277,207,484,29,15,Player A
1474,PatternLearningPlayer,281,216,497,36,13,Player A
1475,PatternLearningPlayer,259,209,468,34,22,Player A
1476,PatternLearningPlayer,329,194,523,47,8,Player A
1477,PatternLearningPlayer,210,235,445,23,26,PatternLearningPlayer
1478,PatternLearningPlayer,267,212,479,33,18,Player A
1479,PatternLearningPlayer,268,198,466,32,22,Player A
1480,PatternLearningPlayer,282,222,504,43,13,Player A
1481,PatternLearningPlayer,264,209,473,36,21,Player A
1482,PatternLearningPlayer,292,202,494,36,14,Player A
1483,PatternLearningPlayer,257,227,484,29,15,Player A
1484,PatternLearningPlayer,230,220,450,19,23,Player A
1485,PatternLearningPlayer,240,225,465,25,20,Player A
1486,PatternLearningPlayer,240,220,460,32,24,Player A
1487,PatternLearningPlayer,296,191,487,35,16,Player A
1488,PatternLearningPlayer,253,223,476,30,18,Player A
1489,PatternLearningPlayer,223,203,426,22,32,Player A
1490,PatternLearningPlayer,313,203,516,40,8,Player A
1491,PatternLearningPlayer,152,222,374,12,46,PatternLearningPlayer
1492,PatternLearningPlayer,235,200,435,22,29,Player A
1493,PatternLearningPlayer,250,200,450,25,25,Player A
1494,PatternLearningPlayer,282,207,489,34,15,Player A
1495,PatternLearningPlayer,227,217,444,25,27,Player A
1496,PatternLearningPlayer,218,223,441,19,26,PatternLearningPlayer
1497,PatternLearningPlayer,304,194,498,40,14,Player A
1498,PatternLearningPlayer,250,195,445,17,24,Player A
1499,PatternLearningPlayer,207,217,424,23,33,PatternLearningPlayer
1500,PatternLearningPlayer,207,227,434,15,27,PatternLearningPlayer
1501,PatternLearningPlayer,274,184,458,27,23,Player A
1502,PatternLearningPlayer,291,196,487,32,15,Player A
1503,PatternLearningPlayer,188,213,401,15,38,PatternLearningPlayer
1504,PatternLearningPlayer,295,190,485,39,18,Player A
1505,PatternLearningPlayer,329,209,538,53,5,Player A
1506,PatternLearningPlayer,304,209,513,40,9,Player A
1507,PatternLearningPlayer,315,185,500,42,14,Player A
1508,PatternLearningPlayer,290,200,490,32,14,Player A
1509,PatternLearningPlayer,312,202,514,38,8,Player A
1510,PatternLearningPlayer,219,209,428,21,31,Player A
1511,PatternLearningPlayer,252,217,469,23,18,Player A
1512,PatternLearningPlayer,274,194,468,25,19,Player A
1513,PatternLearningPlayer,244,204,448,23,25,Player A
1514,PatternLearningPlayer,300,190,490,38,16,Player A
1515,PatternLearningPlayer,238,193,431,21,30,Player A
1516,PatternLearningPlayer,305,190,495,37,14,Player A
1517,PatternLearningPlayer,252,217,469,32,21,Player A
1518,PatternLearningPlayer,258,223,481,32,17,Player A
1519,PatternLearningPlayer,253,228,481,26,15,Player A
1520,PatternLearningPlayer,237,207,444,25,27,Player A
1521,PatternLearningPlayer,316,206,522,46,8,Player A
1522,PatternLearningPlayer,246,226,472,29,19,Player A
1523,PatternLearningPlayer,277,197,474,28,18,Player A
1524,PatternLearningPlayer,214,219,433,20,29,PatternLearningPlayer
1525,PatternLearningPlayer,216,226,442,23,27,PatternLearningPlayer
1526,PatternLearningPlayer,350,185,535,50,5,Player A
1527,PatternLearningPlayer,245,225,470,33,21,Player A
1528,PatternLearningPlayer,246,216,462,28,22,Player A
1529,PatternLearningPlayer,179,239,418,20,34,PatternLearningPlayer
1530,PatternLearningPlayer,276,211,487,35,16,Player A
1531,PatternLearningPlayer,214,209,423,19,32,Player A
1532,PatternLearningPlayer,278,213,491,39,16,Player A
1533,PatternLearningPlayer,268,208,476,30,18,Player A
1534,PatternLearningPlayer,296,211,507,37,10,Player A
1535,PatternLearningPlayer,251,211,462,31,23,Player A
1536,PatternLearningPlayer,271,206,477,34,19,Player A
1537,PatternLearningPlayer,270,205,475,29,18,Player A
1538,PatternLearningPlayer,281,216,497,36,13,Player A
1539,PatternLearningPlayer,250,230,480,28,16,Player A
1540,PatternLearningPlayer,222,242,464,24,20,PatternLearningPlayer
1541,PatternLearningPlayer,305,205,510,40,10,Player A
1542,PatternLearningPlayer,281,181,462,31,23,Player A
1543,PatternLearningPlayer,263,213,476,30,18,Player A
1544,PatternLearningPlayer,218,228,446,27,27,PatternLearningPlayer
1545,PatternLearningPlayer,212,202,414,16,34,Player A
1546,PatternLearningPlayer,296,206,502,38,12,Player A
1547,PatternLearningPlayer,256,206,462,28,22,Player A
1548,PatternLearningPlayer,286,211,497,36,13,Player A
1549,PatternLearningPlayer,249,214,463,35,24,Player A
1550,PatternLearningPlayer,260,205,465,31,22,Player A
1551,PatternLearningPlayer,233,213,446,24,26,Player A
1552,PatternLearningPlayer,220,230,450,25,25,PatternLearningPlayer
1553,PatternLearningPlayer,282,197,479,36,19,Player A
1554,PatternLearningPlayer,297,192,489,34,15,Player A
1555,PatternLearningPlayer,228,228,456,22,22,Tie
1556,PatternLearningPlayer,307,207,514,41,9,Player A
1557,PatternLearningPlayer,303,223,526,53,9,Player A
1558,PatternLearningPlayer,291,226,517,44,9,Player A
1559,PatternLearningPlayer,238,208,446,24,26,Player A
1560,PatternLearningPlayer,303,213,516,46,10,Player A
1561,PatternLearningPlayer,282,192,474,34,20,Player A
1562,PatternLearningPlayer,288,193,481,29,16,Player A
1563,PatternLearningPlayer,271,221,492,34,14,Player A
1564,PatternLearningPlayer,280,205,485,27,14,Player A
1565,PatternLearningPlayer,293,193,486,37,17,Player A
1566,PatternLearningPlayer,290,210,500,36,12,Player A
1567,PatternLearningPlayer,260,215,475,35,20,Player A
1568,PatternLearningPlayer,249,199,448,20,24,Player A
1569,PatternLearningPlayer,156,221,377,6,43,PatternLearningPlayer
1570,PatternLearningPlayer,249,214,463,23,20,Player A
1571,PatternLearningPlayer,280,195,475,32,19,Player A
1572,PatternLearningPlayer,239,214,453,16,21,Player A
1573,PatternLearningPlayer,299,199,498,34,12,Player A
1574,PatternLearningPlayer,251,216,467,24,19,Player A
1575,PatternLearningPlayer,224,234,458,27,23,PatternLearningPlayer
1576,PatternLearningPlayer,272,227,499,35,12,Player A
1577,PatternLearningPlayer,277,202,479,27,16,Player A
1578,PatternLearningPlayer,252,222,474,28,18,Player A
1579,PatternLearningPlayer,236,216,452,24,24,Player A
1580,PatternLearningPlayer,260,210,470,30,20,Player A
1581,PatternLearningPlayer,308,208,516,46,10,Player A
1582,PatternLearningPlayer,237,207,444,22,26,Player A
1583,PatternLearningPlayer,225,230,455,24,23,PatternLearningPlayer
1584,PatternLearningPlayer,319,199,518,39,7,Player A
1585,PatternLearningPlayer,268,188,456,31,25,Player A
1586,PatternLearningPlayer,218,228,446,24,26,PatternLearningPlayer
1587,PatternLearningPlayer,258,188,446,27,27,Player A
1588,PatternLearningPlayer,281,211,492,31,13,Player A
1589,PatternLearningPlayer,269,204,473,30,19,Player A
1590,PatternLearningPlayer,338,193,531,49,6,Player A
1591,PatternLearningPlayer,224,224,448,26,26,Tie
1592,PatternLearningPlayer,275,215,490,23,11,Player A
1593,PatternLearningPlayer,245,220,465,28,21,Player A
1594,PatternLearningPlayer,260,210,470,30,20,Player A
1595,PatternLearningPlayer,235,200,435,16,27,Player A
1596,PatternLearningPlayer,250,195,445,26,27,Player A
1597,PatternLearningPlayer,263,218,481,32,17,Player A
1598,PatternLearningPlayer,271,206,477,31,18,Player A
1599,PatternLearningPlayer,306,216,522,43,7,Player A
1600,PatternLearningPlayer,274,199,473,30,19,Player A
1601,PatternLearningPlayer,331,206,537,52,5,Player A
1602,PatternLearningPlayer,249,214,463,23,20,Player A
1603,PatternLearningPlayer,270,195,465,28,21,Player A
1604,PatternLearningPlayer,240,195,435,25,30,Player A
1605,PatternLearningPlayer,298,213,511,47,12,Player A
1606,PatternLearningPlayer,287,207,494,39,15,Player A
1607,PatternLearningPlayer,311,196,507,37,10,Player A
1608,PatternLearningPlayer,238,203,441,25,28,Player A
1609,PatternLearningPlayer,259,214,473,30,19,Player A
1610,PatternLearningPlayer,256,211,467,33,22,Player A
1611,PatternLearningPlayer,166,246,412,11,33,PatternLearningPlayer
1612,PatternLearningPlayer,214,244,458,21,21,PatternLearningPlayer
1613,PatternLearningPlayer,233,218,451,11,20,Player A
1614,PatternLearningPlayer,310,200,510,43,11,Player A
1615,PatternLearningPlayer,244,209,453,31,26,Player A
1616,PatternLearningPlayer,266,196,462,31,23,Player A
1617,PatternLearningPlayer,257,192,449,30,27,Player A
1618,PatternLearningPlayer,310,200,510,37,9,Player A
1619,PatternLearningPlayer,308,193,501,40,13,Player A
1620,PatternLearningPlayer,220,210,430,23,31,Player A
1621,PatternLearningPlayer,249,199,448,26,26,Player A
1622,PatternLearningPlayer,267,212,479,30,17,Player A
1623,PatternLearningPlayer,242,202,444,19,25,Player A
1624,PatternLearningPlayer,254,209,463,26,21,Player A
1625,PatternLearningPlayer,210,225,435,25,30,PatternLearningPlayer
1626,PatternLearningPlayer,260,195,455,24,23,Player A
1627,PatternLearningPlayer,304,194,498,34,12,Player A
1628,PatternLearningPlayer,297,202,499,29,10,Player A
1629,PatternLearningPlayer,293,208,501,40,13,Player A
1630,PatternLearningPlayer,238,228,466,26,20,Player A
1631,PatternLearningPlayer,264,199,463,23,20,Player A
1632,PatternLearningPlayer,261,216,477,22,15,Player A
1633,PatternLearningPlayer,323,183,506,39,11,Player A
1634,PatternLearningPlayer,307,212,519,40,7,Player A
1635,PatternLearningPlayer,302,187,489,34,15,Player A
1636,PatternLearningPlayer,204,224,428,15,29,PatternLearningPlayer
1637,PatternLearningPlayer,251,211,462,28,22,Player A
1638,PatternLearningPlayer,313,198,511,44,11,Player A
1639,PatternLearningPlayer,249,219,468,31,21,Player A
1640,PatternLearningPlayer,271,221,492,34,14,Player A
1641,PatternLearningPlayer,264,199,463,29,22,Player A
1642,PatternLearningPlayer,244,219,463,26,21,Player A
1643,PatternLearningPlayer,279,219,498,37,13,Player A
1644,PatternLearningPlayer,223,203,426,22,32,Player A
1645,PatternLearningPlayer,247,217,464,30,22,Player A
1646,PatternLearningPlayer,279,204,483,37,18,Player A
1647,PatternLearningPlayer,267,222,489,34,15,Player A
1648,PatternLearningPlayer,297,202,499,35,12,Player A
1649,PatternLearningPlayer,261,196,457,23,22,Player A
1650,PatternLearningPlayer,327,197,524,48,8,Player A
1651,PatternLearningPlayer,255,230,485,33,16,Player A
1652,PatternLearningPlayer,278,208,486,34,16,Player A
1653,PatternLearningPlayer,275,210,485,36,17,Player A
1654,PatternLearningPlayer,242,237,479,33,18,Player A
1655,PatternLearningPlayer,322,217,539,48,3,Player A
1656,PatternLearningPlayer,239,214,453,25,24,Player A
1657,PatternLearningPlayer,300,200,500,39,13,Player A
1658,PatternLearningPlayer,284,214,498,37,13,Player A
1659,PatternLearningPlayer,305,200,505,38,11,Player A
1660,PatternLearningPlayer,258,183,441,22,27,Player A
1661,PatternLearningPlayer,204,204,408,19,37,Tie
1662,PatternLearningPlayer,265,210,475,26,17,Player A
1663,PatternLearningPlayer,322,207,529,50,7,Player A
1664,PatternLearningPlayer,200,230,430,14,28,PatternLearningPlayer
1665,PatternLearningPlayer,203,223,426,19,31,PatternLearningPlayer
1666,PatternLearningPlayer,226,181,407,18,37,Player A
1667,PatternLearningPlayer,203,218,421,14,31,PatternLearningPlayer
1668,PatternLearningPlayer,261,206,467,33,22,Player A
1669,PatternLearningPlayer,287,192,479,27,16,Player A
1670,PatternLearningPlayer,196,236,432,22,30,PatternLearningPlayer
1671,PatternLearningPlayer,307,197,504,43,13,Player A
1672,PatternLearningPlayer,314,204,518,36,6,Player A
1673,PatternLearningPlayer,238,218,456,28,24,Player A
1674,PatternLearningPlayer,225,230,455,30,25,PatternLearningPlayer
1675,PatternLearningPlayer,287,197,484,41,19,Player A
1676,PatternLearningPlayer,275,210,485,36,17,Player A
1677,PatternLearningPlayer,288,208,496,35,13,Player A
1678,PatternLearningPlayer,206,231,437,21,28,PatternLearningPlayer
1679,PatternLearningPlayer,229,204,433,20,29,Player A
1680,PatternLearningPlayer,369,184,553,56,1,Player A
1681,PatternLearningPlayer,229,214,443,27,28,Player A
1682,PatternLearningPlayer,370,175,545,51,2,Player A
1683,PatternLearningPlayer,269,204,473,33,20,Player A
1684,PatternLearningPlayer,232,217,449,18,23,Player A
1685,PatternLearningPlayer,237,222,459,28,23,Player A
1686,PatternLearningPlayer,251,221,472,32,20,Player A
1687,PatternLearningPlayer,223,233,456,28,24,PatternLearningPlayer
1688,PatternLearningPlayer,276,206,482,36,18,Player A
1689,PatternLearningPlayer,328,193,521,39,6,Player A
1690,PatternLearningPlayer,159,224,383,9,42,PatternLearningPlayer
1691,PatternLearningPlayer,295,195,490,32,14,Player A
1692,PatternLearningPlayer,280,200,480,34,18,Player A
1693,PatternLearningPlayer,265,190,455,27,24,Player A
1694,PatternLearningPlayer,199,214,413,15,34,PatternLearningPlayer
1695,PatternLearningPlayer,231,201,432,22,30,Player A
1696,PatternLearningPlayer,235,230,465,25,20,Player A
1697,PatternLearningPlayer,206,201,407,21,38,Player A
1698,PatternLearningPlayer,246,211,457,29,24,Player A
1699,PatternLearningPlayer,240,210,450,34,28,Player A
1700,PatternLearningPlayer,282,207,489,34,15,Player A
1701,PatternLearningPlayer,223,218,441,16,25,Player A
1702,PatternLearningPlayer,174,214,388,11,41,PatternLearningPlayer
1703,PatternLearningPlayer,246,201,447,22,25,Player A
1704,PatternLearningPlayer,252,212,464,36,24,Player A
1705,PatternLearningPlayer,232,222,454,23,23,Player A
1706,PatternLearningPlayer,219,219,438,25,29,Tie
1707,PatternLearningPlayer,268,203,471,28,19,Player A
1708,PatternLearningPlayer,233,208,441,31,30,Player A
1709,PatternLearningPlayer,222,217,439,20,27,Player A
1710,PatternLearningPlayer,279,179,458,24,22,Player A
1711,PatternLearningPlayer,305,185,490,35,15,Player A
1712,PatternLearningPlayer,334,184,518,39,7,Player A
1713,PatternLearningPlayer,256,216,472,26,18,Player A
1714,PatternLearningPlayer,243,208,451,29,26,Player A
1715,PatternLearningPlayer,330,190,520,44,8,Player A
1716,PatternLearningPlayer,241,216,457,29,24,Player A
1717,PatternLearningPlayer,290,195,485,33,16,Player A
1718,PatternLearningPlayer,317,212,529,44,5,Player A
1719,PatternLearningPlayer,214,224,438,25,29,PatternLearningPlayer
1720,PatternLearningPlayer,236,221,457,23,22,Player A
1721,PatternLearningPlayer,238,208,446,27,27,Player A
1722,PatternLearningPlayer,295,210,505,35,10,Player A
1723,PatternLearningPlayer,303,193,496,35,13,Player A
1724,PatternLearningPlayer,218,223,441,19,26,PatternLearningPlayer
1725,PatternLearningPlayer,268,203,471,28,19,Player A
1726,PatternLearningPlayer,268,213,481,29,16,Player A
1727,PatternLearningPlayer,324,199,523,47,8,Player A
1728,PatternLearningPlayer,283,218,501,43,14,Player A
1729,PatternLearningPlayer,270,225,495,34,13,Player A
1730,PatternLearningPlayer,294,224,518,42,8,Player A
1731,PatternLearningPlayer,255,220,475,32,19,Player A
1732,PatternLearningPlayer,261,206,467,27,20,Player A
1733,PatternLearningPlayer,225,215,440,21,27,Player A
1734,PatternLearningPlayer,313,208,521,45,8,Player A
1735,PatternLearningPlayer,228,203,431,21,30,Player A
1736,PatternLearningPlayer,245,200,445,26,27,Player A
1737,PatternLearningPlayer,299,209,508,47,13,Player A
1738,PatternLearningPlayer,164,209,373,11,46,PatternLearningPlayer
1739,PatternLearningPlayer,240,215,455,21,22,Player A
1740,PatternLearningPlayer,234,209,443,21,26,Player A
1741,PatternLearningPlayer,233,238,471,28,19,PatternLearningPlayer
1742,PatternLearningPlayer,272,212,484,32,16,Player A
1743,PatternLearningPlayer,264,209,473,30,19,Player A
1744,PatternLearningPlayer,203,228,431,21,30,PatternLearningPlayer
1745,PatternLearningPlayer,221,211,432,22,30,Player A
1746,PatternLearningPlayer,216,206,422,18,32,Player A
1747,PatternLearningPlayer,247,222,469,26,19,Player A
1748,PatternLearningPlayer,247,232,479,27,16,Player A
1749,PatternLearningPlayer,228,213,441,22,27,Player A
1750,PatternLearningPlayer,298,203,501,31,10,Player A
1751,PatternLearningPlayer,257,222,479,27,16,Player A
1752,PatternLearningPlayer,289,209,498,37,13,Player A
1753,PatternLearningPlayer,259,199,458,24,22,Player A
1754,PatternLearningPlayer,238,223,461,30,23,Player A
1755,PatternLearningPlayer,253,208,461,27,22,Player A
1756,PatternLearningPlayer,265,210,475,29,18,Player A
1757,PatternLearningPlayer,305,200,505,44,13,Player A
1758,PatternLearningPlayer,239,224,463,29,22,Player A
1759,PatternLearningPlayer,242,217,459,19,20,Player A
1760,PatternLearningPlayer,338,158,496,35,13,Player A
1761,PatternLearningPlayer,247,217,464,27,21,Player A
1762,PatternLearningPlayer,295,215,510,43,11,Player A
1763,PatternLearningPlayer,211,226,437,18,27,PatternLearningPlayer
1764,PatternLearningPlayer,290,205,495,34,13,Player A
1765,PatternLearningPlayer,239,219,458,24,22,Player A
1766,PatternLearningPlayer,317,207,524,54,10,Player A
1767,PatternLearningPlayer,280,220,500,39,13,Player A
1768,PatternLearningPlayer,240,215,455,30,25,Player A
1769,PatternLearningPlayer,310,195,505,32,9,Player A
1770,PatternLearningPlayer,270,220,490,38,16,Player A
1771,PatternLearningPlayer,247,187,434,21,29,Player A
1772,PatternLearningPlayer,238,213,451,32,27,Player A
1773,PatternLearningPlayer,317,197,514,47,11,Player A
1774,PatternLearningPlayer,252,217,469,32,21,Player A
1775,PatternLearningPlayer,211,226,437,21,28,PatternLearningPlayer
1776,PatternLearningPlayer,221,211,432,16,28,Player A
1777,PatternLearningPlayer,236,206,442,20,26,Player A
1778,PatternLearningPlayer,204,219,423,16,31,PatternLearningPlayer
1779,PatternLearningPlayer,285,225,510,43,11,Player A
1780,PatternLearningPlayer,279,209,488,27,13,Player A
1781,PatternLearningPlayer,292,212,504,31,9,Player A
1782,PatternLearningPlayer,285,205,490,32,14,Player A
1783,PatternLearningPlayer,291,191,482,36,18,Player A
1784,PatternLearningPlayer,312,207,519,46,9,Player A
1785,PatternLearningPlayer,227,217,444,22,26,Player A
1786,PatternLearningPlayer,208,208,416,15,33,Tie
1787,PatternLearningPlayer,236,216,452,33,27,Player A
1788,PatternLearningPlayer,302,192,494,36,14,Player A
1789,PatternLearningPlayer,316,216,532,50,6,Player A
1790,PatternLearningPlayer,262,217,479,30,17,Player A
1791,PatternLearningPlayer,267,202,469,32,21,Player A
1792,PatternLearningPlayer,301,211,512,48,12,Player A
1793,PatternLearningPlayer,246,221,467,30,21,Player A
1794,PatternLearningPlayer,254,209,463,32,23,Player A
1795,PatternLearningPlayer,182,207,389,9,40,PatternLearningPlayer
1796,PatternLearningPlayer,286,201,487,26,13,Player A
1797,PatternLearningPlayer,322,197,519,43,8,Player A
1798,PatternLearningPlayer,233,233,466,23,19,Tie
1799,PatternLearningPlayer,213,243,456,25,23,PatternLearningPlayer
1800,PatternLearningPlayer,325,200,525,40,5,Player A
1801,PatternLearningPlayer,223,218,441,16,25,Player A
1802,PatternLearningPlayer,270,195,465,34,23,Player A
1803,PatternLearningPlayer,275,190,465,31,22,Player A
1804,PatternLearningPlayer,284,214,498,31,11,Player A
1805,PatternLearningPlayer,270,205,475,29,18,Player A
1806,PatternLearningPlayer,273,208,481,26,15,Player A
1807,PatternLearningPlayer,241,211,452,27,25,Player A
1808,PatternLearningPlayer,301,201,502,32,10,Player A
1809,PatternLearningPlayer,237,227,464,27,21,Player A
1810,PatternLearningPlayer,320,185,505,35,10,Player A
1811,PatternLearningPlayer,292,202,494,36,14,Player A
1812,PatternLearningPlayer,246,196,442,17,25,Player A
1813,PatternLearningPlayer,226,226,452,21,23,Tie
1814,PatternLearningPlayer,336,201,537,46,3,Player A
1815,PatternLearningPlayer,294,189,483,37,18,Player A
1816,PatternLearningPlayer,244,189,433,20,29,Player A
1817,PatternLearningPlayer,292,192,484,35,17,Player A
1818,PatternLearningPlayer,242,227,469,29,20,Player A
1819,PatternLearningPlayer,279,209,488,36,16,Player A
1820,PatternLearningPlayer,280,220,500,36,12,Player A
1821,PatternLearningPlayer,300,210,510,37,9,Player A
1822,PatternLearningPlayer,245,210,455,21,22,Player A
1823,PatternLearningPlayer,291,216,507,37,10,Player A
1824,PatternLearningPlayer,248,213,461,24,21,Player A
1825,PatternLearningPlayer,251,201,452,21,23,Player A
1826,PatternLearningPlayer,312,167,479,27,16,Player A
1827,PatternLearningPlayer,296,216,512,42,10,Player A
1828,PatternLearningPlayer,233,213,446,27,27,Player A
1829,PatternLearningPlayer,251,206,457,20,21,Player A
1830,PatternLearningPlayer,257,202,459,34,25,Player A
1831,PatternLearningPlayer,281,221,502,44,14,Player A
1832,PatternLearningPlayer,249,204,453,25,24,Player A
1833,PatternLearningPlayer,266,216,482,33,17,Player A
1834,PatternLearningPlayer,231,231,462,28,22,Tie
1835,PatternLearningPlayer,259,209,468,37,23,Player A
1836,PatternLearningPlayer,192,217,409,20,37,PatternLearningPlayer
1837,PatternLearningPlayer,218,208,426,16,30,Player A
1838,PatternLearningPlayer,243,218,461,24,21,Player A
1839,PatternLearningPlayer,319,199,518,45,9,Player A
1840,PatternLearningPlayer,263,223,486,37,17,Player A
1841,PatternLearningPlayer,261,211,472,29,19,Player A
1842,PatternLearningPlayer,325,205,530,45,5,Player A
1843,PatternLearningPlayer,288,213,501,43,14,Player A
1844,PatternLearningPlayer,269,189,458,24,22,Player A
1845,PatternLearningPlayer,231,196,427,20,31,Player A
1846,PatternLearningPlayer,253,213,466,29,21,Player A
1847,PatternLearningPlayer,288,203,491,39,16,Player A
1848,PatternLearningPlayer,287,182,469,32,21,Player A
1849,PatternLearningPlayer,318,203,521,48,9,Player A
1850,PatternLearningPlayer,228,223,451,32,27,Player A
1851,PatternLearningPlayer,237,222,459,34,25,Player A
1852,PatternLearningPlayer,315,195,510,43,11,Player A
1853,PatternLearningPlayer,261,216,477,25,16,Player A
1854,PatternLearningPlayer,204,224,428,24,32,PatternLearningPlayer
1855,PatternLearningPlayer,193,208,401,9,36,PatternLearningPlayer
1856,PatternLearningPlayer,265,200,465,28,21,Player A
1857,PatternLearningPlayer,280,215,495,43,16,Player A
1858,PatternLearningPlayer,245,210,455,18,21,Player A
1859,PatternLearningPlayer,291,196,487,35,16,Player A
1860,PatternLearningPlayer,248,218,466,26,20,Player A
1861,PatternLearningPlayer,265,205,470,30,20,Player A
1862,PatternLearningPlayer,319,214,533,48,5,Player A
1863,PatternLearningPlayer,308,193,501,37,12,Player A
1864,PatternLearningPlayer,270,215,485,27,14,Player A
1865,PatternLearningPlayer,235,215,450,28,26,Player A
1866,PatternLearningPlayer,304,184,488,36,16,Player A
1867,PatternLearningPlayer,227,227,454,23,23,Tie
1868,PatternLearningPlayer,265,220,485,33,16,Player A
1869,PatternLearningPlayer,281,206,487,32,15,Player A
1870,PatternLearningPlayer,271,211,482,36,18,Player A
1871,PatternLearningPlayer,306,201,507,37,10,Player A
1872,PatternLearningPlayer,244,219,463,32,23,Player A
1873,PatternLearningPlayer,235,225,460,23,21,Player A
1874,PatternLearningPlayer,264,209,473,27,18,Player A
1875,PatternLearningPlayer,280,185,465,25,20,Player A
1876,PatternLearningPlayer,248,223,471,28,19,Player A
1877,PatternLearningPlayer,224,219,443,15,24,Player A
1878,PatternLearningPlayer,241,211,452,27,25,Player A
1879,PatternLearningPlayer,194,209,403,14,37,PatternLearningPlayer
1880,PatternLearningPlayer,261,216,477,37,20,Player A
1881,PatternLearningPlayer,245,210,455,27,24,Player A
1882,PatternLearningPlayer,242,217,459,31,24,Player A
1883,PatternLearningPlayer,191,221,412,17,35,PatternLearningPlayer
1884,PatternLearningPlayer,249,194,443,24,27,Player A
1885,PatternLearningPlayer,260,215,475,26,17,Player A
1886,PatternLearningPlayer,177,242,419,18,33,PatternLearningPlayer
1887,PatternLearningPlayer,265,210,475,32,19,Player A
1888,PatternLearningPlayer,316,206,522,46,8,Player A
1889,PatternLearningPlayer,319,189,508,41,11,Player A
1890,PatternLearningPlayer,300,195,495,40,15,Player A
1891,PatternLearningPlayer,202,192,394,17,41,Player A
1892,PatternLearningPlayer,308,208,516,43,9,Player A
1893,PatternLearningPlayer,292,212,504,43,13,Player A
1894,PatternLearningPlayer,287,212,499,38,13,Player A
1895,PatternLearningPlayer,239,219,458,21,21,Player A
1896,PatternLearningPlayer,252,207,459,25,22,Player A
1897,PatternLearningPlayer,182,232,414,16,34,PatternLearningPlayer
1898,PatternLearningPlayer,275,210,485,42,19,Player A
1899,PatternLearningPlayer,283,188,471,34,21,Player A
1900,PatternLearningPlayer,275,220,495,34,13,Player A
1901,PatternLearningPlayer,256,201,457,29,24,Player A
1902,PatternLearningPlayer,191,226,417,16,33,PatternLearningPlayer
1903,PatternLearningPlayer,314,199,513,43,10,Player A
1904,PatternLearningPlayer,217,217,434,18,28,Tie
1905,PatternLearningPlayer,220,210,430,20,30,Player A
1906,PatternLearningPlayer,265,215,480,31,17,Player A
1907,PatternLearningPlayer,315,200,515,39,8,Player A
1908,PatternLearningPlayer,193,213,406,17,37,PatternLearningPlayer
1909,PatternLearningPlayer,290,180,470,30,20,Player A
1910,PatternLearningPlayer,208,233,441,19,26,PatternLearningPlayer
1911,PatternLearningPlayer,253,228,481,32,17,Player A
1912,PatternLearningPlayer,258,233,491,30,13,Player A
1913,PatternLearningPlayer,323,203,526,44,6,Player A
1914,PatternLearningPlayer,305,200,505,38,11,Player A
1915,PatternLearningPlayer,218,188,406,14,36,Player A
1916,PatternLearningPlayer,261,211,472,29,19,Player A
1917,PatternLearningPlayer,272,212,484,29,15,Player A
1918,PatternLearningPlayer,274,214,488,24,12,Player A
1919,PatternLearningPlayer,285,210,495,31,12,Player A
1920,PatternLearningPlayer,329,209,538,44,2,Player A
1921,PatternLearningPlayer,273,208,481,32,17,Player A
1922,PatternLearningPlayer,332,197,529,44,5,Player A
1923,PatternLearningPlayer,329,209,538,50,4,Player A
1924,PatternLearningPlayer,274,209,483,34,17,Player A
1925,PatternLearningPlayer,287,187,474,28,18,Player A
1926,PatternLearningPlayer,252,212,464,18,18,Player A
1927,PatternLearningPlayer,269,209,478,32,18,Player A
1928,PatternLearningPlayer,254,214,468,31,21,Player A
1929,PatternLearningPlayer,209,209,418,17,33,Tie
1930,PatternLearningPlayer,260,205,465,31,22,Player A
1931,PatternLearningPlayer,249,214,463,32,23,Player A
1932,PatternLearningPlayer,240,205,445,23,26,Player A
1933,PatternLearningPlayer,221,216,437,24,29,Player A
1934,PatternLearningPlayer,280,225,505,41,12,Player A
1935,PatternLearningPlayer,247,192,439,20,27,Player A
1936,PatternLearningPlayer,246,221,467,33,22,Player A
1937,PatternLearningPlayer,290,205,495,34,13,Player A
1938,PatternLearningPlayer,216,216,432,22,30,Tie
1939,PatternLearningPlayer,227,222,449,24,25,Player A
1940,PatternLearningPlayer,299,199,498,37,13,Player A
1941,PatternLearningPlayer,280,215,495,37,14,Player A
1942,PatternLearningPlayer,312,202,514,44,10,Player A
1943,PatternLearningPlayer,252,212,464,33,23,Player A
1944,PatternLearningPlayer,321,201,522,43,7,Player A
1945,PatternLearningPlayer,267,212,479,33,18,Player A
1946,PatternLearningPlayer,252,197,449,30,27,Player A
1947,PatternLearningPlayer,281,181,462,28,22,Player A
1948,PatternLearningPlayer,272,207,479,36,19,Player A
1949,PatternLearningPlayer,281,191,472,38,22,Player A
1950,PatternLearningPlayer,259,194,453,31,26,Player A
1951,PatternLearningPlayer,268,223,491,30,13,Player A
1952,PatternLearningPlayer,184,214,398,12,38,PatternLearningPlayer
1953,PatternLearningPlayer,310,205,515,39,8,Player A
1954,PatternLearningPlayer,313,203,516,37,7,Player A
1955,PatternLearningPlayer,277,202,479,30,17,Player A
1956,PatternLearningPlayer,247,207,454,23,23,Player A
1957,PatternLearningPlayer,294,214,508,47,13,Player A
1958,PatternLearningPlayer,307,212,519,43,8,Player A
1959,PatternLearningPlayer,255,210,465,25,20,Player A
1960,PatternLearningPlayer,148,228,376,8,44,PatternLearningPlayer
1961,PatternLearningPlayer,282,207,489,40,17,Player A
1962,PatternLearningPlayer,220,205,425,30,35,Player A
1963,PatternLearningPlayer,348,198,546,52,2,Player A
1964,PatternLearningPlayer,275,180,455,33,26,Player A
1965,PatternLearningPlayer,276,196,472,35,21,Player A
1966,PatternLearningPlayer,279,209,488,33,15,Player A
1967,PatternLearningPlayer,251,196,447,22,25,Player A
1968,PatternLearningPlayer,233,208,441,28,29,Player A
1969,PatternLearningPlayer,265,195,460,26,22,Player A
1970,PatternLearningPlayer,241,206,447,25,26,Player A
1971,PatternLearningPlayer,272,187,459,31,24,Player A
1972,PatternLearningPlayer,261,226,487,35,16,Player A
1973,PatternLearningPlayer,272,222,494,36,14,Player A
1974,PatternLearningPlayer,268,233,501,34,11,Player A
1975,PatternLearningPlayer,350,190,540,46,2,Player A
1976,PatternLearningPlayer,283,213,496,32,12,Player A
1977,PatternLearningPlayer,281,231,512,42,10,Player A
1978,PatternLearningPlayer,276,211,487,32,15,Player A
1979,PatternLearningPlayer,257,227,484,32,16,Player A
1980,PatternLearningPlayer,283,228,511,47,12,Player A
1981,PatternLearningPlayer,240,215,455,27,24,Player A
1982,PatternLearningPlayer,244,219,463,26,21,Player A
1983,PatternLearningPlayer,207,232,439,23,28,PatternLearningPlayer
1984,PatternLearningPlayer,325,200,525,46,7,Player A
1985,PatternLearningPlayer,298,193,491,39,16,Player A
1986,PatternLearningPlayer,232,212,444,19,25,Player A
1987,PatternLearningPlayer,256,211,467,30,21,Player A
1988,PatternLearningPlayer,265,220,485,27,14,Player A
1989,PatternLearningPlayer,222,222,444,25,27,Tie
1990,PatternLearningPlayer,226,221,447,25,26,Player A
1991,PatternLearningPlayer,281,201,482,33,17,Player A
1992,PatternLearningPlayer,287,222,509,36,9,Player A
1993,PatternLearningPlayer,261,211,472,32,20,Player A
1994,PatternLearningPlayer,289,214,503,36,11,Player A
1995,PatternLearningPlayer,286,196,482,33,17,Player A
1996,PatternLearningPlayer,291,181,472,29,19,Player A
1997,PatternLearningPlayer,277,192,469,29,20,Player A
1998,PatternLearningPlayer,231,206,437,24,29,Player A
1999,PatternLearningPlayer,251,206,457,23,22,Player A
2000,PatternLearningPlayer,274,204,478,32,18,Player A
2001,PatternLearningPlayer,219,224,443,18,25,PatternLearningPlayer
2002,PatternLearningPlayer,244,219,463,32,23,Player A
2003,PatternLearningPlayer,220,210,430,20,30,Player A
2004,PatternLearningPlayer,242,222,464,24,20,Player A
2005,PatternLearningPlayer,282,222,504,37,11,Player A
2006,PatternLearningPlayer,257,217,474,25,17,Player A
2007,PatternLearningPlayer,268,218,486,31,15,Player A
2008,PatternLearningPlayer,341,181,522,43,7,Player A
2009,PatternLearningPlayer,267,222,489,28,13,Player A
2010,PatternLearningPlayer,245,205,450,25,25,Player A
2011,PatternLearningPlayer,211,196,407,21,38,Player A
2012,PatternLearningPlayer,316,196,512,42,10,Player A
2013,PatternLearningPlayer,299,189,488,36,16,Player A
2014,PatternLearningPlayer,298,208,506,42,12,Player A
2015,PatternLearningPlayer,247,212,459,31,24,Player A
2016,PatternLearningPlayer,214,214,428,21,31,Tie
2017,PatternLearningPlayer,234,204,438,22,28,Player A
2018,PatternLearningPlayer,234,229,463,26,21,Player A
2019,PatternLearningPlayer,233,223,456,22,22,Player A
2020,PatternLearningPlayer,140,240,380,6,42,PatternLearningPlayer
2021,PatternLearningPlayer,272,212,484,38,18,Player A
2022,PatternLearningPlayer,262,202,464,27,21,Player A
2023,PatternLearningPlayer,225,225,450,25,25,Tie
2024,PatternLearningPlayer,256,216,472,29,19,Player A
2025,PatternLearningPlayer,262,222,484,29,15,Player A
2026,PatternLearningPlayer,320,185,505,41,12,Player A
2027,PatternLearningPlayer,294,204,498,34,12,Player A
2028,PatternLearningPlayer,283,213,496,29,11,Player A
2029,PatternLearningPlayer,262,227,489,31,14,Player A
2030,PatternLearningPlayer,312,207,519,46,9,Player A
2031,PatternLearningPlayer,247,202,449,21,24,Player A
2032,PatternLearningPlayer,238,208,446,24,26,Player A
2033,PatternLearningPlayer,289,204,493,35,14,Player A
2034,PatternLearningPlayer,232,207,439,17,26,Player A
2035,PatternLearningPlayer,347,187,534,52,6,Player A
2036,PatternLearningPlayer,218,213,431,24,31,Player A
2037,PatternLearningPlayer,315,195,510,40,10,Player A
2038,PatternLearningPlayer,263,208,471,28,19,Player A
2039,PatternLearningPlayer,257,202,459,22,21,Player A
2040,PatternLearningPlayer,287,207,494,42,16,Player A
2041,PatternLearningPlayer,273,203,476,30,18,Player A
2042,PatternLearningPlayer,264,194,458,27,23,Player A
2043,PatternLearningPlayer,244,199,443,18,25,Player A
2044,PatternLearningPlayer,231,201,432,25,31,Player A
2045,PatternLearningPlayer,199,214,413,15,34,PatternLearningPlayer
2046,PatternLearningPlayer,177,247,424,11,29,PatternLearningPlayer
2047,PatternLearningPlayer,255,225,480,31,17,Player A
2048,PatternLearningPlayer,307,212,519,40,7,Player A
2049,PatternLearningPlayer,293,233,526,47,7,Player A
2050,PatternLearningPlayer,293,218,511,38,9,Player A
2051,PatternLearningPlayer,240,205,445,23,26,Player A
2052,PatternLearningPlayer,288,203,491,36,15,Player A
2053,PatternLearningPlayer,199,234,433,20,29,PatternLearningPlayer
2054,PatternLearningPlayer,210,205,415,14,33,Player A
2055,PatternLearningPlayer,233,198,431,18,29,Player A
2056,PatternLearningPlayer,300,205,505,47,14,Player A
2057,PatternLearningPlayer,352,182,534,49,5,Player A
2058,PatternLearningPlayer,269,209,478,29,17,Player A
2059,PatternLearningPlayer,262,207,469,32,21,Player A
2060,PatternLearningPlayer,271,216,487,32,15,Player A
2061,PatternLearningPlayer,256,211,467,33,22,Player A
2062,PatternLearningPlayer,264,204,468,28,20,Player A
2063,PatternLearningPlayer,302,202,504,49,15,Player A
2064,PatternLearningPlayer,277,207,484,29,15,Player A
2065,PatternLearningPlayer,247,212,459,22,21,Player A
2066,PatternLearningPlayer,276,191,467,30,21,Player A
2067,PatternLearningPlayer,333,188,521,45,8,Player A
2068,PatternLearningPlayer,268,178,446,30,28,Player A
2069,PatternLearningPlayer,218,208,426,25,33,Player A
2070,PatternLearningPlayer,274,224,498,43,15,Player A
2071,PatternLearningPlayer,198,208,406,14,36,PatternLearningPlayer
2072,PatternLearningPlayer,320,195,515,30,5,Player A
2073,PatternLearningPlayer,257,192,449,21,24,Player A
2074,PatternLearningPlayer,257,217,474,28,18,Player A
2075,PatternLearningPlayer,235,215,450,25,25,Player A
2076,PatternLearningPlayer,268,213,481,35,18,Player A
2077,PatternLearningPlayer,239,224,463,23,20,Player A
2078,PatternLearningPlayer,277,217,494,39,15,Player A
2079,PatternLearningPlayer,277,192,469,29,20,Player A
2080,PatternLearningPlayer,230,215,445,26,27,Player A
2081,PatternLearningPlayer,312,212,524,45,7,Player A
2082,PatternLearningPlayer,249,209,458,24,22,Player A
2083,PatternLearningPlayer,207,217,424,14,30,PatternLearningPlayer
2084,PatternLearningPlayer,251,201,452,21,23,Player A
2085,PatternLearningPlayer,295,205,500,36,12,Player A
2086,PatternLearningPlayer,305,200,505,32,9,Player A
2087,PatternLearningPlayer,247,232,479,30,17,Player A
2088,PatternLearningPlayer,314,194,508,35,9,Player A
2089,PatternLearningPlayer,283,203,486,34,16,Player A
2090,PatternLearningPlayer,249,199,448,23,25,Player A
2091,PatternLearningPlayer,304,204,508,35,9,Player A
2092,PatternLearningPlayer,336,196,532,44,4,Player A
2093,PatternLearningPlayer,316,191,507,43,12,Player A
2094,PatternLearningPlayer,201,231,432,16,28,PatternLearningPlayer
2095,PatternLearningPlayer,261,196,457,26,23,Player A
2096,PatternLearningPlayer,259,214,473,39,22,Player A
2097,PatternLearningPlayer,291,221,512,39,9,Player A
2098,PatternLearningPlayer,293,193,486,37,17,Player A
2099,PatternLearningPlayer,274,209,483,37,18,Player A
2100,PatternLearningPlayer,239,229,468,31,21,Player A
2101,PatternLearningPlayer,316,201,517,35,6,Player A
2102,PatternLearningPlayer,231,211,442,29,29,Player A
2103,PatternLearningPlayer,261,216,477,25,16,Player A
2104,PatternLearningPlayer,264,209,473,30,19,Player A
2105,PatternLearningPlayer,269,209,478,32,18,Player A
2106,PatternLearningPlayer,252,227,479,36,19,Player A
2107,PatternLearningPlayer,293,213,506,36,10,Player A
2108,PatternLearningPlayer,248,218,466,26,20,Player A
2109,PatternLearningPlayer,230,215,445,23,26,Player A
2110,PatternLearningPlayer,277,202,479,33,18,Player A
2111,PatternLearningPlayer,317,207,524,45,7,Player A
2112,PatternLearningPlayer,289,209,498,37,13,Player A
2113,PatternLearningPlayer,288,203,491,33,14,Player A
2114,PatternLearningPlayer,269,179,448,26,26,Player A
2115,PatternLearningPlayer,316,191,507,34,9,Player A
2116,PatternLearningPlayer,247,212,459,19,20,Player A
2117,PatternLearningPlayer,244,219,463,26,21,Player A
2118,PatternLearningPlayer,304,204,508,38,10,Player A
2119,PatternLearningPlayer,252,222,474,28,18,Player A
2120,PatternLearningPlayer,257,212,469,26,19,Player A
2121,PatternLearningPlayer,305,210,515,36,7,Player A
2122,PatternLearningPlayer,249,204,453,22,23,Player A
2123,PatternLearningPlayer,314,204,518,42,8,Player A
2124,PatternLearningPlayer,326,186,512,39,9,Player A
2125,PatternLearningPlayer,256,211,467,27,20,Player A
2126,PatternLearningPlayer,256,186,442,29,29,Player A
2127,PatternLearningPlayer,275,200,475,26,17,Player A
2128,PatternLearningPlayer,277,202,479,30,17,Player A
2129,PatternLearningPlayer,252,212,464,27,21,Player A
2130,PatternLearningPlayer,306,211,517,35,6,Player A
2131,PatternLearningPlayer,245,215,460,29,23,Player A
2132,PatternLearningPlayer,295,210,505,44,13,Player A
2133,PatternLearningPlayer,245,205,450,25,25,Player A
2134,PatternLearningPlayer,317,202,519,40,7,Player A
2135,PatternLearningPlayer,279,194,473,30,19,Player A
2136,PatternLearningPlayer,279,184,463,32,23,Player A
2137,PatternLearningPlayer,282,197,479,33,18,Player A
2138,PatternLearningPlayer,238,208,446,18,24,Player A
2139,PatternLearningPlayer,262,192,454,23,23,Player A
2140,PatternLearningPlayer,282,207,489,31,14,Player A
2141,PatternLearningPlayer,215,210,425,21,32,Player A
2142,PatternLearningPlayer,224,219,443,24,27,Player A
2143,PatternLearningPlayer,219,209,428,18,30,Player A
2144,PatternLearningPlayer,220,235,455,24,23,PatternLearningPlayer
2145,PatternLearningPlayer,256,211,467,30,21,Player A
2146,PatternLearningPlayer,213,218,431,18,29,PatternLearningPlayer
2147,PatternLearningPlayer,237,217,454,20,22,Player A
2148,PatternLearningPlayer,321,191,512,45,11,Player A
2149,PatternLearningPlayer,261,211,472,32,20,Player A
2150,PatternLearningPlayer,238,213,451,23,24,Player A
2151,PatternLearningPlayer,234,214,448,35,29,Player A
2152,PatternLearningPlayer,264,204,468,31,21,Player A
2153,PatternLearningPlayer,254,209,463,29,22,Player A
2154,PatternLearningPlayer,260,220,480,31,17,Player A
2155,PatternLearningPlayer,293,223,516,37,7,Player A
2156,PatternLearningPlayer,294,214,508,41,11,Player A
2157,PatternLearningPlayer,293,193,486,31,15,Player A
2158,PatternLearningPlayer,225,230,455,24,23,PatternLearningPlayer
2159,PatternLearningPlayer,204,224,428,12,28,PatternLearningPlayer
2160,PatternLearningPlayer,294,179,473,30,19,Player A
2161,PatternLearningPlayer,280,205,485,36,17,Player A
2162,PatternLearningPlayer,278,203,481,35,18,Player A
2163,PatternLearningPlayer,293,213,506,42,12,Player A
2164,PatternLearningPlayer,310,195,505,44,13,Player A
2165,PatternLearningPlayer,251,206,457,23,22,Player A
0,TitForTat,226,221,447,25,26,Player A
1,TitForTat,236,241,477,25,16,TitForTat
2,TitForTat,228,223,451,26,25,Player A
3,TitForTat,239,244,483,34,17,TitForTat
4,TitForTat,239,234,473,36,21,Player A
5,TitForTat,209,209,418,14,32,Tie
6,TitForTat,215,220,435,22,29,TitForTat
7,TitForTat,223,223,446,21,25,Tie
8,TitForTat,219,214,433,26,31,Player A
9,TitForTat,223,228,451,23,24,TitForTat
10,TitForTat,240,240,480,31,17,Tie
11,TitForTat,223,223,446,18,24,Tie
12,TitForTat,230,230,460,23,21,Tie
13,TitForTat,228,228,456,28,24,Tie
14,TitForTat,226,226,452,21,23,Tie
15,TitForTat,226,221,447,25,26,Player A
16,TitForTat,217,222,439,23,28,TitForTat
17,TitForTat,219,219,438,22,28,Tie
18,TitForTat,234,234,468,25,19,Tie
19,TitForTat,215,210,425,15,30,Player A
20,TitForTat,222,227,449,24,25,TitForTat
21,TitForTat,252,252,504,37,11,Tie
22,TitForTat,223,218,441,22,27,Player A
23,TitForTat,229,234,463,29,22,TitForTat
24,TitForTat,236,231,467,30,21,Player A
25,TitForTat,205,205,410,12,34,Tie
26,TitForTat,229,229,458,27,23,Tie
27,TitForTat,232,232,464,21,19,Tie
28,TitForTat,227,227,454,29,25,Tie
29,TitForTat,228,228,456,25,23,Tie
30,TitForTat,223,223,446,21,25,Tie
31,TitForTat,226,226,452,24,24,Tie
32,TitForTat,219,224,443,24,27,TitForTat
33,TitForTat,230,225,455,24,23,Player A
34,TitForTat,234,239,473,30,19,TitForTat
35,TitForTat,218,213,431,24,31,Player A
36,TitForTat,218,218,436,23,29,Tie
37,TitForTat,231,231,462,28,22,Tie
38,TitForTat,243,248,491,33,14,TitForTat
39,TitForTat,229,229,458,27,23,Tie
40,TitForTat,227,227,454,26,24,Tie
41,TitForTat,227,227,454,26,24,Tie
42,TitForTat,221,221,442,23,27,Tie
43,TitForTat,214,209,423,22,33,Player A
44,TitForTat,235,235,470,27,19,Tie
45,TitForTat,236,241,477,34,19,TitForTat
46,TitForTat,230,225,455,27,24,Player A
47,TitForTat,242,242,484,29,15,Tie
48,TitForTat,224,229,453,22,23,TitForTat
49,TitForTat,210,205,415,14,33,Player A
50,TitForTat,211,216,427,14,29,TitForTat
51,TitForTat,209,204,413,27,38,Player A
52,TitForTat,206,206,412,17,35,Tie
53,TitForTat,224,229,453,31,26,TitForTat
54,TitForTat,234,229,463,23,20,Player A
55,TitForTat,220,225,445,26,27,TitForTat
56,TitForTat,232,232,464,30,22,Tie
57,TitForTat,218,218,436,17,27,Tie
58,TitForTat,233,228,461,30,23,Player A
59,TitForTat,215,215,430,23,31,Tie
60,TitForTat,232,232,464,27,21,Tie
61,TitForTat,225,225,450,25,25,Tie
62,TitForTat,211,216,427,17,30,TitForTat
63,TitForTat,236,236,472,32,20,Tie
64,TitForTat,231,226,457,29,24,Player A
65,TitForTat,233,233,466,32,22,Tie
66,TitForTat,236,241,477,34,19,TitForTat
67,TitForTat,230,230,460,26,22,Tie
68,TitForTat,226,221,447,28,27,Player A
69,TitForTat,226,226,452,24,24,Tie
70,TitForTat,228,233,461,27,22,TitForTat
71,TitForTat,240,235,475,26,17,Player A
72,TitForTat,229,234,463,32,23,TitForTat
73,TitForTat,227,227,454,26,24,Tie
74,TitForTat,212,212,424,20,32,Tie
75,TitForTat,229,224,453,22,23,Player A
76,TitForTat,229,234,463,32,23,TitForTat
77,TitForTat,231,226,457,20,21,Player A
78,TitForTat,202,207,409,14,35,TitForTat
79,TitForTat,222,217,439,26,29,Player A
80,TitForTat,219,224,443,21,26,TitForTat
81,TitForTat,227,227,454,23,23,Tie
82,TitForTat,223,218,441,16,25,Player A
83,TitForTat,238,238,476,27,17,Tie
84,TitForTat,216,216,432,22,30,Tie
85,TitForTat,229,234,463,29,22,TitForTat
86,TitForTat,222,217,439,26,29,Player A
87,TitForTat,219,224,443,21,26,TitForTat
88,TitForTat,223,223,446,27,27,Tie
89,TitForTat,227,222,449,30,27,Player A
90,TitForTat,229,229,458,27,23,Tie
91,TitForTat,224,224,448,26,26,Tie
92,TitForTat,230,235,465,28,21,TitForTat
93,TitForTat,245,245,490,38,16,Tie
94,TitForTat,212,212,424,23,33,Tie
95,TitForTat,215,210,425,21,32,Player A
96,TitForTat,229,229,458,30,24,Tie
97,TitForTat,226,226,452,24,24,Tie
98,TitForTat,212,212,424,20,32,Tie
99,TitForTat,216,221,437,24,29,TitForTat
100,TitForTat,224,219,443,24,27,Player A
101,TitForTat,229,229,458,27,23,Tie
102,TitForTat,227,232,459,31,24,TitForTat
103,TitForTat,230,225,455,30,25,Player A
104,TitForTat,219,224,443,21,26,TitForTat
105,TitForTat,237,237,474,31,19,Tie
106,TitForTat,229,229,458,24,22,Tie
107,TitForTat,220,215,435,22,29,Player A
108,TitForTat,225,230,455,24,23,TitForTat
109,TitForTat,228,228,456,28,24,Tie
110,TitForTat,238,238,476,30,18,Tie
111,TitForTat,222,222,444,28,28,Tie
112,TitForTat,213,213,426,28,34,Tie
113,TitForTat,209,204,413,15,34,Player A
114,TitForTat,212,212,424,20,32,Tie
115,TitForTat,235,240,475,32,19,TitForTat
116,TitForTat,233,233,466,29,21,Tie
117,TitForTat,211,211,422,24,34,Tie
118,TitForTat,232,227,459,34,25,Player A
119,TitForTat,240,245,485,36,17,TitForTat
120,TitForTat,232,232,464,30,22,Tie
121,TitForTat,242,242,484,38,18,Tie
122,TitForTat,203,203,406,20,38,Tie
123,TitForTat,240,240,480,31,17,Tie
124,TitForTat,222,222,444,25,27,Tie
125,TitForTat,211,206,417,19,34,Player A
126,TitForTat,236,236,472,26,18,Tie
127,TitForTat,227,232,459,22,21,TitForTat
128,TitForTat,206,201,407,18,37,Player A
129,TitForTat,216,221,437,24,29,TitForTat
130,TitForTat,251,246,497,33,12,Player A
131,TitForTat,228,228,456,22,22,Tie
132,TitForTat,208,208,416,21,35,Tie
133,TitForTat,233,233,466,20,18,Tie
134,TitForTat,230,235,465,31,22,TitForTat
135,TitForTat,228,228,456,25,23,Tie
136,TitForTat,224,224,448,20,24,Tie
137,TitForTat,228,228,456,22,22,Tie
138,TitForTat,238,233,471,31,20,Player A
139,TitForTat,205,205,410,15,35,Tie
140,TitForTat,237,237,474,37,21,Tie
141,TitForTat,218,218,436,26,30,Tie
142,TitForTat,213,213,426,22,32,Tie
143,TitForTat,225,230,455,24,23,TitForTat
144,TitForTat,220,215,435,22,29,Player A
145,TitForTat,229,234,463,29,22,TitForTat
146,TitForTat,229,224,453,25,24,Player A
147,TitForTat,193,198,391,14,41,TitForTat
148,TitForTat,227,222,449,24,25,Player A
149,TitForTat,229,229,458,24,22,Tie
150,TitForTat,210,210,420,16,32,Tie
151,TitForTat,216,216,432,25,31,Tie
152,TitForTat,226,226,452,27,25,Tie
153,TitForTat,222,222,444,22,26,Tie
154,TitForTat,239,239,478,26,16,Tie
155,TitForTat,212,217,429,16,29,TitForTat
156,TitForTat,235,235,470,27,19,Tie
157,TitForTat,240,235,475,32,19,Player A
158,TitForTat,228,228,456,25,23,Tie
159,TitForTat,221,226,447,19,24,TitForTat
160,TitForTat,210,205,415,20,35,Player A
161,TitForTat,225,230,455,24,23,TitForTat
162,TitForTat,230,225,455,21,22,Player A
163,TitForTat,223,223,446,24,26,Tie
164,TitForTat,233,238,471,28,19,TitForTat
165,TitForTat,218,218,436,17,27,Tie
166,TitForTat,225,225,450,22,24,Tie
167,TitForTat,227,227,454,29,25,Tie
168,TitForTat,239,239,478,32,18,Tie
169,TitForTat,221,216,437,24,29,Player A
170,TitForTat,223,228,451,20,23,TitForTat
171,TitForTat,235,230,465,19,18,Player A
172,TitForTat,217,217,434,18,28,Tie
173,TitForTat,215,220,435,25,30,TitForTat
174,TitForTat,244,239,483,28,15,Player A
175,TitForTat,204,209,413,18,35,TitForTat
176,TitForTat,216,211,427,14,29,Player A
177,TitForTat,234,234,468,22,18,Tie
178,TitForTat,212,217,429,22,31,TitForTat
179,TitForTat,227,227,454,26,24,Tie
180,TitForTat,235,235,470,21,17,Tie
181,TitForTat,218,218,436,26,30,Tie
182,TitForTat,217,212,429,22,31,Player A
183,TitForTat,224,229,453,25,24,TitForTat
184,TitForTat,214,209,423,19,32,Player A
185,TitForTat,236,241,477,28,17,TitForTat
186,TitForTat,221,221,442,14,24,Tie
187,TitForTat,212,212,424,20,32,Tie
188,TitForTat,235,235,470,27,19,Tie
189,TitForTat,225,220,445,23,26,Player A
190,TitForTat,222,222,444,25,27,Tie
191,TitForTat,216,216,432,25,31,Tie
192,TitForTat,228,233,461,30,23,TitForTat
193,TitForTat,222,217,439,23,28,Player A
194,TitForTat,228,228,456,28,24,Tie
195,TitForTat,232,237,469,29,20,TitForTat
196,TitForTat,228,228,456,28,24,Tie
197,TitForTat,218,213,431,24,31,Player A
198,TitForTat,215,215,430,20,30,Tie
199,TitForTat,219,219,438,22,28,Tie
200,TitForTat,211,211,422,24,34,Tie
201,TitForTat,232,237,469,29,20,TitForTat
202,TitForTat,238,238,476,30,18,Tie
203,TitForTat,233,228,461,27,22,Player A
204,TitForTat,240,245,485,33,16,TitForTat
205,TitForTat,222,222,444,19,25,Tie
206,TitForTat,223,223,446,24,26,Tie
207,TitForTat,228,228,456,22,22,Tie
208,TitForTat,242,242,484,29,15,Tie
209,TitForTat,221,221,442,17,25,Tie
210,TitForTat,228,228,456,16,20,Tie
211,TitForTat,216,216,432,22,30,Tie
212,TitForTat,223,218,441,31,30,Player A
213,TitForTat,221,226,447,25,26,TitForTat
214,TitForTat,227,222,449,21,24,Player A
215,TitForTat,241,241,482,33,17,Tie
216,TitForTat,226,226,452,21,23,Tie
217,TitForTat,232,232,464,24,20,Tie
218,TitForTat,202,207,409,20,37,TitForTat
219,TitForTat,236,236,472,29,19,Tie
220,TitForTat,219,214,433,23,30,Player A
221,TitForTat,220,225,445,23,26,TitForTat
222,TitForTat,242,237,479,33,18,Player A
223,TitForTat,218,223,441,31,30,TitForTat
224,TitForTat,237,237,474,31,19,Tie
225,TitForTat,212,212,424,17,31,Tie
226,TitForTat,249,244,493,35,14,Player A
227,TitForTat,232,237,469,29,20,TitForTat
228,TitForTat,225,220,445,26,27,Player A
229,TitForTat,214,219,433,20,29,TitForTat
230,TitForTat,236,231,467,27,20,Player A
231,TitForTat,224,224,448,20,24,Tie
232,TitForTat,230,230,460,35,25,Tie
233,TitForTat,222,222,444,22,26,Tie
234,TitForTat,241,246,487,32,15,TitForTat
235,TitForTat,233,228,461,24,21,Player A
236,TitForTat,229,229,458,27,23,Tie
237,TitForTat,218,218,436,17,27,Tie
238,TitForTat,226,226,452,24,24,Tie
239,TitForTat,234,239,473,36,21,TitForTat
240,TitForTat,230,230,460,29,23,Tie
241,TitForTat,230,230,460,26,22,Tie
242,TitForTat,240,235,475,20,15,Player A
243,TitForTat,230,235,465,31,22,TitForTat
244,TitForTat,225,225,450,28,26,Tie
245,TitForTat,226,221,447,25,26,Player A
246,TitForTat,228,228,456,22,22,Tie
247,TitForTat,220,220,440,27,29,Tie
248,TitForTat,223,228,451,26,25,TitForTat
249,TitForTat,234,229,463,35,24,Player A
250,TitForTat,209,214,423,16,31,TitForTat
251,TitForTat,225,220,445,26,27,Player A
252,TitForTat,233,233,466,32,22,Tie
253,TitForTat,225,230,455,30,25,TitForTat
254,TitForTat,249,244,493,32,13,Player A
255,TitForTat,218,223,441,22,27,TitForTat
256,TitForTat,227,222,449,27,26,Player A
257,TitForTat,218,218,436,23,29,Tie
258,TitForTat,213,213,426,16,30,Tie
259,TitForTat,236,241,477,31,18,TitForTat
260,TitForTat,227,222,449,21,24,Player A
261,TitForTat,222,222,444,19,25,Tie
262,TitForTat,242,247,489,40,17,TitForTat
263,TitForTat,236,236,472,32,20,Tie
264,TitForTat,202,197,399,19,40,Player A
265,TitForTat,221,221,442,23,27,Tie
266,TitForTat,216,221,437,18,27,TitForTat
267,TitForTat,230,225,455,24,23,Player A
268,TitForTat,228,228,456,22,22,Tie
269,TitForTat,227,227,454,23,23,Tie
270,TitForTat,223,223,446,24,26,Tie
271,TitForTat,208,213,421,23,34,TitForTat
272,TitForTat,227,227,454,26,24,Tie
273,TitForTat,225,220,445,26,27,Player A
274,TitForTat,217,222,439,20,27,TitForTat
275,TitForTat,219,214,433,23,30,Player A
276,TitForTat,211,211,422,21,33,Tie
277,TitForTat,228,233,461,33,24,TitForTat
278,TitForTat,240,235,475,29,18,Player A
279,TitForTat,246,251,497,39,14,TitForTat
280,TitForTat,223,218,441,22,27,Player A
281,TitForTat,222,222,444,22,26,Tie
282,TitForTat,224,229,453,22,23,TitForTat
283,TitForTat,228,223,451,29,26,Player A
284,TitForTat,205,210,415,20,35,TitForTat
285,TitForTat,241,236,477,25,16,Player A
286,TitForTat,213,213,426,22,32,Tie
287,TitForTat,224,224,448,23,25,Tie
288,TitForTat,221,221,442,26,28,Tie
289,TitForTat,227,232,459,25,22,TitForTat
290,TitForTat,223,218,441,19,26,Player A
291,TitForTat,234,239,473,33,20,TitForTat
292,TitForTat,219,219,438,19,27,Tie
293,TitForTat,218,218,436,26,30,Tie
294,TitForTat,224,224,448,26,26,Tie
295,TitForTat,243,238,481,29,16,Player A
296,TitForTat,204,209,413,15,34,TitForTat
297,TitForTat,229,224,453,31,26,Player A
298,TitForTat,213,213,426,16,30,Tie
299,TitForTat,223,223,446,18,24,Tie
300,TitForTat,217,217,434,24,30,Tie
301,TitForTat,223,223,446,21,25,Tie
302,TitForTat,206,211,417,13,32,TitForTat
303,TitForTat,227,227,454,23,23,Tie
304,TitForTat,235,235,470,33,21,Tie
305,TitForTat,226,226,452,24,24,Tie
306,TitForTat,245,240,485,36,17,Player A
307,TitForTat,218,218,436,26,30,Tie
308,TitForTat,217,217,434,27,31,Tie
309,TitForTat,214,214,428,21,31,Tie
310,TitForTat,210,215,425,18,31,TitForTat
311,TitForTat,245,240,485,33,16,Player A
312,TitForTat,222,227,449,21,24,TitForTat
313,TitForTat,220,220,440,27,29,Tie
314,TitForTat,215,215,430,23,31,Tie
315,TitForTat,213,213,426,19,31,Tie
316,TitForTat,236,236,472,35,21,Tie
317,TitForTat,232,232,464,24,20,Tie
318,TitForTat,238,233,471,40,23,Player A
319,TitForTat,242,247,489,34,15,TitForTat
320,TitForTat,236,231,467,24,19,Player A
321,TitForTat,222,222,444,19,25,Tie
322,TitForTat,219,224,443,27,28,TitForTat
323,TitForTat,214,214,428,21,31,Tie
324,TitForTat,227,227,454,20,22,Tie
325,TitForTat,218,218,436,23,29,Tie
326,TitForTat,241,236,477,31,18,Player A
327,TitForTat,231,231,462,31,23,Tie
328,TitForTat,220,225,445,29,28,TitForTat
329,TitForTat,228,223,451,32,27,Player A
330,TitForTat,228,233,461,27,22,TitForTat
331,TitForTat,246,246,492,31,13,Tie
332,TitForTat,241,236,477,37,20,Player A
333,TitForTat,223,228,451,32,27,TitForTat
334,TitForTat,236,231,467,27,20,Player A
335,TitForTat,221,226,447,22,25,TitForTat
336,TitForTat,220,215,435,25,30,Player A
337,TitForTat,211,211,422,15,31,Tie
338,TitForTat,213,218,431,21,30,TitForTat
339,TitForTat,219,219,438,25,29,Tie
340,TitForTat,226,221,447,31,28,Player A
341,TitForTat,223,228,451,23,24,TitForTat
342,TitForTat,215,215,430,20,30,Tie
343,TitForTat,229,229,458,24,22,Tie
344,TitForTat,235,235,470,33,21,Tie
345,TitForTat,236,236,472,32,20,Tie
346,TitForTat,216,216,432,25,31,Tie
347,TitForTat,233,233,466,23,19,Tie
348,TitForTat,235,230,465,31,22,Player A
349,TitForTat,221,226,447,22,25,TitForTat
350,TitForTat,238,233,471,28,19,Player A
351,TitForTat,191,196,387,16,43,TitForTat
352,TitForTat,232,232,464,33,23,Tie
353,TitForTat,230,230,460,23,21,Tie
354,TitForTat,230,230,460,26,22,Tie
355,TitForTat,231,226,457,29,24,Player A
356,TitForTat,207,207,414,22,36,Tie
357,TitForTat,213,218,431,18,29,TitForTat
358,TitForTat,240,240,480,40,20,Tie
359,TitForTat,245,245,490,35,15,Tie
360,TitForTat,228,228,456,28,24,Tie
361,TitForTat,225,220,445,23,26,Player A
362,TitForTat,234,234,468,31,21,Tie
363,TitForTat,236,236,472,35,21,Tie
364,TitForTat,230,230,460,29,23,Tie
365,TitForTat,213,218,431,24,31,TitForTat
366,TitForTat,225,225,450,19,23,Tie
367,TitForTat,224,219,443,21,26,Player A
368,TitForTat,246,251,497,39,14,TitForTat
369,TitForTat,229,229,458,33,25,Tie
370,TitForTat,231,226,457,29,24,Player A
371,TitForTat,225,230,455,27,24,TitForTat
372,TitForTat,229,224,453,31,26,Player A
373,TitForTat,220,225,445,20,25,TitForTat
374,TitForTat,218,218,436,26,30,Tie
375,TitForTat,237,232,469,32,21,Player A
376,TitForTat,228,228,456,19,21,Tie
377,TitForTat,233,238,471,25,18,TitForTat
378,TitForTat,230,230,460,32,24,Tie
379,TitForTat,213,213,426,25,33,Tie
380,TitForTat,232,232,464,27,21,Tie
381,TitForTat,217,217,434,15,27,Tie
382,TitForTat,224,224,448,23,25,Tie
383,TitForTat,239,234,473,30,19,Player A
384,TitForTat,227,227,454,26,24,Tie
385,TitForTat,233,238,471,25,18,TitForTat
386,TitForTat,238,238,476,30,18,Tie
387,TitForTat,223,223,446,24,26,Tie
388,TitForTat,234,234,468,31,21,Tie
389,TitForTat,230,230,460,32,24,Tie
390,TitForTat,218,213,431,24,31,Player A
391,TitForTat,208,208,416,15,33,Tie
392,TitForTat,228,228,456,28,24,Tie
393,TitForTat,243,248,491,33,14,TitForTat
394,TitForTat,230,225,455,27,24,Player A
395,TitForTat,234,234,468,31,21,Tie
396,TitForTat,219,219,438,19,27,Tie
397,TitForTat,221,221,442,20,26,Tie
398,TitForTat,231,231,462,22,20,Tie
399,TitForTat,240,245,485,27,14,TitForTat
400,TitForTat,215,215,430,20,30,Tie
401,TitForTat,232,227,459,22,21,Player A
402,TitForTat,226,231,457,23,22,TitForTat
403,TitForTat,221,216,437,18,27,Player A
404,TitForTat,226,231,457,23,22,TitForTat
405,TitForTat,224,224,448,35,29,Tie
406,TitForTat,226,226,452,21,23,Tie
407,TitForTat,217,217,434,21,29,Tie
408,TitForTat,228,223,451,26,25,Player A
409,TitForTat,223,228,451,23,24,TitForTat
410,TitForTat,230,225,455,24,23,Player A
411,TitForTat,227,232,459,25,22,TitForTat
412,TitForTat,226,226,452,27,25,Tie
413,TitForTat,227,222,449,21,24,Player A
414,TitForTat,220,220,440,18,26,Tie
415,TitForTat,238,243,481,32,17,TitForTat
416,TitForTat,220,220,440,27,29,Tie
417,TitForTat,224,219,443,21,26,Player A
418,TitForTat,220,225,445,26,27,TitForTat
419,TitForTat,229,229,458,30,24,Tie
420,TitForTat,226,226,452,27,25,Tie
421,TitForTat,243,243,486,34,16,Tie
422,TitForTat,227,222,449,30,27,Player A
423,TitForTat,221,221,442,32,30,Tie
424,TitForTat,230,235,465,25,20,TitForTat
425,TitForTat,219,214,433,23,30,Player A
426,TitForTat,228,228,456,22,22,Tie
427,TitForTat,234,234,468,37,23,Tie
428,TitForTat,224,229,453,28,25,TitForTat
429,TitForTat,222,222,444,22,26,Tie
430,TitForTat,236,231,467,24,19,Player A
431,TitForTat,219,219,438,19,27,Tie
432,TitForTat,232,237,469,29,20,TitForTat
433,TitForTat,235,230,465,25,20,Player A
434,TitForTat,224,224,448,26,26,Tie
435,TitForTat,237,242,479,30,17,TitForTat
436,TitForTat,242,237,479,36,19,Player A
437,TitForTat,209,209,418,20,34,Tie
438,TitForTat,213,213,426,25,33,Tie
439,TitForTat,220,225,445,23,26,TitForTat
440,TitForTat,227,227,454,29,25,Tie
441,TitForTat,229,229,458,33,25,Tie
442,TitForTat,239,239,478,38,20,Tie
443,TitForTat,220,215,435,19,28,Player A
444,TitForTat,219,224,443,24,27,TitForTat
445,TitForTat,231,231,462,25,21,Tie
446,TitForTat,217,217,434,24,30,Tie
447,TitForTat,224,219,443,24,27,Player A
448,TitForTat,233,238,471,34,21,TitForTat
449,TitForTat,207,202,409,14,35,Player A
450,TitForTat,214,219,433,14,27,TitForTat
451,TitForTat,247,242,489,31,14,Player A
452,TitForTat,233,233,466,26,20,Tie
453,TitForTat,223,223,446,27,27,Tie
454,TitForTat,234,234,468,28,20,Tie
455,TitForTat,221,221,442,17,25,Tie
456,TitForTat,218,223,441,25,28,TitForTat
457,TitForTat,233,233,466,29,21,Tie
458,TitForTat,228,223,451,29,26,Player A
459,TitForTat,229,234,463,29,22,TitForTat
460,TitForTat,250,250,500,36,12,Tie
461,TitForTat,224,224,448,23,25,Tie
462,TitForTat,227,222,449,24,25,Player A
463,TitForTat,217,222,439,23,28,TitForTat
464,TitForTat,236,231,467,33,22,Player A
465,TitForTat,227,227,454,23,23,Tie
466,TitForTat,214,214,428,21,31,Tie
467,TitForTat,212,212,424,20,32,Tie
468,TitForTat,236,236,472,29,19,Tie
469,TitForTat,209,209,418,11,31,Tie
470,TitForTat,218,218,436,26,30,Tie
471,TitForTat,225,225,450,25,25,Tie
472,TitForTat,229,234,463,29,22,TitForTat
473,TitForTat,220,215,435,19,28,Player A
474,TitForTat,231,231,462,25,21,Tie
475,TitForTat,216,216,432,22,30,Tie
476,TitForTat,226,231,457,32,25,TitForTat
477,TitForTat,228,223,451,23,24,Player A
478,TitForTat,227,227,454,23,23,Tie
479,TitForTat,233,238,471,25,18,TitForTat
480,TitForTat,241,241,482,27,15,Tie
481,TitForTat,214,209,423,16,31,Player A
482,TitForTat,214,219,433,17,28,TitForTat
483,TitForTat,222,222,444,25,27,Tie
484,TitForTat,213,213,426,16,30,Tie
485,TitForTat,235,230,465,19,18,Player A
486,TitForTat,241,241,482,36,18,Tie
487,TitForTat,232,232,464,24,20,Tie
488,TitForTat,220,225,445,23,26,TitForTat
489,TitForTat,217,212,429,22,31,Player A
490,TitForTat,229,234,463,32,23,TitForTat
491,TitForTat,215,210,425,15,30,Player A
492,TitForTat,218,218,436,20,28,Tie
493,TitForTat,234,234,468,28,20,Tie
494,TitForTat,240,240,480,28,16,Tie
495,TitForTat,237,237,474,31,19,Tie
496,TitForTat,222,227,449,33,28,TitForTat
497,TitForTat,222,217,439,20,27,Player A
498,TitForTat,205,205,410,15,35,Tie
499,TitForTat,214,214,428,18,30,Tie
500,TitForTat,227,232,459,28,23,TitForTat
501,TitForTat,242,237,479,30,17,Player A
502,TitForTat,225,230,455,24,23,TitForTat
503,TitForTat,206,206,412,20,36,Tie
504,TitForTat,231,226,457,29,24,Player A
505,TitForTat,221,221,442,14,24,Tie
506,TitForTat,220,225,445,26,27,TitForTat
507,TitForTat,240,235,475,23,16,Player A
508,TitForTat,232,237,469,20,17,TitForTat
509,TitForTat,218,213,431,24,31,Player A
510,TitForTat,234,239,473,42,23,TitForTat
511,TitForTat,194,189,383,12,43,Player A
512,TitForTat,232,237,469,23,18,TitForTat
513,TitForTat,219,214,433,17,28,Player A
514,TitForTat,212,212,424,23,33,Tie
515,TitForTat,232,232,464,30,22,Tie
516,TitForTat,201,206,407,12,35,TitForTat
517,TitForTat,213,208,421,20,33,Player A
518,TitForTat,218,218,436,23,29,Tie
519,TitForTat,209,209,418,17,33,Tie
520,TitForTat,223,228,451,23,24,TitForTat
521,TitForTat,221,216,437,24,29,Player A
522,TitForTat,223,228,451,26,25,TitForTat
523,TitForTat,243,238,481,38,19,Player A
524,TitForTat,218,218,436,20,28,Tie
525,TitForTat,222,222,444,19,25,Tie
526,TitForTat,233,238,471,28,19,TitForTat
527,TitForTat,226,221,447,25,26,Player A
528,TitForTat,226,231,457,26,23,TitForTat
529,TitForTat,239,239,478,26,16,Tie
530,TitForTat,204,199,403,14,37,Player A
531,TitForTat,220,220,440,24,28,Tie
532,TitForTat,228,228,456,19,21,Tie
533,TitForTat,239,239,478,35,19,Tie
534,TitForTat,226,231,457,20,21,TitForTat
535,TitForTat,237,232,469,32,21,Player A
536,TitForTat,226,231,457,26,23,TitForTat
537,TitForTat,221,221,442,20,26,Tie
538,TitForTat,233,233,466,32,22,Tie
539,TitForTat,215,215,430,17,29,Tie
540,TitForTat,224,219,443,21,26,Player A
541,TitForTat,242,242,484,32,16,Tie
542,TitForTat,222,227,449,21,24,TitForTat
543,TitForTat,227,227,454,29,25,Tie
544,TitForTat,229,224,453,28,25,Player A
545,TitForTat,227,232,459,25,22,TitForTat
546,TitForTat,217,217,434,24,30,Tie
547,TitForTat,223,218,441,31,30,Player A
548,TitForTat,226,231,457,29,24,TitForTat
549,TitForTat,231,226,457,20,21,Player A
550,TitForTat,216,221,437,18,27,TitForTat
551,TitForTat,233,228,461,30,23,Player A
552,TitForTat,236,241,477,31,18,TitForTat
553,TitForTat,221,221,442,23,27,Tie
554,TitForTat,243,238,481,32,17,Player A
555,TitForTat,220,225,445,32,29,TitForTat
556,TitForTat,241,241,482,24,14,Tie
557,TitForTat,224,224,448,26,26,Tie
558,TitForTat,222,222,444,22,26,Tie
559,TitForTat,224,219,443,24,27,Player A
560,TitForTat,217,222,439,23,28,TitForTat
561,TitForTat,227,222,449,30,27,Player A
562,TitForTat,219,219,438,25,29,Tie
563,TitForTat,240,240,480,37,19,Tie
564,TitForTat,241,241,482,33,17,Tie
565,TitForTat,215,220,435,25,30,TitForTat
566,TitForTat,223,223,446,24,26,Tie
567,TitForTat,217,217,434,18,28,Tie
568,TitForTat,229,224,453,25,24,Player A
569,TitForTat,224,224,448,26,26,Tie
570,TitForTat,237,237,474,22,16,Tie
571,TitForTat,217,222,439,26,29,TitForTat
572,TitForTat,216,211,427,26,33,Player A
573,TitForTat,226,231,457,26,23,TitForTat
574,TitForTat,234,229,463,26,21,Player A
575,TitForTat,243,243,486,34,16,Tie
576,TitForTat,196,196,392,15,41,Tie
577,TitForTat,220,220,440,21,27,Tie
578,TitForTat,233,238,471,34,21,TitForTat
579,TitForTat,225,225,450,25,25,Tie
580,TitForTat,236,231,467,21,18,Player A
581,TitForTat,237,237,474,28,18,Tie
582,TitForTat,221,226,447,28,27,TitForTat
583,TitForTat,232,232,464,18,18,Tie
584,TitForTat,230,230,460,26,22,Tie
585,TitForTat,232,227,459,31,24,Player A
586,TitForTat,229,229,458,27,23,Tie
587,TitForTat,214,214,428,24,32,Tie
588,TitForTat,232,232,464,24,20,Tie
589,TitForTat,231,231,462,25,21,Tie
590,TitForTat,224,229,453,25,24,TitForTat
591,TitForTat,243,238,481,35,18,Player A
592,TitForTat,219,219,438,25,29,Tie
593,TitForTat,221,226,447,22,25,TitForTat
594,TitForTat,246,241,487,41,18,Player A
595,TitForTat,232,237,469,29,20,TitForTat
596,TitForTat,228,228,456,28,24,Tie
597,TitForTat,233,228,461,24,21,Player A
598,TitForTat,218,223,441,22,27,TitForTat
599,TitForTat,204,204,408,22,38,Tie
600,TitForTat,241,241,482,36,18,Tie
601,TitForTat,233,233,466,26,20,Tie
602,TitForTat,220,220,440,18,26,Tie
603,TitForTat,232,232,464,24,20,Tie
604,TitForTat,213,208,421,17,32,Player A
605,TitForTat,222,222,444,25,27,Tie
606,TitForTat,225,225,450,19,23,Tie
607,TitForTat,209,209,418,17,33,Tie
608,TitForTat,213,213,426,25,33,Tie
609,TitForTat,227,227,454,23,23,Tie
610,TitForTat,244,249,493,38,15,TitForTat
611,TitForTat,250,245,495,37,14,Player A
612,TitForTat,226,226,452,24,24,Tie
613,TitForTat,233,238,471,34,21,TitForTat
614,TitForTat,232,232,464,24,20,Tie
615,TitForTat,217,217,434,24,30,Tie
616,TitForTat,218,218,436,26,30,Tie
617,TitForTat,238,238,476,27,17,Tie
618,TitForTat,249,244,493,35,14,Player A
619,TitForTat,213,218,431,24,31,TitForTat
620,TitForTat,218,213,431,27,32,Player A
621,TitForTat,213,218,431,15,28,TitForTat
622,TitForTat,246,241,487,29,14,Player A
623,TitForTat,216,216,432,16,28,Tie
624,TitForTat,235,235,470,30,20,Tie
625,TitForTat,208,208,416,18,34,Tie
626,TitForTat,212,212,424,17,31,Tie
627,TitForTat,212,212,424,17,31,Tie
628,TitForTat,232,232,464,30,22,Tie
629,TitForTat,216,221,437,24,29,TitForTat
630,TitForTat,217,212,429,19,30,Player A
631,TitForTat,214,219,433,23,30,TitForTat
632,TitForTat,228,228,456,34,26,Tie
633,TitForTat,234,229,463,17,18,Player A
634,TitForTat,238,243,481,35,18,TitForTat
635,TitForTat,236,231,467,30,21,Player A
636,TitForTat,231,236,467,27,20,TitForTat
637,TitForTat,224,219,443,24,27,Player A
638,TitForTat,238,243,481,29,16,TitForTat
639,TitForTat,241,241,482,33,17,Tie
640,TitForTat,243,238,481,32,17,Player A
641,TitForTat,223,223,446,24,26,Tie
642,TitForTat,221,221,442,26,28,Tie
643,TitForTat,212,217,429,19,30,TitForTat
644,TitForTat,227,227,454,26,24,Tie
645,TitForTat,221,221,442,23,27,Tie
646,TitForTat,237,237,474,34,20,Tie
647,TitForTat,236,236,472,26,18,Tie
648,TitForTat,221,216,437,15,26,Player A
649,TitForTat,235,240,475,20,15,TitForTat
650,TitForTat,213,213,426,22,32,Tie
651,TitForTat,228,223,451,26,25,Player A
652,TitForTat,210,215,425,18,31,TitForTat
653,TitForTat,230,225,455,27,24,Player A
654,TitForTat,250,255,505,35,10,TitForTat
655,TitForTat,231,231,462,28,22,Tie
656,TitForTat,229,229,458,27,23,Tie
657,TitForTat,231,226,457,23,22,Player A
658,TitForTat,221,226,447,19,24,TitForTat
659,TitForTat,220,220,440,27,29,Tie
660,TitForTat,197,197,394,17,41,Tie
661,TitForTat,229,224,453,31,26,Player A
662,TitForTat,212,217,429,19,30,TitForTat
663,TitForTat,219,219,438,28,30,Tie
664,TitForTat,219,214,433,17,28,Player A
665,TitForTat,220,220,440,21,27,Tie
666,TitForTat,221,221,442,26,28,Tie
667,TitForTat,219,219,438,25,29,Tie
668,TitForTat,220,220,440,24,28,Tie
669,TitForTat,232,232,464,30,22,Tie
670,TitForTat,229,229,458,21,21,Tie
671,TitForTat,223,228,451,26,25,TitForTat
672,TitForTat,233,228,461,39,26,Player A
673,TitForTat,226,231,457,29,24,TitForTat
674,TitForTat,235,230,465,28,21,Player A
675,TitForTat,221,221,442,20,26,Tie
676,TitForTat,212,212,424,20,32,Tie
677,TitForTat,214,214,428,24,32,Tie
678,TitForTat,220,225,445,26,27,TitForTat
679,TitForTat,223,223,446,18,24,Tie
680,TitForTat,237,237,474,25,17,Tie
681,TitForTat,214,214,428,24,32,Tie
682,TitForTat,234,229,463,23,20,Player A
683,TitForTat,215,220,435,19,28,TitForTat
684,TitForTat,251,246,497,39,14,Player A
685,TitForTat,229,234,463,23,20,TitForTat
686,TitForTat,208,203,411,16,35,Player A
687,TitForTat,230,235,465,34,23,TitForTat
688,TitForTat,227,227,454,20,22,Tie
689,TitForTat,220,215,435,19,28,Player A
690,TitForTat,228,233,461,27,22,TitForTat
691,TitForTat,215,210,425,24,33,Player A
692,TitForTat,232,232,464,33,23,Tie
693,TitForTat,216,216,432,25,31,Tie
694,TitForTat,216,221,437,24,29,TitForTat
695,TitForTat,229,224,453,28,25,Player A
696,TitForTat,208,208,416,12,32,Tie
697,TitForTat,222,227,449,30,27,TitForTat
698,TitForTat,210,205,415,17,34,Player A
699,TitForTat,214,214,428,15,29,Tie
700,TitForTat,205,210,415,17,34,TitForTat
701,TitForTat,243,243,486,37,17,Tie
702,TitForTat,237,237,474,28,18,Tie
703,TitForTat,228,228,456,22,22,Tie
704,TitForTat,211,211,422,21,33,Tie
705,TitForTat,226,221,447,25,26,Player A
706,TitForTat,231,231,462,34,24,Tie
707,TitForTat,207,212,419,15,32,TitForTat
708,TitForTat,223,223,446,21,25,Tie
709,TitForTat,243,243,486,40,18,Tie
710,TitForTat,245,240,485,33,16,Player A
711,TitForTat,206,211,417,19,34,TitForTat
712,TitForTat,232,227,459,28,23,Player A
713,TitForTat,231,231,462,25,21,Tie
714,TitForTat,211,211,422,21,33,Tie
715,TitForTat,229,229,458,18,20,Tie
716,TitForTat,213,213,426,25,33,Tie
717,TitForTat,221,221,442,23,27,Tie
718,TitForTat,216,221,437,21,28,TitForTat
719,TitForTat,222,217,439,26,29,Player A
720,TitForTat,213,218,431,24,31,TitForTat
721,TitForTat,221,216,437,24,29,Player A
722,TitForTat,220,220,440,18,26,Tie
723,TitForTat,235,240,475,32,19,TitForTat
724,TitForTat,231,231,462,22,20,Tie
725,TitForTat,229,229,458,27,23,Tie
726,TitForTat,232,232,464,27,21,Tie
727,TitForTat,226,221,447,25,26,Player A
728,TitForTat,220,225,445,23,26,TitForTat
729,TitForTat,216,216,432,34,34,Tie
730,TitForTat,221,221,442,20,26,Tie
731,TitForTat,247,242,489,31,14,Player A
732,TitForTat,219,219,438,25,29,Tie
733,TitForTat,215,220,435,19,28,TitForTat
734,TitForTat,229,224,453,28,25,Player A
735,TitForTat,224,224,448,23,25,Tie
736,TitForTat,199,199,398,21,41,Tie
737,TitForTat,246,251,497,45,16,TitForTat
738,TitForTat,246,246,492,31,13,Tie
739,TitForTat,210,210,420,22,34,Tie
740,TitForTat,220,215,435,13,26,Player A
741,TitForTat,211,216,427,23,32,TitForTat
742,TitForTat,211,206,417,22,35,Player A
743,TitForTat,234,234,468,31,21,Tie
744,TitForTat,234,234,468,31,21,Tie
745,TitForTat,236,236,472,35,21,Tie
746,TitForTat,228,228,456,25,23,Tie
747,TitForTat,230,230,460,26,22,Tie
748,TitForTat,226,231,457,26,23,TitForTat
749,TitForTat,230,225,455,27,24,Player A
750,TitForTat,233,238,471,28,19,TitForTat
751,TitForTat,233,228,461,21,20,Player A
752,TitForTat,209,209,418,23,35,Tie
753,TitForTat,223,228,451,26,25,TitForTat
754,TitForTat,220,215,435,16,27,Player A
755,TitForTat,229,234,463,20,19,TitForTat
756,TitForTat,212,212,424,20,32,Tie
757,TitForTat,207,202,409,20,37,Player A
758,TitForTat,235,235,470,21,17,Tie
759,TitForTat,219,219,438,22,28,Tie
760,TitForTat,220,225,445,35,30,TitForTat
761,TitForTat,224,219,443,24,27,Player A
762,TitForTat,233,233,466,23,19,Tie
763,TitForTat,215,220,435,22,29,TitForTat
764,TitForTat,228,228,456,25,23,Tie
765,TitForTat,230,225,455,18,21,Player A
766,TitForTat,217,217,434,15,27,Tie
767,TitForTat,218,223,441,25,28,TitForTat
768,TitForTat,221,221,442,20,26,Tie
769,TitForTat,232,232,464,27,21,Tie
770,TitForTat,238,238,476,27,17,Tie
771,TitForTat,241,236,477,31,18,Player A
772,TitForTat,251,251,502,35,11,Tie
773,TitForTat,218,218,436,20,28,Tie
774,TitForTat,227,227,454,26,24,Tie
775,TitForTat,225,230,455,24,23,TitForTat
776,TitForTat,214,214,428,24,32,Tie
777,TitForTat,237,237,474,40,22,Tie
778,TitForTat,235,230,465,25,20,Player A
779,TitForTat,231,231,462,28,22,Tie
780,TitForTat,228,233,461,21,20,TitForTat
781,TitForTat,225,220,445,26,27,Player A
782,TitForTat,212,217,429,22,31,TitForTat
783,TitForTat,206,206,412,20,36,Tie
784,TitForTat,233,228,461,27,22,Player A
785,TitForTat,226,226,452,27,25,Tie
786,TitForTat,229,234,463,23,20,TitForTat
787,TitForTat,235,235,470,30,20,Tie
788,TitForTat,226,221,447,25,26,Player A
789,TitForTat,217,222,439,23,28,TitForTat
790,TitForTat,230,225,455,24,23,Player A
791,TitForTat,212,212,424,20,32,Tie
792,TitForTat,203,203,406,14,36,Tie
793,TitForTat,219,224,443,27,28,TitForTat
794,TitForTat,216,216,432,22,30,Tie
795,TitForTat,225,225,450,22,24,Tie
796,TitForTat,231,226,457,29,24,Player A
797,TitForTat,241,246,487,32,15,TitForTat
798,TitForTat,234,229,463,29,22,Player A
799,TitForTat,222,222,444,31,29,Tie
800,TitForTat,234,239,473,27,18,TitForTat
801,TitForTat,229,229,458,24,22,Tie
802,TitForTat,235,230,465,28,21,Player A
803,TitForTat,231,236,467,27,20,TitForTat
804,TitForTat,220,215,435,25,30,Player A
805,TitForTat,226,231,457,26,23,TitForTat
806,TitForTat,216,216,432,22,30,Tie
807,TitForTat,207,202,409,14,35,Player A
808,TitForTat,223,223,446,21,25,Tie
809,TitForTat,221,226,447,19,24,TitForTat
810,TitForTat,212,212,424,17,31,Tie
811,TitForTat,249,244,493,38,15,Player A
812,TitForTat,219,219,438,22,28,Tie
813,TitForTat,226,231,457,23,22,TitForTat
814,TitForTat,225,220,445,23,26,Player A
815,TitForTat,200,205,405,16,37,TitForTat
816,TitForTat,206,201,407,12,35,Player A
817,TitForTat,215,215,430,23,31,Tie
818,TitForTat,209,209,418,23,35,Tie
819,TitForTat,224,229,453,16,21,TitForTat
820,TitForTat,223,223,446,27,27,Tie
821,TitForTat,216,216,432,22,30,Tie
822,TitForTat,231,231,462,25,21,Tie
823,TitForTat,219,219,438,16,26,Tie
824,TitForTat,225,225,450,31,27,Tie
825,TitForTat,247,247,494,36,14,Tie
826,TitForTat,223,218,441,25,28,Player A
827,TitForTat,220,220,440,21,27,Tie
828,TitForTat,225,230,455,24,23,TitForTat
829,TitForTat,236,236,472,29,19,Tie
830,TitForTat,222,222,444,31,29,Tie
831,TitForTat,242,237,479,30,17,Player A
832,TitForTat,225,225,450,31,27,Tie
833,TitForTat,214,219,433,23,30,TitForTat
834,TitForTat,226,221,447,22,25,Player A
835,TitForTat,211,216,427,23,32,TitForTat
836,TitForTat,217,217,434,21,29,Tie
837,TitForTat,228,223,451,20,23,Player A
838,TitForTat,228,233,461,27,22,TitForTat
839,TitForTat,220,220,440,24,28,Tie
840,TitForTat,239,239,478,35,19,Tie
841,TitForTat,237,232,469,29,20,Player A
842,TitForTat,203,203,406,20,38,Tie
843,TitForTat,216,216,432,19,29,Tie
844,TitForTat,224,229,453,28,25,TitForTat
845,TitForTat,233,228,461,30,23,Player A
846,TitForTat,237,237,474,37,21,Tie
847,TitForTat,217,217,434,21,29,Tie
848,TitForTat,200,205,405,16,37,TitForTat
849,TitForTat,216,216,432,19,29,Tie
850,TitForTat,231,226,457,29,24,Player A
851,TitForTat,245,250,495,34,13,TitForTat
852,TitForTat,210,210,420,22,34,Tie
853,TitForTat,221,221,442,26,28,Tie
854,TitForTat,225,225,450,25,25,Tie
855,TitForTat,247,247,494,36,14,Tie
856,TitForTat,222,222,444,25,27,Tie
857,TitForTat,228,223,451,26,25,Player A
858,TitForTat,212,217,429,22,31,TitForTat
859,TitForTat,235,230,465,28,21,Player A
860,TitForTat,216,221,437,24,29,TitForTat
861,TitForTat,226,226,452,21,23,Tie
862,TitForTat,236,236,472,29,19,Tie
863,TitForTat,215,215,430,23,31,Tie
864,TitForTat,232,227,459,28,23,Player A
865,TitForTat,217,217,434,24,30,Tie
866,TitForTat,238,243,481,32,17,TitForTat
867,TitForTat,216,211,427,14,29,Player A
868,TitForTat,223,223,446,27,27,Tie
869,TitForTat,229,229,458,27,23,Tie
870,TitForTat,234,234,468,34,22,Tie
871,TitForTat,215,215,430,23,31,Tie
872,TitForTat,234,234,468,28,20,Tie
873,TitForTat,218,223,441,22,27,TitForTat
874,TitForTat,238,233,471,31,20,Player A
875,TitForTat,235,235,470,30,20,Tie
876,TitForTat,231,231,462,28,22,Tie
877,TitForTat,222,227,449,27,26,TitForTat
878,TitForTat,238,238,476,33,19,Tie
879,TitForTat,242,237,479,33,18,Player A
880,TitForTat,199,204,403,20,39,TitForTat
881,TitForTat,209,209,418,20,34,Tie
882,TitForTat,227,227,454,23,23,Tie
883,TitForTat,232,232,464,24,20,Tie
884,TitForTat,225,225,450,22,24,Tie
885,TitForTat,228,223,451,20,23,Player A
886,TitForTat,226,231,457,23,22,TitForTat
887,TitForTat,235,235,470,27,19,Tie
888,TitForTat,212,212,424,20,32,Tie
889,TitForTat,227,227,454,32,26,Tie
890,TitForTat,239,239,478,32,18,Tie
891,TitForTat,230,225,455,24,23,Player A
892,TitForTat,219,224,443,30,29,TitForTat
893,TitForTat,227,222,449,24,25,Player A
894,TitForTat,235,240,475,32,19,TitForTat
895,TitForTat,220,220,440,24,28,Tie
896,TitForTat,223,218,441,25,28,Player A
897,TitForTat,222,227,449,30,27,TitForTat
898,TitForTat,222,222,444,22,26,Tie
899,TitForTat,214,209,423,16,31,Player A
900,TitForTat,209,214,423,16,31,TitForTat
901,TitForTat,202,197,399,16,39,Player A
902,TitForTat,222,222,444,22,26,Tie
903,TitForTat,225,225,450,19,23,Tie
904,TitForTat,218,218,436,26,30,Tie
905,TitForTat,224,229,453,25,24,TitForTat
906,TitForTat,228,228,456,19,21,Tie
907,TitForTat,222,217,439,20,27,Player A
908,TitForTat,205,205,410,12,34,Tie
909,TitForTat,206,211,417,19,34,TitForTat
910,TitForTat,235,235,470,30,20,Tie
911,TitForTat,237,237,474,28,18,Tie
912,TitForTat,234,229,463,29,22,Player A
913,TitForTat,233,233,466,20,18,Tie
914,TitForTat,217,217,434,21,29,Tie
915,TitForTat,223,228,451,29,26,TitForTat
916,TitForTat,218,213,431,18,29,Player A
917,TitForTat,225,230,455,24,23,TitForTat
918,TitForTat,257,252,509,39,10,Player A
919,TitForTat,234,234,468,31,21,Tie
920,TitForTat,226,231,457,29,24,TitForTat
921,TitForTat,237,237,474,34,20,Tie
922,TitForTat,226,226,452,24,24,Tie
923,TitForTat,231,226,457,29,24,Player A
924,TitForTat,225,230,455,24,23,TitForTat
925,TitForTat,219,214,433,20,29,Player A
926,TitForTat,224,229,453,28,25,TitForTat
927,TitForTat,240,235,475,29,18,Player A
928,TitForTat,221,226,447,22,25,TitForTat
929,TitForTat,233,233,466,32,22,Tie
930,TitForTat,210,210,420,19,33,Tie
931,TitForTat,216,216,432,16,28,Tie
932,TitForTat,210,205,415,17,34,Player A
933,TitForTat,206,211,417,16,33,TitForTat
934,TitForTat,219,219,438,22,28,Tie
935,TitForTat,215,210,425,15,30,Player A
936,TitForTat,223,223,446,21,25,Tie
937,TitForTat,232,232,464,24,20,Tie
938,TitForTat,221,221,442,23,27,Tie
939,TitForTat,227,227,454,32,26,Tie
940,TitForTat,209,214,423,25,34,TitForTat
941,TitForTat,214,214,428,21,31,Tie
942,TitForTat,241,241,482,27,15,Tie
943,TitForTat,230,230,460,35,25,Tie
944,TitForTat,218,213,431,21,30,Player A
945,TitForTat,235,240,475,32,19,TitForTat
946,TitForTat,229,224,453,25,24,Player A
947,TitForTat,209,209,418,17,33,Tie
948,TitForTat,204,204,408,19,37,Tie
949,TitForTat,231,231,462,28,22,Tie
950,TitForTat,217,222,439,20,27,TitForTat
951,TitForTat,233,233,466,29,21,Tie
952,TitForTat,235,230,465,31,22,Player A
953,TitForTat,207,212,419,12,31,TitForTat
954,TitForTat,240,235,475,26,17,Player A
955,TitForTat,234,239,473,30,19,TitForTat
956,TitForTat,228,223,451,26,25,Player A
957,TitForTat,219,219,438,22,28,Tie
958,TitForTat,219,224,443,24,27,TitForTat
959,TitForTat,241,236,477,28,17,Player A
960,TitForTat,248,248,496,35,13,Tie
961,TitForTat,223,228,451,26,25,TitForTat
962,TitForTat,209,204,413,21,36,Player A
963,TitForTat,245,250,495,37,14,TitForTat
964,TitForTat,233,233,466,29,21,Tie
965,TitForTat,233,228,461,21,20,Player A
966,TitForTat,205,210,415,14,33,TitForTat
967,TitForTat,208,203,411,22,37,Player A
968,TitForTat,223,228,451,23,24,TitForTat
969,TitForTat,210,205,415,14,33,Player A
970,TitForTat,226,226,452,27,25,Tie
971,TitForTat,214,219,433,23,30,TitForTat
972,TitForTat,227,222,449,27,26,Player A
973,TitForTat,234,239,473,24,17,TitForTat
974,TitForTat,222,217,439,20,27,Player A
975,TitForTat,220,225,445,23,26,TitForTat
976,TitForTat,230,230,460,26,22,Tie
977,TitForTat,221,216,437,21,28,Player A
978,TitForTat,220,225,445,23,26,TitForTat
979,TitForTat,214,209,423,16,31,Player A
980,TitForTat,237,242,479,24,15,TitForTat
981,TitForTat,243,238,481,29,16,Player A
982,TitForTat,224,224,448,29,27,Tie
983,TitForTat,220,225,445,26,27,TitForTat
984,TitForTat,234,229,463,35,24,Player A
985,TitForTat,217,217,434,24,30,Tie
986,TitForTat,210,210,420,25,35,Tie
987,TitForTat,232,232,464,33,23,Tie
988,TitForTat,221,221,442,20,26,Tie
989,TitForTat,227,232,459,25,22,TitForTat
990,TitForTat,220,220,440,18,26,Tie
991,TitForTat,236,231,467,27,20,Player A
992,TitForTat,208,213,421,14,31,TitForTat
993,TitForTat,246,241,487,38,17,Player A
994,TitForTat,215,220,435,25,30,TitForTat
995,TitForTat,237,237,474,37,21,Tie
996,TitForTat,238,233,471,25,18,Player A
997,TitForTat,228,228,456,25,23,Tie
998,TitForTat,225,230,455,24,23,TitForTat
999,TitForTat,216,211,427,23,32,Player A
1000,TitForTat,236,236,472,32,20,Tie
1001,TitForTat,232,237,469,23,18,TitForTat
1002,TitForTat,233,233,466,32,22,Tie
1003,TitForTat,213,213,426,22,32,Tie
1004,TitForTat,235,235,470,30,20,Tie
1005,TitForTat,243,238,481,32,17,Player A
1006,TitForTat,220,225,445,23,26,TitForTat
1007,TitForTat,230,225,455,27,24,Player A
1008,TitForTat,223,223,446,27,27,Tie
1009,TitForTat,213,218,431,21,30,TitForTat
1010,TitForTat,212,212,424,23,33,Tie
1011,TitForTat,224,224,448,17,23,Tie
1012,TitForTat,230,230,460,32,24,Tie
1013,TitForTat,217,217,434,18,28,Tie
1014,TitForTat,217,217,434,18,28,Tie
1015,TitForTat,236,236,472,23,17,Tie
1016,TitForTat,237,232,469,26,19,Player A
1017,TitForTat,232,237,469,26,19,TitForTat
1018,TitForTat,230,230,460,32,24,Tie
1019,TitForTat,223,223,446,30,28,Tie
1020,TitForTat,222,222,444,22,26,Tie
1021,TitForTat,243,238,481,29,16,Player A
1022,TitForTat,230,230,460,23,21,Tie
1023,TitForTat,205,205,410,18,36,Tie
1024,TitForTat,238,238,476,21,15,Tie
1025,TitForTat,231,236,467,27,20,TitForTat
1026,TitForTat,208,208,416,18,34,Tie
1027,TitForTat,234,234,468,28,20,Tie
1028,TitForTat,229,224,453,28,25,Player A
1029,TitForTat,217,222,439,23,28,TitForTat
1030,TitForTat,220,215,435,31,32,Player A
1031,TitForTat,227,232,459,28,23,TitForTat
1032,TitForTat,205,205,410,15,35,Tie
1033,TitForTat,234,229,463,29,22,Player A
1034,TitForTat,224,224,448,26,26,Tie
1035,TitForTat,215,220,435,28,31,TitForTat
1036,TitForTat,233,233,466,35,23,Tie
1037,TitForTat,232,232,464,24,20,Tie
1038,TitForTat,234,229,463,32,23,Player A
1039,TitForTat,211,216,427,23,32,TitForTat
1040,TitForTat,220,220,440,24,28,Tie
1041,TitForTat,217,217,434,18,28,Tie
1042,TitForTat,233,228,461,30,23,Player A
1043,TitForTat,234,239,473,27,18,TitForTat
1044,TitForTat,225,225,450,31,27,Tie
1045,TitForTat,219,219,438,22,28,Tie
1046,TitForTat,217,217,434,21,29,Tie
1047,TitForTat,234,229,463,29,22,Player A
1048,TitForTat,237,237,474,31,19,Tie
1049,TitForTat,215,220,435,19,28,TitForTat
1050,TitForTat,222,222,444,25,27,Tie
1051,TitForTat,231,231,462,25,21,Tie
1052,TitForTat,220,215,435,19,28,Player A
1053,TitForTat,236,236,472,26,18,Tie
1054,TitForTat,224,224,448,23,25,Tie
1055,TitForTat,223,228,451,26,25,TitForTat
1056,TitForTat,240,240,480,34,18,Tie
1057,TitForTat,227,227,454,26,24,Tie
1058,TitForTat,235,235,470,30,20,Tie
1059,TitForTat,213,213,426,28,34,Tie
1060,TitForTat,223,223,446,27,27,Tie
1061,TitForTat,217,212,429,22,31,Player A
1062,TitForTat,220,225,445,26,27,TitForTat
1063,TitForTat,222,222,444,28,28,Tie
1064,TitForTat,241,241,482,36,18,Tie
1065,TitForTat,228,228,456,25,23,Tie
1066,TitForTat,227,222,449,21,24,Player A
1067,TitForTat,239,239,478,32,18,Tie
1068,TitForTat,244,249,493,35,14,TitForTat
1069,TitForTat,238,238,476,33,19,Tie
1070,TitForTat,222,217,439,23,28,Player A
1071,TitForTat,217,217,434,18,28,Tie
1072,TitForTat,217,222,439,26,29,TitForTat
1073,TitForTat,229,224,453,22,23,Player A
1074,TitForTat,232,237,469,29,20,TitForTat
1075,TitForTat,209,209,418,20,34,Tie
1076,TitForTat,220,220,440,24,28,Tie
1077,TitForTat,216,216,432,28,32,Tie
1078,TitForTat,219,219,438,16,26,Tie
1079,TitForTat,218,213,431,18,29,Player A
1080,TitForTat,216,221,437,27,30,TitForTat
1081,TitForTat,237,237,474,31,19,Tie
1082,TitForTat,233,228,461,21,20,Player A
1083,TitForTat,220,225,445,17,24,TitForTat
1084,TitForTat,233,233,466,26,20,Tie
1085,TitForTat,250,250,500,36,12,Tie
1086,TitForTat,225,220,445,26,27,Player A
1087,TitForTat,228,228,456,28,24,Tie
1088,TitForTat,231,236,467,27,20,TitForTat
1089,TitForTat,253,253,506,45,13,Tie
1090,TitForTat,240,235,475,29,18,Player A
1091,TitForTat,208,213,421,23,34,TitForTat
1092,TitForTat,227,222,449,24,25,Player A
1093,TitForTat,217,222,439,17,26,TitForTat
1094,TitForTat,214,214,428,27,33,Tie
1095,TitForTat,219,214,433,20,29,Player A
1096,TitForTat,242,247,489,31,14,TitForTat
1097,TitForTat,222,222,444,25,27,Tie
1098,TitForTat,217,217,434,18,28,Tie
1099,TitForTat,220,215,435,25,30,Player A
1100,TitForTat,247,247,494,39,15,Tie
1101,TitForTat,241,241,482,36,18,Tie
1102,TitForTat,221,221,442,20,26,Tie
1103,TitForTat,228,228,456,22,22,Tie
1104,TitForTat,223,223,446,18,24,Tie
1105,TitForTat,238,243,481,32,17,TitForTat
1106,TitForTat,234,229,463,26,21,Player A
1107,TitForTat,204,209,413,18,35,TitForTat
1108,TitForTat,217,217,434,21,29,Tie
1109,TitForTat,235,235,470,30,20,Tie
1110,TitForTat,220,220,440,27,29,Tie
1111,TitForTat,238,238,476,30,18,Tie
1112,TitForTat,225,220,445,20,25,Player A
1113,TitForTat,212,217,429,19,30,TitForTat
1114,TitForTat,219,214,433,20,29,Player A
1115,TitForTat,237,237,474,28,18,Tie
1116,TitForTat,208,208,416,21,35,Tie
1117,TitForTat,238,238,476,36,20,Tie
1118,TitForTat,225,225,450,19,23,Tie
1119,TitForTat,218,223,441,28,29,TitForTat
1120,TitForTat,211,206,417,19,34,Player A
1121,TitForTat,222,222,444,25,27,Tie
1122,TitForTat,217,222,439,26,29,TitForTat
1123,TitForTat,234,234,468,28,20,Tie
1124,TitForTat,234,234,468,31,21,Tie
1125,TitForTat,227,227,454,32,26,Tie
1126,TitForTat,232,232,464,30,22,Tie
1127,TitForTat,232,232,464,33,23,Tie
1128,TitForTat,212,212,424,29,35,Tie
1129,TitForTat,212,212,424,20,32,Tie
1130,TitForTat,233,228,461,30,23,Player A
1131,TitForTat,218,218,436,23,29,Tie
1132,TitForTat,219,219,438,25,29,Tie
1133,TitForTat,219,219,438,19,27,Tie
1134,TitForTat,224,224,448,26,26,Tie
1135,TitForTat,221,221,442,29,29,Tie
1136,TitForTat,208,213,421,23,34,TitForTat
1137,TitForTat,220,220,440,21,27,Tie
1138,TitForTat,225,220,445,23,26,Player A
1139,TitForTat,229,229,458,27,23,Tie
1140,TitForTat,217,222,439,26,29,TitForTat
1141,TitForTat,231,226,457,26,23,Player A
1142,TitForTat,231,231,462,31,23,Tie
1143,TitForTat,216,221,437,18,27,TitForTat
1144,TitForTat,213,213,426,16,30,Tie
1145,TitForTat,218,218,436,23,29,Tie
1146,TitForTat,224,219,443,21,26,Player A
1147,TitForTat,214,219,433,11,26,TitForTat
1148,TitForTat,240,240,480,31,17,Tie
1149,TitForTat,223,223,446,24,26,Tie
1150,TitForTat,227,227,454,17,21,Tie
1151,TitForTat,219,214,433,20,29,Player A
1152,TitForTat,209,209,418,26,36,Tie
1153,TitForTat,233,238,471,25,18,TitForTat
1154,TitForTat,243,243,486,31,15,Tie
1155,TitForTat,229,224,453,25,24,Player A
1156,TitForTat,234,234,468,31,21,Tie
1157,TitForTat,219,219,438,19,27,Tie
1158,TitForTat,213,218,431,24,31,TitForTat
1159,TitForTat,219,219,438,25,29,Tie
1160,TitForTat,235,230,465,25,20,Player A
1161,TitForTat,238,243,481,35,18,TitForTat
1162,TitForTat,238,233,471,31,20,Player A
1163,TitForTat,222,227,449,21,24,TitForTat
1164,TitForTat,223,218,441,22,27,Player A
1165,TitForTat,229,229,458,24,22,Tie
1166,TitForTat,246,246,492,34,14,Tie
1167,TitForTat,222,222,444,22,26,Tie
1168,TitForTat,206,211,417,22,35,TitForTat
1169,TitForTat,228,223,451,20,23,Player A
1170,TitForTat,228,228,456,22,22,Tie
1171,TitForTat,207,212,419,18,33,TitForTat
1172,TitForTat,238,233,471,25,18,Player A
1173,TitForTat,227,227,454,26,24,Tie
1174,TitForTat,232,232,464,21,19,Tie
1175,TitForTat,238,243,481,35,18,TitForTat
1176,TitForTat,233,233,466,26,20,Tie
1177,TitForTat,227,222,449,21,24,Player A
1178,TitForTat,215,215,430,14,28,Tie
1179,TitForTat,224,229,453,28,25,TitForTat
1180,TitForTat,233,228,461,27,22,Player A
1181,TitForTat,228,228,456,34,26,Tie
1182,TitForTat,221,221,442,23,27,Tie
1183,TitForTat,241,241,482,33,17,Tie
1184,TitForTat,226,226,452,24,24,Tie
1185,TitForTat,226,226,452,21,23,Tie
1186,TitForTat,233,238,471,28,19,TitForTat
1187,TitForTat,228,223,451,20,23,Player A
1188,TitForTat,230,230,460,32,24,Tie
1189,TitForTat,222,222,444,25,27,Tie
1190,TitForTat,225,230,455,27,24,TitForTat
1191,TitForTat,232,227,459,25,22,Player A
1192,TitForTat,221,226,447,31,28,TitForTat
1193,TitForTat,224,224,448,23,25,Tie
1194,TitForTat,235,235,470,30,20,Tie
1195,TitForTat,222,222,444,25,27,Tie
1196,TitForTat,240,240,480,25,15,Tie
1197,TitForTat,224,219,443,24,27,Player A
1198,TitForTat,203,208,411,16,35,TitForTat
1199,TitForTat,214,214,428,24,32,Tie
1200,TitForTat,232,232,464,27,21,Tie
1201,TitForTat,217,212,429,16,29,Player A
1202,TitForTat,237,237,474,28,18,Tie
1203,TitForTat,222,222,444,25,27,Tie
1204,TitForTat,227,232,459,28,23,TitForTat
1205,TitForTat,247,247,494,36,14,Tie
1206,TitForTat,221,221,442,23,27,Tie
1207,TitForTat,231,226,457,23,22,Player A
1208,TitForTat,246,246,492,37,15,Tie
1209,TitForTat,240,240,480,34,18,Tie
1210,TitForTat,219,219,438,25,29,Tie
1211,TitForTat,214,214,428,18,30,Tie
1212,TitForTat,228,233,461,27,22,TitForTat
1213,TitForTat,229,224,453,28,25,Player A
1214,TitForTat,234,234,468,28,20,Tie
1215,TitForTat,242,242,484,32,16,Tie
1216,TitForTat,216,221,437,27,30,TitForTat
1217,TitForTat,225,225,450,28,26,Tie
1218,TitForTat,221,216,437,24,29,Player A
1219,TitForTat,219,219,438,25,29,Tie
1220,TitForTat,227,232,459,25,22,TitForTat
1221,TitForTat,252,252,504,34,10,Tie
1222,TitForTat,231,226,457,20,21,Player A
1223,TitForTat,235,235,470,24,18,Tie
1224,TitForTat,204,209,413,18,35,TitForTat
1225,TitForTat,227,227,454,29,25,Tie
1226,TitForTat,231,231,462,22,20,Tie
1227,TitForTat,221,221,442,17,25,Tie
1228,TitForTat,224,219,443,21,26,Player A
1229,TitForTat,202,207,409,14,35,TitForTat
1230,TitForTat,219,214,433,23,30,Player A
1231,TitForTat,227,227,454,23,23,Tie
1232,TitForTat,218,223,441,19,26,TitForTat
1233,TitForTat,226,221,447,25,26,Player A
1234,TitForTat,197,197,394,11,39,Tie
1235,TitForTat,233,238,471,28,19,TitForTat
1236,TitForTat,227,227,454,26,24,Tie
1237,TitForTat,232,232,464,27,21,Tie
1238,TitForTat,214,214,428,21,31,Tie
1239,TitForTat,227,222,449,27,26,Player A
1240,TitForTat,220,225,445,23,26,TitForTat
1241,TitForTat,233,228,461,21,20,Player A
1242,TitForTat,208,208,416,18,34,Tie
1243,TitForTat,203,208,411,13,34,TitForTat
1244,TitForTat,218,218,436,23,29,Tie
1245,TitForTat,222,222,444,19,25,Tie
1246,TitForTat,233,228,461,27,22,Player A
1247,TitForTat,245,245,490,38,16,Tie
1248,TitForTat,227,232,459,28,23,TitForTat
1249,TitForTat,229,229,458,27,23,Tie
1250,TitForTat,222,217,439,29,30,Player A
1251,TitForTat,205,210,415,14,33,TitForTat
1252,TitForTat,209,204,413,18,35,Player A
1253,TitForTat,219,224,443,24,27,TitForTat
1254,TitForTat,230,225,455,24,23,Player A
1255,TitForTat,220,225,445,23,26,TitForTat
1256,TitForTat,237,232,469,26,19,Player A
1257,TitForTat,224,229,453,22,23,TitForTat
1258,TitForTat,221,221,442,26,28,Tie
1259,TitForTat,243,238,481,29,16,Player A
1260,TitForTat,242,247,489,25,12,TitForTat
1261,TitForTat,241,236,477,31,18,Player A
1262,TitForTat,221,221,442,26,28,Tie
1263,TitForTat,226,226,452,24,24,Tie
1264,TitForTat,215,215,430,23,31,Tie
1265,TitForTat,238,238,476,30,18,Tie
1266,TitForTat,225,225,450,19,23,Tie
1267,TitForTat,217,222,439,23,28,TitForTat
1268,TitForTat,214,214,428,21,31,Tie
1269,TitForTat,225,225,450,28,26,Tie
1270,TitForTat,236,236,472,38,22,Tie
1271,TitForTat,225,220,445,20,25,Player A
1272,TitForTat,232,232,464,30,22,Tie
1273,TitForTat,225,225,450,22,24,Tie
1274,TitForTat,241,241,482,39,19,Tie
1275,TitForTat,225,225,450,22,24,Tie
1276,TitForTat,208,208,416,18,34,Tie
1277,TitForTat,230,235,465,31,22,TitForTat
1278,TitForTat,233,228,461,27,22,Player A
1279,TitForTat,225,230,455,27,24,TitForTat
1280,TitForTat,234,234,468,28,20,Tie
1281,TitForTat,210,205,415,23,36,Player A
1282,TitForTat,229,234,463,20,19,TitForTat
1283,TitForTat,226,226,452,27,25,Tie
1284,TitForTat,217,212,429,22,31,Player A
1285,TitForTat,222,222,444,25,27,Tie
1286,TitForTat,229,234,463,32,23,TitForTat
1287,TitForTat,232,227,459,25,22,Player A
1288,TitForTat,202,207,409,14,35,TitForTat
1289,TitForTat,222,217,439,23,28,Player A
1290,TitForTat,209,209,418,20,34,Tie
1291,TitForTat,227,227,454,20,22,Tie
1292,TitForTat,208,208,416,18,34,Tie
1293,TitForTat,229,234,463,32,23,TitForTat
1294,TitForTat,236,236,472,26,18,Tie
1295,TitForTat,234,234,468,28,20,Tie
1296,TitForTat,230,230,460,20,20,Tie
1297,TitForTat,207,207,414,19,35,Tie
1298,TitForTat,221,216,437,21,28,Player A
1299,TitForTat,194,199,393,7,38,TitForTat
1300,TitForTat,229,224,453,25,24,Player A
1301,TitForTat,227,232,459,28,23,TitForTat
1302,TitForTat,226,221,447,22,25,Player A
1303,TitForTat,221,226,447,28,27,TitForTat
1304,TitForTat,232,227,459,25,22,Player A
1305,TitForTat,223,223,446,18,24,Tie
1306,TitForTat,232,237,469,23,18,TitForTat
1307,TitForTat,228,228,456,28,24,Tie
1308,TitForTat,234,229,463,23,20,Player A
1309,TitForTat,225,225,450,25,25,Tie
1310,TitForTat,240,240,480,34,18,Tie
1311,TitForTat,235,240,475,26,17,TitForTat
1312,TitForTat,204,204,408,16,36,Tie
1313,TitForTat,221,221,442,26,28,Tie
1314,TitForTat,244,244,488,30,14,Tie
1315,TitForTat,225,220,445,20,25,Player A
1316,TitForTat,232,237,469,29,20,TitForTat
1317,TitForTat,232,227,459,31,24,Player A
1318,TitForTat,219,224,443,24,27,TitForTat
1319,TitForTat,236,236,472,26,18,Tie
1320,TitForTat,225,225,450,25,25,Tie
1321,TitForTat,228,223,451,26,25,Player A
1322,TitForTat,229,229,458,30,24,Tie
1323,TitForTat,218,223,441,19,26,TitForTat
1324,TitForTat,214,214,428,21,31,Tie
1325,TitForTat,211,206,417,19,34,Player A
1326,TitForTat,230,230,460,35,25,Tie
1327,TitForTat,226,226,452,27,25,Tie
1328,TitForTat,210,215,425,21,32,TitForTat
1329,TitForTat,221,221,442,23,27,Tie
1330,TitForTat,201,201,402,19,39,Tie
1331,TitForTat,221,216,437,24,29,Player A
1332,TitForTat,222,222,444,19,25,Tie
1333,TitForTat,207,212,419,21,34,TitForTat
1334,TitForTat,229,229,458,24,22,Tie
1335,TitForTat,227,222,449,24,25,Player A
1336,TitForTat,229,234,463,20,19,TitForTat
1337,TitForTat,221,216,437,18,27,Player A
1338,TitForTat,239,244,483,31,16,TitForTat
1339,TitForTat,216,211,427,20,31,Player A
1340,TitForTat,216,216,432,28,32,Tie
1341,TitForTat,221,221,442,17,25,Tie
1342,TitForTat,232,232,464,30,22,Tie
1343,TitForTat,216,221,437,18,27,TitForTat
1344,TitForTat,229,229,458,24,22,Tie
1345,TitForTat,230,230,460,32,24,Tie
1346,TitForTat,240,240,480,37,19,Tie
1347,TitForTat,224,219,443,18,25,Player A
1348,TitForTat,212,212,424,17,31,Tie
1349,TitForTat,223,228,451,26,25,TitForTat
1350,TitForTat,221,221,442,23,27,Tie
1351,TitForTat,214,209,423,22,33,Player A
1352,TitForTat,214,219,433,23,30,TitForTat
1353,TitForTat,242,237,479,27,16,Player A
1354,TitForTat,204,204,408,19,37,Tie
1355,TitForTat,225,230,455,30,25,TitForTat
1356,TitForTat,220,220,440,21,27,Tie
1357,TitForTat,230,225,455,27,24,Player A
1358,TitForTat,235,240,475,29,18,TitForTat
1359,TitForTat,227,222,449,27,26,Player A
1360,TitForTat,215,215,430,23,31,Tie
1361,TitForTat,203,203,406,17,37,Tie
1362,TitForTat,214,219,433,23,30,TitForTat
1363,TitForTat,231,231,462,22,20,Tie
1364,TitForTat,227,227,454,26,24,Tie
1365,TitForTat,219,219,438,28,30,Tie
1366,TitForTat,234,229,463,23,20,Player A
1367,TitForTat,221,226,447,22,25,TitForTat
1368,TitForTat,227,227,454,32,26,Tie
1369,TitForTat,227,227,454,29,25,Tie
1370,TitForTat,224,224,448,32,28,Tie
1371,TitForTat,204,204,408,16,36,Tie
1372,TitForTat,230,225,455,27,24,Player A
1373,TitForTat,225,230,455,24,23,TitForTat
1374,TitForTat,225,225,450,19,23,Tie
1375,TitForTat,233,228,461,30,23,Player A
1376,TitForTat,227,232,459,25,22,TitForTat
1377,TitForTat,206,206,412,17,35,Tie
1378,TitForTat,231,231,462,28,22,Tie
1379,TitForTat,235,235,470,33,21,Tie
1380,TitForTat,239,239,478,26,16,Tie
1381,TitForTat,238,238,476,27,17,Tie
1382,TitForTat,230,230,460,26,22,Tie
1383,TitForTat,219,219,438,16,26,Tie
1384,TitForTat,224,219,443,18,25,Player A
1385,TitForTat,212,217,429,25,32,TitForTat
1386,TitForTat,219,219,438,16,26,Tie
1387,TitForTat,232,232,464,24,20,Tie
1388,TitForTat,235,230,465,22,19,Player A
1389,TitForTat,214,219,433,20,29,TitForTat
1390,TitForTat,208,208,416,18,34,Tie
1391,TitForTat,220,220,440,27,29,Tie
1392,TitForTat,235,230,465,37,24,Player A
1393,TitForTat,229,234,463,26,21,TitForTat
1394,TitForTat,240,235,475,26,17,Player A
1395,TitForTat,224,229,453,25,24,TitForTat
1396,TitForTat,225,225,450,22,24,Tie
1397,TitForTat,253,248,501,34,11,Player A
1398,TitForTat,222,227,449,30,27,TitForTat
1399,TitForTat,230,230,460,29,23,Tie
1400,TitForTat,229,224,453,22,23,Player A
1401,TitForTat,216,221,437,21,28,TitForTat
1402,TitForTat,223,218,441,19,26,Player A
1403,TitForTat,221,226,447,31,28,TitForTat
1404,TitForTat,215,215,430,17,29,Tie
1405,TitForTat,237,232,469,23,18,Player A
1406,TitForTat,228,228,456,31,25,Tie
1407,TitForTat,229,234,463,23,20,TitForTat
1408,TitForTat,219,214,433,20,29,Player A
1409,TitForTat,210,210,420,25,35,Tie
1410,TitForTat,228,233,461,18,19,TitForTat
1411,TitForTat,225,225,450,28,26,Tie
1412,TitForTat,225,220,445,32,29,Player A
1413,TitForTat,230,235,465,31,22,TitForTat
1414,TitForTat,222,217,439,32,31,Player A
1415,TitForTat,190,190,380,18,46,Tie
1416,TitForTat,221,226,447,28,27,TitForTat
1417,TitForTat,227,222,449,18,23,Player A
1418,TitForTat,226,231,457,23,22,TitForTat
1419,TitForTat,220,220,440,24,28,Tie
1420,TitForTat,219,214,433,20,29,Player A
1421,TitForTat,224,229,453,28,25,TitForTat
1422,TitForTat,234,229,463,32,23,Player A
1423,TitForTat,212,217,429,19,30,TitForTat
1424,TitForTat,216,216,432,19,29,Tie
1425,TitForTat,232,227,459,28,23,Player A
1426,TitForTat,233,233,466,23,19,Tie
1427,TitForTat,225,230,455,33,26,TitForTat
1428,TitForTat,233,228,461,24,21,Player A
1429,TitForTat,227,227,454,26,24,Tie
1430,TitForTat,231,231,462,28,22,Tie
1431,TitForTat,195,195,390,16,42,Tie
1432,TitForTat,230,235,465,31,22,TitForTat
1433,TitForTat,227,227,454,26,24,Tie
1434,TitForTat,238,233,471,31,20,Player A
1435,TitForTat,233,238,471,28,19,TitForTat
1436,TitForTat,219,214,433,20,29,Player A
1437,TitForTat,220,220,440,24,28,Tie
1438,TitForTat,220,220,440,18,26,Tie
1439,TitForTat,225,230,455,24,23,TitForTat
1440,TitForTat,236,236,472,23,17,Tie
1441,TitForTat,216,216,432,25,31,Tie
1442,TitForTat,239,239,478,26,16,Tie
1443,TitForTat,219,219,438,19,27,Tie
1444,TitForTat,229,229,458,21,21,Tie
1445,TitForTat,206,201,407,18,37,Player A
1446,TitForTat,214,219,433,23,30,TitForTat
1447,TitForTat,217,212,429,16,29,Player A
1448,TitForTat,223,223,446,18,24,Tie
1449,TitForTat,225,225,450,19,23,Tie
1450,TitForTat,228,233,461,27,22,TitForTat
1451,TitForTat,225,225,450,28,26,Tie
1452,TitForTat,218,213,431,24,31,Player A
1453,TitForTat,241,246,487,38,17,TitForTat
1454,TitForTat,233,228,461,30,23,Player A
1455,TitForTat,214,214,428,21,31,Tie
1456,TitForTat,224,224,448,23,25,Tie
1457,TitForTat,221,221,442,23,27,Tie
1458,TitForTat,230,235,465,25,20,TitForTat
1459,TitForTat,244,239,483,31,16,Player A
1460,TitForTat,203,208,411,16,35,TitForTat
1461,TitForTat,235,230,465,28,21,Player A
1462,TitForTat,227,227,454,29,25,Tie
1463,TitForTat,232,237,469,32,21,TitForTat
1464,TitForTat,227,227,454,29,25,Tie
1465,TitForTat,218,218,436,23,29,Tie
1466,TitForTat,206,206,412,14,34,Tie
1467,TitForTat,216,216,432,19,29,Tie
1468,TitForTat,235,230,465,34,23,Player A
1469,TitForTat,230,235,465,28,21,TitForTat
1470,TitForTat,233,228,461,27,22,Player A
1471,TitForTat,217,222,439,26,29,TitForTat
1472,TitForTat,241,236,477,31,18,Player A
1473,TitForTat,218,223,441,25,28,TitForTat
1474,TitForTat,231,226,457,23,22,Player A
1475,TitForTat,233,238,471,34,21,TitForTat
1476,TitForTat,215,215,430,20,30,Tie
1477,TitForTat,228,228,456,28,24,Tie
1478,TitForTat,229,224,453,25,24,Player A
1479,TitForTat,217,222,439,20,27,TitForTat
1480,TitForTat,209,204,413,18,35,Player A
1481,TitForTat,224,224,448,32,28,Tie
1482,TitForTat,234,234,468,22,18,Tie
1483,TitForTat,238,238,476,33,19,Tie
1484,TitForTat,233,233,466,29,21,Tie
1485,TitForTat,214,214,428,27,33,Tie
1486,TitForTat,214,214,428,18,30,Tie
1487,TitForTat,235,235,470,27,19,Tie
1488,TitForTat,216,221,437,21,28,TitForTat
1489,TitForTat,231,226,457,29,24,Player A
1490,TitForTat,226,231,457,26,23,TitForTat
1491,TitForTat,235,230,465,28,21,Player A
1492,TitForTat,209,209,418,23,35,Tie
1493,TitForTat,210,215,425,18,31,TitForTat
1494,TitForTat,231,231,462,25,21,Tie
1495,TitForTat,225,220,445,26,27,Player A
1496,TitForTat,220,225,445,23,26,TitForTat
1497,TitForTat,222,222,444,22,26,Tie
1498,TitForTat,238,238,476,27,17,Tie
1499,TitForTat,203,198,401,24,41,Player A
1500,TitForTat,211,216,427,23,32,TitForTat
1501,TitForTat,214,209,423,22,33,Player A
1502,TitForTat,234,239,473,27,18,TitForTat
1503,TitForTat,231,231,462,28,22,Tie
1504,TitForTat,222,222,444,22,26,Tie
1505,TitForTat,237,232,469,32,21,Player A
1506,TitForTat,217,217,434,21,29,Tie
1507,TitForTat,218,223,441,25,28,TitForTat
1508,TitForTat,224,224,448,23,25,Tie
1509,TitForTat,232,232,464,27,21,Tie
1510,TitForTat,215,215,430,23,31,Tie
1511,TitForTat,229,224,453,31,26,Player A
1512,TitForTat,209,209,418,14,32,Tie
1513,TitForTat,219,224,443,24,27,TitForTat
1514,TitForTat,227,222,449,24,25,Player A
1515,TitForTat,206,206,412,17,35,Tie
1516,TitForTat,208,208,416,18,34,Tie
1517,TitForTat,213,213,426,16,30,Tie
1518,TitForTat,211,211,422,18,32,Tie
1519,TitForTat,223,228,451,26,25,TitForTat
1520,TitForTat,233,233,466,29,21,Tie
1521,TitForTat,224,224,448,29,27,Tie
1522,TitForTat,229,229,458,24,22,Tie
1523,TitForTat,237,232,469,23,18,Player A
1524,TitForTat,220,220,440,18,26,Tie
1525,TitForTat,213,213,426,22,32,Tie
1526,TitForTat,221,226,447,19,24,TitForTat
1527,TitForTat,234,229,463,26,21,Player A
1528,TitForTat,224,229,453,25,24,TitForTat
1529,TitForTat,229,224,453,22,23,Player A
1530,TitForTat,214,219,433,20,29,TitForTat
1531,TitForTat,235,230,465,25,20,Player A
1532,TitForTat,222,227,449,33,28,TitForTat
1533,TitForTat,228,228,456,37,27,Tie
1534,TitForTat,218,213,431,21,30,Player A
1535,TitForTat,224,229,453,25,24,TitForTat
1536,TitForTat,245,240,485,30,15,Player A
1537,TitForTat,217,222,439,23,28,TitForTat
1538,TitForTat,223,218,441,25,28,Player A
1539,TitForTat,203,203,406,17,37,Tie
1540,TitForTat,231,231,462,25,21,Tie
1541,TitForTat,216,216,432,16,28,Tie
1542,TitForTat,211,211,422,12,30,Tie
1543,TitForTat,224,229,453,19,22,TitForTat
1544,TitForTat,241,236,477,34,19,Player A
1545,TitForTat,224,229,453,31,26,TitForTat
1546,TitForTat,228,223,451,26,25,Player A
1547,TitForTat,209,214,423,28,35,TitForTat
1548,TitForTat,218,218,436,23,29,Tie
1549,TitForTat,241,236,477,25,16,Player A
1550,TitForTat,213,213,426,16,30,Tie
1551,TitForTat,214,214,428,21,31,Tie
1552,TitForTat,240,245,485,33,16,TitForTat
1553,TitForTat,225,225,450,28,26,Tie
1554,TitForTat,231,231,462,28,22,Tie
1555,TitForTat,230,230,460,23,21,Tie
1556,TitForTat,221,221,442,23,27,Tie
1557,TitForTat,214,214,428,21,31,Tie
1558,TitForTat,234,229,463,26,21,Player A
1559,TitForTat,214,214,428,18,30,Tie
1560,TitForTat,222,222,444,25,27,Tie
1561,TitForTat,198,203,401,18,39,TitForTat
1562,TitForTat,204,199,403,20,39,Player A
1563,TitForTat,220,225,445,23,26,TitForTat
1564,TitForTat,241,241,482,33,17,Tie
1565,TitForTat,210,210,420,22,34,Tie
1566,TitForTat,237,232,469,26,19,Player A
1567,TitForTat,225,225,450,28,26,Tie
1568,TitForTat,215,215,430,23,31,Tie
1569,TitForTat,228,233,461,21,20,TitForTat
1570,TitForTat,213,213,426,22,32,Tie
1571,TitForTat,231,231,462,25,21,Tie
1572,TitForTat,250,245,495,31,12,Player A
1573,TitForTat,216,216,432,22,30,Tie
1574,TitForTat,226,226,452,21,23,Tie
1575,TitForTat,240,245,485,33,16,TitForTat
1576,TitForTat,225,225,450,25,25,Tie
1577,TitForTat,232,232,464,24,20,Tie
1578,TitForTat,231,226,457,26,23,Player A
1579,TitForTat,229,234,463,29,22,TitForTat
1580,TitForTat,236,231,467,27,20,Player A
1581,TitForTat,208,213,421,17,32,TitForTat
1582,TitForTat,232,232,464,27,21,Tie
1583,TitForTat,233,233,466,23,19,Tie
1584,TitForTat,225,220,445,29,28,Player A
1585,TitForTat,223,223,446,24,26,Tie
1586,TitForTat,219,219,438,22,28,Tie
1587,TitForTat,209,209,418,17,33,Tie
1588,TitForTat,237,237,474,37,21,Tie
1589,TitForTat,245,245,490,41,17,Tie
1590,TitForTat,239,244,483,37,18,TitForTat
1591,TitForTat,214,214,428,12,28,Tie
1592,TitForTat,211,211,422,18,32,Tie
1593,TitForTat,229,229,458,33,25,Tie
1594,TitForTat,221,221,442,20,26,Tie
1595,TitForTat,219,214,433,17,28,Player A
1596,TitForTat,214,219,433,23,30,TitForTat
1597,TitForTat,219,219,438,16,26,Tie
1598,TitForTat,224,224,448,29,27,Tie
1599,TitForTat,235,230,465,25,20,Player A
1600,TitForTat,225,230,455,27,24,TitForTat
1601,TitForTat,223,223,446,30,28,Tie
1602,TitForTat,245,240,485,33,16,Player A
1603,TitForTat,237,242,479,30,17,TitForTat
1604,TitForTat,226,221,447,25,26,Player A
1605,TitForTat,230,235,465,25,20,TitForTat
1606,TitForTat,236,231,467,33,22,Player A
1607,TitForTat,215,220,435,19,28,TitForTat
1608,TitForTat,225,220,445,23,26,Player A
1609,TitForTat,229,234,463,23,20,TitForTat
1610,TitForTat,228,228,456,28,24,Tie
1611,TitForTat,217,217,434,24,30,Tie
1612,TitForTat,216,216,432,28,32,Tie
1613,TitForTat,230,225,455,21,22,Player A
1614,TitForTat,216,216,432,19,29,Tie
1615,TitForTat,230,235,465,25,20,TitForTat
1616,TitForTat,230,230,460,35,25,Tie
1617,TitForTat,223,218,441,34,31,Player A
1618,TitForTat,216,221,437,21,28,TitForTat
1619,TitForTat,232,232,464,27,21,Tie
1620,TitForTat,219,219,438,31,31,Tie
1621,TitForTat,242,237,479,33,18,Player A
1622,TitForTat,224,229,453,22,23,TitForTat
1623,TitForTat,230,225,455,18,21,Player A
1624,TitForTat,233,238,471,28,19,TitForTat
1625,TitForTat,233,233,466,26,20,Tie
1626,TitForTat,222,222,444,25,27,Tie
1627,TitForTat,226,221,447,28,27,Player A
1628,TitForTat,217,222,439,20,27,TitForTat
1629,TitForTat,225,225,450,25,25,Tie
1630,TitForTat,224,219,443,21,26,Player A
1631,TitForTat,222,222,444,25,27,Tie
1632,TitForTat,212,217,429,25,32,TitForTat
1633,TitForTat,239,234,473,33,20,Player A
1634,TitForTat,219,224,443,24,27,TitForTat
1635,TitForTat,221,216,437,21,28,Player A
1636,TitForTat,221,226,447,22,25,TitForTat
1637,TitForTat,216,216,432,22,30,Tie
1638,TitForTat,209,204,413,15,34,Player A
1639,TitForTat,213,218,431,18,29,TitForTat
1640,TitForTat,242,242,484,26,14,Tie
1641,TitForTat,221,221,442,26,28,Tie
1642,TitForTat,240,235,475,20,15,Player A
1643,TitForTat,224,229,453,28,25,TitForTat
1644,TitForTat,213,213,426,19,31,Tie
1645,TitForTat,227,227,454,26,24,Tie
1646,TitForTat,224,224,448,26,26,Tie
1647,TitForTat,244,244,488,33,15,Tie
1648,TitForTat,227,222,449,24,25,Player A
1649,TitForTat,216,216,432,19,29,Tie
1650,TitForTat,218,218,436,23,29,Tie
1651,TitForTat,228,233,461,24,21,TitForTat
1652,TitForTat,233,233,466,26,20,Tie
1653,TitForTat,206,201,407,12,35,Player A
1654,TitForTat,237,237,474,25,17,Tie
1655,TitForTat,224,224,448,26,26,Tie
1656,TitForTat,226,226,452,30,26,Tie
1657,TitForTat,228,228,456,28,24,Tie
1658,TitForTat,220,220,440,30,30,Tie
1659,TitForTat,211,211,422,27,35,Tie
1660,TitForTat,211,216,427,20,31,TitForTat
1661,TitForTat,222,217,439,17,26,Player A
0,Bayesian,181,226,407,15,36,Bayesian
1,Bayesian,195,260,455,27,24,Bayesian
2,Bayesian,228,203,431,24,31,Player A
3,Bayesian,227,212,439,26,29,Player A
4,Bayesian,192,242,434,24,30,Bayesian
5,Bayesian,185,235,420,22,34,Bayesian
6,Bayesian,233,198,431,27,32,Player A
7,Bayesian,256,211,467,30,21,Player A
8,Bayesian,263,228,491,30,13,Player A
9,Bayesian,200,250,450,22,24,Bayesian
10,Bayesian,209,239,448,26,26,Bayesian
11,Bayesian,210,225,435,22,29,Bayesian
12,Bayesian,212,232,444,22,26,Bayesian
13,Bayesian,183,268,451,23,24,Bayesian
14,Bayesian,248,218,466,23,19,Player A
15,Bayesian,216,236,452,27,25,Bayesian
16,Bayesian,252,232,484,29,15,Player A
17,Bayesian,224,214,438,22,28,Player A
18,Bayesian,229,204,433,20,29,Player A
19,Bayesian,211,236,447,22,25,Bayesian
20,Bayesian,211,251,462,34,24,Bayesian
21,Bayesian,225,220,445,20,25,Player A
22,Bayesian,225,225,450,28,26,Tie
23,Bayesian,232,217,449,27,26,Player A
24,Bayesian,223,228,451,26,25,Bayesian
25,Bayesian,251,206,457,29,24,Player A
26,Bayesian,214,219,433,17,28,Bayesian
27,Bayesian,222,222,444,28,28,Tie
28,Bayesian,183,263,446,18,24,Bayesian
29,Bayesian,217,227,444,28,28,Bayesian
30,Bayesian,237,217,454,26,24,Player A
31,Bayesian,209,229,438,22,28,Bayesian
32,Bayesian,245,205,450,28,26,Player A
33,Bayesian,226,201,427,17,30,Player A
34,Bayesian,243,213,456,31,25,Player A
35,Bayesian,241,211,452,30,26,Player A
36,Bayesian,247,197,444,22,26,Player A
37,Bayesian,189,244,433,26,31,Bayesian
38,Bayesian,243,223,466,26,20,Player A
39,Bayesian,246,211,457,26,23,Player A
40,Bayesian,232,232,464,24,20,Tie
41,Bayesian,221,231,452,24,24,Bayesian
42,Bayesian,218,223,441,25,28,Bayesian
43,Bayesian,253,203,456,31,25,Player A
44,Bayesian,213,228,441,25,28,Bayesian
45,Bayesian,230,210,440,18,26,Player A
46,Bayesian,208,253,461,27,22,Bayesian
47,Bayesian,234,214,448,17,23,Player A
48,Bayesian,239,224,463,26,21,Player A
49,Bayesian,239,204,443,27,28,Player A
50,Bayesian,224,209,433,26,31,Player A
51,Bayesian,236,226,462,28,22,Player A
52,Bayesian,207,222,429,19,30,Bayesian
53,Bayesian,228,218,446,27,27,Player A
54,Bayesian,216,236,452,24,24,Bayesian
55,Bayesian,239,234,473,36,21,Player A
56,Bayesian,215,210,425,18,31,Player A
57,Bayesian,212,247,459,34,25,Bayesian
58,Bayesian,222,212,434,24,30,Player A
59,Bayesian,221,241,462,19,19,Bayesian
60,Bayesian,243,228,471,28,19,Player A
61,Bayesian,198,228,426,16,30,Bayesian
62,Bayesian,257,202,459,31,24,Player A
63,Bayesian,233,208,441,25,28,Player A
64,Bayesian,243,213,456,28,24,Player A
65,Bayesian,239,204,443,21,26,Player A
66,Bayesian,212,237,449,24,25,Bayesian
67,Bayesian,241,201,442,26,28,Player A
68,Bayesian,224,224,448,26,26,Tie
69,Bayesian,206,256,462,22,20,Bayesian
70,Bayesian,240,215,455,24,23,Player A
71,Bayesian,226,201,427,20,31,Player A
72,Bayesian,242,227,469,29,20,Player A
73,Bayesian,235,220,455,30,25,Player A
74,Bayesian,228,218,446,27,27,Player A
75,Bayesian,212,237,449,27,26,Bayesian
76,Bayesian,273,193,466,23,19,Player A
77,Bayesian,261,216,477,31,18,Player A
78,Bayesian,232,197,429,16,29,Player A
79,Bayesian,215,225,440,21,27,Bayesian
80,Bayesian,219,244,463,26,21,Bayesian
81,Bayesian,213,238,451,20,23,Bayesian
82,Bayesian,217,242,459,28,23,Bayesian
83,Bayesian,211,251,462,31,23,Bayesian
84,Bayesian,221,231,452,33,27,Bayesian
85,Bayesian,230,200,430,20,30,Player A
86,Bayesian,222,247,469,23,18,Bayesian
87,Bayesian,231,211,442,20,26,Player A
88,Bayesian,202,242,444,22,26,Bayesian
89,Bayesian,224,214,438,22,28,Player A
90,Bayesian,200,210,410,18,36,Bayesian
91,Bayesian,247,187,434,15,27,Player A
92,Bayesian,243,208,451,23,24,Player A
93,Bayesian,238,203,441,25,28,Player A
94,Bayesian,245,205,450,19,23,Player A
95,Bayesian,231,221,452,30,26,Player A
96,Bayesian,234,244,478,26,16,Bayesian
97,Bayesian,209,249,458,27,23,Bayesian
98,Bayesian,201,221,422,21,33,Bayesian
99,Bayesian,275,190,465,25,20,Player A
100,Bayesian,243,218,461,27,22,Player A
101,Bayesian,200,240,440,24,28,Bayesian
102,Bayesian,205,215,420,13,31,Bayesian
103,Bayesian,257,202,459,25,22,Player A
104,Bayesian,193,288,481,32,17,Bayesian
105,Bayesian,216,231,447,25,26,Bayesian
106,Bayesian,207,257,464,27,21,Bayesian
107,Bayesian,209,199,408,22,38,Player A
108,Bayesian,232,227,459,31,24,Player A
109,Bayesian,205,235,440,21,27,Bayesian
110,Bayesian,226,236,462,28,22,Bayesian
111,Bayesian,233,198,431,21,30,Player A
112,Bayesian,225,240,465,34,23,Bayesian
113,Bayesian,239,194,433,20,29,Player A
114,Bayesian,182,267,449,21,24,Bayesian
115,Bayesian,211,246,457,26,23,Bayesian
116,Bayesian,265,200,465,28,21,Player A
117,Bayesian,216,216,432,22,30,Tie
118,Bayesian,228,208,436,23,29,Player A
119,Bayesian,202,237,439,26,29,Bayesian
120,Bayesian,243,213,456,25,23,Player A
121,Bayesian,230,225,455,24,23,Player A
122,Bayesian,232,237,469,26,19,Bayesian
123,Bayesian,217,247,464,24,20,Bayesian
124,Bayesian,219,229,448,26,26,Bayesian
125,Bayesian,219,214,433,26,31,Player A
126,Bayesian,224,244,468,28,20,Bayesian
127,Bayesian,235,235,470,21,17,Tie
128,Bayesian,220,215,435,19,28,Player A
129,Bayesian,204,244,448,26,26,Bayesian
130,Bayesian,248,213,461,24,21,Player A
131,Bayesian,229,219,448,23,25,Player A
132,Bayesian,253,203,456,25,23,Player A
133,Bayesian,229,229,458,24,22,Tie
134,Bayesian,244,179,423,22,33,Player A
135,Bayesian,179,274,453,22,23,Bayesian
136,Bayesian,211,226,437,21,28,Bayesian
137,Bayesian,196,241,437,21,28,Bayesian
138,Bayesian,217,232,449,24,25,Bayesian
139,Bayesian,202,237,439,23,28,Bayesian
140,Bayesian,246,216,462,22,20,Player A
141,Bayesian,217,252,469,35,22,Bayesian
142,Bayesian,243,203,446,21,25,Player A
143,Bayesian,224,254,478,32,18,Bayesian
144,Bayesian,217,222,439,17,26,Bayesian
145,Bayesian,211,246,457,20,21,Bayesian
146,Bayesian,180,230,410,15,35,Bayesian
147,Bayesian,245,225,470,24,18,Player A
148,Bayesian,224,219,443,27,28,Player A
149,Bayesian,247,207,454,20,22,Player A
150,Bayesian,242,207,449,30,27,Player A
151,Bayesian,194,269,463,29,22,Bayesian
152,Bayesian,253,223,476,24,16,Player A
153,Bayesian,210,240,450,25,25,Bayesian
154,Bayesian,230,220,450,22,24,Player A
155,Bayesian,201,236,437,27,30,Bayesian
156,Bayesian,207,247,454,23,23,Bayesian
157,Bayesian,223,238,461,33,24,Bayesian
158,Bayesian,227,217,444,25,27,Player A
159,Bayesian,245,200,445,23,26,Player A
160,Bayesian,229,219,448,20,24,Player A
161,Bayesian,241,211,452,27,25,Player A
162,Bayesian,222,232,454,20,22,Bayesian
163,Bayesian,233,238,471,31,20,Bayesian
164,Bayesian,216,211,427,29,34,Player A
165,Bayesian,215,225,440,18,26,Bayesian
166,Bayesian,213,248,461,30,23,Bayesian
167,Bayesian,215,240,455,24,23,Bayesian
168,Bayesian,256,216,472,26,18,Player A
169,Bayesian,212,232,444,22,26,Bayesian
170,Bayesian,209,244,453,19,22,Bayesian
171,Bayesian,227,212,439,23,28,Player A
172,Bayesian,209,239,448,20,24,Bayesian
173,Bayesian,229,249,478,32,18,Bayesian
174,Bayesian,200,220,420,19,33,Bayesian
175,Bayesian,228,233,461,27,22,Bayesian
176,Bayesian,217,207,424,17,31,Player A
177,Bayesian,207,232,439,20,27,Bayesian
178,Bayesian,248,208,456,25,23,Player A
179,Bayesian,227,227,454,26,24,Tie
180,Bayesian,260,195,455,18,21,Player A
181,Bayesian,211,246,457,26,23,Bayesian
182,Bayesian,271,171,442,29,29,Player A
183,Bayesian,241,191,432,25,31,Player A
184,Bayesian,218,228,446,27,27,Bayesian
185,Bayesian,231,206,437,24,29,Player A
186,Bayesian,208,233,441,28,29,Bayesian
187,Bayesian,242,202,444,28,28,Player A
188,Bayesian,211,236,447,28,27,Bayesian
189,Bayesian,216,216,432,22,30,Tie
190,Bayesian,212,227,439,23,28,Bayesian
191,Bayesian,245,235,480,31,17,Player A
192,Bayesian,251,226,477,28,17,Player A
193,Bayesian,221,231,452,21,23,Bayesian
194,Bayesian,215,230,445,20,25,Bayesian
195,Bayesian,259,184,443,21,26,Player A
196,Bayesian,240,230,470,36,22,Player A
197,Bayesian,226,236,462,25,21,Bayesian
198,Bayesian,191,266,457,32,25,Bayesian
199,Bayesian,224,229,453,28,25,Bayesian
200,Bayesian,241,236,477,31,18,Player A
201,Bayesian,243,208,451,26,25,Player A
202,Bayesian,197,217,414,13,33,Bayesian
203,Bayesian,198,253,451,26,25,Bayesian
204,Bayesian,212,237,449,24,25,Bayesian
205,Bayesian,224,224,448,29,27,Tie
206,Bayesian,214,229,443,24,27,Bayesian
207,Bayesian,206,236,442,20,26,Bayesian
208,Bayesian,226,236,462,34,24,Bayesian
209,Bayesian,200,230,430,26,32,Bayesian
210,Bayesian,218,233,451,20,23,Bayesian
211,Bayesian,218,188,406,14,36,Player A
212,Bayesian,229,199,428,21,31,Player A
213,Bayesian,248,208,456,25,23,Player A
214,Bayesian,250,215,465,22,19,Player A
215,Bayesian,209,229,438,19,27,Bayesian
216,Bayesian,227,202,429,22,31,Player A
217,Bayesian,244,224,468,31,21,Player A
218,Bayesian,227,232,459,31,24,Bayesian
219,Bayesian,241,201,442,26,28,Player A
220,Bayesian,211,221,432,19,29,Bayesian
221,Bayesian,215,245,460,20,20,Bayesian
222,Bayesian,211,241,452,24,24,Bayesian
223,Bayesian,198,233,431,27,32,Bayesian
224,Bayesian,202,247,449,27,26,Bayesian
225,Bayesian,240,210,450,25,25,Player A
226,Bayesian,216,226,442,26,28,Bayesian
227,Bayesian,229,214,443,21,26,Player A
228,Bayesian,211,246,457,23,22,Bayesian
229,Bayesian,234,204,438,22,28,Player A
230,Bayesian,226,226,452,27,25,Tie
231,Bayesian,222,222,444,28,28,Tie
232,Bayesian,218,233,451,23,24,Bayesian
233,Bayesian,224,214,438,25,29,Player A
234,Bayesian,208,228,436,23,29,Bayesian
235,Bayesian,217,252,469,23,18,Bayesian
236,Bayesian,240,210,450,19,23,Player A
237,Bayesian,194,259,453,25,24,Bayesian
238,Bayesian,211,221,432,22,30,Bayesian
239,Bayesian,228,218,446,24,26,Player A
240,Bayesian,234,229,463,26,21,Player A
241,Bayesian,236,211,447,28,27,Player A
242,Bayesian,214,214,428,24,32,Tie
243,Bayesian,244,199,443,27,28,Player A
244,Bayesian,200,230,430,23,31,Bayesian
245,Bayesian,219,219,438,19,27,Tie
246,Bayesian,244,234,478,35,19,Player A
247,Bayesian,228,228,456,25,23,Tie
248,Bayesian,227,212,439,23,28,Player A
249,Bayesian,234,209,443,21,26,Player A
250,Bayesian,255,220,475,32,19,Player A
251,Bayesian,180,245,425,18,31,Bayesian
252,Bayesian,254,209,463,23,20,Player A
253,Bayesian,207,232,439,29,30,Bayesian
254,Bayesian,252,197,449,27,26,Player A
255,Bayesian,235,245,480,34,18,Bayesian
256,Bayesian,223,213,436,20,28,Player A
257,Bayesian,209,239,448,29,27,Bayesian
258,Bayesian,188,253,441,25,28,Bayesian
259,Bayesian,235,225,460,26,22,Player A
260,Bayesian,223,238,461,30,23,Bayesian
261,Bayesian,226,211,437,24,29,Player A
262,Bayesian,238,203,441,25,28,Player A
263,Bayesian,214,229,443,21,26,Bayesian
264,Bayesian,197,227,424,20,32,Bayesian
265,Bayesian,181,281,462,25,21,Bayesian
266,Bayesian,228,228,456,31,25,Tie
267,Bayesian,244,204,448,17,23,Player A
268,Bayesian,199,214,413,21,36,Bayesian
269,Bayesian,241,211,452,18,22,Player A
270,Bayesian,228,233,461,24,21,Bayesian
271,Bayesian,254,194,448,26,26,Player A
272,Bayesian,214,224,438,25,29,Bayesian
273,Bayesian,235,215,450,19,23,Player A
274,Bayesian,220,200,420,22,34,Player A
275,Bayesian,237,207,444,25,27,Player A
276,Bayesian,215,215,430,23,31,Tie
277,Bayesian,227,227,454,23,23,Tie
278,Bayesian,211,241,452,33,27,Bayesian
279,Bayesian,230,235,465,28,21,Bayesian
280,Bayesian,240,225,465,25,20,Player A
281,Bayesian,247,187,434,21,29,Player A
282,Bayesian,233,218,451,29,26,Player A
283,Bayesian,245,215,460,23,21,Player A
284,Bayesian,176,291,467,27,20,Bayesian
285,Bayesian,234,219,453,25,24,Player A
286,Bayesian,260,185,445,26,27,Player A
287,Bayesian,244,224,468,25,19,Player A
288,Bayesian,208,218,426,19,31,Bayesian
289,Bayesian,206,256,462,22,20,Bayesian
290,Bayesian,224,219,443,30,29,Player A
291,Bayesian,231,216,447,22,25,Player A
292,Bayesian,217,222,439,20,27,Bayesian
293,Bayesian,226,231,457,29,24,Bayesian
294,Bayesian,198,233,431,24,31,Bayesian
295,Bayesian,196,226,422,21,33,Bayesian
296,Bayesian,219,244,463,29,22,Bayesian
297,Bayesian,230,250,480,28,16,Bayesian
298,Bayesian,227,232,459,22,21,Bayesian
299,Bayesian,248,178,426,22,32,Player A
300,Bayesian,202,262,464,24,20,Bayesian
301,Bayesian,190,255,445,26,27,Bayesian
302,Bayesian,259,224,483,28,15,Player A
303,Bayesian,210,245,455,21,22,Bayesian
304,Bayesian,227,247,474,34,20,Bayesian
305,Bayesian,240,240,480,25,15,Tie
306,Bayesian,244,224,468,28,20,Player A
307,Bayesian,238,233,471,28,19,Player A
308,Bayesian,210,230,440,21,27,Bayesian
309,Bayesian,173,258,431,21,30,Bayesian
310,Bayesian,241,186,427,14,29,Player A
311,Bayesian,247,217,464,24,20,Player A
312,Bayesian,228,223,451,23,24,Player A
313,Bayesian,245,225,470,24,18,Player A
314,Bayesian,205,240,445,23,26,Bayesian
315,Bayesian,209,234,443,27,28,Bayesian
316,Bayesian,214,219,433,17,28,Bayesian
317,Bayesian,228,238,466,32,22,Bayesian
318,Bayesian,189,244,433,20,29,Bayesian
319,Bayesian,228,213,441,25,28,Player A
320,Bayesian,262,197,459,25,22,Player A
321,Bayesian,225,210,435,19,28,Player A
322,Bayesian,220,230,450,31,27,Bayesian
323,Bayesian,223,243,466,26,20,Bayesian
324,Bayesian,194,249,443,24,27,Bayesian
325,Bayesian,213,248,461,18,19,Bayesian
326,Bayesian,205,260,465,28,21,Bayesian
327,Bayesian,213,228,441,22,27,Bayesian
328,Bayesian,225,245,470,24,18,Bayesian
329,Bayesian,205,250,455,21,22,Bayesian
330,Bayesian,181,236,417,16,33,Bayesian
331,Bayesian,249,229,478,32,18,Player A
332,Bayesian,205,265,470,30,20,Bayesian
333,Bayesian,217,242,459,22,21,Bayesian
334,Bayesian,223,223,446,27,27,Tie
335,Bayesian,207,237,444,25,27,Bayesian
336,Bayesian,276,171,447,19,24,Player A
337,Bayesian,196,246,442,20,26,Bayesian
338,Bayesian,195,275,470,27,19,Bayesian
339,Bayesian,245,200,445,20,25,Player A
340,Bayesian,221,211,432,19,29,Player A
341,Bayesian,219,229,448,29,27,Bayesian
342,Bayesian,234,204,438,22,28,Player A
343,Bayesian,211,226,437,15,26,Bayesian
344,Bayesian,226,206,432,22,30,Player A
345,Bayesian,246,211,457,20,21,Player A
346,Bayesian,217,217,434,18,28,Tie
347,Bayesian,204,229,433,23,30,Bayesian
348,Bayesian,211,231,442,20,26,Bayesian
349,Bayesian,219,259,478,35,19,Bayesian
350,Bayesian,223,213,436,23,29,Player A
351,Bayesian,261,211,472,29,19,Player A
352,Bayesian,239,229,468,25,19,Player A
353,Bayesian,204,234,438,22,28,Bayesian
354,Bayesian,191,246,437,18,27,Bayesian
355,Bayesian,225,220,445,23,26,Player A
356,Bayesian,227,247,474,25,17,Bayesian
357,Bayesian,228,228,456,28,24,Tie
358,Bayesian,222,197,419,24,35,Player A
359,Bayesian,215,245,460,29,23,Bayesian
360,Bayesian,215,230,445,29,28,Bayesian
361,Bayesian,253,218,471,28,19,Player A
362,Bayesian,244,204,448,23,25,Player A
363,Bayesian,260,180,440,18,26,Player A
364,Bayesian,226,221,447,25,26,Player A
365,Bayesian,231,251,482,27,15,Bayesian
366,Bayesian,230,215,445,23,26,Player A
367,Bayesian,229,209,438,22,28,Player A
368,Bayesian,223,223,446,27,27,Tie
369,Bayesian,207,232,439,23,28,Bayesian
370,Bayesian,214,219,433,20,29,Bayesian
371,Bayesian,208,253,461,27,22,Bayesian
372,Bayesian,178,298,476,27,17,Bayesian
373,Bayesian,217,247,464,30,22,Bayesian
374,Bayesian,208,243,451,26,25,Bayesian
375,Bayesian,215,250,465,31,22,Bayesian
376,Bayesian,200,235,435,25,30,Bayesian
377,Bayesian,234,219,453,28,25,Player A
378,Bayesian,200,260,460,29,23,Bayesian
379,Bayesian,208,233,441,28,29,Bayesian
380,Bayesian,237,212,449,24,25,Player A
381,Bayesian,253,193,446,21,25,Player A
382,Bayesian,273,203,476,27,17,Player A
383,Bayesian,250,195,445,29,28,Player A
384,Bayesian,226,221,447,19,24,Player A
385,Bayesian,219,184,403,20,39,Player A
386,Bayesian,255,200,455,30,25,Player A
387,Bayesian,237,217,454,32,26,Player A
388,Bayesian,251,211,462,22,20,Player A
389,Bayesian,225,250,475,26,17,Bayesian
390,Bayesian,226,216,442,35,31,Player A
391,Bayesian,248,213,461,30,23,Player A
392,Bayesian,233,228,461,30,23,Player A
393,Bayesian,229,209,438,22,28,Player A
394,Bayesian,222,237,459,28,23,Bayesian
395,Bayesian,212,227,439,20,27,Bayesian
396,Bayesian,215,230,445,29,28,Bayesian
397,Bayesian,212,232,444,22,26,Bayesian
398,Bayesian,233,238,471,28,19,Bayesian
399,Bayesian,267,197,464,30,22,Player A
400,Bayesian,210,240,450,25,25,Bayesian
401,Bayesian,253,188,441,16,25,Player A
402,Bayesian,175,240,415,23,36,Bayesian
403,Bayesian,232,242,474,28,18,Bayesian
404,Bayesian,213,248,461,36,25,Bayesian
405,Bayesian,248,213,461,24,21,Player A
406,Bayesian,196,246,442,29,29,Bayesian
407,Bayesian,259,184,443,27,28,Player A
408,Bayesian,227,197,424,26,34,Player A
409,Bayesian,226,211,437,27,30,Player A
410,Bayesian,207,227,434,27,31,Bayesian
411,Bayesian,233,238,471,25,18,Bayesian
412,Bayesian,242,207,449,27,26,Player A
413,Bayesian,223,243,466,29,21,Bayesian
414,Bayesian,235,240,475,26,17,Bayesian
415,Bayesian,237,217,454,29,25,Player A
416,Bayesian,229,224,453,19,22,Player A
417,Bayesian,261,201,462,31,23,Player A
418,Bayesian,231,201,432,22,30,Player A
419,Bayesian,217,227,444,31,29,Bayesian
420,Bayesian,240,205,445,23,26,Player A
421,Bayesian,212,242,454,20,22,Bayesian
422,Bayesian,218,223,441,22,27,Bayesian
423,Bayesian,249,194,443,15,24,Player A
424,Bayesian,213,223,436,26,30,Bayesian
425,Bayesian,230,220,450,25,25,Player A
426,Bayesian,199,224,423,22,33,Bayesian
427,Bayesian,235,210,445,20,25,Player A
428,Bayesian,214,219,433,26,31,Bayesian
429,Bayesian,214,199,413,18,35,Player A
430,Bayesian,266,196,462,28,22,Player A
431,Bayesian,213,228,441,25,28,Bayesian
432,Bayesian,207,252,459,28,23,Bayesian
433,Bayesian,221,236,457,23,22,Bayesian
434,Bayesian,226,246,472,32,20,Bayesian
435,Bayesian,247,197,444,19,25,Player A
436,Bayesian,222,257,479,36,19,Bayesian
437,Bayesian,200,245,445,23,26,Bayesian
438,Bayesian,201,241,442,20,26,Bayesian
439,Bayesian,214,214,428,21,31,Tie
440,Bayesian,253,173,426,22,32,Player A
441,Bayesian,253,213,466,20,18,Player A
442,Bayesian,235,230,465,22,19,Player A
443,Bayesian,222,237,459,28,23,Bayesian
444,Bayesian,248,223,471,34,21,Player A
445,Bayesian,235,220,455,30,25,Player A
446,Bayesian,244,239,483,31,16,Player A
447,Bayesian,189,239,428,18,30,Bayesian
448,Bayesian,229,214,443,27,28,Player A
449,Bayesian,244,249,493,35,14,Bayesian
450,Bayesian,231,221,452,24,24,Player A
451,Bayesian,228,228,456,25,23,Tie
452,Bayesian,244,204,448,23,25,Player A
453,Bayesian,231,211,442,23,27,Player A
454,Bayesian,237,207,444,16,24,Player A
455,Bayesian,217,242,459,25,22,Bayesian
456,Bayesian,198,248,446,27,27,Bayesian
457,Bayesian,193,248,441,22,27,Bayesian
458,Bayesian,216,221,437,24,29,Bayesian
459,Bayesian,224,259,483,31,16,Bayesian
460,Bayesian,204,249,453,28,25,Bayesian
461,Bayesian,233,223,456,22,22,Player A
462,Bayesian,240,195,435,22,29,Player A
463,Bayesian,226,231,457,20,21,Bayesian
464,Bayesian,255,210,465,28,21,Player A
465,Bayesian,203,258,461,27,22,Bayesian
466,Bayesian,193,238,431,18,29,Bayesian
467,Bayesian,225,240,465,28,21,Bayesian
468,Bayesian,222,242,464,33,23,Bayesian
469,Bayesian,237,217,454,32,26,Player A
470,Bayesian,226,221,447,22,25,Player A
471,Bayesian,204,239,443,27,28,Bayesian
472,Bayesian,229,209,438,28,30,Player A
473,Bayesian,232,222,454,26,24,Player A
474,Bayesian,248,213,461,24,21,Player A
475,Bayesian,251,186,437,24,29,Player A
476,Bayesian,208,248,456,28,24,Bayesian
477,Bayesian,241,196,437,24,29,Player A
478,Bayesian,226,211,437,27,30,Player A
479,Bayesian,211,231,442,29,29,Bayesian
480,Bayesian,227,202,429,22,31,Player A
481,Bayesian,208,233,441,28,29,Bayesian
482,Bayesian,221,226,447,25,26,Bayesian
483,Bayesian,246,211,457,29,24,Player A
484,Bayesian,210,205,415,23,36,Player A
485,Bayesian,225,220,445,23,26,Player A
486,Bayesian,236,191,427,20,31,Player A
487,Bayesian,216,241,457,23,22,Bayesian
488,Bayesian,194,249,443,27,28,Bayesian
489,Bayesian,218,213,431,24,31,Player A
490,Bayesian,216,251,467,30,21,Bayesian
491,Bayesian,222,227,449,27,26,Bayesian
492,Bayesian,239,199,438,19,27,Player A
493,Bayesian,213,233,446,24,26,Bayesian
494,Bayesian,243,238,481,26,15,Player A
495,Bayesian,248,183,431,15,28,Player A
496,Bayesian,224,234,458,27,23,Bayesian
497,Bayesian,245,210,455,24,23,Player A
498,Bayesian,204,269,473,33,20,Bayesian
499,Bayesian,184,249,433,23,30,Bayesian
500,Bayesian,204,229,433,23,30,Bayesian
501,Bayesian,223,253,476,30,18,Bayesian
502,Bayesian,221,226,447,22,25,Bayesian
503,Bayesian,247,222,469,26,19,Player A
504,Bayesian,216,231,447,28,27,Bayesian
505,Bayesian,243,233,476,27,17,Player A
506,Bayesian,179,269,448,23,25,Bayesian
507,Bayesian,216,251,467,30,21,Bayesian
508,Bayesian,250,210,460,23,21,Player A
509,Bayesian,248,193,441,19,26,Player A
510,Bayesian,213,253,466,26,20,Bayesian
511,Bayesian,203,263,466,29,21,Bayesian
512,Bayesian,205,250,455,24,23,Bayesian
513,Bayesian,196,256,452,24,24,Bayesian
514,Bayesian,248,198,446,30,28,Player A
515,Bayesian,187,267,454,26,24,Bayesian
516,Bayesian,247,202,449,30,27,Player A
517,Bayesian,238,233,471,34,21,Player A
518,Bayesian,216,236,452,30,26,Bayesian
519,Bayesian,239,219,458,24,22,Player A
520,Bayesian,208,218,426,19,31,Bayesian
521,Bayesian,219,244,463,29,22,Bayesian
522,Bayesian,206,251,457,29,24,Bayesian
523,Bayesian,266,181,447,25,26,Player A
524,Bayesian,195,255,450,22,24,Bayesian
525,Bayesian,238,218,456,28,24,Player A
526,Bayesian,244,204,448,32,28,Player A
527,Bayesian,217,262,479,30,17,Bayesian
528,Bayesian,257,202,459,31,24,Player A
529,Bayesian,204,234,438,22,28,Bayesian
530,Bayesian,245,220,465,40,25,Player A
531,Bayesian,253,188,441,31,30,Player A
532,Bayesian,241,231,472,26,18,Player A
533,Bayesian,214,229,443,24,27,Bayesian
534,Bayesian,205,270,475,26,17,Bayesian
535,Bayesian,243,193,436,14,26,Player A
536,Bayesian,199,234,433,23,30,Bayesian
537,Bayesian,227,232,459,28,23,Bayesian
538,Bayesian,230,220,450,25,25,Player A
539,Bayesian,212,232,444,25,27,Bayesian
540,Bayesian,217,247,464,27,21,Bayesian
541,Bayesian,240,210,450,28,26,Player A
542,Bayesian,229,204,433,20,29,Player A
543,Bayesian,226,246,472,32,20,Bayesian
544,Bayesian,261,206,467,27,20,Player A
545,Bayesian,201,221,422,24,34,Bayesian
546,Bayesian,229,224,453,34,27,Player A
547,Bayesian,196,281,477,34,19,Bayesian
548,Bayesian,222,237,459,28,23,Bayesian
549,Bayesian,191,256,447,22,25,Bayesian
550,Bayesian,211,241,452,24,24,Bayesian
551,Bayesian,224,249,473,33,20,Bayesian
552,Bayesian,195,250,445,17,24,Bayesian
553,Bayesian,224,244,468,34,22,Bayesian
554,Bayesian,194,259,453,22,23,Bayesian
555,Bayesian,217,232,449,24,25,Bayesian
556,Bayesian,216,251,467,27,20,Bayesian
557,Bayesian,238,228,466,29,21,Player A
558,Bayesian,228,218,446,27,27,Player A
559,Bayesian,241,216,457,32,25,Player A
560,Bayesian,235,230,465,28,21,Player A
561,Bayesian,273,193,466,23,19,Player A
562,Bayesian,244,209,453,28,25,Player A
563,Bayesian,221,261,482,33,17,Bayesian
564,Bayesian,224,214,438,25,29,Player A
565,Bayesian,246,166,412,23,37,Player A
566,Bayesian,225,245,470,30,20,Bayesian
567,Bayesian,242,187,429,16,29,Player A
568,Bayesian,257,197,454,29,25,Player A
569,Bayesian,219,229,448,23,25,Bayesian
570,Bayesian,207,227,434,18,28,Bayesian
571,Bayesian,218,218,436,14,26,Tie
572,Bayesian,198,243,441,16,25,Bayesian
573,Bayesian,245,215,460,23,21,Player A
574,Bayesian,204,254,458,27,23,Bayesian
575,Bayesian,212,217,429,25,32,Bayesian
576,Bayesian,230,205,435,25,30,Player A
577,Bayesian,220,245,465,28,21,Bayesian
578,Bayesian,233,228,461,30,23,Player A
579,Bayesian,206,241,447,22,25,Bayesian
580,Bayesian,249,204,453,28,25,Player A
581,Bayesian,246,201,447,25,26,Player A
582,Bayesian,243,228,471,34,21,Player A
583,Bayesian,270,200,470,27,19,Player A
584,Bayesian,206,221,427,20,31,Bayesian
585,Bayesian,217,237,454,32,26,Bayesian
586,Bayesian,229,244,473,30,19,Bayesian
587,Bayesian,231,206,437,24,29,Player A
588,Bayesian,250,220,470,24,18,Player A
589,Bayesian,208,253,461,27,22,Bayesian
590,Bayesian,222,237,459,25,22,Bayesian
591,Bayesian,245,215,460,29,23,Player A
592,Bayesian,190,265,455,24,23,Bayesian
593,Bayesian,207,232,439,17,26,Bayesian
594,Bayesian,230,245,475,29,18,Bayesian
595,Bayesian,239,209,448,26,26,Player A
596,Bayesian,217,222,439,23,28,Bayesian
597,Bayesian,211,236,447,25,26,Bayesian
598,Bayesian,204,214,418,20,34,Bayesian
599,Bayesian,239,214,453,28,25,Player A
600,Bayesian,214,204,418,20,34,Player A
601,Bayesian,226,221,447,25,26,Player A
602,Bayesian,234,189,423,19,32,Player A
603,Bayesian,257,197,454,23,23,Player A
604,Bayesian,246,211,457,29,24,Player A
605,Bayesian,189,239,428,30,34,Bayesian
606,Bayesian,255,185,440,21,27,Player A
607,Bayesian,261,211,472,26,18,Player A
608,Bayesian,231,216,447,31,28,Player A
609,Bayesian,217,232,449,27,26,Bayesian
610,Bayesian,247,202,449,21,24,Player A
611,Bayesian,205,210,415,20,35,Bayesian
612,Bayesian,190,240,430,26,32,Bayesian
613,Bayesian,232,212,444,22,26,Player A
614,Bayesian,192,252,444,19,25,Bayesian
615,Bayesian,209,229,438,22,28,Bayesian
616,Bayesian,225,225,450,25,25,Tie
617,Bayesian,232,212,444,25,27,Player A
618,Bayesian,242,227,469,26,19,Player A
619,Bayesian,208,233,441,19,26,Bayesian
620,Bayesian,268,208,476,30,18,Player A
621,Bayesian,212,227,439,20,27,Bayesian
622,Bayesian,234,239,473,30,19,Bayesian
623,Bayesian,212,222,434,18,28,Bayesian
624,Bayesian,264,209,473,33,20,Player A
625,Bayesian,242,212,454,26,24,Player A
626,Bayesian,241,226,467,33,22,Player A
627,Bayesian,205,260,465,31,22,Bayesian
628,Bayesian,246,211,457,29,24,Player A
629,Bayesian,224,219,443,27,28,Player A
630,Bayesian,226,216,442,17,25,Player A
631,Bayesian,208,238,446,24,26,Bayesian
632,Bayesian,187,262,449,27,26,Bayesian
633,Bayesian,245,190,435,16,27,Player A
634,Bayesian,247,222,469,32,21,Player A
635,Bayesian,241,251,492,34,14,Bayesian
636,Bayesian,203,258,461,24,21,Bayesian
637,Bayesian,219,244,463,29,22,Bayesian
638,Bayesian,222,232,454,26,24,Bayesian
639,Bayesian,216,236,452,33,27,Bayesian
640,Bayesian,216,221,437,24,29,Bayesian
641,Bayesian,218,213,431,21,30,Player A
642,Bayesian,251,206,457,29,24,Player A
643,Bayesian,207,237,444,19,25,Bayesian
644,Bayesian,233,223,456,22,22,Player A
645,Bayesian,243,223,466,26,20,Player A
646,Bayesian,234,209,443,24,27,Player A
647,Bayesian,226,216,442,29,29,Player A
648,Bayesian,213,213,426,19,31,Tie
649,Bayesian,225,225,450,28,26,Tie
650,Bayesian,213,223,436,23,29,Bayesian
651,Bayesian,250,200,450,19,23,Player A
652,Bayesian,209,239,448,26,26,Bayesian
653,Bayesian,240,225,465,34,23,Player A
654,Bayesian,230,205,435,25,30,Player A
655,Bayesian,237,237,474,31,19,Tie
656,Bayesian,194,249,443,30,29,Bayesian
657,Bayesian,231,211,442,17,25,Player A
658,Bayesian,235,225,460,32,24,Player A
659,Bayesian,241,241,482,33,17,Tie
660,Bayesian,230,210,440,24,28,Player A
661,Bayesian,226,226,452,27,25,Tie
662,Bayesian,209,214,423,16,31,Bayesian
663,Bayesian,219,244,463,29,22,Bayesian
664,Bayesian,227,247,474,31,19,Bayesian
665,Bayesian,207,227,434,21,29,Bayesian
666,Bayesian,223,243,466,32,22,Bayesian
667,Bayesian,214,249,463,32,23,Bayesian
668,Bayesian,275,200,475,29,18,Player A
669,Bayesian,173,268,441,22,27,Bayesian
670,Bayesian,216,231,447,28,27,Bayesian
671,Bayesian,202,257,459,28,23,Bayesian
672,Bayesian,236,216,452,27,25,Player A
673,Bayesian,203,238,441,25,28,Bayesian
674,Bayesian,219,224,443,24,27,Bayesian
675,Bayesian,238,223,461,24,21,Player A
676,Bayesian,229,199,428,27,33,Player A
677,Bayesian,190,235,425,24,33,Bayesian
678,Bayesian,257,187,444,28,28,Player A
679,Bayesian,229,224,453,25,24,Player A
680,Bayesian,265,185,450,25,25,Player A
681,Bayesian,251,201,452,24,24,Player A
682,Bayesian,233,243,476,33,19,Bayesian
683,Bayesian,235,220,455,24,23,Player A
684,Bayesian,204,224,428,18,30,Bayesian
685,Bayesian,218,243,461,21,20,Bayesian
686,Bayesian,233,233,466,26,20,Tie
687,Bayesian,240,230,470,24,18,Player A
688,Bayesian,243,203,446,24,26,Player A
689,Bayesian,217,232,449,27,26,Bayesian
690,Bayesian,253,213,466,26,20,Player A
691,Bayesian,223,223,446,24,26,Tie
692,Bayesian,188,278,466,26,20,Bayesian
693,Bayesian,236,206,442,23,27,Player A
694,Bayesian,226,221,447,25,26,Player A
695,Bayesian,205,260,465,25,20,Bayesian
696,Bayesian,209,229,438,22,28,Bayesian
697,Bayesian,177,252,429,22,31,Bayesian
698,Bayesian,229,234,463,23,20,Bayesian
699,Bayesian,244,199,443,24,27,Player A
700,Bayesian,241,211,452,27,25,Player A
701,Bayesian,237,202,439,17,26,Player A
702,Bayesian,227,212,439,20,27,Player A
703,Bayesian,205,250,455,27,24,Bayesian
704,Bayesian,246,186,432,22,30,Player A
705,Bayesian,226,221,447,25,26,Player A
706,Bayesian,255,200,455,30,25,Player A
707,Bayesian,237,232,469,32,21,Player A
708,Bayesian,211,221,432,19,29,Bayesian
709,Bayesian,188,253,441,22,27,Bayesian
710,Bayesian,210,245,455,24,23,Bayesian
711,Bayesian,216,211,427,23,32,Player A
712,Bayesian,222,212,434,24,30,Player A
713,Bayesian,229,229,458,21,21,Tie
714,Bayesian,205,240,445,23,26,Bayesian
715,Bayesian,181,276,457,26,23,Bayesian
716,Bayesian,216,251,467,24,19,Bayesian
717,Bayesian,238,213,451,26,25,Player A
718,Bayesian,247,227,474,28,18,Player A
719,Bayesian,242,212,454,26,24,Player A
720,Bayesian,220,210,430,23,31,Player A
721,Bayesian,219,234,453,22,23,Bayesian
722,Bayesian,219,229,448,23,25,Bayesian
723,Bayesian,224,204,428,24,32,Player A
724,Bayesian,233,228,461,27,22,Player A
725,Bayesian,234,229,463,32,23,Player A
726,Bayesian,205,230,435,22,29,Bayesian
727,Bayesian,210,225,435,19,28,Bayesian
728,Bayesian,218,218,436,20,28,Tie
729,Bayesian,235,185,420,28,36,Player A
730,Bayesian,215,245,460,32,24,Bayesian
731,Bayesian,209,239,448,26,26,Bayesian
732,Bayesian,203,243,446,27,27,Bayesian
733,Bayesian,194,239,433,29,32,Bayesian
734,Bayesian,247,192,439,29,30,Player A
735,Bayesian,234,214,448,20,24,Player A
736,Bayesian,229,194,423,25,34,Player A
737,Bayesian,214,229,443,27,28,Bayesian
738,Bayesian,232,212,444,25,27,Player A
739,Bayesian,212,242,454,23,23,Bayesian
740,Bayesian,249,224,473,33,20,Player A
741,Bayesian,244,204,448,20,24,Player A
742,Bayesian,231,216,447,22,25,Player A
743,Bayesian,282,202,484,26,14,Player A
744,Bayesian,219,249,468,28,20,Bayesian
745,Bayesian,231,211,442,23,27,Player A
746,Bayesian,237,227,464,36,24,Player A
747,Bayesian,190,225,415,20,35,Bayesian
748,Bayesian,238,198,436,20,28,Player A
749,Bayesian,246,221,467,27,20,Player A
750,Bayesian,269,224,493,35,14,Player A
751,Bayesian,190,250,440,24,28,Bayesian
752,Bayesian,207,242,449,18,23,Bayesian
753,Bayesian,233,213,446,24,26,Player A
754,Bayesian,204,224,428,21,31,Bayesian
755,Bayesian,224,229,453,28,25,Bayesian
756,Bayesian,224,214,438,22,28,Player A
757,Bayesian,206,216,422,15,31,Bayesian
758,Bayesian,218,218,436,20,28,Tie
759,Bayesian,244,209,453,25,24,Player A
760,Bayesian,255,205,460,26,22,Player A
761,Bayesian,221,226,447,25,26,Bayesian
762,Bayesian,208,228,436,20,28,Bayesian
763,Bayesian,259,179,438,22,28,Player A
764,Bayesian,238,238,476,30,18,Tie
765,Bayesian,212,207,419,21,34,Player A
766,Bayesian,213,228,441,22,27,Bayesian
767,Bayesian,210,245,455,21,22,Bayesian
768,Bayesian,205,235,440,24,28,Bayesian
769,Bayesian,200,255,455,24,23,Bayesian
770,Bayesian,213,228,441,19,26,Bayesian
771,Bayesian,223,223,446,24,26,Tie
772,Bayesian,235,220,455,24,23,Player A
773,Bayesian,241,206,447,28,27,Player A
774,Bayesian,197,237,434,27,31,Bayesian
775,Bayesian,243,213,456,31,25,Player A
776,Bayesian,241,211,452,21,23,Player A
777,Bayesian,211,226,437,24,29,Bayesian
778,Bayesian,197,252,449,21,24,Bayesian
779,Bayesian,212,227,439,26,29,Bayesian
780,Bayesian,199,239,438,19,27,Bayesian
781,Bayesian,249,199,448,29,27,Player A
782,Bayesian,222,242,464,27,21,Bayesian
783,Bayesian,250,210,460,29,23,Player A
784,Bayesian,219,249,468,28,20,Bayesian
785,Bayesian,230,215,445,17,24,Player A
786,Bayesian,201,246,447,22,25,Bayesian
787,Bayesian,231,221,452,24,24,Player A
788,Bayesian,247,202,449,24,25,Player A
789,Bayesian,206,236,442,23,27,Bayesian
790,Bayesian,239,214,453,25,24,Player A
791,Bayesian,221,246,467,30,21,Bayesian
792,Bayesian,243,223,466,26,20,Player A
793,Bayesian,237,237,474,31,19,Tie
794,Bayesian,227,222,449,24,25,Player A
795,Bayesian,202,232,434,21,29,Bayesian
796,Bayesian,239,214,453,31,26,Player A
797,Bayesian,252,197,449,27,26,Player A
798,Bayesian,233,213,446,24,26,Player A
799,Bayesian,242,207,449,24,25,Player A
800,Bayesian,218,203,421,14,31,Player A
801,Bayesian,258,203,461,24,21,Player A
802,Bayesian,247,227,474,31,19,Player A
803,Bayesian,234,219,453,25,24,Player A
804,Bayesian,241,216,457,26,23,Player A
805,Bayesian,228,228,456,28,24,Tie
806,Bayesian,258,198,456,25,23,Player A
807,Bayesian,220,215,435,25,30,Player A
808,Bayesian,233,228,461,24,21,Player A
809,Bayesian,214,204,418,32,38,Player A
810,Bayesian,210,235,445,26,27,Bayesian
811,Bayesian,222,232,454,26,24,Bayesian
812,Bayesian,215,260,475,23,16,Bayesian
813,Bayesian,232,217,449,24,25,Player A
814,Bayesian,239,204,443,24,27,Player A
815,Bayesian,220,240,460,26,22,Bayesian
816,Bayesian,228,248,476,33,19,Bayesian
817,Bayesian,238,248,486,31,15,Bayesian
818,Bayesian,245,205,450,22,24,Player A
819,Bayesian,230,210,440,24,28,Player A
820,Bayesian,235,215,450,22,24,Player A
821,Bayesian,231,221,452,24,24,Player A
822,Bayesian,214,229,443,21,26,Bayesian
823,Bayesian,235,215,450,19,23,Player A
824,Bayesian,198,248,446,30,28,Bayesian
825,Bayesian,196,241,437,24,29,Bayesian
826,Bayesian,212,247,459,22,21,Bayesian
827,Bayesian,239,209,448,23,25,Player A
828,Bayesian,214,224,438,19,27,Bayesian
829,Bayesian,214,234,448,20,24,Bayesian
830,Bayesian,209,239,448,20,24,Bayesian
831,Bayesian,247,207,454,26,24,Player A
832,Bayesian,220,230,450,22,24,Bayesian
833,Bayesian,230,220,450,16,22,Player A
834,Bayesian,243,203,446,24,26,Player A
835,Bayesian,210,245,455,33,26,Bayesian
836,Bayesian,183,268,451,23,24,Bayesian
837,Bayesian,204,234,438,22,28,Bayesian
838,Bayesian,244,219,463,26,21,Player A
839,Bayesian,210,215,425,18,31,Bayesian
840,Bayesian,218,238,456,25,23,Bayesian
841,Bayesian,267,197,464,24,20,Player A
842,Bayesian,244,209,453,28,25,Player A
843,Bayesian,242,202,444,22,26,Player A
844,Bayesian,238,213,451,23,24,Player A
845,Bayesian,230,230,460,32,24,Tie
846,Bayesian,193,238,431,21,30,Bayesian
847,Bayesian,246,211,457,29,24,Player A
848,Bayesian,256,216,472,29,19,Player A
849,Bayesian,245,215,460,26,22,Player A
850,Bayesian,236,216,452,27,25,Player A
851,Bayesian,206,236,442,23,27,Bayesian
852,Bayesian,203,233,436,29,31,Bayesian
853,Bayesian,232,217,449,30,27,Player A
854,Bayesian,244,209,453,28,25,Player A
855,Bayesian,192,237,429,16,29,Bayesian
856,Bayesian,206,216,422,21,33,Bayesian
857,Bayesian,239,164,403,20,39,Player A
858,Bayesian,246,226,472,35,21,Player A
859,Bayesian,231,211,442,26,28,Player A
860,Bayesian,207,267,474,28,18,Bayesian
861,Bayesian,233,208,441,25,28,Player A
862,Bayesian,234,209,443,21,26,Player A
863,Bayesian,202,227,429,19,30,Bayesian
864,Bayesian,228,228,456,25,23,Tie
865,Bayesian,233,203,436,26,30,Player A
866,Bayesian,222,232,454,26,24,Bayesian
867,Bayesian,251,216,467,27,20,Player A
868,Bayesian,238,213,451,23,24,Player A
869,Bayesian,227,217,444,25,27,Player A
870,Bayesian,205,240,445,23,26,Bayesian
871,Bayesian,226,231,457,26,23,Bayesian
872,Bayesian,195,245,440,24,28,Bayesian
873,Bayesian,234,239,473,33,20,Bayesian
874,Bayesian,234,239,473,27,18,Bayesian
875,Bayesian,234,204,438,25,29,Player A
876,Bayesian,230,240,470,30,20,Bayesian
877,Bayesian,227,227,454,32,26,Tie
878,Bayesian,212,222,434,21,29,Bayesian
879,Bayesian,219,234,453,25,24,Bayesian
880,Bayesian,220,250,470,24,18,Bayesian
881,Bayesian,199,259,458,24,22,Bayesian
882,Bayesian,220,230,450,22,24,Bayesian
883,Bayesian,215,235,450,25,25,Bayesian
884,Bayesian,220,210,430,23,31,Player A
885,Bayesian,241,231,472,23,17,Player A
886,Bayesian,224,229,453,28,25,Bayesian
887,Bayesian,242,217,459,25,22,Player A
888,Bayesian,228,213,441,22,27,Player A
889,Bayesian,184,264,448,26,26,Bayesian
890,Bayesian,208,228,436,23,29,Bayesian
891,Bayesian,242,207,449,18,23,Player A
892,Bayesian,195,210,405,16,37,Bayesian
893,Bayesian,215,200,415,14,33,Player A
894,Bayesian,241,226,467,30,21,Player A
895,Bayesian,191,236,427,23,32,Bayesian
896,Bayesian,245,220,465,31,22,Player A
897,Bayesian,240,200,440,24,28,Player A
898,Bayesian,225,260,485,33,16,Bayesian
899,Bayesian,246,196,442,23,27,Player A
900,Bayesian,248,218,466,29,21,Player A
901,Bayesian,241,231,472,26,18,Player A
902,Bayesian,251,231,482,33,17,Player A
903,Bayesian,228,228,456,19,21,Tie
904,Bayesian,217,257,474,31,19,Bayesian
905,Bayesian,258,203,461,24,21,Player A
906,Bayesian,226,236,462,31,23,Bayesian
907,Bayesian,234,209,443,18,25,Player A
908,Bayesian,179,244,423,22,33,Bayesian
909,Bayesian,222,227,449,27,26,Bayesian
910,Bayesian,226,201,427,20,31,Player A
911,Bayesian,252,207,459,31,24,Player A
912,Bayesian,227,227,454,20,22,Tie
913,Bayesian,197,247,444,19,25,Bayesian
914,Bayesian,217,252,469,26,19,Bayesian
915,Bayesian,226,196,422,21,33,Player A
916,Bayesian,236,221,457,26,23,Player A
917,Bayesian,270,195,465,28,21,Player A
918,Bayesian,205,230,435,22,29,Bayesian
919,Bayesian,224,249,473,36,21,Bayesian
920,Bayesian,242,237,479,30,17,Player A
921,Bayesian,222,242,464,30,22,Bayesian
922,Bayesian,236,231,467,30,21,Player A
923,Bayesian,217,232,449,24,25,Bayesian
924,Bayesian,205,230,435,19,28,Bayesian
925,Bayesian,251,216,467,21,18,Player A
926,Bayesian,221,216,437,21,28,Player A
927,Bayesian,211,246,457,29,24,Bayesian
928,Bayesian,206,216,422,21,33,Bayesian
929,Bayesian,245,230,475,35,20,Player A
930,Bayesian,241,186,427,20,31,Player A
931,Bayesian,238,238,476,33,19,Tie
932,Bayesian,221,221,442,17,25,Tie
933,Bayesian,258,188,446,21,25,Player A
934,Bayesian,241,221,462,28,22,Player A
935,Bayesian,230,230,460,26,22,Tie
936,Bayesian,212,222,434,21,29,Bayesian
937,Bayesian,235,225,460,32,24,Player A
938,Bayesian,243,188,431,21,30,Player A
939,Bayesian,192,257,449,30,27,Bayesian
940,Bayesian,235,225,460,32,24,Player A
941,Bayesian,254,214,468,25,19,Player A
942,Bayesian,223,238,461,27,22,Bayesian
943,Bayesian,225,230,455,30,25,Bayesian
944,Bayesian,208,238,446,24,26,Bayesian
945,Bayesian,274,174,448,26,26,Player A
946,Bayesian,234,209,443,21,26,Player A
947,Bayesian,186,246,432,22,30,Bayesian
948,Bayesian,201,221,422,18,32,Bayesian
949,Bayesian,261,211,472,26,18,Player A
950,Bayesian,227,217,444,22,26,Player A
951,Bayesian,220,240,460,32,24,Bayesian
952,Bayesian,261,201,462,31,23,Player A
953,Bayesian,188,268,456,22,22,Bayesian
954,Bayesian,277,187,464,24,20,Player A
955,Bayesian,233,218,451,26,25,Player A
956,Bayesian,253,213,466,20,18,Player A
957,Bayesian,248,213,461,33,24,Player A
958,Bayesian,191,231,422,21,33,Bayesian
959,Bayesian,227,232,459,25,22,Bayesian
960,Bayesian,213,238,451,20,23,Bayesian
961,Bayesian,233,228,461,30,23,Player A
962,Bayesian,204,244,448,26,26,Bayesian
963,Bayesian,207,237,444,22,26,Bayesian
964,Bayesian,223,233,456,34,26,Bayesian
965,Bayesian,238,223,461,33,24,Player A
966,Bayesian,205,255,460,35,25,Bayesian
967,Bayesian,242,212,454,26,24,Player A
968,Bayesian,219,224,443,24,27,Bayesian
969,Bayesian,236,211,447,22,25,Player A
970,Bayesian,227,217,444,22,26,Player A
971,Bayesian,243,208,451,26,25,Player A
972,Bayesian,245,215,460,23,21,Player A
973,Bayesian,209,219,428,21,31,Bayesian
974,Bayesian,222,257,479,36,19,Bayesian
975,Bayesian,221,241,462,34,24,Bayesian
976,Bayesian,225,215,440,24,28,Player A
977,Bayesian,235,215,450,25,25,Player A
978,Bayesian,239,229,468,25,19,Player A
979,Bayesian,224,254,478,26,16,Bayesian
980,Bayesian,215,215,430,20,30,Tie
981,Bayesian,257,212,469,29,20,Player A
982,Bayesian,238,213,451,23,24,Player A
983,Bayesian,202,232,434,24,30,Bayesian
984,Bayesian,210,240,450,25,25,Bayesian
985,Bayesian,224,214,438,22,28,Player A
986,Bayesian,235,250,485,27,14,Bayesian
987,Bayesian,262,187,449,24,25,Player A
988,Bayesian,218,233,451,23,24,Bayesian
989,Bayesian,253,203,456,25,23,Player A
990,Bayesian,226,216,442,20,26,Player A
991,Bayesian,236,216,452,21,23,Player A
992,Bayesian,249,189,438,25,29,Player A
993,Bayesian,217,242,459,25,22,Bayesian
994,Bayesian,239,209,448,23,25,Player A
995,Bayesian,261,201,462,25,21,Player A
996,Bayesian,206,236,442,20,26,Bayesian
997,Bayesian,218,238,456,22,22,Bayesian
998,Bayesian,237,212,449,24,25,Player A
999,Bayesian,219,229,448,20,24,Bayesian
1000,Bayesian,202,217,419,18,33,Bayesian
1001,Bayesian,231,236,467,24,19,Bayesian
1002,Bayesian,221,236,457,17,20,Bayesian
1003,Bayesian,225,225,450,22,24,Tie
1004,Bayesian,232,197,429,19,30,Player A
1005,Bayesian,243,213,456,22,22,Player A
1006,Bayesian,204,229,433,26,31,Bayesian
1007,Bayesian,200,260,460,26,22,Bayesian
1008,Bayesian,200,230,430,17,29,Bayesian
1009,Bayesian,205,235,440,24,28,Bayesian
1010,Bayesian,237,207,444,19,25,Player A
1011,Bayesian,226,226,452,24,24,Tie
1012,Bayesian,240,215,455,30,25,Player A
1013,Bayesian,267,162,429,19,30,Player A
1014,Bayesian,196,256,452,24,24,Bayesian
1015,Bayesian,243,223,466,29,21,Player A
1016,Bayesian,236,201,437,24,29,Player A
1017,Bayesian,252,197,449,21,24,Player A
1018,Bayesian,217,247,464,27,21,Bayesian
1019,Bayesian,231,226,457,26,23,Player A
1020,Bayesian,252,202,454,26,24,Player A
1021,Bayesian,222,227,449,27,26,Bayesian
1022,Bayesian,219,219,438,31,31,Tie
1023,Bayesian,192,257,449,24,25,Bayesian
1024,Bayesian,236,211,447,22,25,Player A
1025,Bayesian,186,251,437,18,27,Bayesian
1026,Bayesian,206,241,447,25,26,Bayesian
1027,Bayesian,231,211,442,20,26,Player A
1028,Bayesian,219,219,438,25,29,Tie
1029,Bayesian,248,198,446,24,26,Player A
1030,Bayesian,250,200,450,28,26,Player A
1031,Bayesian,233,238,471,31,20,Bayesian
1032,Bayesian,218,263,481,32,17,Bayesian
1033,Bayesian,223,213,436,23,29,Player A
1034,Bayesian,244,219,463,26,21,Player A
1035,Bayesian,201,236,437,24,29,Bayesian
1036,Bayesian,190,275,465,19,18,Bayesian
1037,Bayesian,214,224,438,22,28,Bayesian
1038,Bayesian,202,232,434,18,28,Bayesian
1039,Bayesian,235,210,445,23,26,Player A
1040,Bayesian,223,213,436,20,28,Player A
1041,Bayesian,251,216,467,30,21,Player A
1042,Bayesian,233,223,456,22,22,Player A
1043,Bayesian,223,233,456,25,23,Bayesian
1044,Bayesian,212,252,464,24,20,Bayesian
1045,Bayesian,270,205,475,20,15,Player A
1046,Bayesian,215,230,445,26,27,Bayesian
1047,Bayesian,252,202,454,23,23,Player A
1048,Bayesian,245,220,465,31,22,Player A
1049,Bayesian,231,211,442,26,28,Player A
1050,Bayesian,235,220,455,33,26,Player A
1051,Bayesian,245,190,435,19,28,Player A
1052,Bayesian,242,222,464,30,22,Player A
1053,Bayesian,201,251,452,30,26,Bayesian
1054,Bayesian,226,206,432,28,32,Player A
1055,Bayesian,232,207,439,23,28,Player A
1056,Bayesian,229,224,453,25,24,Player A
1057,Bayesian,241,206,447,22,25,Player A
1058,Bayesian,262,187,449,15,22,Player A
1059,Bayesian,206,236,442,26,28,Bayesian
1060,Bayesian,184,249,433,20,29,Bayesian
1061,Bayesian,229,239,468,25,19,Bayesian
1062,Bayesian,237,217,454,23,23,Player A
1063,Bayesian,228,248,476,30,18,Bayesian
1064,Bayesian,197,257,454,26,24,Bayesian
1065,Bayesian,228,233,461,27,22,Bayesian
1066,Bayesian,252,197,449,27,26,Player A
1067,Bayesian,231,211,442,26,28,Player A
1068,Bayesian,263,213,476,21,15,Player A
1069,Bayesian,217,227,444,25,27,Bayesian
1070,Bayesian,237,212,449,24,25,Player A
1071,Bayesian,241,201,442,26,28,Player A
1072,Bayesian,228,238,466,20,18,Bayesian
1073,Bayesian,217,222,439,23,28,Bayesian
1074,Bayesian,234,199,433,17,28,Player A
1075,Bayesian,223,213,436,26,30,Player A
1076,Bayesian,243,223,466,23,19,Player A
1077,Bayesian,195,265,460,23,21,Bayesian
1078,Bayesian,262,207,469,29,20,Player A
1079,Bayesian,248,213,461,30,23,Player A
1080,Bayesian,229,229,458,30,24,Tie
1081,Bayesian,219,239,458,33,25,Bayesian
1082,Bayesian,241,241,482,36,18,Tie
1083,Bayesian,244,204,448,32,28,Player A
1084,Bayesian,214,224,438,25,29,Bayesian
1085,Bayesian,199,234,433,23,30,Bayesian
1086,Bayesian,195,250,445,23,26,Bayesian
1087,Bayesian,215,245,460,26,22,Bayesian
1088,Bayesian,239,219,458,24,22,Player A
1089,Bayesian,242,212,454,26,24,Player A
1090,Bayesian,192,242,434,27,31,Bayesian
1091,Bayesian,245,220,465,28,21,Player A
1092,Bayesian,205,250,455,24,23,Bayesian
1093,Bayesian,213,238,451,23,24,Bayesian
1094,Bayesian,202,252,454,23,23,Bayesian
1095,Bayesian,265,200,465,25,20,Player A
1096,Bayesian,224,209,433,26,31,Player A
1097,Bayesian,225,230,455,21,22,Bayesian
1098,Bayesian,196,206,402,16,38,Bayesian
1099,Bayesian,238,233,471,34,21,Player A
1100,Bayesian,242,242,484,32,16,Tie
1101,Bayesian,216,211,427,20,31,Player A
1102,Bayesian,209,264,473,33,20,Bayesian
1103,Bayesian,209,249,458,21,21,Bayesian
1104,Bayesian,229,214,443,21,26,Player A
1105,Bayesian,245,230,475,26,17,Player A
1106,Bayesian,205,245,450,25,25,Bayesian
1107,Bayesian,192,252,444,22,26,Bayesian
1108,Bayesian,223,228,451,23,24,Bayesian
1109,Bayesian,217,222,439,20,27,Bayesian
1110,Bayesian,223,203,426,16,30,Player A
1111,Bayesian,209,239,448,23,25,Bayesian
1112,Bayesian,230,220,450,22,24,Player A
1113,Bayesian,225,250,475,29,18,Bayesian
1114,Bayesian,232,202,434,24,30,Player A
1115,Bayesian,193,268,461,27,22,Bayesian
1116,Bayesian,204,249,453,28,25,Bayesian
1117,Bayesian,207,222,429,25,32,Bayesian
1118,Bayesian,224,169,393,16,41,Player A
1119,Bayesian,230,220,450,19,23,Player A
1120,Bayesian,219,234,453,22,23,Bayesian
1121,Bayesian,217,207,424,20,32,Player A
1122,Bayesian,237,232,469,29,20,Player A
1123,Bayesian,228,213,441,19,26,Player A
1124,Bayesian,239,214,453,28,25,Player A
1125,Bayesian,240,200,440,24,28,Player A
1126,Bayesian,263,203,466,26,20,Player A
1127,Bayesian,212,217,429,22,31,Bayesian
1128,Bayesian,224,194,418,17,33,Player A
1129,Bayesian,210,225,435,22,29,Bayesian
1130,Bayesian,231,226,457,23,22,Player A
1131,Bayesian,227,212,439,23,28,Player A
1132,Bayesian,238,218,456,28,24,Player A
1133,Bayesian,221,236,457,23,22,Bayesian
1134,Bayesian,235,220,455,27,24,Player A
1135,Bayesian,202,232,434,18,28,Bayesian
1136,Bayesian,239,204,443,18,25,Player A
1137,Bayesian,222,237,459,25,22,Bayesian
1138,Bayesian,220,225,445,17,24,Bayesian
1139,Bayesian,220,200,420,19,33,Player A
1140,Bayesian,256,206,462,28,22,Player A
1141,Bayesian,228,233,461,27,22,Bayesian
1142,Bayesian,208,228,436,26,30,Bayesian
1143,Bayesian,194,239,433,20,29,Bayesian
1144,Bayesian,236,216,452,24,24,Player A
1145,Bayesian,243,223,466,29,21,Player A
1146,Bayesian,244,199,443,24,27,Player A
1147,Bayesian,209,244,453,25,24,Bayesian
1148,Bayesian,196,261,457,29,24,Bayesian
1149,Bayesian,203,218,421,20,33,Bayesian
1150,Bayesian,227,222,449,27,26,Player A
1151,Bayesian,257,202,459,31,24,Player A
1152,Bayesian,276,186,462,28,22,Player A
1153,Bayesian,206,236,442,29,29,Bayesian
1154,Bayesian,230,235,465,28,21,Bayesian
1155,Bayesian,272,192,464,27,21,Player A
1156,Bayesian,218,223,441,25,28,Bayesian
1157,Bayesian,241,206,447,22,25,Player A
1158,Bayesian,220,215,435,19,28,Player A
1159,Bayesian,217,207,424,23,33,Player A
1160,Bayesian,217,232,449,18,23,Bayesian
1161,Bayesian,215,225,440,24,28,Bayesian
1162,Bayesian,248,218,466,32,22,Player A
1163,Bayesian,219,234,453,31,26,Bayesian
1164,Bayesian,220,225,445,23,26,Bayesian
1165,Bayesian,218,238,456,25,23,Bayesian
1166,Bayesian,192,257,449,18,23,Bayesian
1167,Bayesian,207,237,444,31,29,Bayesian
1168,Bayesian,195,260,455,36,27,Bayesian
1169,Bayesian,253,208,461,27,22,Player A
1170,Bayesian,220,250,470,30,20,Bayesian
1171,Bayesian,247,207,454,23,23,Player A
1172,Bayesian,268,208,476,33,19,Player A
1173,Bayesian,201,236,437,21,28,Bayesian
1174,Bayesian,232,217,449,24,25,Player A
1175,Bayesian,261,206,467,30,21,Player A
1176,Bayesian,229,224,453,25,24,Player A
1177,Bayesian,207,237,444,25,27,Bayesian
1178,Bayesian,228,233,461,24,21,Bayesian
1179,Bayesian,237,207,444,25,27,Player A
1180,Bayesian,213,248,461,21,20,Bayesian
1181,Bayesian,202,247,449,15,22,Bayesian
1182,Bayesian,250,190,440,24,28,Player A
1183,Bayesian,216,216,432,19,29,Tie
1184,Bayesian,211,216,427,23,32,Bayesian
1185,Bayesian,220,200,420,22,34,Player A
1186,Bayesian,252,217,469,26,19,Player A
1187,Bayesian,220,230,450,22,24,Bayesian
1188,Bayesian,222,217,439,26,29,Player A
1189,Bayesian,243,213,456,28,24,Player A
1190,Bayesian,238,223,461,30,23,Player A
1191,Bayesian,204,214,418,23,35,Bayesian
1192,Bayesian,227,222,449,24,25,Player A
1193,Bayesian,224,219,443,30,29,Player A
1194,Bayesian,224,224,448,17,23,Tie
1195,Bayesian,204,234,438,22,28,Bayesian
1196,Bayesian,239,214,453,28,25,Player A
1197,Bayesian,197,242,439,26,29,Bayesian
1198,Bayesian,232,232,464,24,20,Tie
1199,Bayesian,244,214,458,33,25,Player A
1200,Bayesian,204,239,443,24,27,Bayesian
1201,Bayesian,241,211,452,24,24,Player A
1202,Bayesian,267,182,449,21,24,Player A
1203,Bayesian,216,216,432,25,31,Tie
1204,Bayesian,207,237,444,25,27,Bayesian
1205,Bayesian,228,228,456,25,23,Tie
1206,Bayesian,233,218,451,23,24,Player A
1207,Bayesian,203,233,436,23,29,Bayesian
1208,Bayesian,239,214,453,25,24,Player A
1209,Bayesian,191,291,482,30,16,Bayesian
1210,Bayesian,257,212,469,20,17,Player A
1211,Bayesian,256,191,447,25,26,Player A
1212,Bayesian,244,214,458,27,23,Player A
1213,Bayesian,221,211,432,28,32,Player A
1214,Bayesian,264,209,473,27,18,Player A
1215,Bayesian,243,208,451,29,26,Player A
1216,Bayesian,213,233,446,27,27,Bayesian
1217,Bayesian,252,207,459,22,21,Player A
1218,Bayesian,221,231,452,18,22,Bayesian
1219,Bayesian,248,198,446,24,26,Player A
1220,Bayesian,205,210,415,23,36,Bayesian
1221,Bayesian,231,231,462,25,21,Tie
1222,Bayesian,243,213,456,31,25,Player A
1223,Bayesian,213,233,446,24,26,Bayesian
1224,Bayesian,227,227,454,26,24,Tie
1225,Bayesian,220,265,485,27,14,Bayesian
1226,Bayesian,233,203,436,20,28,Player A
1227,Bayesian,184,244,428,27,33,Bayesian
1228,Bayesian,239,209,448,32,28,Player A
1229,Bayesian,232,217,449,27,26,Player A
1230,Bayesian,227,197,424,26,34,Player A
1231,Bayesian,227,222,449,27,26,Player A
1232,Bayesian,217,257,474,31,19,Bayesian
1233,Bayesian,227,227,454,17,21,Tie
1234,Bayesian,242,222,464,30,22,Player A
1235,Bayesian,259,204,463,29,22,Player A
1236,Bayesian,223,218,441,22,27,Player A
1237,Bayesian,237,212,449,27,26,Player A
1238,Bayesian,253,203,456,25,23,Player A
1239,Bayesian,220,240,460,29,23,Bayesian
1240,Bayesian,243,208,451,23,24,Player A
1241,Bayesian,185,260,445,20,25,Bayesian
1242,Bayesian,221,226,447,25,26,Bayesian
1243,Bayesian,195,225,420,19,33,Bayesian
1244,Bayesian,227,227,454,35,27,Tie
1245,Bayesian,214,224,438,22,28,Bayesian
1246,Bayesian,232,227,459,31,24,Player A
1247,Bayesian,206,226,432,22,30,Bayesian
1248,Bayesian,224,249,473,30,19,Bayesian
1249,Bayesian,244,209,453,28,25,Player A
1250,Bayesian,228,208,436,23,29,Player A
1251,Bayesian,243,218,461,24,21,Player A
1252,Bayesian,220,235,455,24,23,Bayesian
1253,Bayesian,259,209,468,31,21,Player A
1254,Bayesian,234,199,433,23,30,Player A
1255,Bayesian,207,237,444,28,28,Bayesian
1256,Bayesian,211,206,417,19,34,Player A
1257,Bayesian,264,209,473,30,19,Player A
1258,Bayesian,221,211,432,25,31,Player A
1259,Bayesian,239,204,443,30,29,Player A
1260,Bayesian,206,231,437,24,29,Bayesian
1261,Bayesian,213,248,461,27,22,Bayesian
1262,Bayesian,208,228,436,23,29,Bayesian
1263,Bayesian,237,187,424,14,30,Player A
1264,Bayesian,200,240,440,24,28,Bayesian
1265,Bayesian,214,229,443,27,28,Bayesian
1266,Bayesian,239,199,438,22,28,Player A
1267,Bayesian,241,216,457,17,20,Player A
1268,Bayesian,228,198,426,19,31,Player A
1269,Bayesian,187,252,439,23,28,Bayesian
1270,Bayesian,230,215,445,29,28,Player A
1271,Bayesian,228,238,466,26,20,Bayesian
1272,Bayesian,212,247,459,31,24,Bayesian
1273,Bayesian,229,234,463,26,21,Bayesian
1274,Bayesian,218,248,466,29,21,Bayesian
1275,Bayesian,226,226,452,21,23,Tie
1276,Bayesian,261,206,467,30,21,Player A
1277,Bayesian,208,248,456,31,25,Bayesian
1278,Bayesian,229,229,458,30,24,Tie
1279,Bayesian,206,236,442,26,28,Bayesian
1280,Bayesian,235,235,470,30,20,Tie
1281,Bayesian,227,212,439,26,29,Player A
1282,Bayesian,236,221,457,26,23,Player A
1283,Bayesian,222,217,439,17,26,Player A
1284,Bayesian,219,239,458,30,24,Bayesian
1285,Bayesian,238,228,466,32,22,Player A
1286,Bayesian,231,221,452,24,24,Player A
1287,Bayesian,213,273,486,37,17,Bayesian
1288,Bayesian,214,234,448,17,23,Bayesian
1289,Bayesian,233,243,476,33,19,Bayesian
1290,Bayesian,224,229,453,25,24,Bayesian
1291,Bayesian,214,244,458,27,23,Bayesian
1292,Bayesian,256,191,447,25,26,Player A
1293,Bayesian,251,221,472,20,16,Player A
1294,Bayesian,227,232,459,25,22,Bayesian
1295,Bayesian,252,197,449,27,26,Player A
1296,Bayesian,202,252,454,26,24,Bayesian
1297,Bayesian,247,182,429,22,31,Player A
1298,Bayesian,204,264,468,22,18,Bayesian
1299,Bayesian,222,217,439,20,27,Player A
1300,Bayesian,216,231,447,22,25,Bayesian
1301,Bayesian,227,212,439,20,27,Player A
1302,Bayesian,192,262,454,20,22,Bayesian
1303,Bayesian,217,242,459,25,22,Bayesian
1304,Bayesian,220,210,430,20,30,Player A
1305,Bayesian,205,215,420,19,33,Bayesian
1306,Bayesian,252,212,464,30,22,Player A
1307,Bayesian,202,222,424,23,33,Bayesian
1308,Bayesian,221,256,477,40,21,Bayesian
1309,Bayesian,265,200,465,31,22,Player A
1310,Bayesian,211,236,447,25,26,Bayesian
1311,Bayesian,233,228,461,21,20,Player A
1312,Bayesian,249,194,443,24,27,Player A
1313,Bayesian,186,251,437,24,29,Bayesian
1314,Bayesian,260,185,445,23,26,Player A
1315,Bayesian,243,203,446,24,26,Player A
1316,Bayesian,246,221,467,27,20,Player A
1317,Bayesian,248,228,476,30,18,Player A
1318,Bayesian,248,223,471,25,18,Player A
1319,Bayesian,215,220,435,19,28,Bayesian
1320,Bayesian,235,190,425,18,31,Player A
1321,Bayesian,250,210,460,38,26,Player A
1322,Bayesian,209,224,433,26,31,Bayesian
1323,Bayesian,206,246,452,24,24,Bayesian
1324,Bayesian,190,230,420,19,33,Bayesian
1325,Bayesian,211,246,457,26,23,Bayesian
1326,Bayesian,232,222,454,20,22,Player A
1327,Bayesian,219,229,448,23,25,Bayesian
1328,Bayesian,221,226,447,22,25,Bayesian
1329,Bayesian,224,214,438,25,29,Player A
1330,Bayesian,211,216,427,17,30,Bayesian
1331,Bayesian,232,237,469,23,18,Bayesian
1332,Bayesian,221,241,462,22,20,Bayesian
1333,Bayesian,238,208,446,18,24,Player A
1334,Bayesian,210,235,445,29,28,Bayesian
1335,Bayesian,244,209,453,22,23,Player A
1336,Bayesian,234,209,443,21,26,Player A
1337,Bayesian,194,259,453,25,24,Bayesian
1338,Bayesian,196,236,432,22,30,Bayesian
1339,Bayesian,236,221,457,26,23,Player A
1340,Bayesian,206,241,447,25,26,Bayesian
1341,Bayesian,213,243,456,25,23,Bayesian
1342,Bayesian,222,237,459,28,23,Bayesian
1343,Bayesian,230,205,435,22,29,Player A
1344,Bayesian,226,211,437,24,29,Player A
1345,Bayesian,233,243,476,24,16,Bayesian
1346,Bayesian,234,204,438,28,30,Player A
1347,Bayesian,244,219,463,29,22,Player A
1348,Bayesian,212,227,439,23,28,Bayesian
1349,Bayesian,241,226,467,30,21,Player A
1350,Bayesian,219,229,448,23,25,Bayesian
1351,Bayesian,221,231,452,27,25,Bayesian
1352,Bayesian,204,254,458,24,22,Bayesian
1353,Bayesian,229,204,433,17,28,Player A
1354,Bayesian,236,226,462,28,22,Player A
1355,Bayesian,223,248,471,19,16,Bayesian
1356,Bayesian,223,218,441,25,28,Player A
1357,Bayesian,205,235,440,18,26,Bayesian
1358,Bayesian,200,255,455,30,25,Bayesian
1359,Bayesian,233,223,456,28,24,Player A
1360,Bayesian,233,198,431,18,29,Player A
1361,Bayesian,203,243,446,21,25,Bayesian
1362,Bayesian,236,196,432,22,30,Player A
1363,Bayesian,232,217,449,24,25,Player A
1364,Bayesian,213,243,456,25,23,Bayesian
1365,Bayesian,245,225,470,27,19,Player A
1366,Bayesian,217,247,464,30,22,Bayesian
1367,Bayesian,240,200,440,18,26,Player A
1368,Bayesian,224,219,443,27,28,Player A
1369,Bayesian,221,211,432,25,31,Player A
1370,Bayesian,224,224,448,23,25,Tie
1371,Bayesian,222,212,434,30,32,Player A
1372,Bayesian,229,224,453,22,23,Player A
1373,Bayesian,215,255,470,24,18,Bayesian
1374,Bayesian,259,219,478,32,18,Player A
1375,Bayesian,219,234,453,25,24,Bayesian
1376,Bayesian,207,222,429,25,32,Bayesian
1377,Bayesian,190,255,445,23,26,Bayesian
1378,Bayesian,254,219,473,36,21,Player A
1379,Bayesian,243,203,446,24,26,Player A
1380,Bayesian,256,196,452,24,24,Player A
1381,Bayesian,195,225,420,16,32,Bayesian
1382,Bayesian,217,242,459,31,24,Bayesian
1383,Bayesian,217,237,454,20,22,Bayesian
1384,Bayesian,232,212,444,22,26,Player A
1385,Bayesian,221,231,452,33,27,Bayesian
1386,Bayesian,198,253,451,29,26,Bayesian
1387,Bayesian,246,216,462,34,24,Player A
1388,Bayesian,204,244,448,26,26,Bayesian
1389,Bayesian,262,207,469,29,20,Player A
1390,Bayesian,224,214,438,28,30,Player A
1391,Bayesian,184,289,473,27,18,Bayesian
1392,Bayesian,242,217,459,22,21,Player A
1393,Bayesian,249,204,453,25,24,Player A
1394,Bayesian,213,238,451,29,26,Bayesian
1395,Bayesian,208,218,426,25,33,Bayesian
1396,Bayesian,238,233,471,25,18,Player A
1397,Bayesian,236,216,452,21,23,Player A
1398,Bayesian,250,195,445,26,27,Player A
1399,Bayesian,217,257,474,31,19,Bayesian
1400,Bayesian,241,196,437,24,29,Player A
1401,Bayesian,217,232,449,30,27,Bayesian
1402,Bayesian,243,213,456,16,20,Player A
1403,Bayesian,227,262,489,34,15,Bayesian
1404,Bayesian,252,222,474,34,20,Player A
1405,Bayesian,214,204,418,23,35,Player A
1406,Bayesian,238,213,451,29,26,Player A
1407,Bayesian,228,213,441,19,26,Player A
1408,Bayesian,230,220,450,28,26,Player A
1409,Bayesian,212,217,429,22,31,Bayesian
1410,Bayesian,217,232,449,21,24,Bayesian
1411,Bayesian,233,223,456,22,22,Player A
1412,Bayesian,213,258,471,31,20,Bayesian
1413,Bayesian,229,214,443,30,29,Player A
1414,Bayesian,200,240,440,21,27,Bayesian
1415,Bayesian,219,249,468,37,23,Bayesian
1416,Bayesian,199,244,443,24,27,Bayesian
1417,Bayesian,205,250,455,24,23,Bayesian
1418,Bayesian,230,240,470,30,20,Bayesian
1419,Bayesian,215,240,455,24,23,Bayesian
1420,Bayesian,215,230,445,26,27,Bayesian
1421,Bayesian,199,224,423,19,32,Bayesian
1422,Bayesian,236,201,437,27,30,Player A
1423,Bayesian,255,185,440,21,27,Player A
1424,Bayesian,236,221,457,20,21,Player A
1425,Bayesian,173,278,451,23,24,Bayesian
1426,Bayesian,211,261,472,32,20,Bayesian
1427,Bayesian,198,268,466,29,21,Bayesian
1428,Bayesian,255,195,450,25,25,Player A
1429,Bayesian,229,199,428,21,31,Player A
1430,Bayesian,219,214,433,23,30,Player A
1431,Bayesian,235,240,475,32,19,Bayesian
1432,Bayesian,226,216,442,29,29,Player A
1433,Bayesian,237,232,469,23,18,Player A
1434,Bayesian,215,230,445,29,28,Bayesian
1435,Bayesian,236,226,462,28,22,Player A
1436,Bayesian,239,224,463,26,21,Player A
1437,Bayesian,235,210,445,29,28,Player A
1438,Bayesian,216,221,437,27,30,Bayesian
1439,Bayesian,210,235,445,26,27,Bayesian
1440,Bayesian,249,219,468,34,22,Player A
1441,Bayesian,203,223,426,25,33,Bayesian
1442,Bayesian,203,238,441,25,28,Bayesian
1443,Bayesian,215,245,460,29,23,Bayesian
1444,Bayesian,227,232,459,28,23,Bayesian
1445,Bayesian,224,214,438,19,27,Player A
1446,Bayesian,202,232,434,21,29,Bayesian
1447,Bayesian,247,217,464,24,20,Player A
1448,Bayesian,208,243,451,26,25,Bayesian
1449,Bayesian,227,212,439,26,29,Player A
1450,Bayesian,226,226,452,24,24,Tie
1451,Bayesian,232,222,454,23,23,Player A
1452,Bayesian,222,212,434,21,29,Player A
1453,Bayesian,225,210,435,22,29,Player A
1454,Bayesian,233,198,431,21,30,Player A
1455,Bayesian,204,249,453,34,27,Bayesian
1456,Bayesian,205,220,425,21,32,Bayesian
1457,Bayesian,186,251,437,21,28,Bayesian
1458,Bayesian,208,228,436,26,30,Bayesian
1459,Bayesian,195,225,420,22,34,Bayesian
1460,Bayesian,226,216,442,29,29,Player A
1461,Bayesian,219,214,433,23,30,Player A
1462,Bayesian,197,252,449,18,23,Bayesian
1463,Bayesian,232,222,454,26,24,Player A
1464,Bayesian,216,226,442,26,28,Bayesian
1465,Bayesian,230,220,450,31,27,Player A
1466,Bayesian,196,276,472,29,19,Bayesian
1467,Bayesian,207,237,444,25,27,Bayesian
1468,Bayesian,242,207,449,24,25,Player A
1469,Bayesian,226,211,437,27,30,Player A
1470,Bayesian,195,240,435,22,29,Bayesian
1471,Bayesian,268,198,466,23,19,Player A
1472,Bayesian,220,245,465,25,20,Bayesian
1473,Bayesian,211,256,467,33,22,Bayesian
1474,Bayesian,203,253,456,28,24,Bayesian
1475,Bayesian,233,198,431,27,32,Player A
1476,Bayesian,234,209,443,24,27,Player A
1477,Bayesian,231,226,457,32,25,Player A
1478,Bayesian,240,220,460,32,24,Player A
1479,Bayesian,251,201,452,27,25,Player A
1480,Bayesian,201,221,422,24,34,Bayesian
1481,Bayesian,229,229,458,27,23,Tie
1482,Bayesian,223,213,436,23,29,Player A
1483,Bayesian,174,264,438,22,28,Bayesian
1484,Bayesian,207,232,439,23,28,Bayesian
1485,Bayesian,240,225,465,28,21,Player A
1486,Bayesian,221,206,427,26,33,Player A
1487,Bayesian,230,225,455,30,25,Player A
1488,Bayesian,222,237,459,31,24,Bayesian
1489,Bayesian,190,270,460,35,25,Bayesian
1490,Bayesian,229,219,448,23,25,Player A
1491,Bayesian,194,249,443,21,26,Bayesian
1492,Bayesian,200,215,415,17,34,Bayesian
1493,Bayesian,262,217,479,27,16,Player A
1494,Bayesian,200,245,445,26,27,Bayesian
1495,Bayesian,236,196,432,22,30,Player A
1496,Bayesian,226,231,457,26,23,Bayesian
1497,Bayesian,248,233,481,32,17,Player A
1498,Bayesian,216,226,442,26,28,Bayesian
1499,Bayesian,231,216,447,16,23,Player A
1500,Bayesian,215,240,455,21,22,Bayesian
1501,Bayesian,203,233,436,20,28,Bayesian
1502,Bayesian,227,232,459,34,25,Bayesian
1503,Bayesian,249,219,468,31,21,Player A
1504,Bayesian,258,203,461,33,24,Player A
1505,Bayesian,248,198,446,27,27,Player A
1506,Bayesian,238,213,451,26,25,Player A
1507,Bayesian,223,248,471,31,20,Bayesian
1508,Bayesian,244,214,458,24,22,Player A
1509,Bayesian,258,193,451,23,24,Player A
1510,Bayesian,236,221,457,26,23,Player A
1511,Bayesian,232,232,464,27,21,Tie
1512,Bayesian,189,274,463,26,21,Bayesian
1513,Bayesian,178,263,441,25,28,Bayesian
1514,Bayesian,220,245,465,31,22,Bayesian
1515,Bayesian,220,225,445,23,26,Bayesian
1516,Bayesian,208,243,451,26,25,Bayesian
1517,Bayesian,272,197,469,32,21,Player A
1518,Bayesian,198,243,441,25,28,Bayesian
1519,Bayesian,225,205,430,23,31,Player A
1520,Bayesian,251,196,447,22,25,Player A
1521,Bayesian,239,214,453,28,25,Player A
1522,Bayesian,250,200,450,31,27,Player A
1523,Bayesian,200,240,440,18,26,Bayesian
1524,Bayesian,200,265,465,22,19,Bayesian
1525,Bayesian,223,208,431,24,31,Player A
1526,Bayesian,235,205,440,33,31,Player A
1527,Bayesian,202,252,454,29,25,Bayesian
1528,Bayesian,249,214,463,32,23,Player A
1529,Bayesian,244,204,448,26,26,Player A
1530,Bayesian,233,223,456,25,23,Player A
1531,Bayesian,223,203,426,25,33,Player A
1532,Bayesian,211,246,457,23,22,Bayesian
1533,Bayesian,228,208,436,20,28,Player A
1534,Bayesian,226,216,442,32,30,Player A
1535,Bayesian,234,204,438,22,28,Player A
1536,Bayesian,243,203,446,21,25,Player A
1537,Bayesian,239,209,448,23,25,Player A
1538,Bayesian,221,201,422,18,32,Player A
1539,Bayesian,241,211,452,27,25,Player A
1540,Bayesian,190,260,450,22,24,Bayesian
1541,Bayesian,251,206,457,26,23,Player A
1542,Bayesian,195,225,420,16,32,Bayesian
1543,Bayesian,222,227,449,18,23,Bayesian
1544,Bayesian,188,263,451,14,21,Bayesian
1545,Bayesian,253,228,481,32,17,Player A
1546,Bayesian,224,234,458,27,23,Bayesian
1547,Bayesian,235,200,435,22,29,Player A
1548,Bayesian,202,247,449,27,26,Bayesian
1549,Bayesian,223,238,461,33,24,Bayesian
1550,Bayesian,222,227,449,24,25,Bayesian
1551,Bayesian,183,243,426,25,33,Bayesian
1552,Bayesian,188,253,441,19,26,Bayesian
1553,Bayesian,218,208,426,25,33,Player A
1554,Bayesian,192,252,444,16,24,Bayesian
1555,Bayesian,245,235,480,34,18,Player A
1556,Bayesian,235,225,460,29,23,Player A
1557,Bayesian,222,227,449,27,26,Bayesian
1558,Bayesian,262,197,459,22,21,Player A
1559,Bayesian,235,210,445,26,27,Player A
1560,Bayesian,224,244,468,25,19,Bayesian
1561,Bayesian,227,232,459,19,20,Bayesian
1562,Bayesian,217,242,459,22,21,Bayesian
1563,Bayesian,249,199,448,23,25,Player A
1564,Bayesian,202,247,449,24,25,Bayesian
1565,Bayesian,235,225,460,26,22,Player A
1566,Bayesian,225,230,455,27,24,Bayesian
1567,Bayesian,195,250,445,20,25,Bayesian
1568,Bayesian,223,253,476,36,20,Bayesian
1569,Bayesian,206,216,422,21,33,Bayesian
1570,Bayesian,250,205,455,27,24,Player A
1571,Bayesian,213,238,451,23,24,Bayesian
1572,Bayesian,212,257,469,32,21,Bayesian
1573,Bayesian,236,201,437,18,27,Player A
1574,Bayesian,194,254,448,17,23,Bayesian
1575,Bayesian,199,249,448,26,26,Bayesian
1576,Bayesian,241,211,452,21,23,Player A
1577,Bayesian,226,231,457,20,21,Bayesian
1578,Bayesian,224,224,448,29,27,Tie
1579,Bayesian,250,225,475,29,18,Player A
1580,Bayesian,218,228,446,30,28,Bayesian
1581,Bayesian,211,231,442,23,27,Bayesian
1582,Bayesian,235,230,465,22,19,Player A
1583,Bayesian,226,236,462,25,21,Bayesian
1584,Bayesian,255,215,470,24,18,Player A
1585,Bayesian,232,192,424,11,29,Player A
1586,Bayesian,224,234,458,21,21,Bayesian
1587,Bayesian,205,240,445,26,27,Bayesian
1588,Bayesian,227,237,464,18,18,Bayesian
1589,Bayesian,275,205,480,34,18,Player A
1590,Bayesian,218,228,446,24,26,Bayesian
1591,Bayesian,226,236,462,22,20,Bayesian
1592,Bayesian,227,242,469,23,18,Bayesian
1593,Bayesian,266,211,477,31,18,Player A
1594,Bayesian,224,244,468,31,21,Bayesian
1595,Bayesian,208,233,441,28,29,Bayesian
1596,Bayesian,243,218,461,27,22,Player A
1597,Bayesian,221,236,457,29,24,Bayesian
1598,Bayesian,222,207,429,22,31,Player A
1599,Bayesian,234,224,458,33,25,Player A
1600,Bayesian,263,188,451,23,24,Player A
1601,Bayesian,246,201,447,28,27,Player A
1602,Bayesian,199,279,478,20,14,Bayesian
1603,Bayesian,222,252,474,34,20,Bayesian
1604,Bayesian,235,235,470,36,22,Tie
1605,Bayesian,196,226,422,27,35,Bayesian
1606,Bayesian,236,206,442,23,27,Player A
1607,Bayesian,253,198,451,23,24,Player A
1608,Bayesian,243,223,466,29,21,Player A
1609,Bayesian,230,225,455,30,25,Player A
1610,Bayesian,230,240,470,27,19,Bayesian
1611,Bayesian,226,241,467,27,20,Bayesian
1612,Bayesian,210,245,455,27,24,Bayesian
1613,Bayesian,247,192,439,20,27,Player A
1614,Bayesian,261,211,472,29,19,Player A
1615,Bayesian,240,195,435,25,30,Player A
1616,Bayesian,256,186,442,26,28,Player A
1617,Bayesian,223,253,476,33,19,Bayesian
1618,Bayesian,238,208,446,27,27,Player A
1619,Bayesian,226,216,442,29,29,Player A
1620,Bayesian,199,249,448,20,24,Bayesian
1621,Bayesian,221,251,472,32,20,Bayesian
1622,Bayesian,194,219,413,15,34,Bayesian
1623,Bayesian,234,204,438,22,28,Player A
1624,Bayesian,201,236,437,21,28,Bayesian
1625,Bayesian,252,197,449,21,24,Player A
1626,Bayesian,226,226,452,21,23,Tie
1627,Bayesian,216,221,437,30,31,Bayesian
1628,Bayesian,208,233,441,19,26,Bayesian
1629,Bayesian,212,217,429,25,32,Bayesian
1630,Bayesian,213,263,476,36,20,Bayesian
1631,Bayesian,224,219,443,24,27,Player A
1632,Bayesian,210,240,450,28,26,Bayesian
1633,Bayesian,163,288,451,26,25,Bayesian
1634,Bayesian,232,222,454,26,24,Player A
1635,Bayesian,218,233,451,23,24,Bayesian
1636,Bayesian,209,244,453,25,24,Bayesian
1637,Bayesian,251,231,482,30,16,Player A
1638,Bayesian,238,208,446,30,28,Player A
1639,Bayesian,255,225,480,34,18,Player A
1640,Bayesian,233,213,446,30,28,Player A
1641,Bayesian,258,188,446,21,25,Player A
1642,Bayesian,251,191,442,23,27,Player A
1643,Bayesian,217,242,459,31,24,Bayesian
1644,Bayesian,252,197,449,21,24,Player A
1645,Bayesian,242,202,444,25,27,Player A
1646,Bayesian,235,215,450,22,24,Player A
1647,Bayesian,199,234,433,26,31,Bayesian
1648,Bayesian,237,222,459,28,23,Player A
1649,Bayesian,233,213,446,21,25,Player A
1650,Bayesian,243,213,456,28,24,Player A
1651,Bayesian,205,215,420,25,35,Bayesian
1652,Bayesian,237,217,454,26,24,Player A
1653,Bayesian,212,237,449,30,27,Bayesian
1654,Bayesian,238,238,476,30,18,Tie
1655,Bayesian,228,228,456,31,25,Tie
1656,Bayesian,208,248,456,28,24,Bayesian
1657,Bayesian,214,234,448,23,25,Bayesian
1658,Bayesian,235,215,450,25,25,Player A
1659,Bayesian,216,241,457,26,23,Bayesian
1660,Bayesian,256,206,462,31,23,Player A
1661,Bayesian,201,236,437,21,28,Bayesian
1662,Bayesian,240,215,455,24,23,Player A
1663,Bayesian,255,185,440,24,28,Player A
1664,Bayesian,226,241,467,24,19,Bayesian
1665,Bayesian,265,215,480,34,18,Player A
1666,Bayesian,245,190,435,19,28,Player A
1667,Bayesian,221,226,447,25,26,Bayesian
1668,Bayesian,231,241,472,26,18,Bayesian
1669,Bayesian,204,229,433,23,30,Bayesian
1670,Bayesian,233,223,456,25,23,Player A
1671,Bayesian,269,219,488,30,14,Player A
1672,Bayesian,219,219,438,22,28,Tie
1673,Bayesian,210,200,410,24,38,Player A
1674,Bayesian,233,243,476,30,18,Bayesian
1675,Bayesian,223,233,456,28,24,Bayesian
1676,Bayesian,219,239,458,24,22,Bayesian
1677,Bayesian,218,208,426,19,31,Player A
1678,Bayesian,195,240,435,19,28,Bayesian
1679,Bayesian,218,233,451,26,25,Bayesian
1680,Bayesian,246,201,447,25,26,Player A
1681,Bayesian,228,248,476,33,19,Bayesian
1682,Bayesian,251,201,452,24,24,Player A
1683,Bayesian,225,230,455,24,23,Bayesian
1684,Bayesian,195,270,465,28,21,Bayesian
1685,Bayesian,241,201,442,20,26,Player A
1686,Bayesian,218,223,441,19,26,Bayesian
1687,Bayesian,232,217,449,27,26,Player A
1688,Bayesian,237,232,469,32,21,Player A
1689,Bayesian,204,244,448,23,25,Bayesian
1690,Bayesian,225,230,455,24,23,Bayesian
1691,Bayesian,221,231,452,24,24,Bayesian
1692,Bayesian,228,223,451,26,25,Player A
1693,Bayesian,223,233,456,28,24,Bayesian
1694,Bayesian,199,269,468,22,18,Bayesian
1695,Bayesian,224,224,448,29,27,Tie
1696,Bayesian,246,206,452,24,24,Player A
1697,Bayesian,211,271,482,30,16,Bayesian
1698,Bayesian,226,236,462,22,20,Bayesian
1699,Bayesian,222,237,459,34,25,Bayesian
1700,Bayesian,226,221,447,28,27,Player A
1701,Bayesian,214,239,453,25,24,Bayesian
1702,Bayesian,204,249,453,28,25,Bayesian
1703,Bayesian,225,230,455,30,25,Bayesian
1704,Bayesian,240,225,465,34,23,Player A
1705,Bayesian,212,217,429,19,30,Bayesian
1706,Bayesian,225,230,455,21,22,Bayesian
1707,Bayesian,230,210,440,27,29,Player A
1708,Bayesian,225,190,415,14,33,Player A
1709,Bayesian,264,189,453,19,22,Player A
1710,Bayesian,235,220,455,24,23,Player A
1711,Bayesian,221,246,467,24,19,Bayesian
1712,Bayesian,184,264,448,23,25,Bayesian
1713,Bayesian,217,222,439,23,28,Bayesian
1714,Bayesian,245,195,440,27,29,Player A
1715,Bayesian,260,200,460,26,22,Player A
1716,Bayesian,218,238,456,25,23,Bayesian
1717,Bayesian,226,236,462,25,21,Bayesian
1718,Bayesian,228,233,461,24,21,Bayesian
1719,Bayesian,214,209,423,19,32,Player A
1720,Bayesian,267,192,459,25,22,Player A
1721,Bayesian,259,209,468,31,21,Player A
1722,Bayesian,191,246,437,27,30,Bayesian
1723,Bayesian,199,259,458,21,21,Bayesian
1724,Bayesian,222,237,459,22,21,Bayesian
1725,Bayesian,252,187,439,23,28,Player A
1726,Bayesian,231,196,427,20,31,Player A
1727,Bayesian,237,207,444,22,26,Player A
1728,Bayesian,270,200,470,21,17,Player A
1729,Bayesian,253,203,456,22,22,Player A
1730,Bayesian,217,222,439,20,27,Bayesian
1731,Bayesian,204,229,433,23,30,Bayesian
1732,Bayesian,220,220,440,21,27,Tie
1733,Bayesian,236,201,437,24,29,Player A
1734,Bayesian,209,224,433,23,30,Bayesian
1735,Bayesian,250,200,450,22,24,Player A
1736,Bayesian,234,219,453,25,24,Player A
1737,Bayesian,241,231,472,23,17,Player A
1738,Bayesian,246,226,472,32,20,Player A
1739,Bayesian,205,255,460,26,22,Bayesian
1740,Bayesian,199,239,438,16,26,Bayesian
1741,Bayesian,233,203,436,23,29,Player A
1742,Bayesian,214,224,438,25,29,Bayesian
1743,Bayesian,210,225,435,22,29,Bayesian
1744,Bayesian,219,239,458,24,22,Bayesian
1745,Bayesian,222,237,459,31,24,Bayesian
1746,Bayesian,215,225,440,21,27,Bayesian
1747,Bayesian,206,246,452,21,23,Bayesian
1748,Bayesian,227,217,444,22,26,Player A
1749,Bayesian,240,220,460,29,23,Player A
1750,Bayesian,195,275,470,24,18,Bayesian
1751,Bayesian,196,231,427,17,30,Bayesian
1752,Bayesian,247,227,474,28,18,Player A
1753,Bayesian,228,223,451,20,23,Player A
1754,Bayesian,224,219,443,27,28,Player A
1755,Bayesian,204,249,453,25,24,Bayesian
1756,Bayesian,217,237,454,26,24,Bayesian
1757,Bayesian,221,221,442,20,26,Tie
1758,Bayesian,227,212,439,26,29,Player A
1759,Bayesian,212,217,429,22,31,Bayesian
1760,Bayesian,215,220,435,19,28,Bayesian
1761,Bayesian,216,246,462,34,24,Bayesian
1762,Bayesian,198,238,436,23,29,Bayesian
1763,Bayesian,256,216,472,32,20,Player A
1764,Bayesian,255,185,440,21,27,Player A
1765,Bayesian,245,230,475,26,17,Player A
1766,Bayesian,216,231,447,22,25,Bayesian
1767,Bayesian,221,216,437,24,29,Player A
1768,Bayesian,227,212,439,23,28,Player A
1769,Bayesian,220,235,455,24,23,Bayesian
1770,Bayesian,209,239,448,23,25,Bayesian
1771,Bayesian,234,234,468,28,20,Tie
1772,Bayesian,250,205,455,24,23,Player A
1773,Bayesian,239,219,458,27,23,Player A
1774,Bayesian,212,252,464,24,20,Bayesian
1775,Bayesian,221,226,447,28,27,Bayesian
1776,Bayesian,233,218,451,20,23,Player A
1777,Bayesian,252,212,464,27,21,Player A
1778,Bayesian,235,245,480,25,15,Bayesian
1779,Bayesian,203,243,446,24,26,Bayesian
1780,Bayesian,218,238,456,25,23,Bayesian
1781,Bayesian,234,199,433,23,30,Player A
1782,Bayesian,214,239,453,22,23,Bayesian
1783,Bayesian,233,193,426,22,32,Player A
1784,Bayesian,216,216,432,22,30,Tie
1785,Bayesian,210,215,425,24,33,Bayesian
1786,Bayesian,224,259,483,37,18,Bayesian
1787,Bayesian,209,239,448,23,25,Bayesian
1788,Bayesian,230,190,420,16,32,Player A
1789,Bayesian,270,200,470,30,20,Player A
1790,Bayesian,243,233,476,33,19,Player A
1791,Bayesian,204,239,443,24,27,Bayesian
1792,Bayesian,220,250,470,24,18,Bayesian
1793,Bayesian,252,207,459,25,22,Player A
1794,Bayesian,219,234,453,22,23,Bayesian
1795,Bayesian,248,218,466,26,20,Player A
1796,Bayesian,214,249,463,32,23,Bayesian
1797,Bayesian,233,223,456,25,23,Player A
1798,Bayesian,233,223,456,22,22,Player A
1799,Bayesian,224,219,443,21,26,Player A
1800,Bayesian,221,236,457,23,22,Bayesian
1801,Bayesian,223,228,451,26,25,Bayesian
1802,Bayesian,184,269,453,28,25,Bayesian
1803,Bayesian,239,199,438,16,26,Player A
1804,Bayesian,241,226,467,30,21,Player A
1805,Bayesian,224,219,443,24,27,Player A
1806,Bayesian,174,284,458,24,22,Bayesian
1807,Bayesian,227,222,449,24,25,Player A
1808,Bayesian,229,209,438,22,28,Player A
1809,Bayesian,237,227,464,21,19,Player A
1810,Bayesian,207,227,434,21,29,Bayesian
1811,Bayesian,214,244,458,18,20,Bayesian
1812,Bayesian,232,237,469,35,22,Bayesian
1813,Bayesian,232,212,444,22,26,Player A
1814,Bayesian,234,209,443,30,29,Player A
1815,Bayesian,240,230,470,30,20,Player A
1816,Bayesian,187,237,424,23,33,Bayesian
1817,Bayesian,212,257,469,23,18,Bayesian
1818,Bayesian,222,207,429,22,31,Player A
1819,Bayesian,195,220,415,11,32,Bayesian
1820,Bayesian,228,223,451,32,27,Player A
1821,Bayesian,242,197,439,26,29,Player A
1822,Bayesian,234,229,463,29,22,Player A
1823,Bayesian,219,224,443,27,28,Bayesian
1824,Bayesian,245,250,495,25,10,Bayesian
1825,Bayesian,258,198,456,31,25,Player A
1826,Bayesian,245,200,445,23,26,Player A
1827,Bayesian,235,190,425,15,30,Player A
1828,Bayesian,212,242,454,29,25,Bayesian
1829,Bayesian,239,224,463,32,23,Player A
1830,Bayesian,243,233,476,30,18,Player A
1831,Bayesian,235,210,445,23,26,Player A
1832,Bayesian,200,240,440,18,26,Bayesian
1833,Bayesian,236,216,452,30,26,Player A
1834,Bayesian,229,224,453,25,24,Player A
1835,Bayesian,229,199,428,21,31,Player A
1836,Bayesian,244,219,463,23,20,Player A
1837,Bayesian,232,232,464,24,20,Tie
1838,Bayesian,208,248,456,22,22,Bayesian
1839,Bayesian,196,256,452,27,25,Bayesian
1840,Bayesian,235,190,425,12,29,Player A
1841,Bayesian,268,198,466,32,22,Player A
1842,Bayesian,201,266,467,30,21,Bayesian
1843,Bayesian,214,229,443,27,28,Bayesian
1844,Bayesian,270,185,455,24,23,Player A
1845,Bayesian,226,221,447,19,24,Player A
1846,Bayesian,190,270,460,26,22,Bayesian
1847,Bayesian,232,202,434,24,30,Player A
1848,Bayesian,220,235,455,27,24,Bayesian
1849,Bayesian,233,203,436,23,29,Player A
1850,Bayesian,185,265,450,25,25,Bayesian
1851,Bayesian,197,222,419,21,34,Bayesian
1852,Bayesian,236,186,422,18,32,Player A
1853,Bayesian,206,226,432,19,29,Bayesian
1854,Bayesian,220,225,445,20,25,Bayesian
1855,Bayesian,202,247,449,21,24,Bayesian
1856,Bayesian,222,237,459,28,23,Bayesian
1857,Bayesian,218,228,446,27,27,Bayesian
1858,Bayesian,187,247,434,24,30,Bayesian
1859,Bayesian,217,227,444,25,27,Bayesian
1860,Bayesian,244,209,453,25,24,Player A
1861,Bayesian,219,239,458,27,23,Bayesian
1862,Bayesian,202,257,459,25,22,Bayesian
1863,Bayesian,237,227,464,27,21,Player A
1864,Bayesian,217,242,459,22,21,Bayesian
1865,Bayesian,218,208,426,22,32,Player A
1866,Bayesian,226,211,437,27,30,Player A
1867,Bayesian,215,260,475,26,17,Bayesian
1868,Bayesian,209,249,458,24,22,Bayesian
1869,Bayesian,215,220,435,25,30,Bayesian
1870,Bayesian,213,228,441,22,27,Bayesian
1871,Bayesian,220,220,440,21,27,Tie
1872,Bayesian,233,213,446,24,26,Player A
1873,Bayesian,210,225,435,25,30,Bayesian
1874,Bayesian,221,211,432,19,29,Player A
1875,Bayesian,214,244,458,18,20,Bayesian
1876,Bayesian,230,220,450,22,24,Player A
1877,Bayesian,230,215,445,26,27,Player A
1878,Bayesian,198,248,446,27,27,Bayesian
1879,Bayesian,226,226,452,27,25,Tie
1880,Bayesian,224,234,458,21,21,Bayesian
1881,Bayesian,230,225,455,27,24,Player A
1882,Bayesian,217,232,449,27,26,Bayesian
1883,Bayesian,240,190,430,23,31,Player A
1884,Bayesian,219,219,438,22,28,Tie
1885,Bayesian,209,239,448,23,25,Bayesian
1886,Bayesian,250,220,470,27,19,Player A
1887,Bayesian,205,250,455,27,24,Bayesian
1888,Bayesian,229,209,438,25,29,Player A
1889,Bayesian,228,213,441,25,28,Player A
1890,Bayesian,236,216,452,27,25,Player A
1891,Bayesian,229,219,448,29,27,Player A
1892,Bayesian,212,237,449,24,25,Bayesian
1893,Bayesian,194,244,438,22,28,Bayesian
1894,Bayesian,241,206,447,25,26,Player A
1895,Bayesian,225,235,460,29,23,Bayesian
1896,Bayesian,230,215,445,23,26,Player A
1897,Bayesian,191,236,427,23,32,Bayesian
1898,Bayesian,216,231,447,22,25,Bayesian
1899,Bayesian,218,213,431,18,29,Player A
1900,Bayesian,197,242,439,23,28,Bayesian
1901,Bayesian,203,218,421,20,33,Bayesian
1902,Bayesian,227,242,469,29,20,Bayesian
1903,Bayesian,234,229,463,26,21,Player A
1904,Bayesian,220,220,440,18,26,Tie
1905,Bayesian,251,211,462,31,23,Player A
1906,Bayesian,243,218,461,27,22,Player A
1907,Bayesian,230,210,440,21,27,Player A
1908,Bayesian,217,232,449,24,25,Bayesian
1909,Bayesian,259,214,473,27,18,Player A
1910,Bayesian,223,218,441,28,29,Player A
1911,Bayesian,207,252,459,25,22,Bayesian
1912,Bayesian,241,221,462,25,21,Player A
1913,Bayesian,222,212,434,21,29,Player A
1914,Bayesian,280,180,460,23,21,Player A
1915,Bayesian,224,199,423,19,32,Player A
1916,Bayesian,206,246,452,27,25,Bayesian
1917,Bayesian,235,225,460,29,23,Player A
1918,Bayesian,221,231,452,27,25,Bayesian
1919,Bayesian,231,206,437,24,29,Player A
1920,Bayesian,216,211,427,23,32,Player A
1921,Bayesian,214,229,443,33,30,Bayesian
1922,Bayesian,218,218,436,23,29,Tie
1923,Bayesian,198,253,451,26,25,Bayesian
1924,Bayesian,220,245,465,28,21,Bayesian
1925,Bayesian,234,209,443,21,26,Player A
1926,Bayesian,204,269,473,21,16,Bayesian
1927,Bayesian,192,262,454,23,23,Bayesian
1928,Bayesian,216,216,432,25,31,Tie
1929,Bayesian,208,248,456,25,23,Bayesian
1930,Bayesian,221,231,452,24,24,Bayesian
1931,Bayesian,225,230,455,30,25,Bayesian
1932,Bayesian,239,244,483,31,16,Bayesian
1933,Bayesian,217,222,439,26,29,Bayesian
1934,Bayesian,260,225,485,33,16,Player A
1935,Bayesian,218,228,446,21,25,Bayesian
1936,Bayesian,214,224,438,28,30,Bayesian
1937,Bayesian,206,211,417,19,34,Bayesian
1938,Bayesian,224,219,443,24,27,Player A
1939,Bayesian,255,215,470,30,20,Player A
1940,Bayesian,211,231,442,20,26,Bayesian
1941,Bayesian,247,227,474,28,18,Player A
1942,Bayesian,227,237,464,30,22,Bayesian
1943,Bayesian,224,224,448,29,27,Tie
1944,Bayesian,191,241,432,16,28,Bayesian
1945,Bayesian,239,219,458,30,24,Player A
1946,Bayesian,181,231,412,17,35,Bayesian
1947,Bayesian,237,212,449,27,26,Player A
1948,Bayesian,249,214,463,20,19,Player A
1949,Bayesian,212,237,449,27,26,Bayesian
1950,Bayesian,254,209,463,26,21,Player A
1951,Bayesian,219,239,458,27,23,Bayesian
1952,Bayesian,181,261,442,20,26,Bayesian
1953,Bayesian,243,193,436,26,30,Player A
1954,Bayesian,229,224,453,25,24,Player A
1955,Bayesian,208,228,436,23,29,Bayesian
1956,Bayesian,177,272,449,21,24,Bayesian
1957,Bayesian,250,210,460,26,22,Player A
1958,Bayesian,246,231,477,34,19,Player A
1959,Bayesian,230,220,450,22,24,Player A
1960,Bayesian,218,248,466,23,19,Bayesian
1961,Bayesian,197,262,459,25,22,Bayesian
1962,Bayesian,235,220,455,27,24,Player A
1963,Bayesian,212,262,474,31,19,Bayesian
1964,Bayesian,220,235,455,30,25,Bayesian
1965,Bayesian,226,231,457,23,22,Bayesian
1966,Bayesian,224,199,423,25,34,Player A
1967,Bayesian,228,228,456,28,24,Tie
1968,Bayesian,264,199,463,26,21,Player A
1969,Bayesian,220,205,425,27,34,Player A
1970,Bayesian,229,224,453,22,23,Player A
1971,Bayesian,231,251,482,30,16,Bayesian
1972,Bayesian,213,243,456,22,22,Bayesian
1973,Bayesian,158,273,431,24,31,Bayesian
1974,Bayesian,240,220,460,23,21,Player A
1975,Bayesian,225,230,455,33,26,Bayesian
1976,Bayesian,227,227,454,20,22,Tie
1977,Bayesian,211,241,452,27,25,Bayesian
1978,Bayesian,214,229,443,21,26,Bayesian
1979,Bayesian,260,190,450,25,25,Player A
1980,Bayesian,209,224,433,26,31,Bayesian
1981,Bayesian,274,184,458,24,22,Player A
1982,Bayesian,234,234,468,25,19,Tie
1983,Bayesian,232,232,464,33,23,Tie
1984,Bayesian,210,245,455,24,23,Bayesian
1985,Bayesian,210,235,445,23,26,Bayesian
1986,Bayesian,239,224,463,26,21,Player A
1987,Bayesian,224,229,453,25,24,Bayesian
1988,Bayesian,253,228,481,32,17,Player A
1989,Bayesian,249,204,453,25,24,Player A
1990,Bayesian,256,196,452,27,25,Player A
1991,Bayesian,220,230,450,22,24,Bayesian
1992,Bayesian,200,240,440,24,28,Bayesian
1993,Bayesian,225,205,430,17,29,Player A
1994,Bayesian,219,214,433,26,31,Player A
1995,Bayesian,240,215,455,24,23,Player A
1996,Bayesian,228,218,446,24,26,Player A
1997,Bayesian,217,227,444,25,27,Bayesian
1998,Bayesian,221,221,442,29,29,Tie
1999,Bayesian,216,246,462,22,20,Bayesian
2000,Bayesian,206,246,452,30,26,Bayesian
2001,Bayesian,211,241,452,21,23,Bayesian
2002,Bayesian,249,194,443,18,25,Player A
2003,Bayesian,230,265,495,37,14,Bayesian
2004,Bayesian,231,241,472,32,20,Bayesian
2005,Bayesian,205,235,440,24,28,Bayesian
2006,Bayesian,248,203,451,23,24,Player A
2007,Bayesian,185,275,460,20,20,Bayesian
2008,Bayesian,228,233,461,24,21,Bayesian
2009,Bayesian,225,235,460,20,20,Bayesian
2010,Bayesian,271,191,462,34,24,Player A
2011,Bayesian,249,189,438,25,29,Player A
2012,Bayesian,242,232,474,37,21,Player A
2013,Bayesian,202,257,459,19,20,Bayesian
2014,Bayesian,216,221,437,24,29,Bayesian
2015,Bayesian,231,216,447,22,25,Player A
2016,Bayesian,200,240,440,30,30,Bayesian
2017,Bayesian,205,225,430,23,31,Bayesian
2018,Bayesian,235,210,445,20,25,Player A
2019,Bayesian,246,226,472,26,18,Player A
2020,Bayesian,226,241,467,27,20,Bayesian
2021,Bayesian,218,223,441,22,27,Bayesian
2022,Bayesian,216,226,442,23,27,Bayesian
2023,Bayesian,215,230,445,23,26,Bayesian
2024,Bayesian,218,218,436,17,27,Tie
2025,Bayesian,197,237,434,21,29,Bayesian
2026,Bayesian,233,208,441,28,29,Player A
2027,Bayesian,216,251,467,27,20,Bayesian
2028,Bayesian,196,236,432,19,29,Bayesian
2029,Bayesian,245,200,445,23,26,Player A
2030,Bayesian,233,213,446,27,27,Player A
2031,Bayesian,216,236,452,21,23,Bayesian
2032,Bayesian,231,211,442,29,29,Player A
2033,Bayesian,236,206,442,23,27,Player A
2034,Bayesian,209,234,443,24,27,Bayesian
2035,Bayesian,224,229,453,19,22,Bayesian
2036,Bayesian,268,198,466,23,19,Player A
2037,Bayesian,242,222,464,30,22,Player A
2038,Bayesian,220,230,450,28,26,Bayesian
2039,Bayesian,228,213,441,22,27,Player A
2040,Bayesian,231,201,432,16,28,Player A
2041,Bayesian,224,229,453,25,24,Bayesian
2042,Bayesian,239,214,453,25,24,Player A
2043,Bayesian,229,239,468,25,19,Bayesian
2044,Bayesian,238,203,441,22,27,Player A
2045,Bayesian,226,246,472,29,19,Bayesian
2046,Bayesian,226,211,437,24,29,Player A
2047,Bayesian,239,239,478,26,16,Tie
2048,Bayesian,236,216,452,21,23,Player A
2049,Bayesian,229,224,453,22,23,Player A
2050,Bayesian,207,232,439,26,29,Bayesian
2051,Bayesian,213,243,456,25,23,Bayesian
2052,Bayesian,205,250,455,27,24,Bayesian
2053,Bayesian,211,216,427,26,33,Bayesian
2054,Bayesian,241,206,447,22,25,Player A
2055,Bayesian,216,236,452,27,25,Bayesian
2056,Bayesian,240,240,480,28,16,Tie
2057,Bayesian,224,229,453,19,22,Bayesian
2058,Bayesian,240,215,455,30,25,Player A
2059,Bayesian,239,234,473,30,19,Player A
2060,Bayesian,190,230,420,22,34,Bayesian
2061,Bayesian,247,227,474,31,19,Player A
2062,Bayesian,233,218,451,26,25,Player A
2063,Bayesian,237,212,449,18,23,Player A
2064,Bayesian,212,202,414,22,36,Player A
2065,Bayesian,207,237,444,25,27,Bayesian
2066,Bayesian,227,227,454,32,26,Tie
2067,Bayesian,230,210,440,24,28,Player A
2068,Bayesian,267,187,454,26,24,Player A
2069,Bayesian,225,230,455,18,21,Bayesian
2070,Bayesian,262,172,434,21,29,Player A
2071,Bayesian,215,235,450,28,26,Bayesian
2072,Bayesian,197,252,449,24,25,Bayesian
2073,Bayesian,251,206,457,23,22,Player A
2074,Bayesian,242,217,459,25,22,Player A
2075,Bayesian,228,208,436,29,31,Player A
2076,Bayesian,241,241,482,24,14,Tie
2077,Bayesian,247,217,464,24,20,Player A
2078,Bayesian,200,230,430,23,31,Bayesian
2079,Bayesian,173,268,441,25,28,Bayesian
2080,Bayesian,248,203,451,26,25,Player A
2081,Bayesian,239,219,458,24,22,Player A
2082,Bayesian,222,237,459,31,24,Bayesian
2083,Bayesian,259,194,453,28,25,Player A
2084,Bayesian,220,220,440,21,27,Tie
2085,Bayesian,223,218,441,28,29,Player A
2086,Bayesian,238,213,451,23,24,Player A
2087,Bayesian,203,248,451,26,25,Bayesian
2088,Bayesian,223,233,456,28,24,Bayesian
2089,Bayesian,207,217,424,20,32,Bayesian
2090,Bayesian,229,209,438,25,29,Player A
2091,Bayesian,227,232,459,22,21,Bayesian
2092,Bayesian,202,242,444,28,28,Bayesian
2093,Bayesian,245,210,455,27,24,Player A
2094,Bayesian,211,231,442,23,27,Bayesian
2095,Bayesian,211,221,432,22,30,Bayesian
2096,Bayesian,225,245,470,36,22,Bayesian
2097,Bayesian,212,262,474,25,17,Bayesian
2098,Bayesian,202,242,444,28,28,Bayesian
2099,Bayesian,258,208,466,26,20,Player A
2100,Bayesian,216,196,412,20,36,Player A
2101,Bayesian,243,208,451,29,26,Player A
2102,Bayesian,204,259,463,23,20,Bayesian
2103,Bayesian,232,237,469,26,19,Bayesian
2104,Bayesian,236,221,457,20,21,Player A
2105,Bayesian,201,241,442,26,28,Bayesian
2106,Bayesian,224,239,463,26,21,Bayesian
2107,Bayesian,245,235,480,37,19,Player A
2108,Bayesian,233,233,466,23,19,Tie
2109,Bayesian,252,202,454,23,23,Player A
2110,Bayesian,231,226,457,29,24,Player A
2111,Bayesian,236,221,457,23,22,Player A
2112,Bayesian,275,210,485,30,15,Player A
2113,Bayesian,226,221,447,28,27,Player A
2114,Bayesian,244,219,463,29,22,Player A
2115,Bayesian,222,222,444,28,28,Tie
2116,Bayesian,211,231,442,26,28,Bayesian
2117,Bayesian,222,242,464,30,22,Bayesian
2118,Bayesian,232,217,449,24,25,Player A
2119,Bayesian,237,217,454,32,26,Player A
2120,Bayesian,243,233,476,36,20,Player A
2121,Bayesian,251,216,467,33,22,Player A
2122,Bayesian,229,234,463,29,22,Bayesian
2123,Bayesian,238,218,456,19,21,Player A
2124,Bayesian,225,245,470,33,21,Bayesian
2125,Bayesian,198,218,416,15,33,Bayesian
2126,Bayesian,214,224,438,22,28,Bayesian
2127,Bayesian,278,168,446,27,27,Player A
2128,Bayesian,214,224,438,25,29,Bayesian
2129,Bayesian,231,216,447,28,27,Player A
2130,Bayesian,223,228,451,26,25,Bayesian
2131,Bayesian,223,218,441,25,28,Player A
2132,Bayesian,223,223,446,27,27,Tie
2133,Bayesian,245,200,445,26,27,Player A
2134,Bayesian,238,223,461,27,22,Player A
2135,Bayesian,231,221,452,24,24,Player A
2136,Bayesian,233,233,466,26,20,Tie
2137,Bayesian,216,251,467,27,20,Bayesian
2138,Bayesian,200,230,430,14,28,Bayesian
2139,Bayesian,205,265,470,33,21,Bayesian
2140,Bayesian,225,240,465,19,18,Bayesian
2141,Bayesian,223,223,446,24,26,Tie
2142,Bayesian,224,209,433,14,27,Player A
2143,Bayesian,172,287,459,25,22,Bayesian
2144,Bayesian,227,232,459,22,21,Bayesian
2145,Bayesian,227,202,429,22,31,Player A
2146,Bayesian,209,249,458,27,23,Bayesian
2147,Bayesian,249,204,453,22,23,Player A
2148,Bayesian,241,216,457,29,24,Player A
2149,Bayesian,202,247,449,21,24,Bayesian
2150,Bayesian,190,260,450,34,28,Bayesian
2151,Bayesian,270,180,450,22,24,Player A
2152,Bayesian,244,209,453,19,22,Player A
2153,Bayesian,228,223,451,26,25,Player A
2154,Bayesian,224,219,443,24,27,Player A
2155,Bayesian,202,232,434,24,30,Bayesian
2156,Bayesian,246,216,462,22,20,Player A
2157,Bayesian,214,234,448,20,24,Bayesian
2158,Bayesian,215,210,425,21,32,Player A
2159,Bayesian,237,222,459,28,23,Player A
2160,Bayesian,220,210,430,17,29,Player A
2161,Bayesian,235,215,450,25,25,Player A
2162,Bayesian,252,217,469,29,20,Player A
2163,Bayesian,237,217,454,32,26,Player A
2164,Bayesian,249,184,433,23,30,Player A
2165,Bayesian,243,213,456,25,23,Player A
2166,Bayesian,226,251,477,34,19,Bayesian
2167,Bayesian,219,239,458,24,22,Bayesian
2168,Bayesian,213,243,456,25,23,Bayesian
2169,Bayesian,241,236,477,28,17,Player A
2170,Bayesian,204,239,443,21,26,Bayesian
2171,Bayesian,237,202,439,23,28,Player A
2172,Bayesian,222,217,439,23,28,Player A
2173,Bayesian,220,220,440,24,28,Tie
2174,Bayesian,230,215,445,29,28,Player A
2175,Bayesian,209,214,423,19,32,Bayesian
2176,Bayesian,239,229,468,28,20,Player A
2177,Bayesian,221,216,437,24,29,Player A
2178,Bayesian,219,234,453,28,25,Bayesian
2179,Bayesian,214,244,458,24,22,Bayesian
2180,Bayesian,213,228,441,19,26,Bayesian
2181,Bayesian,200,245,445,26,27,Bayesian
2182,Bayesian,216,241,457,23,22,Bayesian
2183,Bayesian,239,199,438,22,28,Player A
2184,Bayesian,228,213,441,22,27,Player A
2185,Bayesian,247,207,454,32,26,Player A
2186,Bayesian,211,231,442,26,28,Bayesian
2187,Bayesian,221,191,412,17,35,Player A
2188,Bayesian,235,210,445,32,29,Player A
2189,Bayesian,195,240,435,16,27,Bayesian
2190,Bayesian,228,223,451,20,23,Player A
2191,Bayesian,224,244,468,25,19,Bayesian
2192,Bayesian,232,182,414,22,36,Player A
2193,Bayesian,254,234,488,30,14,Player A
2194,Bayesian,196,241,437,21,28,Bayesian
2195,Bayesian,245,225,470,27,19,Player A
2196,Bayesian,227,237,464,24,20,Bayesian
2197,Bayesian,239,234,473,24,17,Player A
2198,Bayesian,250,230,480,25,15,Player A
2199,Bayesian,209,224,433,23,30,Bayesian
2200,Bayesian,245,235,480,34,18,Player A
2201,Bayesian,195,255,450,22,24,Bayesian
2202,Bayesian,220,235,455,24,23,Bayesian
2203,Bayesian,231,201,432,22,30,Player A
2204,Bayesian,214,279,493,32,13,Bayesian
2205,Bayesian,219,234,453,19,22,Bayesian
2206,Bayesian,209,239,448,26,26,Bayesian
2207,Bayesian,206,246,452,27,25,Bayesian
2208,Bayesian,225,245,470,33,21,Bayesian
2209,Bayesian,205,255,460,26,22,Bayesian
2210,Bayesian,240,225,465,28,21,Player A
2211,Bayesian,249,199,448,26,26,Player A
2212,Bayesian,240,230,470,33,21,Player A
2213,Bayesian,252,182,434,24,30,Player A
2214,Bayesian,225,210,435,25,30,Player A
2215,Bayesian,265,195,460,26,22,Player A
2216,Bayesian,263,183,446,21,25,Player A
2217,Bayesian,240,210,450,28,26,Player A
2218,Bayesian,204,239,443,30,29,Bayesian
2219,Bayesian,215,255,470,27,19,Bayesian
2220,Bayesian,232,222,454,23,23,Player A
2221,Bayesian,265,220,485,30,15,Player A
2222,Bayesian,213,243,456,22,22,Bayesian
2223,Bayesian,213,263,476,30,18,Bayesian
2224,Bayesian,262,207,469,26,19,Player A
2225,Bayesian,242,212,454,23,23,Player A
2226,Bayesian,219,219,438,28,30,Tie
2227,Bayesian,250,230,480,37,19,Player A
2228,Bayesian,229,204,433,29,32,Player A
2229,Bayesian,281,196,477,28,17,Player A
2230,Bayesian,226,216,442,20,26,Player A
2231,Bayesian,215,215,430,26,32,Tie
2232,Bayesian,205,245,450,22,24,Bayesian
2233,Bayesian,206,251,457,29,24,Bayesian
2234,Bayesian,257,197,454,29,25,Player A
2235,Bayesian,272,202,474,37,21,Player A
2236,Bayesian,237,222,459,28,23,Player A
2237,Bayesian,233,238,471,31,20,Bayesian
2238,Bayesian,205,240,445,29,28,Bayesian
2239,Bayesian,190,255,445,17,24,Bayesian
2240,Bayesian,217,237,454,23,23,Bayesian
2241,Bayesian,244,184,428,18,30,Player A
2242,Bayesian,222,227,449,27,26,Bayesian
2243,Bayesian,228,218,446,27,27,Player A
2244,Bayesian,191,241,432,16,28,Bayesian
2245,Bayesian,221,256,477,34,19,Bayesian
2246,Bayesian,218,238,456,25,23,Bayesian
2247,Bayesian,240,210,450,19,23,Player A
2248,Bayesian,199,249,448,29,27,Bayesian
2249,Bayesian,250,225,475,32,19,Player A
2250,Bayesian,232,242,474,25,17,Bayesian
2251,Bayesian,224,244,468,25,19,Bayesian
2252,Bayesian,238,193,431,27,32,Player A
2253,Bayesian,237,237,474,31,19,Tie
0,UCBPlayer,57,287,344,0,52,UCBPlayer
1,UCBPlayer,49,319,368,0,44,UCBPlayer
2,UCBPlayer,341,191,532,56,8,Player A
3,UCBPlayer,72,297,369,4,45,UCBPlayer
4,UCBPlayer,61,321,382,2,40,UCBPlayer
5,UCBPlayer,73,323,396,7,37,UCBPlayer
6,UCBPlayer,101,271,372,7,45,UCBPlayer
7,UCBPlayer,60,300,360,1,47,UCBPlayer
8,UCBPlayer,59,279,338,0,54,UCBPlayer
9,UCBPlayer,122,262,384,16,44,UCBPlayer
10,UCBPlayer,49,329,378,1,41,UCBPlayer
11,UCBPlayer,59,304,363,1,46,UCBPlayer
12,UCBPlayer,50,315,365,0,45,UCBPlayer
13,UCBPlayer,69,314,383,6,41,UCBPlayer
14,UCBPlayer,61,271,332,0,56,UCBPlayer
15,UCBPlayer,47,327,374,0,42,UCBPlayer
16,UCBPlayer,95,250,345,4,53,UCBPlayer
17,UCBPlayer,56,291,347,0,51,UCBPlayer
18,UCBPlayer,53,303,356,0,48,UCBPlayer
19,UCBPlayer,69,249,318,1,61,UCBPlayer
20,UCBPlayer,48,323,371,0,43,UCBPlayer
21,UCBPlayer,46,331,377,0,41,UCBPlayer
22,UCBPlayer,53,303,356,0,48,UCBPlayer
23,UCBPlayer,57,287,344,0,52,UCBPlayer
24,UCBPlayer,63,308,371,3,44,UCBPlayer
25,UCBPlayer,62,282,344,0,52,UCBPlayer
26,UCBPlayer,46,331,377,0,41,UCBPlayer
27,UCBPlayer,80,290,370,5,45,UCBPlayer
28,UCBPlayer,63,293,356,3,49,UCBPlayer
29,UCBPlayer,71,311,382,5,41,UCBPlayer
30,UCBPlayer,64,294,358,2,48,UCBPlayer
31,UCBPlayer,52,307,359,0,47,UCBPlayer
32,UCBPlayer,61,271,332,0,56,UCBPlayer
33,UCBPlayer,66,291,357,1,48,UCBPlayer
34,UCBPlayer,52,307,359,0,47,UCBPlayer
35,UCBPlayer,88,288,376,8,44,UCBPlayer
36,UCBPlayer,49,329,378,1,41,UCBPlayer
37,UCBPlayer,62,322,384,4,40,UCBPlayer
38,UCBPlayer,140,215,355,11,52,UCBPlayer
39,UCBPlayer,112,277,389,9,40,UCBPlayer
40,UCBPlayer,62,282,344,0,52,UCBPlayer
41,UCBPlayer,54,299,353,0,49,UCBPlayer
42,UCBPlayer,57,287,344,0,52,UCBPlayer
43,UCBPlayer,50,315,365,0,45,UCBPlayer
44,UCBPlayer,48,323,371,0,43,UCBPlayer
45,UCBPlayer,56,291,347,0,51,UCBPlayer
46,UCBPlayer,75,250,325,2,59,UCBPlayer
47,UCBPlayer,57,307,364,2,46,UCBPlayer
48,UCBPlayer,72,267,339,1,54,UCBPlayer
49,UCBPlayer,49,314,363,1,46,UCBPlayer
50,UCBPlayer,52,322,374,0,42,UCBPlayer
51,UCBPlayer,63,298,361,2,47,UCBPlayer
52,UCBPlayer,101,306,407,9,34,UCBPlayer
53,UCBPlayer,51,311,362,0,46,UCBPlayer
54,UCBPlayer,60,300,360,1,47,UCBPlayer
55,UCBPlayer,54,299,353,0,49,UCBPlayer
56,UCBPlayer,70,250,320,0,60,UCBPlayer
57,UCBPlayer,58,283,341,0,53,UCBPlayer
58,UCBPlayer,56,316,372,1,43,UCBPlayer
59,UCBPlayer,50,315,365,0,45,UCBPlayer
60,UCBPlayer,118,243,361,11,50,UCBPlayer
61,UCBPlayer,69,274,343,2,53,UCBPlayer
62,UCBPlayer,68,283,351,1,50,UCBPlayer
63,UCBPlayer,59,279,338,0,54,UCBPlayer
64,UCBPlayer,61,306,367,2,45,UCBPlayer
65,UCBPlayer,53,303,356,0,48,UCBPlayer
66,UCBPlayer,50,315,365,0,45,UCBPlayer
67,UCBPlayer,53,303,356,0,48,UCBPlayer
68,UCBPlayer,65,280,345,1,52,UCBPlayer
69,UCBPlayer,61,311,372,4,44,UCBPlayer
70,UCBPlayer,68,293,361,2,47,UCBPlayer
71,UCBPlayer,63,263,326,0,58,UCBPlayer
72,UCBPlayer,65,290,355,2,49,UCBPlayer
73,UCBPlayer,56,291,347,0,51,UCBPlayer
74,UCBPlayer,61,316,377,3,42,UCBPlayer
75,UCBPlayer,61,306,367,2,45,UCBPlayer
76,UCBPlayer,77,267,344,3,53,UCBPlayer
77,UCBPlayer,52,317,369,1,44,UCBPlayer
78,UCBPlayer,63,308,371,3,44,UCBPlayer
79,UCBPlayer,56,291,347,0,51,UCBPlayer
80,UCBPlayer,77,302,379,5,42,UCBPlayer
81,UCBPlayer,54,299,353,0,49,UCBPlayer
82,UCBPlayer,57,317,374,3,43,UCBPlayer
83,UCBPlayer,61,316,377,3,42,UCBPlayer
84,UCBPlayer,63,278,341,0,53,UCBPlayer
85,UCBPlayer,56,291,347,0,51,UCBPlayer
86,UCBPlayer,65,280,345,1,52,UCBPlayer
87,UCBPlayer,76,261,337,2,55,UCBPlayer
88,UCBPlayer,49,329,378,1,41,UCBPlayer
89,UCBPlayer,68,298,366,4,46,UCBPlayer
90,UCBPlayer,64,284,348,1,51,UCBPlayer
91,UCBPlayer,59,304,363,1,46,UCBPlayer
92,UCBPlayer,68,258,326,0,58,UCBPlayer
93,UCBPlayer,57,297,354,1,49,UCBPlayer
94,UCBPlayer,64,284,348,1,51,UCBPlayer
95,UCBPlayer,57,297,354,1,49,UCBPlayer
96,UCBPlayer,68,268,336,1,55,UCBPlayer
97,UCBPlayer,64,304,368,3,45,UCBPlayer
98,UCBPlayer,51,311,362,0,46,UCBPlayer
99,UCBPlayer,55,300,355,2,49,UCBPlayer
100,UCBPlayer,93,263,356,6,50,UCBPlayer
101,UCBPlayer,49,304,353,0,49,UCBPlayer
102,UCBPlayer,65,305,370,2,44,UCBPlayer
103,UCBPlayer,98,258,356,6,50,UCBPlayer
104,UCBPlayer,52,307,359,0,47,UCBPlayer
105,UCBPlayer,68,278,346,2,52,UCBPlayer
106,UCBPlayer,75,285,360,4,48,UCBPlayer
107,UCBPlayer,58,328,386,3,39,UCBPlayer
108,UCBPlayer,45,335,380,0,40,UCBPlayer
109,UCBPlayer,86,291,377,9,44,UCBPlayer
110,UCBPlayer,53,303,356,0,48,UCBPlayer
111,UCBPlayer,52,307,359,0,47,UCBPlayer
112,UCBPlayer,54,299,353,0,49,UCBPlayer
113,UCBPlayer,58,283,341,0,53,UCBPlayer
114,UCBPlayer,42,347,389,0,37,UCBPlayer
115,UCBPlayer,78,273,351,4,51,UCBPlayer
116,UCBPlayer,62,267,329,0,57,UCBPlayer
117,UCBPlayer,55,295,350,0,50,UCBPlayer
118,UCBPlayer,59,279,338,0,54,UCBPlayer
119,UCBPlayer,46,331,377,0,41,UCBPlayer
120,UCBPlayer,75,295,370,5,45,UCBPlayer
121,UCBPlayer,53,303,356,0,48,UCBPlayer
122,UCBPlayer,66,301,367,2,45,UCBPlayer
123,UCBPlayer,54,299,353,0,49,UCBPlayer
124,UCBPlayer,62,302,364,2,46,UCBPlayer
125,UCBPlayer,72,252,324,1,59,UCBPlayer
126,UCBPlayer,94,274,368,9,47,UCBPlayer
127,UCBPlayer,52,307,359,0,47,UCBPlayer
128,UCBPlayer,51,341,392,3,37,UCBPlayer
129,UCBPlayer,63,278,341,0,53,UCBPlayer
130,UCBPlayer,56,291,347,0,51,UCBPlayer
131,UCBPlayer,53,303,356,0,48,UCBPlayer
132,UCBPlayer,54,339,393,4,37,UCBPlayer
133,UCBPlayer,70,305,375,4,43,UCBPlayer
134,UCBPlayer,72,307,379,5,42,UCBPlayer
135,UCBPlayer,73,258,331,2,57,UCBPlayer
136,UCBPlayer,83,293,376,5,43,UCBPlayer
137,UCBPlayer,69,284,353,3,50,UCBPlayer
138,UCBPlayer,77,287,364,5,47,UCBPlayer
139,UCBPlayer,118,263,381,13,44,UCBPlayer
140,UCBPlayer,62,322,384,1,39,UCBPlayer
141,UCBPlayer,82,292,374,6,44,UCBPlayer
142,UCBPlayer,50,325,375,1,42,UCBPlayer
143,UCBPlayer,83,268,351,4,51,UCBPlayer
144,UCBPlayer,65,280,345,1,52,UCBPlayer
145,UCBPlayer,76,296,372,4,44,UCBPlayer
146,UCBPlayer,55,295,350,0,50,UCBPlayer
147,UCBPlayer,50,315,365,0,45,UCBPlayer
148,UCBPlayer,66,306,372,4,44,UCBPlayer
149,UCBPlayer,84,239,323,0,59,UCBPlayer
150,UCBPlayer,53,313,366,1,45,UCBPlayer
151,UCBPlayer,59,294,353,0,49,UCBPlayer
152,UCBPlayer,44,324,368,0,44,UCBPlayer
153,UCBPlayer,60,275,335,0,55,UCBPlayer
154,UCBPlayer,82,287,369,7,46,UCBPlayer
155,UCBPlayer,94,274,368,6,46,UCBPlayer
156,UCBPlayer,55,295,350,0,50,UCBPlayer
157,UCBPlayer,71,256,327,1,58,UCBPlayer
158,UCBPlayer,69,284,353,3,50,UCBPlayer
159,UCBPlayer,69,264,333,1,56,UCBPlayer
160,UCBPlayer,54,299,353,0,49,UCBPlayer
161,UCBPlayer,47,327,374,0,42,UCBPlayer
162,UCBPlayer,51,311,362,0,46,UCBPlayer
163,UCBPlayer,54,299,353,0,49,UCBPlayer
164,UCBPlayer,72,277,349,2,51,UCBPlayer
165,UCBPlayer,52,307,359,0,47,UCBPlayer
166,UCBPlayer,79,279,358,5,49,UCBPlayer
167,UCBPlayer,51,311,362,0,46,UCBPlayer
168,UCBPlayer,60,275,335,0,55,UCBPlayer
169,UCBPlayer,57,287,344,0,52,UCBPlayer
170,UCBPlayer,68,293,361,2,47,UCBPlayer
171,UCBPlayer,51,311,362,0,46,UCBPlayer
172,UCBPlayer,91,281,372,7,45,UCBPlayer
173,UCBPlayer,114,249,363,13,50,UCBPlayer
174,UCBPlayer,63,288,351,1,50,UCBPlayer
175,UCBPlayer,56,291,347,0,51,UCBPlayer
176,UCBPlayer,55,295,350,0,50,UCBPlayer
177,UCBPlayer,49,319,368,0,44,UCBPlayer
178,UCBPlayer,53,303,356,0,48,UCBPlayer
179,UCBPlayer,81,291,372,4,44,UCBPlayer
180,UCBPlayer,47,327,374,0,42,UCBPlayer
181,UCBPlayer,66,286,352,2,50,UCBPlayer
182,UCBPlayer,55,295,350,0,50,UCBPlayer
183,UCBPlayer,60,300,360,1,47,UCBPlayer
184,UCBPlayer,64,314,378,4,42,UCBPlayer
185,UCBPlayer,52,307,359,0,47,UCBPlayer
186,UCBPlayer,52,307,359,0,47,UCBPlayer
187,UCBPlayer,59,279,338,0,54,UCBPlayer
188,UCBPlayer,90,260,350,6,52,UCBPlayer
189,UCBPlayer,84,294,378,7,43,UCBPlayer
190,UCBPlayer,53,303,356,0,48,UCBPlayer
191,UCBPlayer,58,283,341,0,53,UCBPlayer
192,UCBPlayer,117,247,364,11,49,UCBPlayer
193,UCBPlayer,73,263,336,1,55,UCBPlayer
194,UCBPlayer,72,272,344,3,53,UCBPlayer
195,UCBPlayer,55,310,365,0,45,UCBPlayer
196,UCBPlayer,58,283,341,0,53,UCBPlayer
197,UCBPlayer,53,303,356,0,48,UCBPlayer
198,UCBPlayer,53,303,356,0,48,UCBPlayer
199,UCBPlayer,56,291,347,0,51,UCBPlayer
200,UCBPlayer,54,299,353,0,49,UCBPlayer
201,UCBPlayer,55,300,355,2,49,UCBPlayer
202,UCBPlayer,83,263,346,5,53,UCBPlayer
203,UCBPlayer,108,253,361,8,49,UCBPlayer
204,UCBPlayer,71,291,362,3,47,UCBPlayer
205,UCBPlayer,53,303,356,0,48,UCBPlayer
206,UCBPlayer,52,307,359,0,47,UCBPlayer
207,UCBPlayer,71,291,362,3,47,UCBPlayer
208,UCBPlayer,50,315,365,0,45,UCBPlayer
209,UCBPlayer,62,302,364,2,46,UCBPlayer
210,UCBPlayer,66,296,362,3,47,UCBPlayer
211,UCBPlayer,57,287,344,0,52,UCBPlayer
212,UCBPlayer,97,287,384,10,42,UCBPlayer
213,UCBPlayer,79,269,348,4,52,UCBPlayer
214,UCBPlayer,55,320,375,1,42,UCBPlayer
215,UCBPlayer,76,281,357,4,49,UCBPlayer
216,UCBPlayer,66,286,352,2,50,UCBPlayer
217,UCBPlayer,59,324,383,3,40,UCBPlayer
218,UCBPlayer,119,254,373,11,46,UCBPlayer
219,UCBPlayer,59,279,338,0,54,UCBPlayer
220,UCBPlayer,70,290,360,1,47,UCBPlayer
221,UCBPlayer,74,284,358,5,49,UCBPlayer
222,UCBPlayer,51,311,362,0,46,UCBPlayer
223,UCBPlayer,98,288,386,12,42,UCBPlayer
224,UCBPlayer,48,323,371,0,43,UCBPlayer
225,UCBPlayer,65,310,375,4,43,UCBPlayer
226,UCBPlayer,64,279,343,2,53,UCBPlayer
227,UCBPlayer,56,291,347,0,51,UCBPlayer
228,UCBPlayer,54,299,353,0,49,UCBPlayer
229,UCBPlayer,52,307,359,0,47,UCBPlayer
230,UCBPlayer,61,271,332,0,56,UCBPlayer
231,UCBPlayer,50,315,365,0,45,UCBPlayer
232,UCBPlayer,57,322,379,5,42,UCBPlayer
233,UCBPlayer,71,291,362,3,47,UCBPlayer
234,UCBPlayer,60,275,335,0,55,UCBPlayer
235,UCBPlayer,65,280,345,1,52,UCBPlayer
236,UCBPlayer,75,255,330,1,57,UCBPlayer
237,UCBPlayer,92,282,374,9,45,UCBPlayer
238,UCBPlayer,143,248,391,14,41,UCBPlayer
239,UCBPlayer,59,314,373,2,43,UCBPlayer
240,UCBPlayer,74,309,383,6,41,UCBPlayer
241,UCBPlayer,110,255,365,12,49,UCBPlayer
242,UCBPlayer,69,319,388,8,40,UCBPlayer
243,UCBPlayer,71,281,352,2,50,UCBPlayer
244,UCBPlayer,71,291,362,3,47,UCBPlayer
245,UCBPlayer,62,297,359,3,48,UCBPlayer
246,UCBPlayer,76,266,342,4,54,UCBPlayer
247,UCBPlayer,73,278,351,1,50,UCBPlayer
248,UCBPlayer,53,303,356,0,48,UCBPlayer
249,UCBPlayer,53,303,356,0,48,UCBPlayer
250,UCBPlayer,55,295,350,0,50,UCBPlayer
251,UCBPlayer,59,294,353,3,50,UCBPlayer
252,UCBPlayer,79,264,343,2,53,UCBPlayer
253,UCBPlayer,46,326,372,1,43,UCBPlayer
254,UCBPlayer,73,293,366,4,46,UCBPlayer
255,UCBPlayer,53,303,356,0,48,UCBPlayer
256,UCBPlayer,61,271,332,0,56,UCBPlayer
257,UCBPlayer,61,296,357,1,48,UCBPlayer
258,UCBPlayer,54,299,353,0,49,UCBPlayer
259,UCBPlayer,45,335,380,0,40,UCBPlayer
260,UCBPlayer,73,283,356,3,49,UCBPlayer
261,UCBPlayer,59,304,363,1,46,UCBPlayer
262,UCBPlayer,84,279,363,4,47,UCBPlayer
263,UCBPlayer,57,287,344,0,52,UCBPlayer
264,UCBPlayer,89,264,353,6,51,UCBPlayer
265,UCBPlayer,70,275,345,1,52,UCBPlayer
266,UCBPlayer,64,299,363,1,46,UCBPlayer
267,UCBPlayer,63,278,341,0,53,UCBPlayer
268,UCBPlayer,52,307,359,0,47,UCBPlayer
269,UCBPlayer,67,282,349,2,51,UCBPlayer
270,UCBPlayer,50,315,365,0,45,UCBPlayer
271,UCBPlayer,67,297,364,2,46,UCBPlayer
272,UCBPlayer,59,279,338,0,54,UCBPlayer
273,UCBPlayer,68,288,356,3,49,UCBPlayer
274,UCBPlayer,91,296,387,10,41,UCBPlayer
275,UCBPlayer,55,295,350,0,50,UCBPlayer
276,UCBPlayer,43,343,386,0,38,UCBPlayer
277,UCBPlayer,49,329,378,1,41,UCBPlayer
278,UCBPlayer,52,307,359,0,47,UCBPlayer
279,UCBPlayer,94,264,358,8,50,UCBPlayer
280,UCBPlayer,48,323,371,0,43,UCBPlayer
281,UCBPlayer,53,303,356,0,48,UCBPlayer
282,UCBPlayer,58,283,341,0,53,UCBPlayer
283,UCBPlayer,54,299,353,0,49,UCBPlayer
284,UCBPlayer,62,302,364,2,46,UCBPlayer
285,UCBPlayer,64,259,323,0,59,UCBPlayer
286,UCBPlayer,107,252,359,9,50,UCBPlayer
287,UCBPlayer,50,335,385,2,39,UCBPlayer
288,UCBPlayer,104,284,388,11,41,UCBPlayer
289,UCBPlayer,49,319,368,0,44,UCBPlayer
290,UCBPlayer,76,266,342,4,54,UCBPlayer
291,UCBPlayer,67,312,379,2,41,UCBPlayer
292,UCBPlayer,56,316,372,1,43,UCBPlayer
293,UCBPlayer,68,278,346,2,52,UCBPlayer
294,UCBPlayer,86,276,362,3,47,UCBPlayer
295,UCBPlayer,48,343,391,2,37,UCBPlayer
296,UCBPlayer,59,294,353,0,49,UCBPlayer
297,UCBPlayer,49,319,368,0,44,UCBPlayer
298,UCBPlayer,54,319,373,2,43,UCBPlayer
299,UCBPlayer,56,306,362,0,46,UCBPlayer
300,UCBPlayer,84,264,348,7,53,UCBPlayer
301,UCBPlayer,85,295,380,6,42,UCBPlayer
302,UCBPlayer,65,270,335,0,55,UCBPlayer
303,UCBPlayer,52,307,359,0,47,UCBPlayer
304,UCBPlayer,55,290,345,1,52,UCBPlayer
305,UCBPlayer,67,282,349,2,51,UCBPlayer
306,UCBPlayer,60,275,335,0,55,UCBPlayer
307,UCBPlayer,50,315,365,0,45,UCBPlayer
308,UCBPlayer,56,291,347,0,51,UCBPlayer
309,UCBPlayer,70,320,390,7,39,UCBPlayer
310,UCBPlayer,51,311,362,0,46,UCBPlayer
311,UCBPlayer,55,295,350,0,50,UCBPlayer
312,UCBPlayer,52,307,359,0,47,UCBPlayer
313,UCBPlayer,61,271,332,0,56,UCBPlayer
314,UCBPlayer,63,278,341,0,53,UCBPlayer
315,UCBPlayer,52,307,359,0,47,UCBPlayer
316,UCBPlayer,58,318,376,2,42,UCBPlayer
317,UCBPlayer,63,298,361,2,47,UCBPlayer
318,UCBPlayer,64,294,358,2,48,UCBPlayer
319,UCBPlayer,58,283,341,0,53,UCBPlayer
320,UCBPlayer,52,307,359,0,47,UCBPlayer
321,UCBPlayer,51,311,362,0,46,UCBPlayer
322,UCBPlayer,45,345,390,1,37,UCBPlayer
323,UCBPlayer,110,270,380,6,42,UCBPlayer
324,UCBPlayer,50,325,375,1,42,UCBPlayer
325,UCBPlayer,78,243,321,1,60,UCBPlayer
326,UCBPlayer,51,311,362,0,46,UCBPlayer
327,UCBPlayer,53,303,356,0,48,UCBPlayer
328,UCBPlayer,76,291,367,5,46,UCBPlayer
329,UCBPlayer,49,319,368,0,44,UCBPlayer
330,UCBPlayer,62,292,354,1,49,UCBPlayer
331,UCBPlayer,70,290,360,4,48,UCBPlayer
332,UCBPlayer,63,288,351,1,50,UCBPlayer
333,UCBPlayer,67,272,339,1,54,UCBPlayer
334,UCBPlayer,42,347,389,0,37,UCBPlayer
335,UCBPlayer,93,288,381,7,42,UCBPlayer
336,UCBPlayer,56,291,347,0,51,UCBPlayer
337,UCBPlayer,58,293,351,1,50,UCBPlayer
338,UCBPlayer,80,295,375,4,43,UCBPlayer
339,UCBPlayer,52,317,369,1,44,UCBPlayer
340,UCBPlayer,63,278,341,0,53,UCBPlayer
341,UCBPlayer,59,299,358,2,48,UCBPlayer
342,UCBPlayer,94,254,348,4,52,UCBPlayer
343,UCBPlayer,48,343,391,2,37,UCBPlayer
344,UCBPlayer,64,274,338,0,54,UCBPlayer
345,UCBPlayer,61,296,357,1,48,UCBPlayer
346,UCBPlayer,60,320,380,3,41,UCBPlayer
347,UCBPlayer,84,249,333,4,57,UCBPlayer
348,UCBPlayer,59,289,348,1,51,UCBPlayer
349,UCBPlayer,60,300,360,1,47,UCBPlayer
350,UCBPlayer,46,351,397,2,35,UCBPlayer
351,UCBPlayer,56,306,362,0,46,UCBPlayer
352,UCBPlayer,63,288,351,4,51,UCBPlayer
353,UCBPlayer,89,254,343,2,53,UCBPlayer
354,UCBPlayer,54,324,378,1,41,UCBPlayer
355,UCBPlayer,65,315,380,6,42,UCBPlayer
356,UCBPlayer,89,289,378,7,43,UCBPlayer
357,UCBPlayer,56,291,347,0,51,UCBPlayer
358,UCBPlayer,42,357,399,1,34,UCBPlayer
359,UCBPlayer,64,274,338,0,54,UCBPlayer
360,UCBPlayer,57,287,344,0,52,UCBPlayer
361,UCBPlayer,60,300,360,1,47,UCBPlayer
362,UCBPlayer,52,307,359,0,47,UCBPlayer
363,UCBPlayer,59,279,338,0,54,UCBPlayer
364,UCBPlayer,62,292,354,1,49,UCBPlayer
365,UCBPlayer,51,311,362,0,46,UCBPlayer
366,UCBPlayer,51,311,362,0,46,UCBPlayer
367,UCBPlayer,48,323,371,0,43,UCBPlayer
368,UCBPlayer,60,275,335,0,55,UCBPlayer
369,UCBPlayer,62,322,384,4,40,UCBPlayer
370,UCBPlayer,76,246,322,2,60,UCBPlayer
371,UCBPlayer,50,340,390,1,37,UCBPlayer
372,UCBPlayer,53,303,356,0,48,UCBPlayer
373,UCBPlayer,51,311,362,0,46,UCBPlayer
374,UCBPlayer,42,347,389,0,37,UCBPlayer
375,UCBPlayer,46,331,377,0,41,UCBPlayer
376,UCBPlayer,75,295,370,5,45,UCBPlayer
377,UCBPlayer,61,271,332,0,56,UCBPlayer
378,UCBPlayer,50,315,365,0,45,UCBPlayer
379,UCBPlayer,56,291,347,0,51,UCBPlayer
380,UCBPlayer,48,323,371,0,43,UCBPlayer
381,UCBPlayer,64,304,368,3,45,UCBPlayer
382,UCBPlayer,63,288,351,1,50,UCBPlayer
383,UCBPlayer,70,295,365,3,46,UCBPlayer
384,UCBPlayer,54,319,373,2,43,UCBPlayer
385,UCBPlayer,70,300,370,5,45,UCBPlayer
386,UCBPlayer,112,277,389,9,40,UCBPlayer
387,UCBPlayer,66,271,337,2,55,UCBPlayer
388,UCBPlayer,67,292,359,3,48,UCBPlayer
389,UCBPlayer,52,322,374,0,42,UCBPlayer
390,UCBPlayer,150,250,400,17,39,UCBPlayer
391,UCBPlayer,85,250,335,3,56,UCBPlayer
392,UCBPlayer,120,260,380,12,44,UCBPlayer
393,UCBPlayer,53,303,356,0,48,UCBPlayer
394,UCBPlayer,84,299,383,6,41,UCBPlayer
395,UCBPlayer,54,299,353,0,49,UCBPlayer
396,UCBPlayer,55,295,350,0,50,UCBPlayer
397,UCBPlayer,57,287,344,0,52,UCBPlayer
398,UCBPlayer,46,331,377,0,41,UCBPlayer
399,UCBPlayer,95,250,345,7,54,UCBPlayer
400,UCBPlayer,63,278,341,0,53,UCBPlayer
401,UCBPlayer,55,310,365,3,46,UCBPlayer
402,UCBPlayer,76,311,387,7,40,UCBPlayer
403,UCBPlayer,44,339,383,0,39,UCBPlayer
404,UCBPlayer,50,315,365,0,45,UCBPlayer
405,UCBPlayer,55,295,350,0,50,UCBPlayer
406,UCBPlayer,56,291,347,0,51,UCBPlayer
407,UCBPlayer,62,267,329,0,57,UCBPlayer
408,UCBPlayer,68,268,336,1,55,UCBPlayer
409,UCBPlayer,55,295,350,0,50,UCBPlayer
410,UCBPlayer,82,257,339,4,55,UCBPlayer
411,UCBPlayer,93,298,391,8,39,UCBPlayer
412,UCBPlayer,107,257,364,11,49,UCBPlayer
413,UCBPlayer,64,324,388,5,39,UCBPlayer
414,UCBPlayer,63,298,361,2,47,UCBPlayer
415,UCBPlayer,55,295,350,0,50,UCBPlayer
416,UCBPlayer,49,319,368,0,44,UCBPlayer
417,UCBPlayer,107,247,354,7,51,UCBPlayer
418,UCBPlayer,58,283,341,0,53,UCBPlayer
419,UCBPlayer,89,244,333,4,57,UCBPlayer
420,UCBPlayer,57,287,344,0,52,UCBPlayer
421,UCBPlayer,58,283,341,0,53,UCBPlayer
422,UCBPlayer,59,304,363,1,46,UCBPlayer
423,UCBPlayer,60,275,335,0,55,UCBPlayer
424,UCBPlayer,48,323,371,0,43,UCBPlayer
425,UCBPlayer,61,271,332,0,56,UCBPlayer
426,UCBPlayer,59,294,353,0,49,UCBPlayer
427,UCBPlayer,69,294,363,4,47,UCBPlayer
428,UCBPlayer,85,290,375,7,44,UCBPlayer
429,UCBPlayer,49,319,368,0,44,UCBPlayer
430,UCBPlayer,56,311,367,2,45,UCBPlayer
431,UCBPlayer,51,336,387,1,38,UCBPlayer
432,UCBPlayer,55,295,350,0,50,UCBPlayer
433,UCBPlayer,62,267,329,0,57,UCBPlayer
434,UCBPlayer,52,307,359,0,47,UCBPlayer
435,UCBPlayer,56,291,347,0,51,UCBPlayer
436,UCBPlayer,89,264,353,6,51,UCBPlayer
437,UCBPlayer,41,351,392,0,36,UCBPlayer
438,UCBPlayer,46,331,377,0,41,UCBPlayer
439,UCBPlayer,84,284,368,6,46,UCBPlayer
440,UCBPlayer,61,306,367,2,45,UCBPlayer
441,UCBPlayer,67,272,339,1,54,UCBPlayer
442,UCBPlayer,57,287,344,0,52,UCBPlayer
443,UCBPlayer,113,263,376,8,44,UCBPlayer
444,UCBPlayer,50,325,375,1,42,UCBPlayer
445,UCBPlayer,125,260,385,17,44,UCBPlayer
446,UCBPlayer,49,319,368,0,44,UCBPlayer
447,UCBPlayer,56,291,347,0,51,UCBPlayer
448,UCBPlayer,55,295,350,0,50,UCBPlayer
449,UCBPlayer,57,307,364,2,46,UCBPlayer
450,UCBPlayer,54,314,368,0,44,UCBPlayer
451,UCBPlayer,55,295,350,0,50,UCBPlayer
452,UCBPlayer,52,307,359,0,47,UCBPlayer
453,UCBPlayer,56,291,347,0,51,UCBPlayer
454,UCBPlayer,55,305,360,1,47,UCBPlayer
455,UCBPlayer,60,290,350,0,50,UCBPlayer
456,UCBPlayer,132,267,399,13,38,UCBPlayer
457,UCBPlayer,89,249,338,3,55,UCBPlayer
458,UCBPlayer,77,252,329,3,58,UCBPlayer
459,UCBPlayer,55,295,350,0,50,UCBPlayer
460,UCBPlayer,164,244,408,19,37,UCBPlayer
461,UCBPlayer,57,322,379,2,41,UCBPlayer
462,UCBPlayer,60,300,360,1,47,UCBPlayer
463,UCBPlayer,66,291,357,1,48,UCBPlayer
464,UCBPlayer,53,303,356,0,48,UCBPlayer
465,UCBPlayer,54,299,353,0,49,UCBPlayer
466,UCBPlayer,54,299,353,0,49,UCBPlayer
467,UCBPlayer,55,295,350,0,50,UCBPlayer
468,UCBPlayer,63,263,326,0,58,UCBPlayer
469,UCBPlayer,55,295,350,0,50,UCBPlayer
470,UCBPlayer,78,263,341,3,54,UCBPlayer
471,UCBPlayer,66,296,362,3,47,UCBPlayer
472,UCBPlayer,82,292,374,3,43,UCBPlayer
473,UCBPlayer,65,280,345,1,52,UCBPlayer
474,UCBPlayer,62,267,329,0,57,UCBPlayer
475,UCBPlayer,53,303,356,0,48,UCBPlayer
476,UCBPlayer,58,283,341,0,53,UCBPlayer
477,UCBPlayer,66,276,342,1,53,UCBPlayer
478,UCBPlayer,50,315,365,0,45,UCBPlayer
479,UCBPlayer,63,263,326,0,58,UCBPlayer
480,UCBPlayer,57,287,344,0,52,UCBPlayer
481,UCBPlayer,49,319,368,0,44,UCBPlayer
482,UCBPlayer,59,279,338,0,54,UCBPlayer
483,UCBPlayer,86,306,392,6,38,UCBPlayer
484,UCBPlayer,73,288,361,2,47,UCBPlayer
485,UCBPlayer,53,303,356,0,48,UCBPlayer
486,UCBPlayer,66,276,342,1,53,UCBPlayer
487,UCBPlayer,51,311,362,0,46,UCBPlayer
488,UCBPlayer,111,261,372,10,46,UCBPlayer
489,UCBPlayer,59,279,338,0,54,UCBPlayer
490,UCBPlayer,62,292,354,1,49,UCBPlayer
491,UCBPlayer,54,299,353,0,49,UCBPlayer
492,UCBPlayer,79,284,363,7,48,UCBPlayer
493,UCBPlayer,80,305,385,8,41,UCBPlayer
494,UCBPlayer,67,317,384,4,40,UCBPlayer
495,UCBPlayer,63,278,341,0,53,UCBPlayer
496,UCBPlayer,66,276,342,1,53,UCBPlayer
497,UCBPlayer,48,323,371,0,43,UCBPlayer
498,UCBPlayer,59,279,338,0,54,UCBPlayer
499,UCBPlayer,71,276,347,3,52,UCBPlayer
500,UCBPlayer,63,278,341,0,53,UCBPlayer
501,UCBPlayer,81,291,372,4,44,UCBPlayer
502,UCBPlayer,60,275,335,0,55,UCBPlayer
503,UCBPlayer,52,307,359,0,47,UCBPlayer
504,UCBPlayer,63,263,326,0,58,UCBPlayer
505,UCBPlayer,83,253,336,4,56,UCBPlayer
506,UCBPlayer,65,310,375,4,43,UCBPlayer
507,UCBPlayer,111,276,387,13,42,UCBPlayer
508,UCBPlayer,53,298,351,1,50,UCBPlayer
509,UCBPlayer,81,301,382,8,42,UCBPlayer
510,UCBPlayer,71,281,352,2,50,UCBPlayer
511,UCBPlayer,57,287,344,0,52,UCBPlayer
512,UCBPlayer,73,283,356,3,49,UCBPlayer
513,UCBPlayer,51,311,362,0,46,UCBPlayer
514,UCBPlayer,91,276,367,8,47,UCBPlayer
515,UCBPlayer,88,288,376,8,44,UCBPlayer
516,UCBPlayer,88,298,386,6,40,UCBPlayer
517,UCBPlayer,62,292,354,1,49,UCBPlayer
518,UCBPlayer,83,273,356,6,50,UCBPlayer
519,UCBPlayer,63,298,361,2,47,UCBPlayer
520,UCBPlayer,55,295,350,0,50,UCBPlayer
521,UCBPlayer,95,285,380,9,43,UCBPlayer
522,UCBPlayer,52,317,369,1,44,UCBPlayer
523,UCBPlayer,56,306,362,0,46,UCBPlayer
524,UCBPlayer,54,299,353,0,49,UCBPlayer
525,UCBPlayer,56,291,347,0,51,UCBPlayer
526,UCBPlayer,51,311,362,0,46,UCBPlayer
527,UCBPlayer,57,287,344,0,52,UCBPlayer
528,UCBPlayer,65,300,365,3,46,UCBPlayer
529,UCBPlayer,66,276,342,1,53,UCBPlayer
530,UCBPlayer,54,299,353,0,49,UCBPlayer
531,UCBPlayer,74,299,373,5,44,UCBPlayer
532,UCBPlayer,51,311,362,0,46,UCBPlayer
533,UCBPlayer,51,311,362,0,46,UCBPlayer
534,UCBPlayer,56,291,347,0,51,UCBPlayer
535,UCBPlayer,60,275,335,0,55,UCBPlayer
536,UCBPlayer,67,272,339,1,54,UCBPlayer
537,UCBPlayer,50,315,365,0,45,UCBPlayer
538,UCBPlayer,86,281,367,5,46,UCBPlayer
539,UCBPlayer,61,301,362,3,47,UCBPlayer
540,UCBPlayer,59,294,353,0,49,UCBPlayer
541,UCBPlayer,64,259,323,0,59,UCBPlayer
542,UCBPlayer,74,284,358,5,49,UCBPlayer
543,UCBPlayer,102,267,369,10,47,UCBPlayer
544,UCBPlayer,54,299,353,0,49,UCBPlayer
545,UCBPlayer,59,279,338,0,54,UCBPlayer
546,UCBPlayer,71,291,362,3,47,UCBPlayer
547,UCBPlayer,52,307,359,0,47,UCBPlayer
548,UCBPlayer,61,271,332,0,56,UCBPlayer
549,UCBPlayer,105,255,360,10,50,UCBPlayer
550,UCBPlayer,94,259,353,6,51,UCBPlayer
551,UCBPlayer,62,267,329,0,57,UCBPlayer
552,UCBPlayer,64,274,338,0,54,UCBPlayer
553,UCBPlayer,62,267,329,0,57,UCBPlayer
554,UCBPlayer,53,303,356,0,48,UCBPlayer
555,UCBPlayer,47,327,374,0,42,UCBPlayer
556,UCBPlayer,57,287,344,0,52,UCBPlayer
557,UCBPlayer,61,271,332,0,56,UCBPlayer
558,UCBPlayer,62,287,349,2,51,UCBPlayer
559,UCBPlayer,81,261,342,4,54,UCBPlayer
560,UCBPlayer,66,286,352,2,50,UCBPlayer
561,UCBPlayer,67,262,329,0,57,UCBPlayer
562,UCBPlayer,64,294,358,2,48,UCBPlayer
563,UCBPlayer,54,299,353,0,49,UCBPlayer
564,UCBPlayer,83,283,366,7,47,UCBPlayer
565,UCBPlayer,92,277,369,10,47,UCBPlayer
566,UCBPlayer,65,305,370,2,44,UCBPlayer
567,UCBPlayer,129,264,393,13,40,UCBPlayer
568,UCBPlayer,93,228,321,4,61,UCBPlayer
569,UCBPlayer,68,268,336,1,55,UCBPlayer
570,UCBPlayer,58,318,376,2,42,UCBPlayer
571,UCBPlayer,90,270,360,7,49,UCBPlayer
572,UCBPlayer,62,312,374,3,43,UCBPlayer
573,UCBPlayer,58,283,341,0,53,UCBPlayer
574,UCBPlayer,86,276,362,6,48,UCBPlayer
575,UCBPlayer,48,323,371,0,43,UCBPlayer
576,UCBPlayer,78,288,366,4,46,UCBPlayer
577,UCBPlayer,51,321,372,1,43,UCBPlayer
578,UCBPlayer,100,265,365,9,48,UCBPlayer
579,UCBPlayer,136,246,382,14,44,UCBPlayer
580,UCBPlayer,52,307,359,0,47,UCBPlayer
581,UCBPlayer,50,315,365,0,45,UCBPlayer
582,UCBPlayer,157,252,409,17,36,UCBPlayer
583,UCBPlayer,51,311,362,0,46,UCBPlayer
584,UCBPlayer,62,267,329,0,57,UCBPlayer
585,UCBPlayer,56,291,347,0,51,UCBPlayer
586,UCBPlayer,49,329,378,1,41,UCBPlayer
587,UCBPlayer,64,314,378,4,42,UCBPlayer
588,UCBPlayer,61,296,357,1,48,UCBPlayer
589,UCBPlayer,49,319,368,0,44,UCBPlayer
590,UCBPlayer,54,299,353,0,49,UCBPlayer
591,UCBPlayer,67,287,354,4,50,UCBPlayer
592,UCBPlayer,74,259,333,1,56,UCBPlayer
593,UCBPlayer,58,283,341,0,53,UCBPlayer
594,UCBPlayer,57,287,344,0,52,UCBPlayer
595,UCBPlayer,53,303,356,0,48,UCBPlayer
596,UCBPlayer,56,291,347,0,51,UCBPlayer
597,UCBPlayer,84,234,318,1,61,UCBPlayer
598,UCBPlayer,87,317,404,9,35,UCBPlayer
599,UCBPlayer,110,275,385,11,42,UCBPlayer
600,UCBPlayer,48,323,371,0,43,UCBPlayer
601,UCBPlayer,59,279,338,0,54,UCBPlayer
602,UCBPlayer,46,331,377,0,41,UCBPlayer
603,UCBPlayer,59,289,348,1,51,UCBPlayer
604,UCBPlayer,97,267,364,8,48,UCBPlayer
605,UCBPlayer,57,312,369,1,44,UCBPlayer
606,UCBPlayer,74,274,348,4,52,UCBPlayer
607,UCBPlayer,81,281,362,3,47,UCBPlayer
608,UCBPlayer,57,287,344,0,52,UCBPlayer
609,UCBPlayer,56,291,347,0,51,UCBPlayer
610,UCBPlayer,47,327,374,0,42,UCBPlayer
611,UCBPlayer,46,316,362,0,46,UCBPlayer
612,UCBPlayer,68,293,361,2,47,UCBPlayer
613,UCBPlayer,47,327,374,0,42,UCBPlayer
614,UCBPlayer,71,266,337,2,55,UCBPlayer
615,UCBPlayer,46,331,377,0,41,UCBPlayer
616,UCBPlayer,52,307,359,0,47,UCBPlayer
617,UCBPlayer,43,353,396,1,35,UCBPlayer
618,UCBPlayer,59,279,338,0,54,UCBPlayer
619,UCBPlayer,102,267,369,7,46,UCBPlayer
620,UCBPlayer,63,288,351,1,50,UCBPlayer
621,UCBPlayer,165,230,395,24,43,UCBPlayer
622,UCBPlayer,62,292,354,1,49,UCBPlayer
623,UCBPlayer,68,288,356,3,49,UCBPlayer
624,UCBPlayer,77,267,344,3,53,UCBPlayer
625,UCBPlayer,65,290,355,2,49,UCBPlayer
626,UCBPlayer,61,306,367,2,45,UCBPlayer
627,UCBPlayer,55,295,350,0,50,UCBPlayer
628,UCBPlayer,72,287,359,3,48,UCBPlayer
629,UCBPlayer,73,273,346,2,52,UCBPlayer
630,UCBPlayer,48,323,371,0,43,UCBPlayer
631,UCBPlayer,56,291,347,0,51,UCBPlayer
632,UCBPlayer,46,331,377,0,41,UCBPlayer
633,UCBPlayer,51,311,362,0,46,UCBPlayer
634,UCBPlayer,59,279,338,0,54,UCBPlayer
635,UCBPlayer,52,307,359,0,47,UCBPlayer
636,UCBPlayer,75,285,360,4,48,UCBPlayer
637,UCBPlayer,64,259,323,0,59,UCBPlayer
638,UCBPlayer,55,295,350,0,50,UCBPlayer
639,UCBPlayer,56,291,347,0,51,UCBPlayer
640,UCBPlayer,47,327,374,0,42,UCBPlayer
641,UCBPlayer,55,305,360,1,47,UCBPlayer
642,UCBPlayer,86,291,377,9,44,UCBPlayer
643,UCBPlayer,72,312,384,7,41,UCBPlayer
644,UCBPlayer,58,308,366,1,45,UCBPlayer
645,UCBPlayer,60,275,335,0,55,UCBPlayer
646,UCBPlayer,73,333,406,11,35,UCBPlayer
647,UCBPlayer,83,293,376,5,43,UCBPlayer
648,UCBPlayer,55,295,350,0,50,UCBPlayer
649,UCBPlayer,51,311,362,0,46,UCBPlayer
650,UCBPlayer,53,303,356,0,48,UCBPlayer
651,UCBPlayer,67,282,349,2,51,UCBPlayer
652,UCBPlayer,80,290,370,5,45,UCBPlayer
653,UCBPlayer,65,310,375,4,43,UCBPlayer
654,UCBPlayer,77,257,334,2,56,UCBPlayer
655,UCBPlayer,56,291,347,0,51,UCBPlayer
656,UCBPlayer,61,281,342,1,53,UCBPlayer
657,UCBPlayer,65,270,335,0,55,UCBPlayer
658,UCBPlayer,51,311,362,0,46,UCBPlayer
659,UCBPlayer,57,307,364,2,46,UCBPlayer
660,UCBPlayer,63,278,341,0,53,UCBPlayer
661,UCBPlayer,56,291,347,0,51,UCBPlayer
662,UCBPlayer,54,284,338,0,54,UCBPlayer
663,UCBPlayer,56,291,347,0,51,UCBPlayer
664,UCBPlayer,112,257,369,13,48,UCBPlayer
665,UCBPlayer,64,274,338,0,54,UCBPlayer
666,UCBPlayer,70,305,375,4,43,UCBPlayer
667,UCBPlayer,66,276,342,1,53,UCBPlayer
668,UCBPlayer,52,307,359,0,47,UCBPlayer
669,UCBPlayer,66,296,362,3,47,UCBPlayer
670,UCBPlayer,51,311,362,0,46,UCBPlayer
671,UCBPlayer,52,332,384,1,39,UCBPlayer
672,UCBPlayer,60,275,335,0,55,UCBPlayer
673,UCBPlayer,60,300,360,1,47,UCBPlayer
674,UCBPlayer,58,283,341,0,53,UCBPlayer
675,UCBPlayer,66,286,352,2,50,UCBPlayer
676,UCBPlayer,56,291,347,0,51,UCBPlayer
677,UCBPlayer,52,307,359,0,47,UCBPlayer
678,UCBPlayer,194,234,428,21,31,UCBPlayer
679,UCBPlayer,66,276,342,1,53,UCBPlayer
680,UCBPlayer,53,303,356,0,48,UCBPlayer
681,UCBPlayer,67,282,349,2,51,UCBPlayer
682,UCBPlayer,88,268,356,6,50,UCBPlayer
683,UCBPlayer,50,315,365,0,45,UCBPlayer
684,UCBPlayer,89,274,363,7,48,UCBPlayer
685,UCBPlayer,52,307,359,0,47,UCBPlayer
686,UCBPlayer,63,288,351,1,50,UCBPlayer
687,UCBPlayer,64,274,338,0,54,UCBPlayer
688,UCBPlayer,55,305,360,1,47,UCBPlayer
689,UCBPlayer,58,298,356,0,48,UCBPlayer
690,UCBPlayer,76,281,357,4,49,UCBPlayer
691,UCBPlayer,61,306,367,2,45,UCBPlayer
692,UCBPlayer,49,319,368,0,44,UCBPlayer
693,UCBPlayer,70,270,340,2,54,UCBPlayer
694,UCBPlayer,61,306,367,2,45,UCBPlayer
695,UCBPlayer,66,276,342,1,53,UCBPlayer
696,UCBPlayer,55,315,370,2,44,UCBPlayer
697,UCBPlayer,75,255,330,1,57,UCBPlayer
698,UCBPlayer,138,248,386,15,43,UCBPlayer
699,UCBPlayer,62,322,384,1,39,UCBPlayer
700,UCBPlayer,61,286,347,0,51,UCBPlayer
701,UCBPlayer,116,266,382,11,43,UCBPlayer
702,UCBPlayer,92,262,354,4,50,UCBPlayer
703,UCBPlayer,65,280,345,1,52,UCBPlayer
704,UCBPlayer,57,287,344,0,52,UCBPlayer
705,UCBPlayer,59,279,338,0,54,UCBPlayer
706,UCBPlayer,91,271,362,6,48,UCBPlayer
707,UCBPlayer,83,273,356,3,49,UCBPlayer
708,UCBPlayer,73,303,376,5,43,UCBPlayer
709,UCBPlayer,80,295,375,4,43,UCBPlayer
710,UCBPlayer,51,321,372,1,43,UCBPlayer
711,UCBPlayer,58,308,366,1,45,UCBPlayer
712,UCBPlayer,51,306,357,1,48,UCBPlayer
713,UCBPlayer,55,310,365,0,45,UCBPlayer
714,UCBPlayer,59,279,338,0,54,UCBPlayer
715,UCBPlayer,88,273,361,8,49,UCBPlayer
716,UCBPlayer,52,307,359,0,47,UCBPlayer
717,UCBPlayer,54,299,353,0,49,UCBPlayer
718,UCBPlayer,49,329,378,1,41,UCBPlayer
719,UCBPlayer,51,311,362,0,46,UCBPlayer
720,UCBPlayer,75,295,370,5,45,UCBPlayer
721,UCBPlayer,52,307,359,0,47,UCBPlayer
722,UCBPlayer,86,271,357,7,50,UCBPlayer
723,UCBPlayer,46,341,387,1,38,UCBPlayer
724,UCBPlayer,64,284,348,1,51,UCBPlayer
725,UCBPlayer,64,294,358,2,48,UCBPlayer
726,UCBPlayer,58,283,341,0,53,UCBPlayer
727,UCBPlayer,64,294,358,2,48,UCBPlayer
728,UCBPlayer,43,343,386,0,38,UCBPlayer
729,UCBPlayer,73,278,351,4,51,UCBPlayer
730,UCBPlayer,67,297,364,2,46,UCBPlayer
731,UCBPlayer,49,319,368,0,44,UCBPlayer
732,UCBPlayer,53,303,356,0,48,UCBPlayer
733,UCBPlayer,108,258,366,10,48,UCBPlayer
734,UCBPlayer,50,325,375,1,42,UCBPlayer
735,UCBPlayer,66,301,367,2,45,UCBPlayer
736,UCBPlayer,70,260,330,1,57,UCBPlayer
737,UCBPlayer,59,309,368,3,45,UCBPlayer
738,UCBPlayer,49,319,368,0,44,UCBPlayer
739,UCBPlayer,61,306,367,2,45,UCBPlayer
740,UCBPlayer,64,304,368,3,45,UCBPlayer
741,UCBPlayer,184,249,433,26,31,UCBPlayer
742,UCBPlayer,62,302,364,2,46,UCBPlayer
743,UCBPlayer,60,275,335,0,55,UCBPlayer
744,UCBPlayer,54,299,353,0,49,UCBPlayer
745,UCBPlayer,52,317,369,1,44,UCBPlayer
746,UCBPlayer,66,296,362,3,47,UCBPlayer
747,UCBPlayer,80,300,380,6,42,UCBPlayer
748,UCBPlayer,53,303,356,0,48,UCBPlayer
749,UCBPlayer,60,275,335,0,55,UCBPlayer
750,UCBPlayer,66,266,332,0,56,UCBPlayer
751,UCBPlayer,48,323,371,0,43,UCBPlayer
752,UCBPlayer,48,323,371,0,43,UCBPlayer
753,UCBPlayer,50,315,365,0,45,UCBPlayer
754,UCBPlayer,49,319,368,0,44,UCBPlayer
755,UCBPlayer,51,331,382,2,40,UCBPlayer
756,UCBPlayer,107,242,349,8,53,UCBPlayer
757,UCBPlayer,124,269,393,13,40,UCBPlayer
758,UCBPlayer,140,225,365,12,49,UCBPlayer
759,UCBPlayer,45,340,385,2,39,UCBPlayer
760,UCBPlayer,84,274,358,5,49,UCBPlayer
761,UCBPlayer,73,238,311,0,63,UCBPlayer
762,UCBPlayer,52,317,369,1,44,UCBPlayer
763,UCBPlayer,62,282,344,0,52,UCBPlayer
764,UCBPlayer,49,304,353,0,49,UCBPlayer
765,UCBPlayer,79,279,358,5,49,UCBPlayer
766,UCBPlayer,111,256,367,11,48,UCBPlayer
767,UCBPlayer,72,277,349,2,51,UCBPlayer
768,UCBPlayer,50,315,365,0,45,UCBPlayer
769,UCBPlayer,80,295,375,7,44,UCBPlayer
770,UCBPlayer,60,275,335,0,55,UCBPlayer
771,UCBPlayer,44,339,383,0,39,UCBPlayer
772,UCBPlayer,70,305,375,4,43,UCBPlayer
773,UCBPlayer,103,293,396,16,40,UCBPlayer
774,UCBPlayer,63,288,351,1,50,UCBPlayer
775,UCBPlayer,52,327,379,2,41,UCBPlayer
776,UCBPlayer,76,301,377,6,43,UCBPlayer
777,UCBPlayer,50,315,365,0,45,UCBPlayer
778,UCBPlayer,51,311,362,0,46,UCBPlayer
779,UCBPlayer,46,331,377,0,41,UCBPlayer
780,UCBPlayer,61,271,332,0,56,UCBPlayer
781,UCBPlayer,47,327,374,0,42,UCBPlayer
782,UCBPlayer,55,295,350,0,50,UCBPlayer
783,UCBPlayer,50,325,375,1,42,UCBPlayer
784,UCBPlayer,51,326,377,0,41,UCBPlayer
785,UCBPlayer,50,315,365,0,45,UCBPlayer
786,UCBPlayer,105,260,365,12,49,UCBPlayer
787,UCBPlayer,54,299,353,0,49,UCBPlayer
788,UCBPlayer,74,244,318,1,61,UCBPlayer
789,UCBPlayer,53,303,356,0,48,UCBPlayer
790,UCBPlayer,55,295,350,0,50,UCBPlayer
791,UCBPlayer,73,278,351,4,51,UCBPlayer
792,UCBPlayer,58,308,366,1,45,UCBPlayer
793,UCBPlayer,61,281,342,1,53,UCBPlayer
794,UCBPlayer,72,267,339,1,54,UCBPlayer
795,UCBPlayer,90,265,355,5,50,UCBPlayer
796,UCBPlayer,59,279,338,0,54,UCBPlayer
797,UCBPlayer,60,300,360,1,47,UCBPlayer
798,UCBPlayer,48,333,381,1,40,UCBPlayer
799,UCBPlayer,101,261,362,6,48,UCBPlayer
800,UCBPlayer,60,300,360,1,47,UCBPlayer
801,UCBPlayer,50,315,365,0,45,UCBPlayer
802,UCBPlayer,49,319,368,0,44,UCBPlayer
803,UCBPlayer,65,290,355,2,49,UCBPlayer
804,UCBPlayer,46,331,377,0,41,UCBPlayer
805,UCBPlayer,67,262,329,0,57,UCBPlayer
806,UCBPlayer,49,329,378,1,41,UCBPlayer
807,UCBPlayer,62,312,374,3,43,UCBPlayer
808,UCBPlayer,78,293,371,6,45,UCBPlayer
809,UCBPlayer,58,313,371,3,44,UCBPlayer
810,UCBPlayer,53,318,371,0,43,UCBPlayer
811,UCBPlayer,47,327,374,0,42,UCBPlayer
812,UCBPlayer,55,290,345,1,52,UCBPlayer
813,UCBPlayer,66,301,367,2,45,UCBPlayer
814,UCBPlayer,59,309,368,0,44,UCBPlayer
815,UCBPlayer,44,324,368,0,44,UCBPlayer
816,UCBPlayer,70,260,330,1,57,UCBPlayer
817,UCBPlayer,57,287,344,0,52,UCBPlayer
818,UCBPlayer,82,257,339,4,55,UCBPlayer
819,UCBPlayer,92,302,394,11,39,UCBPlayer
820,UCBPlayer,70,300,370,5,45,UCBPlayer
821,UCBPlayer,53,303,356,0,48,UCBPlayer
822,UCBPlayer,47,327,374,0,42,UCBPlayer
823,UCBPlayer,74,294,368,6,46,UCBPlayer
824,UCBPlayer,58,308,366,1,45,UCBPlayer
825,UCBPlayer,69,284,353,3,50,UCBPlayer
826,UCBPlayer,57,287,344,0,52,UCBPlayer
827,UCBPlayer,59,324,383,3,40,UCBPlayer
828,UCBPlayer,52,307,359,0,47,UCBPlayer
829,UCBPlayer,82,277,359,6,49,UCBPlayer
830,UCBPlayer,83,268,351,4,51,UCBPlayer
831,UCBPlayer,56,291,347,0,51,UCBPlayer
832,UCBPlayer,47,327,374,0,42,UCBPlayer
833,UCBPlayer,47,327,374,0,42,UCBPlayer
834,UCBPlayer,71,281,352,2,50,UCBPlayer
835,UCBPlayer,54,299,353,0,49,UCBPlayer
836,UCBPlayer,54,299,353,0,49,UCBPlayer
837,UCBPlayer,51,311,362,0,46,UCBPlayer
838,UCBPlayer,56,291,347,0,51,UCBPlayer
839,UCBPlayer,52,307,359,0,47,UCBPlayer
840,UCBPlayer,73,283,356,3,49,UCBPlayer
841,UCBPlayer,75,280,355,5,50,UCBPlayer
842,UCBPlayer,66,306,372,4,44,UCBPlayer
843,UCBPlayer,44,339,383,0,39,UCBPlayer
844,UCBPlayer,115,280,395,12,39,UCBPlayer
845,UCBPlayer,60,275,335,0,55,UCBPlayer
846,UCBPlayer,61,296,357,1,48,UCBPlayer
847,UCBPlayer,43,343,386,0,38,UCBPlayer
848,UCBPlayer,154,254,408,19,37,UCBPlayer
849,UCBPlayer,96,266,362,6,48,UCBPlayer
850,UCBPlayer,53,303,356,0,48,UCBPlayer
851,UCBPlayer,91,276,367,8,47,UCBPlayer
852,UCBPlayer,82,262,344,3,53,UCBPlayer
853,UCBPlayer,68,268,336,1,55,UCBPlayer
854,UCBPlayer,60,290,350,0,50,UCBPlayer
855,UCBPlayer,54,299,353,0,49,UCBPlayer
856,UCBPlayer,54,319,373,2,43,UCBPlayer
857,UCBPlayer,71,291,362,3,47,UCBPlayer
858,UCBPlayer,63,288,351,1,50,UCBPlayer
859,UCBPlayer,89,274,363,7,48,UCBPlayer
860,UCBPlayer,60,315,375,1,42,UCBPlayer
861,UCBPlayer,51,326,377,0,41,UCBPlayer
862,UCBPlayer,52,307,359,0,47,UCBPlayer
863,UCBPlayer,48,323,371,0,43,UCBPlayer
864,UCBPlayer,44,339,383,0,39,UCBPlayer
865,UCBPlayer,60,275,335,0,55,UCBPlayer
866,UCBPlayer,44,324,368,0,44,UCBPlayer
867,UCBPlayer,81,251,332,3,57,UCBPlayer
868,UCBPlayer,56,291,347,0,51,UCBPlayer
869,UCBPlayer,89,264,353,6,51,UCBPlayer
870,UCBPlayer,51,311,362,0,46,UCBPlayer
871,UCBPlayer,82,262,344,3,53,UCBPlayer
872,UCBPlayer,58,283,341,0,53,UCBPlayer
873,UCBPlayer,58,308,366,1,45,UCBPlayer
874,UCBPlayer,91,251,342,4,54,UCBPlayer
875,UCBPlayer,68,288,356,3,49,UCBPlayer
876,UCBPlayer,47,337,384,1,39,UCBPlayer
877,UCBPlayer,61,321,382,2,40,UCBPlayer
878,UCBPlayer,55,295,350,0,50,UCBPlayer
879,UCBPlayer,56,291,347,0,51,UCBPlayer
880,UCBPlayer,54,299,353,0,49,UCBPlayer
881,UCBPlayer,74,279,353,3,50,UCBPlayer
882,UCBPlayer,57,312,369,1,44,UCBPlayer
883,UCBPlayer,43,353,396,1,35,UCBPlayer
884,UCBPlayer,57,287,344,0,52,UCBPlayer
885,UCBPlayer,72,312,384,4,40,UCBPlayer
886,UCBPlayer,84,289,373,5,44,UCBPlayer
887,UCBPlayer,63,318,381,4,41,UCBPlayer
888,UCBPlayer,69,304,373,5,44,UCBPlayer
889,UCBPlayer,52,307,359,0,47,UCBPlayer
890,UCBPlayer,49,329,378,1,41,UCBPlayer
891,UCBPlayer,68,288,356,3,49,UCBPlayer
892,UCBPlayer,61,316,377,3,42,UCBPlayer
893,UCBPlayer,58,303,361,2,47,UCBPlayer
894,UCBPlayer,74,289,363,4,47,UCBPlayer
895,UCBPlayer,51,311,362,0,46,UCBPlayer
896,UCBPlayer,58,318,376,2,42,UCBPlayer
897,UCBPlayer,57,307,364,2,46,UCBPlayer
898,UCBPlayer,54,314,368,0,44,UCBPlayer
899,UCBPlayer,81,291,372,4,44,UCBPlayer
900,UCBPlayer,79,264,343,5,54,UCBPlayer
901,UCBPlayer,70,285,355,2,49,UCBPlayer
902,UCBPlayer,58,308,366,1,45,UCBPlayer
903,UCBPlayer,64,314,378,4,42,UCBPlayer
904,UCBPlayer,51,311,362,0,46,UCBPlayer
905,UCBPlayer,59,279,338,0,54,UCBPlayer
906,UCBPlayer,78,283,361,5,48,UCBPlayer
907,UCBPlayer,54,309,363,1,46,UCBPlayer
908,UCBPlayer,59,304,363,1,46,UCBPlayer
909,UCBPlayer,65,315,380,6,42,UCBPlayer
910,UCBPlayer,80,270,350,3,51,UCBPlayer
911,UCBPlayer,49,329,378,1,41,UCBPlayer
912,UCBPlayer,60,310,370,2,44,UCBPlayer
913,UCBPlayer,80,275,355,5,50,UCBPlayer
914,UCBPlayer,58,308,366,1,45,UCBPlayer
915,UCBPlayer,47,337,384,1,39,UCBPlayer
916,UCBPlayer,64,314,378,4,42,UCBPlayer
917,UCBPlayer,44,324,368,0,44,UCBPlayer
918,UCBPlayer,60,275,335,0,55,UCBPlayer
919,UCBPlayer,67,262,329,0,57,UCBPlayer
920,UCBPlayer,71,246,317,0,61,UCBPlayer
921,UCBPlayer,224,204,428,27,33,Player A
922,UCBPlayer,65,290,355,2,49,UCBPlayer
923,UCBPlayer,56,291,347,0,51,UCBPlayer
924,UCBPlayer,49,319,368,0,44,UCBPlayer
925,UCBPlayer,65,310,375,4,43,UCBPlayer
926,UCBPlayer,59,279,338,0,54,UCBPlayer
927,UCBPlayer,55,295,350,0,50,UCBPlayer
928,UCBPlayer,46,331,377,0,41,UCBPlayer
929,UCBPlayer,57,287,344,0,52,UCBPlayer
930,UCBPlayer,88,263,351,4,51,UCBPlayer
931,UCBPlayer,49,339,388,2,38,UCBPlayer
932,UCBPlayer,107,302,409,20,37,UCBPlayer
933,UCBPlayer,66,286,352,2,50,UCBPlayer
934,UCBPlayer,51,311,362,0,46,UCBPlayer
935,UCBPlayer,61,271,332,0,56,UCBPlayer
936,UCBPlayer,53,328,381,1,40,UCBPlayer
937,UCBPlayer,98,283,381,7,42,UCBPlayer
938,UCBPlayer,54,299,353,0,49,UCBPlayer
939,UCBPlayer,63,278,341,0,53,UCBPlayer
940,UCBPlayer,60,275,335,0,55,UCBPlayer
941,UCBPlayer,55,325,380,3,41,UCBPlayer
942,UCBPlayer,59,304,363,1,46,UCBPlayer
943,UCBPlayer,54,299,353,0,49,UCBPlayer
944,UCBPlayer,56,291,347,0,51,UCBPlayer
945,UCBPlayer,86,276,362,6,48,UCBPlayer
946,UCBPlayer,52,327,379,2,41,UCBPlayer
947,UCBPlayer,61,306,367,2,45,UCBPlayer
948,UCBPlayer,74,244,318,1,61,UCBPlayer
949,UCBPlayer,84,264,348,4,52,UCBPlayer
950,UCBPlayer,68,308,376,5,43,UCBPlayer
951,UCBPlayer,53,303,356,0,48,UCBPlayer
952,UCBPlayer,57,297,354,1,49,UCBPlayer
953,UCBPlayer,62,292,354,1,49,UCBPlayer
954,UCBPlayer,61,271,332,0,56,UCBPlayer
955,UCBPlayer,68,278,346,2,52,UCBPlayer
956,UCBPlayer,56,291,347,0,51,UCBPlayer
957,UCBPlayer,55,330,385,2,39,UCBPlayer
958,UCBPlayer,64,274,338,0,54,UCBPlayer
959,UCBPlayer,51,311,362,0,46,UCBPlayer
960,UCBPlayer,76,296,372,4,44,UCBPlayer
961,UCBPlayer,58,283,341,0,53,UCBPlayer
962,UCBPlayer,54,299,353,0,49,UCBPlayer
963,UCBPlayer,50,315,365,0,45,UCBPlayer
964,UCBPlayer,68,298,366,4,46,UCBPlayer
965,UCBPlayer,119,259,378,7,43,UCBPlayer
966,UCBPlayer,60,285,345,1,52,UCBPlayer
967,UCBPlayer,54,309,363,1,46,UCBPlayer
968,UCBPlayer,67,262,329,0,57,UCBPlayer
969,UCBPlayer,55,295,350,0,50,UCBPlayer
970,UCBPlayer,46,331,377,0,41,UCBPlayer
971,UCBPlayer,59,279,338,0,54,UCBPlayer
972,UCBPlayer,49,319,368,0,44,UCBPlayer
973,UCBPlayer,68,288,356,3,49,UCBPlayer
974,UCBPlayer,58,308,366,1,45,UCBPlayer
975,UCBPlayer,85,280,365,6,47,UCBPlayer
976,UCBPlayer,79,259,338,3,55,UCBPlayer
977,UCBPlayer,53,303,356,0,48,UCBPlayer
978,UCBPlayer,73,248,321,1,60,UCBPlayer
979,UCBPlayer,187,212,399,22,41,UCBPlayer
980,UCBPlayer,53,303,356,0,48,UCBPlayer
981,UCBPlayer,76,271,347,3,52,UCBPlayer
982,UCBPlayer,64,294,358,2,48,UCBPlayer
983,UCBPlayer,54,309,363,1,46,UCBPlayer
984,UCBPlayer,128,273,401,15,38,UCBPlayer
985,UCBPlayer,49,319,368,0,44,UCBPlayer
986,UCBPlayer,134,244,378,13,45,UCBPlayer
987,UCBPlayer,57,297,354,1,49,UCBPlayer
988,UCBPlayer,52,322,374,0,42,UCBPlayer
989,UCBPlayer,53,303,356,0,48,UCBPlayer
990,UCBPlayer,50,325,375,1,42,UCBPlayer
991,UCBPlayer,55,295,350,0,50,UCBPlayer
992,UCBPlayer,58,303,361,2,47,UCBPlayer
993,UCBPlayer,56,306,362,0,46,UCBPlayer
994,UCBPlayer,106,276,382,11,43,UCBPlayer
995,UCBPlayer,78,278,356,3,49,UCBPlayer
996,UCBPlayer,69,289,358,2,48,UCBPlayer
997,UCBPlayer,74,274,348,4,52,UCBPlayer
998,UCBPlayer,101,251,352,8,52,UCBPlayer
999,UCBPlayer,53,303,356,0,48,UCBPlayer
1000,UCBPlayer,129,259,388,17,43,UCBPlayer
1001,UCBPlayer,61,306,367,2,45,UCBPlayer
1002,UCBPlayer,161,256,417,22,35,UCBPlayer
1003,UCBPlayer,59,314,373,2,43,UCBPlayer
1004,UCBPlayer,52,307,359,0,47,UCBPlayer
1005,UCBPlayer,84,279,363,4,47,UCBPlayer
1006,UCBPlayer,60,275,335,0,55,UCBPlayer
1007,UCBPlayer,52,307,359,0,47,UCBPlayer
1008,UCBPlayer,59,279,338,0,54,UCBPlayer
1009,UCBPlayer,53,303,356,0,48,UCBPlayer
1010,UCBPlayer,50,315,365,0,45,UCBPlayer
1011,UCBPlayer,49,319,368,0,44,UCBPlayer
1012,UCBPlayer,69,274,343,2,53,UCBPlayer
1013,UCBPlayer,104,269,373,11,46,UCBPlayer
1014,UCBPlayer,59,314,373,2,43,UCBPlayer
1015,UCBPlayer,74,264,338,3,55,UCBPlayer
1016,UCBPlayer,78,253,331,2,57,UCBPlayer
1017,UCBPlayer,61,301,362,3,47,UCBPlayer
1018,UCBPlayer,64,304,368,3,45,UCBPlayer
1019,UCBPlayer,73,263,336,1,55,UCBPlayer
1020,UCBPlayer,51,311,362,0,46,UCBPlayer
1021,UCBPlayer,50,315,365,0,45,UCBPlayer
1022,UCBPlayer,61,306,367,2,45,UCBPlayer
1023,UCBPlayer,53,303,356,0,48,UCBPlayer
1024,UCBPlayer,61,306,367,2,45,UCBPlayer
1025,UCBPlayer,68,278,346,2,52,UCBPlayer
1026,UCBPlayer,63,298,361,2,47,UCBPlayer
1027,UCBPlayer,48,323,371,0,43,UCBPlayer
1028,UCBPlayer,49,319,368,0,44,UCBPlayer
1029,UCBPlayer,178,218,396,16,40,UCBPlayer
1030,UCBPlayer,59,279,338,0,54,UCBPlayer
1031,UCBPlayer,63,288,351,1,50,UCBPlayer
1032,UCBPlayer,65,280,345,1,52,UCBPlayer
1033,UCBPlayer,69,294,363,4,47,UCBPlayer
1034,UCBPlayer,58,283,341,0,53,UCBPlayer
1035,UCBPlayer,51,311,362,0,46,UCBPlayer
1036,UCBPlayer,63,278,341,0,53,UCBPlayer
1037,UCBPlayer,50,315,365,0,45,UCBPlayer
1038,UCBPlayer,58,283,341,0,53,UCBPlayer
1039,UCBPlayer,73,263,336,1,55,UCBPlayer
1040,UCBPlayer,86,271,357,7,50,UCBPlayer
1041,UCBPlayer,51,311,362,0,46,UCBPlayer
1042,UCBPlayer,67,317,384,7,41,UCBPlayer
1043,UCBPlayer,53,313,366,1,45,UCBPlayer
1044,UCBPlayer,59,314,373,2,43,UCBPlayer
1045,UCBPlayer,56,316,372,1,43,UCBPlayer
1046,UCBPlayer,60,275,335,0,55,UCBPlayer
1047,UCBPlayer,60,275,335,0,55,UCBPlayer
1048,UCBPlayer,77,297,374,6,44,UCBPlayer
1049,UCBPlayer,52,317,369,1,44,UCBPlayer
1050,UCBPlayer,69,289,358,2,48,UCBPlayer
1051,UCBPlayer,68,298,366,4,46,UCBPlayer
1052,UCBPlayer,71,306,377,3,42,UCBPlayer
1053,UCBPlayer,73,308,381,7,42,UCBPlayer
1054,UCBPlayer,60,290,350,0,50,UCBPlayer
1055,UCBPlayer,56,291,347,0,51,UCBPlayer
1056,UCBPlayer,79,294,373,8,45,UCBPlayer
1057,UCBPlayer,74,294,368,3,45,UCBPlayer
1058,UCBPlayer,48,323,371,0,43,UCBPlayer
1059,UCBPlayer,67,262,329,0,57,UCBPlayer
1060,UCBPlayer,52,307,359,0,47,UCBPlayer
1061,UCBPlayer,48,323,371,0,43,UCBPlayer
1062,UCBPlayer,52,307,359,0,47,UCBPlayer
1063,UCBPlayer,58,293,351,1,50,UCBPlayer
1064,UCBPlayer,65,270,335,0,55,UCBPlayer
1065,UCBPlayer,53,343,396,1,35,UCBPlayer
1066,UCBPlayer,59,279,338,0,54,UCBPlayer
1067,UCBPlayer,54,324,378,1,41,UCBPlayer
1068,UCBPlayer,51,316,367,2,45,UCBPlayer
1069,UCBPlayer,57,312,369,1,44,UCBPlayer
1070,UCBPlayer,70,290,360,4,48,UCBPlayer
1071,UCBPlayer,60,300,360,1,47,UCBPlayer
1072,UCBPlayer,94,269,363,7,48,UCBPlayer
1073,UCBPlayer,54,299,353,0,49,UCBPlayer
1074,UCBPlayer,78,263,341,3,54,UCBPlayer
1075,UCBPlayer,64,284,348,1,51,UCBPlayer
1076,UCBPlayer,66,306,372,4,44,UCBPlayer
1077,UCBPlayer,60,275,335,0,55,UCBPlayer
1078,UCBPlayer,45,335,380,0,40,UCBPlayer
1079,UCBPlayer,59,279,338,0,54,UCBPlayer
1080,UCBPlayer,59,279,338,0,54,UCBPlayer
1081,UCBPlayer,59,314,373,2,43,UCBPlayer
1082,UCBPlayer,64,284,348,1,51,UCBPlayer
1083,UCBPlayer,85,285,370,5,45,UCBPlayer
1084,UCBPlayer,72,292,364,5,47,UCBPlayer
1085,UCBPlayer,66,306,372,4,44,UCBPlayer
1086,UCBPlayer,63,298,361,2,47,UCBPlayer
1087,UCBPlayer,51,311,362,0,46,UCBPlayer
1088,UCBPlayer,68,278,346,2,52,UCBPlayer
1089,UCBPlayer,61,296,357,1,48,UCBPlayer
1090,UCBPlayer,61,271,332,0,56,UCBPlayer
1091,UCBPlayer,57,312,369,1,44,UCBPlayer
1092,UCBPlayer,58,293,351,1,50,UCBPlayer
1093,UCBPlayer,71,271,342,1,53,UCBPlayer
1094,UCBPlayer,62,312,374,3,43,UCBPlayer
1095,UCBPlayer,63,278,341,0,53,UCBPlayer
1096,UCBPlayer,59,279,338,0,54,UCBPlayer
1097,UCBPlayer,75,275,350,3,51,UCBPlayer
1098,UCBPlayer,56,311,367,2,45,UCBPlayer
1099,UCBPlayer,56,306,362,0,46,UCBPlayer
1100,UCBPlayer,52,307,359,0,47,UCBPlayer
1101,UCBPlayer,52,307,359,0,47,UCBPlayer
1102,UCBPlayer,56,291,347,0,51,UCBPlayer
1103,UCBPlayer,59,279,338,0,54,UCBPlayer
1104,UCBPlayer,63,288,351,1,50,UCBPlayer
1105,UCBPlayer,58,318,376,2,42,UCBPlayer
1106,UCBPlayer,63,288,351,1,50,UCBPlayer
1107,UCBPlayer,94,299,393,10,39,UCBPlayer
1108,UCBPlayer,61,291,352,2,50,UCBPlayer
1109,UCBPlayer,69,314,383,6,41,UCBPlayer
1110,UCBPlayer,67,282,349,2,51,UCBPlayer
1111,UCBPlayer,57,322,379,2,41,UCBPlayer
1112,UCBPlayer,63,273,336,1,55,UCBPlayer
1113,UCBPlayer,63,333,396,4,36,UCBPlayer
1114,UCBPlayer,61,306,367,2,45,UCBPlayer
1115,UCBPlayer,66,276,342,1,53,UCBPlayer
1116,UCBPlayer,75,265,340,2,54,UCBPlayer
1117,UCBPlayer,57,307,364,2,46,UCBPlayer
1118,UCBPlayer,61,296,357,1,48,UCBPlayer
1119,UCBPlayer,51,311,362,0,46,UCBPlayer
1120,UCBPlayer,62,267,329,0,57,UCBPlayer
1121,UCBPlayer,175,220,395,18,41,UCBPlayer
1122,UCBPlayer,50,315,365,0,45,UCBPlayer
1123,UCBPlayer,54,299,353,0,49,UCBPlayer
1124,UCBPlayer,56,291,347,0,51,UCBPlayer
1125,UCBPlayer,53,303,356,0,48,UCBPlayer
1126,UCBPlayer,77,257,334,2,56,UCBPlayer
1127,UCBPlayer,48,323,371,0,43,UCBPlayer
1128,UCBPlayer,51,311,362,0,46,UCBPlayer
1129,UCBPlayer,74,289,363,4,47,UCBPlayer
1130,UCBPlayer,53,303,356,0,48,UCBPlayer
1131,UCBPlayer,53,303,356,0,48,UCBPlayer
1132,UCBPlayer,53,303,356,0,48,UCBPlayer
1133,UCBPlayer,51,321,372,1,43,UCBPlayer
1134,UCBPlayer,51,311,362,0,46,UCBPlayer
1135,UCBPlayer,68,293,361,2,47,UCBPlayer
1136,UCBPlayer,53,303,356,0,48,UCBPlayer
1137,UCBPlayer,100,250,350,6,52,UCBPlayer
1138,UCBPlayer,57,312,369,1,44,UCBPlayer
1139,UCBPlayer,53,303,356,0,48,UCBPlayer
1140,UCBPlayer,72,302,374,6,44,UCBPlayer
1141,UCBPlayer,115,270,385,8,41,UCBPlayer
1142,UCBPlayer,69,274,343,2,53,UCBPlayer
1143,UCBPlayer,48,323,371,0,43,UCBPlayer
1144,UCBPlayer,67,302,369,4,45,UCBPlayer
1145,UCBPlayer,59,314,373,2,43,UCBPlayer
1146,UCBPlayer,49,319,368,0,44,UCBPlayer
1147,UCBPlayer,69,254,323,0,59,UCBPlayer
1148,UCBPlayer,61,326,387,4,39,UCBPlayer
1149,UCBPlayer,157,267,424,20,32,UCBPlayer
1150,UCBPlayer,59,279,338,0,54,UCBPlayer
1151,UCBPlayer,57,297,354,1,49,UCBPlayer
1152,UCBPlayer,57,302,359,0,47,UCBPlayer
1153,UCBPlayer,99,254,353,9,52,UCBPlayer
1154,UCBPlayer,64,294,358,2,48,UCBPlayer
1155,UCBPlayer,49,319,368,0,44,UCBPlayer
1156,UCBPlayer,64,294,358,2,48,UCBPlayer
1157,UCBPlayer,63,263,326,0,58,UCBPlayer
1158,UCBPlayer,54,299,353,0,49,UCBPlayer
1159,UCBPlayer,57,287,344,0,52,UCBPlayer
1160,UCBPlayer,62,267,329,0,57,UCBPlayer
1161,UCBPlayer,67,272,339,1,54,UCBPlayer
1162,UCBPlayer,60,295,355,2,49,UCBPlayer
1163,UCBPlayer,91,266,357,7,50,UCBPlayer
1164,UCBPlayer,68,268,336,1,55,UCBPlayer
1165,UCBPlayer,78,258,336,4,56,UCBPlayer
1166,UCBPlayer,68,308,376,2,42,UCBPlayer
1167,UCBPlayer,58,303,361,2,47,UCBPlayer
1168,UCBPlayer,49,334,383,0,39,UCBPlayer
1169,UCBPlayer,55,295,350,0,50,UCBPlayer
1170,UCBPlayer,51,321,372,1,43,UCBPlayer
1171,UCBPlayer,54,324,378,1,41,UCBPlayer
1172,UCBPlayer,59,304,363,1,46,UCBPlayer
1173,UCBPlayer,51,311,362,0,46,UCBPlayer
1174,UCBPlayer,51,311,362,0,46,UCBPlayer
1175,UCBPlayer,63,278,341,0,53,UCBPlayer
1176,UCBPlayer,58,318,376,2,42,UCBPlayer
1177,UCBPlayer,48,323,371,0,43,UCBPlayer
1178,UCBPlayer,66,286,352,2,50,UCBPlayer
1179,UCBPlayer,68,258,326,0,58,UCBPlayer
1180,UCBPlayer,51,311,362,0,46,UCBPlayer
1181,UCBPlayer,56,291,347,0,51,UCBPlayer
1182,UCBPlayer,65,315,380,3,41,UCBPlayer
1183,UCBPlayer,53,303,356,0,48,UCBPlayer
1184,UCBPlayer,73,283,356,3,49,UCBPlayer
1185,UCBPlayer,58,318,376,2,42,UCBPlayer
1186,UCBPlayer,59,304,363,1,46,UCBPlayer
1187,UCBPlayer,68,268,336,1,55,UCBPlayer
1188,UCBPlayer,58,283,341,0,53,UCBPlayer
1189,UCBPlayer,65,280,345,1,52,UCBPlayer
1190,UCBPlayer,59,279,338,0,54,UCBPlayer
1191,UCBPlayer,53,303,356,0,48,UCBPlayer
1192,UCBPlayer,53,313,366,1,45,UCBPlayer
1193,UCBPlayer,62,282,344,0,52,UCBPlayer
1194,UCBPlayer,50,315,365,0,45,UCBPlayer
1195,UCBPlayer,53,303,356,0,48,UCBPlayer
1196,UCBPlayer,67,282,349,2,51,UCBPlayer
1197,UCBPlayer,103,283,386,12,42,UCBPlayer
1198,UCBPlayer,60,275,335,0,55,UCBPlayer
1199,UCBPlayer,54,309,363,1,46,UCBPlayer
1200,UCBPlayer,61,316,377,3,42,UCBPlayer
1201,UCBPlayer,75,280,355,2,49,UCBPlayer
1202,UCBPlayer,62,302,364,2,46,UCBPlayer
1203,UCBPlayer,57,287,344,0,52,UCBPlayer
1204,UCBPlayer,52,317,369,1,44,UCBPlayer
1205,UCBPlayer,98,243,341,6,55,UCBPlayer
1206,UCBPlayer,57,287,344,0,52,UCBPlayer
1207,UCBPlayer,69,294,363,4,47,UCBPlayer
1208,UCBPlayer,65,270,335,0,55,UCBPlayer
1209,UCBPlayer,57,287,344,0,52,UCBPlayer
1210,UCBPlayer,52,307,359,0,47,UCBPlayer
1211,UCBPlayer,55,295,350,0,50,UCBPlayer
1212,UCBPlayer,55,310,365,3,46,UCBPlayer
1213,UCBPlayer,64,299,363,1,46,UCBPlayer
1214,UCBPlayer,93,293,386,6,40,UCBPlayer
1215,UCBPlayer,50,315,365,0,45,UCBPlayer
1216,UCBPlayer,80,260,340,2,54,UCBPlayer
1217,UCBPlayer,86,266,352,8,52,UCBPlayer
1218,UCBPlayer,123,263,386,12,42,UCBPlayer
1219,UCBPlayer,57,297,354,1,49,UCBPlayer
1220,UCBPlayer,74,274,348,4,52,UCBPlayer
1221,UCBPlayer,100,275,375,10,45,UCBPlayer
1222,UCBPlayer,60,275,335,0,55,UCBPlayer
1223,UCBPlayer,47,312,359,0,47,UCBPlayer
1224,UCBPlayer,82,267,349,5,52,UCBPlayer
1225,UCBPlayer,51,311,362,0,46,UCBPlayer
1226,UCBPlayer,65,290,355,2,49,UCBPlayer
1227,UCBPlayer,59,279,338,0,54,UCBPlayer
1228,UCBPlayer,54,299,353,0,49,UCBPlayer
1229,UCBPlayer,60,275,335,0,55,UCBPlayer
1230,UCBPlayer,65,300,365,3,46,UCBPlayer
1231,UCBPlayer,66,286,352,2,50,UCBPlayer
1232,UCBPlayer,68,318,386,6,40,UCBPlayer
1233,UCBPlayer,98,268,366,7,47,UCBPlayer
1234,UCBPlayer,67,272,339,1,54,UCBPlayer
1235,UCBPlayer,52,307,359,0,47,UCBPlayer
1236,UCBPlayer,211,226,437,27,30,UCBPlayer
1237,UCBPlayer,81,261,342,4,54,UCBPlayer
1238,UCBPlayer,77,317,394,5,37,UCBPlayer
1239,UCBPlayer,86,281,367,8,47,UCBPlayer
1240,UCBPlayer,73,293,366,4,46,UCBPlayer
1241,UCBPlayer,66,306,372,4,44,UCBPlayer
1242,UCBPlayer,62,267,329,0,57,UCBPlayer
1243,UCBPlayer,58,298,356,0,48,UCBPlayer
1244,UCBPlayer,59,279,338,0,54,UCBPlayer
1245,UCBPlayer,68,293,361,2,47,UCBPlayer
1246,UCBPlayer,53,313,366,1,45,UCBPlayer
1247,UCBPlayer,69,319,388,5,39,UCBPlayer
1248,UCBPlayer,56,291,347,0,51,UCBPlayer
1249,UCBPlayer,50,325,375,1,42,UCBPlayer
1250,UCBPlayer,62,282,344,0,52,UCBPlayer
1251,UCBPlayer,98,253,351,7,52,UCBPlayer
1252,UCBPlayer,54,319,373,2,43,UCBPlayer
1253,UCBPlayer,99,259,358,5,49,UCBPlayer
1254,UCBPlayer,59,304,363,1,46,UCBPlayer
1255,UCBPlayer,69,299,368,3,45,UCBPlayer
1256,UCBPlayer,71,276,347,3,52,UCBPlayer
1257,UCBPlayer,54,299,353,0,49,UCBPlayer
1258,UCBPlayer,80,270,350,3,51,UCBPlayer
1259,UCBPlayer,58,313,371,3,44,UCBPlayer
1260,UCBPlayer,73,263,336,1,55,UCBPlayer
1261,UCBPlayer,53,303,356,0,48,UCBPlayer
1262,UCBPlayer,76,251,327,1,58,UCBPlayer
1263,UCBPlayer,91,276,367,5,46,UCBPlayer
1264,UCBPlayer,46,331,377,0,41,UCBPlayer
1265,UCBPlayer,44,339,383,0,39,UCBPlayer
1266,UCBPlayer,70,275,345,4,53,UCBPlayer
1267,UCBPlayer,68,298,366,4,46,UCBPlayer
1268,UCBPlayer,80,285,365,6,47,UCBPlayer
1269,UCBPlayer,61,331,392,3,37,UCBPlayer
1270,UCBPlayer,54,299,353,0,49,UCBPlayer
1271,UCBPlayer,55,295,350,0,50,UCBPlayer
1272,UCBPlayer,57,287,344,0,52,UCBPlayer
1273,UCBPlayer,53,303,356,0,48,UCBPlayer
1274,UCBPlayer,43,328,371,0,43,UCBPlayer
1275,UCBPlayer,59,314,373,2,43,UCBPlayer
1276,UCBPlayer,61,271,332,0,56,UCBPlayer
1277,UCBPlayer,81,301,382,8,42,UCBPlayer
1278,UCBPlayer,56,291,347,0,51,UCBPlayer
1279,UCBPlayer,60,275,335,0,55,UCBPlayer
1280,UCBPlayer,88,258,346,5,53,UCBPlayer
1281,UCBPlayer,62,302,364,2,46,UCBPlayer
1282,UCBPlayer,57,322,379,2,41,UCBPlayer
1283,UCBPlayer,60,315,375,1,42,UCBPlayer
1284,UCBPlayer,47,327,374,0,42,UCBPlayer
1285,UCBPlayer,65,280,345,1,52,UCBPlayer
1286,UCBPlayer,73,298,371,6,45,UCBPlayer
1287,UCBPlayer,65,280,345,1,52,UCBPlayer
1288,UCBPlayer,52,307,359,0,47,UCBPlayer
1289,UCBPlayer,43,343,386,0,38,UCBPlayer
1290,UCBPlayer,54,299,353,0,49,UCBPlayer
1291,UCBPlayer,75,265,340,2,54,UCBPlayer
1292,UCBPlayer,59,304,363,1,46,UCBPlayer
1293,UCBPlayer,63,288,351,1,50,UCBPlayer
1294,UCBPlayer,53,303,356,0,48,UCBPlayer
1295,UCBPlayer,103,283,386,9,41,UCBPlayer
1296,UCBPlayer,47,327,374,0,42,UCBPlayer
1297,UCBPlayer,126,256,382,11,43,UCBPlayer
1298,UCBPlayer,76,261,337,2,55,UCBPlayer
1299,UCBPlayer,189,249,438,25,29,UCBPlayer
1300,UCBPlayer,139,249,388,14,42,UCBPlayer
1301,UCBPlayer,48,323,371,0,43,UCBPlayer
1302,UCBPlayer,63,263,326,0,58,UCBPlayer
1303,UCBPlayer,53,303,356,0,48,UCBPlayer
1304,UCBPlayer,56,291,347,0,51,UCBPlayer
1305,UCBPlayer,88,278,366,7,47,UCBPlayer
1306,UCBPlayer,61,321,382,2,40,UCBPlayer
1307,UCBPlayer,74,324,398,6,36,UCBPlayer
1308,UCBPlayer,52,307,359,0,47,UCBPlayer
1309,UCBPlayer,57,287,344,0,52,UCBPlayer
1310,UCBPlayer,57,307,364,2,46,UCBPlayer
1311,UCBPlayer,56,306,362,0,46,UCBPlayer
1312,UCBPlayer,74,284,358,5,49,UCBPlayer
1313,UCBPlayer,55,305,360,1,47,UCBPlayer
1314,UCBPlayer,62,302,364,2,46,UCBPlayer
1315,UCBPlayer,61,286,347,0,51,UCBPlayer
1316,UCBPlayer,58,303,361,2,47,UCBPlayer
1317,UCBPlayer,78,283,361,5,48,UCBPlayer
1318,UCBPlayer,66,296,362,3,47,UCBPlayer
1319,UCBPlayer,79,274,353,3,50,UCBPlayer
1320,UCBPlayer,65,305,370,2,44,UCBPlayer
1321,UCBPlayer,56,301,357,1,48,UCBPlayer
1322,UCBPlayer,55,310,365,0,45,UCBPlayer
1323,UCBPlayer,78,253,331,2,57,UCBPlayer
1324,UCBPlayer,54,299,353,0,49,UCBPlayer
1325,UCBPlayer,44,324,368,0,44,UCBPlayer
1326,UCBPlayer,55,295,350,0,50,UCBPlayer
1327,UCBPlayer,73,318,391,8,39,UCBPlayer
1328,UCBPlayer,61,306,367,2,45,UCBPlayer
1329,UCBPlayer,67,282,349,2,51,UCBPlayer
1330,UCBPlayer,58,308,366,1,45,UCBPlayer
1331,UCBPlayer,48,323,371,0,43,UCBPlayer
1332,UCBPlayer,50,315,365,0,45,UCBPlayer
1333,UCBPlayer,57,312,369,1,44,UCBPlayer
1334,UCBPlayer,79,269,348,4,52,UCBPlayer
1335,UCBPlayer,49,339,388,2,38,UCBPlayer
1336,UCBPlayer,55,320,375,1,42,UCBPlayer
1337,UCBPlayer,63,288,351,1,50,UCBPlayer
1338,UCBPlayer,59,279,338,0,54,UCBPlayer
1339,UCBPlayer,58,308,366,1,45,UCBPlayer
1340,UCBPlayer,60,275,335,0,55,UCBPlayer
1341,UCBPlayer,46,331,377,0,41,UCBPlayer
1342,UCBPlayer,51,311,362,0,46,UCBPlayer
1343,UCBPlayer,68,288,356,3,49,UCBPlayer
1344,UCBPlayer,56,291,347,0,51,UCBPlayer
1345,UCBPlayer,56,291,347,0,51,UCBPlayer
1346,UCBPlayer,69,289,358,2,48,UCBPlayer
1347,UCBPlayer,52,317,369,1,44,UCBPlayer
1348,UCBPlayer,62,302,364,2,46,UCBPlayer
1349,UCBPlayer,79,294,373,5,44,UCBPlayer
1350,UCBPlayer,49,319,368,0,44,UCBPlayer
1351,UCBPlayer,67,272,339,1,54,UCBPlayer
1352,UCBPlayer,69,289,358,2,48,UCBPlayer
1353,UCBPlayer,62,267,329,0,57,UCBPlayer
1354,UCBPlayer,68,258,326,0,58,UCBPlayer
1355,UCBPlayer,101,261,362,9,49,UCBPlayer
1356,UCBPlayer,62,292,354,1,49,UCBPlayer
1357,UCBPlayer,56,291,347,0,51,UCBPlayer
1358,UCBPlayer,67,282,349,2,51,UCBPlayer
1359,UCBPlayer,64,304,368,3,45,UCBPlayer
1360,UCBPlayer,81,271,352,5,51,UCBPlayer
1361,UCBPlayer,42,347,389,0,37,UCBPlayer
1362,UCBPlayer,62,267,329,0,57,UCBPlayer
1363,UCBPlayer,69,289,358,2,48,UCBPlayer
1364,UCBPlayer,68,298,366,1,45,UCBPlayer
1365,UCBPlayer,58,283,341,0,53,UCBPlayer
1366,UCBPlayer,66,276,342,1,53,UCBPlayer
1367,UCBPlayer,58,283,341,0,53,UCBPlayer
1368,UCBPlayer,49,319,368,0,44,UCBPlayer
1369,UCBPlayer,53,303,356,0,48,UCBPlayer
1370,UCBPlayer,90,245,335,3,56,UCBPlayer
1371,UCBPlayer,81,286,367,5,46,UCBPlayer
1372,UCBPlayer,51,326,377,0,41,UCBPlayer
1373,UCBPlayer,44,349,393,1,36,UCBPlayer
1374,UCBPlayer,64,284,348,1,51,UCBPlayer
1375,UCBPlayer,53,303,356,0,48,UCBPlayer
1376,UCBPlayer,37,352,389,0,37,UCBPlayer
1377,UCBPlayer,61,296,357,1,48,UCBPlayer
1378,UCBPlayer,53,303,356,0,48,UCBPlayer
1379,UCBPlayer,78,273,351,4,51,UCBPlayer
1380,UCBPlayer,63,278,341,0,53,UCBPlayer
1381,UCBPlayer,58,318,376,2,42,UCBPlayer
1382,UCBPlayer,83,278,361,5,48,UCBPlayer
1383,UCBPlayer,59,279,338,0,54,UCBPlayer
1384,UCBPlayer,46,341,387,1,38,UCBPlayer
1385,UCBPlayer,54,314,368,0,44,UCBPlayer
1386,UCBPlayer,68,278,346,2,52,UCBPlayer
1387,UCBPlayer,58,318,376,2,42,UCBPlayer
1388,UCBPlayer,45,335,380,0,40,UCBPlayer
1389,UCBPlayer,65,320,385,5,40,UCBPlayer
1390,UCBPlayer,64,284,348,1,51,UCBPlayer
1391,UCBPlayer,55,320,375,1,42,UCBPlayer
1392,UCBPlayer,54,299,353,0,49,UCBPlayer
1393,UCBPlayer,70,295,365,3,46,UCBPlayer
1394,UCBPlayer,77,292,369,7,46,UCBPlayer
1395,UCBPlayer,64,299,363,1,46,UCBPlayer
1396,UCBPlayer,92,307,399,7,36,UCBPlayer
1397,UCBPlayer,61,271,332,0,56,UCBPlayer
1398,UCBPlayer,56,301,357,1,48,UCBPlayer
1399,UCBPlayer,50,315,365,0,45,UCBPlayer
1400,UCBPlayer,56,291,347,0,51,UCBPlayer
1401,UCBPlayer,50,315,365,0,45,UCBPlayer
1402,UCBPlayer,73,283,356,3,49,UCBPlayer
1403,UCBPlayer,180,230,410,24,38,UCBPlayer
1404,UCBPlayer,127,252,379,8,43,UCBPlayer
1405,UCBPlayer,65,300,365,3,46,UCBPlayer
1406,UCBPlayer,82,252,334,2,56,UCBPlayer
1407,UCBPlayer,95,280,375,7,44,UCBPlayer
1408,UCBPlayer,59,279,338,0,54,UCBPlayer
1409,UCBPlayer,87,242,329,3,58,UCBPlayer
1410,UCBPlayer,71,276,347,3,52,UCBPlayer
1411,UCBPlayer,51,321,372,1,43,UCBPlayer
1412,UCBPlayer,63,288,351,1,50,UCBPlayer
1413,UCBPlayer,61,331,392,3,37,UCBPlayer
1414,UCBPlayer,52,317,369,1,44,UCBPlayer
1415,UCBPlayer,53,318,371,0,43,UCBPlayer
1416,UCBPlayer,67,272,339,1,54,UCBPlayer
1417,UCBPlayer,55,305,360,1,47,UCBPlayer
1418,UCBPlayer,75,290,365,3,46,UCBPlayer
1419,UCBPlayer,59,289,348,1,51,UCBPlayer
1420,UCBPlayer,82,272,354,4,50,UCBPlayer
1421,UCBPlayer,71,296,367,5,46,UCBPlayer
1422,UCBPlayer,89,269,358,5,49,UCBPlayer
1423,UCBPlayer,53,313,366,1,45,UCBPlayer
1424,UCBPlayer,58,303,361,2,47,UCBPlayer
1425,UCBPlayer,63,293,356,0,48,UCBPlayer
1426,UCBPlayer,46,326,372,1,43,UCBPlayer
1427,UCBPlayer,68,308,376,2,42,UCBPlayer
1428,UCBPlayer,58,308,366,1,45,UCBPlayer
1429,UCBPlayer,46,331,377,0,41,UCBPlayer
1430,UCBPlayer,76,226,302,0,66,UCBPlayer
1431,UCBPlayer,94,289,383,9,42,UCBPlayer
1432,UCBPlayer,56,291,347,0,51,UCBPlayer
1433,UCBPlayer,92,272,364,5,47,UCBPlayer
1434,UCBPlayer,64,284,348,1,51,UCBPlayer
1435,UCBPlayer,51,311,362,0,46,UCBPlayer
1436,UCBPlayer,59,279,338,0,54,UCBPlayer
1437,UCBPlayer,46,346,392,0,36,UCBPlayer
1438,UCBPlayer,94,289,383,9,42,UCBPlayer
1439,UCBPlayer,63,288,351,1,50,UCBPlayer
1440,UCBPlayer,53,303,356,0,48,UCBPlayer
1441,UCBPlayer,196,241,437,24,29,UCBPlayer
1442,UCBPlayer,50,315,365,0,45,UCBPlayer
1443,UCBPlayer,40,355,395,0,35,UCBPlayer
1444,UCBPlayer,58,283,341,0,53,UCBPlayer
1445,UCBPlayer,57,287,344,0,52,UCBPlayer
1446,UCBPlayer,107,272,379,14,45,UCBPlayer
1447,UCBPlayer,191,231,422,27,35,UCBPlayer
1448,UCBPlayer,67,292,359,3,48,UCBPlayer
1449,UCBPlayer,96,301,397,11,38,UCBPlayer
1450,UCBPlayer,61,271,332,0,56,UCBPlayer
1451,UCBPlayer,47,327,374,0,42,UCBPlayer
1452,UCBPlayer,60,300,360,1,47,UCBPlayer
1453,UCBPlayer,63,263,326,0,58,UCBPlayer
1454,UCBPlayer,65,255,320,0,60,UCBPlayer
1455,UCBPlayer,50,315,365,0,45,UCBPlayer
1456,UCBPlayer,91,291,382,5,41,UCBPlayer
1457,UCBPlayer,55,295,350,0,50,UCBPlayer
1458,UCBPlayer,65,255,320,0,60,UCBPlayer
1459,UCBPlayer,56,291,347,0,51,UCBPlayer
1460,UCBPlayer,60,295,355,2,49,UCBPlayer
1461,UCBPlayer,57,322,379,2,41,UCBPlayer
1462,UCBPlayer,61,286,347,0,51,UCBPlayer
1463,UCBPlayer,66,286,352,2,50,UCBPlayer
1464,UCBPlayer,47,327,374,0,42,UCBPlayer
1465,UCBPlayer,57,297,354,1,49,UCBPlayer
1466,UCBPlayer,58,318,376,2,42,UCBPlayer
1467,UCBPlayer,59,314,373,2,43,UCBPlayer
1468,UCBPlayer,100,275,375,13,46,UCBPlayer
1469,UCBPlayer,75,295,370,2,44,UCBPlayer
1470,UCBPlayer,83,288,371,6,45,UCBPlayer
1471,UCBPlayer,70,255,325,2,59,UCBPlayer
1472,UCBPlayer,79,279,358,5,49,UCBPlayer
1473,UCBPlayer,46,326,372,1,43,UCBPlayer
1474,UCBPlayer,71,261,332,0,56,UCBPlayer
1475,UCBPlayer,51,311,362,0,46,UCBPlayer
1476,UCBPlayer,57,297,354,1,49,UCBPlayer
1477,UCBPlayer,67,302,369,4,45,UCBPlayer
1478,UCBPlayer,59,279,338,0,54,UCBPlayer
1479,UCBPlayer,255,175,430,29,33,Player A
1480,UCBPlayer,59,279,338,0,54,UCBPlayer
1481,UCBPlayer,49,319,368,0,44,UCBPlayer
1482,UCBPlayer,63,288,351,1,50,UCBPlayer
1483,UCBPlayer,49,319,368,0,44,UCBPlayer
1484,UCBPlayer,54,299,353,0,49,UCBPlayer
1485,UCBPlayer,52,307,359,0,47,UCBPlayer
1486,UCBPlayer,67,292,359,3,48,UCBPlayer
1487,UCBPlayer,69,274,343,2,53,UCBPlayer
1488,UCBPlayer,48,323,371,0,43,UCBPlayer
1489,UCBPlayer,89,289,378,7,43,UCBPlayer
1490,UCBPlayer,54,299,353,0,49,UCBPlayer
1491,UCBPlayer,58,283,341,0,53,UCBPlayer
1492,UCBPlayer,60,275,335,0,55,UCBPlayer
1493,UCBPlayer,55,295,350,0,50,UCBPlayer
1494,UCBPlayer,79,269,348,4,52,UCBPlayer
1495,UCBPlayer,78,283,361,5,48,UCBPlayer
1496,UCBPlayer,48,323,371,0,43,UCBPlayer
1497,UCBPlayer,44,339,383,0,39,UCBPlayer
1498,UCBPlayer,54,299,353,0,49,UCBPlayer
1499,UCBPlayer,71,266,337,2,55,UCBPlayer
1500,UCBPlayer,64,284,348,1,51,UCBPlayer
1501,UCBPlayer,55,295,350,0,50,UCBPlayer
1502,UCBPlayer,56,301,357,1,48,UCBPlayer
1503,UCBPlayer,86,271,357,4,49,UCBPlayer
1504,UCBPlayer,58,283,341,0,53,UCBPlayer
1505,UCBPlayer,50,315,365,0,45,UCBPlayer
1506,UCBPlayer,69,274,343,2,53,UCBPlayer
1507,UCBPlayer,51,311,362,0,46,UCBPlayer
1508,UCBPlayer,62,327,389,3,38,UCBPlayer
1509,UCBPlayer,54,309,363,1,46,UCBPlayer
1510,UCBPlayer,67,272,339,1,54,UCBPlayer
1511,UCBPlayer,69,289,358,2,48,UCBPlayer
1512,UCBPlayer,59,314,373,2,43,UCBPlayer
1513,UCBPlayer,53,303,356,0,48,UCBPlayer
1514,UCBPlayer,53,313,366,1,45,UCBPlayer
1515,UCBPlayer,136,271,407,18,37,UCBPlayer
1516,UCBPlayer,85,290,375,4,43,UCBPlayer
1517,UCBPlayer,58,283,341,0,53,UCBPlayer
1518,UCBPlayer,87,272,359,6,49,UCBPlayer
1519,UCBPlayer,81,261,342,4,54,UCBPlayer
1520,UCBPlayer,86,256,342,4,54,UCBPlayer
1521,UCBPlayer,62,282,344,0,52,UCBPlayer
1522,UCBPlayer,58,283,341,0,53,UCBPlayer
1523,UCBPlayer,62,287,349,2,51,UCBPlayer
1524,UCBPlayer,71,301,372,4,44,UCBPlayer
1525,UCBPlayer,67,297,364,5,47,UCBPlayer
1526,UCBPlayer,214,224,438,22,28,UCBPlayer
1527,UCBPlayer,80,270,350,3,51,UCBPlayer
1528,UCBPlayer,52,307,359,0,47,UCBPlayer
1529,UCBPlayer,54,284,338,0,54,UCBPlayer
1530,UCBPlayer,76,261,337,2,55,UCBPlayer
1531,UCBPlayer,52,307,359,0,47,UCBPlayer
1532,UCBPlayer,50,315,365,0,45,UCBPlayer
1533,UCBPlayer,48,333,381,1,40,UCBPlayer
1534,UCBPlayer,66,306,372,4,44,UCBPlayer
1535,UCBPlayer,51,311,362,0,46,UCBPlayer
1536,UCBPlayer,57,322,379,2,41,UCBPlayer
1537,UCBPlayer,56,291,347,0,51,UCBPlayer
1538,UCBPlayer,57,312,369,1,44,UCBPlayer
1539,UCBPlayer,74,274,348,4,52,UCBPlayer
1540,UCBPlayer,61,296,357,1,48,UCBPlayer
1541,UCBPlayer,66,296,362,3,47,UCBPlayer
1542,UCBPlayer,50,315,365,0,45,UCBPlayer
1543,UCBPlayer,48,323,371,0,43,UCBPlayer
1544,UCBPlayer,61,296,357,1,48,UCBPlayer
1545,UCBPlayer,49,319,368,0,44,UCBPlayer
1546,UCBPlayer,70,280,350,3,51,UCBPlayer
1547,UCBPlayer,64,274,338,0,54,UCBPlayer
1548,UCBPlayer,57,287,344,0,52,UCBPlayer
1549,UCBPlayer,53,303,356,0,48,UCBPlayer
1550,UCBPlayer,67,262,329,0,57,UCBPlayer
1551,UCBPlayer,53,303,356,0,48,UCBPlayer
1552,UCBPlayer,54,299,353,0,49,UCBPlayer
1553,UCBPlayer,73,288,361,2,47,UCBPlayer
1554,UCBPlayer,63,323,386,3,39,UCBPlayer
1555,UCBPlayer,52,327,379,2,41,UCBPlayer
1556,UCBPlayer,62,282,344,0,52,UCBPlayer
1557,UCBPlayer,54,314,368,0,44,UCBPlayer
1558,UCBPlayer,68,313,381,4,41,UCBPlayer
1559,UCBPlayer,55,295,350,0,50,UCBPlayer
1560,UCBPlayer,124,264,388,14,42,UCBPlayer
1561,UCBPlayer,40,355,395,0,35,UCBPlayer
1562,UCBPlayer,58,283,341,0,53,UCBPlayer
1563,UCBPlayer,45,335,380,0,40,UCBPlayer
1564,UCBPlayer,63,283,346,2,52,UCBPlayer
1565,UCBPlayer,74,309,383,6,41,UCBPlayer
1566,UCBPlayer,84,269,353,6,51,UCBPlayer
1567,UCBPlayer,62,292,354,1,49,UCBPlayer
1568,UCBPlayer,53,303,356,0,48,UCBPlayer
1569,UCBPlayer,51,311,362,0,46,UCBPlayer
1570,UCBPlayer,57,317,374,3,43,UCBPlayer
1571,UCBPlayer,96,241,337,5,56,UCBPlayer
1572,UCBPlayer,88,318,406,8,34,UCBPlayer
1573,UCBPlayer,46,331,377,0,41,UCBPlayer
1574,UCBPlayer,55,295,350,0,50,UCBPlayer
1575,UCBPlayer,54,319,373,2,43,UCBPlayer
1576,UCBPlayer,69,289,358,2,48,UCBPlayer
1577,UCBPlayer,50,315,365,0,45,UCBPlayer
1578,UCBPlayer,52,302,354,1,49,UCBPlayer
1579,UCBPlayer,72,317,389,6,39,UCBPlayer
1580,UCBPlayer,49,344,393,1,36,UCBPlayer
1581,UCBPlayer,56,291,347,0,51,UCBPlayer
1582,UCBPlayer,66,276,342,1,53,UCBPlayer
1583,UCBPlayer,81,301,382,8,42,UCBPlayer
1584,UCBPlayer,104,269,373,11,46,UCBPlayer
1585,UCBPlayer,52,307,359,0,47,UCBPlayer
1586,UCBPlayer,56,291,347,0,51,UCBPlayer
1587,UCBPlayer,67,282,349,2,51,UCBPlayer
1588,UCBPlayer,53,303,356,0,48,UCBPlayer
1589,UCBPlayer,52,307,359,0,47,UCBPlayer
1590,UCBPlayer,71,256,327,1,58,UCBPlayer
1591,UCBPlayer,105,270,375,10,45,UCBPlayer
1592,UCBPlayer,52,307,359,0,47,UCBPlayer
1593,UCBPlayer,55,295,350,0,50,UCBPlayer
1594,UCBPlayer,69,289,358,2,48,UCBPlayer
1595,UCBPlayer,78,283,361,5,48,UCBPlayer
1596,UCBPlayer,55,320,375,1,42,UCBPlayer
1597,UCBPlayer,65,290,355,2,49,UCBPlayer
1598,UCBPlayer,65,290,355,2,49,UCBPlayer
1599,UCBPlayer,70,300,370,5,45,UCBPlayer
1600,UCBPlayer,80,265,345,4,53,UCBPlayer
1601,UCBPlayer,51,311,362,0,46,UCBPlayer
1602,UCBPlayer,52,307,359,0,47,UCBPlayer
1603,UCBPlayer,62,317,379,2,41,UCBPlayer
1604,UCBPlayer,59,279,338,0,54,UCBPlayer
1605,UCBPlayer,49,329,378,1,41,UCBPlayer
1606,UCBPlayer,52,322,374,0,42,UCBPlayer
1607,UCBPlayer,61,321,382,5,41,UCBPlayer
1608,UCBPlayer,78,283,361,5,48,UCBPlayer
1609,UCBPlayer,69,274,343,2,53,UCBPlayer
1610,UCBPlayer,48,323,371,0,43,UCBPlayer
1611,UCBPlayer,51,311,362,0,46,UCBPlayer
1612,UCBPlayer,51,321,372,1,43,UCBPlayer
1613,UCBPlayer,80,245,325,2,59,UCBPlayer
1614,UCBPlayer,53,303,356,0,48,UCBPlayer
1615,UCBPlayer,50,315,365,0,45,UCBPlayer
1616,UCBPlayer,54,299,353,0,49,UCBPlayer
1617,UCBPlayer,52,307,359,0,47,UCBPlayer
1618,UCBPlayer,61,271,332,0,56,UCBPlayer
1619,UCBPlayer,71,276,347,3,52,UCBPlayer
1620,UCBPlayer,100,315,415,14,33,UCBPlayer
1621,UCBPlayer,58,298,356,0,48,UCBPlayer
1622,UCBPlayer,52,307,359,0,47,UCBPlayer
1623,UCBPlayer,90,260,350,6,52,UCBPlayer
1624,UCBPlayer,85,260,345,4,53,UCBPlayer
1625,UCBPlayer,49,319,368,0,44,UCBPlayer
1626,UCBPlayer,61,321,382,2,40,UCBPlayer
1627,UCBPlayer,46,331,377,0,41,UCBPlayer
1628,UCBPlayer,55,290,345,1,52,UCBPlayer
1629,UCBPlayer,64,314,378,4,42,UCBPlayer
1630,UCBPlayer,71,281,352,2,50,UCBPlayer
1631,UCBPlayer,55,280,335,0,55,UCBPlayer
1632,UCBPlayer,57,287,344,0,52,UCBPlayer
1633,UCBPlayer,63,288,351,1,50,UCBPlayer
1634,UCBPlayer,51,311,362,0,46,UCBPlayer
1635,UCBPlayer,57,287,344,0,52,UCBPlayer
1636,UCBPlayer,48,323,371,0,43,UCBPlayer
1637,UCBPlayer,75,280,355,2,49,UCBPlayer
1638,UCBPlayer,50,325,375,1,42,UCBPlayer
1639,UCBPlayer,69,264,333,1,56,UCBPlayer
1640,UCBPlayer,68,278,346,2,52,UCBPlayer
1641,UCBPlayer,67,292,359,3,48,UCBPlayer
1642,UCBPlayer,85,260,345,4,53,UCBPlayer
1643,UCBPlayer,52,307,359,0,47,UCBPlayer
1644,UCBPlayer,51,311,362,0,46,UCBPlayer
1645,UCBPlayer,76,271,347,3,52,UCBPlayer
1646,UCBPlayer,55,295,350,0,50,UCBPlayer
1647,UCBPlayer,54,299,353,0,49,UCBPlayer
1648,UCBPlayer,70,305,375,4,43,UCBPlayer
1649,UCBPlayer,74,294,368,6,46,UCBPlayer
1650,UCBPlayer,64,284,348,1,51,UCBPlayer
1651,UCBPlayer,99,274,373,8,45,UCBPlayer
1652,UCBPlayer,54,299,353,0,49,UCBPlayer
1653,UCBPlayer,65,255,320,0,60,UCBPlayer
1654,UCBPlayer,77,267,344,3,53,UCBPlayer
1655,UCBPlayer,66,301,367,2,45,UCBPlayer
1656,UCBPlayer,59,304,363,1,46,UCBPlayer
1657,UCBPlayer,60,275,335,0,55,UCBPlayer
1658,UCBPlayer,42,347,389,0,37,UCBPlayer
1659,UCBPlayer,51,311,362,0,46,UCBPlayer
1660,UCBPlayer,83,258,341,3,54,UCBPlayer
1661,UCBPlayer,58,283,341,0,53,UCBPlayer
1662,UCBPlayer,51,331,382,2,40,UCBPlayer
1663,UCBPlayer,71,271,342,1,53,UCBPlayer
1664,UCBPlayer,80,255,335,3,56,UCBPlayer
1665,UCBPlayer,44,349,393,1,36,UCBPlayer
1666,UCBPlayer,50,315,365,0,45,UCBPlayer
1667,UCBPlayer,51,311,362,0,46,UCBPlayer
1668,UCBPlayer,64,304,368,3,45,UCBPlayer
1669,UCBPlayer,71,286,357,4,49,UCBPlayer
1670,UCBPlayer,56,326,382,2,40,UCBPlayer
1671,UCBPlayer,70,280,350,3,51,UCBPlayer
1672,UCBPlayer,114,244,358,8,50,UCBPlayer
1673,UCBPlayer,120,270,390,10,40,UCBPlayer
1674,UCBPlayer,63,308,371,6,45,UCBPlayer
1675,UCBPlayer,101,276,377,9,44,UCBPlayer
1676,UCBPlayer,64,299,363,1,46,UCBPlayer
1677,UCBPlayer,44,339,383,0,39,UCBPlayer
1678,UCBPlayer,48,323,371,0,43,UCBPlayer
1679,UCBPlayer,54,309,363,1,46,UCBPlayer
1680,UCBPlayer,66,301,367,5,46,UCBPlayer
1681,UCBPlayer,131,286,417,13,32,UCBPlayer
1682,UCBPlayer,49,304,353,0,49,UCBPlayer
1683,UCBPlayer,61,271,332,0,56,UCBPlayer
1684,UCBPlayer,50,315,365,0,45,UCBPlayer
1685,UCBPlayer,55,295,350,0,50,UCBPlayer
1686,UCBPlayer,56,291,347,0,51,UCBPlayer
1687,UCBPlayer,54,299,353,0,49,UCBPlayer
1688,UCBPlayer,61,306,367,2,45,UCBPlayer
1689,UCBPlayer,75,230,305,0,65,UCBPlayer
1690,UCBPlayer,71,246,317,0,61,UCBPlayer
1691,UCBPlayer,94,244,338,6,56,UCBPlayer
1692,UCBPlayer,56,291,347,0,51,UCBPlayer
1693,UCBPlayer,58,308,366,1,45,UCBPlayer
1694,UCBPlayer,92,282,374,9,45,UCBPlayer
1695,UCBPlayer,61,306,367,2,45,UCBPlayer
1696,UCBPlayer,68,258,326,0,58,UCBPlayer
1697,UCBPlayer,65,290,355,2,49,UCBPlayer
1698,UCBPlayer,68,278,346,2,52,UCBPlayer
1699,UCBPlayer,55,320,375,1,42,UCBPlayer
1700,UCBPlayer,66,266,332,0,56,UCBPlayer
1701,UCBPlayer,55,295,350,0,50,UCBPlayer
1702,UCBPlayer,103,258,361,5,48,UCBPlayer
1703,UCBPlayer,56,291,347,0,51,UCBPlayer
1704,UCBPlayer,75,290,365,6,47,UCBPlayer
1705,UCBPlayer,54,299,353,0,49,UCBPlayer
1706,UCBPlayer,51,311,362,0,46,UCBPlayer
1707,UCBPlayer,57,287,344,0,52,UCBPlayer
1708,UCBPlayer,48,333,381,1,40,UCBPlayer
1709,UCBPlayer,48,323,371,0,43,UCBPlayer
1710,UCBPlayer,54,299,353,0,49,UCBPlayer
1711,UCBPlayer,52,307,359,0,47,UCBPlayer
1712,UCBPlayer,68,268,336,1,55,UCBPlayer
1713,UCBPlayer,61,271,332,0,56,UCBPlayer
1714,UCBPlayer,92,287,379,8,43,UCBPlayer
1715,UCBPlayer,63,263,326,0,58,UCBPlayer
1716,UCBPlayer,59,289,348,1,51,UCBPlayer
1717,UCBPlayer,65,280,345,1,52,UCBPlayer
1718,UCBPlayer,53,303,356,0,48,UCBPlayer
1719,UCBPlayer,55,295,350,0,50,UCBPlayer
1720,UCBPlayer,73,283,356,3,49,UCBPlayer
1721,UCBPlayer,55,295,350,0,50,UCBPlayer
1722,UCBPlayer,56,331,387,4,39,UCBPlayer
1723,UCBPlayer,65,290,355,2,49,UCBPlayer
1724,UCBPlayer,59,299,358,2,48,UCBPlayer
1725,UCBPlayer,62,292,354,1,49,UCBPlayer
1726,UCBPlayer,50,345,395,3,36,UCBPlayer
1727,UCBPlayer,67,277,344,0,52,UCBPlayer
1728,UCBPlayer,53,318,371,3,44,UCBPlayer
1729,UCBPlayer,66,281,347,0,51,UCBPlayer
1730,UCBPlayer,53,323,376,2,42,UCBPlayer
1731,UCBPlayer,61,286,347,0,51,UCBPlayer
1732,UCBPlayer,53,298,351,1,50,UCBPlayer
1733,UCBPlayer,143,248,391,17,42,UCBPlayer
1734,UCBPlayer,76,281,357,4,49,UCBPlayer
1735,UCBPlayer,50,315,365,0,45,UCBPlayer
1736,UCBPlayer,49,319,368,0,44,UCBPlayer
1737,UCBPlayer,59,324,383,3,40,UCBPlayer
1738,UCBPlayer,79,249,328,2,58,UCBPlayer
1739,UCBPlayer,56,291,347,0,51,UCBPlayer
1740,UCBPlayer,68,268,336,1,55,UCBPlayer
1741,UCBPlayer,101,301,402,10,36,UCBPlayer
1742,UCBPlayer,138,273,411,16,35,UCBPlayer
1743,UCBPlayer,54,299,353,0,49,UCBPlayer
1744,UCBPlayer,56,291,347,0,51,UCBPlayer
1745,UCBPlayer,86,281,367,8,47,UCBPlayer
1746,UCBPlayer,51,311,362,0,46,UCBPlayer
1747,UCBPlayer,63,298,361,2,47,UCBPlayer
1748,UCBPlayer,110,255,365,6,47,UCBPlayer
1749,UCBPlayer,52,307,359,0,47,UCBPlayer
1750,UCBPlayer,76,281,357,4,49,UCBPlayer
1751,UCBPlayer,65,310,375,4,43,UCBPlayer
1752,UCBPlayer,67,312,379,5,42,UCBPlayer
1753,UCBPlayer,62,292,354,1,49,UCBPlayer
1754,UCBPlayer,53,303,356,0,48,UCBPlayer
1755,UCBPlayer,117,242,359,12,51,UCBPlayer
1756,UCBPlayer,49,319,368,0,44,UCBPlayer
1757,UCBPlayer,56,291,347,0,51,UCBPlayer
1758,UCBPlayer,77,277,354,4,50,UCBPlayer
1759,UCBPlayer,78,293,371,6,45,UCBPlayer
1760,UCBPlayer,56,316,372,1,43,UCBPlayer
1761,UCBPlayer,60,320,380,3,41,UCBPlayer
1762,UCBPlayer,48,323,371,0,43,UCBPlayer
1763,UCBPlayer,53,313,366,1,45,UCBPlayer
1764,UCBPlayer,61,286,347,0,51,UCBPlayer
1765,UCBPlayer,64,294,358,2,48,UCBPlayer
1766,UCBPlayer,54,299,353,0,49,UCBPlayer
1767,UCBPlayer,47,327,374,0,42,UCBPlayer
1768,UCBPlayer,46,331,377,0,41,UCBPlayer
1769,UCBPlayer,56,321,377,3,42,UCBPlayer
1770,UCBPlayer,65,290,355,2,49,UCBPlayer
1771,UCBPlayer,52,322,374,0,42,UCBPlayer
1772,UCBPlayer,58,283,341,0,53,UCBPlayer
1773,UCBPlayer,67,282,349,2,51,UCBPlayer
1774,UCBPlayer,49,319,368,0,44,UCBPlayer
1775,UCBPlayer,54,299,353,0,49,UCBPlayer
1776,UCBPlayer,57,287,344,0,52,UCBPlayer
1777,UCBPlayer,71,306,377,9,44,UCBPlayer
1778,UCBPlayer,71,306,377,3,42,UCBPlayer
1779,UCBPlayer,70,270,340,2,54,UCBPlayer
1780,UCBPlayer,58,308,366,1,45,UCBPlayer
1781,UCBPlayer,56,316,372,1,43,UCBPlayer
1782,UCBPlayer,65,290,355,2,49,UCBPlayer
1783,UCBPlayer,62,277,339,1,54,UCBPlayer
1784,UCBPlayer,54,314,368,0,44,UCBPlayer
1785,UCBPlayer,62,322,384,4,40,UCBPlayer
1786,UCBPlayer,73,293,366,4,46,UCBPlayer
1787,UCBPlayer,55,295,350,0,50,UCBPlayer
1788,UCBPlayer,57,287,344,0,52,UCBPlayer
1789,UCBPlayer,72,252,324,1,59,UCBPlayer
1790,UCBPlayer,47,327,374,0,42,UCBPlayer
1791,UCBPlayer,51,311,362,0,46,UCBPlayer
1792,UCBPlayer,64,259,323,0,59,UCBPlayer
1793,UCBPlayer,70,305,375,4,43,UCBPlayer
1794,UCBPlayer,57,312,369,1,44,UCBPlayer
1795,UCBPlayer,58,283,341,0,53,UCBPlayer
1796,UCBPlayer,58,308,366,1,45,UCBPlayer
1797,UCBPlayer,70,250,320,0,60,UCBPlayer
1798,UCBPlayer,63,288,351,1,50,UCBPlayer
1799,UCBPlayer,50,315,365,0,45,UCBPlayer
1800,UCBPlayer,65,300,365,3,46,UCBPlayer
1801,UCBPlayer,88,278,366,7,47,UCBPlayer
1802,UCBPlayer,49,319,368,0,44,UCBPlayer
1803,UCBPlayer,57,287,344,0,52,UCBPlayer
1804,UCBPlayer,71,266,337,2,55,UCBPlayer
1805,UCBPlayer,61,296,357,1,48,UCBPlayer
1806,UCBPlayer,55,295,350,0,50,UCBPlayer
1807,UCBPlayer,60,275,335,0,55,UCBPlayer
1808,UCBPlayer,72,277,349,2,51,UCBPlayer
1809,UCBPlayer,95,285,380,9,43,UCBPlayer
1810,UCBPlayer,59,279,338,0,54,UCBPlayer
1811,UCBPlayer,71,316,387,4,39,UCBPlayer
1812,UCBPlayer,151,241,392,15,41,UCBPlayer
1813,UCBPlayer,52,307,359,0,47,UCBPlayer
1814,UCBPlayer,56,301,357,1,48,UCBPlayer
1815,UCBPlayer,59,294,353,0,49,UCBPlayer
1816,UCBPlayer,92,247,339,4,55,UCBPlayer
1817,UCBPlayer,62,267,329,0,57,UCBPlayer
1818,UCBPlayer,76,306,382,8,42,UCBPlayer
1819,UCBPlayer,71,271,342,1,53,UCBPlayer
1820,UCBPlayer,89,274,363,7,48,UCBPlayer
1821,UCBPlayer,48,348,396,1,35,UCBPlayer
1822,UCBPlayer,79,269,348,4,52,UCBPlayer
1823,UCBPlayer,49,319,368,0,44,UCBPlayer
1824,UCBPlayer,57,287,344,0,52,UCBPlayer
1825,UCBPlayer,60,290,350,0,50,UCBPlayer
1826,UCBPlayer,53,303,356,0,48,UCBPlayer
1827,UCBPlayer,56,291,347,0,51,UCBPlayer
1828,UCBPlayer,52,307,359,0,47,UCBPlayer
1829,UCBPlayer,57,287,344,0,52,UCBPlayer
1830,UCBPlayer,55,305,360,1,47,UCBPlayer
1831,UCBPlayer,81,261,342,4,54,UCBPlayer
1832,UCBPlayer,58,283,341,0,53,UCBPlayer
1833,UCBPlayer,43,343,386,0,38,UCBPlayer
1834,UCBPlayer,66,266,332,0,56,UCBPlayer
1835,UCBPlayer,50,300,350,0,50,UCBPlayer
1836,UCBPlayer,97,267,364,8,48,UCBPlayer
1837,UCBPlayer,65,300,365,3,46,UCBPlayer
1838,UCBPlayer,71,306,377,6,43,UCBPlayer
1839,UCBPlayer,58,283,341,0,53,UCBPlayer
1840,UCBPlayer,57,287,344,0,52,UCBPlayer
1841,UCBPlayer,53,303,356,0,48,UCBPlayer
1842,UCBPlayer,54,299,353,0,49,UCBPlayer
1843,UCBPlayer,78,273,351,4,51,UCBPlayer
1844,UCBPlayer,70,310,380,6,42,UCBPlayer
1845,UCBPlayer,66,296,362,3,47,UCBPlayer
1846,UCBPlayer,92,257,349,5,52,UCBPlayer
1847,UCBPlayer,62,292,354,1,49,UCBPlayer
1848,UCBPlayer,54,299,353,0,49,UCBPlayer
1849,UCBPlayer,148,238,386,18,44,UCBPlayer
1850,UCBPlayer,66,276,342,1,53,UCBPlayer
1851,UCBPlayer,56,291,347,0,51,UCBPlayer
1852,UCBPlayer,46,331,377,0,41,UCBPlayer
1853,UCBPlayer,57,287,344,0,52,UCBPlayer
1854,UCBPlayer,55,295,350,0,50,UCBPlayer
1855,UCBPlayer,53,313,366,1,45,UCBPlayer
1856,UCBPlayer,74,244,318,1,61,UCBPlayer
1857,UCBPlayer,58,298,356,0,48,UCBPlayer
1858,UCBPlayer,44,349,393,1,36,UCBPlayer
1859,UCBPlayer,67,292,359,3,48,UCBPlayer
1860,UCBPlayer,60,285,345,1,52,UCBPlayer
1861,UCBPlayer,74,279,353,3,50,UCBPlayer
1862,UCBPlayer,65,305,370,2,44,UCBPlayer
1863,UCBPlayer,53,303,356,0,48,UCBPlayer
1864,UCBPlayer,45,335,380,0,40,UCBPlayer
1865,UCBPlayer,56,291,347,0,51,UCBPlayer
1866,UCBPlayer,68,278,346,2,52,UCBPlayer
1867,UCBPlayer,101,276,377,9,44,UCBPlayer
1868,UCBPlayer,52,307,359,0,47,UCBPlayer
1869,UCBPlayer,58,283,341,0,53,UCBPlayer
1870,UCBPlayer,66,276,342,1,53,UCBPlayer
1871,UCBPlayer,58,283,341,0,53,UCBPlayer
1872,UCBPlayer,64,304,368,3,45,UCBPlayer
1873,UCBPlayer,51,311,362,0,46,UCBPlayer
1874,UCBPlayer,65,255,320,0,60,UCBPlayer
1875,UCBPlayer,68,303,371,3,44,UCBPlayer
1876,UCBPlayer,59,279,338,0,54,UCBPlayer
1877,UCBPlayer,55,295,350,0,50,UCBPlayer
1878,UCBPlayer,73,273,346,2,52,UCBPlayer
1879,UCBPlayer,55,295,350,0,50,UCBPlayer
1880,UCBPlayer,62,297,359,3,48,UCBPlayer
1881,UCBPlayer,92,247,339,4,55,UCBPlayer
1882,UCBPlayer,87,292,379,5,42,UCBPlayer
1883,UCBPlayer,66,266,332,0,56,UCBPlayer
1884,UCBPlayer,58,283,341,0,53,UCBPlayer
1885,UCBPlayer,44,334,378,1,41,UCBPlayer
1886,UCBPlayer,121,286,407,12,35,UCBPlayer
1887,UCBPlayer,82,287,369,4,45,UCBPlayer
1888,UCBPlayer,56,291,347,0,51,UCBPlayer
1889,UCBPlayer,163,268,431,24,31,UCBPlayer
1890,UCBPlayer,60,275,335,0,55,UCBPlayer
1891,UCBPlayer,78,263,341,3,54,UCBPlayer
1892,UCBPlayer,68,268,336,1,55,UCBPlayer
1893,UCBPlayer,56,291,347,0,51,UCBPlayer
1894,UCBPlayer,57,287,344,0,52,UCBPlayer
1895,UCBPlayer,59,314,373,2,43,UCBPlayer
1896,UCBPlayer,59,304,363,1,46,UCBPlayer
1897,UCBPlayer,69,264,333,1,56,UCBPlayer
1898,UCBPlayer,59,279,338,0,54,UCBPlayer
1899,UCBPlayer,68,313,381,7,42,UCBPlayer
1900,UCBPlayer,65,270,335,0,55,UCBPlayer
1901,UCBPlayer,75,255,330,1,57,UCBPlayer
1902,UCBPlayer,91,291,382,8,42,UCBPlayer
1903,UCBPlayer,105,240,345,7,54,UCBPlayer
1904,UCBPlayer,51,311,362,0,46,UCBPlayer
1905,UCBPlayer,53,313,366,1,45,UCBPlayer
1906,UCBPlayer,60,310,370,2,44,UCBPlayer
1907,UCBPlayer,116,276,392,12,40,UCBPlayer
1908,UCBPlayer,58,283,341,0,53,UCBPlayer
1909,UCBPlayer,78,298,376,5,43,UCBPlayer
1910,UCBPlayer,49,329,378,1,41,UCBPlayer
1911,UCBPlayer,79,284,363,4,47,UCBPlayer
1912,UCBPlayer,57,287,344,0,52,UCBPlayer
1913,UCBPlayer,49,319,368,0,44,UCBPlayer
1914,UCBPlayer,84,289,373,5,44,UCBPlayer
1915,UCBPlayer,57,287,344,0,52,UCBPlayer
1916,UCBPlayer,67,327,394,5,37,UCBPlayer
1917,UCBPlayer,73,273,346,2,52,UCBPlayer
1918,UCBPlayer,138,228,366,16,50,UCBPlayer
1919,UCBPlayer,46,331,377,0,41,UCBPlayer
1920,UCBPlayer,59,294,353,0,49,UCBPlayer
1921,UCBPlayer,57,287,344,0,52,UCBPlayer
1922,UCBPlayer,54,299,353,0,49,UCBPlayer
1923,UCBPlayer,51,321,372,1,43,UCBPlayer
1924,UCBPlayer,71,281,352,2,50,UCBPlayer
1925,UCBPlayer,120,270,390,13,41,UCBPlayer
1926,UCBPlayer,62,277,339,1,54,UCBPlayer
1927,UCBPlayer,63,278,341,0,53,UCBPlayer
1928,UCBPlayer,56,301,357,1,48,UCBPlayer
1929,UCBPlayer,64,274,338,0,54,UCBPlayer
1930,UCBPlayer,57,287,344,0,52,UCBPlayer
1931,UCBPlayer,67,272,339,1,54,UCBPlayer
1932,UCBPlayer,53,318,371,0,43,UCBPlayer
1933,UCBPlayer,58,313,371,3,44,UCBPlayer
1934,UCBPlayer,54,314,368,0,44,UCBPlayer
1935,UCBPlayer,64,274,338,0,54,UCBPlayer
1936,UCBPlayer,47,322,369,1,44,UCBPlayer
1937,UCBPlayer,161,246,407,18,37,UCBPlayer
1938,UCBPlayer,61,271,332,0,56,UCBPlayer
1939,UCBPlayer,70,305,375,4,43,UCBPlayer
1940,UCBPlayer,70,315,385,5,40,UCBPlayer
1941,UCBPlayer,70,280,350,3,51,UCBPlayer
1942,UCBPlayer,55,320,375,1,42,UCBPlayer
1943,UCBPlayer,66,301,367,2,45,UCBPlayer
1944,UCBPlayer,83,278,361,5,48,UCBPlayer
1945,UCBPlayer,51,311,362,0,46,UCBPlayer
1946,UCBPlayer,48,323,371,0,43,UCBPlayer
1947,UCBPlayer,88,263,351,4,51,UCBPlayer
1948,UCBPlayer,72,277,349,2,51,UCBPlayer
1949,UCBPlayer,56,291,347,0,51,UCBPlayer
1950,UCBPlayer,225,210,435,28,31,Player A
1951,UCBPlayer,55,295,350,0,50,UCBPlayer
1952,UCBPlayer,63,263,326,0,58,UCBPlayer
1953,UCBPlayer,181,261,442,26,28,UCBPlayer
1954,UCBPlayer,43,343,386,0,38,UCBPlayer
1955,UCBPlayer,57,287,344,0,52,UCBPlayer
1956,UCBPlayer,55,295,350,0,50,UCBPlayer
1957,UCBPlayer,66,296,362,3,47,UCBPlayer
1958,UCBPlayer,69,254,323,0,59,UCBPlayer
1959,UCBPlayer,65,305,370,2,44,UCBPlayer
1960,UCBPlayer,94,289,383,9,42,UCBPlayer
1961,UCBPlayer,59,279,338,0,54,UCBPlayer
1962,UCBPlayer,56,291,347,0,51,UCBPlayer
1963,UCBPlayer,49,319,368,0,44,UCBPlayer
1964,UCBPlayer,60,275,335,0,55,UCBPlayer
1965,UCBPlayer,47,327,374,0,42,UCBPlayer
1966,UCBPlayer,70,275,345,1,52,UCBPlayer
1967,UCBPlayer,84,279,363,7,48,UCBPlayer
1968,UCBPlayer,52,327,379,2,41,UCBPlayer
1969,UCBPlayer,57,312,369,1,44,UCBPlayer
1970,UCBPlayer,64,284,348,1,51,UCBPlayer
1971,UCBPlayer,69,254,323,0,59,UCBPlayer
1972,UCBPlayer,55,295,350,0,50,UCBPlayer
1973,UCBPlayer,47,327,374,0,42,UCBPlayer
1974,UCBPlayer,72,297,369,4,45,UCBPlayer
1975,UCBPlayer,64,269,333,1,56,UCBPlayer
1976,UCBPlayer,78,273,351,4,51,UCBPlayer
1977,UCBPlayer,113,283,396,10,38,UCBPlayer
1978,UCBPlayer,58,298,356,0,48,UCBPlayer
1979,UCBPlayer,61,286,347,0,51,UCBPlayer
1980,UCBPlayer,70,325,395,9,38,UCBPlayer
1981,UCBPlayer,87,307,394,8,38,UCBPlayer
1982,UCBPlayer,61,271,332,0,56,UCBPlayer
1983,UCBPlayer,77,287,364,5,47,UCBPlayer
1984,UCBPlayer,75,295,370,2,44,UCBPlayer
1985,UCBPlayer,50,310,360,1,47,UCBPlayer
1986,UCBPlayer,67,307,374,3,43,UCBPlayer
1987,UCBPlayer,51,311,362,0,46,UCBPlayer
1988,UCBPlayer,92,262,354,7,51,UCBPlayer
1989,UCBPlayer,78,243,321,1,60,UCBPlayer
1990,UCBPlayer,49,319,368,0,44,UCBPlayer
1991,UCBPlayer,63,263,326,0,58,UCBPlayer
1992,UCBPlayer,60,290,350,0,50,UCBPlayer
1993,UCBPlayer,67,302,369,4,45,UCBPlayer
1994,UCBPlayer,59,314,373,2,43,UCBPlayer
1995,UCBPlayer,59,304,363,1,46,UCBPlayer
1996,UCBPlayer,62,292,354,1,49,UCBPlayer
1997,UCBPlayer,59,279,338,0,54,UCBPlayer
1998,UCBPlayer,54,299,353,0,49,UCBPlayer
1999,UCBPlayer,62,282,344,0,52,UCBPlayer
2000,UCBPlayer,234,204,438,31,31,Player A
2001,UCBPlayer,55,295,350,0,50,UCBPlayer
2002,UCBPlayer,67,272,339,1,54,UCBPlayer
2003,UCBPlayer,54,299,353,0,49,UCBPlayer
2004,UCBPlayer,70,305,375,4,43,UCBPlayer
2005,UCBPlayer,64,274,338,0,54,UCBPlayer
2006,UCBPlayer,54,299,353,0,49,UCBPlayer
2007,UCBPlayer,49,319,368,0,44,UCBPlayer
2008,UCBPlayer,56,291,347,0,51,UCBPlayer
2009,UCBPlayer,70,260,330,1,57,UCBPlayer
2010,UCBPlayer,56,291,347,0,51,UCBPlayer
2011,UCBPlayer,52,307,359,0,47,UCBPlayer
2012,UCBPlayer,66,311,377,3,42,UCBPlayer
2013,UCBPlayer,208,223,431,30,33,UCBPlayer
2014,UCBPlayer,226,221,447,22,25,Player A
2015,UCBPlayer,53,313,366,1,45,UCBPlayer
2016,UCBPlayer,39,359,398,0,34,UCBPlayer
2017,UCBPlayer,52,307,359,0,47,UCBPlayer
2018,UCBPlayer,85,285,370,8,46,UCBPlayer
2019,UCBPlayer,50,315,365,0,45,UCBPlayer
2020,UCBPlayer,69,274,343,2,53,UCBPlayer
2021,UCBPlayer,67,272,339,1,54,UCBPlayer
2022,UCBPlayer,91,291,382,11,43,UCBPlayer
2023,UCBPlayer,72,282,354,4,50,UCBPlayer
2024,UCBPlayer,47,327,374,0,42,UCBPlayer
2025,UCBPlayer,56,291,347,0,51,UCBPlayer
2026,UCBPlayer,84,259,343,5,54,UCBPlayer
2027,UCBPlayer,53,313,366,1,45,UCBPlayer
2028,UCBPlayer,72,282,354,4,50,UCBPlayer
2029,UCBPlayer,70,305,375,4,43,UCBPlayer
2030,UCBPlayer,67,272,339,1,54,UCBPlayer
2031,UCBPlayer,64,309,373,2,43,UCBPlayer
2032,UCBPlayer,49,319,368,0,44,UCBPlayer
2033,UCBPlayer,69,294,363,4,47,UCBPlayer
2034,UCBPlayer,54,299,353,0,49,UCBPlayer
2035,UCBPlayer,55,320,375,4,43,UCBPlayer
2036,UCBPlayer,65,305,370,2,44,UCBPlayer
2037,UCBPlayer,55,295,350,0,50,UCBPlayer
2038,UCBPlayer,54,294,348,1,51,UCBPlayer
2039,UCBPlayer,94,279,373,5,44,UCBPlayer
2040,UCBPlayer,57,287,344,0,52,UCBPlayer
2041,UCBPlayer,49,319,368,0,44,UCBPlayer
2042,UCBPlayer,279,199,478,35,19,Player A
2043,UCBPlayer,56,291,347,0,51,UCBPlayer
2044,UCBPlayer,54,299,353,0,49,UCBPlayer
2045,UCBPlayer,55,295,350,0,50,UCBPlayer
2046,UCBPlayer,63,288,351,1,50,UCBPlayer
2047,UCBPlayer,87,267,354,4,50,UCBPlayer
2048,UCBPlayer,57,287,344,0,52,UCBPlayer
2049,UCBPlayer,62,317,379,2,41,UCBPlayer
2050,UCBPlayer,54,299,353,0,49,UCBPlayer
2051,UCBPlayer,62,292,354,1,49,UCBPlayer
2052,UCBPlayer,52,317,369,1,44,UCBPlayer
2053,UCBPlayer,71,291,362,3,47,UCBPlayer
2054,UCBPlayer,58,283,341,0,53,UCBPlayer
2055,UCBPlayer,61,306,367,2,45,UCBPlayer
2056,UCBPlayer,54,314,368,0,44,UCBPlayer
2057,UCBPlayer,59,294,353,0,49,UCBPlayer
2058,UCBPlayer,56,291,347,0,51,UCBPlayer
2059,UCBPlayer,53,303,356,0,48,UCBPlayer
2060,UCBPlayer,63,288,351,1,50,UCBPlayer
2061,UCBPlayer,55,295,350,0,50,UCBPlayer
2062,UCBPlayer,65,310,375,4,43,UCBPlayer
2063,UCBPlayer,134,274,408,19,37,UCBPlayer
2064,UCBPlayer,79,249,328,2,58,UCBPlayer
2065,UCBPlayer,190,265,455,33,26,UCBPlayer
2066,UCBPlayer,186,231,417,22,35,UCBPlayer
2067,UCBPlayer,105,265,370,11,47,UCBPlayer
2068,UCBPlayer,102,277,379,11,44,UCBPlayer
2069,UCBPlayer,48,323,371,0,43,UCBPlayer
2070,UCBPlayer,54,299,353,0,49,UCBPlayer
2071,UCBPlayer,48,333,381,1,40,UCBPlayer
2072,UCBPlayer,70,285,355,5,50,UCBPlayer
2073,UCBPlayer,64,274,338,0,54,UCBPlayer
2074,UCBPlayer,53,303,356,0,48,UCBPlayer
2075,UCBPlayer,52,307,359,0,47,UCBPlayer
2076,UCBPlayer,70,260,330,1,57,UCBPlayer
2077,UCBPlayer,58,283,341,0,53,UCBPlayer
2078,UCBPlayer,51,311,362,0,46,UCBPlayer
2079,UCBPlayer,64,269,333,1,56,UCBPlayer
2080,UCBPlayer,65,270,335,0,55,UCBPlayer
2081,UCBPlayer,60,320,380,3,41,UCBPlayer
2082,UCBPlayer,83,243,326,3,59,UCBPlayer
2083,UCBPlayer,53,303,356,0,48,UCBPlayer
2084,UCBPlayer,55,295,350,0,50,UCBPlayer
2085,UCBPlayer,59,289,348,1,51,UCBPlayer
2086,UCBPlayer,60,290,350,0,50,UCBPlayer
2087,UCBPlayer,53,303,356,0,48,UCBPlayer
2088,UCBPlayer,56,291,347,0,51,UCBPlayer
2089,UCBPlayer,55,295,350,0,50,UCBPlayer
2090,UCBPlayer,48,308,356,0,48,UCBPlayer
2091,UCBPlayer,54,299,353,0,49,UCBPlayer
2092,UCBPlayer,48,323,371,0,43,UCBPlayer
2093,UCBPlayer,54,299,353,0,49,UCBPlayer
2094,UCBPlayer,52,307,359,0,47,UCBPlayer
2095,UCBPlayer,45,335,380,0,40,UCBPlayer
2096,UCBPlayer,48,323,371,0,43,UCBPlayer
2097,UCBPlayer,71,266,337,2,55,UCBPlayer
2098,UCBPlayer,73,273,346,2,52,UCBPlayer
2099,UCBPlayer,50,315,365,0,45,UCBPlayer
2100,UCBPlayer,59,304,363,1,46,UCBPlayer
2101,UCBPlayer,70,270,340,2,54,UCBPlayer
2102,UCBPlayer,66,306,372,4,44,UCBPlayer
2103,UCBPlayer,92,282,374,9,45,UCBPlayer
2104,UCBPlayer,63,288,351,1,50,UCBPlayer
2105,UCBPlayer,59,304,363,1,46,UCBPlayer
2106,UCBPlayer,62,282,344,0,52,UCBPlayer
2107,UCBPlayer,68,283,351,1,50,UCBPlayer
2108,UCBPlayer,51,311,362,0,46,UCBPlayer
2109,UCBPlayer,57,287,344,0,52,UCBPlayer
2110,UCBPlayer,69,299,368,3,45,UCBPlayer
2111,UCBPlayer,207,207,414,22,36,Tie
2112,UCBPlayer,69,294,363,4,47,UCBPlayer
2113,UCBPlayer,53,303,356,0,48,UCBPlayer
2114,UCBPlayer,87,317,404,9,35,UCBPlayer
2115,UCBPlayer,53,328,381,1,40,UCBPlayer
2116,UCBPlayer,55,295,350,0,50,UCBPlayer
2117,UCBPlayer,57,287,344,0,52,UCBPlayer
2118,UCBPlayer,54,309,363,1,46,UCBPlayer
2119,UCBPlayer,69,279,348,1,51,UCBPlayer
2120,UCBPlayer,61,296,357,1,48,UCBPlayer
2121,UCBPlayer,81,286,367,5,46,UCBPlayer
2122,UCBPlayer,54,309,363,1,46,UCBPlayer
2123,UCBPlayer,65,270,335,0,55,UCBPlayer
2124,UCBPlayer,45,335,380,0,40,UCBPlayer
2125,UCBPlayer,52,307,359,0,47,UCBPlayer
2126,UCBPlayer,110,265,375,7,44,UCBPlayer
2127,UCBPlayer,52,307,359,0,47,UCBPlayer
2128,UCBPlayer,104,274,378,10,44,UCBPlayer
2129,UCBPlayer,51,311,362,0,46,UCBPlayer
2130,UCBPlayer,67,302,369,4,45,UCBPlayer
2131,UCBPlayer,62,282,344,0,52,UCBPlayer
2132,UCBPlayer,49,319,368,0,44,UCBPlayer
2133,UCBPlayer,60,275,335,0,55,UCBPlayer
2134,UCBPlayer,52,317,369,1,44,UCBPlayer
2135,UCBPlayer,54,334,388,2,38,UCBPlayer
2136,UCBPlayer,58,283,341,0,53,UCBPlayer
2137,UCBPlayer,63,273,336,1,55,UCBPlayer
2138,UCBPlayer,67,262,329,0,57,UCBPlayer
2139,UCBPlayer,59,279,338,0,54,UCBPlayer
2140,UCBPlayer,53,298,351,1,50,UCBPlayer
2141,UCBPlayer,56,316,372,1,43,UCBPlayer
2142,UCBPlayer,66,291,357,1,48,UCBPlayer
2143,UCBPlayer,56,291,347,0,51,UCBPlayer
2144,UCBPlayer,57,287,344,0,52,UCBPlayer
2145,UCBPlayer,80,270,350,3,51,UCBPlayer
2146,UCBPlayer,70,270,340,2,54,UCBPlayer
2147,UCBPlayer,51,311,362,0,46,UCBPlayer
2148,UCBPlayer,71,281,352,2,50,UCBPlayer
2149,UCBPlayer,70,290,360,4,48,UCBPlayer
2150,UCBPlayer,44,339,383,0,39,UCBPlayer
2151,UCBPlayer,62,267,329,0,57,UCBPlayer
2152,UCBPlayer,112,277,389,9,40,UCBPlayer
2153,UCBPlayer,58,328,386,3,39,UCBPlayer
2154,UCBPlayer,53,303,356,0,48,UCBPlayer
2155,UCBPlayer,71,281,352,2,50,UCBPlayer
2156,UCBPlayer,71,281,352,5,51,UCBPlayer
2157,UCBPlayer,96,276,372,7,45,UCBPlayer
2158,UCBPlayer,80,290,370,5,45,UCBPlayer
2159,UCBPlayer,60,275,335,0,55,UCBPlayer
2160,UCBPlayer,59,304,363,1,46,UCBPlayer
2161,UCBPlayer,57,287,344,0,52,UCBPlayer
2162,UCBPlayer,170,240,410,18,36,UCBPlayer
2163,UCBPlayer,56,291,347,0,51,UCBPlayer
2164,UCBPlayer,54,299,353,0,49,UCBPlayer
2165,UCBPlayer,46,331,377,0,41,UCBPlayer
2166,UCBPlayer,48,333,381,1,40,UCBPlayer
2167,UCBPlayer,74,294,368,3,45,UCBPlayer
2168,UCBPlayer,69,284,353,3,50,UCBPlayer
2169,UCBPlayer,62,302,364,2,46,UCBPlayer
2170,UCBPlayer,90,280,370,11,47,UCBPlayer
2171,UCBPlayer,58,298,356,0,48,UCBPlayer
2172,UCBPlayer,58,303,361,2,47,UCBPlayer
2173,UCBPlayer,118,293,411,16,35,UCBPlayer
2174,UCBPlayer,52,307,359,0,47,UCBPlayer
2175,UCBPlayer,58,283,341,0,53,UCBPlayer
2176,UCBPlayer,54,299,353,0,49,UCBPlayer
2177,UCBPlayer,77,307,384,4,40,UCBPlayer
2178,UCBPlayer,47,327,374,0,42,UCBPlayer
2179,UCBPlayer,66,286,352,2,50,UCBPlayer
2180,UCBPlayer,86,261,347,6,53,UCBPlayer
2181,UCBPlayer,53,328,381,1,40,UCBPlayer
2182,UCBPlayer,94,254,348,7,53,UCBPlayer
2183,UCBPlayer,54,309,363,1,46,UCBPlayer
2184,UCBPlayer,64,304,368,3,45,UCBPlayer
2185,UCBPlayer,52,322,374,0,42,UCBPlayer
2186,UCBPlayer,50,325,375,1,42,UCBPlayer
2187,UCBPlayer,55,310,365,0,45,UCBPlayer
2188,UCBPlayer,56,301,357,1,48,UCBPlayer
2189,UCBPlayer,67,282,349,2,51,UCBPlayer
2190,UCBPlayer,45,330,375,1,42,UCBPlayer
2191,UCBPlayer,68,308,376,5,43,UCBPlayer
2192,UCBPlayer,85,310,395,12,39,UCBPlayer
2193,UCBPlayer,56,291,347,0,51,UCBPlayer
2194,UCBPlayer,59,279,338,0,54,UCBPlayer
2195,UCBPlayer,55,295,350,0,50,UCBPlayer
2196,UCBPlayer,41,351,392,0,36,UCBPlayer
2197,UCBPlayer,58,308,366,1,45,UCBPlayer
2198,UCBPlayer,67,292,359,3,48,UCBPlayer
2199,UCBPlayer,73,318,391,5,38,UCBPlayer
2200,UCBPlayer,61,306,367,2,45,UCBPlayer
2201,UCBPlayer,69,264,333,1,56,UCBPlayer
2202,UCBPlayer,48,323,371,0,43,UCBPlayer
2203,UCBPlayer,59,279,338,0,54,UCBPlayer
2204,UCBPlayer,61,271,332,0,56,UCBPlayer
2205,UCBPlayer,91,236,327,4,59,UCBPlayer
2206,UCBPlayer,74,289,363,4,47,UCBPlayer
2207,UCBPlayer,50,315,365,0,45,UCBPlayer
2208,UCBPlayer,60,275,335,0,55,UCBPlayer
2209,UCBPlayer,53,333,386,3,39,UCBPlayer
2210,UCBPlayer,96,241,337,5,56,UCBPlayer
2211,UCBPlayer,54,299,353,0,49,UCBPlayer
2212,UCBPlayer,60,275,335,0,55,UCBPlayer
2213,UCBPlayer,52,307,359,0,47,UCBPlayer
2214,UCBPlayer,55,295,350,0,50,UCBPlayer
2215,UCBPlayer,59,279,338,0,54,UCBPlayer
2216,UCBPlayer,57,287,344,0,52,UCBPlayer
2217,UCBPlayer,52,307,359,0,47,UCBPlayer
2218,UCBPlayer,49,329,378,1,41,UCBPlayer
2219,UCBPlayer,58,318,376,2,42,UCBPlayer
2220,UCBPlayer,59,299,358,2,48,UCBPlayer
2221,UCBPlayer,52,332,384,1,39,UCBPlayer
2222,UCBPlayer,64,274,338,0,54,UCBPlayer
2223,UCBPlayer,57,287,344,0,52,UCBPlayer
2224,UCBPlayer,60,275,335,0,55,UCBPlayer
2225,UCBPlayer,61,286,347,0,51,UCBPlayer
2226,UCBPlayer,71,286,357,4,49,UCBPlayer
2227,UCBPlayer,49,319,368,0,44,UCBPlayer
2228,UCBPlayer,69,304,373,5,44,UCBPlayer
2229,UCBPlayer,62,292,354,1,49,UCBPlayer
2230,UCBPlayer,75,230,305,0,65,UCBPlayer
2231,UCBPlayer,66,266,332,0,56,UCBPlayer
2232,UCBPlayer,70,290,360,4,48,UCBPlayer
2233,UCBPlayer,61,296,357,1,48,UCBPlayer
2234,UCBPlayer,69,264,333,1,56,UCBPlayer
2235,UCBPlayer,65,270,335,0,55,UCBPlayer
2236,UCBPlayer,64,259,323,0,59,UCBPlayer
2237,UCBPlayer,64,274,338,0,54,UCBPlayer
2238,UCBPlayer,50,335,385,2,39,UCBPlayer
2239,UCBPlayer,70,275,345,1,52,UCBPlayer
2240,UCBPlayer,59,289,348,1,51,UCBPlayer
2241,UCBPlayer,87,292,379,5,42,UCBPlayer
2242,UCBPlayer,54,294,348,1,51,UCBPlayer
2243,UCBPlayer,63,308,371,3,44,UCBPlayer
2244,UCBPlayer,67,272,339,1,54,UCBPlayer
2245,UCBPlayer,47,327,374,0,42,UCBPlayer
2246,UCBPlayer,47,327,374,0,42,UCBPlayer
2247,UCBPlayer,65,290,355,2,49,UCBPlayer
2248,UCBPlayer,61,296,357,1,48,UCBPlayer
2249,UCBPlayer,80,275,355,5,50,UCBPlayer
2250,UCBPlayer,73,278,351,4,51,UCBPlayer
2251,UCBPlayer,67,297,364,2,46,UCBPlayer
2252,UCBPlayer,65,255,320,0,60,UCBPlayer
2253,UCBPlayer,54,299,353,0,49,UCBPlayer
2254,UCBPlayer,63,298,361,2,47,UCBPlayer
2255,UCBPlayer,55,295,350,0,50,UCBPlayer
2256,UCBPlayer,58,283,341,0,53,UCBPlayer
2257,UCBPlayer,64,314,378,4,42,UCBPlayer
2258,UCBPlayer,53,303,356,0,48,UCBPlayer
2259,UCBPlayer,67,247,314,0,62,UCBPlayer
2260,UCBPlayer,83,288,371,6,45,UCBPlayer
2261,UCBPlayer,62,292,354,1,49,UCBPlayer
2262,UCBPlayer,53,303,356,0,48,UCBPlayer
2263,UCBPlayer,63,298,361,2,47,UCBPlayer
2264,UCBPlayer,58,283,341,0,53,UCBPlayer
2265,UCBPlayer,74,299,373,5,44,UCBPlayer
2266,UCBPlayer,59,279,338,0,54,UCBPlayer
2267,UCBPlayer,45,345,390,1,37,UCBPlayer
2268,UCBPlayer,86,266,352,5,51,UCBPlayer
2269,UCBPlayer,46,341,387,1,38,UCBPlayer
2270,UCBPlayer,100,255,355,8,51,UCBPlayer
2271,UCBPlayer,61,296,357,1,48,UCBPlayer
2272,UCBPlayer,49,319,368,0,44,UCBPlayer
2273,UCBPlayer,71,296,367,5,46,UCBPlayer
2274,UCBPlayer,55,295,350,0,50,UCBPlayer
2275,UCBPlayer,56,291,347,0,51,UCBPlayer
2276,UCBPlayer,65,305,370,2,44,UCBPlayer
2277,UCBPlayer,53,303,356,0,48,UCBPlayer
2278,UCBPlayer,49,319,368,0,44,UCBPlayer
2279,UCBPlayer,59,279,338,0,54,UCBPlayer
2280,UCBPlayer,55,325,380,3,41,UCBPlayer
2281,UCBPlayer,56,306,362,0,46,UCBPlayer
2282,UCBPlayer,58,283,341,0,53,UCBPlayer
2283,UCBPlayer,52,332,384,4,40,UCBPlayer
2284,UCBPlayer,59,309,368,0,44,UCBPlayer
2285,UCBPlayer,50,315,365,0,45,UCBPlayer
2286,UCBPlayer,61,271,332,0,56,UCBPlayer
2287,UCBPlayer,54,299,353,0,49,UCBPlayer
2288,UCBPlayer,55,305,360,1,47,UCBPlayer
2289,UCBPlayer,79,259,338,3,55,UCBPlayer
2290,UCBPlayer,162,247,409,20,37,UCBPlayer
2291,UCBPlayer,57,302,359,3,48,UCBPlayer
2292,UCBPlayer,82,287,369,4,45,UCBPlayer
2293,UCBPlayer,67,297,364,2,46,UCBPlayer
2294,UCBPlayer,49,304,353,0,49,UCBPlayer
2295,UCBPlayer,53,303,356,0,48,UCBPlayer
2296,UCBPlayer,64,284,348,1,51,UCBPlayer
2297,UCBPlayer,74,289,363,4,47,UCBPlayer
2298,UCBPlayer,69,264,333,1,56,UCBPlayer
2299,UCBPlayer,59,279,338,0,54,UCBPlayer
2300,UCBPlayer,81,271,352,5,51,UCBPlayer
2301,UCBPlayer,64,304,368,3,45,UCBPlayer
2302,UCBPlayer,47,337,384,1,39,UCBPlayer
2303,UCBPlayer,72,297,369,4,45,UCBPlayer
2304,UCBPlayer,68,258,326,0,58,UCBPlayer
2305,UCBPlayer,54,299,353,0,49,UCBPlayer
2306,UCBPlayer,52,307,359,0,47,UCBPlayer
2307,UCBPlayer,77,292,369,4,45,UCBPlayer
2308,UCBPlayer,61,296,357,1,48,UCBPlayer
2309,UCBPlayer,54,299,353,0,49,UCBPlayer
2310,UCBPlayer,59,279,338,0,54,UCBPlayer
2311,UCBPlayer,53,303,356,0,48,UCBPlayer
2312,UCBPlayer,53,303,356,0,48,UCBPlayer
2313,UCBPlayer,63,323,386,3,39,UCBPlayer
2314,UCBPlayer,135,275,410,18,36,UCBPlayer
2315,UCBPlayer,54,299,353,0,49,UCBPlayer
2316,UCBPlayer,54,299,353,0,49,UCBPlayer
2317,UCBPlayer,63,288,351,1,50,UCBPlayer
2318,UCBPlayer,75,305,380,6,42,UCBPlayer
2319,UCBPlayer,70,300,370,5,45,UCBPlayer
2320,UCBPlayer,62,292,354,1,49,UCBPlayer
2321,UCBPlayer,71,281,352,2,50,UCBPlayer
2322,UCBPlayer,89,264,353,6,51,UCBPlayer
2323,UCBPlayer,92,297,389,9,40,UCBPlayer
2324,UCBPlayer,51,311,362,0,46,UCBPlayer
2325,UCBPlayer,77,282,359,6,49,UCBPlayer
2326,UCBPlayer,68,288,356,3,49,UCBPlayer
2327,UCBPlayer,50,315,365,0,45,UCBPlayer
2328,UCBPlayer,54,309,363,1,46,UCBPlayer
2329,UCBPlayer,62,292,354,1,49,UCBPlayer
2330,UCBPlayer,58,283,341,0,53,UCBPlayer
2331,UCBPlayer,52,317,369,1,44,UCBPlayer
2332,UCBPlayer,75,320,395,6,37,UCBPlayer
2333,UCBPlayer,51,321,372,1,43,UCBPlayer
2334,UCBPlayer,53,318,371,0,43,UCBPlayer
2335,UCBPlayer,69,264,333,1,56,UCBPlayer
2336,UCBPlayer,107,232,339,7,56,UCBPlayer
2337,UCBPlayer,82,302,384,4,40,UCBPlayer
2338,UCBPlayer,42,357,399,1,34,UCBPlayer
2339,UCBPlayer,78,298,376,5,43,UCBPlayer
2340,UCBPlayer,48,323,371,0,43,UCBPlayer
2341,UCBPlayer,53,303,356,0,48,UCBPlayer
2342,UCBPlayer,53,298,351,1,50,UCBPlayer
2343,UCBPlayer,79,274,353,3,50,UCBPlayer
2344,UCBPlayer,56,286,342,1,53,UCBPlayer
2345,UCBPlayer,72,277,349,2,51,UCBPlayer
2346,UCBPlayer,55,295,350,0,50,UCBPlayer
2347,UCBPlayer,157,262,419,18,33,UCBPlayer
2348,UCBPlayer,50,315,365,0,45,UCBPlayer
2349,UCBPlayer,65,290,355,2,49,UCBPlayer
2350,UCBPlayer,58,283,341,0,53,UCBPlayer
2351,UCBPlayer,57,287,344,0,52,UCBPlayer
2352,UCBPlayer,59,279,338,0,54,UCBPlayer
2353,UCBPlayer,88,273,361,8,49,UCBPlayer
2354,UCBPlayer,54,299,353,0,49,UCBPlayer
2355,UCBPlayer,69,304,373,5,44,UCBPlayer
2356,UCBPlayer,52,307,359,0,47,UCBPlayer
2357,UCBPlayer,71,256,327,1,58,UCBPlayer
2358,UCBPlayer,63,298,361,2,47,UCBPlayer
2359,UCBPlayer,79,259,338,3,55,UCBPlayer
2360,UCBPlayer,45,345,390,1,37,UCBPlayer
2361,UCBPlayer,64,304,368,3,45,UCBPlayer
2362,UCBPlayer,51,311,362,0,46,UCBPlayer
2363,UCBPlayer,52,307,359,0,47,UCBPlayer
2364,UCBPlayer,57,287,344,0,52,UCBPlayer
2365,UCBPlayer,64,294,358,2,48,UCBPlayer
2366,UCBPlayer,45,335,380,0,40,UCBPlayer
2367,UCBPlayer,43,343,386,0,38,UCBPlayer
2368,UCBPlayer,58,283,341,0,53,UCBPlayer
2369,UCBPlayer,53,303,356,0,48,UCBPlayer
2370,UCBPlayer,58,283,341,0,53,UCBPlayer
2371,UCBPlayer,58,283,341,0,53,UCBPlayer
2372,UCBPlayer,76,291,367,5,46,UCBPlayer
2373,UCBPlayer,78,298,376,5,43,UCBPlayer
2374,UCBPlayer,73,288,361,2,47,UCBPlayer
2375,UCBPlayer,55,295,350,0,50,UCBPlayer
2376,UCBPlayer,70,270,340,2,54,UCBPlayer
2377,UCBPlayer,52,307,359,0,47,UCBPlayer
2378,UCBPlayer,77,292,369,7,46,UCBPlayer
2379,UCBPlayer,62,302,364,2,46,UCBPlayer
2380,UCBPlayer,60,310,370,2,44,UCBPlayer
2381,UCBPlayer,62,267,329,0,57,UCBPlayer
2382,UCBPlayer,52,307,359,0,47,UCBPlayer
2383,UCBPlayer,53,303,356,0,48,UCBPlayer
2384,UCBPlayer,53,313,366,1,45,UCBPlayer
2385,UCBPlayer,87,292,379,5,42,UCBPlayer
2386,UCBPlayer,49,319,368,0,44,UCBPlayer
2387,UCBPlayer,51,321,372,1,43,UCBPlayer
2388,UCBPlayer,59,324,383,3,40,UCBPlayer
2389,UCBPlayer,53,318,371,0,43,UCBPlayer
2390,UCBPlayer,60,300,360,1,47,UCBPlayer
2391,UCBPlayer,52,317,369,1,44,UCBPlayer
2392,UCBPlayer,72,297,369,7,46,UCBPlayer
2393,UCBPlayer,77,307,384,1,39,UCBPlayer
2394,UCBPlayer,58,303,361,2,47,UCBPlayer
2395,UCBPlayer,66,291,357,1,48,UCBPlayer
2396,UCBPlayer,36,356,392,0,36,UCBPlayer
2397,UCBPlayer,94,289,383,9,42,UCBPlayer
2398,UCBPlayer,95,245,340,5,55,UCBPlayer
2399,UCBPlayer,62,282,344,0,52,UCBPlayer
2400,UCBPlayer,52,307,359,0,47,UCBPlayer
2401,UCBPlayer,51,311,362,0,46,UCBPlayer
2402,UCBPlayer,80,265,345,4,53,UCBPlayer
2403,UCBPlayer,77,247,324,1,59,UCBPlayer
2404,UCBPlayer,73,273,346,2,52,UCBPlayer
2405,UCBPlayer,91,296,387,10,41,UCBPlayer
2406,UCBPlayer,45,335,380,0,40,UCBPlayer
2407,UCBPlayer,48,333,381,1,40,UCBPlayer
2408,UCBPlayer,114,244,358,11,51,UCBPlayer
2409,UCBPlayer,53,303,356,0,48,UCBPlayer
2410,UCBPlayer,58,308,366,1,45,UCBPlayer
2411,UCBPlayer,70,270,340,2,54,UCBPlayer
2412,UCBPlayer,57,312,369,1,44,UCBPlayer
2413,UCBPlayer,54,299,353,0,49,UCBPlayer
2414,UCBPlayer,48,323,371,0,43,UCBPlayer
2415,UCBPlayer,53,303,356,0,48,UCBPlayer
2416,UCBPlayer,52,307,359,0,47,UCBPlayer
2417,UCBPlayer,45,335,380,0,40,UCBPlayer
2418,UCBPlayer,56,291,347,0,51,UCBPlayer
2419,UCBPlayer,65,290,355,2,49,UCBPlayer
2420,UCBPlayer,81,281,362,6,48,UCBPlayer
2421,UCBPlayer,67,272,339,1,54,UCBPlayer
2422,UCBPlayer,84,269,353,6,51,UCBPlayer
2423,UCBPlayer,85,255,340,5,55,UCBPlayer
2424,UCBPlayer,89,314,403,8,35,UCBPlayer
2425,UCBPlayer,56,291,347,0,51,UCBPlayer
2426,UCBPlayer,50,325,375,1,42,UCBPlayer
2427,UCBPlayer,44,339,383,0,39,UCBPlayer
2428,UCBPlayer,56,291,347,0,51,UCBPlayer
2429,UCBPlayer,73,278,351,4,51,UCBPlayer
2430,UCBPlayer,69,274,343,2,53,UCBPlayer
2431,UCBPlayer,78,288,366,4,46,UCBPlayer
2432,UCBPlayer,50,315,365,0,45,UCBPlayer
2433,UCBPlayer,54,299,353,0,49,UCBPlayer
2434,UCBPlayer,59,314,373,2,43,UCBPlayer
2435,UCBPlayer,56,306,362,0,46,UCBPlayer
2436,UCBPlayer,72,307,379,5,42,UCBPlayer
2437,UCBPlayer,51,311,362,0,46,UCBPlayer
2438,UCBPlayer,53,303,356,0,48,UCBPlayer
2439,UCBPlayer,84,279,363,4,47,UCBPlayer
2440,UCBPlayer,56,291,347,0,51,UCBPlayer
2441,UCBPlayer,44,339,383,0,39,UCBPlayer
2442,UCBPlayer,84,259,343,5,54,UCBPlayer
2443,UCBPlayer,72,282,354,1,49,UCBPlayer
2444,UCBPlayer,53,303,356,0,48,UCBPlayer
2445,UCBPlayer,53,303,356,0,48,UCBPlayer
2446,UCBPlayer,59,279,338,0,54,UCBPlayer
2447,UCBPlayer,53,288,341,0,53,UCBPlayer
2448,UCBPlayer,51,311,362,0,46,UCBPlayer
2449,UCBPlayer,50,315,365,0,45,UCBPlayer
2450,UCBPlayer,81,281,362,6,48,UCBPlayer
2451,UCBPlayer,69,264,333,1,56,UCBPlayer
2452,UCBPlayer,161,236,397,14,39,UCBPlayer
2453,UCBPlayer,57,287,344,0,52,UCBPlayer
2454,UCBPlayer,56,291,347,0,51,UCBPlayer
2455,UCBPlayer,61,271,332,0,56,UCBPlayer
2456,UCBPlayer,49,329,378,1,41,UCBPlayer
2457,UCBPlayer,56,291,347,0,51,UCBPlayer
2458,UCBPlayer,67,302,369,4,45,UCBPlayer
2459,UCBPlayer,56,291,347,0,51,UCBPlayer
2460,UCBPlayer,57,287,344,0,52,UCBPlayer
2461,UCBPlayer,84,289,373,8,45,UCBPlayer
2462,UCBPlayer,49,319,368,0,44,UCBPlayer
2463,UCBPlayer,59,314,373,2,43,UCBPlayer
2464,UCBPlayer,57,287,344,0,52,UCBPlayer
2465,UCBPlayer,58,283,341,0,53,UCBPlayer
2466,UCBPlayer,55,295,350,0,50,UCBPlayer
2467,UCBPlayer,56,291,347,0,51,UCBPlayer
2468,UCBPlayer,109,279,388,11,41,UCBPlayer
2469,UCBPlayer,53,323,376,2,42,UCBPlayer
2470,UCBPlayer,115,245,360,10,50,UCBPlayer
2471,UCBPlayer,58,283,341,0,53,UCBPlayer
2472,UCBPlayer,134,274,408,13,35,UCBPlayer
2473,UCBPlayer,52,317,369,1,44,UCBPlayer
2474,UCBPlayer,52,332,384,1,39,UCBPlayer
2475,UCBPlayer,100,255,355,8,51,UCBPlayer
2476,UCBPlayer,60,275,335,0,55,UCBPlayer
2477,UCBPlayer,61,301,362,3,47,UCBPlayer
2478,UCBPlayer,45,350,395,0,35,UCBPlayer
2479,UCBPlayer,61,306,367,2,45,UCBPlayer
2480,UCBPlayer,54,299,353,0,49,UCBPlayer
2481,UCBPlayer,71,291,362,3,47,UCBPlayer
2482,UCBPlayer,56,311,367,2,45,UCBPlayer
2483,UCBPlayer,61,306,367,2,45,UCBPlayer
2484,UCBPlayer,55,295,350,0,50,UCBPlayer
2485,UCBPlayer,58,328,386,3,39,UCBPlayer
2486,UCBPlayer,79,269,348,4,52,UCBPlayer
2487,UCBPlayer,63,298,361,2,47,UCBPlayer
2488,UCBPlayer,55,310,365,0,45,UCBPlayer
2489,UCBPlayer,55,315,370,2,44,UCBPlayer
2490,UCBPlayer,65,270,335,0,55,UCBPlayer
2491,UCBPlayer,45,335,380,0,40,UCBPlayer
2492,UCBPlayer,55,295,350,0,50,UCBPlayer
2493,UCBPlayer,56,291,347,0,51,UCBPlayer
2494,UCBPlayer,57,302,359,3,48,UCBPlayer
2495,UCBPlayer,65,305,370,2,44,UCBPlayer
2496,UCBPlayer,59,284,343,2,53,UCBPlayer
2497,UCBPlayer,71,271,342,1,53,UCBPlayer
2498,UCBPlayer,57,322,379,2,41,UCBPlayer
2499,UCBPlayer,54,299,353,0,49,UCBPlayer
2500,UCBPlayer,52,307,359,0,47,UCBPlayer
2501,UCBPlayer,56,291,347,0,51,UCBPlayer
2502,UCBPlayer,50,315,365,0,45,UCBPlayer
2503,UCBPlayer,63,288,351,1,50,UCBPlayer
2504,UCBPlayer,89,269,358,5,49,UCBPlayer
2505,UCBPlayer,53,303,356,0,48,UCBPlayer
2506,UCBPlayer,60,275,335,0,55,UCBPlayer
2507,UCBPlayer,81,266,347,3,52,UCBPlayer
2508,UCBPlayer,59,279,338,0,54,UCBPlayer
2509,UCBPlayer,60,290,350,0,50,UCBPlayer
2510,UCBPlayer,72,302,374,6,44,UCBPlayer
2511,UCBPlayer,150,240,390,13,41,UCBPlayer
2512,UCBPlayer,79,294,373,8,45,UCBPlayer
2513,UCBPlayer,58,283,341,0,53,UCBPlayer
2514,UCBPlayer,63,298,361,2,47,UCBPlayer
2515,UCBPlayer,66,296,362,3,47,UCBPlayer
2516,UCBPlayer,56,291,347,0,51,UCBPlayer
2517,UCBPlayer,64,259,323,0,59,UCBPlayer
2518,UCBPlayer,93,268,361,5,48,UCBPlayer
2519,UCBPlayer,56,291,347,0,51,UCBPlayer
2520,UCBPlayer,59,279,338,0,54,UCBPlayer
2521,UCBPlayer,53,303,356,0,48,UCBPlayer
2522,UCBPlayer,51,311,362,0,46,UCBPlayer
2523,UCBPlayer,48,323,371,0,43,UCBPlayer
2524,UCBPlayer,93,288,381,7,42,UCBPlayer
2525,UCBPlayer,105,250,355,8,51,UCBPlayer
2526,UCBPlayer,51,311,362,0,46,UCBPlayer
2527,UCBPlayer,97,287,384,10,42,UCBPlayer
2528,UCBPlayer,78,288,366,4,46,UCBPlayer
2529,UCBPlayer,44,349,393,1,36,UCBPlayer
2530,UCBPlayer,81,271,352,5,51,UCBPlayer
2531,UCBPlayer,53,303,356,0,48,UCBPlayer
2532,UCBPlayer,64,304,368,3,45,UCBPlayer
2533,UCBPlayer,61,306,367,2,45,UCBPlayer
2534,UCBPlayer,46,341,387,1,38,UCBPlayer
2535,UCBPlayer,67,262,329,0,57,UCBPlayer
2536,UCBPlayer,51,311,362,0,46,UCBPlayer
2537,UCBPlayer,60,275,335,0,55,UCBPlayer
2538,UCBPlayer,71,276,347,3,52,UCBPlayer
2539,UCBPlayer,70,260,330,1,57,UCBPlayer
2540,UCBPlayer,90,315,405,10,35,UCBPlayer
2541,UCBPlayer,82,277,359,3,48,UCBPlayer
2542,UCBPlayer,55,305,360,1,47,UCBPlayer
2543,UCBPlayer,68,278,346,2,52,UCBPlayer
2544,UCBPlayer,61,296,357,1,48,UCBPlayer
2545,UCBPlayer,68,298,366,4,46,UCBPlayer
2546,UCBPlayer,112,257,369,10,47,UCBPlayer
2547,UCBPlayer,66,281,347,0,51,UCBPlayer
2548,UCBPlayer,50,315,365,0,45,UCBPlayer
2549,UCBPlayer,47,312,359,0,47,UCBPlayer
2550,UCBPlayer,56,291,347,0,51,UCBPlayer
2551,UCBPlayer,59,324,383,3,40,UCBPlayer
2552,UCBPlayer,114,264,378,13,45,UCBPlayer
2553,UCBPlayer,56,291,347,0,51,UCBPlayer
2554,UCBPlayer,54,299,353,0,49,UCBPlayer
2555,UCBPlayer,56,291,347,0,51,UCBPlayer
2556,UCBPlayer,48,323,371,0,43,UCBPlayer
2557,UCBPlayer,53,303,356,0,48,UCBPlayer
2558,UCBPlayer,67,282,349,2,51,UCBPlayer
2559,UCBPlayer,79,299,378,7,43,UCBPlayer
2560,UCBPlayer,49,319,368,0,44,UCBPlayer
2561,UCBPlayer,66,291,357,1,48,UCBPlayer
2562,UCBPlayer,62,312,374,3,43,UCBPlayer
2563,UCBPlayer,49,319,368,0,44,UCBPlayer
2564,UCBPlayer,52,307,359,0,47,UCBPlayer
2565,UCBPlayer,62,292,354,1,49,UCBPlayer
2566,UCBPlayer,54,299,353,0,49,UCBPlayer
2567,UCBPlayer,101,306,407,9,34,UCBPlayer
2568,UCBPlayer,66,251,317,0,61,UCBPlayer
2569,UCBPlayer,52,307,359,0,47,UCBPlayer
2570,UCBPlayer,57,287,344,0,52,UCBPlayer
2571,UCBPlayer,55,295,350,0,50,UCBPlayer
2572,UCBPlayer,51,311,362,0,46,UCBPlayer
2573,UCBPlayer,65,310,375,4,43,UCBPlayer
2574,UCBPlayer,49,319,368,0,44,UCBPlayer
2575,UCBPlayer,50,315,365,0,45,UCBPlayer
2576,UCBPlayer,55,320,375,1,42,UCBPlayer
2577,UCBPlayer,65,255,320,0,60,UCBPlayer
2578,UCBPlayer,65,270,335,0,55,UCBPlayer
2579,UCBPlayer,53,303,356,0,48,UCBPlayer
2580,UCBPlayer,56,291,347,0,51,UCBPlayer
2581,UCBPlayer,52,307,359,0,47,UCBPlayer
2582,UCBPlayer,59,314,373,2,43,UCBPlayer
2583,UCBPlayer,65,310,375,4,43,UCBPlayer
2584,UCBPlayer,70,295,365,3,46,UCBPlayer
2585,UCBPlayer,48,323,371,0,43,UCBPlayer
2586,UCBPlayer,64,319,383,3,40,UCBPlayer
2587,UCBPlayer,58,293,351,1,50,UCBPlayer
2588,UCBPlayer,88,258,346,5,53,UCBPlayer
2589,UCBPlayer,57,297,354,1,49,UCBPlayer
2590,UCBPlayer,61,311,372,1,43,UCBPlayer
2591,UCBPlayer,53,313,366,1,45,UCBPlayer
2592,UCBPlayer,66,276,342,1,53,UCBPlayer
2593,UCBPlayer,49,319,368,0,44,UCBPlayer
2594,UCBPlayer,69,264,333,1,56,UCBPlayer
2595,UCBPlayer,53,303,356,0,48,UCBPlayer
2596,UCBPlayer,95,270,365,9,48,UCBPlayer
2597,UCBPlayer,45,335,380,0,40,UCBPlayer
2598,UCBPlayer,55,295,350,0,50,UCBPlayer
2599,UCBPlayer,53,298,351,1,50,UCBPlayer
2600,UCBPlayer,75,265,340,2,54,UCBPlayer
2601,UCBPlayer,58,283,341,0,53,UCBPlayer
2602,UCBPlayer,62,292,354,1,49,UCBPlayer
2603,UCBPlayer,58,283,341,0,53,UCBPlayer
2604,UCBPlayer,204,219,423,28,35,UCBPlayer
2605,UCBPlayer,54,299,353,0,49,UCBPlayer
2606,UCBPlayer,57,287,344,0,52,UCBPlayer
2607,UCBPlayer,60,275,335,0,55,UCBPlayer
2608,UCBPlayer,75,255,330,1,57,UCBPlayer
2609,UCBPlayer,103,258,361,8,49,UCBPlayer
2610,UCBPlayer,56,291,347,0,51,UCBPlayer
2611,UCBPlayer,54,299,353,0,49,UCBPlayer
2612,UCBPlayer,54,299,353,0,49,UCBPlayer
2613,UCBPlayer,49,319,368,0,44,UCBPlayer
2614,UCBPlayer,63,288,351,1,50,UCBPlayer
2615,UCBPlayer,58,283,341,0,53,UCBPlayer
2616,UCBPlayer,102,262,364,8,48,UCBPlayer
2617,UCBPlayer,63,263,326,0,58,UCBPlayer
2618,UCBPlayer,73,313,386,6,40,UCBPlayer
2619,UCBPlayer,49,319,368,0,44,UCBPlayer
2620,UCBPlayer,65,300,365,3,46,UCBPlayer
2621,UCBPlayer,62,292,354,1,49,UCBPlayer
2622,UCBPlayer,65,280,345,1,52,UCBPlayer
2623,UCBPlayer,56,291,347,0,51,UCBPlayer
2624,UCBPlayer,56,291,347,0,51,UCBPlayer
2625,UCBPlayer,53,303,356,0,48,UCBPlayer
2626,UCBPlayer,54,299,353,0,49,UCBPlayer
2627,UCBPlayer,57,287,344,0,52,UCBPlayer
2628,UCBPlayer,49,319,368,0,44,UCBPlayer
2629,UCBPlayer,81,276,357,4,49,UCBPlayer
2630,UCBPlayer,78,308,386,6,40,UCBPlayer
2631,UCBPlayer,50,315,365,0,45,UCBPlayer
2632,UCBPlayer,77,257,334,2,56,UCBPlayer
2633,UCBPlayer,59,279,338,0,54,UCBPlayer
2634,UCBPlayer,67,262,329,0,57,UCBPlayer
2635,UCBPlayer,59,309,368,3,45,UCBPlayer
2636,UCBPlayer,136,271,407,12,35,UCBPlayer
2637,UCBPlayer,54,299,353,0,49,UCBPlayer
2638,UCBPlayer,96,261,357,7,50,UCBPlayer
2639,UCBPlayer,72,287,359,3,48,UCBPlayer
2640,UCBPlayer,60,310,370,5,45,UCBPlayer
2641,UCBPlayer,73,293,366,4,46,UCBPlayer
2642,UCBPlayer,55,295,350,0,50,UCBPlayer
2643,UCBPlayer,53,303,356,0,48,UCBPlayer
2644,UCBPlayer,84,244,328,2,58,UCBPlayer
2645,UCBPlayer,49,319,368,0,44,UCBPlayer
2646,UCBPlayer,69,254,323,0,59,UCBPlayer
2647,UCBPlayer,48,323,371,0,43,UCBPlayer
2648,UCBPlayer,57,312,369,1,44,UCBPlayer
2649,UCBPlayer,49,319,368,0,44,UCBPlayer
2650,UCBPlayer,57,287,344,0,52,UCBPlayer
2651,UCBPlayer,54,284,338,0,54,UCBPlayer
2652,UCBPlayer,57,287,344,0,52,UCBPlayer
2653,UCBPlayer,54,299,353,0,49,UCBPlayer
2654,UCBPlayer,49,319,368,0,44,UCBPlayer
2655,UCBPlayer,69,294,363,4,47,UCBPlayer
2656,UCBPlayer,47,327,374,0,42,UCBPlayer
2657,UCBPlayer,64,284,348,1,51,UCBPlayer
2658,UCBPlayer,56,291,347,0,51,UCBPlayer
2659,UCBPlayer,60,275,335,0,55,UCBPlayer
2660,UCBPlayer,58,283,341,0,53,UCBPlayer
2661,UCBPlayer,55,295,350,0,50,UCBPlayer
2662,UCBPlayer,92,282,374,6,44,UCBPlayer
2663,UCBPlayer,61,271,332,0,56,UCBPlayer
2664,UCBPlayer,107,262,369,10,47,UCBPlayer
2665,UCBPlayer,55,305,360,1,47,UCBPlayer
2666,UCBPlayer,97,247,344,6,54,UCBPlayer
2667,UCBPlayer,77,297,374,6,44,UCBPlayer
2668,UCBPlayer,51,311,362,0,46,UCBPlayer
2669,UCBPlayer,202,242,444,28,28,UCBPlayer
2670,UCBPlayer,46,331,377,0,41,UCBPlayer
2671,UCBPlayer,81,296,377,6,43,UCBPlayer
2672,UCBPlayer,67,302,369,4,45,UCBPlayer
2673,UCBPlayer,57,287,344,0,52,UCBPlayer
2674,UCBPlayer,50,315,365,0,45,UCBPlayer
2675,UCBPlayer,62,322,384,4,40,UCBPlayer
2676,UCBPlayer,61,271,332,0,56,UCBPlayer
2677,UCBPlayer,51,311,362,0,46,UCBPlayer
2678,UCBPlayer,57,287,344,0,52,UCBPlayer
2679,UCBPlayer,82,247,329,3,58,UCBPlayer
2680,UCBPlayer,149,249,398,15,39,UCBPlayer
2681,UCBPlayer,70,275,345,1,52,UCBPlayer
2682,UCBPlayer,61,306,367,2,45,UCBPlayer
2683,UCBPlayer,50,315,365,0,45,UCBPlayer
2684,UCBPlayer,52,307,359,0,47,UCBPlayer
2685,UCBPlayer,49,319,368,0,44,UCBPlayer
2686,UCBPlayer,58,283,341,0,53,UCBPlayer
2687,UCBPlayer,64,294,358,2,48,UCBPlayer
2688,UCBPlayer,55,295,350,0,50,UCBPlayer
2689,UCBPlayer,51,311,362,0,46,UCBPlayer
2690,UCBPlayer,53,303,356,0,48,UCBPlayer
2691,UCBPlayer,58,293,351,1,50,UCBPlayer
2692,UCBPlayer,47,342,389,0,37,UCBPlayer
2693,UCBPlayer,54,299,353,0,49,UCBPlayer
2694,UCBPlayer,74,279,353,6,51,UCBPlayer
2695,UCBPlayer,67,297,364,2,46,UCBPlayer
2696,UCBPlayer,54,299,353,0,49,UCBPlayer
2697,UCBPlayer,53,323,376,2,42,UCBPlayer
2698,UCBPlayer,68,323,391,5,38,UCBPlayer
2699,UCBPlayer,73,308,381,4,41,UCBPlayer
2700,UCBPlayer,63,303,366,1,45,UCBPlayer
2701,UCBPlayer,79,289,368,6,46,UCBPlayer
2702,UCBPlayer,65,310,375,4,43,UCBPlayer
2703,UCBPlayer,63,308,371,3,44,UCBPlayer
2704,UCBPlayer,68,293,361,2,47,UCBPlayer
2705,UCBPlayer,55,295,350,0,50,UCBPlayer
2706,UCBPlayer,68,298,366,4,46,UCBPlayer
2707,UCBPlayer,64,284,348,1,51,UCBPlayer
2708,UCBPlayer,69,299,368,3,45,UCBPlayer
2709,UCBPlayer,63,308,371,3,44,UCBPlayer
2710,UCBPlayer,50,315,365,0,45,UCBPlayer
2711,UCBPlayer,49,339,388,2,38,UCBPlayer
2712,UCBPlayer,84,284,368,3,45,UCBPlayer
2713,UCBPlayer,49,319,368,0,44,UCBPlayer
2714,UCBPlayer,86,276,362,6,48,UCBPlayer
2715,UCBPlayer,51,311,362,0,46,UCBPlayer
2716,UCBPlayer,56,291,347,0,51,UCBPlayer
2717,UCBPlayer,59,279,338,0,54,UCBPlayer
2718,UCBPlayer,112,267,379,8,43,UCBPlayer
2719,UCBPlayer,53,303,356,0,48,UCBPlayer
2720,UCBPlayer,59,279,338,0,54,UCBPlayer
2721,UCBPlayer,63,263,326,0,58,UCBPlayer
2722,UCBPlayer,179,209,388,17,43,UCBPlayer
2723,UCBPlayer,45,335,380,0,40,UCBPlayer
2724,UCBPlayer,54,299,353,0,49,UCBPlayer
2725,UCBPlayer,57,287,344,0,52,UCBPlayer
2726,UCBPlayer,52,317,369,1,44,UCBPlayer
2727,UCBPlayer,124,259,383,9,42,UCBPlayer
2728,UCBPlayer,55,295,350,0,50,UCBPlayer
2729,UCBPlayer,47,327,374,0,42,UCBPlayer
2730,UCBPlayer,59,279,338,0,54,UCBPlayer
2731,UCBPlayer,60,275,335,0,55,UCBPlayer
2732,UCBPlayer,63,288,351,1,50,UCBPlayer
2733,UCBPlayer,61,306,367,2,45,UCBPlayer
2734,UCBPlayer,79,294,373,8,45,UCBPlayer
2735,UCBPlayer,89,279,368,6,46,UCBPlayer
2736,UCBPlayer,59,289,348,1,51,UCBPlayer
2737,UCBPlayer,78,253,331,2,57,UCBPlayer
2738,UCBPlayer,72,277,349,2,51,UCBPlayer
2739,UCBPlayer,63,313,376,5,43,UCBPlayer
2740,UCBPlayer,64,289,353,0,49,UCBPlayer
2741,UCBPlayer,60,285,345,1,52,UCBPlayer
2742,UCBPlayer,66,291,357,1,48,UCBPlayer
2743,UCBPlayer,50,315,365,0,45,UCBPlayer
2744,UCBPlayer,54,299,353,0,49,UCBPlayer
2745,UCBPlayer,46,331,377,0,41,UCBPlayer
2746,UCBPlayer,60,275,335,0,55,UCBPlayer
2747,UCBPlayer,78,293,371,9,46,UCBPlayer
2748,UCBPlayer,91,261,352,5,51,UCBPlayer
2749,UCBPlayer,95,285,380,9,43,UCBPlayer
2750,UCBPlayer,84,274,358,8,50,UCBPlayer
2751,UCBPlayer,65,290,355,2,49,UCBPlayer
2752,UCBPlayer,71,291,362,0,46,UCBPlayer
2753,UCBPlayer,52,292,344,0,52,UCBPlayer
2754,UCBPlayer,57,287,344,0,52,UCBPlayer
2755,UCBPlayer,46,331,377,0,41,UCBPlayer
2756,UCBPlayer,148,233,381,13,44,UCBPlayer
2757,UCBPlayer,66,296,362,3,47,UCBPlayer
2758,UCBPlayer,48,323,371,0,43,UCBPlayer
2759,UCBPlayer,47,327,374,0,42,UCBPlayer
2760,UCBPlayer,66,306,372,4,44,UCBPlayer
2761,UCBPlayer,64,284,348,1,51,UCBPlayer
2762,UCBPlayer,60,310,370,2,44,UCBPlayer
2763,UCBPlayer,66,266,332,0,56,UCBPlayer
2764,UCBPlayer,67,272,339,1,54,UCBPlayer
2765,UCBPlayer,65,280,345,1,52,UCBPlayer
2766,UCBPlayer,163,258,421,23,34,UCBPlayer
2767,UCBPlayer,47,327,374,0,42,UCBPlayer
2768,UCBPlayer,154,254,408,19,37,UCBPlayer
2769,UCBPlayer,63,288,351,1,50,UCBPlayer
2770,UCBPlayer,84,289,373,5,44,UCBPlayer
2771,UCBPlayer,70,295,365,3,46,UCBPlayer
2772,UCBPlayer,121,256,377,9,44,UCBPlayer
2773,UCBPlayer,58,283,341,0,53,UCBPlayer
2774,UCBPlayer,59,304,363,1,46,UCBPlayer
2775,UCBPlayer,54,299,353,0,49,UCBPlayer
2776,UCBPlayer,73,288,361,5,48,UCBPlayer
2777,UCBPlayer,58,283,341,0,53,UCBPlayer
2778,UCBPlayer,53,303,356,0,48,UCBPlayer
2779,UCBPlayer,68,278,346,2,52,UCBPlayer
2780,UCBPlayer,90,255,345,4,53,UCBPlayer
2781,UCBPlayer,99,324,423,13,30,UCBPlayer
2782,UCBPlayer,72,287,359,3,48,UCBPlayer
2783,UCBPlayer,128,253,381,10,43,UCBPlayer
2784,UCBPlayer,55,315,370,2,44,UCBPlayer
2785,UCBPlayer,78,278,356,3,49,UCBPlayer
2786,UCBPlayer,55,295,350,0,50,UCBPlayer
2787,UCBPlayer,157,212,369,13,48,UCBPlayer
2788,UCBPlayer,60,275,335,0,55,UCBPlayer
2789,UCBPlayer,73,288,361,5,48,UCBPlayer
2790,UCBPlayer,52,327,379,2,41,UCBPlayer
2791,UCBPlayer,61,296,357,1,48,UCBPlayer
2792,UCBPlayer,54,309,363,1,46,UCBPlayer
2793,UCBPlayer,60,290,350,0,50,UCBPlayer
2794,UCBPlayer,62,267,329,0,57,UCBPlayer
2795,UCBPlayer,56,291,347,0,51,UCBPlayer
2796,UCBPlayer,50,315,365,0,45,UCBPlayer
2797,UCBPlayer,83,298,381,7,42,UCBPlayer
2798,UCBPlayer,85,295,380,6,42,UCBPlayer
2799,UCBPlayer,83,268,351,7,52,UCBPlayer
2800,UCBPlayer,66,301,367,2,45,UCBPlayer
2801,UCBPlayer,63,308,371,3,44,UCBPlayer
2802,UCBPlayer,62,272,334,2,56,UCBPlayer
2803,UCBPlayer,61,296,357,1,48,UCBPlayer
2804,UCBPlayer,60,290,350,0,50,UCBPlayer
2805,UCBPlayer,54,324,378,1,41,UCBPlayer
2806,UCBPlayer,71,246,317,0,61,UCBPlayer
2807,UCBPlayer,50,315,365,0,45,UCBPlayer
2808,UCBPlayer,44,339,383,0,39,UCBPlayer
2809,UCBPlayer,64,284,348,1,51,UCBPlayer
2810,UCBPlayer,53,303,356,0,48,UCBPlayer
2811,UCBPlayer,54,299,353,0,49,UCBPlayer
2812,UCBPlayer,92,242,334,5,57,UCBPlayer
2813,UCBPlayer,60,275,335,0,55,UCBPlayer
2814,UCBPlayer,58,308,366,1,45,UCBPlayer
2815,UCBPlayer,119,264,383,12,43,UCBPlayer
2816,UCBPlayer,102,292,394,8,38,UCBPlayer
2817,UCBPlayer,109,259,368,9,47,UCBPlayer
2818,UCBPlayer,57,287,344,0,52,UCBPlayer
2819,UCBPlayer,78,253,331,2,57,UCBPlayer
2820,UCBPlayer,94,269,363,7,48,UCBPlayer
2821,UCBPlayer,48,323,371,0,43,UCBPlayer
2822,UCBPlayer,55,295,350,0,50,UCBPlayer
2823,UCBPlayer,67,282,349,2,51,UCBPlayer
2824,UCBPlayer,54,299,353,0,49,UCBPlayer
2825,UCBPlayer,53,303,356,0,48,UCBPlayer
2826,UCBPlayer,57,287,344,0,52,UCBPlayer
2827,UCBPlayer,69,279,348,1,51,UCBPlayer
2828,UCBPlayer,73,283,356,3,49,UCBPlayer
2829,UCBPlayer,63,293,356,3,49,UCBPlayer
2830,UCBPlayer,60,290,350,0,50,UCBPlayer
2831,UCBPlayer,68,268,336,1,55,UCBPlayer
2832,UCBPlayer,72,287,359,3,48,UCBPlayer
2833,UCBPlayer,66,301,367,2,45,UCBPlayer
2834,UCBPlayer,58,318,376,5,43,UCBPlayer
2835,UCBPlayer,57,317,374,0,42,UCBPlayer
2836,UCBPlayer,60,300,360,1,47,UCBPlayer
2837,UCBPlayer,71,266,337,2,55,UCBPlayer
2838,UCBPlayer,71,296,367,5,46,UCBPlayer
2839,UCBPlayer,59,304,363,1,46,UCBPlayer
2840,UCBPlayer,65,290,355,2,49,UCBPlayer
2841,UCBPlayer,62,287,349,2,51,UCBPlayer
2842,UCBPlayer,93,283,376,8,44,UCBPlayer
2843,UCBPlayer,70,320,390,4,38,UCBPlayer
2844,UCBPlayer,59,279,338,0,54,UCBPlayer
2845,UCBPlayer,54,299,353,0,49,UCBPlayer
2846,UCBPlayer,48,323,371,0,43,UCBPlayer
2847,UCBPlayer,65,305,370,2,44,UCBPlayer
2848,UCBPlayer,58,283,341,0,53,UCBPlayer
2849,UCBPlayer,52,307,359,0,47,UCBPlayer
2850,UCBPlayer,51,311,362,0,46,UCBPlayer
2851,UCBPlayer,50,335,385,2,39,UCBPlayer
2852,UCBPlayer,63,278,341,0,53,UCBPlayer
2853,UCBPlayer,64,284,348,1,51,UCBPlayer
2854,UCBPlayer,56,291,347,0,51,UCBPlayer
2855,UCBPlayer,54,284,338,0,54,UCBPlayer
2856,UCBPlayer,98,263,361,8,49,UCBPlayer
2857,UCBPlayer,61,316,377,3,42,UCBPlayer
2858,UCBPlayer,74,279,353,3,50,UCBPlayer
2859,UCBPlayer,88,278,366,7,47,UCBPlayer
2860,UCBPlayer,51,311,362,0,46,UCBPlayer
2861,UCBPlayer,54,299,353,0,49,UCBPlayer
2862,UCBPlayer,63,288,351,1,50,UCBPlayer
2863,UCBPlayer,66,296,362,3,47,UCBPlayer
2864,UCBPlayer,65,290,355,2,49,UCBPlayer
2865,UCBPlayer,70,290,360,4,48,UCBPlayer
2866,UCBPlayer,73,288,361,5,48,UCBPlayer
2867,UCBPlayer,71,281,352,2,50,UCBPlayer
2868,UCBPlayer,61,271,332,0,56,UCBPlayer
2869,UCBPlayer,57,312,369,1,44,UCBPlayer
2870,UCBPlayer,51,311,362,0,46,UCBPlayer
2871,UCBPlayer,84,279,363,4,47,UCBPlayer
2872,UCBPlayer,79,279,358,5,49,UCBPlayer
2873,UCBPlayer,58,308,366,1,45,UCBPlayer
2874,UCBPlayer,50,340,390,1,37,UCBPlayer
2875,UCBPlayer,113,288,401,15,38,UCBPlayer
2876,UCBPlayer,51,311,362,0,46,UCBPlayer
2877,UCBPlayer,63,288,351,1,50,UCBPlayer
2878,UCBPlayer,73,278,351,4,51,UCBPlayer
2879,UCBPlayer,53,328,381,1,40,UCBPlayer
2880,UCBPlayer,50,315,365,0,45,UCBPlayer
2881,UCBPlayer,64,259,323,0,59,UCBPlayer
2882,UCBPlayer,90,290,380,6,42,UCBPlayer
2883,UCBPlayer,56,291,347,0,51,UCBPlayer
2884,UCBPlayer,70,340,410,6,32,UCBPlayer
2885,UCBPlayer,56,291,347,0,51,UCBPlayer
2886,UCBPlayer,59,304,363,1,46,UCBPlayer
2887,UCBPlayer,63,303,366,4,46,UCBPlayer
2888,UCBPlayer,78,278,356,3,49,UCBPlayer
2889,UCBPlayer,61,271,332,0,56,UCBPlayer
2890,UCBPlayer,56,291,347,0,51,UCBPlayer
2891,UCBPlayer,79,289,368,6,46,UCBPlayer
2892,UCBPlayer,79,289,368,3,45,UCBPlayer
2893,UCBPlayer,60,295,355,2,49,UCBPlayer
2894,UCBPlayer,65,270,335,0,55,UCBPlayer
2895,UCBPlayer,63,263,326,0,58,UCBPlayer
2896,UCBPlayer,89,299,388,8,40,UCBPlayer
2897,UCBPlayer,62,282,344,0,52,UCBPlayer
2898,UCBPlayer,58,303,361,2,47,UCBPlayer
2899,UCBPlayer,47,342,389,0,37,UCBPlayer
2900,UCBPlayer,54,299,353,0,49,UCBPlayer
2901,UCBPlayer,47,322,369,1,44,UCBPlayer
2902,UCBPlayer,69,309,378,4,42,UCBPlayer
2903,UCBPlayer,57,312,369,1,44,UCBPlayer
2904,UCBPlayer,62,277,339,1,54,UCBPlayer
2905,UCBPlayer,66,286,352,2,50,UCBPlayer
2906,UCBPlayer,56,276,332,0,56,UCBPlayer
2907,UCBPlayer,136,226,362,9,49,UCBPlayer
2908,UCBPlayer,47,327,374,0,42,UCBPlayer
2909,UCBPlayer,65,270,335,0,55,UCBPlayer
2910,UCBPlayer,54,299,353,0,49,UCBPlayer
2911,UCBPlayer,73,308,381,7,42,UCBPlayer
2912,UCBPlayer,48,323,371,0,43,UCBPlayer
2913,UCBPlayer,55,295,350,0,50,UCBPlayer
2914,UCBPlayer,76,271,347,3,52,UCBPlayer
2915,UCBPlayer,122,252,374,9,45,UCBPlayer
2916,UCBPlayer,68,288,356,3,49,UCBPlayer
2917,UCBPlayer,55,295,350,0,50,UCBPlayer
2918,UCBPlayer,68,258,326,0,58,UCBPlayer
2919,UCBPlayer,79,249,328,2,58,UCBPlayer
2920,UCBPlayer,53,303,356,0,48,UCBPlayer
2921,UCBPlayer,60,275,335,0,55,UCBPlayer
2922,UCBPlayer,82,287,369,4,45,UCBPlayer
2923,UCBPlayer,74,264,338,3,55,UCBPlayer
2924,UCBPlayer,51,311,362,0,46,UCBPlayer
2925,UCBPlayer,60,300,360,1,47,UCBPlayer
2926,UCBPlayer,59,324,383,3,40,UCBPlayer
2927,UCBPlayer,49,319,368,0,44,UCBPlayer
2928,UCBPlayer,56,291,347,0,51,UCBPlayer
2929,UCBPlayer,72,282,354,4,50,UCBPlayer
2930,UCBPlayer,49,319,368,0,44,UCBPlayer
2931,UCBPlayer,54,299,353,0,49,UCBPlayer
2932,UCBPlayer,191,266,457,29,24,UCBPlayer
2933,UCBPlayer,98,273,371,6,45,UCBPlayer
2934,UCBPlayer,59,319,378,4,42,UCBPlayer
2935,UCBPlayer,56,306,362,0,46,UCBPlayer
2936,UCBPlayer,58,283,341,0,53,UCBPlayer
2937,UCBPlayer,48,333,381,1,40,UCBPlayer
2938,UCBPlayer,70,300,370,5,45,UCBPlayer
2939,UCBPlayer,72,287,359,3,48,UCBPlayer
2940,UCBPlayer,58,283,341,0,53,UCBPlayer
2941,UCBPlayer,58,308,366,1,45,UCBPlayer
2942,UCBPlayer,75,290,365,3,46,UCBPlayer
2943,UCBPlayer,50,315,365,0,45,UCBPlayer
2944,UCBPlayer,54,319,373,2,43,UCBPlayer
2945,UCBPlayer,65,290,355,2,49,UCBPlayer
2946,UCBPlayer,57,312,369,1,44,UCBPlayer
2947,UCBPlayer,61,271,332,0,56,UCBPlayer
2948,UCBPlayer,46,331,377,0,41,UCBPlayer
2949,UCBPlayer,62,267,329,0,57,UCBPlayer
2950,UCBPlayer,53,303,356,0,48,UCBPlayer
2951,UCBPlayer,72,312,384,4,40,UCBPlayer
2952,UCBPlayer,52,307,359,0,47,UCBPlayer
2953,UCBPlayer,50,320,370,2,44,UCBPlayer
2954,UCBPlayer,79,274,353,3,50,UCBPlayer
2955,UCBPlayer,55,295,350,0,50,UCBPlayer
2956,UCBPlayer,56,291,347,0,51,UCBPlayer
2957,UCBPlayer,49,304,353,0,49,UCBPlayer
2958,UCBPlayer,78,283,361,5,48,UCBPlayer
2959,UCBPlayer,57,287,344,0,52,UCBPlayer
2960,UCBPlayer,57,287,344,0,52,UCBPlayer
2961,UCBPlayer,61,296,357,1,48,UCBPlayer
2962,UCBPlayer,52,307,359,0,47,UCBPlayer
2963,UCBPlayer,70,275,345,1,52,UCBPlayer
2964,UCBPlayer,59,279,338,0,54,UCBPlayer
2965,UCBPlayer,64,294,358,2,48,UCBPlayer
2966,UCBPlayer,49,344,393,1,36,UCBPlayer
2967,UCBPlayer,52,307,359,0,47,UCBPlayer
2968,UCBPlayer,55,295,350,0,50,UCBPlayer
2969,UCBPlayer,110,260,370,8,46,UCBPlayer
2970,UCBPlayer,65,300,365,3,46,UCBPlayer
2971,UCBPlayer,54,299,353,0,49,UCBPlayer
2972,UCBPlayer,89,264,353,6,51,UCBPlayer
2973,UCBPlayer,93,268,361,5,48,UCBPlayer
2974,UCBPlayer,54,299,353,0,49,UCBPlayer
2975,UCBPlayer,54,299,353,0,49,UCBPlayer
2976,UCBPlayer,65,280,345,1,52,UCBPlayer
2977,UCBPlayer,84,274,358,5,49,UCBPlayer
2978,UCBPlayer,55,310,365,0,45,UCBPlayer
2979,UCBPlayer,51,311,362,0,46,UCBPlayer
2980,UCBPlayer,76,236,312,1,63,UCBPlayer
2981,UCBPlayer,52,317,369,1,44,UCBPlayer
2982,UCBPlayer,75,280,355,2,49,UCBPlayer
2983,UCBPlayer,51,311,362,0,46,UCBPlayer
2984,UCBPlayer,54,309,363,1,46,UCBPlayer
2985,UCBPlayer,71,301,372,4,44,UCBPlayer
2986,UCBPlayer,71,286,357,4,49,UCBPlayer
2987,UCBPlayer,47,347,394,2,36,UCBPlayer
2988,UCBPlayer,55,330,385,2,39,UCBPlayer
2989,UCBPlayer,71,296,367,5,46,UCBPlayer
2990,UCBPlayer,94,274,368,9,47,UCBPlayer
2991,UCBPlayer,75,295,370,5,45,UCBPlayer
2992,UCBPlayer,55,305,360,1,47,UCBPlayer
2993,UCBPlayer,47,327,374,0,42,UCBPlayer
2994,UCBPlayer,70,270,340,2,54,UCBPlayer
2995,UCBPlayer,66,301,367,2,45,UCBPlayer
2996,UCBPlayer,55,295,350,0,50,UCBPlayer
2997,UCBPlayer,56,301,357,1,48,UCBPlayer
2998,UCBPlayer,58,298,356,0,48,UCBPlayer
2999,UCBPlayer,81,261,342,4,54,UCBPlayer
3000,UCBPlayer,65,265,330,1,57,UCBPlayer
3001,UCBPlayer,61,301,362,0,46,UCBPlayer
3002,UCBPlayer,51,311,362,0,46,UCBPlayer
3003,UCBPlayer,70,285,355,2,49,UCBPlayer
3004,UCBPlayer,62,267,329,0,57,UCBPlayer
3005,UCBPlayer,53,318,371,3,44,UCBPlayer
3006,UCBPlayer,85,250,335,3,56,UCBPlayer
3007,UCBPlayer,66,301,367,2,45,UCBPlayer
3008,UCBPlayer,73,308,381,7,42,UCBPlayer
3009,UCBPlayer,62,312,374,3,43,UCBPlayer
3010,UCBPlayer,71,296,367,5,46,UCBPlayer
3011,UCBPlayer,61,296,357,1,48,UCBPlayer
3012,UCBPlayer,66,286,352,2,50,UCBPlayer
3013,UCBPlayer,49,319,368,0,44,UCBPlayer
3014,UCBPlayer,94,269,363,7,48,UCBPlayer
3015,UCBPlayer,54,324,378,1,41,UCBPlayer
3016,UCBPlayer,48,323,371,0,43,UCBPlayer
3017,UCBPlayer,65,310,375,4,43,UCBPlayer
3018,UCBPlayer,81,276,357,4,49,UCBPlayer
3019,UCBPlayer,92,287,379,8,43,UCBPlayer
3020,UCBPlayer,52,307,359,0,47,UCBPlayer
3021,UCBPlayer,66,296,362,3,47,UCBPlayer
3022,UCBPlayer,52,307,359,0,47,UCBPlayer
3023,UCBPlayer,52,307,359,0,47,UCBPlayer
3024,UCBPlayer,72,322,394,5,37,UCBPlayer
3025,UCBPlayer,54,299,353,0,49,UCBPlayer
3026,UCBPlayer,63,288,351,1,50,UCBPlayer
3027,UCBPlayer,80,275,355,5,50,UCBPlayer
3028,UCBPlayer,78,263,341,3,54,UCBPlayer
3029,UCBPlayer,55,295,350,0,50,UCBPlayer
3030,UCBPlayer,58,283,341,0,53,UCBPlayer
3031,UCBPlayer,58,283,341,0,53,UCBPlayer
3032,UCBPlayer,45,335,380,0,40,UCBPlayer
3033,UCBPlayer,54,299,353,0,49,UCBPlayer
3034,UCBPlayer,46,341,387,1,38,UCBPlayer
3035,UCBPlayer,70,275,345,1,52,UCBPlayer
3036,UCBPlayer,99,279,378,10,44,UCBPlayer
3037,UCBPlayer,86,261,347,3,52,UCBPlayer
3038,UCBPlayer,54,299,353,0,49,UCBPlayer
3039,UCBPlayer,51,311,362,0,46,UCBPlayer
3040,UCBPlayer,69,294,363,4,47,UCBPlayer
3041,UCBPlayer,69,299,368,3,45,UCBPlayer
3042,UCBPlayer,64,294,358,2,48,UCBPlayer
3043,UCBPlayer,60,300,360,1,47,UCBPlayer
3044,UCBPlayer,76,261,337,2,55,UCBPlayer
3045,UCBPlayer,62,267,329,0,57,UCBPlayer
3046,UCBPlayer,75,295,370,8,46,UCBPlayer
3047,UCBPlayer,94,269,363,7,48,UCBPlayer
3048,UCBPlayer,81,316,397,8,37,UCBPlayer
3049,UCBPlayer,102,252,354,4,50,UCBPlayer
3050,UCBPlayer,65,280,345,1,52,UCBPlayer
3051,UCBPlayer,67,262,329,0,57,UCBPlayer
3052,UCBPlayer,49,319,368,0,44,UCBPlayer
3053,UCBPlayer,70,270,340,2,54,UCBPlayer
3054,UCBPlayer,81,271,352,2,50,UCBPlayer
3055,UCBPlayer,71,271,342,4,54,UCBPlayer
3056,UCBPlayer,121,251,372,13,47,UCBPlayer
3057,UCBPlayer,54,299,353,0,49,UCBPlayer
3058,UCBPlayer,54,299,353,0,49,UCBPlayer
3059,UCBPlayer,60,275,335,0,55,UCBPlayer
3060,UCBPlayer,60,275,335,0,55,UCBPlayer
3061,UCBPlayer,52,307,359,0,47,UCBPlayer
3062,UCBPlayer,70,295,365,3,46,UCBPlayer
3063,UCBPlayer,56,291,347,0,51,UCBPlayer
3064,UCBPlayer,56,291,347,0,51,UCBPlayer
3065,UCBPlayer,53,303,356,0,48,UCBPlayer
3066,UCBPlayer,55,295,350,0,50,UCBPlayer
3067,UCBPlayer,46,331,377,0,41,UCBPlayer
3068,UCBPlayer,56,291,347,0,51,UCBPlayer
3069,UCBPlayer,79,249,328,2,58,UCBPlayer
3070,UCBPlayer,66,306,372,4,44,UCBPlayer
3071,UCBPlayer,82,267,349,5,52,UCBPlayer
3072,UCBPlayer,75,295,370,5,45,UCBPlayer
3073,UCBPlayer,51,321,372,1,43,UCBPlayer
3074,UCBPlayer,55,330,385,2,39,UCBPlayer
3075,UCBPlayer,59,279,338,0,54,UCBPlayer
3076,UCBPlayer,58,308,366,1,45,UCBPlayer
3077,UCBPlayer,66,296,362,3,47,UCBPlayer
3078,UCBPlayer,66,286,352,2,50,UCBPlayer
3079,UCBPlayer,48,323,371,0,43,UCBPlayer
3080,UCBPlayer,129,249,378,13,45,UCBPlayer
3081,UCBPlayer,60,315,375,1,42,UCBPlayer
3082,UCBPlayer,55,295,350,0,50,UCBPlayer
3083,UCBPlayer,53,303,356,0,48,UCBPlayer
3084,UCBPlayer,77,287,364,5,47,UCBPlayer
3085,UCBPlayer,59,279,338,0,54,UCBPlayer
3086,UCBPlayer,61,286,347,0,51,UCBPlayer
3087,UCBPlayer,51,321,372,1,43,UCBPlayer
3088,UCBPlayer,118,283,401,15,38,UCBPlayer
3089,UCBPlayer,59,289,348,1,51,UCBPlayer
3090,UCBPlayer,76,251,327,1,58,UCBPlayer
3091,UCBPlayer,52,307,359,0,47,UCBPlayer
3092,UCBPlayer,75,310,385,5,40,UCBPlayer
3093,UCBPlayer,54,299,353,0,49,UCBPlayer
3094,UCBPlayer,133,268,401,18,39,UCBPlayer
3095,UCBPlayer,127,242,369,7,46,UCBPlayer
3096,UCBPlayer,55,305,360,1,47,UCBPlayer
3097,UCBPlayer,58,298,356,0,48,UCBPlayer
3098,UCBPlayer,56,291,347,0,51,UCBPlayer
3099,UCBPlayer,55,295,350,0,50,UCBPlayer
3100,UCBPlayer,57,287,344,0,52,UCBPlayer
3101,UCBPlayer,53,303,356,0,48,UCBPlayer
3102,UCBPlayer,55,305,360,1,47,UCBPlayer
3103,UCBPlayer,59,304,363,1,46,UCBPlayer
3104,UCBPlayer,57,287,344,0,52,UCBPlayer
3105,UCBPlayer,54,299,353,0,49,UCBPlayer
3106,UCBPlayer,57,297,354,1,49,UCBPlayer
3107,UCBPlayer,66,286,352,2,50,UCBPlayer
3108,UCBPlayer,56,291,347,0,51,UCBPlayer
3109,UCBPlayer,45,330,375,1,42,UCBPlayer
3110,UCBPlayer,71,276,347,3,52,UCBPlayer
3111,UCBPlayer,45,335,380,0,40,UCBPlayer
3112,UCBPlayer,72,252,324,1,59,UCBPlayer
3113,UCBPlayer,58,308,366,1,45,UCBPlayer
3114,UCBPlayer,57,322,379,2,41,UCBPlayer
3115,UCBPlayer,57,287,344,0,52,UCBPlayer
3116,UCBPlayer,60,320,380,3,41,UCBPlayer
3117,UCBPlayer,64,309,373,2,43,UCBPlayer
3118,UCBPlayer,82,272,354,4,50,UCBPlayer
3119,UCBPlayer,67,292,359,3,48,UCBPlayer
3120,UCBPlayer,53,303,356,0,48,UCBPlayer
3121,UCBPlayer,98,278,376,11,45,UCBPlayer
3122,UCBPlayer,54,299,353,0,49,UCBPlayer
3123,UCBPlayer,59,279,338,0,54,UCBPlayer
3124,UCBPlayer,59,279,338,0,54,UCBPlayer
3125,UCBPlayer,65,290,355,2,49,UCBPlayer
3126,UCBPlayer,56,306,362,0,46,UCBPlayer
3127,UCBPlayer,50,315,365,0,45,UCBPlayer
3128,UCBPlayer,50,315,365,0,45,UCBPlayer
3129,UCBPlayer,60,310,370,2,44,UCBPlayer
3130,UCBPlayer,74,284,358,2,48,UCBPlayer
3131,UCBPlayer,65,305,370,2,44,UCBPlayer
3132,UCBPlayer,52,317,369,1,44,UCBPlayer
3133,UCBPlayer,77,297,374,6,44,UCBPlayer
3134,UCBPlayer,100,235,335,6,57,UCBPlayer
3135,UCBPlayer,82,277,359,3,48,UCBPlayer
3136,UCBPlayer,93,278,371,9,46,UCBPlayer
3137,UCBPlayer,54,309,363,1,46,UCBPlayer
3138,UCBPlayer,60,290,350,0,50,UCBPlayer
3139,UCBPlayer,49,319,368,0,44,UCBPlayer
3140,UCBPlayer,54,299,353,0,49,UCBPlayer
3141,UCBPlayer,77,302,379,8,43,UCBPlayer
3142,UCBPlayer,78,298,376,5,43,UCBPlayer
3143,UCBPlayer,54,299,353,0,49,UCBPlayer
3144,UCBPlayer,52,307,359,0,47,UCBPlayer
3145,UCBPlayer,65,295,360,1,47,UCBPlayer
3146,UCBPlayer,54,299,353,0,49,UCBPlayer
3147,UCBPlayer,52,327,379,2,41,UCBPlayer
3148,UCBPlayer,97,262,359,9,50,UCBPlayer
3149,UCBPlayer,54,319,373,2,43,UCBPlayer
3150,UCBPlayer,65,290,355,2,49,UCBPlayer
3151,UCBPlayer,62,292,354,1,49,UCBPlayer
3152,UCBPlayer,69,264,333,1,56,UCBPlayer
3153,UCBPlayer,53,303,356,0,48,UCBPlayer
3154,UCBPlayer,56,291,347,0,51,UCBPlayer
3155,UCBPlayer,54,309,363,1,46,UCBPlayer
3156,UCBPlayer,67,272,339,1,54,UCBPlayer
3157,UCBPlayer,74,269,343,2,53,UCBPlayer
3158,UCBPlayer,46,331,377,0,41,UCBPlayer
3159,UCBPlayer,58,288,346,2,52,UCBPlayer
3160,UCBPlayer,65,300,365,3,46,UCBPlayer
3161,UCBPlayer,159,234,393,16,41,UCBPlayer
3162,UCBPlayer,75,285,360,4,48,UCBPlayer
3163,UCBPlayer,56,291,347,0,51,UCBPlayer
3164,UCBPlayer,52,307,359,0,47,UCBPlayer
3165,UCBPlayer,96,276,372,10,46,UCBPlayer
3166,UCBPlayer,63,278,341,0,53,UCBPlayer
3167,UCBPlayer,41,351,392,0,36,UCBPlayer
3168,UCBPlayer,60,275,335,0,55,UCBPlayer
3169,UCBPlayer,57,287,344,0,52,UCBPlayer
3170,UCBPlayer,50,315,365,0,45,UCBPlayer
3171,UCBPlayer,58,308,366,1,45,UCBPlayer
3172,UCBPlayer,81,296,377,6,43,UCBPlayer
3173,UCBPlayer,55,295,350,0,50,UCBPlayer
3174,UCBPlayer,52,307,359,0,47,UCBPlayer
3175,UCBPlayer,63,263,326,0,58,UCBPlayer
3176,UCBPlayer,56,291,347,0,51,UCBPlayer
3177,UCBPlayer,66,266,332,0,56,UCBPlayer
3178,UCBPlayer,58,283,341,0,53,UCBPlayer
3179,UCBPlayer,42,347,389,0,37,UCBPlayer
3180,UCBPlayer,52,307,359,0,47,UCBPlayer
3181,UCBPlayer,48,323,371,0,43,UCBPlayer
3182,UCBPlayer,47,327,374,0,42,UCBPlayer
3183,UCBPlayer,59,279,338,0,54,UCBPlayer
3184,UCBPlayer,60,275,335,0,55,UCBPlayer
3185,UCBPlayer,50,315,365,0,45,UCBPlayer
3186,UCBPlayer,66,296,362,3,47,UCBPlayer
3187,UCBPlayer,62,302,364,2,46,UCBPlayer
3188,UCBPlayer,141,236,377,12,45,UCBPlayer
3189,UCBPlayer,53,303,356,0,48,UCBPlayer
3190,UCBPlayer,55,295,350,0,50,UCBPlayer
3191,UCBPlayer,47,327,374,0,42,UCBPlayer
3192,UCBPlayer,65,310,375,4,43,UCBPlayer
3193,UCBPlayer,54,299,353,0,49,UCBPlayer
3194,UCBPlayer,61,296,357,1,48,UCBPlayer
3195,UCBPlayer,56,291,347,0,51,UCBPlayer
3196,UCBPlayer,47,327,374,0,42,UCBPlayer
3197,UCBPlayer,45,335,380,0,40,UCBPlayer
3198,UCBPlayer,53,313,366,1,45,UCBPlayer
3199,UCBPlayer,51,311,362,0,46,UCBPlayer
3200,UCBPlayer,48,343,391,2,37,UCBPlayer
3201,UCBPlayer,75,265,340,2,54,UCBPlayer
3202,UCBPlayer,62,282,344,0,52,UCBPlayer
3203,UCBPlayer,68,263,331,2,57,UCBPlayer
3204,UCBPlayer,54,324,378,1,41,UCBPlayer
3205,UCBPlayer,52,307,359,0,47,UCBPlayer
3206,UCBPlayer,58,283,341,0,53,UCBPlayer
3207,UCBPlayer,49,319,368,0,44,UCBPlayer
3208,UCBPlayer,63,283,346,2,52,UCBPlayer
3209,UCBPlayer,67,297,364,5,47,UCBPlayer
3210,UCBPlayer,129,234,363,10,49,UCBPlayer
3211,UCBPlayer,91,306,397,5,36,UCBPlayer
3212,UCBPlayer,54,284,338,0,54,UCBPlayer
3213,UCBPlayer,68,268,336,1,55,UCBPlayer
3214,UCBPlayer,65,290,355,2,49,UCBPlayer
3215,UCBPlayer,60,310,370,2,44,UCBPlayer
3216,UCBPlayer,69,294,363,4,47,UCBPlayer
3217,UCBPlayer,160,250,410,21,37,UCBPlayer
3218,UCBPlayer,53,303,356,0,48,UCBPlayer
3219,UCBPlayer,59,314,373,2,43,UCBPlayer
3220,UCBPlayer,50,315,365,0,45,UCBPlayer
3221,UCBPlayer,88,278,366,7,47,UCBPlayer
3222,UCBPlayer,65,255,320,0,60,UCBPlayer
3223,UCBPlayer,56,291,347,0,51,UCBPlayer
3224,UCBPlayer,57,287,344,0,52,UCBPlayer
3225,UCBPlayer,93,278,371,6,45,UCBPlayer
3226,UCBPlayer,167,267,434,21,29,UCBPlayer
3227,UCBPlayer,41,351,392,0,36,UCBPlayer
3228,UCBPlayer,52,307,359,0,47,UCBPlayer
3229,UCBPlayer,52,307,359,0,47,UCBPlayer
3230,UCBPlayer,52,307,359,0,47,UCBPlayer
3231,UCBPlayer,91,281,372,7,45,UCBPlayer
3232,UCBPlayer,61,316,377,3,42,UCBPlayer
3233,UCBPlayer,53,303,356,0,48,UCBPlayer
3234,UCBPlayer,63,298,361,2,47,UCBPlayer
3235,UCBPlayer,62,302,364,2,46,UCBPlayer
3236,UCBPlayer,63,278,341,0,53,UCBPlayer
3237,UCBPlayer,48,323,371,0,43,UCBPlayer
3238,UCBPlayer,51,321,372,1,43,UCBPlayer
3239,UCBPlayer,70,280,350,3,51,UCBPlayer
3240,UCBPlayer,48,323,371,0,43,UCBPlayer
3241,UCBPlayer,59,289,348,1,51,UCBPlayer
3242,UCBPlayer,56,306,362,0,46,UCBPlayer
3243,UCBPlayer,58,298,356,0,48,UCBPlayer
3244,UCBPlayer,66,276,342,1,53,UCBPlayer
3245,UCBPlayer,72,242,314,0,62,UCBPlayer
3246,UCBPlayer,66,276,342,1,53,UCBPlayer
3247,UCBPlayer,50,315,365,0,45,UCBPlayer
3248,UCBPlayer,56,291,347,0,51,UCBPlayer
3249,UCBPlayer,58,283,341,0,53,UCBPlayer
3250,UCBPlayer,51,311,362,0,46,UCBPlayer
3251,UCBPlayer,58,283,341,0,53,UCBPlayer
3252,UCBPlayer,70,250,320,0,60,UCBPlayer
3253,UCBPlayer,55,315,370,2,44,UCBPlayer
3254,UCBPlayer,55,310,365,0,45,UCBPlayer
3255,UCBPlayer,55,295,350,0,50,UCBPlayer
3256,UCBPlayer,64,309,373,2,43,UCBPlayer
3257,UCBPlayer,59,279,338,0,54,UCBPlayer
3258,UCBPlayer,57,302,359,3,48,UCBPlayer
3259,UCBPlayer,83,273,356,3,49,UCBPlayer
3260,UCBPlayer,88,238,326,3,59,UCBPlayer
3261,UCBPlayer,57,312,369,1,44,UCBPlayer
3262,UCBPlayer,55,290,345,1,52,UCBPlayer
3263,UCBPlayer,54,314,368,0,44,UCBPlayer
3264,UCBPlayer,69,274,343,2,53,UCBPlayer
3265,UCBPlayer,59,279,338,0,54,UCBPlayer
3266,UCBPlayer,91,246,337,2,55,UCBPlayer
3267,UCBPlayer,57,312,369,1,44,UCBPlayer
3268,UCBPlayer,63,313,376,2,42,UCBPlayer
3269,UCBPlayer,52,307,359,0,47,UCBPlayer
3270,UCBPlayer,60,300,360,1,47,UCBPlayer
3271,UCBPlayer,51,311,362,0,46,UCBPlayer
3272,UCBPlayer,76,251,327,1,58,UCBPlayer
3273,UCBPlayer,53,303,356,0,48,UCBPlayer
3274,UCBPlayer,67,292,359,3,48,UCBPlayer
3275,UCBPlayer,70,275,345,1,52,UCBPlayer
3276,UCBPlayer,59,314,373,2,43,UCBPlayer
3277,UCBPlayer,65,290,355,2,49,UCBPlayer
3278,UCBPlayer,64,294,358,2,48,UCBPlayer
3279,UCBPlayer,77,287,364,5,47,UCBPlayer
3280,UCBPlayer,60,310,370,2,44,UCBPlayer
3281,UCBPlayer,66,296,362,3,47,UCBPlayer
3282,UCBPlayer,63,288,351,1,50,UCBPlayer
3283,UCBPlayer,50,315,365,0,45,UCBPlayer
3284,UCBPlayer,48,323,371,0,43,UCBPlayer
3285,UCBPlayer,76,286,362,6,48,UCBPlayer
3286,UCBPlayer,63,278,341,0,53,UCBPlayer
3287,UCBPlayer,76,271,347,3,52,UCBPlayer
3288,UCBPlayer,52,317,369,1,44,UCBPlayer
3289,UCBPlayer,63,278,341,0,53,UCBPlayer
3290,UCBPlayer,70,270,340,2,54,UCBPlayer
3291,UCBPlayer,63,288,351,1,50,UCBPlayer
3292,UCBPlayer,57,287,344,0,52,UCBPlayer
3293,UCBPlayer,93,293,386,9,41,UCBPlayer
3294,UCBPlayer,65,300,365,3,46,UCBPlayer
3295,UCBPlayer,88,278,366,7,47,UCBPlayer
3296,UCBPlayer,124,289,413,15,34,UCBPlayer
3297,UCBPlayer,55,315,370,2,44,UCBPlayer
3298,UCBPlayer,69,289,358,2,48,UCBPlayer
3299,UCBPlayer,51,311,362,0,46,UCBPlayer
3300,UCBPlayer,130,260,390,13,41,UCBPlayer
3301,UCBPlayer,102,292,394,8,38,UCBPlayer
3302,UCBPlayer,83,303,386,9,41,UCBPlayer
3303,UCBPlayer,80,270,350,3,51,UCBPlayer
3304,UCBPlayer,54,299,353,0,49,UCBPlayer
3305,UCBPlayer,64,269,333,1,56,UCBPlayer
3306,UCBPlayer,65,285,350,0,50,UCBPlayer
3307,UCBPlayer,47,327,374,0,42,UCBPlayer
3308,UCBPlayer,81,276,357,4,49,UCBPlayer
3309,UCBPlayer,175,220,395,18,41,UCBPlayer
3310,UCBPlayer,68,308,376,5,43,UCBPlayer
3311,UCBPlayer,57,287,344,0,52,UCBPlayer
3312,UCBPlayer,51,311,362,0,46,UCBPlayer
3313,UCBPlayer,57,282,339,1,54,UCBPlayer
3314,UCBPlayer,70,310,380,6,42,UCBPlayer
3315,UCBPlayer,61,296,357,1,48,UCBPlayer
3316,UCBPlayer,64,299,363,1,46,UCBPlayer
3317,UCBPlayer,71,306,377,6,43,UCBPlayer
3318,UCBPlayer,60,300,360,1,47,UCBPlayer
3319,UCBPlayer,101,261,362,6,48,UCBPlayer
3320,UCBPlayer,55,295,350,0,50,UCBPlayer
3321,UCBPlayer,46,331,377,0,41,UCBPlayer
3322,UCBPlayer,62,302,364,2,46,UCBPlayer
3323,UCBPlayer,131,281,412,17,35,UCBPlayer
3324,UCBPlayer,60,275,335,0,55,UCBPlayer
3325,UCBPlayer,52,307,359,0,47,UCBPlayer
3326,UCBPlayer,61,296,357,1,48,UCBPlayer
3327,UCBPlayer,47,327,374,0,42,UCBPlayer
3328,UCBPlayer,60,275,335,0,55,UCBPlayer
3329,UCBPlayer,79,299,378,7,43,UCBPlayer
3330,UCBPlayer,62,302,364,2,46,UCBPlayer
3331,UCBPlayer,62,267,329,0,57,UCBPlayer
3332,UCBPlayer,80,265,345,4,53,UCBPlayer
3333,UCBPlayer,59,279,338,0,54,UCBPlayer
3334,UCBPlayer,45,335,380,0,40,UCBPlayer
3335,UCBPlayer,83,293,376,5,43,UCBPlayer
3336,UCBPlayer,52,307,359,0,47,UCBPlayer
3337,UCBPlayer,54,299,353,0,49,UCBPlayer
3338,UCBPlayer,60,275,335,0,55,UCBPlayer
3339,UCBPlayer,72,287,359,3,48,UCBPlayer
3340,UCBPlayer,67,292,359,3,48,UCBPlayer
3341,UCBPlayer,49,319,368,0,44,UCBPlayer
3342,UCBPlayer,59,279,338,0,54,UCBPlayer
3343,UCBPlayer,66,311,377,3,42,UCBPlayer
3344,UCBPlayer,54,299,353,0,49,UCBPlayer
3345,UCBPlayer,65,300,365,3,46,UCBPlayer
3346,UCBPlayer,53,328,381,1,40,UCBPlayer
3347,UCBPlayer,151,251,402,16,38,UCBPlayer
3348,UCBPlayer,62,307,369,1,44,UCBPlayer
3349,UCBPlayer,97,272,369,7,46,UCBPlayer
3350,UCBPlayer,59,279,338,0,54,UCBPlayer
3351,UCBPlayer,89,289,378,7,43,UCBPlayer
3352,UCBPlayer,53,313,366,1,45,UCBPlayer
3353,UCBPlayer,60,290,350,0,50,UCBPlayer
3354,UCBPlayer,51,311,362,0,46,UCBPlayer
3355,UCBPlayer,83,313,396,7,37,UCBPlayer
3356,UCBPlayer,59,279,338,0,54,UCBPlayer
3357,UCBPlayer,62,292,354,1,49,UCBPlayer
3358,UCBPlayer,57,287,344,0,52,UCBPlayer
3359,UCBPlayer,73,313,386,9,41,UCBPlayer
3360,UCBPlayer,96,271,367,2,45,UCBPlayer
3361,UCBPlayer,66,266,332,0,56,UCBPlayer
3362,UCBPlayer,51,321,372,1,43,UCBPlayer
3363,UCBPlayer,67,322,389,6,39,UCBPlayer
3364,UCBPlayer,59,279,338,0,54,UCBPlayer
3365,UCBPlayer,42,332,374,0,42,UCBPlayer
3366,UCBPlayer,46,331,377,0,41,UCBPlayer
3367,UCBPlayer,47,327,374,0,42,UCBPlayer
3368,UCBPlayer,152,252,404,18,38,UCBPlayer
3369,UCBPlayer,63,308,371,3,44,UCBPlayer
3370,UCBPlayer,230,235,465,34,23,UCBPlayer
3371,UCBPlayer,73,298,371,6,45,UCBPlayer
3372,UCBPlayer,55,320,375,1,42,UCBPlayer
3373,UCBPlayer,50,315,365,0,45,UCBPlayer
3374,UCBPlayer,49,319,368,0,44,UCBPlayer
3375,UCBPlayer,57,287,344,0,52,UCBPlayer
3376,UCBPlayer,42,357,399,1,34,UCBPlayer
3377,UCBPlayer,80,290,370,8,46,UCBPlayer
3378,UCBPlayer,57,312,369,1,44,UCBPlayer
3379,UCBPlayer,65,280,345,1,52,UCBPlayer
3380,UCBPlayer,94,279,373,5,44,UCBPlayer
3381,UCBPlayer,57,287,344,0,52,UCBPlayer
3382,UCBPlayer,53,313,366,1,45,UCBPlayer
3383,UCBPlayer,89,254,343,5,54,UCBPlayer
3384,UCBPlayer,44,339,383,0,39,UCBPlayer
3385,UCBPlayer,66,266,332,0,56,UCBPlayer
3386,UCBPlayer,78,288,366,4,46,UCBPlayer
3387,UCBPlayer,59,279,338,0,54,UCBPlayer
3388,UCBPlayer,107,252,359,6,49,UCBPlayer
3389,UCBPlayer,57,287,344,0,52,UCBPlayer
3390,UCBPlayer,67,272,339,1,54,UCBPlayer
3391,UCBPlayer,62,302,364,2,46,UCBPlayer
3392,UCBPlayer,52,307,359,0,47,UCBPlayer
3393,UCBPlayer,59,279,338,0,54,UCBPlayer
3394,UCBPlayer,62,267,329,0,57,UCBPlayer
3395,UCBPlayer,68,298,366,4,46,UCBPlayer
3396,UCBPlayer,68,258,326,0,58,UCBPlayer
3397,UCBPlayer,74,254,328,2,58,UCBPlayer
3398,UCBPlayer,77,282,359,3,48,UCBPlayer
3399,UCBPlayer,46,331,377,0,41,UCBPlayer
3400,UCBPlayer,52,307,359,0,47,UCBPlayer
3401,UCBPlayer,74,284,358,5,49,UCBPlayer
3402,UCBPlayer,63,318,381,4,41,UCBPlayer
3403,UCBPlayer,62,292,354,1,49,UCBPlayer
3404,UCBPlayer,74,274,348,4,52,UCBPlayer
3405,UCBPlayer,125,270,395,15,40,UCBPlayer
3406,UCBPlayer,92,287,379,5,42,UCBPlayer
3407,UCBPlayer,57,297,354,1,49,UCBPlayer
3408,UCBPlayer,81,271,352,5,51,UCBPlayer
3409,UCBPlayer,110,260,370,11,47,UCBPlayer
3410,UCBPlayer,88,268,356,3,49,UCBPlayer
3411,UCBPlayer,52,307,359,0,47,UCBPlayer
3412,UCBPlayer,59,279,338,0,54,UCBPlayer
3413,UCBPlayer,54,299,353,0,49,UCBPlayer
3414,UCBPlayer,43,343,386,0,38,UCBPlayer
3415,UCBPlayer,59,279,338,0,54,UCBPlayer
3416,UCBPlayer,45,320,365,0,45,UCBPlayer
3417,UCBPlayer,51,311,362,0,46,UCBPlayer
3418,UCBPlayer,45,335,380,0,40,UCBPlayer
3419,UCBPlayer,65,290,355,2,49,UCBPlayer
3420,UCBPlayer,57,322,379,2,41,UCBPlayer
3421,UCBPlayer,54,299,353,0,49,UCBPlayer
3422,UCBPlayer,65,320,385,5,40,UCBPlayer
3423,UCBPlayer,53,303,356,0,48,UCBPlayer
3424,UCBPlayer,64,294,358,2,48,UCBPlayer
3425,UCBPlayer,53,303,356,0,48,UCBPlayer
3426,UCBPlayer,84,279,363,7,48,UCBPlayer
3427,UCBPlayer,54,324,378,1,41,UCBPlayer
3428,UCBPlayer,43,343,386,0,38,UCBPlayer
3429,UCBPlayer,63,288,351,1,50,UCBPlayer
3430,UCBPlayer,43,343,386,0,38,UCBPlayer
3431,UCBPlayer,71,266,337,2,55,UCBPlayer
3432,UCBPlayer,63,278,341,0,53,UCBPlayer
3433,UCBPlayer,70,280,350,3,51,UCBPlayer
3434,UCBPlayer,62,312,374,3,43,UCBPlayer
3435,UCBPlayer,60,310,370,2,44,UCBPlayer
3436,UCBPlayer,55,320,375,1,42,UCBPlayer
3437,UCBPlayer,56,291,347,0,51,UCBPlayer
3438,UCBPlayer,52,327,379,2,41,UCBPlayer
3439,UCBPlayer,70,285,355,2,49,UCBPlayer
3440,UCBPlayer,52,307,359,0,47,UCBPlayer
3441,UCBPlayer,54,299,353,0,49,UCBPlayer
3442,UCBPlayer,73,288,361,5,48,UCBPlayer
3443,UCBPlayer,64,304,368,3,45,UCBPlayer
3444,UCBPlayer,59,294,353,0,49,UCBPlayer
3445,UCBPlayer,57,312,369,1,44,UCBPlayer
3446,UCBPlayer,68,288,356,3,49,UCBPlayer
3447,UCBPlayer,61,271,332,0,56,UCBPlayer
3448,UCBPlayer,67,272,339,1,54,UCBPlayer
3449,UCBPlayer,93,253,346,5,53,UCBPlayer
3450,UCBPlayer,58,283,341,0,53,UCBPlayer
3451,UCBPlayer,55,295,350,0,50,UCBPlayer
3452,UCBPlayer,112,262,374,9,45,UCBPlayer
3453,UCBPlayer,59,279,338,0,54,UCBPlayer
3454,UCBPlayer,94,294,388,8,40,UCBPlayer
3455,UCBPlayer,51,311,362,0,46,UCBPlayer
3456,UCBPlayer,49,334,383,3,40,UCBPlayer
3457,UCBPlayer,65,315,380,3,41,UCBPlayer
3458,UCBPlayer,54,309,363,1,46,UCBPlayer
3459,UCBPlayer,66,316,382,5,41,UCBPlayer
3460,UCBPlayer,70,285,355,2,49,UCBPlayer
3461,UCBPlayer,81,251,332,3,57,UCBPlayer
3462,UCBPlayer,81,266,347,3,52,UCBPlayer
3463,UCBPlayer,78,293,371,3,44,UCBPlayer
3464,UCBPlayer,51,311,362,0,46,UCBPlayer
3465,UCBPlayer,55,295,350,0,50,UCBPlayer
3466,UCBPlayer,48,323,371,0,43,UCBPlayer
3467,UCBPlayer,56,276,332,0,56,UCBPlayer
3468,UCBPlayer,49,319,368,0,44,UCBPlayer
3469,UCBPlayer,51,311,362,0,46,UCBPlayer
3470,UCBPlayer,57,322,379,2,41,UCBPlayer
3471,UCBPlayer,84,254,338,3,55,UCBPlayer
3472,UCBPlayer,49,319,368,0,44,UCBPlayer
3473,UCBPlayer,69,299,368,3,45,UCBPlayer
3474,UCBPlayer,62,292,354,1,49,UCBPlayer
3475,UCBPlayer,69,264,333,1,56,UCBPlayer
3476,UCBPlayer,74,294,368,6,46,UCBPlayer
3477,UCBPlayer,64,274,338,0,54,UCBPlayer
3478,UCBPlayer,65,300,365,3,46,UCBPlayer
3479,UCBPlayer,69,299,368,3,45,UCBPlayer
3480,UCBPlayer,57,287,344,0,52,UCBPlayer
3481,UCBPlayer,68,258,326,0,58,UCBPlayer
3482,UCBPlayer,66,306,372,4,44,UCBPlayer
3483,UCBPlayer,49,319,368,0,44,UCBPlayer
3484,UCBPlayer,56,291,347,0,51,UCBPlayer
3485,UCBPlayer,53,328,381,1,40,UCBPlayer
3486,UCBPlayer,63,298,361,2,47,UCBPlayer
3487,UCBPlayer,54,299,353,0,49,UCBPlayer
3488,UCBPlayer,53,303,356,0,48,UCBPlayer
3489,UCBPlayer,53,303,356,0,48,UCBPlayer
3490,UCBPlayer,63,298,361,2,47,UCBPlayer
3491,UCBPlayer,61,296,357,1,48,UCBPlayer
3492,UCBPlayer,71,266,337,2,55,UCBPlayer
3493,UCBPlayer,49,319,368,0,44,UCBPlayer
3494,UCBPlayer,63,288,351,1,50,UCBPlayer
3495,UCBPlayer,56,291,347,0,51,UCBPlayer
3496,UCBPlayer,48,323,371,0,43,UCBPlayer
3497,UCBPlayer,51,311,362,0,46,UCBPlayer
3498,UCBPlayer,54,299,353,0,49,UCBPlayer
3499,UCBPlayer,89,284,373,5,44,UCBPlayer
3500,UCBPlayer,62,267,329,0,57,UCBPlayer
3501,UCBPlayer,49,339,388,2,38,UCBPlayer
3502,UCBPlayer,58,298,356,0,48,UCBPlayer
3503,UCBPlayer,69,264,333,1,56,UCBPlayer
3504,UCBPlayer,65,280,345,1,52,UCBPlayer
3505,UCBPlayer,82,287,369,4,45,UCBPlayer
3506,UCBPlayer,57,287,344,0,52,UCBPlayer
3507,UCBPlayer,48,323,371,0,43,UCBPlayer
3508,UCBPlayer,60,275,335,0,55,UCBPlayer
3509,UCBPlayer,95,290,385,8,41,UCBPlayer
3510,UCBPlayer,125,265,390,10,40,UCBPlayer
3511,UCBPlayer,62,267,329,0,57,UCBPlayer
3512,UCBPlayer,58,283,341,0,53,UCBPlayer
3513,UCBPlayer,51,336,387,1,38,UCBPlayer
3514,UCBPlayer,57,287,344,0,52,UCBPlayer
3515,UCBPlayer,59,304,363,4,47,UCBPlayer
3516,UCBPlayer,127,257,384,10,42,UCBPlayer
3517,UCBPlayer,53,303,356,0,48,UCBPlayer
3518,UCBPlayer,46,316,362,0,46,UCBPlayer
3519,UCBPlayer,48,323,371,0,43,UCBPlayer
3520,UCBPlayer,83,313,396,10,38,UCBPlayer
3521,UCBPlayer,69,264,333,1,56,UCBPlayer
3522,UCBPlayer,53,303,356,0,48,UCBPlayer
3523,UCBPlayer,86,271,357,4,49,UCBPlayer
3524,UCBPlayer,76,291,367,2,45,UCBPlayer
3525,UCBPlayer,51,311,362,0,46,UCBPlayer
3526,UCBPlayer,61,296,357,1,48,UCBPlayer
3527,UCBPlayer,60,275,335,0,55,UCBPlayer
3528,UCBPlayer,61,316,377,3,42,UCBPlayer
3529,UCBPlayer,43,343,386,0,38,UCBPlayer
3530,UCBPlayer,49,329,378,1,41,UCBPlayer
3531,UCBPlayer,74,279,353,3,50,UCBPlayer
3532,UCBPlayer,47,327,374,0,42,UCBPlayer
3533,UCBPlayer,55,295,350,0,50,UCBPlayer
3534,UCBPlayer,69,284,353,3,50,UCBPlayer
3535,UCBPlayer,60,275,335,0,55,UCBPlayer
3536,UCBPlayer,50,315,365,0,45,UCBPlayer
3537,UCBPlayer,79,284,363,4,47,UCBPlayer
3538,UCBPlayer,90,295,385,11,42,UCBPlayer
3539,UCBPlayer,54,299,353,0,49,UCBPlayer
3540,UCBPlayer,58,283,341,0,53,UCBPlayer
3541,UCBPlayer,101,286,387,7,40,UCBPlayer
3542,UCBPlayer,64,259,323,0,59,UCBPlayer
3543,UCBPlayer,54,299,353,0,49,UCBPlayer
3544,UCBPlayer,195,245,440,27,29,UCBPlayer
3545,UCBPlayer,106,271,377,9,44,UCBPlayer
3546,UCBPlayer,53,328,381,1,40,UCBPlayer
3547,UCBPlayer,60,300,360,1,47,UCBPlayer
3548,UCBPlayer,61,271,332,0,56,UCBPlayer
3549,UCBPlayer,77,297,374,6,44,UCBPlayer
3550,UCBPlayer,54,299,353,0,49,UCBPlayer
3551,UCBPlayer,53,303,356,0,48,UCBPlayer
3552,UCBPlayer,72,287,359,3,48,UCBPlayer
3553,UCBPlayer,54,299,353,0,49,UCBPlayer
3554,UCBPlayer,91,321,412,11,33,UCBPlayer
3555,UCBPlayer,65,280,345,1,52,UCBPlayer
3556,UCBPlayer,66,291,357,1,48,UCBPlayer
3557,UCBPlayer,52,307,359,0,47,UCBPlayer
3558,UCBPlayer,54,299,353,0,49,UCBPlayer
3559,UCBPlayer,101,251,352,8,52,UCBPlayer
3560,UCBPlayer,69,299,368,3,45,UCBPlayer
3561,UCBPlayer,55,305,360,1,47,UCBPlayer
3562,UCBPlayer,62,292,354,1,49,UCBPlayer
3563,UCBPlayer,76,281,357,4,49,UCBPlayer
3564,UCBPlayer,104,269,373,5,44,UCBPlayer
3565,UCBPlayer,41,351,392,0,36,UCBPlayer
3566,UCBPlayer,59,289,348,1,51,UCBPlayer
3567,UCBPlayer,64,299,363,1,46,UCBPlayer
3568,UCBPlayer,65,270,335,0,55,UCBPlayer
3569,UCBPlayer,54,284,338,0,54,UCBPlayer
3570,UCBPlayer,57,322,379,2,41,UCBPlayer
3571,UCBPlayer,65,300,365,3,46,UCBPlayer
3572,UCBPlayer,50,325,375,1,42,UCBPlayer
3573,UCBPlayer,72,267,339,1,54,UCBPlayer
3574,UCBPlayer,48,323,371,0,43,UCBPlayer
3575,UCBPlayer,63,298,361,2,47,UCBPlayer
3576,UCBPlayer,56,316,372,1,43,UCBPlayer
3577,UCBPlayer,67,292,359,3,48,UCBPlayer
3578,UCBPlayer,82,297,379,8,43,UCBPlayer
3579,UCBPlayer,64,284,348,1,51,UCBPlayer
3580,UCBPlayer,59,279,338,0,54,UCBPlayer
3581,UCBPlayer,68,303,371,3,44,UCBPlayer
3582,UCBPlayer,76,291,367,5,46,UCBPlayer
3583,UCBPlayer,54,299,353,0,49,UCBPlayer
3584,UCBPlayer,51,321,372,1,43,UCBPlayer
3585,UCBPlayer,65,270,335,0,55,UCBPlayer
3586,UCBPlayer,56,306,362,0,46,UCBPlayer
3587,UCBPlayer,51,311,362,0,46,UCBPlayer
3588,UCBPlayer,78,283,361,5,48,UCBPlayer
3589,UCBPlayer,52,307,359,0,47,UCBPlayer
3590,UCBPlayer,56,291,347,0,51,UCBPlayer
3591,UCBPlayer,54,299,353,0,49,UCBPlayer
3592,UCBPlayer,56,316,372,1,43,UCBPlayer
3593,UCBPlayer,45,335,380,0,40,UCBPlayer
3594,UCBPlayer,56,301,357,1,48,UCBPlayer
3595,UCBPlayer,71,291,362,3,47,UCBPlayer
3596,UCBPlayer,56,291,347,0,51,UCBPlayer
3597,UCBPlayer,72,302,374,6,44,UCBPlayer
3598,UCBPlayer,62,292,354,1,49,UCBPlayer
3599,UCBPlayer,53,313,366,1,45,UCBPlayer
3600,UCBPlayer,163,218,381,16,45,UCBPlayer
3601,UCBPlayer,111,261,372,10,46,UCBPlayer
3602,UCBPlayer,56,311,367,2,45,UCBPlayer
3603,UCBPlayer,63,288,351,1,50,UCBPlayer
3604,UCBPlayer,64,294,358,2,48,UCBPlayer
3605,UCBPlayer,65,270,335,0,55,UCBPlayer
3606,UCBPlayer,59,279,338,0,54,UCBPlayer
3607,UCBPlayer,68,293,361,2,47,UCBPlayer
3608,UCBPlayer,55,295,350,0,50,UCBPlayer
3609,UCBPlayer,72,297,369,4,45,UCBPlayer
3610,UCBPlayer,56,291,347,0,51,UCBPlayer
3611,UCBPlayer,66,266,332,0,56,UCBPlayer
3612,UCBPlayer,57,287,344,0,52,UCBPlayer
3613,UCBPlayer,51,321,372,1,43,UCBPlayer
3614,UCBPlayer,64,284,348,1,51,UCBPlayer
3615,UCBPlayer,63,278,341,0,53,UCBPlayer
3616,UCBPlayer,71,276,347,3,52,UCBPlayer
3617,UCBPlayer,91,256,347,6,53,UCBPlayer
3618,UCBPlayer,84,309,393,4,37,UCBPlayer
3619,UCBPlayer,59,279,338,0,54,UCBPlayer
3620,UCBPlayer,48,308,356,0,48,UCBPlayer
3621,UCBPlayer,63,288,351,1,50,UCBPlayer
3622,UCBPlayer,63,273,336,1,55,UCBPlayer
3623,UCBPlayer,71,301,372,4,44,UCBPlayer
3624,UCBPlayer,56,291,347,0,51,UCBPlayer
3625,UCBPlayer,77,302,379,8,43,UCBPlayer
3626,UCBPlayer,53,303,356,0,48,UCBPlayer
3627,UCBPlayer,59,304,363,1,46,UCBPlayer
3628,UCBPlayer,55,295,350,0,50,UCBPlayer
3629,UCBPlayer,46,331,377,0,41,UCBPlayer
3630,UCBPlayer,50,315,365,0,45,UCBPlayer
3631,UCBPlayer,46,331,377,0,41,UCBPlayer
3632,UCBPlayer,66,266,332,0,56,UCBPlayer
3633,UCBPlayer,65,280,345,1,52,UCBPlayer
3634,UCBPlayer,59,279,338,0,54,UCBPlayer
3635,UCBPlayer,79,279,358,5,49,UCBPlayer
3636,UCBPlayer,62,312,374,3,43,UCBPlayer
3637,UCBPlayer,48,333,381,1,40,UCBPlayer
3638,UCBPlayer,54,299,353,0,49,UCBPlayer
3639,UCBPlayer,58,308,366,1,45,UCBPlayer
3640,UCBPlayer,51,311,362,0,46,UCBPlayer
3641,UCBPlayer,60,300,360,1,47,UCBPlayer
3642,UCBPlayer,45,335,380,0,40,UCBPlayer
3643,UCBPlayer,62,282,344,0,52,UCBPlayer
3644,UCBPlayer,60,275,335,0,55,UCBPlayer
3645,UCBPlayer,52,307,359,0,47,UCBPlayer
3646,UCBPlayer,59,279,338,0,54,UCBPlayer
3647,UCBPlayer,55,295,350,0,50,UCBPlayer
3648,UCBPlayer,55,295,350,0,50,UCBPlayer
3649,UCBPlayer,54,299,353,0,49,UCBPlayer
3650,UCBPlayer,48,323,371,0,43,UCBPlayer
3651,UCBPlayer,71,276,347,3,52,UCBPlayer
3652,UCBPlayer,51,311,362,0,46,UCBPlayer
3653,UCBPlayer,54,309,363,1,46,UCBPlayer
3654,UCBPlayer,69,299,368,3,45,UCBPlayer
3655,UCBPlayer,56,291,347,0,51,UCBPlayer
3656,UCBPlayer,48,323,371,0,43,UCBPlayer
3657,UCBPlayer,48,333,381,1,40,UCBPlayer
3658,UCBPlayer,78,263,341,3,54,UCBPlayer
3659,UCBPlayer,63,263,326,0,58,UCBPlayer
3660,UCBPlayer,106,296,402,13,37,UCBPlayer
3661,UCBPlayer,46,341,387,1,38,UCBPlayer
3662,UCBPlayer,89,254,343,5,54,UCBPlayer
3663,UCBPlayer,72,277,349,2,51,UCBPlayer
3664,UCBPlayer,52,307,359,0,47,UCBPlayer
3665,UCBPlayer,56,291,347,0,51,UCBPlayer
3666,UCBPlayer,50,325,375,1,42,UCBPlayer
3667,UCBPlayer,63,293,356,3,49,UCBPlayer
3668,UCBPlayer,74,284,358,2,48,UCBPlayer
3669,UCBPlayer,49,319,368,0,44,UCBPlayer
3670,UCBPlayer,55,295,350,0,50,UCBPlayer
3671,UCBPlayer,47,312,359,0,47,UCBPlayer
3672,UCBPlayer,63,298,361,2,47,UCBPlayer
3673,UCBPlayer,68,298,366,4,46,UCBPlayer
3674,UCBPlayer,50,315,365,0,45,UCBPlayer
3675,UCBPlayer,69,289,358,2,48,UCBPlayer
3676,UCBPlayer,43,343,386,0,38,UCBPlayer
3677,UCBPlayer,75,295,370,5,45,UCBPlayer
3678,UCBPlayer,58,283,341,0,53,UCBPlayer
3679,UCBPlayer,73,273,346,2,52,UCBPlayer
3680,UCBPlayer,57,322,379,2,41,UCBPlayer
3681,UCBPlayer,85,285,370,8,46,UCBPlayer
3682,UCBPlayer,92,252,344,3,53,UCBPlayer
3683,UCBPlayer,52,307,359,0,47,UCBPlayer
3684,UCBPlayer,62,267,329,0,57,UCBPlayer
3685,UCBPlayer,101,291,392,12,40,UCBPlayer
3686,UCBPlayer,51,331,382,2,40,UCBPlayer
3687,UCBPlayer,64,294,358,2,48,UCBPlayer
3688,UCBPlayer,54,299,353,0,49,UCBPlayer
3689,UCBPlayer,73,288,361,2,47,UCBPlayer
3690,UCBPlayer,63,298,361,2,47,UCBPlayer
3691,UCBPlayer,58,283,341,0,53,UCBPlayer
3692,UCBPlayer,48,323,371,0,43,UCBPlayer
3693,UCBPlayer,89,269,358,5,49,UCBPlayer
3694,UCBPlayer,43,343,386,0,38,UCBPlayer
3695,UCBPlayer,52,307,359,0,47,UCBPlayer
3696,UCBPlayer,69,289,358,2,48,UCBPlayer
3697,UCBPlayer,65,300,365,3,46,UCBPlayer
3698,UCBPlayer,70,280,350,3,51,UCBPlayer
3699,UCBPlayer,66,301,367,2,45,UCBPlayer
3700,UCBPlayer,88,288,376,5,43,UCBPlayer
3701,UCBPlayer,56,301,357,1,48,UCBPlayer
3702,UCBPlayer,59,294,353,0,49,UCBPlayer
3703,UCBPlayer,51,321,372,1,43,UCBPlayer
3704,UCBPlayer,75,295,370,5,45,UCBPlayer
3705,UCBPlayer,60,310,370,2,44,UCBPlayer
3706,UCBPlayer,71,266,337,2,55,UCBPlayer
3707,UCBPlayer,53,303,356,0,48,UCBPlayer
3708,UCBPlayer,53,303,356,0,48,UCBPlayer
3709,UCBPlayer,55,295,350,0,50,UCBPlayer
3710,UCBPlayer,51,311,362,0,46,UCBPlayer
3711,UCBPlayer,60,275,335,0,55,UCBPlayer
3712,UCBPlayer,56,311,367,2,45,UCBPlayer
3713,UCBPlayer,80,285,365,3,46,UCBPlayer
3714,UCBPlayer,56,291,347,0,51,UCBPlayer
3715,UCBPlayer,50,315,365,0,45,UCBPlayer
3716,UCBPlayer,62,282,344,0,52,UCBPlayer
3717,UCBPlayer,50,315,365,0,45,UCBPlayer
3718,UCBPlayer,52,317,369,1,44,UCBPlayer
3719,UCBPlayer,64,294,358,2,48,UCBPlayer
3720,UCBPlayer,57,322,379,2,41,UCBPlayer
3721,UCBPlayer,82,282,364,8,48,UCBPlayer
3722,UCBPlayer,85,295,380,6,42,UCBPlayer
3723,UCBPlayer,64,294,358,2,48,UCBPlayer
3724,UCBPlayer,74,279,353,3,50,UCBPlayer
3725,UCBPlayer,79,269,348,4,52,UCBPlayer
3726,UCBPlayer,66,286,352,2,50,UCBPlayer
3727,UCBPlayer,49,319,368,0,44,UCBPlayer
3728,UCBPlayer,63,313,376,2,42,UCBPlayer
3729,UCBPlayer,47,327,374,0,42,UCBPlayer
3730,UCBPlayer,71,281,352,2,50,UCBPlayer
3731,UCBPlayer,62,302,364,2,46,UCBPlayer
3732,UCBPlayer,52,307,359,0,47,UCBPlayer
3733,UCBPlayer,51,311,362,0,46,UCBPlayer
3734,UCBPlayer,54,299,353,0,49,UCBPlayer
3735,UCBPlayer,58,298,356,0,48,UCBPlayer
3736,UCBPlayer,63,313,376,2,42,UCBPlayer
3737,UCBPlayer,66,296,362,3,47,UCBPlayer
3738,UCBPlayer,55,295,350,0,50,UCBPlayer
3739,UCBPlayer,51,321,372,1,43,UCBPlayer
3740,UCBPlayer,43,343,386,0,38,UCBPlayer
3741,UCBPlayer,83,268,351,4,51,UCBPlayer
3742,UCBPlayer,124,264,388,14,42,UCBPlayer
3743,UCBPlayer,57,297,354,1,49,UCBPlayer
3744,UCBPlayer,60,300,360,1,47,UCBPlayer
3745,UCBPlayer,68,278,346,2,52,UCBPlayer
3746,UCBPlayer,55,295,350,0,50,UCBPlayer
3747,UCBPlayer,54,299,353,0,49,UCBPlayer
3748,UCBPlayer,63,298,361,2,47,UCBPlayer
3749,UCBPlayer,68,278,346,2,52,UCBPlayer
3750,UCBPlayer,78,298,376,5,43,UCBPlayer
3751,UCBPlayer,52,307,359,0,47,UCBPlayer
3752,UCBPlayer,73,248,321,1,60,UCBPlayer
3753,UCBPlayer,55,295,350,0,50,UCBPlayer
3754,UCBPlayer,50,315,365,0,45,UCBPlayer
3755,UCBPlayer,57,287,344,0,52,UCBPlayer
3756,UCBPlayer,73,293,366,7,47,UCBPlayer
3757,UCBPlayer,93,258,351,4,51,UCBPlayer
3758,UCBPlayer,50,315,365,0,45,UCBPlayer
3759,UCBPlayer,54,319,373,2,43,UCBPlayer
3760,UCBPlayer,60,300,360,1,47,UCBPlayer
3761,UCBPlayer,47,327,374,0,42,UCBPlayer
3762,UCBPlayer,64,309,373,5,44,UCBPlayer
3763,UCBPlayer,63,293,356,0,48,UCBPlayer
3764,UCBPlayer,59,279,338,0,54,UCBPlayer
3765,UCBPlayer,56,291,347,0,51,UCBPlayer
3766,UCBPlayer,57,287,344,0,52,UCBPlayer
3767,UCBPlayer,56,291,347,0,51,UCBPlayer
3768,UCBPlayer,47,347,394,2,36,UCBPlayer
3769,UCBPlayer,71,281,352,2,50,UCBPlayer
3770,UCBPlayer,60,310,370,2,44,UCBPlayer
3771,UCBPlayer,62,297,359,3,48,UCBPlayer
3772,UCBPlayer,88,263,351,4,51,UCBPlayer
3773,UCBPlayer,46,316,362,0,46,UCBPlayer
3774,UCBPlayer,69,304,373,5,44,UCBPlayer
3775,UCBPlayer,73,293,366,4,46,UCBPlayer
3776,UCBPlayer,57,312,369,1,44,UCBPlayer
3777,UCBPlayer,70,285,355,2,49,UCBPlayer
3778,UCBPlayer,66,286,352,2,50,UCBPlayer
3779,UCBPlayer,66,276,342,1,53,UCBPlayer
3780,UCBPlayer,66,311,377,3,42,UCBPlayer
3781,UCBPlayer,59,279,338,0,54,UCBPlayer
3782,UCBPlayer,75,275,350,3,51,UCBPlayer
3783,UCBPlayer,55,295,350,0,50,UCBPlayer
3784,UCBPlayer,52,327,379,2,41,UCBPlayer
3785,UCBPlayer,61,296,357,1,48,UCBPlayer
3786,UCBPlayer,118,268,386,12,42,UCBPlayer
3787,UCBPlayer,84,264,348,4,52,UCBPlayer
3788,UCBPlayer,49,319,368,0,44,UCBPlayer
3789,UCBPlayer,65,270,335,0,55,UCBPlayer
3790,UCBPlayer,56,291,347,0,51,UCBPlayer
3791,UCBPlayer,64,314,378,4,42,UCBPlayer
3792,UCBPlayer,72,267,339,1,54,UCBPlayer
3793,UCBPlayer,68,288,356,3,49,UCBPlayer
3794,UCBPlayer,67,282,349,2,51,UCBPlayer
3795,UCBPlayer,71,286,357,4,49,UCBPlayer
3796,UCBPlayer,74,279,353,3,50,UCBPlayer
3797,UCBPlayer,46,331,377,0,41,UCBPlayer
3798,UCBPlayer,56,291,347,0,51,UCBPlayer
3799,UCBPlayer,58,308,366,1,45,UCBPlayer
3800,UCBPlayer,66,296,362,3,47,UCBPlayer
3801,UCBPlayer,56,291,347,0,51,UCBPlayer
3802,UCBPlayer,67,322,389,3,38,UCBPlayer
3803,UCBPlayer,57,287,344,0,52,UCBPlayer
3804,UCBPlayer,52,307,359,0,47,UCBPlayer
3805,UCBPlayer,67,282,349,2,51,UCBPlayer
3806,UCBPlayer,57,287,344,0,52,UCBPlayer
3807,UCBPlayer,47,327,374,0,42,UCBPlayer
3808,UCBPlayer,47,327,374,0,42,UCBPlayer
3809,UCBPlayer,63,278,341,0,53,UCBPlayer
3810,UCBPlayer,52,307,359,0,47,UCBPlayer
3811,UCBPlayer,51,311,362,0,46,UCBPlayer
3812,UCBPlayer,55,295,350,0,50,UCBPlayer
3813,UCBPlayer,58,283,341,0,53,UCBPlayer
3814,UCBPlayer,43,343,386,0,38,UCBPlayer
3815,UCBPlayer,56,301,357,1,48,UCBPlayer
3816,UCBPlayer,61,306,367,2,45,UCBPlayer
3817,UCBPlayer,61,301,362,3,47,UCBPlayer
3818,UCBPlayer,60,305,365,0,45,UCBPlayer
3819,UCBPlayer,57,287,344,0,52,UCBPlayer
3820,UCBPlayer,74,264,338,3,55,UCBPlayer
3821,UCBPlayer,87,267,354,4,50,UCBPlayer
3822,UCBPlayer,56,306,362,0,46,UCBPlayer
3823,UCBPlayer,61,271,332,0,56,UCBPlayer
3824,UCBPlayer,42,332,374,0,42,UCBPlayer
3825,UCBPlayer,55,320,375,1,42,UCBPlayer
3826,UCBPlayer,59,304,363,1,46,UCBPlayer
3827,UCBPlayer,66,266,332,0,56,UCBPlayer
3828,UCBPlayer,45,335,380,0,40,UCBPlayer
3829,UCBPlayer,70,300,370,5,45,UCBPlayer
3830,UCBPlayer,74,269,343,2,53,UCBPlayer
3831,UCBPlayer,59,279,338,0,54,UCBPlayer
3832,UCBPlayer,55,295,350,0,50,UCBPlayer
3833,UCBPlayer,63,263,326,0,58,UCBPlayer
3834,UCBPlayer,73,303,376,5,43,UCBPlayer
3835,UCBPlayer,67,282,349,2,51,UCBPlayer
3836,UCBPlayer,56,291,347,0,51,UCBPlayer
3837,UCBPlayer,58,283,341,0,53,UCBPlayer
3838,UCBPlayer,54,314,368,0,44,UCBPlayer
3839,UCBPlayer,61,271,332,0,56,UCBPlayer
3840,UCBPlayer,95,295,390,10,40,UCBPlayer
3841,UCBPlayer,56,291,347,0,51,UCBPlayer
3842,UCBPlayer,55,305,360,1,47,UCBPlayer
3843,UCBPlayer,71,291,362,3,47,UCBPlayer
3844,UCBPlayer,82,317,399,10,37,UCBPlayer
3845,UCBPlayer,52,307,359,0,47,UCBPlayer
3846,UCBPlayer,62,267,329,0,57,UCBPlayer
3847,UCBPlayer,50,315,365,0,45,UCBPlayer
3848,UCBPlayer,72,272,344,3,53,UCBPlayer
3849,UCBPlayer,52,307,359,0,47,UCBPlayer
3850,UCBPlayer,55,320,375,1,42,UCBPlayer
3851,UCBPlayer,64,259,323,0,59,UCBPlayer
3852,UCBPlayer,55,310,365,0,45,UCBPlayer
3853,UCBPlayer,71,306,377,6,43,UCBPlayer
3854,UCBPlayer,86,276,362,6,48,UCBPlayer
3855,UCBPlayer,67,282,349,2,51,UCBPlayer
3856,UCBPlayer,64,304,368,3,45,UCBPlayer
3857,UCBPlayer,72,277,349,2,51,UCBPlayer
3858,UCBPlayer,52,307,359,0,47,UCBPlayer
3859,UCBPlayer,58,303,361,2,47,UCBPlayer
3860,UCBPlayer,58,308,366,1,45,UCBPlayer
3861,UCBPlayer,63,303,366,4,46,UCBPlayer
3862,UCBPlayer,62,302,364,2,46,UCBPlayer
3863,UCBPlayer,56,316,372,1,43,UCBPlayer
3864,UCBPlayer,59,304,363,1,46,UCBPlayer
3865,UCBPlayer,53,303,356,0,48,UCBPlayer
3866,UCBPlayer,46,331,377,0,41,UCBPlayer
3867,UCBPlayer,81,286,367,5,46,UCBPlayer
3868,UCBPlayer,72,302,374,3,43,UCBPlayer
3869,UCBPlayer,54,319,373,2,43,UCBPlayer
3870,UCBPlayer,92,272,364,8,48,UCBPlayer
3871,UCBPlayer,56,311,367,2,45,UCBPlayer
3872,UCBPlayer,54,314,368,0,44,UCBPlayer
3873,UCBPlayer,55,295,350,0,50,UCBPlayer
3874,UCBPlayer,50,315,365,0,45,UCBPlayer
3875,UCBPlayer,51,296,347,0,51,UCBPlayer
3876,UCBPlayer,63,318,381,4,41,UCBPlayer
3877,UCBPlayer,55,295,350,0,50,UCBPlayer
3878,UCBPlayer,52,307,359,0,47,UCBPlayer
3879,UCBPlayer,57,287,344,0,52,UCBPlayer
3880,UCBPlayer,108,278,386,12,42,UCBPlayer
3881,UCBPlayer,77,317,394,5,37,UCBPlayer
3882,UCBPlayer,57,337,394,2,36,UCBPlayer
3883,UCBPlayer,73,308,381,7,42,UCBPlayer
3884,UCBPlayer,61,271,332,0,56,UCBPlayer
3885,UCBPlayer,63,298,361,2,47,UCBPlayer
3886,UCBPlayer,53,303,356,0,48,UCBPlayer
3887,UCBPlayer,65,300,365,3,46,UCBPlayer
3888,UCBPlayer,127,237,364,11,49,UCBPlayer
3889,UCBPlayer,229,234,463,38,25,UCBPlayer
3890,UCBPlayer,57,287,344,0,52,UCBPlayer
3891,UCBPlayer,65,280,345,1,52,UCBPlayer
3892,UCBPlayer,57,287,344,0,52,UCBPlayer
3893,UCBPlayer,65,290,355,2,49,UCBPlayer
3894,UCBPlayer,59,279,338,0,54,UCBPlayer
3895,UCBPlayer,65,300,365,3,46,UCBPlayer
3896,UCBPlayer,52,317,369,1,44,UCBPlayer
3897,UCBPlayer,56,291,347,0,51,UCBPlayer
3898,UCBPlayer,57,287,344,0,52,UCBPlayer
3899,UCBPlayer,52,307,359,0,47,UCBPlayer
3900,UCBPlayer,53,303,356,0,48,UCBPlayer
3901,UCBPlayer,57,287,344,0,52,UCBPlayer
3902,UCBPlayer,55,295,350,0,50,UCBPlayer
3903,UCBPlayer,54,299,353,0,49,UCBPlayer
3904,UCBPlayer,61,296,357,1,48,UCBPlayer
3905,UCBPlayer,46,331,377,0,41,UCBPlayer
3906,UCBPlayer,81,281,362,6,48,UCBPlayer
3907,UCBPlayer,66,276,342,1,53,UCBPlayer
3908,UCBPlayer,78,263,341,6,55,UCBPlayer
3909,UCBPlayer,112,262,374,12,46,UCBPlayer
3910,UCBPlayer,101,281,382,11,43,UCBPlayer
3911,UCBPlayer,61,306,367,2,45,UCBPlayer
3912,UCBPlayer,53,303,356,0,48,UCBPlayer
3913,UCBPlayer,93,258,351,7,52,UCBPlayer
3914,UCBPlayer,74,289,363,4,47,UCBPlayer
3915,UCBPlayer,106,251,357,10,51,UCBPlayer
3916,UCBPlayer,67,287,354,1,49,UCBPlayer
3917,UCBPlayer,107,252,359,9,50,UCBPlayer
3918,UCBPlayer,65,280,345,1,52,UCBPlayer
3919,UCBPlayer,58,283,341,0,53,UCBPlayer
3920,UCBPlayer,50,315,365,0,45,UCBPlayer
3921,UCBPlayer,50,315,365,0,45,UCBPlayer
3922,UCBPlayer,46,331,377,0,41,UCBPlayer
3923,UCBPlayer,53,303,356,0,48,UCBPlayer
3924,UCBPlayer,47,327,374,0,42,UCBPlayer
3925,UCBPlayer,43,338,381,1,40,UCBPlayer
3926,UCBPlayer,105,270,375,7,44,UCBPlayer
3927,UCBPlayer,119,244,363,13,50,UCBPlayer
3928,UCBPlayer,75,255,330,1,57,UCBPlayer
3929,UCBPlayer,129,229,358,14,52,UCBPlayer
3930,UCBPlayer,55,295,350,0,50,UCBPlayer
3931,UCBPlayer,86,271,357,7,50,UCBPlayer
3932,UCBPlayer,51,311,362,0,46,UCBPlayer
3933,UCBPlayer,50,325,375,1,42,UCBPlayer
3934,UCBPlayer,175,225,400,17,39,UCBPlayer
3935,UCBPlayer,69,264,333,1,56,UCBPlayer
3936,UCBPlayer,51,311,362,0,46,UCBPlayer
3937,UCBPlayer,48,323,371,0,43,UCBPlayer
3938,UCBPlayer,61,306,367,2,45,UCBPlayer
3939,UCBPlayer,72,292,364,5,47,UCBPlayer
3940,UCBPlayer,54,299,353,0,49,UCBPlayer
3941,UCBPlayer,93,288,381,7,42,UCBPlayer
3942,UCBPlayer,58,283,341,0,53,UCBPlayer
3943,UCBPlayer,66,311,377,3,42,UCBPlayer
3944,UCBPlayer,55,305,360,1,47,UCBPlayer
3945,UCBPlayer,79,279,358,5,49,UCBPlayer
3946,UCBPlayer,58,283,341,0,53,UCBPlayer
3947,UCBPlayer,52,307,359,0,47,UCBPlayer
3948,UCBPlayer,65,255,320,0,60,UCBPlayer
3949,UCBPlayer,61,286,347,0,51,UCBPlayer
3950,UCBPlayer,53,303,356,0,48,UCBPlayer
3951,UCBPlayer,60,300,360,1,47,UCBPlayer
3952,UCBPlayer,65,305,370,2,44,UCBPlayer
3953,UCBPlayer,58,283,341,0,53,UCBPlayer
3954,UCBPlayer,56,291,347,0,51,UCBPlayer
3955,UCBPlayer,53,303,356,0,48,UCBPlayer
3956,UCBPlayer,59,324,383,3,40,UCBPlayer
3957,UCBPlayer,51,311,362,0,46,UCBPlayer
3958,UCBPlayer,58,283,341,0,53,UCBPlayer
3959,UCBPlayer,60,275,335,0,55,UCBPlayer
3960,UCBPlayer,61,306,367,2,45,UCBPlayer
3961,UCBPlayer,123,238,361,8,49,UCBPlayer
3962,UCBPlayer,66,286,352,2,50,UCBPlayer
3963,UCBPlayer,50,315,365,0,45,UCBPlayer
3964,UCBPlayer,50,325,375,1,42,UCBPlayer
3965,UCBPlayer,58,308,366,1,45,UCBPlayer
3966,UCBPlayer,45,335,380,0,40,UCBPlayer
3967,UCBPlayer,73,273,346,2,52,UCBPlayer
3968,UCBPlayer,54,309,363,1,46,UCBPlayer
3969,UCBPlayer,62,292,354,1,49,UCBPlayer
3970,UCBPlayer,65,280,345,1,52,UCBPlayer
3971,UCBPlayer,61,271,332,0,56,UCBPlayer
3972,UCBPlayer,54,324,378,1,41,UCBPlayer
3973,UCBPlayer,59,279,338,0,54,UCBPlayer
3974,UCBPlayer,67,272,339,1,54,UCBPlayer
3975,UCBPlayer,56,306,362,0,46,UCBPlayer
3976,UCBPlayer,54,294,348,1,51,UCBPlayer
3977,UCBPlayer,64,294,358,2,48,UCBPlayer
3978,UCBPlayer,59,279,338,0,54,UCBPlayer
3979,UCBPlayer,48,323,371,0,43,UCBPlayer
3980,UCBPlayer,52,332,384,1,39,UCBPlayer
3981,UCBPlayer,54,299,353,0,49,UCBPlayer
3982,UCBPlayer,53,303,356,0,48,UCBPlayer
3983,UCBPlayer,115,280,395,15,40,UCBPlayer
3984,UCBPlayer,58,283,341,0,53,UCBPlayer
3985,UCBPlayer,58,283,341,0,53,UCBPlayer
3986,UCBPlayer,66,286,352,2,50,UCBPlayer
3987,UCBPlayer,69,289,358,2,48,UCBPlayer
3988,UCBPlayer,58,283,341,0,53,UCBPlayer
3989,UCBPlayer,116,281,397,11,38,UCBPlayer
3990,UCBPlayer,50,315,365,0,45,UCBPlayer
3991,UCBPlayer,46,341,387,1,38,UCBPlayer
3992,UCBPlayer,49,319,368,0,44,UCBPlayer
3993,UCBPlayer,55,295,350,0,50,UCBPlayer
3994,UCBPlayer,57,287,344,0,52,UCBPlayer
3995,UCBPlayer,61,306,367,2,45,UCBPlayer
3996,UCBPlayer,53,303,356,0,48,UCBPlayer
3997,UCBPlayer,55,295,350,0,50,UCBPlayer
3998,UCBPlayer,71,266,337,2,55,UCBPlayer
3999,UCBPlayer,46,331,377,0,41,UCBPlayer
4000,UCBPlayer,80,265,345,4,53,UCBPlayer
4001,UCBPlayer,84,274,358,5,49,UCBPlayer
4002,UCBPlayer,133,258,391,14,41,UCBPlayer
4003,UCBPlayer,45,345,390,1,37,UCBPlayer
4004,UCBPlayer,74,289,363,4,47,UCBPlayer
4005,UCBPlayer,48,333,381,1,40,UCBPlayer
4006,UCBPlayer,58,308,366,1,45,UCBPlayer
4007,UCBPlayer,59,294,353,0,49,UCBPlayer
4008,UCBPlayer,60,310,370,2,44,UCBPlayer
4009,UCBPlayer,68,318,386,6,40,UCBPlayer
4010,UCBPlayer,55,295,350,0,50,UCBPlayer
4011,UCBPlayer,64,289,353,0,49,UCBPlayer
4012,UCBPlayer,61,306,367,2,45,UCBPlayer
4013,UCBPlayer,59,314,373,2,43,UCBPlayer
4014,UCBPlayer,65,315,380,6,42,UCBPlayer
4015,UCBPlayer,62,282,344,0,52,UCBPlayer
4016,UCBPlayer,53,313,366,1,45,UCBPlayer
4017,UCBPlayer,58,338,396,4,36,UCBPlayer
4018,UCBPlayer,70,265,335,0,55,UCBPlayer
4019,UCBPlayer,57,297,354,1,49,UCBPlayer
4020,UCBPlayer,65,280,345,1,52,UCBPlayer
4021,UCBPlayer,86,281,367,5,46,UCBPlayer
4022,UCBPlayer,62,267,329,0,57,UCBPlayer
4023,UCBPlayer,48,323,371,0,43,UCBPlayer
4024,UCBPlayer,68,293,361,2,47,UCBPlayer
4025,UCBPlayer,324,179,503,42,13,Player A
4026,UCBPlayer,62,302,364,2,46,UCBPlayer
4027,UCBPlayer,56,286,342,1,53,UCBPlayer
4028,UCBPlayer,76,301,377,6,43,UCBPlayer
4029,UCBPlayer,54,299,353,0,49,UCBPlayer
4030,UCBPlayer,52,327,379,2,41,UCBPlayer
4031,UCBPlayer,70,310,380,3,41,UCBPlayer
4032,UCBPlayer,64,284,348,1,51,UCBPlayer
4033,UCBPlayer,84,314,398,9,37,UCBPlayer
4034,UCBPlayer,48,323,371,0,43,UCBPlayer
4035,UCBPlayer,65,270,335,0,55,UCBPlayer
4036,UCBPlayer,82,267,349,5,52,UCBPlayer
4037,UCBPlayer,75,275,350,3,51,UCBPlayer
4038,UCBPlayer,56,291,347,0,51,UCBPlayer
4039,UCBPlayer,54,299,353,0,49,UCBPlayer
4040,UCBPlayer,63,278,341,0,53,UCBPlayer
4041,UCBPlayer,80,275,355,5,50,UCBPlayer
4042,UCBPlayer,75,275,350,3,51,UCBPlayer
4043,UCBPlayer,55,295,350,0,50,UCBPlayer
4044,UCBPlayer,58,283,341,0,53,UCBPlayer
4045,UCBPlayer,68,268,336,1,55,UCBPlayer
4046,UCBPlayer,60,290,350,0,50,UCBPlayer
4047,UCBPlayer,50,315,365,0,45,UCBPlayer
4048,UCBPlayer,43,343,386,0,38,UCBPlayer
4049,UCBPlayer,67,292,359,3,48,UCBPlayer
4050,UCBPlayer,106,241,347,6,53,UCBPlayer
4051,UCBPlayer,61,271,332,0,56,UCBPlayer
4052,UCBPlayer,61,281,342,1,53,UCBPlayer
4053,UCBPlayer,57,312,369,1,44,UCBPlayer
4054,UCBPlayer,72,297,369,4,45,UCBPlayer
4055,UCBPlayer,70,280,350,3,51,UCBPlayer
4056,UCBPlayer,75,285,360,4,48,UCBPlayer
4057,UCBPlayer,61,271,332,0,56,UCBPlayer
4058,UCBPlayer,84,279,363,7,48,UCBPlayer
4059,UCBPlayer,66,276,342,1,53,UCBPlayer
4060,UCBPlayer,61,296,357,1,48,UCBPlayer
4061,UCBPlayer,51,311,362,0,46,UCBPlayer
4062,UCBPlayer,58,293,351,1,50,UCBPlayer
4063,UCBPlayer,62,282,344,0,52,UCBPlayer
4064,UCBPlayer,69,264,333,1,56,UCBPlayer
4065,UCBPlayer,65,280,345,1,52,UCBPlayer
4066,UCBPlayer,48,323,371,0,43,UCBPlayer
4067,UCBPlayer,55,295,350,0,50,UCBPlayer
4068,UCBPlayer,54,299,353,0,49,UCBPlayer
4069,UCBPlayer,62,322,384,4,40,UCBPlayer
4070,UCBPlayer,49,329,378,1,41,UCBPlayer
4071,UCBPlayer,80,295,375,7,44,UCBPlayer
4072,UCBPlayer,68,268,336,1,55,UCBPlayer
4073,UCBPlayer,68,278,346,2,52,UCBPlayer
4074,UCBPlayer,50,330,380,0,40,UCBPlayer
4075,UCBPlayer,76,266,342,4,54,UCBPlayer
4076,UCBPlayer,119,259,378,7,43,UCBPlayer
4077,UCBPlayer,51,311,362,0,46,UCBPlayer
4078,UCBPlayer,49,314,363,1,46,UCBPlayer
4079,UCBPlayer,82,282,364,5,47,UCBPlayer
4080,UCBPlayer,57,287,344,0,52,UCBPlayer
4081,UCBPlayer,59,304,363,1,46,UCBPlayer
4082,UCBPlayer,113,258,371,9,46,UCBPlayer
4083,UCBPlayer,56,291,347,0,51,UCBPlayer
4084,UCBPlayer,47,327,374,0,42,UCBPlayer
4085,UCBPlayer,81,291,372,7,45,UCBPlayer
4086,UCBPlayer,65,270,335,0,55,UCBPlayer
4087,UCBPlayer,50,315,365,0,45,UCBPlayer
4088,UCBPlayer,57,287,344,0,52,UCBPlayer
4089,UCBPlayer,61,306,367,2,45,UCBPlayer
4090,UCBPlayer,88,273,361,5,48,UCBPlayer
4091,UCBPlayer,71,266,337,2,55,UCBPlayer
4092,UCBPlayer,50,315,365,0,45,UCBPlayer
4093,UCBPlayer,62,292,354,1,49,UCBPlayer
4094,UCBPlayer,96,291,387,10,41,UCBPlayer
4095,UCBPlayer,67,282,349,2,51,UCBPlayer
4096,UCBPlayer,82,262,344,3,53,UCBPlayer
4097,UCBPlayer,61,271,332,0,56,UCBPlayer
4098,UCBPlayer,57,287,344,0,52,UCBPlayer
4099,UCBPlayer,62,322,384,4,40,UCBPlayer
4100,UCBPlayer,61,306,367,2,45,UCBPlayer
4101,UCBPlayer,55,295,350,0,50,UCBPlayer
4102,UCBPlayer,61,306,367,2,45,UCBPlayer
4103,UCBPlayer,62,267,329,0,57,UCBPlayer
4104,UCBPlayer,63,288,351,1,50,UCBPlayer
4105,UCBPlayer,51,336,387,1,38,UCBPlayer
4106,UCBPlayer,49,319,368,0,44,UCBPlayer
4107,UCBPlayer,47,327,374,0,42,UCBPlayer
4108,UCBPlayer,81,271,352,5,51,UCBPlayer
4109,UCBPlayer,52,307,359,0,47,UCBPlayer
4110,UCBPlayer,84,259,343,5,54,UCBPlayer
4111,UCBPlayer,58,308,366,1,45,UCBPlayer
4112,UCBPlayer,57,297,354,1,49,UCBPlayer
4113,UCBPlayer,66,291,357,1,48,UCBPlayer
4114,UCBPlayer,51,321,372,1,43,UCBPlayer
4115,UCBPlayer,60,290,350,0,50,UCBPlayer
4116,UCBPlayer,70,250,320,0,60,UCBPlayer
4117,UCBPlayer,50,325,375,1,42,UCBPlayer
4118,UCBPlayer,75,275,350,3,51,UCBPlayer
4119,UCBPlayer,51,311,362,0,46,UCBPlayer
4120,UCBPlayer,53,303,356,0,48,UCBPlayer
4121,UCBPlayer,55,295,350,0,50,UCBPlayer
4122,UCBPlayer,51,311,362,0,46,UCBPlayer
4123,UCBPlayer,64,309,373,5,44,UCBPlayer
4124,UCBPlayer,79,284,363,4,47,UCBPlayer
4125,UCBPlayer,50,315,365,0,45,UCBPlayer
4126,UCBPlayer,64,284,348,4,52,UCBPlayer
4127,UCBPlayer,72,292,364,2,46,UCBPlayer
4128,UCBPlayer,57,297,354,1,49,UCBPlayer
4129,UCBPlayer,72,297,369,4,45,UCBPlayer
4130,UCBPlayer,46,316,362,0,46,UCBPlayer
4131,UCBPlayer,64,309,373,2,43,UCBPlayer
4132,UCBPlayer,59,279,338,0,54,UCBPlayer
4133,UCBPlayer,76,261,337,2,55,UCBPlayer
4134,UCBPlayer,83,283,366,7,47,UCBPlayer
4135,UCBPlayer,63,303,366,1,45,UCBPlayer
4136,UCBPlayer,69,304,373,5,44,UCBPlayer
4137,UCBPlayer,61,296,357,1,48,UCBPlayer
4138,UCBPlayer,51,321,372,1,43,UCBPlayer
4139,UCBPlayer,118,268,386,12,42,UCBPlayer
4140,UCBPlayer,57,312,369,1,44,UCBPlayer
4141,UCBPlayer,52,327,379,2,41,UCBPlayer
4142,UCBPlayer,55,310,365,0,45,UCBPlayer
4143,UCBPlayer,101,266,367,8,47,UCBPlayer
4144,UCBPlayer,59,279,338,0,54,UCBPlayer
4145,UCBPlayer,79,309,388,5,39,UCBPlayer
4146,UCBPlayer,60,310,370,2,44,UCBPlayer
4147,UCBPlayer,63,263,326,0,58,UCBPlayer
4148,UCBPlayer,52,307,359,0,47,UCBPlayer
4149,UCBPlayer,64,259,323,0,59,UCBPlayer
4150,UCBPlayer,71,281,352,2,50,UCBPlayer
4151,UCBPlayer,53,313,366,1,45,UCBPlayer
4152,UCBPlayer,48,323,371,0,43,UCBPlayer
4153,UCBPlayer,57,287,344,0,52,UCBPlayer
4154,UCBPlayer,66,286,352,2,50,UCBPlayer
4155,UCBPlayer,71,281,352,2,50,UCBPlayer
4156,UCBPlayer,61,306,367,2,45,UCBPlayer
4157,UCBPlayer,65,270,335,0,55,UCBPlayer
4158,UCBPlayer,57,287,344,0,52,UCBPlayer
4159,UCBPlayer,70,280,350,3,51,UCBPlayer
4160,UCBPlayer,67,327,394,8,38,UCBPlayer
4161,UCBPlayer,46,331,377,0,41,UCBPlayer
4162,UCBPlayer,60,275,335,0,55,UCBPlayer
4163,UCBPlayer,50,315,365,0,45,UCBPlayer
4164,UCBPlayer,62,267,329,0,57,UCBPlayer
4165,UCBPlayer,130,245,375,13,46,UCBPlayer
4166,UCBPlayer,60,275,335,0,55,UCBPlayer
4167,UCBPlayer,62,292,354,1,49,UCBPlayer
4168,UCBPlayer,51,311,362,0,46,UCBPlayer
4169,UCBPlayer,51,311,362,0,46,UCBPlayer
4170,UCBPlayer,101,311,412,14,34,UCBPlayer
4171,UCBPlayer,88,243,331,2,57,UCBPlayer
4172,UCBPlayer,58,283,341,0,53,UCBPlayer
4173,UCBPlayer,57,287,344,0,52,UCBPlayer
4174,UCBPlayer,53,303,356,0,48,UCBPlayer
4175,UCBPlayer,56,291,347,0,51,UCBPlayer
4176,UCBPlayer,93,273,366,7,47,UCBPlayer
4177,UCBPlayer,67,297,364,2,46,UCBPlayer
4178,UCBPlayer,69,269,338,0,54,UCBPlayer
4179,UCBPlayer,55,295,350,0,50,UCBPlayer
4180,UCBPlayer,56,291,347,0,51,UCBPlayer
4181,UCBPlayer,53,288,341,0,53,UCBPlayer
4182,UCBPlayer,64,294,358,2,48,UCBPlayer
4183,UCBPlayer,103,263,366,10,48,UCBPlayer
4184,UCBPlayer,49,319,368,0,44,UCBPlayer
4185,UCBPlayer,49,349,398,3,35,UCBPlayer
4186,UCBPlayer,56,326,382,2,40,UCBPlayer
4187,UCBPlayer,68,278,346,2,52,UCBPlayer
4188,UCBPlayer,52,307,359,0,47,UCBPlayer
4189,UCBPlayer,60,335,395,3,36,UCBPlayer
4190,UCBPlayer,75,285,360,4,48,UCBPlayer
4191,UCBPlayer,55,295,350,0,50,UCBPlayer
4192,UCBPlayer,95,250,345,7,54,UCBPlayer
4193,UCBPlayer,56,291,347,0,51,UCBPlayer
4194,UCBPlayer,69,294,363,4,47,UCBPlayer
4195,UCBPlayer,59,279,338,0,54,UCBPlayer
4196,UCBPlayer,74,289,363,4,47,UCBPlayer
4197,UCBPlayer,45,335,380,0,40,UCBPlayer
4198,UCBPlayer,50,315,365,0,45,UCBPlayer
4199,UCBPlayer,54,299,353,0,49,UCBPlayer
4200,UCBPlayer,63,298,361,2,47,UCBPlayer
4201,UCBPlayer,71,256,327,1,58,UCBPlayer
4202,UCBPlayer,81,256,337,2,55,UCBPlayer
4203,UCBPlayer,50,315,365,0,45,UCBPlayer
4204,UCBPlayer,67,262,329,0,57,UCBPlayer
4205,UCBPlayer,59,279,338,0,54,UCBPlayer
4206,UCBPlayer,44,339,383,0,39,UCBPlayer
4207,UCBPlayer,55,295,350,0,50,UCBPlayer
4208,UCBPlayer,70,295,365,3,46,UCBPlayer
4209,UCBPlayer,49,319,368,0,44,UCBPlayer
4210,UCBPlayer,54,299,353,0,49,UCBPlayer
4211,UCBPlayer,67,292,359,3,48,UCBPlayer
4212,UCBPlayer,54,299,353,0,49,UCBPlayer
4213,UCBPlayer,68,278,346,2,52,UCBPlayer
4214,UCBPlayer,58,298,356,0,48,UCBPlayer
4215,UCBPlayer,56,291,347,0,51,UCBPlayer
4216,UCBPlayer,109,254,363,10,49,UCBPlayer
4217,UCBPlayer,64,294,358,2,48,UCBPlayer
4218,UCBPlayer,65,270,335,0,55,UCBPlayer
4219,UCBPlayer,52,317,369,1,44,UCBPlayer
4220,UCBPlayer,64,274,338,0,54,UCBPlayer
4221,UCBPlayer,66,286,352,2,50,UCBPlayer
4222,UCBPlayer,70,250,320,0,60,UCBPlayer
4223,UCBPlayer,54,299,353,0,49,UCBPlayer
4224,UCBPlayer,82,257,339,4,55,UCBPlayer
4225,UCBPlayer,72,302,374,6,44,UCBPlayer
4226,UCBPlayer,76,271,347,3,52,UCBPlayer
4227,UCBPlayer,54,299,353,0,49,UCBPlayer
4228,UCBPlayer,69,254,323,0,59,UCBPlayer
4229,UCBPlayer,42,342,384,1,39,UCBPlayer
4230,UCBPlayer,70,300,370,5,45,UCBPlayer
4231,UCBPlayer,76,296,372,1,43,UCBPlayer
4232,UCBPlayer,50,300,350,0,50,UCBPlayer
4233,UCBPlayer,68,308,376,5,43,UCBPlayer
4234,UCBPlayer,77,267,344,3,53,UCBPlayer
4235,UCBPlayer,179,249,428,21,31,UCBPlayer
4236,UCBPlayer,56,291,347,0,51,UCBPlayer
4237,UCBPlayer,55,295,350,0,50,UCBPlayer
4238,UCBPlayer,54,299,353,0,49,UCBPlayer
4239,UCBPlayer,75,265,340,2,54,UCBPlayer
4240,UCBPlayer,49,319,368,0,44,UCBPlayer
4241,UCBPlayer,52,307,359,0,47,UCBPlayer
4242,UCBPlayer,51,331,382,2,40,UCBPlayer
4243,UCBPlayer,69,274,343,2,53,UCBPlayer
4244,UCBPlayer,63,288,351,1,50,UCBPlayer
4245,UCBPlayer,57,287,344,0,52,UCBPlayer
4246,UCBPlayer,49,319,368,0,44,UCBPlayer
4247,UCBPlayer,68,293,361,2,47,UCBPlayer
4248,UCBPlayer,53,313,366,1,45,UCBPlayer
4249,UCBPlayer,82,272,354,4,50,UCBPlayer
4250,UCBPlayer,87,272,359,6,49,UCBPlayer
4251,UCBPlayer,66,286,352,2,50,UCBPlayer
4252,UCBPlayer,69,304,373,5,44,UCBPlayer
4253,UCBPlayer,78,263,341,3,54,UCBPlayer
4254,UCBPlayer,57,302,359,0,47,UCBPlayer
4255,UCBPlayer,68,288,356,3,49,UCBPlayer
4256,UCBPlayer,67,292,359,3,48,UCBPlayer
4257,UCBPlayer,75,295,370,5,45,UCBPlayer
4258,UCBPlayer,82,272,354,4,50,UCBPlayer
4259,UCBPlayer,55,295,350,0,50,UCBPlayer
4260,UCBPlayer,47,337,384,1,39,UCBPlayer
4261,UCBPlayer,112,262,374,12,46,UCBPlayer
4262,UCBPlayer,59,279,338,0,54,UCBPlayer
4263,UCBPlayer,49,319,368,0,44,UCBPlayer
4264,UCBPlayer,62,302,364,2,46,UCBPlayer
4265,UCBPlayer,64,274,338,0,54,UCBPlayer
4266,UCBPlayer,54,299,353,0,49,UCBPlayer
4267,UCBPlayer,52,322,374,0,42,UCBPlayer
4268,UCBPlayer,59,279,338,0,54,UCBPlayer
4269,UCBPlayer,66,276,342,1,53,UCBPlayer
4270,UCBPlayer,65,315,380,3,41,UCBPlayer
4271,UCBPlayer,57,297,354,1,49,UCBPlayer
4272,UCBPlayer,101,271,372,7,45,UCBPlayer
4273,UCBPlayer,70,280,350,0,50,UCBPlayer
4274,UCBPlayer,67,307,374,3,43,UCBPlayer
4275,UCBPlayer,58,293,351,1,50,UCBPlayer
4276,UCBPlayer,63,288,351,1,50,UCBPlayer
4277,UCBPlayer,63,283,346,2,52,UCBPlayer
4278,UCBPlayer,60,300,360,1,47,UCBPlayer
4279,UCBPlayer,57,312,369,1,44,UCBPlayer
4280,UCBPlayer,44,334,378,1,41,UCBPlayer
4281,UCBPlayer,91,251,342,4,54,UCBPlayer
4282,UCBPlayer,48,323,371,0,43,UCBPlayer
4283,UCBPlayer,83,273,356,6,50,UCBPlayer
4284,UCBPlayer,64,294,358,2,48,UCBPlayer
4285,UCBPlayer,85,280,365,6,47,UCBPlayer
4286,UCBPlayer,62,302,364,2,46,UCBPlayer
4287,UCBPlayer,96,271,367,8,47,UCBPlayer
4288,UCBPlayer,52,307,359,0,47,UCBPlayer
4289,UCBPlayer,87,247,334,2,56,UCBPlayer
4290,UCBPlayer,60,300,360,1,47,UCBPlayer
4291,UCBPlayer,59,279,338,0,54,UCBPlayer
4292,UCBPlayer,71,276,347,3,52,UCBPlayer
4293,UCBPlayer,64,274,338,0,54,UCBPlayer
4294,UCBPlayer,86,276,362,6,48,UCBPlayer
4295,UCBPlayer,54,299,353,0,49,UCBPlayer
4296,UCBPlayer,54,299,353,0,49,UCBPlayer
4297,UCBPlayer,67,292,359,3,48,UCBPlayer
4298,UCBPlayer,67,282,349,2,51,UCBPlayer
4299,UCBPlayer,71,301,372,4,44,UCBPlayer
4300,UCBPlayer,58,283,341,0,53,UCBPlayer
4301,UCBPlayer,55,295,350,0,50,UCBPlayer
4302,UCBPlayer,51,311,362,0,46,UCBPlayer
4303,UCBPlayer,62,292,354,1,49,UCBPlayer
4304,UCBPlayer,60,300,360,1,47,UCBPlayer
4305,UCBPlayer,61,316,377,3,42,UCBPlayer
4306,UCBPlayer,49,319,368,0,44,UCBPlayer
4307,UCBPlayer,97,287,384,10,42,UCBPlayer
4308,UCBPlayer,56,291,347,0,51,UCBPlayer
4309,UCBPlayer,51,321,372,1,43,UCBPlayer
4310,UCBPlayer,70,285,355,2,49,UCBPlayer
4311,UCBPlayer,55,295,350,0,50,UCBPlayer
4312,UCBPlayer,59,279,338,0,54,UCBPlayer
4313,UCBPlayer,102,257,359,9,50,UCBPlayer
4314,UCBPlayer,61,296,357,1,48,UCBPlayer
4315,UCBPlayer,74,294,368,6,46,UCBPlayer
4316,UCBPlayer,66,286,352,2,50,UCBPlayer
4317,UCBPlayer,56,291,347,0,51,UCBPlayer
4318,UCBPlayer,58,283,341,0,53,UCBPlayer
4319,UCBPlayer,67,272,339,1,54,UCBPlayer
4320,UCBPlayer,82,292,374,6,44,UCBPlayer
4321,UCBPlayer,55,295,350,0,50,UCBPlayer
4322,UCBPlayer,53,303,356,0,48,UCBPlayer
4323,UCBPlayer,54,299,353,0,49,UCBPlayer
4324,UCBPlayer,66,286,352,2,50,UCBPlayer
4325,UCBPlayer,82,292,374,6,44,UCBPlayer
4326,UCBPlayer,69,274,343,2,53,UCBPlayer
4327,UCBPlayer,67,297,364,2,46,UCBPlayer
4328,UCBPlayer,42,347,389,0,37,UCBPlayer
4329,UCBPlayer,66,281,347,3,52,UCBPlayer
4330,UCBPlayer,67,312,379,5,42,UCBPlayer
4331,UCBPlayer,101,251,352,8,52,UCBPlayer
4332,UCBPlayer,222,257,479,33,18,UCBPlayer
4333,UCBPlayer,52,307,359,0,47,UCBPlayer
4334,UCBPlayer,52,292,344,0,52,UCBPlayer
4335,UCBPlayer,80,275,355,5,50,UCBPlayer
4336,UCBPlayer,64,274,338,0,54,UCBPlayer
4337,UCBPlayer,55,295,350,0,50,UCBPlayer
4338,UCBPlayer,122,252,374,12,46,UCBPlayer
4339,UCBPlayer,74,294,368,3,45,UCBPlayer
4340,UCBPlayer,67,282,349,2,51,UCBPlayer
4341,UCBPlayer,73,283,356,3,49,UCBPlayer
4342,UCBPlayer,53,303,356,0,48,UCBPlayer
4343,UCBPlayer,59,279,338,0,54,UCBPlayer
4344,UCBPlayer,57,287,344,0,52,UCBPlayer
4345,UCBPlayer,72,277,349,2,51,UCBPlayer
4346,UCBPlayer,59,304,363,1,46,UCBPlayer
4347,UCBPlayer,58,318,376,2,42,UCBPlayer
4348,UCBPlayer,50,335,385,2,39,UCBPlayer
4349,UCBPlayer,62,282,344,0,52,UCBPlayer
4350,UCBPlayer,52,307,359,0,47,UCBPlayer
4351,UCBPlayer,60,275,335,0,55,UCBPlayer
4352,UCBPlayer,169,269,438,25,29,UCBPlayer
4353,UCBPlayer,55,295,350,0,50,UCBPlayer
4354,UCBPlayer,65,255,320,0,60,UCBPlayer
4355,UCBPlayer,57,302,359,0,47,UCBPlayer
4356,UCBPlayer,52,307,359,0,47,UCBPlayer
4357,UCBPlayer,50,315,365,0,45,UCBPlayer
4358,UCBPlayer,52,307,359,0,47,UCBPlayer
4359,UCBPlayer,57,287,344,0,52,UCBPlayer
4360,UCBPlayer,70,270,340,2,54,UCBPlayer
4361,UCBPlayer,57,287,344,0,52,UCBPlayer
4362,UCBPlayer,68,293,361,2,47,UCBPlayer
4363,UCBPlayer,65,310,375,4,43,UCBPlayer
4364,UCBPlayer,58,283,341,0,53,UCBPlayer
4365,UCBPlayer,76,291,367,5,46,UCBPlayer
4366,UCBPlayer,58,313,371,3,44,UCBPlayer
4367,UCBPlayer,86,291,377,6,43,UCBPlayer
4368,UCBPlayer,66,301,367,5,46,UCBPlayer
4369,UCBPlayer,48,338,386,0,38,UCBPlayer
4370,UCBPlayer,74,259,333,1,56,UCBPlayer
4371,UCBPlayer,52,307,359,0,47,UCBPlayer
4372,UCBPlayer,119,289,408,13,35,UCBPlayer
4373,UCBPlayer,57,312,369,1,44,UCBPlayer
4374,UCBPlayer,101,281,382,11,43,UCBPlayer
4375,UCBPlayer,50,315,365,0,45,UCBPlayer
4376,UCBPlayer,78,258,336,1,55,UCBPlayer
4377,UCBPlayer,56,321,377,3,42,UCBPlayer
4378,UCBPlayer,67,292,359,3,48,UCBPlayer
4379,UCBPlayer,67,297,364,2,46,UCBPlayer
4380,UCBPlayer,62,312,374,3,43,UCBPlayer
4381,UCBPlayer,67,307,374,3,43,UCBPlayer
4382,UCBPlayer,60,305,365,3,46,UCBPlayer
4383,UCBPlayer,65,285,350,0,50,UCBPlayer
4384,UCBPlayer,58,278,336,1,55,UCBPlayer
4385,UCBPlayer,55,310,365,0,45,UCBPlayer
4386,UCBPlayer,76,261,337,2,55,UCBPlayer
4387,UCBPlayer,77,297,374,6,44,UCBPlayer
4388,UCBPlayer,77,287,364,5,47,UCBPlayer
4389,UCBPlayer,80,285,365,6,47,UCBPlayer
4390,UCBPlayer,67,282,349,2,51,UCBPlayer
4391,UCBPlayer,68,258,326,0,58,UCBPlayer
4392,UCBPlayer,70,295,365,3,46,UCBPlayer
4393,UCBPlayer,56,291,347,0,51,UCBPlayer
4394,UCBPlayer,56,291,347,0,51,UCBPlayer
4395,UCBPlayer,49,319,368,0,44,UCBPlayer
4396,UCBPlayer,50,315,365,0,45,UCBPlayer
4397,UCBPlayer,59,279,338,0,54,UCBPlayer
4398,UCBPlayer,105,280,385,14,43,UCBPlayer
4399,UCBPlayer,58,298,356,0,48,UCBPlayer
4400,UCBPlayer,70,270,340,2,54,UCBPlayer
4401,UCBPlayer,56,316,372,1,43,UCBPlayer
4402,UCBPlayer,52,332,384,1,39,UCBPlayer
4403,UCBPlayer,96,281,377,9,44,UCBPlayer
4404,UCBPlayer,60,275,335,0,55,UCBPlayer
4405,UCBPlayer,62,292,354,1,49,UCBPlayer
4406,UCBPlayer,62,302,364,2,46,UCBPlayer
4407,UCBPlayer,59,279,338,0,54,UCBPlayer
4408,UCBPlayer,66,311,377,3,42,UCBPlayer
4409,UCBPlayer,53,303,356,0,48,UCBPlayer
4410,UCBPlayer,48,323,371,0,43,UCBPlayer
4411,UCBPlayer,69,314,383,3,40,UCBPlayer
4412,UCBPlayer,54,299,353,0,49,UCBPlayer
4413,UCBPlayer,87,302,389,12,41,UCBPlayer
4414,UCBPlayer,68,283,351,1,50,UCBPlayer
4415,UCBPlayer,58,308,366,1,45,UCBPlayer
4416,UCBPlayer,52,327,379,2,41,UCBPlayer
4417,UCBPlayer,60,300,360,1,47,UCBPlayer
4418,UCBPlayer,61,271,332,0,56,UCBPlayer
4419,UCBPlayer,79,269,348,4,52,UCBPlayer
4420,UCBPlayer,110,275,385,8,41,UCBPlayer
4421,UCBPlayer,97,282,379,8,43,UCBPlayer
4422,UCBPlayer,55,295,350,0,50,UCBPlayer
4423,UCBPlayer,55,315,370,2,44,UCBPlayer
4424,UCBPlayer,94,249,343,5,54,UCBPlayer
4425,UCBPlayer,63,293,356,3,49,UCBPlayer
4426,UCBPlayer,64,299,363,1,46,UCBPlayer
4427,UCBPlayer,60,310,370,2,44,UCBPlayer
4428,UCBPlayer,80,260,340,5,55,UCBPlayer
4429,UCBPlayer,52,337,389,3,38,UCBPlayer
4430,UCBPlayer,51,326,377,0,41,UCBPlayer
4431,UCBPlayer,52,307,359,0,47,UCBPlayer
4432,UCBPlayer,53,318,371,3,44,UCBPlayer
4433,UCBPlayer,76,281,357,4,49,UCBPlayer
4434,UCBPlayer,41,346,387,1,38,UCBPlayer
4435,UCBPlayer,59,324,383,3,40,UCBPlayer
4436,UCBPlayer,74,299,373,5,44,UCBPlayer
4437,UCBPlayer,63,308,371,3,44,UCBPlayer
4438,UCBPlayer,53,303,356,0,48,UCBPlayer
4439,UCBPlayer,54,299,353,0,49,UCBPlayer
4440,UCBPlayer,58,283,341,0,53,UCBPlayer
4441,UCBPlayer,78,283,361,5,48,UCBPlayer
4442,UCBPlayer,50,325,375,1,42,UCBPlayer
4443,UCBPlayer,63,298,361,2,47,UCBPlayer
4444,UCBPlayer,62,267,329,0,57,UCBPlayer
4445,UCBPlayer,78,263,341,3,54,UCBPlayer
4446,UCBPlayer,50,315,365,0,45,UCBPlayer
4447,UCBPlayer,78,278,356,3,49,UCBPlayer
4448,UCBPlayer,113,278,391,11,40,UCBPlayer
4449,UCBPlayer,56,291,347,0,51,UCBPlayer
4450,UCBPlayer,71,301,372,4,44,UCBPlayer
4451,UCBPlayer,118,258,376,11,45,UCBPlayer
4452,UCBPlayer,56,291,347,0,51,UCBPlayer
4453,UCBPlayer,79,289,368,6,46,UCBPlayer
4454,UCBPlayer,59,314,373,2,43,UCBPlayer
4455,UCBPlayer,58,283,341,0,53,UCBPlayer
4456,UCBPlayer,78,248,326,3,59,UCBPlayer
4457,UCBPlayer,69,264,333,1,56,UCBPlayer
4458,UCBPlayer,51,311,362,0,46,UCBPlayer
4459,UCBPlayer,50,315,365,0,45,UCBPlayer
4460,UCBPlayer,55,295,350,0,50,UCBPlayer
4461,UCBPlayer,48,323,371,0,43,UCBPlayer
4462,UCBPlayer,56,291,347,0,51,UCBPlayer
4463,UCBPlayer,46,331,377,0,41,UCBPlayer
4464,UCBPlayer,53,303,356,0,48,UCBPlayer
4465,UCBPlayer,68,263,331,2,57,UCBPlayer
4466,UCBPlayer,57,322,379,2,41,UCBPlayer
4467,UCBPlayer,61,271,332,0,56,UCBPlayer
4468,UCBPlayer,56,301,357,1,48,UCBPlayer
4469,UCBPlayer,76,296,372,7,45,UCBPlayer
4470,UCBPlayer,59,324,383,3,40,UCBPlayer
4471,UCBPlayer,64,314,378,4,42,UCBPlayer
4472,UCBPlayer,63,288,351,1,50,UCBPlayer
4473,UCBPlayer,56,291,347,0,51,UCBPlayer
4474,UCBPlayer,53,303,356,0,48,UCBPlayer
4475,UCBPlayer,56,301,357,1,48,UCBPlayer
4476,UCBPlayer,78,253,331,2,57,UCBPlayer
4477,UCBPlayer,53,303,356,0,48,UCBPlayer
4478,UCBPlayer,47,327,374,0,42,UCBPlayer
4479,UCBPlayer,60,275,335,0,55,UCBPlayer
4480,UCBPlayer,53,303,356,0,48,UCBPlayer
4481,UCBPlayer,70,275,345,1,52,UCBPlayer
4482,UCBPlayer,56,291,347,0,51,UCBPlayer
4483,UCBPlayer,48,318,366,1,45,UCBPlayer
4484,UCBPlayer,52,332,384,1,39,UCBPlayer
4485,UCBPlayer,64,294,358,2,48,UCBPlayer
4486,UCBPlayer,54,294,348,1,51,UCBPlayer
4487,UCBPlayer,78,263,341,3,54,UCBPlayer
4488,UCBPlayer,56,291,347,0,51,UCBPlayer
4489,UCBPlayer,49,319,368,0,44,UCBPlayer
4490,UCBPlayer,145,250,395,21,42,UCBPlayer
4491,UCBPlayer,48,323,371,0,43,UCBPlayer
4492,UCBPlayer,50,315,365,0,45,UCBPlayer
4493,UCBPlayer,58,308,366,1,45,UCBPlayer
4494,UCBPlayer,73,273,346,2,52,UCBPlayer
4495,UCBPlayer,60,275,335,0,55,UCBPlayer
4496,UCBPlayer,67,302,369,4,45,UCBPlayer
4497,UCBPlayer,96,296,392,12,40,UCBPlayer
4498,UCBPlayer,65,300,365,3,46,UCBPlayer
4499,UCBPlayer,66,276,342,1,53,UCBPlayer
4500,UCBPlayer,49,319,368,0,44,UCBPlayer
4501,UCBPlayer,60,275,335,0,55,UCBPlayer
4502,UCBPlayer,87,292,379,8,43,UCBPlayer
4503,UCBPlayer,65,280,345,1,52,UCBPlayer
4504,UCBPlayer,64,284,348,1,51,UCBPlayer
4505,UCBPlayer,63,263,326,0,58,UCBPlayer
4506,UCBPlayer,54,299,353,0,49,UCBPlayer
4507,UCBPlayer,94,289,383,6,41,UCBPlayer
4508,UCBPlayer,46,331,377,0,41,UCBPlayer
4509,UCBPlayer,51,311,362,0,46,UCBPlayer
4510,UCBPlayer,63,308,371,3,44,UCBPlayer
4511,UCBPlayer,53,303,356,0,48,UCBPlayer
4512,UCBPlayer,83,273,356,3,49,UCBPlayer
4513,UCBPlayer,59,279,338,0,54,UCBPlayer
4514,UCBPlayer,70,305,375,4,43,UCBPlayer
4515,UCBPlayer,78,263,341,3,54,UCBPlayer
4516,UCBPlayer,60,275,335,0,55,UCBPlayer
4517,UCBPlayer,66,291,357,1,48,UCBPlayer
4518,UCBPlayer,78,293,371,3,44,UCBPlayer
4519,UCBPlayer,58,283,341,0,53,UCBPlayer
4520,UCBPlayer,54,299,353,0,49,UCBPlayer
4521,UCBPlayer,55,295,350,0,50,UCBPlayer
4522,UCBPlayer,51,311,362,0,46,UCBPlayer
4523,UCBPlayer,58,323,381,1,40,UCBPlayer
4524,UCBPlayer,43,353,396,1,35,UCBPlayer
4525,UCBPlayer,48,323,371,0,43,UCBPlayer
4526,UCBPlayer,88,303,391,11,40,UCBPlayer
4527,UCBPlayer,56,306,362,0,46,UCBPlayer
4528,UCBPlayer,59,279,338,0,54,UCBPlayer
4529,UCBPlayer,54,299,353,0,49,UCBPlayer
4530,UCBPlayer,54,299,353,0,49,UCBPlayer
4531,UCBPlayer,51,311,362,0,46,UCBPlayer
4532,UCBPlayer,60,275,335,0,55,UCBPlayer
4533,UCBPlayer,76,286,362,3,47,UCBPlayer
4534,UCBPlayer,46,331,377,0,41,UCBPlayer
4535,UCBPlayer,62,267,329,0,57,UCBPlayer
4536,UCBPlayer,59,294,353,0,49,UCBPlayer
4537,UCBPlayer,44,334,378,1,41,UCBPlayer
4538,UCBPlayer,65,320,385,5,40,UCBPlayer
4539,UCBPlayer,51,311,362,0,46,UCBPlayer
4540,UCBPlayer,55,295,350,0,50,UCBPlayer
4541,UCBPlayer,59,304,363,1,46,UCBPlayer
4542,UCBPlayer,53,303,356,0,48,UCBPlayer
4543,UCBPlayer,60,300,360,1,47,UCBPlayer
4544,UCBPlayer,55,295,350,0,50,UCBPlayer
4545,UCBPlayer,43,343,386,0,38,UCBPlayer
4546,UCBPlayer,96,281,377,9,44,UCBPlayer
4547,UCBPlayer,47,327,374,0,42,UCBPlayer
4548,UCBPlayer,47,327,374,0,42,UCBPlayer
4549,UCBPlayer,62,322,384,4,40,UCBPlayer
4550,UCBPlayer,62,267,329,0,57,UCBPlayer
4551,UCBPlayer,41,351,392,0,36,UCBPlayer
4552,UCBPlayer,55,295,350,0,50,UCBPlayer
4553,UCBPlayer,68,298,366,4,46,UCBPlayer
4554,UCBPlayer,63,278,341,0,53,UCBPlayer
4555,UCBPlayer,118,278,396,16,40,UCBPlayer
4556,UCBPlayer,57,337,394,2,36,UCBPlayer
4557,UCBPlayer,51,311,362,0,46,UCBPlayer
4558,UCBPlayer,62,267,329,0,57,UCBPlayer
4559,UCBPlayer,76,261,337,2,55,UCBPlayer
4560,UCBPlayer,90,305,395,6,37,UCBPlayer
4561,UCBPlayer,90,245,335,3,56,UCBPlayer
4562,UCBPlayer,59,279,338,0,54,UCBPlayer
4563,UCBPlayer,56,311,367,2,45,UCBPlayer
4564,UCBPlayer,65,280,345,1,52,UCBPlayer
4565,UCBPlayer,100,275,375,10,45,UCBPlayer
4566,UCBPlayer,52,307,359,0,47,UCBPlayer
4567,UCBPlayer,61,306,367,2,45,UCBPlayer
4568,UCBPlayer,76,276,352,5,51,UCBPlayer
4569,UCBPlayer,64,284,348,1,51,UCBPlayer
4570,UCBPlayer,51,311,362,0,46,UCBPlayer
4571,UCBPlayer,51,321,372,1,43,UCBPlayer
4572,UCBPlayer,47,337,384,1,39,UCBPlayer
4573,UCBPlayer,60,320,380,3,41,UCBPlayer
4574,UCBPlayer,66,286,352,2,50,UCBPlayer
4575,UCBPlayer,65,280,345,1,52,UCBPlayer
4576,UCBPlayer,69,254,323,0,59,UCBPlayer
4577,UCBPlayer,62,267,329,0,57,UCBPlayer
4578,UCBPlayer,68,268,336,1,55,UCBPlayer
4579,UCBPlayer,67,272,339,1,54,UCBPlayer
4580,UCBPlayer,88,318,406,8,34,UCBPlayer
4581,UCBPlayer,47,327,374,0,42,UCBPlayer
4582,UCBPlayer,56,291,347,0,51,UCBPlayer
4583,UCBPlayer,60,325,385,2,39,UCBPlayer
4584,UCBPlayer,81,266,347,3,52,UCBPlayer
4585,UCBPlayer,89,284,373,5,44,UCBPlayer
4586,UCBPlayer,303,193,496,41,15,Player A
4587,UCBPlayer,79,274,353,3,50,UCBPlayer
4588,UCBPlayer,56,291,347,0,51,UCBPlayer
4589,UCBPlayer,53,288,341,0,53,UCBPlayer
4590,UCBPlayer,64,294,358,2,48,UCBPlayer
4591,UCBPlayer,42,347,389,0,37,UCBPlayer
4592,UCBPlayer,48,323,371,0,43,UCBPlayer
4593,UCBPlayer,81,306,387,7,40,UCBPlayer
4594,UCBPlayer,47,327,374,0,42,UCBPlayer
4595,UCBPlayer,61,271,332,0,56,UCBPlayer
4596,UCBPlayer,80,255,335,3,56,UCBPlayer
4597,UCBPlayer,46,331,377,0,41,UCBPlayer
4598,UCBPlayer,59,279,338,0,54,UCBPlayer
4599,UCBPlayer,71,291,362,3,47,UCBPlayer
4600,UCBPlayer,78,263,341,3,54,UCBPlayer
4601,UCBPlayer,57,287,344,0,52,UCBPlayer
4602,UCBPlayer,49,319,368,0,44,UCBPlayer
4603,UCBPlayer,52,307,359,0,47,UCBPlayer
4604,UCBPlayer,67,282,349,2,51,UCBPlayer
4605,UCBPlayer,66,276,342,1,53,UCBPlayer
4606,UCBPlayer,68,293,361,2,47,UCBPlayer
4607,UCBPlayer,52,307,359,0,47,UCBPlayer
4608,UCBPlayer,90,275,365,9,48,UCBPlayer
4609,UCBPlayer,92,282,374,9,45,UCBPlayer
4610,UCBPlayer,109,274,383,9,42,UCBPlayer
4611,UCBPlayer,50,315,365,0,45,UCBPlayer
4612,UCBPlayer,91,251,342,4,54,UCBPlayer
4613,UCBPlayer,56,291,347,0,51,UCBPlayer
4614,UCBPlayer,56,291,347,0,51,UCBPlayer
4615,UCBPlayer,76,276,352,2,50,UCBPlayer
4616,UCBPlayer,60,275,335,0,55,UCBPlayer
4617,UCBPlayer,79,274,353,3,50,UCBPlayer
4618,UCBPlayer,56,291,347,0,51,UCBPlayer
4619,UCBPlayer,49,319,368,0,44,UCBPlayer
4620,UCBPlayer,61,271,332,0,56,UCBPlayer
4621,UCBPlayer,62,312,374,3,43,UCBPlayer
4622,UCBPlayer,70,260,330,1,57,UCBPlayer
4623,UCBPlayer,60,320,380,3,41,UCBPlayer
4624,UCBPlayer,63,278,341,0,53,UCBPlayer
4625,UCBPlayer,67,287,354,1,49,UCBPlayer
4626,UCBPlayer,61,301,362,3,47,UCBPlayer
4627,UCBPlayer,56,306,362,0,46,UCBPlayer
4628,UCBPlayer,63,288,351,1,50,UCBPlayer
4629,UCBPlayer,53,303,356,0,48,UCBPlayer
4630,UCBPlayer,52,307,359,0,47,UCBPlayer
4631,UCBPlayer,53,303,356,0,48,UCBPlayer
4632,UCBPlayer,57,327,384,1,39,UCBPlayer
4633,UCBPlayer,63,298,361,5,48,UCBPlayer
4634,UCBPlayer,80,280,360,4,48,UCBPlayer
4635,UCBPlayer,76,261,337,2,55,UCBPlayer
4636,UCBPlayer,62,282,344,0,52,UCBPlayer
4637,UCBPlayer,46,331,377,0,41,UCBPlayer
4638,UCBPlayer,56,291,347,0,51,UCBPlayer
4639,UCBPlayer,59,279,338,0,54,UCBPlayer
4640,UCBPlayer,72,252,324,1,59,UCBPlayer
4641,UCBPlayer,54,299,353,0,49,UCBPlayer
4642,UCBPlayer,49,319,368,0,44,UCBPlayer
4643,UCBPlayer,64,334,398,6,36,UCBPlayer
4644,UCBPlayer,49,319,368,0,44,UCBPlayer
4645,UCBPlayer,58,283,341,0,53,UCBPlayer
4646,UCBPlayer,82,257,339,4,55,UCBPlayer
4647,UCBPlayer,78,263,341,3,54,UCBPlayer
4648,UCBPlayer,61,306,367,2,45,UCBPlayer
4649,UCBPlayer,56,291,347,0,51,UCBPlayer
4650,UCBPlayer,64,294,358,2,48,UCBPlayer
4651,UCBPlayer,62,267,329,0,57,UCBPlayer
4652,UCBPlayer,76,251,327,1,58,UCBPlayer
4653,UCBPlayer,74,269,343,2,53,UCBPlayer
4654,UCBPlayer,57,287,344,0,52,UCBPlayer
4655,UCBPlayer,69,294,363,4,47,UCBPlayer
4656,UCBPlayer,58,283,341,0,53,UCBPlayer
4657,UCBPlayer,49,319,368,0,44,UCBPlayer
4658,UCBPlayer,47,327,374,0,42,UCBPlayer
4659,UCBPlayer,51,311,362,0,46,UCBPlayer
4660,UCBPlayer,62,312,374,3,43,UCBPlayer
4661,UCBPlayer,60,275,335,0,55,UCBPlayer
4662,UCBPlayer,52,307,359,0,47,UCBPlayer
4663,UCBPlayer,61,316,377,3,42,UCBPlayer
4664,UCBPlayer,68,268,336,1,55,UCBPlayer
4665,UCBPlayer,55,295,350,0,50,UCBPlayer
4666,UCBPlayer,59,294,353,0,49,UCBPlayer
4667,UCBPlayer,49,319,368,0,44,UCBPlayer
4668,UCBPlayer,59,279,338,0,54,UCBPlayer
4669,UCBPlayer,51,311,362,0,46,UCBPlayer
4670,UCBPlayer,49,319,368,0,44,UCBPlayer
4671,UCBPlayer,61,271,332,0,56,UCBPlayer
4672,UCBPlayer,59,279,338,0,54,UCBPlayer
4673,UCBPlayer,55,295,350,0,50,UCBPlayer
4674,UCBPlayer,50,315,365,0,45,UCBPlayer
4675,UCBPlayer,71,286,357,4,49,UCBPlayer
4676,UCBPlayer,49,319,368,0,44,UCBPlayer
4677,UCBPlayer,69,274,343,2,53,UCBPlayer
4678,UCBPlayer,61,316,377,3,42,UCBPlayer
4679,UCBPlayer,58,298,356,0,48,UCBPlayer
4680,UCBPlayer,44,339,383,0,39,UCBPlayer
4681,UCBPlayer,53,303,356,0,48,UCBPlayer
4682,UCBPlayer,66,296,362,3,47,UCBPlayer
4683,UCBPlayer,50,315,365,0,45,UCBPlayer
4684,UCBPlayer,69,269,338,3,55,UCBPlayer
4685,UCBPlayer,70,315,385,5,40,UCBPlayer
4686,UCBPlayer,76,311,387,4,39,UCBPlayer
4687,UCBPlayer,56,291,347,0,51,UCBPlayer
4688,UCBPlayer,62,297,359,3,48,UCBPlayer
4689,UCBPlayer,98,288,386,9,41,UCBPlayer
4690,UCBPlayer,69,289,358,2,48,UCBPlayer
4691,UCBPlayer,77,277,354,4,50,UCBPlayer
4692,UCBPlayer,55,295,350,0,50,UCBPlayer
4693,UCBPlayer,76,296,372,4,44,UCBPlayer
4694,UCBPlayer,49,329,378,1,41,UCBPlayer
4695,UCBPlayer,66,301,367,2,45,UCBPlayer
4696,UCBPlayer,80,255,335,3,56,UCBPlayer
4697,UCBPlayer,62,302,364,2,46,UCBPlayer
4698,UCBPlayer,89,274,363,7,48,UCBPlayer
4699,UCBPlayer,59,279,338,0,54,UCBPlayer
4700,UCBPlayer,76,281,357,4,49,UCBPlayer
4701,UCBPlayer,51,311,362,0,46,UCBPlayer
4702,UCBPlayer,61,316,377,3,42,UCBPlayer
4703,UCBPlayer,46,331,377,0,41,UCBPlayer
4704,UCBPlayer,78,308,386,6,40,UCBPlayer
4705,UCBPlayer,47,327,374,0,42,UCBPlayer
4706,UCBPlayer,56,291,347,0,51,UCBPlayer
4707,UCBPlayer,65,300,365,3,46,UCBPlayer
4708,UCBPlayer,94,279,373,8,45,UCBPlayer
4709,UCBPlayer,85,270,355,5,50,UCBPlayer
4710,UCBPlayer,60,300,360,1,47,UCBPlayer
4711,UCBPlayer,46,331,377,0,41,UCBPlayer
4712,UCBPlayer,96,261,357,7,50,UCBPlayer
4713,UCBPlayer,52,317,369,1,44,UCBPlayer
4714,UCBPlayer,88,268,356,3,49,UCBPlayer
4715,UCBPlayer,60,300,360,1,47,UCBPlayer
4716,UCBPlayer,47,327,374,0,42,UCBPlayer
4717,UCBPlayer,57,287,344,0,52,UCBPlayer
4718,UCBPlayer,73,283,356,3,49,UCBPlayer
4719,UCBPlayer,64,304,368,3,45,UCBPlayer
4720,UCBPlayer,68,298,366,4,46,UCBPlayer
4721,UCBPlayer,42,347,389,0,37,UCBPlayer
4722,UCBPlayer,78,308,386,6,40,UCBPlayer
4723,UCBPlayer,64,309,373,2,43,UCBPlayer
4724,UCBPlayer,54,299,353,0,49,UCBPlayer
4725,UCBPlayer,60,320,380,3,41,UCBPlayer
4726,UCBPlayer,46,331,377,0,41,UCBPlayer
4727,UCBPlayer,50,315,365,0,45,UCBPlayer
4728,UCBPlayer,59,319,378,4,42,UCBPlayer
4729,UCBPlayer,67,282,349,2,51,UCBPlayer
4730,UCBPlayer,61,286,347,0,51,UCBPlayer
4731,UCBPlayer,71,306,377,3,42,UCBPlayer
4732,UCBPlayer,60,275,335,0,55,UCBPlayer
4733,UCBPlayer,58,283,341,0,53,UCBPlayer
4734,UCBPlayer,56,291,347,0,51,UCBPlayer
4735,UCBPlayer,53,313,366,1,45,UCBPlayer
4736,UCBPlayer,63,288,351,1,50,UCBPlayer
4737,UCBPlayer,58,283,341,0,53,UCBPlayer
4738,UCBPlayer,48,323,371,0,43,UCBPlayer
4739,UCBPlayer,56,321,377,3,42,UCBPlayer
4740,UCBPlayer,80,295,375,4,43,UCBPlayer
4741,UCBPlayer,50,310,360,1,47,UCBPlayer
4742,UCBPlayer,97,262,359,9,50,UCBPlayer
4743,UCBPlayer,51,311,362,0,46,UCBPlayer
4744,UCBPlayer,61,271,332,0,56,UCBPlayer
4745,UCBPlayer,53,303,356,0,48,UCBPlayer
4746,UCBPlayer,62,302,364,2,46,UCBPlayer
4747,UCBPlayer,49,319,368,0,44,UCBPlayer
4748,UCBPlayer,53,303,356,0,48,UCBPlayer
4749,UCBPlayer,80,300,380,9,43,UCBPlayer
4750,UCBPlayer,135,275,410,12,34,UCBPlayer
4751,UCBPlayer,80,280,360,4,48,UCBPlayer
4752,UCBPlayer,54,299,353,0,49,UCBPlayer
4753,UCBPlayer,48,323,371,0,43,UCBPlayer
4754,UCBPlayer,95,285,380,9,43,UCBPlayer
4755,UCBPlayer,58,283,341,0,53,UCBPlayer
4756,UCBPlayer,202,227,429,22,31,UCBPlayer
4757,UCBPlayer,128,228,356,9,51,UCBPlayer
4758,UCBPlayer,87,252,339,4,55,UCBPlayer
4759,UCBPlayer,52,307,359,0,47,UCBPlayer
4760,UCBPlayer,51,311,362,0,46,UCBPlayer
4761,UCBPlayer,67,302,369,4,45,UCBPlayer
4762,UCBPlayer,61,306,367,2,45,UCBPlayer
4763,UCBPlayer,77,277,354,4,50,UCBPlayer
4764,UCBPlayer,51,311,362,0,46,UCBPlayer
4765,UCBPlayer,73,273,346,2,52,UCBPlayer
4766,UCBPlayer,58,283,341,0,53,UCBPlayer
4767,UCBPlayer,75,275,350,3,51,UCBPlayer
4768,UCBPlayer,58,308,366,1,45,UCBPlayer
4769,UCBPlayer,78,283,361,5,48,UCBPlayer
4770,UCBPlayer,50,340,390,1,37,UCBPlayer
4771,UCBPlayer,67,307,374,6,44,UCBPlayer
4772,UCBPlayer,62,302,364,2,46,UCBPlayer
4773,UCBPlayer,67,297,364,2,46,UCBPlayer
4774,UCBPlayer,48,323,371,0,43,UCBPlayer
4775,UCBPlayer,48,323,371,0,43,UCBPlayer
4776,UCBPlayer,47,327,374,0,42,UCBPlayer
4777,UCBPlayer,55,295,350,0,50,UCBPlayer
4778,UCBPlayer,97,262,359,6,49,UCBPlayer
4779,UCBPlayer,53,303,356,0,48,UCBPlayer
4780,UCBPlayer,51,311,362,0,46,UCBPlayer
4781,UCBPlayer,57,287,344,0,52,UCBPlayer
4782,UCBPlayer,59,279,338,0,54,UCBPlayer
4783,UCBPlayer,65,270,335,0,55,UCBPlayer
4784,UCBPlayer,57,287,344,0,52,UCBPlayer
4785,UCBPlayer,117,242,359,9,50,UCBPlayer
4786,UCBPlayer,50,330,380,0,40,UCBPlayer
4787,UCBPlayer,62,277,339,1,54,UCBPlayer
4788,UCBPlayer,138,218,356,15,53,UCBPlayer
4789,UCBPlayer,64,269,333,1,56,UCBPlayer
4790,UCBPlayer,58,298,356,0,48,UCBPlayer
4791,UCBPlayer,51,316,367,2,45,UCBPlayer
4792,UCBPlayer,62,292,354,1,49,UCBPlayer
4793,UCBPlayer,71,261,332,0,56,UCBPlayer
4794,UCBPlayer,52,307,359,0,47,UCBPlayer
4795,UCBPlayer,58,283,341,0,53,UCBPlayer
4796,UCBPlayer,66,266,332,0,56,UCBPlayer
4797,UCBPlayer,58,283,341,0,53,UCBPlayer
4798,UCBPlayer,57,287,344,0,52,UCBPlayer
4799,UCBPlayer,62,292,354,1,49,UCBPlayer
4800,UCBPlayer,49,319,368,0,44,UCBPlayer
4801,UCBPlayer,62,312,374,3,43,UCBPlayer
4802,UCBPlayer,71,256,327,1,58,UCBPlayer
4803,UCBPlayer,57,287,344,0,52,UCBPlayer
4804,UCBPlayer,52,307,359,0,47,UCBPlayer
4805,UCBPlayer,66,276,342,1,53,UCBPlayer
4806,UCBPlayer,59,279,338,0,54,UCBPlayer
4807,UCBPlayer,65,280,345,1,52,UCBPlayer
4808,UCBPlayer,55,295,350,0,50,UCBPlayer
4809,UCBPlayer,54,299,353,0,49,UCBPlayer
4810,UCBPlayer,48,323,371,0,43,UCBPlayer
4811,UCBPlayer,68,298,366,4,46,UCBPlayer
4812,UCBPlayer,110,240,350,9,53,UCBPlayer
4813,UCBPlayer,61,286,347,0,51,UCBPlayer
4814,UCBPlayer,52,307,359,0,47,UCBPlayer
4815,UCBPlayer,90,265,355,5,50,UCBPlayer
4816,UCBPlayer,49,329,378,1,41,UCBPlayer
4817,UCBPlayer,87,312,399,10,37,UCBPlayer
4818,UCBPlayer,69,264,333,1,56,UCBPlayer
4819,UCBPlayer,65,280,345,1,52,UCBPlayer
4820,UCBPlayer,53,303,356,0,48,UCBPlayer
4821,UCBPlayer,52,307,359,0,47,UCBPlayer
4822,UCBPlayer,52,307,359,0,47,UCBPlayer
4823,UCBPlayer,49,339,388,2,38,UCBPlayer
4824,UCBPlayer,58,298,356,0,48,UCBPlayer
4825,UCBPlayer,52,307,359,0,47,UCBPlayer
4826,UCBPlayer,60,275,335,0,55,UCBPlayer
4827,UCBPlayer,108,258,366,10,48,UCBPlayer
4828,UCBPlayer,63,278,341,0,53,UCBPlayer
4829,UCBPlayer,57,287,344,0,52,UCBPlayer
4830,UCBPlayer,72,302,374,6,44,UCBPlayer
4831,UCBPlayer,63,278,341,0,53,UCBPlayer
4832,UCBPlayer,56,291,347,0,51,UCBPlayer
4833,UCBPlayer,70,315,385,5,40,UCBPlayer
4834,UCBPlayer,47,327,374,0,42,UCBPlayer
4835,UCBPlayer,54,299,353,0,49,UCBPlayer
4836,UCBPlayer,59,289,348,1,51,UCBPlayer
4837,UCBPlayer,92,282,374,9,45,UCBPlayer
4838,UCBPlayer,253,223,476,39,21,Player A
4839,UCBPlayer,77,287,364,2,46,UCBPlayer
4840,UCBPlayer,69,274,343,2,53,UCBPlayer
4841,UCBPlayer,57,287,344,0,52,UCBPlayer
4842,UCBPlayer,48,323,371,0,43,UCBPlayer
4843,UCBPlayer,51,306,357,1,48,UCBPlayer
4844,UCBPlayer,64,274,338,0,54,UCBPlayer
4845,UCBPlayer,72,312,384,7,41,UCBPlayer
4846,UCBPlayer,56,291,347,0,51,UCBPlayer
4847,UCBPlayer,69,299,368,3,45,UCBPlayer
4848,UCBPlayer,56,316,372,1,43,UCBPlayer
4849,UCBPlayer,71,256,327,1,58,UCBPlayer
4850,UCBPlayer,55,295,350,0,50,UCBPlayer
4851,UCBPlayer,191,211,402,25,41,UCBPlayer
4852,UCBPlayer,58,283,341,0,53,UCBPlayer
4853,UCBPlayer,103,243,346,5,53,UCBPlayer
4854,UCBPlayer,60,275,335,0,55,UCBPlayer
4855,UCBPlayer,50,315,365,0,45,UCBPlayer
4856,UCBPlayer,50,325,375,1,42,UCBPlayer
4857,UCBPlayer,96,271,367,8,47,UCBPlayer
4858,UCBPlayer,75,320,395,6,37,UCBPlayer
4859,UCBPlayer,56,311,367,2,45,UCBPlayer
4860,UCBPlayer,59,289,348,1,51,UCBPlayer
4861,UCBPlayer,80,280,360,4,48,UCBPlayer
4862,UCBPlayer,96,286,382,8,42,UCBPlayer
4863,UCBPlayer,68,268,336,1,55,UCBPlayer
4864,UCBPlayer,69,284,353,3,50,UCBPlayer
4865,UCBPlayer,54,299,353,0,49,UCBPlayer
4866,UCBPlayer,63,288,351,1,50,UCBPlayer
4867,UCBPlayer,59,314,373,2,43,UCBPlayer
4868,UCBPlayer,59,279,338,0,54,UCBPlayer
4869,UCBPlayer,52,317,369,1,44,UCBPlayer
4870,UCBPlayer,89,279,368,6,46,UCBPlayer
4871,UCBPlayer,45,335,380,0,40,UCBPlayer
4872,UCBPlayer,58,293,351,1,50,UCBPlayer
4873,UCBPlayer,81,271,352,5,51,UCBPlayer
4874,UCBPlayer,102,272,374,12,46,UCBPlayer
4875,UCBPlayer,57,297,354,1,49,UCBPlayer
4876,UCBPlayer,158,248,406,17,37,UCBPlayer
4877,UCBPlayer,57,287,344,0,52,UCBPlayer
4878,UCBPlayer,68,298,366,4,46,UCBPlayer
4879,UCBPlayer,69,299,368,3,45,UCBPlayer
4880,UCBPlayer,60,295,355,2,49,UCBPlayer
4881,UCBPlayer,52,332,384,1,39,UCBPlayer
4882,UCBPlayer,59,294,353,0,49,UCBPlayer
4883,UCBPlayer,56,291,347,0,51,UCBPlayer
4884,UCBPlayer,67,282,349,2,51,UCBPlayer
4885,UCBPlayer,51,311,362,0,46,UCBPlayer
4886,UCBPlayer,57,287,344,0,52,UCBPlayer
4887,UCBPlayer,54,309,363,1,46,UCBPlayer
4888,UCBPlayer,54,314,368,0,44,UCBPlayer
4889,UCBPlayer,76,276,352,8,52,UCBPlayer
4890,UCBPlayer,61,311,372,1,43,UCBPlayer
4891,UCBPlayer,54,299,353,0,49,UCBPlayer
4892,UCBPlayer,48,323,371,0,43,UCBPlayer
4893,UCBPlayer,52,302,354,1,49,UCBPlayer
4894,UCBPlayer,70,295,365,3,46,UCBPlayer
4895,UCBPlayer,47,312,359,0,47,UCBPlayer
4896,UCBPlayer,56,291,347,0,51,UCBPlayer
4897,UCBPlayer,67,282,349,2,51,UCBPlayer
4898,UCBPlayer,65,280,345,1,52,UCBPlayer
4899,UCBPlayer,57,287,344,0,52,UCBPlayer
4900,UCBPlayer,54,324,378,1,41,UCBPlayer
4901,UCBPlayer,43,343,386,0,38,UCBPlayer
4902,UCBPlayer,55,295,350,0,50,UCBPlayer
4903,UCBPlayer,57,287,344,0,52,UCBPlayer
4904,UCBPlayer,59,304,363,1,46,UCBPlayer
4905,UCBPlayer,67,307,374,3,43,UCBPlayer
4906,UCBPlayer,49,319,368,0,44,UCBPlayer
4907,UCBPlayer,82,297,379,8,43,UCBPlayer
4908,UCBPlayer,53,303,356,0,48,UCBPlayer
4909,UCBPlayer,57,287,344,0,52,UCBPlayer
4910,UCBPlayer,67,272,339,1,54,UCBPlayer
4911,UCBPlayer,53,303,356,0,48,UCBPlayer
4912,UCBPlayer,68,308,376,2,42,UCBPlayer
4913,UCBPlayer,71,301,372,4,44,UCBPlayer
4914,UCBPlayer,71,266,337,2,55,UCBPlayer
4915,UCBPlayer,97,282,379,8,43,UCBPlayer
4916,UCBPlayer,90,265,355,5,50,UCBPlayer
4917,UCBPlayer,60,275,335,0,55,UCBPlayer
4918,UCBPlayer,59,279,338,0,54,UCBPlayer
4919,UCBPlayer,50,315,365,0,45,UCBPlayer
4920,UCBPlayer,57,287,344,0,52,UCBPlayer
4921,UCBPlayer,166,236,402,25,41,UCBPlayer
4922,UCBPlayer,48,323,371,0,43,UCBPlayer
4923,UCBPlayer,66,291,357,1,48,UCBPlayer
4924,UCBPlayer,57,297,354,1,49,UCBPlayer
4925,UCBPlayer,60,320,380,3,41,UCBPlayer
4926,UCBPlayer,53,303,356,0,48,UCBPlayer
4927,UCBPlayer,54,299,353,0,49,UCBPlayer
4928,UCBPlayer,57,352,409,5,32,UCBPlayer
4929,UCBPlayer,45,335,380,0,40,UCBPlayer
4930,UCBPlayer,74,299,373,5,44,UCBPlayer
4931,UCBPlayer,77,237,314,0,62,UCBPlayer
4932,UCBPlayer,52,307,359,0,47,UCBPlayer
4933,UCBPlayer,67,302,369,4,45,UCBPlayer
4934,UCBPlayer,73,278,351,4,51,UCBPlayer
4935,UCBPlayer,60,300,360,1,47,UCBPlayer
4936,UCBPlayer,58,293,351,1,50,UCBPlayer
4937,UCBPlayer,58,318,376,2,42,UCBPlayer
4938,UCBPlayer,62,302,364,2,46,UCBPlayer
4939,UCBPlayer,57,302,359,3,48,UCBPlayer
4940,UCBPlayer,65,285,350,0,50,UCBPlayer
4941,UCBPlayer,57,297,354,1,49,UCBPlayer
4942,UCBPlayer,57,312,369,1,44,UCBPlayer
4943,UCBPlayer,58,298,356,3,49,UCBPlayer
4944,UCBPlayer,103,263,366,10,48,UCBPlayer
4945,UCBPlayer,79,299,378,4,42,UCBPlayer
4946,UCBPlayer,61,271,332,0,56,UCBPlayer
4947,UCBPlayer,70,280,350,3,51,UCBPlayer
4948,UCBPlayer,86,286,372,7,45,UCBPlayer
4949,UCBPlayer,75,305,380,3,41,UCBPlayer
4950,UCBPlayer,58,308,366,1,45,UCBPlayer
4951,UCBPlayer,50,315,365,0,45,UCBPlayer
4952,UCBPlayer,51,311,362,0,46,UCBPlayer
4953,UCBPlayer,54,299,353,0,49,UCBPlayer
4954,UCBPlayer,48,333,381,1,40,UCBPlayer
4955,UCBPlayer,70,270,340,2,54,UCBPlayer
4956,UCBPlayer,56,291,347,0,51,UCBPlayer
4957,UCBPlayer,79,284,363,4,47,UCBPlayer
4958,UCBPlayer,84,239,323,3,60,UCBPlayer
4959,UCBPlayer,53,303,356,0,48,UCBPlayer
4960,UCBPlayer,79,259,338,3,55,UCBPlayer
4961,UCBPlayer,69,304,373,5,44,UCBPlayer
4962,UCBPlayer,86,276,362,6,48,UCBPlayer
4963,UCBPlayer,54,299,353,0,49,UCBPlayer
4964,UCBPlayer,61,296,357,1,48,UCBPlayer
4965,UCBPlayer,55,295,350,0,50,UCBPlayer
4966,UCBPlayer,67,302,369,4,45,UCBPlayer
4967,UCBPlayer,55,295,350,0,50,UCBPlayer
4968,UCBPlayer,124,264,388,14,42,UCBPlayer
4969,UCBPlayer,78,293,371,6,45,UCBPlayer
4970,UCBPlayer,51,311,362,0,46,UCBPlayer
4971,UCBPlayer,47,327,374,0,42,UCBPlayer
4972,UCBPlayer,84,274,358,5,49,UCBPlayer
4973,UCBPlayer,52,307,359,0,47,UCBPlayer
4974,UCBPlayer,70,280,350,3,51,UCBPlayer
4975,UCBPlayer,67,262,329,0,57,UCBPlayer
4976,UCBPlayer,57,312,369,1,44,UCBPlayer
4977,UCBPlayer,49,319,368,0,44,UCBPlayer
4978,UCBPlayer,56,301,357,1,48,UCBPlayer
4979,UCBPlayer,59,294,353,0,49,UCBPlayer
4980,UCBPlayer,77,297,374,3,43,UCBPlayer
4981,UCBPlayer,46,331,377,0,41,UCBPlayer
4982,UCBPlayer,51,311,362,0,46,UCBPlayer
4983,UCBPlayer,73,283,356,3,49,UCBPlayer
4984,UCBPlayer,66,291,357,1,48,UCBPlayer
4985,UCBPlayer,50,315,365,0,45,UCBPlayer
4986,UCBPlayer,54,299,353,0,49,UCBPlayer
4987,UCBPlayer,60,275,335,0,55,UCBPlayer
4988,UCBPlayer,59,319,378,1,41,UCBPlayer
4989,UCBPlayer,50,315,365,0,45,UCBPlayer
4990,UCBPlayer,63,273,336,1,55,UCBPlayer
4991,UCBPlayer,67,287,354,1,49,UCBPlayer
4992,UCBPlayer,69,279,348,1,51,UCBPlayer
4993,UCBPlayer,61,291,352,2,50,UCBPlayer
4994,UCBPlayer,63,288,351,1,50,UCBPlayer
4995,UCBPlayer,70,290,360,4,48,UCBPlayer
4996,UCBPlayer,58,323,381,1,40,UCBPlayer
4997,UCBPlayer,47,312,359,0,47,UCBPlayer
4998,UCBPlayer,60,310,370,2,44,UCBPlayer
4999,UCBPlayer,65,280,345,1,52,UCBPlayer
5000,UCBPlayer,48,323,371,0,43,UCBPlayer
5001,UCBPlayer,54,299,353,0,49,UCBPlayer
5002,UCBPlayer,51,311,362,0,46,UCBPlayer
5003,UCBPlayer,51,311,362,0,46,UCBPlayer
5004,UCBPlayer,244,209,453,34,27,Player A
5005,UCBPlayer,57,287,344,0,52,UCBPlayer
5006,UCBPlayer,58,283,341,0,53,UCBPlayer
5007,UCBPlayer,50,315,365,0,45,UCBPlayer
5008,UCBPlayer,55,295,350,0,50,UCBPlayer
5009,UCBPlayer,64,314,378,4,42,UCBPlayer
5010,UCBPlayer,73,293,366,4,46,UCBPlayer
5011,UCBPlayer,74,304,378,4,42,UCBPlayer
5012,UCBPlayer,52,307,359,0,47,UCBPlayer
5013,UCBPlayer,51,331,382,2,40,UCBPlayer
5014,UCBPlayer,67,287,354,1,49,UCBPlayer
5015,UCBPlayer,50,315,365,0,45,UCBPlayer
5016,UCBPlayer,72,287,359,3,48,UCBPlayer
5017,UCBPlayer,58,308,366,1,45,UCBPlayer
5018,UCBPlayer,54,299,353,0,49,UCBPlayer
5019,UCBPlayer,60,275,335,0,55,UCBPlayer
5020,UCBPlayer,64,284,348,1,51,UCBPlayer
5021,UCBPlayer,57,322,379,2,41,UCBPlayer
5022,UCBPlayer,54,299,353,0,49,UCBPlayer
5023,UCBPlayer,65,315,380,3,41,UCBPlayer
5024,UCBPlayer,88,288,376,8,44,UCBPlayer
5025,UCBPlayer,71,266,337,2,55,UCBPlayer
5026,UCBPlayer,142,237,379,11,44,UCBPlayer
5027,UCBPlayer,46,341,387,1,38,UCBPlayer
5028,UCBPlayer,63,288,351,1,50,UCBPlayer
5029,UCBPlayer,55,295,350,0,50,UCBPlayer
5030,UCBPlayer,62,267,329,0,57,UCBPlayer
5031,UCBPlayer,140,235,375,16,47,UCBPlayer
5032,UCBPlayer,57,312,369,1,44,UCBPlayer
5033,UCBPlayer,125,270,395,18,41,UCBPlayer
5034,UCBPlayer,76,306,382,5,41,UCBPlayer
5035,UCBPlayer,67,302,369,4,45,UCBPlayer
5036,UCBPlayer,55,310,365,0,45,UCBPlayer
5037,UCBPlayer,53,303,356,0,48,UCBPlayer
5038,UCBPlayer,73,318,391,5,38,UCBPlayer
5039,UCBPlayer,52,307,359,0,47,UCBPlayer
5040,UCBPlayer,56,291,347,0,51,UCBPlayer
5041,UCBPlayer,71,246,317,0,61,UCBPlayer
5042,UCBPlayer,48,323,371,0,43,UCBPlayer
5043,UCBPlayer,65,305,370,5,45,UCBPlayer
5044,UCBPlayer,67,287,354,1,49,UCBPlayer
5045,UCBPlayer,75,260,335,3,56,UCBPlayer
5046,UCBPlayer,60,315,375,1,42,UCBPlayer
5047,UCBPlayer,60,300,360,1,47,UCBPlayer
5048,UCBPlayer,45,320,365,0,45,UCBPlayer
5049,UCBPlayer,68,278,346,2,52,UCBPlayer
5050,UCBPlayer,57,287,344,0,52,UCBPlayer
5051,UCBPlayer,59,304,363,1,46,UCBPlayer
5052,UCBPlayer,68,268,336,1,55,UCBPlayer
5053,UCBPlayer,147,252,399,19,40,UCBPlayer
5054,UCBPlayer,54,324,378,1,41,UCBPlayer
5055,UCBPlayer,49,319,368,0,44,UCBPlayer
5056,UCBPlayer,56,291,347,0,51,UCBPlayer
5057,UCBPlayer,53,303,356,0,48,UCBPlayer
5058,UCBPlayer,57,287,344,0,52,UCBPlayer
5059,UCBPlayer,50,315,365,0,45,UCBPlayer
5060,UCBPlayer,49,319,368,0,44,UCBPlayer
5061,UCBPlayer,59,279,338,0,54,UCBPlayer
5062,UCBPlayer,61,286,347,0,51,UCBPlayer
5063,UCBPlayer,57,312,369,1,44,UCBPlayer
5064,UCBPlayer,56,291,347,0,51,UCBPlayer
5065,UCBPlayer,55,295,350,0,50,UCBPlayer
5066,UCBPlayer,61,286,347,0,51,UCBPlayer
5067,UCBPlayer,81,301,382,8,42,UCBPlayer
5068,UCBPlayer,54,314,368,0,44,UCBPlayer
5069,UCBPlayer,53,303,356,0,48,UCBPlayer
5070,UCBPlayer,60,275,335,0,55,UCBPlayer
5071,UCBPlayer,60,310,370,2,44,UCBPlayer
5072,UCBPlayer,53,303,356,0,48,UCBPlayer
5073,UCBPlayer,52,307,359,0,47,UCBPlayer
5074,UCBPlayer,69,284,353,3,50,UCBPlayer
5075,UCBPlayer,191,236,427,23,32,UCBPlayer
5076,UCBPlayer,224,219,443,30,29,Player A
5077,UCBPlayer,133,288,421,11,30,UCBPlayer
5078,UCBPlayer,66,286,352,2,50,UCBPlayer
5079,UCBPlayer,53,303,356,0,48,UCBPlayer
5080,UCBPlayer,65,305,370,2,44,UCBPlayer
5081,UCBPlayer,57,317,374,3,43,UCBPlayer
5082,UCBPlayer,142,257,399,16,39,UCBPlayer
5083,UCBPlayer,66,266,332,0,56,UCBPlayer
5084,UCBPlayer,61,296,357,1,48,UCBPlayer
5085,UCBPlayer,76,296,372,4,44,UCBPlayer
5086,UCBPlayer,61,291,352,2,50,UCBPlayer
5087,UCBPlayer,49,334,383,0,39,UCBPlayer
5088,UCBPlayer,65,290,355,2,49,UCBPlayer
5089,UCBPlayer,67,312,379,8,43,UCBPlayer
5090,UCBPlayer,126,256,382,14,44,UCBPlayer
5091,UCBPlayer,65,280,345,1,52,UCBPlayer
5092,UCBPlayer,61,271,332,0,56,UCBPlayer
5093,UCBPlayer,66,286,352,2,50,UCBPlayer
5094,UCBPlayer,57,287,344,0,52,UCBPlayer
5095,UCBPlayer,72,282,354,4,50,UCBPlayer
5096,UCBPlayer,106,286,392,9,39,UCBPlayer
5097,UCBPlayer,69,279,348,1,51,UCBPlayer
5098,UCBPlayer,72,312,384,4,40,UCBPlayer
5099,UCBPlayer,65,300,365,3,46,UCBPlayer
5100,UCBPlayer,112,282,394,14,40,UCBPlayer
5101,UCBPlayer,54,299,353,0,49,UCBPlayer
5102,UCBPlayer,74,289,363,4,47,UCBPlayer
5103,UCBPlayer,73,273,346,2,52,UCBPlayer
5104,UCBPlayer,54,299,353,0,49,UCBPlayer
5105,UCBPlayer,71,296,367,5,46,UCBPlayer
5106,UCBPlayer,63,323,386,3,39,UCBPlayer
5107,UCBPlayer,55,295,350,0,50,UCBPlayer
5108,UCBPlayer,56,316,372,1,43,UCBPlayer
5109,UCBPlayer,53,303,356,0,48,UCBPlayer
5110,UCBPlayer,53,303,356,0,48,UCBPlayer
5111,UCBPlayer,91,291,382,11,43,UCBPlayer
5112,UCBPlayer,77,257,334,2,56,UCBPlayer
5113,UCBPlayer,61,271,332,0,56,UCBPlayer
5114,UCBPlayer,65,290,355,2,49,UCBPlayer
5115,UCBPlayer,63,298,361,2,47,UCBPlayer
5116,UCBPlayer,107,297,404,12,36,UCBPlayer
5117,UCBPlayer,56,311,367,2,45,UCBPlayer
5118,UCBPlayer,100,290,390,13,41,UCBPlayer
5119,UCBPlayer,90,285,375,7,44,UCBPlayer
5120,UCBPlayer,62,302,364,2,46,UCBPlayer
5121,UCBPlayer,58,338,396,4,36,UCBPlayer
5122,UCBPlayer,59,279,338,0,54,UCBPlayer
5123,UCBPlayer,60,300,360,1,47,UCBPlayer
5124,UCBPlayer,55,330,385,2,39,UCBPlayer
5125,UCBPlayer,59,279,338,0,54,UCBPlayer
5126,UCBPlayer,51,311,362,0,46,UCBPlayer
5127,UCBPlayer,64,259,323,0,59,UCBPlayer
5128,UCBPlayer,53,303,356,0,48,UCBPlayer
5129,UCBPlayer,55,295,350,0,50,UCBPlayer
5130,UCBPlayer,63,263,326,0,58,UCBPlayer
5131,UCBPlayer,53,303,356,0,48,UCBPlayer
5132,UCBPlayer,56,291,347,0,51,UCBPlayer
5133,UCBPlayer,54,309,363,1,46,UCBPlayer
5134,UCBPlayer,70,295,365,3,46,UCBPlayer
5135,UCBPlayer,65,290,355,2,49,UCBPlayer
5136,UCBPlayer,57,302,359,0,47,UCBPlayer
5137,UCBPlayer,98,293,391,11,40,UCBPlayer
5138,UCBPlayer,78,288,366,4,46,UCBPlayer
5139,UCBPlayer,54,299,353,0,49,UCBPlayer
5140,UCBPlayer,60,285,345,1,52,UCBPlayer
5141,UCBPlayer,72,287,359,3,48,UCBPlayer
5142,UCBPlayer,55,295,350,0,50,UCBPlayer
5143,UCBPlayer,51,311,362,0,46,UCBPlayer
5144,UCBPlayer,60,295,355,2,49,UCBPlayer
5145,UCBPlayer,71,291,362,3,47,UCBPlayer
5146,UCBPlayer,51,311,362,0,46,UCBPlayer
5147,UCBPlayer,57,297,354,1,49,UCBPlayer
5148,UCBPlayer,63,303,366,4,46,UCBPlayer
5149,UCBPlayer,75,290,365,3,46,UCBPlayer
5150,UCBPlayer,78,293,371,3,44,UCBPlayer
5151,UCBPlayer,240,230,470,30,20,Player A
5152,UCBPlayer,52,307,359,0,47,UCBPlayer
5153,UCBPlayer,60,300,360,1,47,UCBPlayer
5154,UCBPlayer,55,320,375,1,42,UCBPlayer
5155,UCBPlayer,73,283,356,3,49,UCBPlayer
5156,UCBPlayer,56,291,347,0,51,UCBPlayer
5157,UCBPlayer,160,255,415,20,35,UCBPlayer
5158,UCBPlayer,69,264,333,1,56,UCBPlayer
5159,UCBPlayer,48,323,371,0,43,UCBPlayer
5160,UCBPlayer,56,291,347,0,51,UCBPlayer
5161,UCBPlayer,49,319,368,0,44,UCBPlayer
5162,UCBPlayer,58,308,366,1,45,UCBPlayer
5163,UCBPlayer,54,299,353,0,49,UCBPlayer
5164,UCBPlayer,61,271,332,0,56,UCBPlayer
5165,UCBPlayer,61,296,357,1,48,UCBPlayer
5166,UCBPlayer,53,303,356,0,48,UCBPlayer
5167,UCBPlayer,78,303,381,7,42,UCBPlayer
5168,UCBPlayer,63,298,361,2,47,UCBPlayer
5169,UCBPlayer,54,299,353,0,49,UCBPlayer
5170,UCBPlayer,66,296,362,3,47,UCBPlayer
5171,UCBPlayer,76,266,342,4,54,UCBPlayer
5172,UCBPlayer,62,292,354,1,49,UCBPlayer
5173,UCBPlayer,59,279,338,0,54,UCBPlayer
5174,UCBPlayer,59,314,373,2,43,UCBPlayer
5175,UCBPlayer,100,255,355,8,51,UCBPlayer
5176,UCBPlayer,52,307,359,0,47,UCBPlayer
5177,UCBPlayer,53,303,356,0,48,UCBPlayer
5178,UCBPlayer,67,282,349,2,51,UCBPlayer
5179,UCBPlayer,54,299,353,0,49,UCBPlayer
5180,UCBPlayer,52,307,359,0,47,UCBPlayer
5181,UCBPlayer,78,278,356,6,50,UCBPlayer
5182,UCBPlayer,44,339,383,0,39,UCBPlayer
5183,UCBPlayer,67,302,369,4,45,UCBPlayer
5184,UCBPlayer,62,282,344,0,52,UCBPlayer
5185,UCBPlayer,55,295,350,0,50,UCBPlayer
5186,UCBPlayer,62,267,329,0,57,UCBPlayer
5187,UCBPlayer,54,299,353,0,49,UCBPlayer
5188,UCBPlayer,63,283,346,2,52,UCBPlayer
5189,UCBPlayer,67,282,349,2,51,UCBPlayer
5190,UCBPlayer,56,291,347,0,51,UCBPlayer
5191,UCBPlayer,52,307,359,0,47,UCBPlayer
5192,UCBPlayer,68,293,361,5,48,UCBPlayer
5193,UCBPlayer,117,252,369,10,47,UCBPlayer
5194,UCBPlayer,69,289,358,2,48,UCBPlayer
5195,UCBPlayer,77,262,339,4,55,UCBPlayer
5196,UCBPlayer,71,281,352,2,50,UCBPlayer
5197,UCBPlayer,86,291,377,9,44,UCBPlayer
5198,UCBPlayer,59,279,338,0,54,UCBPlayer
5199,UCBPlayer,51,311,362,0,46,UCBPlayer
5200,UCBPlayer,57,282,339,1,54,UCBPlayer
5201,UCBPlayer,55,310,365,0,45,UCBPlayer
5202,UCBPlayer,53,303,356,0,48,UCBPlayer
5203,UCBPlayer,70,260,330,1,57,UCBPlayer
5204,UCBPlayer,59,304,363,1,46,UCBPlayer
5205,UCBPlayer,65,280,345,1,52,UCBPlayer
5206,UCBPlayer,91,266,357,7,50,UCBPlayer
5207,UCBPlayer,72,252,324,1,59,UCBPlayer
5208,UCBPlayer,57,287,344,0,52,UCBPlayer
5209,UCBPlayer,69,284,353,3,50,UCBPlayer
5210,UCBPlayer,76,291,367,5,46,UCBPlayer
5211,UCBPlayer,48,323,371,0,43,UCBPlayer
5212,UCBPlayer,70,290,360,4,48,UCBPlayer
5213,UCBPlayer,58,318,376,2,42,UCBPlayer
5214,UCBPlayer,62,267,329,0,57,UCBPlayer
5215,UCBPlayer,74,294,368,6,46,UCBPlayer
5216,UCBPlayer,80,285,365,6,47,UCBPlayer
5217,UCBPlayer,75,285,360,4,48,UCBPlayer
5218,UCBPlayer,59,304,363,1,46,UCBPlayer
5219,UCBPlayer,91,301,392,6,38,UCBPlayer
5220,UCBPlayer,102,267,369,7,46,UCBPlayer
5221,UCBPlayer,60,290,350,0,50,UCBPlayer
5222,UCBPlayer,115,290,405,13,36,UCBPlayer
5223,UCBPlayer,63,263,326,0,58,UCBPlayer
5224,UCBPlayer,51,311,362,0,46,UCBPlayer
5225,UCBPlayer,49,319,368,0,44,UCBPlayer
5226,UCBPlayer,60,275,335,0,55,UCBPlayer
5227,UCBPlayer,70,290,360,4,48,UCBPlayer
5228,UCBPlayer,52,322,374,0,42,UCBPlayer
5229,UCBPlayer,44,339,383,0,39,UCBPlayer
5230,UCBPlayer,95,285,380,6,42,UCBPlayer
5231,UCBPlayer,55,295,350,0,50,UCBPlayer
5232,UCBPlayer,62,317,379,5,42,UCBPlayer
5233,UCBPlayer,62,312,374,3,43,UCBPlayer
5234,UCBPlayer,50,315,365,0,45,UCBPlayer
5235,UCBPlayer,72,332,404,6,34,UCBPlayer
5236,UCBPlayer,57,287,344,0,52,UCBPlayer
5237,UCBPlayer,68,258,326,0,58,UCBPlayer
5238,UCBPlayer,49,339,388,2,38,UCBPlayer
5239,UCBPlayer,81,261,342,4,54,UCBPlayer
5240,UCBPlayer,55,295,350,0,50,UCBPlayer
5241,UCBPlayer,60,275,335,0,55,UCBPlayer
5242,UCBPlayer,56,301,357,1,48,UCBPlayer
5243,UCBPlayer,73,293,366,4,46,UCBPlayer
5244,UCBPlayer,52,317,369,1,44,UCBPlayer
5245,UCBPlayer,88,293,381,10,43,UCBPlayer
5246,UCBPlayer,69,279,348,1,51,UCBPlayer
5247,UCBPlayer,53,303,356,0,48,UCBPlayer
5248,UCBPlayer,64,284,348,1,51,UCBPlayer
5249,UCBPlayer,50,315,365,0,45,UCBPlayer
5250,UCBPlayer,49,319,368,0,44,UCBPlayer
5251,UCBPlayer,67,272,339,1,54,UCBPlayer
5252,UCBPlayer,55,280,335,0,55,UCBPlayer
5253,UCBPlayer,56,291,347,0,51,UCBPlayer
5254,UCBPlayer,83,273,356,6,50,UCBPlayer
5255,UCBPlayer,55,295,350,0,50,UCBPlayer
5256,UCBPlayer,67,287,354,1,49,UCBPlayer
5257,UCBPlayer,50,315,365,0,45,UCBPlayer
5258,UCBPlayer,48,323,371,0,43,UCBPlayer
5259,UCBPlayer,80,275,355,5,50,UCBPlayer
5260,UCBPlayer,95,280,375,7,44,UCBPlayer
5261,UCBPlayer,85,255,340,5,55,UCBPlayer
5262,UCBPlayer,80,315,395,9,38,UCBPlayer
5263,UCBPlayer,53,328,381,1,40,UCBPlayer
5264,UCBPlayer,45,335,380,0,40,UCBPlayer
5265,UCBPlayer,72,287,359,3,48,UCBPlayer
5266,UCBPlayer,113,258,371,9,46,UCBPlayer
5267,UCBPlayer,65,320,385,5,40,UCBPlayer
5268,UCBPlayer,68,278,346,2,52,UCBPlayer
5269,UCBPlayer,53,303,356,0,48,UCBPlayer
5270,UCBPlayer,51,311,362,0,46,UCBPlayer
5271,UCBPlayer,60,320,380,3,41,UCBPlayer
5272,UCBPlayer,122,297,419,12,31,UCBPlayer
5273,UCBPlayer,76,256,332,3,57,UCBPlayer
5274,UCBPlayer,62,292,354,1,49,UCBPlayer
5275,UCBPlayer,54,299,353,0,49,UCBPlayer
5276,UCBPlayer,81,261,342,4,54,UCBPlayer
5277,UCBPlayer,56,291,347,0,51,UCBPlayer
5278,UCBPlayer,63,288,351,1,50,UCBPlayer
5279,UCBPlayer,69,314,383,6,41,UCBPlayer
5280,UCBPlayer,67,262,329,0,57,UCBPlayer
5281,UCBPlayer,66,276,342,1,53,UCBPlayer
5282,UCBPlayer,60,275,335,0,55,UCBPlayer
5283,UCBPlayer,57,287,344,0,52,UCBPlayer
5284,UCBPlayer,56,291,347,0,51,UCBPlayer
5285,UCBPlayer,85,250,335,3,56,UCBPlayer
5286,UCBPlayer,56,291,347,0,51,UCBPlayer
5287,UCBPlayer,64,274,338,0,54,UCBPlayer
5288,UCBPlayer,65,280,345,1,52,UCBPlayer
5289,UCBPlayer,73,288,361,5,48,UCBPlayer
5290,UCBPlayer,65,280,345,1,52,UCBPlayer
5291,UCBPlayer,61,296,357,1,48,UCBPlayer
5292,UCBPlayer,60,310,370,2,44,UCBPlayer
5293,UCBPlayer,69,254,323,0,59,UCBPlayer
5294,UCBPlayer,67,307,374,6,44,UCBPlayer
5295,UCBPlayer,69,289,358,2,48,UCBPlayer
5296,UCBPlayer,54,299,353,0,49,UCBPlayer
5297,UCBPlayer,58,293,351,1,50,UCBPlayer
5298,UCBPlayer,70,275,345,1,52,UCBPlayer
5299,UCBPlayer,52,307,359,0,47,UCBPlayer
5300,UCBPlayer,50,315,365,0,45,UCBPlayer
5301,UCBPlayer,51,311,362,0,46,UCBPlayer
5302,UCBPlayer,59,279,338,0,54,UCBPlayer
5303,UCBPlayer,50,300,350,0,50,UCBPlayer
5304,UCBPlayer,62,292,354,1,49,UCBPlayer
5305,UCBPlayer,51,311,362,0,46,UCBPlayer
5306,UCBPlayer,59,304,363,1,46,UCBPlayer
5307,UCBPlayer,95,270,365,6,47,UCBPlayer
5308,UCBPlayer,57,287,344,0,52,UCBPlayer
5309,UCBPlayer,67,292,359,3,48,UCBPlayer
5310,UCBPlayer,73,283,356,3,49,UCBPlayer
5311,UCBPlayer,83,273,356,3,49,UCBPlayer
5312,UCBPlayer,82,247,329,3,58,UCBPlayer
5313,UCBPlayer,71,286,357,4,49,UCBPlayer
5314,UCBPlayer,64,294,358,2,48,UCBPlayer
5315,UCBPlayer,56,291,347,0,51,UCBPlayer
5316,UCBPlayer,56,291,347,0,51,UCBPlayer
5317,UCBPlayer,174,264,438,25,29,UCBPlayer
5318,UCBPlayer,64,294,358,2,48,UCBPlayer
5319,UCBPlayer,120,255,375,16,47,UCBPlayer
5320,UCBPlayer,67,272,339,1,54,UCBPlayer
5321,UCBPlayer,63,338,401,6,35,UCBPlayer
5322,UCBPlayer,67,312,379,5,42,UCBPlayer
5323,UCBPlayer,79,299,378,10,44,UCBPlayer
5324,UCBPlayer,127,227,354,10,52,UCBPlayer
5325,UCBPlayer,57,287,344,0,52,UCBPlayer
5326,UCBPlayer,53,313,366,1,45,UCBPlayer
5327,UCBPlayer,74,259,333,1,56,UCBPlayer
5328,UCBPlayer,59,294,353,0,49,UCBPlayer
5329,UCBPlayer,103,273,376,8,44,UCBPlayer
5330,UCBPlayer,54,299,353,0,49,UCBPlayer
5331,UCBPlayer,50,315,365,0,45,UCBPlayer
5332,UCBPlayer,57,287,344,0,52,UCBPlayer
5333,UCBPlayer,57,287,344,0,52,UCBPlayer
5334,UCBPlayer,60,335,395,6,37,UCBPlayer
5335,UCBPlayer,64,274,338,0,54,UCBPlayer
5336,UCBPlayer,72,277,349,2,51,UCBPlayer
5337,UCBPlayer,62,292,354,1,49,UCBPlayer
5338,UCBPlayer,108,253,361,8,49,UCBPlayer
5339,UCBPlayer,59,314,373,2,43,UCBPlayer
5340,UCBPlayer,57,322,379,2,41,UCBPlayer
5341,UCBPlayer,46,331,377,0,41,UCBPlayer
5342,UCBPlayer,55,295,350,0,50,UCBPlayer
5343,UCBPlayer,56,291,347,0,51,UCBPlayer
5344,UCBPlayer,54,309,363,1,46,UCBPlayer
5345,UCBPlayer,88,308,396,7,37,UCBPlayer
5346,UCBPlayer,154,239,393,16,41,UCBPlayer
5347,UCBPlayer,65,270,335,0,55,UCBPlayer
5348,UCBPlayer,55,305,360,1,47,UCBPlayer
5349,UCBPlayer,64,309,373,2,43,UCBPlayer
5350,UCBPlayer,58,313,371,3,44,UCBPlayer
5351,UCBPlayer,67,277,344,0,52,UCBPlayer
5352,UCBPlayer,48,323,371,0,43,UCBPlayer
5353,UCBPlayer,52,307,359,0,47,UCBPlayer
5354,UCBPlayer,53,288,341,0,53,UCBPlayer
5355,UCBPlayer,105,250,355,8,51,UCBPlayer
5356,UCBPlayer,63,308,371,3,44,UCBPlayer
5357,UCBPlayer,59,279,338,0,54,UCBPlayer
5358,UCBPlayer,57,287,344,0,52,UCBPlayer
5359,UCBPlayer,64,294,358,2,48,UCBPlayer
5360,UCBPlayer,62,267,329,0,57,UCBPlayer
5361,UCBPlayer,61,311,372,1,43,UCBPlayer
5362,UCBPlayer,65,280,345,1,52,UCBPlayer
5363,UCBPlayer,54,299,353,0,49,UCBPlayer
5364,UCBPlayer,71,276,347,3,52,UCBPlayer
5365,UCBPlayer,100,270,370,11,47,UCBPlayer
5366,UCBPlayer,60,310,370,2,44,UCBPlayer
5367,UCBPlayer,68,278,346,2,52,UCBPlayer
5368,UCBPlayer,53,303,356,0,48,UCBPlayer
5369,UCBPlayer,65,300,365,3,46,UCBPlayer
5370,UCBPlayer,57,312,369,1,44,UCBPlayer
5371,UCBPlayer,62,267,329,0,57,UCBPlayer
5372,UCBPlayer,63,308,371,3,44,UCBPlayer
5373,UCBPlayer,107,272,379,8,43,UCBPlayer
5374,UCBPlayer,47,327,374,0,42,UCBPlayer
5375,UCBPlayer,53,303,356,0,48,UCBPlayer
5376,UCBPlayer,68,293,361,2,47,UCBPlayer
5377,UCBPlayer,83,273,356,6,50,UCBPlayer
5378,UCBPlayer,91,261,352,5,51,UCBPlayer
5379,UCBPlayer,60,275,335,0,55,UCBPlayer
5380,UCBPlayer,66,276,342,1,53,UCBPlayer
5381,UCBPlayer,82,287,369,7,46,UCBPlayer
5382,UCBPlayer,58,283,341,0,53,UCBPlayer
5383,UCBPlayer,96,246,342,4,54,UCBPlayer
5384,UCBPlayer,63,288,351,1,50,UCBPlayer
5385,UCBPlayer,96,276,372,7,45,UCBPlayer
5386,UCBPlayer,48,323,371,0,43,UCBPlayer
5387,UCBPlayer,63,288,351,1,50,UCBPlayer
5388,UCBPlayer,80,260,340,2,54,UCBPlayer
5389,UCBPlayer,64,259,323,0,59,UCBPlayer
5390,UCBPlayer,56,291,347,0,51,UCBPlayer
5391,UCBPlayer,109,264,373,8,45,UCBPlayer
5392,UCBPlayer,57,332,389,3,38,UCBPlayer
5393,UCBPlayer,67,272,339,1,54,UCBPlayer
5394,UCBPlayer,55,295,350,0,50,UCBPlayer
5395,UCBPlayer,53,303,356,0,48,UCBPlayer
5396,UCBPlayer,62,302,364,2,46,UCBPlayer
5397,UCBPlayer,62,297,359,3,48,UCBPlayer
5398,UCBPlayer,86,281,367,5,46,UCBPlayer
5399,UCBPlayer,59,309,368,3,45,UCBPlayer
5400,UCBPlayer,89,264,353,6,51,UCBPlayer
5401,UCBPlayer,69,294,363,1,46,UCBPlayer
5402,UCBPlayer,48,323,371,0,43,UCBPlayer
5403,UCBPlayer,49,314,363,1,46,UCBPlayer
5404,UCBPlayer,80,270,350,3,51,UCBPlayer
5405,UCBPlayer,49,304,353,0,49,UCBPlayer
5406,UCBPlayer,54,299,353,0,49,UCBPlayer
5407,UCBPlayer,50,315,365,0,45,UCBPlayer
5408,UCBPlayer,62,312,374,3,43,UCBPlayer
5409,UCBPlayer,61,306,367,2,45,UCBPlayer
5410,UCBPlayer,55,295,350,0,50,UCBPlayer
5411,UCBPlayer,53,303,356,0,48,UCBPlayer
5412,UCBPlayer,58,283,341,0,53,UCBPlayer
5413,UCBPlayer,56,291,347,0,51,UCBPlayer
5414,UCBPlayer,52,307,359,0,47,UCBPlayer
5415,UCBPlayer,82,277,359,6,49,UCBPlayer
5416,UCBPlayer,59,279,338,0,54,UCBPlayer
5417,UCBPlayer,48,323,371,0,43,UCBPlayer
5418,UCBPlayer,44,339,383,0,39,UCBPlayer
5419,UCBPlayer,49,319,368,0,44,UCBPlayer
5420,UCBPlayer,59,304,363,1,46,UCBPlayer
5421,UCBPlayer,82,277,359,6,49,UCBPlayer
5422,UCBPlayer,58,308,366,1,45,UCBPlayer
5423,UCBPlayer,58,283,341,0,53,UCBPlayer
5424,UCBPlayer,55,325,380,3,41,UCBPlayer
5425,UCBPlayer,70,280,350,3,51,UCBPlayer
5426,UCBPlayer,60,275,335,0,55,UCBPlayer
5427,UCBPlayer,66,266,332,0,56,UCBPlayer
5428,UCBPlayer,63,298,361,2,47,UCBPlayer
5429,UCBPlayer,66,306,372,4,44,UCBPlayer
5430,UCBPlayer,58,308,366,1,45,UCBPlayer
5431,UCBPlayer,71,296,367,2,45,UCBPlayer
5432,UCBPlayer,62,267,329,0,57,UCBPlayer
5433,UCBPlayer,62,302,364,2,46,UCBPlayer
5434,UCBPlayer,60,290,350,0,50,UCBPlayer
5435,UCBPlayer,47,327,374,0,42,UCBPlayer
5436,UCBPlayer,141,256,397,14,39,UCBPlayer
5437,UCBPlayer,76,276,352,5,51,UCBPlayer
5438,UCBPlayer,57,317,374,3,43,UCBPlayer
5439,UCBPlayer,70,275,345,1,52,UCBPlayer
5440,UCBPlayer,69,264,333,1,56,UCBPlayer
5441,UCBPlayer,59,299,358,2,48,UCBPlayer
5442,UCBPlayer,70,285,355,2,49,UCBPlayer
5443,UCBPlayer,49,319,368,0,44,UCBPlayer
5444,UCBPlayer,60,285,345,1,52,UCBPlayer
5445,UCBPlayer,97,272,369,10,47,UCBPlayer
5446,UCBPlayer,68,303,371,3,44,UCBPlayer
5447,UCBPlayer,55,295,350,0,50,UCBPlayer
5448,UCBPlayer,56,291,347,0,51,UCBPlayer
5449,UCBPlayer,53,313,366,1,45,UCBPlayer
5450,UCBPlayer,67,282,349,2,51,UCBPlayer
5451,UCBPlayer,66,271,337,2,55,UCBPlayer
5452,UCBPlayer,81,266,347,3,52,UCBPlayer
5453,UCBPlayer,61,286,347,0,51,UCBPlayer
5454,UCBPlayer,74,254,328,2,58,UCBPlayer
5455,UCBPlayer,106,261,367,8,47,UCBPlayer
5456,UCBPlayer,66,261,327,1,58,UCBPlayer
5457,UCBPlayer,86,256,342,4,54,UCBPlayer
5458,UCBPlayer,110,290,400,14,38,UCBPlayer
5459,UCBPlayer,63,288,351,1,50,UCBPlayer
5460,UCBPlayer,73,283,356,3,49,UCBPlayer
5461,UCBPlayer,56,291,347,0,51,UCBPlayer
5462,UCBPlayer,80,285,365,6,47,UCBPlayer
5463,UCBPlayer,60,275,335,0,55,UCBPlayer
5464,UCBPlayer,62,302,364,2,46,UCBPlayer
5465,UCBPlayer,61,306,367,2,45,UCBPlayer
5466,UCBPlayer,59,279,338,0,54,UCBPlayer
5467,UCBPlayer,106,286,392,9,39,UCBPlayer
5468,UCBPlayer,65,310,375,4,43,UCBPlayer
5469,UCBPlayer,69,299,368,3,45,UCBPlayer
5470,UCBPlayer,96,261,357,7,50,UCBPlayer
5471,UCBPlayer,56,291,347,0,51,UCBPlayer
5472,UCBPlayer,54,299,353,0,49,UCBPlayer
5473,UCBPlayer,88,293,381,7,42,UCBPlayer
5474,UCBPlayer,51,311,362,0,46,UCBPlayer
5475,UCBPlayer,54,299,353,0,49,UCBPlayer
5476,UCBPlayer,121,241,362,12,50,UCBPlayer
5477,UCBPlayer,131,266,397,14,39,UCBPlayer
5478,UCBPlayer,65,280,345,1,52,UCBPlayer
5479,UCBPlayer,65,270,335,0,55,UCBPlayer
5480,UCBPlayer,60,275,335,0,55,UCBPlayer
5481,UCBPlayer,81,276,357,4,49,UCBPlayer
5482,UCBPlayer,71,271,342,1,53,UCBPlayer
5483,UCBPlayer,63,263,326,0,58,UCBPlayer
5484,UCBPlayer,80,275,355,5,50,UCBPlayer
5485,UCBPlayer,47,327,374,0,42,UCBPlayer
5486,UCBPlayer,46,341,387,1,38,UCBPlayer
5487,UCBPlayer,60,310,370,2,44,UCBPlayer
5488,UCBPlayer,57,287,344,0,52,UCBPlayer
5489,UCBPlayer,52,307,359,0,47,UCBPlayer
5490,UCBPlayer,47,327,374,0,42,UCBPlayer
5491,UCBPlayer,78,293,371,6,45,UCBPlayer
5492,UCBPlayer,50,315,365,0,45,UCBPlayer
5493,UCBPlayer,62,312,374,3,43,UCBPlayer
5494,UCBPlayer,67,297,364,2,46,UCBPlayer
5495,UCBPlayer,56,301,357,1,48,UCBPlayer
5496,UCBPlayer,63,278,341,0,53,UCBPlayer
5497,UCBPlayer,82,267,349,5,52,UCBPlayer
5498,UCBPlayer,60,315,375,4,43,UCBPlayer
5499,UCBPlayer,88,278,366,7,47,UCBPlayer
5500,UCBPlayer,53,303,356,0,48,UCBPlayer
5501,UCBPlayer,54,319,373,2,43,UCBPlayer
5502,UCBPlayer,62,312,374,3,43,UCBPlayer
5503,UCBPlayer,55,305,360,1,47,UCBPlayer
5504,UCBPlayer,91,256,347,6,53,UCBPlayer
5505,UCBPlayer,65,335,400,5,35,UCBPlayer
5506,UCBPlayer,104,279,383,6,41,UCBPlayer
5507,UCBPlayer,61,281,342,1,53,UCBPlayer
5508,UCBPlayer,46,331,377,0,41,UCBPlayer
5509,UCBPlayer,75,265,340,2,54,UCBPlayer
5510,UCBPlayer,82,287,369,7,46,UCBPlayer
5511,UCBPlayer,59,319,378,1,41,UCBPlayer
5512,UCBPlayer,67,262,329,0,57,UCBPlayer
5513,UCBPlayer,73,273,346,2,52,UCBPlayer
5514,UCBPlayer,46,341,387,1,38,UCBPlayer
5515,UCBPlayer,53,303,356,0,48,UCBPlayer
5516,UCBPlayer,89,274,363,7,48,UCBPlayer
5517,UCBPlayer,55,295,350,0,50,UCBPlayer
5518,UCBPlayer,56,291,347,0,51,UCBPlayer
5519,UCBPlayer,59,279,338,0,54,UCBPlayer
5520,UCBPlayer,54,299,353,0,49,UCBPlayer
5521,UCBPlayer,57,287,344,0,52,UCBPlayer
5522,UCBPlayer,62,292,354,1,49,UCBPlayer
5523,UCBPlayer,59,279,338,0,54,UCBPlayer
5524,UCBPlayer,57,332,389,3,38,UCBPlayer
5525,UCBPlayer,53,303,356,0,48,UCBPlayer
5526,UCBPlayer,53,303,356,0,48,UCBPlayer
5527,UCBPlayer,47,327,374,0,42,UCBPlayer
5528,UCBPlayer,83,248,331,2,57,UCBPlayer
5529,UCBPlayer,59,279,338,0,54,UCBPlayer
5530,UCBPlayer,93,293,386,12,42,UCBPlayer
5531,UCBPlayer,70,285,355,2,49,UCBPlayer
5532,UCBPlayer,55,295,350,0,50,UCBPlayer
5533,UCBPlayer,54,299,353,0,49,UCBPlayer
5534,UCBPlayer,57,287,344,0,52,UCBPlayer
5535,UCBPlayer,76,276,352,5,51,UCBPlayer
5536,UCBPlayer,80,285,365,6,47,UCBPlayer
5537,UCBPlayer,64,274,338,0,54,UCBPlayer
5538,UCBPlayer,55,305,360,1,47,UCBPlayer
5539,UCBPlayer,84,264,348,4,52,UCBPlayer
5540,UCBPlayer,53,303,356,0,48,UCBPlayer
5541,UCBPlayer,61,296,357,1,48,UCBPlayer
5542,UCBPlayer,141,266,407,15,36,UCBPlayer
5543,UCBPlayer,74,289,363,4,47,UCBPlayer
5544,UCBPlayer,55,295,350,0,50,UCBPlayer
5545,UCBPlayer,67,262,329,0,57,UCBPlayer
5546,UCBPlayer,82,287,369,4,45,UCBPlayer
5547,UCBPlayer,79,264,343,5,54,UCBPlayer
5548,UCBPlayer,65,270,335,0,55,UCBPlayer
5549,UCBPlayer,110,260,370,8,46,UCBPlayer
5550,UCBPlayer,100,275,375,7,44,UCBPlayer
5551,UCBPlayer,54,299,353,0,49,UCBPlayer
5552,UCBPlayer,65,280,345,1,52,UCBPlayer
5553,UCBPlayer,50,315,365,0,45,UCBPlayer
5554,UCBPlayer,48,323,371,0,43,UCBPlayer
5555,UCBPlayer,61,296,357,4,49,UCBPlayer
5556,UCBPlayer,139,279,418,17,33,UCBPlayer
5557,UCBPlayer,90,280,370,8,46,UCBPlayer
5558,UCBPlayer,66,296,362,3,47,UCBPlayer
5559,UCBPlayer,55,295,350,0,50,UCBPlayer
5560,UCBPlayer,50,315,365,0,45,UCBPlayer
5561,UCBPlayer,49,319,368,0,44,UCBPlayer
5562,UCBPlayer,49,319,368,0,44,UCBPlayer
5563,UCBPlayer,54,299,353,0,49,UCBPlayer
5564,UCBPlayer,55,295,350,0,50,UCBPlayer
5565,UCBPlayer,94,264,358,8,50,UCBPlayer
5566,UCBPlayer,59,279,338,0,54,UCBPlayer
5567,UCBPlayer,72,277,349,2,51,UCBPlayer
5568,UCBPlayer,118,268,386,12,42,UCBPlayer
5569,UCBPlayer,53,348,401,3,34,UCBPlayer
5570,UCBPlayer,49,319,368,0,44,UCBPlayer
5571,UCBPlayer,73,303,376,5,43,UCBPlayer
5572,UCBPlayer,75,285,360,4,48,UCBPlayer
5573,UCBPlayer,76,261,337,2,55,UCBPlayer
5574,UCBPlayer,56,316,372,1,43,UCBPlayer
5575,UCBPlayer,64,304,368,3,45,UCBPlayer
5576,UCBPlayer,57,297,354,1,49,UCBPlayer
5577,UCBPlayer,80,235,315,1,62,UCBPlayer
5578,UCBPlayer,54,309,363,1,46,UCBPlayer
5579,UCBPlayer,71,266,337,2,55,UCBPlayer
5580,UCBPlayer,137,252,389,12,41,UCBPlayer
5581,UCBPlayer,147,272,419,21,34,UCBPlayer
5582,UCBPlayer,54,299,353,0,49,UCBPlayer
5583,UCBPlayer,156,291,447,22,25,UCBPlayer
5584,UCBPlayer,53,313,366,1,45,UCBPlayer
5585,UCBPlayer,60,290,350,0,50,UCBPlayer
5586,UCBPlayer,51,311,362,0,46,UCBPlayer
5587,UCBPlayer,89,269,358,5,49,UCBPlayer
5588,UCBPlayer,61,271,332,0,56,UCBPlayer
5589,UCBPlayer,52,307,359,0,47,UCBPlayer
5590,UCBPlayer,54,329,383,3,40,UCBPlayer
5591,UCBPlayer,61,311,372,1,43,UCBPlayer
5592,UCBPlayer,53,323,376,2,42,UCBPlayer
5593,UCBPlayer,63,288,351,1,50,UCBPlayer
5594,UCBPlayer,84,264,348,4,52,UCBPlayer
5595,UCBPlayer,56,291,347,0,51,UCBPlayer
5596,UCBPlayer,68,288,356,3,49,UCBPlayer
5597,UCBPlayer,71,296,367,5,46,UCBPlayer
5598,UCBPlayer,54,314,368,0,44,UCBPlayer
5599,UCBPlayer,65,300,365,3,46,UCBPlayer
5600,UCBPlayer,45,335,380,0,40,UCBPlayer
5601,UCBPlayer,57,287,344,0,52,UCBPlayer
5602,UCBPlayer,56,291,347,0,51,UCBPlayer
5603,UCBPlayer,61,286,347,0,51,UCBPlayer
5604,UCBPlayer,76,261,337,2,55,UCBPlayer
5605,UCBPlayer,60,285,345,1,52,UCBPlayer
5606,UCBPlayer,59,294,353,0,49,UCBPlayer
5607,UCBPlayer,53,298,351,1,50,UCBPlayer
5608,UCBPlayer,132,272,404,18,38,UCBPlayer
5609,UCBPlayer,43,328,371,0,43,UCBPlayer
5610,UCBPlayer,56,291,347,0,51,UCBPlayer
5611,UCBPlayer,58,283,341,0,53,UCBPlayer
5612,UCBPlayer,58,308,366,1,45,UCBPlayer
5613,UCBPlayer,68,268,336,1,55,UCBPlayer
5614,UCBPlayer,75,275,350,3,51,UCBPlayer
5615,UCBPlayer,68,278,346,2,52,UCBPlayer
5616,UCBPlayer,61,296,357,1,48,UCBPlayer
5617,UCBPlayer,52,307,359,0,47,UCBPlayer
5618,UCBPlayer,61,271,332,0,56,UCBPlayer
5619,UCBPlayer,58,308,366,1,45,UCBPlayer
5620,UCBPlayer,59,279,338,0,54,UCBPlayer
5621,UCBPlayer,61,286,347,0,51,UCBPlayer
5622,UCBPlayer,63,288,351,1,50,UCBPlayer
5623,UCBPlayer,57,312,369,1,44,UCBPlayer
5624,UCBPlayer,40,355,395,0,35,UCBPlayer
5625,UCBPlayer,67,282,349,2,51,UCBPlayer
5626,UCBPlayer,56,291,347,0,51,UCBPlayer
5627,UCBPlayer,62,317,379,5,42,UCBPlayer
5628,UCBPlayer,75,305,380,6,42,UCBPlayer
5629,UCBPlayer,59,304,363,1,46,UCBPlayer
5630,UCBPlayer,59,279,338,0,54,UCBPlayer
5631,UCBPlayer,49,319,368,0,44,UCBPlayer
5632,UCBPlayer,49,319,368,0,44,UCBPlayer
5633,UCBPlayer,59,324,383,3,40,UCBPlayer
5634,UCBPlayer,43,343,386,0,38,UCBPlayer
5635,UCBPlayer,68,268,336,1,55,UCBPlayer
5636,UCBPlayer,60,285,345,1,52,UCBPlayer
5637,UCBPlayer,54,324,378,1,41,UCBPlayer
5638,UCBPlayer,98,243,341,6,55,UCBPlayer
5639,UCBPlayer,59,279,338,0,54,UCBPlayer
5640,UCBPlayer,63,318,381,4,41,UCBPlayer
5641,UCBPlayer,68,268,336,1,55,UCBPlayer
5642,UCBPlayer,59,314,373,2,43,UCBPlayer
5643,UCBPlayer,57,287,344,0,52,UCBPlayer
5644,UCBPlayer,64,259,323,0,59,UCBPlayer
5645,UCBPlayer,53,303,356,0,48,UCBPlayer
5646,UCBPlayer,67,302,369,4,45,UCBPlayer
5647,UCBPlayer,61,296,357,1,48,UCBPlayer
5648,UCBPlayer,53,303,356,0,48,UCBPlayer
5649,UCBPlayer,49,319,368,0,44,UCBPlayer
5650,UCBPlayer,51,311,362,0,46,UCBPlayer
5651,UCBPlayer,44,339,383,0,39,UCBPlayer
5652,UCBPlayer,83,258,341,3,54,UCBPlayer
5653,UCBPlayer,52,317,369,1,44,UCBPlayer
5654,UCBPlayer,67,282,349,2,51,UCBPlayer
5655,UCBPlayer,65,290,355,2,49,UCBPlayer
5656,UCBPlayer,59,299,358,2,48,UCBPlayer
5657,UCBPlayer,67,287,354,1,49,UCBPlayer
5658,UCBPlayer,51,311,362,0,46,UCBPlayer
5659,UCBPlayer,50,315,365,0,45,UCBPlayer
5660,UCBPlayer,54,284,338,0,54,UCBPlayer
5661,UCBPlayer,54,299,353,0,49,UCBPlayer
5662,UCBPlayer,44,339,383,0,39,UCBPlayer
5663,UCBPlayer,49,319,368,0,44,UCBPlayer
5664,UCBPlayer,58,318,376,2,42,UCBPlayer
5665,UCBPlayer,57,287,344,0,52,UCBPlayer
5666,UCBPlayer,56,291,347,0,51,UCBPlayer
5667,UCBPlayer,60,275,335,0,55,UCBPlayer
5668,UCBPlayer,64,299,363,1,46,UCBPlayer
5669,UCBPlayer,64,294,358,2,48,UCBPlayer
5670,UCBPlayer,58,283,341,0,53,UCBPlayer
5671,UCBPlayer,60,290,350,0,50,UCBPlayer
5672,UCBPlayer,67,302,369,4,45,UCBPlayer
5673,UCBPlayer,55,320,375,1,42,UCBPlayer
5674,UCBPlayer,62,302,364,2,46,UCBPlayer
5675,UCBPlayer,53,303,356,0,48,UCBPlayer
5676,UCBPlayer,80,270,350,3,51,UCBPlayer
5677,UCBPlayer,102,282,384,7,41,UCBPlayer
5678,UCBPlayer,91,296,387,7,40,UCBPlayer
5679,UCBPlayer,97,267,364,8,48,UCBPlayer
5680,UCBPlayer,50,325,375,1,42,UCBPlayer
5681,UCBPlayer,73,283,356,3,49,UCBPlayer
5682,UCBPlayer,54,299,353,0,49,UCBPlayer
5683,UCBPlayer,74,279,353,3,50,UCBPlayer
5684,UCBPlayer,57,287,344,0,52,UCBPlayer
5685,UCBPlayer,78,258,336,4,56,UCBPlayer
5686,UCBPlayer,49,319,368,0,44,UCBPlayer
5687,UCBPlayer,63,288,351,1,50,UCBPlayer
5688,UCBPlayer,57,302,359,0,47,UCBPlayer
5689,UCBPlayer,61,306,367,2,45,UCBPlayer
5690,UCBPlayer,63,263,326,0,58,UCBPlayer
5691,UCBPlayer,53,313,366,1,45,UCBPlayer
5692,UCBPlayer,61,296,357,1,48,UCBPlayer
5693,UCBPlayer,56,306,362,0,46,UCBPlayer
5694,UCBPlayer,71,256,327,1,58,UCBPlayer
5695,UCBPlayer,48,323,371,0,43,UCBPlayer
5696,UCBPlayer,55,295,350,0,50,UCBPlayer
5697,UCBPlayer,52,307,359,0,47,UCBPlayer
5698,UCBPlayer,74,279,353,3,50,UCBPlayer
5699,UCBPlayer,49,319,368,0,44,UCBPlayer
5700,UCBPlayer,65,305,370,2,44,UCBPlayer
5701,UCBPlayer,58,283,341,0,53,UCBPlayer
5702,UCBPlayer,103,278,381,13,44,UCBPlayer
5703,UCBPlayer,191,221,412,17,35,UCBPlayer
5704,UCBPlayer,49,319,368,0,44,UCBPlayer
5705,UCBPlayer,53,303,356,0,48,UCBPlayer
5706,UCBPlayer,52,307,359,0,47,UCBPlayer
5707,UCBPlayer,73,258,331,2,57,UCBPlayer
5708,UCBPlayer,71,281,352,2,50,UCBPlayer
5709,UCBPlayer,73,318,391,8,39,UCBPlayer
5710,UCBPlayer,64,269,333,1,56,UCBPlayer
5711,UCBPlayer,72,287,359,3,48,UCBPlayer
5712,UCBPlayer,72,332,404,6,34,UCBPlayer
5713,UCBPlayer,64,304,368,3,45,UCBPlayer
5714,UCBPlayer,81,281,362,6,48,UCBPlayer
5715,UCBPlayer,55,295,350,0,50,UCBPlayer
5716,UCBPlayer,59,279,338,0,54,UCBPlayer
5717,UCBPlayer,68,268,336,1,55,UCBPlayer
5718,UCBPlayer,65,320,385,5,40,UCBPlayer
5719,UCBPlayer,49,319,368,0,44,UCBPlayer
5720,UCBPlayer,52,307,359,0,47,UCBPlayer
5721,UCBPlayer,55,295,350,0,50,UCBPlayer
5722,UCBPlayer,78,278,356,6,50,UCBPlayer
5723,UCBPlayer,54,324,378,1,41,UCBPlayer
5724,UCBPlayer,51,321,372,1,43,UCBPlayer
5725,UCBPlayer,77,277,354,4,50,UCBPlayer
5726,UCBPlayer,69,299,368,3,45,UCBPlayer
5727,UCBPlayer,73,288,361,2,47,UCBPlayer
5728,UCBPlayer,46,341,387,1,38,UCBPlayer
5729,UCBPlayer,96,306,402,10,36,UCBPlayer
5730,UCBPlayer,89,249,338,3,55,UCBPlayer
5731,UCBPlayer,97,262,359,6,49,UCBPlayer
5732,UCBPlayer,50,315,365,0,45,UCBPlayer
5733,UCBPlayer,63,298,361,2,47,UCBPlayer
5734,UCBPlayer,57,287,344,0,52,UCBPlayer
5735,UCBPlayer,221,216,437,30,31,Player A
5736,UCBPlayer,56,291,347,0,51,UCBPlayer
5737,UCBPlayer,73,293,366,4,46,UCBPlayer
5738,UCBPlayer,156,231,387,16,43,UCBPlayer
5739,UCBPlayer,58,303,361,2,47,UCBPlayer
5740,UCBPlayer,57,322,379,2,41,UCBPlayer
5741,UCBPlayer,75,265,340,2,54,UCBPlayer
5742,UCBPlayer,83,258,341,3,54,UCBPlayer
5743,UCBPlayer,58,283,341,0,53,UCBPlayer
5744,UCBPlayer,48,323,371,0,43,UCBPlayer
5745,UCBPlayer,70,260,330,1,57,UCBPlayer
5746,UCBPlayer,59,279,338,0,54,UCBPlayer
5747,UCBPlayer,52,307,359,0,47,UCBPlayer
5748,UCBPlayer,76,286,362,6,48,UCBPlayer
5749,UCBPlayer,58,298,356,0,48,UCBPlayer
5750,UCBPlayer,60,275,335,0,55,UCBPlayer
5751,UCBPlayer,48,323,371,0,43,UCBPlayer
5752,UCBPlayer,65,315,380,6,42,UCBPlayer
5753,UCBPlayer,65,295,360,1,47,UCBPlayer
5754,UCBPlayer,56,291,347,0,51,UCBPlayer
5755,UCBPlayer,72,277,349,2,51,UCBPlayer
5756,UCBPlayer,61,331,392,3,37,UCBPlayer
5757,UCBPlayer,55,295,350,0,50,UCBPlayer
5758,UCBPlayer,54,309,363,1,46,UCBPlayer
5759,UCBPlayer,72,287,359,3,48,UCBPlayer
5760,UCBPlayer,68,273,341,0,53,UCBPlayer
5761,UCBPlayer,56,286,342,1,53,UCBPlayer
5762,UCBPlayer,60,290,350,0,50,UCBPlayer
5763,UCBPlayer,65,300,365,3,46,UCBPlayer
5764,UCBPlayer,82,302,384,10,42,UCBPlayer
5765,UCBPlayer,100,260,360,7,49,UCBPlayer
5766,UCBPlayer,78,263,341,3,54,UCBPlayer
5767,UCBPlayer,61,271,332,0,56,UCBPlayer
5768,UCBPlayer,76,281,357,4,49,UCBPlayer
5769,UCBPlayer,74,289,363,4,47,UCBPlayer
5770,UCBPlayer,54,299,353,0,49,UCBPlayer
5771,UCBPlayer,58,283,341,0,53,UCBPlayer
5772,UCBPlayer,55,295,350,0,50,UCBPlayer
5773,UCBPlayer,68,268,336,1,55,UCBPlayer
5774,UCBPlayer,69,274,343,2,53,UCBPlayer
5775,UCBPlayer,53,303,356,0,48,UCBPlayer
5776,UCBPlayer,54,299,353,0,49,UCBPlayer
5777,UCBPlayer,63,328,391,5,38,UCBPlayer
5778,UCBPlayer,52,307,359,0,47,UCBPlayer
5779,UCBPlayer,182,262,444,25,27,UCBPlayer
5780,UCBPlayer,54,299,353,0,49,UCBPlayer
5781,UCBPlayer,169,249,418,20,34,UCBPlayer
5782,UCBPlayer,64,294,358,2,48,UCBPlayer
5783,UCBPlayer,47,327,374,0,42,UCBPlayer
5784,UCBPlayer,56,291,347,0,51,UCBPlayer
5785,UCBPlayer,77,267,344,3,53,UCBPlayer
5786,UCBPlayer,62,282,344,0,52,UCBPlayer
5787,UCBPlayer,52,307,359,0,47,UCBPlayer
5788,UCBPlayer,51,311,362,0,46,UCBPlayer
5789,UCBPlayer,61,271,332,0,56,UCBPlayer
5790,UCBPlayer,56,291,347,0,51,UCBPlayer
5791,UCBPlayer,45,335,380,0,40,UCBPlayer
5792,UCBPlayer,54,299,353,0,49,UCBPlayer
5793,UCBPlayer,65,265,330,1,57,UCBPlayer
5794,UCBPlayer,58,298,356,0,48,UCBPlayer
5795,UCBPlayer,56,311,367,2,45,UCBPlayer
5796,UCBPlayer,57,317,374,3,43,UCBPlayer
5797,UCBPlayer,52,307,359,0,47,UCBPlayer
5798,UCBPlayer,54,309,363,1,46,UCBPlayer
5799,UCBPlayer,58,308,366,1,45,UCBPlayer
5800,UCBPlayer,49,319,368,0,44,UCBPlayer
5801,UCBPlayer,57,297,354,1,49,UCBPlayer
5802,UCBPlayer,64,284,348,1,51,UCBPlayer
5803,UCBPlayer,85,270,355,5,50,UCBPlayer
5804,UCBPlayer,67,297,364,2,46,UCBPlayer
5805,UCBPlayer,51,311,362,0,46,UCBPlayer
5806,UCBPlayer,55,315,370,2,44,UCBPlayer
5807,UCBPlayer,56,326,382,2,40,UCBPlayer
5808,UCBPlayer,54,299,353,0,49,UCBPlayer
5809,UCBPlayer,65,290,355,5,50,UCBPlayer
5810,UCBPlayer,82,292,374,6,44,UCBPlayer
5811,UCBPlayer,59,279,338,0,54,UCBPlayer
5812,UCBPlayer,46,331,377,0,41,UCBPlayer
5813,UCBPlayer,47,312,359,0,47,UCBPlayer
5814,UCBPlayer,63,313,376,2,42,UCBPlayer
5815,UCBPlayer,66,296,362,3,47,UCBPlayer
5816,UCBPlayer,141,216,357,13,52,UCBPlayer
5817,UCBPlayer,46,331,377,0,41,UCBPlayer
5818,UCBPlayer,55,295,350,0,50,UCBPlayer
5819,UCBPlayer,51,311,362,0,46,UCBPlayer
5820,UCBPlayer,82,302,384,10,42,UCBPlayer
5821,UCBPlayer,60,290,350,0,50,UCBPlayer
5822,UCBPlayer,66,276,342,1,53,UCBPlayer
5823,UCBPlayer,56,291,347,0,51,UCBPlayer
5824,UCBPlayer,60,275,335,0,55,UCBPlayer
5825,UCBPlayer,55,320,375,1,42,UCBPlayer
5826,UCBPlayer,67,302,369,4,45,UCBPlayer
5827,UCBPlayer,49,319,368,0,44,UCBPlayer
5828,UCBPlayer,55,295,350,0,50,UCBPlayer
5829,UCBPlayer,53,303,356,0,48,UCBPlayer
5830,UCBPlayer,66,251,317,0,61,UCBPlayer
5831,UCBPlayer,70,265,335,0,55,UCBPlayer
5832,UCBPlayer,65,305,370,5,45,UCBPlayer
5833,UCBPlayer,68,258,326,0,58,UCBPlayer
5834,UCBPlayer,103,268,371,9,46,UCBPlayer
5835,UCBPlayer,51,311,362,0,46,UCBPlayer
5836,UCBPlayer,55,320,375,1,42,UCBPlayer
5837,UCBPlayer,59,279,338,0,54,UCBPlayer
5838,UCBPlayer,56,291,347,0,51,UCBPlayer
5839,UCBPlayer,47,327,374,0,42,UCBPlayer
5840,UCBPlayer,70,310,380,6,42,UCBPlayer
5841,UCBPlayer,85,275,360,7,49,UCBPlayer
5842,UCBPlayer,59,279,338,0,54,UCBPlayer
5843,UCBPlayer,88,268,356,3,49,UCBPlayer
5844,UCBPlayer,76,286,362,6,48,UCBPlayer
5845,UCBPlayer,50,325,375,1,42,UCBPlayer
5846,UCBPlayer,60,305,365,3,46,UCBPlayer
5847,UCBPlayer,84,304,388,5,39,UCBPlayer
5848,UCBPlayer,48,333,381,1,40,UCBPlayer
5849,UCBPlayer,77,297,374,3,43,UCBPlayer
5850,UCBPlayer,66,276,342,1,53,UCBPlayer
5851,UCBPlayer,60,285,345,1,52,UCBPlayer
5852,UCBPlayer,67,302,369,4,45,UCBPlayer
5853,UCBPlayer,117,247,364,11,49,UCBPlayer
5854,UCBPlayer,114,279,393,10,39,UCBPlayer
5855,UCBPlayer,55,295,350,0,50,UCBPlayer
5856,UCBPlayer,45,335,380,0,40,UCBPlayer
5857,UCBPlayer,54,309,363,1,46,UCBPlayer
5858,UCBPlayer,73,293,366,4,46,UCBPlayer
5859,UCBPlayer,59,289,348,1,51,UCBPlayer
5860,UCBPlayer,74,299,373,5,44,UCBPlayer
5861,UCBPlayer,116,256,372,10,46,UCBPlayer
5862,UCBPlayer,55,295,350,0,50,UCBPlayer
5863,UCBPlayer,56,291,347,0,51,UCBPlayer
5864,UCBPlayer,45,320,365,0,45,UCBPlayer
5865,UCBPlayer,58,283,341,0,53,UCBPlayer
5866,UCBPlayer,79,279,358,5,49,UCBPlayer
5867,UCBPlayer,48,323,371,0,43,UCBPlayer
5868,UCBPlayer,94,269,363,7,48,UCBPlayer
5869,UCBPlayer,48,323,371,0,43,UCBPlayer
5870,UCBPlayer,81,306,387,10,41,UCBPlayer
5871,UCBPlayer,67,292,359,3,48,UCBPlayer
5872,UCBPlayer,61,271,332,0,56,UCBPlayer
5873,UCBPlayer,67,282,349,2,51,UCBPlayer
5874,UCBPlayer,59,279,338,0,54,UCBPlayer
5875,UCBPlayer,96,261,357,7,50,UCBPlayer
5876,UCBPlayer,56,291,347,0,51,UCBPlayer
5877,UCBPlayer,45,345,390,1,37,UCBPlayer
5878,UCBPlayer,62,302,364,2,46,UCBPlayer
5879,UCBPlayer,59,279,338,0,54,UCBPlayer
5880,UCBPlayer,60,300,360,1,47,UCBPlayer
5881,UCBPlayer,50,315,365,0,45,UCBPlayer
5882,UCBPlayer,56,336,392,3,37,UCBPlayer
5883,UCBPlayer,69,274,343,2,53,UCBPlayer
5884,UCBPlayer,52,307,359,0,47,UCBPlayer
5885,UCBPlayer,77,307,384,7,41,UCBPlayer
5886,UCBPlayer,47,327,374,0,42,UCBPlayer
5887,UCBPlayer,55,295,350,0,50,UCBPlayer
5888,UCBPlayer,62,292,354,1,49,UCBPlayer
5889,UCBPlayer,60,275,335,0,55,UCBPlayer
5890,UCBPlayer,52,307,359,0,47,UCBPlayer
5891,UCBPlayer,61,271,332,0,56,UCBPlayer
5892,UCBPlayer,62,302,364,2,46,UCBPlayer
5893,UCBPlayer,61,286,347,0,51,UCBPlayer
5894,UCBPlayer,59,289,348,1,51,UCBPlayer
5895,UCBPlayer,74,269,343,2,53,UCBPlayer
5896,UCBPlayer,55,295,350,0,50,UCBPlayer
5897,UCBPlayer,65,310,375,4,43,UCBPlayer
5898,UCBPlayer,77,282,359,3,48,UCBPlayer
5899,UCBPlayer,76,266,342,4,54,UCBPlayer
5900,UCBPlayer,81,271,352,5,51,UCBPlayer
5901,UCBPlayer,70,295,365,3,46,UCBPlayer
5902,UCBPlayer,52,307,359,0,47,UCBPlayer
5903,UCBPlayer,52,307,359,0,47,UCBPlayer
5904,UCBPlayer,59,289,348,1,51,UCBPlayer
5905,UCBPlayer,42,347,389,0,37,UCBPlayer
5906,UCBPlayer,64,274,338,0,54,UCBPlayer
5907,UCBPlayer,53,313,366,1,45,UCBPlayer
5908,UCBPlayer,74,264,338,3,55,UCBPlayer
5909,UCBPlayer,78,283,361,5,48,UCBPlayer
5910,UCBPlayer,49,319,368,0,44,UCBPlayer
5911,UCBPlayer,47,327,374,0,42,UCBPlayer
5912,UCBPlayer,58,278,336,1,55,UCBPlayer
5913,UCBPlayer,58,323,381,1,40,UCBPlayer
5914,UCBPlayer,51,311,362,0,46,UCBPlayer
5915,UCBPlayer,48,308,356,0,48,UCBPlayer
5916,UCBPlayer,53,303,356,0,48,UCBPlayer
5917,UCBPlayer,55,295,350,0,50,UCBPlayer
5918,UCBPlayer,74,289,363,4,47,UCBPlayer
5919,UCBPlayer,55,295,350,0,50,UCBPlayer
5920,UCBPlayer,58,283,341,0,53,UCBPlayer
5921,UCBPlayer,58,283,341,0,53,UCBPlayer
5922,UCBPlayer,67,272,339,1,54,UCBPlayer
5923,UCBPlayer,79,249,328,2,58,UCBPlayer
5924,UCBPlayer,118,288,406,14,36,UCBPlayer
5925,UCBPlayer,56,291,347,0,51,UCBPlayer
5926,UCBPlayer,47,327,374,0,42,UCBPlayer
5927,UCBPlayer,55,295,350,0,50,UCBPlayer
5928,UCBPlayer,54,299,353,0,49,UCBPlayer
5929,UCBPlayer,59,279,338,0,54,UCBPlayer
5930,UCBPlayer,75,295,370,5,45,UCBPlayer
5931,UCBPlayer,75,285,360,4,48,UCBPlayer
5932,UCBPlayer,63,298,361,2,47,UCBPlayer
5933,UCBPlayer,51,311,362,0,46,UCBPlayer
5934,UCBPlayer,61,306,367,2,45,UCBPlayer
5935,UCBPlayer,148,258,406,23,39,UCBPlayer
5936,UCBPlayer,67,307,374,3,43,UCBPlayer
5937,UCBPlayer,55,315,370,2,44,UCBPlayer
5938,UCBPlayer,64,274,338,0,54,UCBPlayer
5939,UCBPlayer,55,295,350,0,50,UCBPlayer
5940,UCBPlayer,77,267,344,3,53,UCBPlayer
5941,UCBPlayer,54,299,353,0,49,UCBPlayer
5942,UCBPlayer,53,323,376,2,42,UCBPlayer
5943,UCBPlayer,71,291,362,3,47,UCBPlayer
5944,UCBPlayer,95,260,355,8,51,UCBPlayer
5945,UCBPlayer,79,294,373,5,44,UCBPlayer
5946,UCBPlayer,56,291,347,0,51,UCBPlayer
5947,UCBPlayer,121,241,362,9,49,UCBPlayer
5948,UCBPlayer,54,299,353,0,49,UCBPlayer
5949,UCBPlayer,62,302,364,2,46,UCBPlayer
5950,UCBPlayer,57,287,344,0,52,UCBPlayer
5951,UCBPlayer,63,303,366,4,46,UCBPlayer
5952,UCBPlayer,57,302,359,0,47,UCBPlayer
5953,UCBPlayer,63,263,326,0,58,UCBPlayer
5954,UCBPlayer,48,323,371,0,43,UCBPlayer
5955,UCBPlayer,60,275,335,0,55,UCBPlayer
5956,UCBPlayer,67,297,364,2,46,UCBPlayer
5957,UCBPlayer,65,255,320,0,60,UCBPlayer
5958,UCBPlayer,116,246,362,12,50,UCBPlayer
5959,UCBPlayer,67,307,374,3,43,UCBPlayer
5960,UCBPlayer,52,307,359,0,47,UCBPlayer
5961,UCBPlayer,66,321,387,4,39,UCBPlayer
5962,UCBPlayer,290,215,505,44,13,Player A
5963,UCBPlayer,103,258,361,8,49,UCBPlayer
5964,UCBPlayer,68,283,351,1,50,UCBPlayer
5965,UCBPlayer,69,279,348,1,51,UCBPlayer
5966,UCBPlayer,96,266,362,6,48,UCBPlayer
5967,UCBPlayer,52,307,359,0,47,UCBPlayer
5968,UCBPlayer,69,274,343,2,53,UCBPlayer
5969,UCBPlayer,57,287,344,0,52,UCBPlayer
5970,UCBPlayer,117,232,349,8,53,UCBPlayer
5971,UCBPlayer,60,275,335,0,55,UCBPlayer
5972,UCBPlayer,54,299,353,0,49,UCBPlayer
5973,UCBPlayer,48,323,371,0,43,UCBPlayer
5974,UCBPlayer,50,315,365,0,45,UCBPlayer
5975,UCBPlayer,72,277,349,2,51,UCBPlayer
5976,UCBPlayer,49,319,368,0,44,UCBPlayer
5977,UCBPlayer,50,315,365,0,45,UCBPlayer
5978,UCBPlayer,52,307,359,0,47,UCBPlayer
5979,UCBPlayer,62,267,329,0,57,UCBPlayer
5980,UCBPlayer,57,287,344,0,52,UCBPlayer
5981,UCBPlayer,75,285,360,4,48,UCBPlayer
5982,UCBPlayer,46,331,377,0,41,UCBPlayer
5983,UCBPlayer,59,279,338,0,54,UCBPlayer
5984,UCBPlayer,50,315,365,0,45,UCBPlayer
5985,UCBPlayer,56,301,357,1,48,UCBPlayer
5986,UCBPlayer,76,281,357,4,49,UCBPlayer
5987,UCBPlayer,74,279,353,3,50,UCBPlayer
5988,UCBPlayer,63,308,371,3,44,UCBPlayer
5989,UCBPlayer,54,299,353,0,49,UCBPlayer
5990,UCBPlayer,68,268,336,1,55,UCBPlayer
5991,UCBPlayer,67,302,369,4,45,UCBPlayer
5992,UCBPlayer,68,258,326,0,58,UCBPlayer
5993,UCBPlayer,82,272,354,4,50,UCBPlayer
5994,UCBPlayer,71,296,367,5,46,UCBPlayer
5995,UCBPlayer,65,280,345,1,52,UCBPlayer
5996,UCBPlayer,64,319,383,6,41,UCBPlayer
5997,UCBPlayer,50,330,380,0,40,UCBPlayer
5998,UCBPlayer,57,297,354,1,49,UCBPlayer
5999,UCBPlayer,102,282,384,10,42,UCBPlayer
6000,UCBPlayer,53,303,356,0,48,UCBPlayer
6001,UCBPlayer,51,311,362,0,46,UCBPlayer
6002,UCBPlayer,50,315,365,0,45,UCBPlayer
6003,UCBPlayer,74,279,353,3,50,UCBPlayer
6004,UCBPlayer,46,331,377,0,41,UCBPlayer
6005,UCBPlayer,62,287,349,2,51,UCBPlayer
6006,UCBPlayer,73,288,361,2,47,UCBPlayer
6007,UCBPlayer,87,257,344,6,54,UCBPlayer
6008,UCBPlayer,52,327,379,2,41,UCBPlayer
6009,UCBPlayer,61,286,347,0,51,UCBPlayer
6010,UCBPlayer,77,287,364,5,47,UCBPlayer
6011,UCBPlayer,68,283,351,1,50,UCBPlayer
6012,UCBPlayer,60,300,360,1,47,UCBPlayer
6013,UCBPlayer,73,278,351,4,51,UCBPlayer
6014,UCBPlayer,121,251,372,10,46,UCBPlayer
6015,UCBPlayer,55,290,345,1,52,UCBPlayer
6016,UCBPlayer,70,310,380,6,42,UCBPlayer
6017,UCBPlayer,64,274,338,0,54,UCBPlayer
6018,UCBPlayer,70,295,365,3,46,UCBPlayer
6019,UCBPlayer,64,334,398,3,35,UCBPlayer
6020,UCBPlayer,63,308,371,3,44,UCBPlayer
6021,UCBPlayer,58,283,341,0,53,UCBPlayer
6022,UCBPlayer,66,276,342,1,53,UCBPlayer
6023,UCBPlayer,77,307,384,7,41,UCBPlayer
6024,UCBPlayer,62,302,364,2,46,UCBPlayer
6025,UCBPlayer,62,302,364,2,46,UCBPlayer
6026,UCBPlayer,79,259,338,3,55,UCBPlayer
6027,UCBPlayer,66,286,352,2,50,UCBPlayer
6028,UCBPlayer,67,292,359,3,48,UCBPlayer
6029,UCBPlayer,70,285,355,2,49,UCBPlayer
6030,UCBPlayer,48,323,371,0,43,UCBPlayer
6031,UCBPlayer,85,275,360,4,48,UCBPlayer
6032,UCBPlayer,75,270,345,4,53,UCBPlayer
6033,UCBPlayer,83,288,371,6,45,UCBPlayer
6034,UCBPlayer,66,301,367,2,45,UCBPlayer
6035,UCBPlayer,53,303,356,0,48,UCBPlayer
6036,UCBPlayer,76,286,362,6,48,UCBPlayer
6037,UCBPlayer,74,269,343,2,53,UCBPlayer
6038,UCBPlayer,52,307,359,0,47,UCBPlayer
6039,UCBPlayer,46,331,377,0,41,UCBPlayer
6040,UCBPlayer,77,277,354,4,50,UCBPlayer
6041,UCBPlayer,55,295,350,0,50,UCBPlayer
6042,UCBPlayer,55,295,350,0,50,UCBPlayer
6043,UCBPlayer,51,311,362,0,46,UCBPlayer
6044,UCBPlayer,72,277,349,2,51,UCBPlayer
6045,UCBPlayer,58,283,341,0,53,UCBPlayer
6046,UCBPlayer,51,311,362,0,46,UCBPlayer
6047,UCBPlayer,54,309,363,1,46,UCBPlayer
6048,UCBPlayer,59,314,373,2,43,UCBPlayer
6049,UCBPlayer,61,271,332,0,56,UCBPlayer
6050,UCBPlayer,69,289,358,2,48,UCBPlayer
6051,UCBPlayer,69,274,343,2,53,UCBPlayer
6052,UCBPlayer,51,311,362,0,46,UCBPlayer
6053,UCBPlayer,51,321,372,1,43,UCBPlayer
6054,UCBPlayer,93,293,386,6,40,UCBPlayer
6055,UCBPlayer,46,331,377,0,41,UCBPlayer
6056,UCBPlayer,47,337,384,1,39,UCBPlayer
6057,UCBPlayer,69,274,343,2,53,UCBPlayer
6058,UCBPlayer,79,259,338,3,55,UCBPlayer
6059,UCBPlayer,56,291,347,0,51,UCBPlayer
6060,UCBPlayer,59,294,353,3,50,UCBPlayer
6061,UCBPlayer,98,278,376,8,44,UCBPlayer
6062,UCBPlayer,69,254,323,0,59,UCBPlayer
6063,UCBPlayer,49,329,378,1,41,UCBPlayer
6064,UCBPlayer,54,334,388,2,38,UCBPlayer
6065,UCBPlayer,50,330,380,0,40,UCBPlayer
6066,UCBPlayer,45,335,380,0,40,UCBPlayer
6067,UCBPlayer,49,319,368,0,44,UCBPlayer
6068,UCBPlayer,74,264,338,3,55,UCBPlayer
6069,UCBPlayer,66,276,342,1,53,UCBPlayer
6070,UCBPlayer,66,266,332,0,56,UCBPlayer
6071,UCBPlayer,58,283,341,0,53,UCBPlayer
6072,UCBPlayer,57,287,344,0,52,UCBPlayer
6073,UCBPlayer,48,323,371,0,43,UCBPlayer
6074,UCBPlayer,63,278,341,0,53,UCBPlayer
6075,UCBPlayer,66,296,362,3,47,UCBPlayer
6076,UCBPlayer,158,228,386,18,44,UCBPlayer
6077,UCBPlayer,97,262,359,9,50,UCBPlayer
6078,UCBPlayer,54,299,353,0,49,UCBPlayer
6079,UCBPlayer,69,264,333,1,56,UCBPlayer
6080,UCBPlayer,79,249,328,2,58,UCBPlayer
6081,UCBPlayer,98,263,361,5,48,UCBPlayer
6082,UCBPlayer,53,303,356,0,48,UCBPlayer
6083,UCBPlayer,100,280,380,12,44,UCBPlayer
6084,UCBPlayer,52,327,379,2,41,UCBPlayer
6085,UCBPlayer,60,290,350,0,50,UCBPlayer
6086,UCBPlayer,55,295,350,0,50,UCBPlayer
6087,UCBPlayer,60,300,360,1,47,UCBPlayer
6088,UCBPlayer,61,271,332,0,56,UCBPlayer
6089,UCBPlayer,114,274,388,14,42,UCBPlayer
6090,UCBPlayer,49,319,368,0,44,UCBPlayer
6091,UCBPlayer,91,311,402,13,37,UCBPlayer
6092,UCBPlayer,66,281,347,0,51,UCBPlayer
6093,UCBPlayer,69,299,368,6,46,UCBPlayer
6094,UCBPlayer,57,312,369,1,44,UCBPlayer
6095,UCBPlayer,88,308,396,7,37,UCBPlayer
6096,UCBPlayer,152,252,404,15,37,UCBPlayer
6097,UCBPlayer,65,255,320,0,60,UCBPlayer
6098,UCBPlayer,192,242,434,33,33,UCBPlayer
6099,UCBPlayer,95,290,385,5,40,UCBPlayer
6100,UCBPlayer,92,247,339,4,55,UCBPlayer
6101,UCBPlayer,54,299,353,0,49,UCBPlayer
6102,UCBPlayer,63,298,361,2,47,UCBPlayer
6103,UCBPlayer,64,279,343,2,53,UCBPlayer
6104,UCBPlayer,70,280,350,3,51,UCBPlayer
6105,UCBPlayer,76,281,357,4,49,UCBPlayer
6106,UCBPlayer,98,258,356,9,51,UCBPlayer
6107,UCBPlayer,49,319,368,0,44,UCBPlayer
6108,UCBPlayer,66,296,362,3,47,UCBPlayer
6109,UCBPlayer,74,264,338,3,55,UCBPlayer
6110,UCBPlayer,59,314,373,2,43,UCBPlayer
6111,UCBPlayer,71,266,337,2,55,UCBPlayer
6112,UCBPlayer,67,282,349,2,51,UCBPlayer
6113,UCBPlayer,59,304,363,1,46,UCBPlayer
6114,UCBPlayer,54,299,353,0,49,UCBPlayer
6115,UCBPlayer,60,305,365,3,46,UCBPlayer
6116,UCBPlayer,68,283,351,1,50,UCBPlayer
6117,UCBPlayer,58,293,351,1,50,UCBPlayer
6118,UCBPlayer,63,273,336,1,55,UCBPlayer
6119,UCBPlayer,61,306,367,2,45,UCBPlayer
6120,UCBPlayer,54,324,378,1,41,UCBPlayer
6121,UCBPlayer,68,308,376,5,43,UCBPlayer
6122,UCBPlayer,50,315,365,0,45,UCBPlayer
6123,UCBPlayer,64,284,348,1,51,UCBPlayer
6124,UCBPlayer,54,299,353,0,49,UCBPlayer
6125,UCBPlayer,58,283,341,0,53,UCBPlayer
6126,UCBPlayer,59,279,338,0,54,UCBPlayer
6127,UCBPlayer,109,289,398,15,39,UCBPlayer
6128,UCBPlayer,69,274,343,2,53,UCBPlayer
6129,UCBPlayer,62,282,344,0,52,UCBPlayer
6130,UCBPlayer,67,287,354,1,49,UCBPlayer
6131,UCBPlayer,57,287,344,0,52,UCBPlayer
6132,UCBPlayer,88,253,341,6,55,UCBPlayer
6133,UCBPlayer,49,319,368,0,44,UCBPlayer
6134,UCBPlayer,47,327,374,0,42,UCBPlayer
6135,UCBPlayer,49,319,368,0,44,UCBPlayer
6136,UCBPlayer,47,327,374,0,42,UCBPlayer
6137,UCBPlayer,56,291,347,0,51,UCBPlayer
6138,UCBPlayer,63,288,351,1,50,UCBPlayer
6139,UCBPlayer,62,292,354,1,49,UCBPlayer
6140,UCBPlayer,72,302,374,6,44,UCBPlayer
6141,UCBPlayer,88,273,361,5,48,UCBPlayer
6142,UCBPlayer,62,282,344,0,52,UCBPlayer
6143,UCBPlayer,48,323,371,0,43,UCBPlayer
6144,UCBPlayer,43,343,386,0,38,UCBPlayer
6145,UCBPlayer,62,312,374,3,43,UCBPlayer
6146,UCBPlayer,50,315,365,0,45,UCBPlayer
6147,UCBPlayer,46,331,377,0,41,UCBPlayer
6148,UCBPlayer,60,295,355,2,49,UCBPlayer
6149,UCBPlayer,53,318,371,0,43,UCBPlayer
6150,UCBPlayer,51,311,362,0,46,UCBPlayer
6151,UCBPlayer,50,315,365,0,45,UCBPlayer
6152,UCBPlayer,57,297,354,1,49,UCBPlayer
6153,UCBPlayer,70,275,345,1,52,UCBPlayer
6154,UCBPlayer,79,304,383,6,41,UCBPlayer
6155,UCBPlayer,51,311,362,0,46,UCBPlayer
6156,UCBPlayer,51,311,362,0,46,UCBPlayer
6157,UCBPlayer,60,305,365,3,46,UCBPlayer
6158,UCBPlayer,76,301,377,6,43,UCBPlayer
6159,UCBPlayer,63,278,341,0,53,UCBPlayer
6160,UCBPlayer,61,296,357,1,48,UCBPlayer
6161,UCBPlayer,61,271,332,0,56,UCBPlayer
6162,UCBPlayer,69,299,368,3,45,UCBPlayer
6163,UCBPlayer,67,272,339,1,54,UCBPlayer
6164,UCBPlayer,51,311,362,0,46,UCBPlayer
6165,UCBPlayer,68,273,341,3,54,UCBPlayer
6166,UCBPlayer,70,285,355,2,49,UCBPlayer
6167,UCBPlayer,66,261,327,1,58,UCBPlayer
6168,UCBPlayer,78,283,361,5,48,UCBPlayer
6169,UCBPlayer,69,299,368,3,45,UCBPlayer
6170,UCBPlayer,45,320,365,0,45,UCBPlayer
6171,UCBPlayer,64,294,358,2,48,UCBPlayer
6172,UCBPlayer,79,289,368,3,45,UCBPlayer
6173,UCBPlayer,47,327,374,0,42,UCBPlayer
6174,UCBPlayer,61,306,367,2,45,UCBPlayer
6175,UCBPlayer,62,267,329,0,57,UCBPlayer
6176,UCBPlayer,214,244,458,30,24,UCBPlayer
6177,UCBPlayer,62,292,354,1,49,UCBPlayer
6178,UCBPlayer,51,311,362,0,46,UCBPlayer
6179,UCBPlayer,52,307,359,0,47,UCBPlayer
6180,UCBPlayer,78,273,351,4,51,UCBPlayer
6181,UCBPlayer,62,267,329,0,57,UCBPlayer
6182,UCBPlayer,66,266,332,0,56,UCBPlayer
6183,UCBPlayer,171,231,402,19,39,UCBPlayer
6184,UCBPlayer,61,271,332,0,56,UCBPlayer
6185,UCBPlayer,68,258,326,0,58,UCBPlayer
6186,UCBPlayer,49,319,368,0,44,UCBPlayer
6187,UCBPlayer,87,267,354,4,50,UCBPlayer
6188,UCBPlayer,52,307,359,0,47,UCBPlayer
6189,UCBPlayer,53,303,356,0,48,UCBPlayer
6190,UCBPlayer,60,290,350,0,50,UCBPlayer
6191,UCBPlayer,54,299,353,0,49,UCBPlayer
6192,UCBPlayer,56,291,347,0,51,UCBPlayer
6193,UCBPlayer,60,275,335,0,55,UCBPlayer
6194,UCBPlayer,90,275,365,6,47,UCBPlayer
6195,UCBPlayer,57,307,364,2,46,UCBPlayer
6196,UCBPlayer,82,312,394,11,39,UCBPlayer
6197,UCBPlayer,130,265,395,15,40,UCBPlayer
6198,UCBPlayer,53,328,381,1,40,UCBPlayer
6199,UCBPlayer,52,332,384,1,39,UCBPlayer
6200,UCBPlayer,50,355,405,4,33,UCBPlayer
6201,UCBPlayer,77,267,344,3,53,UCBPlayer
6202,UCBPlayer,63,288,351,1,50,UCBPlayer
6203,UCBPlayer,63,298,361,2,47,UCBPlayer
6204,UCBPlayer,62,302,364,2,46,UCBPlayer
6205,UCBPlayer,56,291,347,0,51,UCBPlayer
6206,UCBPlayer,92,257,349,5,52,UCBPlayer
6207,UCBPlayer,51,311,362,0,46,UCBPlayer
6208,UCBPlayer,53,303,356,0,48,UCBPlayer
6209,UCBPlayer,75,285,360,4,48,UCBPlayer
6210,UCBPlayer,111,276,387,13,42,UCBPlayer
6211,UCBPlayer,60,315,375,1,42,UCBPlayer
6212,UCBPlayer,50,315,365,0,45,UCBPlayer
6213,UCBPlayer,62,287,349,2,51,UCBPlayer
6214,UCBPlayer,66,316,382,5,41,UCBPlayer
6215,UCBPlayer,70,285,355,2,49,UCBPlayer
6216,UCBPlayer,60,285,345,1,52,UCBPlayer
6217,UCBPlayer,67,272,339,1,54,UCBPlayer
6218,UCBPlayer,72,267,339,1,54,UCBPlayer
6219,UCBPlayer,67,272,339,1,54,UCBPlayer
6220,UCBPlayer,64,279,343,2,53,UCBPlayer
6221,UCBPlayer,56,306,362,0,46,UCBPlayer
6222,UCBPlayer,61,271,332,0,56,UCBPlayer
6223,UCBPlayer,72,267,339,1,54,UCBPlayer
6224,UCBPlayer,59,279,338,0,54,UCBPlayer
6225,UCBPlayer,108,253,361,8,49,UCBPlayer
6226,UCBPlayer,66,291,357,1,48,UCBPlayer
6227,UCBPlayer,221,211,432,25,31,Player A
6228,UCBPlayer,56,291,347,0,51,UCBPlayer
6229,UCBPlayer,56,291,347,0,51,UCBPlayer
6230,UCBPlayer,136,246,382,11,43,UCBPlayer
6231,UCBPlayer,102,297,399,13,38,UCBPlayer
6232,UCBPlayer,69,299,368,3,45,UCBPlayer
6233,UCBPlayer,60,275,335,0,55,UCBPlayer
6234,UCBPlayer,56,316,372,1,43,UCBPlayer
6235,UCBPlayer,104,249,353,9,52,UCBPlayer
6236,UCBPlayer,62,282,344,0,52,UCBPlayer
6237,UCBPlayer,65,305,370,2,44,UCBPlayer
6238,UCBPlayer,73,293,366,4,46,UCBPlayer
6239,UCBPlayer,77,267,344,3,53,UCBPlayer
6240,UCBPlayer,58,283,341,0,53,UCBPlayer
6241,UCBPlayer,66,296,362,3,47,UCBPlayer
6242,UCBPlayer,152,252,404,15,37,UCBPlayer
6243,UCBPlayer,72,262,334,2,56,UCBPlayer
6244,UCBPlayer,62,337,399,7,36,UCBPlayer
6245,UCBPlayer,63,278,341,0,53,UCBPlayer
6246,UCBPlayer,59,314,373,2,43,UCBPlayer
6247,UCBPlayer,63,298,361,2,47,UCBPlayer
6248,UCBPlayer,53,303,356,0,48,UCBPlayer
6249,UCBPlayer,58,318,376,2,42,UCBPlayer
6250,UCBPlayer,86,281,367,5,46,UCBPlayer
6251,UCBPlayer,67,292,359,3,48,UCBPlayer
6252,UCBPlayer,60,290,350,0,50,UCBPlayer
6253,UCBPlayer,53,303,356,0,48,UCBPlayer
6254,UCBPlayer,56,291,347,0,51,UCBPlayer
6255,UCBPlayer,48,323,371,0,43,UCBPlayer
6256,UCBPlayer,54,299,353,0,49,UCBPlayer
6257,UCBPlayer,54,299,353,0,49,UCBPlayer
6258,UCBPlayer,52,317,369,1,44,UCBPlayer
6259,UCBPlayer,68,303,371,3,44,UCBPlayer
6260,UCBPlayer,59,279,338,0,54,UCBPlayer
6261,UCBPlayer,56,301,357,1,48,UCBPlayer
6262,UCBPlayer,63,318,381,4,41,UCBPlayer
6263,UCBPlayer,65,270,335,0,55,UCBPlayer
6264,UCBPlayer,70,295,365,3,46,UCBPlayer
6265,UCBPlayer,49,319,368,0,44,UCBPlayer
6266,UCBPlayer,52,307,359,0,47,UCBPlayer
6267,UCBPlayer,57,297,354,1,49,UCBPlayer
6268,UCBPlayer,65,295,360,1,47,UCBPlayer
6269,UCBPlayer,46,336,382,2,40,UCBPlayer
6270,UCBPlayer,97,247,344,6,54,UCBPlayer
6271,UCBPlayer,59,314,373,2,43,UCBPlayer
6272,UCBPlayer,72,277,349,2,51,UCBPlayer
6273,UCBPlayer,66,286,352,2,50,UCBPlayer
6274,UCBPlayer,52,307,359,0,47,UCBPlayer
6275,UCBPlayer,52,307,359,0,47,UCBPlayer
6276,UCBPlayer,83,298,381,7,42,UCBPlayer
6277,UCBPlayer,53,303,356,0,48,UCBPlayer
6278,UCBPlayer,75,285,360,4,48,UCBPlayer
6279,UCBPlayer,110,255,365,9,48,UCBPlayer
6280,UCBPlayer,79,254,333,1,56,UCBPlayer
6281,UCBPlayer,53,303,356,0,48,UCBPlayer
6282,UCBPlayer,49,319,368,0,44,UCBPlayer
6283,UCBPlayer,56,291,347,0,51,UCBPlayer
6284,UCBPlayer,77,277,354,4,50,UCBPlayer
6285,UCBPlayer,104,264,368,12,48,UCBPlayer
6286,UCBPlayer,67,282,349,2,51,UCBPlayer
6287,UCBPlayer,58,298,356,0,48,UCBPlayer
6288,UCBPlayer,59,314,373,2,43,UCBPlayer
6289,UCBPlayer,61,271,332,0,56,UCBPlayer
6290,UCBPlayer,59,314,373,2,43,UCBPlayer
6291,UCBPlayer,53,303,356,0,48,UCBPlayer
6292,UCBPlayer,62,302,364,2,46,UCBPlayer
6293,UCBPlayer,65,300,365,3,46,UCBPlayer
6294,UCBPlayer,51,321,372,1,43,UCBPlayer
6295,UCBPlayer,97,277,374,6,44,UCBPlayer
6296,UCBPlayer,46,331,377,0,41,UCBPlayer
6297,UCBPlayer,59,279,338,0,54,UCBPlayer
6298,UCBPlayer,56,291,347,0,51,UCBPlayer
6299,UCBPlayer,56,291,347,0,51,UCBPlayer
6300,UCBPlayer,59,279,338,0,54,UCBPlayer
6301,UCBPlayer,59,279,338,0,54,UCBPlayer
6302,UCBPlayer,58,283,341,0,53,UCBPlayer
6303,UCBPlayer,69,279,348,1,51,UCBPlayer
6304,UCBPlayer,64,294,358,2,48,UCBPlayer
6305,UCBPlayer,51,311,362,0,46,UCBPlayer
6306,UCBPlayer,60,275,335,0,55,UCBPlayer
6307,UCBPlayer,65,290,355,2,49,UCBPlayer
6308,UCBPlayer,62,282,344,0,52,UCBPlayer
6309,UCBPlayer,49,319,368,0,44,UCBPlayer
6310,UCBPlayer,61,271,332,0,56,UCBPlayer
6311,UCBPlayer,130,255,385,14,43,UCBPlayer
6312,UCBPlayer,55,295,350,0,50,UCBPlayer
6313,UCBPlayer,58,293,351,1,50,UCBPlayer
6314,UCBPlayer,71,276,347,3,52,UCBPlayer
6315,UCBPlayer,65,270,335,0,55,UCBPlayer
6316,UCBPlayer,67,272,339,1,54,UCBPlayer
6317,UCBPlayer,69,264,333,1,56,UCBPlayer
6318,UCBPlayer,76,261,337,2,55,UCBPlayer
6319,UCBPlayer,61,316,377,6,43,UCBPlayer
6320,UCBPlayer,140,255,395,15,40,UCBPlayer
6321,UCBPlayer,59,279,338,0,54,UCBPlayer
6322,UCBPlayer,53,303,356,0,48,UCBPlayer
6323,UCBPlayer,46,316,362,0,46,UCBPlayer
6324,UCBPlayer,107,272,379,14,45,UCBPlayer
6325,UCBPlayer,46,331,377,0,41,UCBPlayer
6326,UCBPlayer,95,300,395,12,39,UCBPlayer
6327,UCBPlayer,67,282,349,2,51,UCBPlayer
6328,UCBPlayer,59,304,363,1,46,UCBPlayer
6329,UCBPlayer,58,308,366,1,45,UCBPlayer
6330,UCBPlayer,74,269,343,2,53,UCBPlayer
6331,UCBPlayer,80,280,360,4,48,UCBPlayer
6332,UCBPlayer,52,307,359,0,47,UCBPlayer
6333,UCBPlayer,53,303,356,0,48,UCBPlayer
6334,UCBPlayer,56,291,347,0,51,UCBPlayer
6335,UCBPlayer,68,293,361,2,47,UCBPlayer
6336,UCBPlayer,60,275,335,0,55,UCBPlayer
6337,UCBPlayer,54,314,368,0,44,UCBPlayer
6338,UCBPlayer,64,319,383,6,41,UCBPlayer
6339,UCBPlayer,74,254,328,2,58,UCBPlayer
6340,UCBPlayer,76,261,337,2,55,UCBPlayer
6341,UCBPlayer,52,307,359,0,47,UCBPlayer
6342,UCBPlayer,52,307,359,0,47,UCBPlayer
6343,UCBPlayer,78,283,361,5,48,UCBPlayer
6344,UCBPlayer,67,282,349,2,51,UCBPlayer
6345,UCBPlayer,64,274,338,0,54,UCBPlayer
6346,UCBPlayer,50,315,365,0,45,UCBPlayer
6347,UCBPlayer,47,327,374,0,42,UCBPlayer
6348,UCBPlayer,54,299,353,0,49,UCBPlayer
6349,UCBPlayer,76,261,337,2,55,UCBPlayer
6350,UCBPlayer,87,272,359,6,49,UCBPlayer
6351,UCBPlayer,94,264,358,5,49,UCBPlayer
6352,UCBPlayer,65,255,320,0,60,UCBPlayer
6353,UCBPlayer,71,291,362,3,47,UCBPlayer
6354,UCBPlayer,72,277,349,2,51,UCBPlayer
6355,UCBPlayer,62,292,354,1,49,UCBPlayer
6356,UCBPlayer,50,315,365,0,45,UCBPlayer
6357,UCBPlayer,108,258,366,7,47,UCBPlayer
6358,UCBPlayer,107,297,404,9,35,UCBPlayer
6359,UCBPlayer,51,311,362,0,46,UCBPlayer
6360,UCBPlayer,59,289,348,1,51,UCBPlayer
6361,UCBPlayer,75,280,355,2,49,UCBPlayer
6362,UCBPlayer,48,323,371,0,43,UCBPlayer
6363,UCBPlayer,63,293,356,3,49,UCBPlayer
6364,UCBPlayer,51,326,377,0,41,UCBPlayer
6365,UCBPlayer,49,329,378,1,41,UCBPlayer
6366,UCBPlayer,59,294,353,0,49,UCBPlayer
6367,UCBPlayer,68,258,326,0,58,UCBPlayer
6368,UCBPlayer,50,315,365,0,45,UCBPlayer
6369,UCBPlayer,61,296,357,1,48,UCBPlayer
6370,UCBPlayer,67,262,329,0,57,UCBPlayer
6371,UCBPlayer,68,268,336,1,55,UCBPlayer
6372,UCBPlayer,50,315,365,0,45,UCBPlayer
6373,UCBPlayer,65,275,340,2,54,UCBPlayer
6374,UCBPlayer,103,233,336,7,57,UCBPlayer
6375,UCBPlayer,50,315,365,0,45,UCBPlayer
6376,UCBPlayer,101,286,387,13,42,UCBPlayer
6377,UCBPlayer,96,266,362,9,49,UCBPlayer
6378,UCBPlayer,56,291,347,0,51,UCBPlayer
6379,UCBPlayer,68,283,351,1,50,UCBPlayer
6380,UCBPlayer,52,307,359,0,47,UCBPlayer
6381,UCBPlayer,123,253,376,8,44,UCBPlayer
6382,UCBPlayer,59,279,338,0,54,UCBPlayer
6383,UCBPlayer,54,299,353,0,49,UCBPlayer
6384,UCBPlayer,67,262,329,0,57,UCBPlayer
6385,UCBPlayer,49,319,368,0,44,UCBPlayer
6386,UCBPlayer,59,279,338,0,54,UCBPlayer
6387,UCBPlayer,59,294,353,0,49,UCBPlayer
6388,UCBPlayer,75,270,345,1,52,UCBPlayer
6389,UCBPlayer,57,287,344,0,52,UCBPlayer
6390,UCBPlayer,115,265,380,12,44,UCBPlayer
6391,UCBPlayer,50,315,365,0,45,UCBPlayer
6392,UCBPlayer,62,322,384,4,40,UCBPlayer
6393,UCBPlayer,49,319,368,0,44,UCBPlayer
6394,UCBPlayer,56,291,347,0,51,UCBPlayer
6395,UCBPlayer,53,313,366,1,45,UCBPlayer
6396,UCBPlayer,62,312,374,3,43,UCBPlayer
6397,UCBPlayer,55,295,350,0,50,UCBPlayer
6398,UCBPlayer,57,332,389,3,38,UCBPlayer
6399,UCBPlayer,48,323,371,0,43,UCBPlayer
6400,UCBPlayer,57,297,354,1,49,UCBPlayer
6401,UCBPlayer,89,299,388,8,40,UCBPlayer
6402,UCBPlayer,46,341,387,1,38,UCBPlayer
6403,UCBPlayer,107,272,379,8,43,UCBPlayer
6404,UCBPlayer,57,287,344,0,52,UCBPlayer
6405,UCBPlayer,62,282,344,0,52,UCBPlayer
6406,UCBPlayer,48,323,371,0,43,UCBPlayer
6407,UCBPlayer,53,303,356,0,48,UCBPlayer
6408,UCBPlayer,58,283,341,0,53,UCBPlayer
6409,UCBPlayer,68,308,376,5,43,UCBPlayer
6410,UCBPlayer,75,285,360,4,48,UCBPlayer
6411,UCBPlayer,78,253,331,2,57,UCBPlayer
6412,UCBPlayer,53,303,356,0,48,UCBPlayer
6413,UCBPlayer,59,294,353,0,49,UCBPlayer
6414,UCBPlayer,67,292,359,3,48,UCBPlayer
6415,UCBPlayer,63,288,351,1,50,UCBPlayer
6416,UCBPlayer,49,319,368,0,44,UCBPlayer
6417,UCBPlayer,53,303,356,0,48,UCBPlayer
6418,UCBPlayer,46,331,377,0,41,UCBPlayer
6419,UCBPlayer,73,258,331,2,57,UCBPlayer
6420,UCBPlayer,85,270,355,5,50,UCBPlayer
6421,UCBPlayer,136,281,417,13,32,UCBPlayer
6422,UCBPlayer,55,290,345,1,52,UCBPlayer
6423,UCBPlayer,60,300,360,1,47,UCBPlayer
6424,UCBPlayer,69,289,358,2,48,UCBPlayer
6425,UCBPlayer,51,296,347,0,51,UCBPlayer
6426,UCBPlayer,48,323,371,0,43,UCBPlayer
6427,UCBPlayer,69,254,323,0,59,UCBPlayer
6428,UCBPlayer,59,279,338,0,54,UCBPlayer
6429,UCBPlayer,55,320,375,1,42,UCBPlayer
6430,UCBPlayer,59,279,338,0,54,UCBPlayer
6431,UCBPlayer,69,284,353,3,50,UCBPlayer
6432,UCBPlayer,52,307,359,0,47,UCBPlayer
6433,UCBPlayer,77,287,364,5,47,UCBPlayer
6434,UCBPlayer,55,295,350,0,50,UCBPlayer
6435,UCBPlayer,77,287,364,5,47,UCBPlayer
6436,UCBPlayer,82,292,374,6,44,UCBPlayer
6437,UCBPlayer,53,303,356,0,48,UCBPlayer
6438,UCBPlayer,53,328,381,1,40,UCBPlayer
6439,UCBPlayer,64,284,348,1,51,UCBPlayer
6440,UCBPlayer,56,291,347,0,51,UCBPlayer
6441,UCBPlayer,76,281,357,4,49,UCBPlayer
6442,UCBPlayer,63,263,326,0,58,UCBPlayer
6443,UCBPlayer,66,291,357,1,48,UCBPlayer
6444,UCBPlayer,53,303,356,0,48,UCBPlayer
6445,UCBPlayer,57,287,344,0,52,UCBPlayer
6446,UCBPlayer,53,303,356,0,48,UCBPlayer
6447,UCBPlayer,55,295,350,0,50,UCBPlayer
6448,UCBPlayer,55,295,350,0,50,UCBPlayer
6449,UCBPlayer,102,247,349,5,52,UCBPlayer
6450,UCBPlayer,58,283,341,0,53,UCBPlayer
6451,UCBPlayer,56,291,347,0,51,UCBPlayer
6452,UCBPlayer,65,280,345,1,52,UCBPlayer
6453,UCBPlayer,59,314,373,2,43,UCBPlayer
6454,UCBPlayer,58,308,366,1,45,UCBPlayer
6455,UCBPlayer,62,292,354,1,49,UCBPlayer
6456,UCBPlayer,60,290,350,0,50,UCBPlayer
6457,UCBPlayer,56,291,347,0,51,UCBPlayer
6458,UCBPlayer,55,295,350,0,50,UCBPlayer
6459,UCBPlayer,70,285,355,2,49,UCBPlayer
6460,UCBPlayer,144,254,398,18,40,UCBPlayer
6461,UCBPlayer,89,264,353,3,50,UCBPlayer
6462,UCBPlayer,117,287,404,12,36,UCBPlayer
6463,UCBPlayer,61,271,332,0,56,UCBPlayer
6464,UCBPlayer,55,295,350,0,50,UCBPlayer
6465,UCBPlayer,67,282,349,2,51,UCBPlayer
6466,UCBPlayer,48,323,371,0,43,UCBPlayer
6467,UCBPlayer,52,307,359,0,47,UCBPlayer
6468,UCBPlayer,60,275,335,0,55,UCBPlayer
6469,UCBPlayer,50,315,365,0,45,UCBPlayer
6470,UCBPlayer,62,277,339,1,54,UCBPlayer
6471,UCBPlayer,69,289,358,2,48,UCBPlayer
6472,UCBPlayer,64,269,333,1,56,UCBPlayer
6473,UCBPlayer,66,311,377,3,42,UCBPlayer
6474,UCBPlayer,62,267,329,0,57,UCBPlayer
6475,UCBPlayer,52,307,359,0,47,UCBPlayer
6476,UCBPlayer,50,300,350,0,50,UCBPlayer
6477,UCBPlayer,92,262,354,7,51,UCBPlayer
6478,UCBPlayer,82,287,369,4,45,UCBPlayer
6479,UCBPlayer,58,318,376,2,42,UCBPlayer
6480,UCBPlayer,56,291,347,0,51,UCBPlayer
6481,UCBPlayer,55,295,350,0,50,UCBPlayer
6482,UCBPlayer,48,323,371,0,43,UCBPlayer
6483,UCBPlayer,60,300,360,1,47,UCBPlayer
6484,UCBPlayer,52,307,359,0,47,UCBPlayer
6485,UCBPlayer,52,317,369,1,44,UCBPlayer
6486,UCBPlayer,84,264,348,4,52,UCBPlayer
6487,UCBPlayer,89,244,333,4,57,UCBPlayer
6488,UCBPlayer,53,303,356,0,48,UCBPlayer
6489,UCBPlayer,82,287,369,4,45,UCBPlayer
6490,UCBPlayer,54,299,353,0,49,UCBPlayer
6491,UCBPlayer,80,300,380,6,42,UCBPlayer
6492,UCBPlayer,64,259,323,0,59,UCBPlayer
6493,UCBPlayer,59,334,393,4,37,UCBPlayer
6494,UCBPlayer,72,297,369,4,45,UCBPlayer
6495,UCBPlayer,60,310,370,2,44,UCBPlayer
6496,UCBPlayer,56,306,362,0,46,UCBPlayer
6497,UCBPlayer,53,303,356,0,48,UCBPlayer
6498,UCBPlayer,51,311,362,0,46,UCBPlayer
6499,UCBPlayer,45,345,390,1,37,UCBPlayer
6500,UCBPlayer,67,272,339,1,54,UCBPlayer
6501,UCBPlayer,64,274,338,0,54,UCBPlayer
6502,UCBPlayer,55,315,370,2,44,UCBPlayer
6503,UCBPlayer,91,321,412,11,33,UCBPlayer
6504,UCBPlayer,53,303,356,0,48,UCBPlayer
6505,UCBPlayer,75,295,370,5,45,UCBPlayer
6506,UCBPlayer,69,294,363,1,46,UCBPlayer
6507,UCBPlayer,50,315,365,0,45,UCBPlayer
6508,UCBPlayer,59,279,338,0,54,UCBPlayer
6509,UCBPlayer,58,318,376,2,42,UCBPlayer
6510,UCBPlayer,55,295,350,0,50,UCBPlayer
6511,UCBPlayer,67,282,349,2,51,UCBPlayer
6512,UCBPlayer,49,329,378,1,41,UCBPlayer
6513,UCBPlayer,65,280,345,1,52,UCBPlayer
6514,UCBPlayer,57,287,344,0,52,UCBPlayer
6515,UCBPlayer,50,315,365,0,45,UCBPlayer
6516,UCBPlayer,55,295,350,0,50,UCBPlayer
6517,UCBPlayer,64,294,358,2,48,UCBPlayer
6518,UCBPlayer,50,315,365,0,45,UCBPlayer
6519,UCBPlayer,89,289,378,10,44,UCBPlayer
6520,UCBPlayer,128,273,401,15,38,UCBPlayer
6521,UCBPlayer,65,290,355,2,49,UCBPlayer
6522,UCBPlayer,55,295,350,0,50,UCBPlayer
6523,UCBPlayer,59,279,338,0,54,UCBPlayer
6524,UCBPlayer,48,323,371,0,43,UCBPlayer
6525,UCBPlayer,57,292,349,2,51,UCBPlayer
6526,UCBPlayer,73,313,386,3,39,UCBPlayer
6527,UCBPlayer,51,296,347,0,51,UCBPlayer
6528,UCBPlayer,55,295,350,0,50,UCBPlayer
6529,UCBPlayer,59,279,338,0,54,UCBPlayer
6530,UCBPlayer,61,306,367,2,45,UCBPlayer
6531,UCBPlayer,99,314,413,12,33,UCBPlayer
6532,UCBPlayer,56,291,347,0,51,UCBPlayer
6533,UCBPlayer,59,279,338,0,54,UCBPlayer
6534,UCBPlayer,65,280,345,1,52,UCBPlayer
6535,UCBPlayer,56,316,372,1,43,UCBPlayer
6536,UCBPlayer,55,295,350,0,50,UCBPlayer
6537,UCBPlayer,72,302,374,6,44,UCBPlayer
6538,UCBPlayer,75,300,375,4,43,UCBPlayer
6539,UCBPlayer,55,295,350,0,50,UCBPlayer
6540,UCBPlayer,48,323,371,0,43,UCBPlayer
6541,UCBPlayer,75,255,330,1,57,UCBPlayer
6542,UCBPlayer,81,286,367,5,46,UCBPlayer
6543,UCBPlayer,88,288,376,8,44,UCBPlayer
6544,UCBPlayer,76,261,337,2,55,UCBPlayer
6545,UCBPlayer,51,311,362,0,46,UCBPlayer
6546,UCBPlayer,70,270,340,2,54,UCBPlayer
6547,UCBPlayer,75,310,385,5,40,UCBPlayer
6548,UCBPlayer,44,339,383,0,39,UCBPlayer
6549,UCBPlayer,63,288,351,1,50,UCBPlayer
6550,UCBPlayer,48,323,371,0,43,UCBPlayer
6551,UCBPlayer,50,315,365,0,45,UCBPlayer
6552,UCBPlayer,53,303,356,0,48,UCBPlayer
6553,UCBPlayer,67,297,364,2,46,UCBPlayer
6554,UCBPlayer,62,287,349,2,51,UCBPlayer
6555,UCBPlayer,100,245,345,7,54,UCBPlayer
6556,UCBPlayer,48,323,371,0,43,UCBPlayer
6557,UCBPlayer,54,309,363,1,46,UCBPlayer
6558,UCBPlayer,52,332,384,1,39,UCBPlayer
6559,UCBPlayer,46,331,377,0,41,UCBPlayer
6560,UCBPlayer,52,307,359,0,47,UCBPlayer
6561,UCBPlayer,57,287,344,0,52,UCBPlayer
6562,UCBPlayer,72,282,354,4,50,UCBPlayer
6563,UCBPlayer,48,323,371,0,43,UCBPlayer
6564,UCBPlayer,54,299,353,0,49,UCBPlayer
6565,UCBPlayer,54,319,373,2,43,UCBPlayer
6566,UCBPlayer,90,310,400,8,36,UCBPlayer
6567,UCBPlayer,57,287,344,0,52,UCBPlayer
6568,UCBPlayer,61,271,332,0,56,UCBPlayer
6569,UCBPlayer,49,319,368,0,44,UCBPlayer
6570,UCBPlayer,62,297,359,3,48,UCBPlayer
6571,UCBPlayer,62,292,354,1,49,UCBPlayer
6572,UCBPlayer,89,259,348,4,52,UCBPlayer
6573,UCBPlayer,75,250,325,2,59,UCBPlayer
6574,UCBPlayer,46,331,377,0,41,UCBPlayer
6575,UCBPlayer,60,300,360,4,48,UCBPlayer
6576,UCBPlayer,100,260,360,7,49,UCBPlayer
6577,UCBPlayer,55,290,345,1,52,UCBPlayer
6578,UCBPlayer,61,286,347,0,51,UCBPlayer
6579,UCBPlayer,80,285,365,6,47,UCBPlayer
6580,UCBPlayer,59,304,363,1,46,UCBPlayer
6581,UCBPlayer,56,291,347,0,51,UCBPlayer
6582,UCBPlayer,63,288,351,1,50,UCBPlayer
6583,UCBPlayer,52,307,359,0,47,UCBPlayer
6584,UCBPlayer,66,251,317,0,61,UCBPlayer
6585,UCBPlayer,66,266,332,0,56,UCBPlayer
6586,UCBPlayer,59,334,393,4,37,UCBPlayer
6587,UCBPlayer,57,287,344,0,52,UCBPlayer
6588,UCBPlayer,39,359,398,0,34,UCBPlayer
6589,UCBPlayer,81,301,382,8,42,UCBPlayer
6590,UCBPlayer,72,282,354,4,50,UCBPlayer
6591,UCBPlayer,73,288,361,2,47,UCBPlayer
6592,UCBPlayer,74,269,343,2,53,UCBPlayer
6593,UCBPlayer,85,250,335,3,56,UCBPlayer
6594,UCBPlayer,74,259,333,1,56,UCBPlayer
6595,UCBPlayer,55,295,350,0,50,UCBPlayer
6596,UCBPlayer,54,299,353,0,49,UCBPlayer
6597,UCBPlayer,60,310,370,2,44,UCBPlayer
6598,UCBPlayer,51,311,362,0,46,UCBPlayer
6599,UCBPlayer,68,288,356,3,49,UCBPlayer
6600,UCBPlayer,52,317,369,1,44,UCBPlayer
6601,UCBPlayer,62,317,379,2,41,UCBPlayer
6602,UCBPlayer,48,323,371,0,43,UCBPlayer
6603,UCBPlayer,60,275,335,0,55,UCBPlayer
6604,UCBPlayer,51,311,362,0,46,UCBPlayer
6605,UCBPlayer,54,299,353,0,49,UCBPlayer
6606,UCBPlayer,51,311,362,0,46,UCBPlayer
6607,UCBPlayer,62,267,329,0,57,UCBPlayer
6608,UCBPlayer,49,329,378,1,41,UCBPlayer
6609,UCBPlayer,60,300,360,1,47,UCBPlayer
6610,UCBPlayer,59,319,378,4,42,UCBPlayer
6611,UCBPlayer,65,290,355,2,49,UCBPlayer
6612,UCBPlayer,69,299,368,6,46,UCBPlayer
6613,UCBPlayer,53,318,371,0,43,UCBPlayer
6614,UCBPlayer,55,320,375,1,42,UCBPlayer
6615,UCBPlayer,54,299,353,0,49,UCBPlayer
6616,UCBPlayer,62,302,364,2,46,UCBPlayer
6617,UCBPlayer,51,311,362,0,46,UCBPlayer
6618,UCBPlayer,61,296,357,1,48,UCBPlayer
6619,UCBPlayer,113,253,366,10,48,UCBPlayer
6620,UCBPlayer,95,245,340,5,55,UCBPlayer
6621,UCBPlayer,51,311,362,0,46,UCBPlayer
6622,UCBPlayer,87,292,379,8,43,UCBPlayer
6623,UCBPlayer,82,302,384,4,40,UCBPlayer
6624,UCBPlayer,56,301,357,1,48,UCBPlayer
6625,UCBPlayer,46,331,377,0,41,UCBPlayer
6626,UCBPlayer,55,295,350,0,50,UCBPlayer
6627,UCBPlayer,45,340,385,2,39,UCBPlayer
6628,UCBPlayer,72,282,354,1,49,UCBPlayer
6629,UCBPlayer,52,292,344,0,52,UCBPlayer
6630,UCBPlayer,55,295,350,0,50,UCBPlayer
6631,UCBPlayer,65,280,345,1,52,UCBPlayer
6632,UCBPlayer,64,304,368,3,45,UCBPlayer
6633,UCBPlayer,61,306,367,2,45,UCBPlayer
6634,UCBPlayer,57,322,379,2,41,UCBPlayer
6635,UCBPlayer,56,291,347,0,51,UCBPlayer
6636,UCBPlayer,50,315,365,0,45,UCBPlayer
6637,UCBPlayer,55,295,350,0,50,UCBPlayer
6638,UCBPlayer,49,319,368,0,44,UCBPlayer
6639,UCBPlayer,60,300,360,1,47,UCBPlayer
6640,UCBPlayer,74,259,333,1,56,UCBPlayer
6641,UCBPlayer,78,303,381,4,41,UCBPlayer
6642,UCBPlayer,63,263,326,0,58,UCBPlayer
6643,UCBPlayer,99,279,378,10,44,UCBPlayer
6644,UCBPlayer,52,307,359,0,47,UCBPlayer
6645,UCBPlayer,52,307,359,0,47,UCBPlayer
6646,UCBPlayer,59,279,338,0,54,UCBPlayer
6647,UCBPlayer,88,258,346,5,53,UCBPlayer
6648,UCBPlayer,90,305,395,9,38,UCBPlayer
6649,UCBPlayer,53,328,381,1,40,UCBPlayer
6650,UCBPlayer,71,301,372,4,44,UCBPlayer
6651,UCBPlayer,58,283,341,0,53,UCBPlayer
6652,UCBPlayer,66,286,352,2,50,UCBPlayer
6653,UCBPlayer,101,266,367,8,47,UCBPlayer
6654,UCBPlayer,56,316,372,1,43,UCBPlayer
6655,UCBPlayer,59,279,338,0,54,UCBPlayer
6656,UCBPlayer,61,296,357,1,48,UCBPlayer
6657,UCBPlayer,72,297,369,4,45,UCBPlayer
6658,UCBPlayer,54,299,353,0,49,UCBPlayer
6659,UCBPlayer,57,287,344,0,52,UCBPlayer
6660,UCBPlayer,52,317,369,1,44,UCBPlayer
6661,UCBPlayer,67,262,329,0,57,UCBPlayer
6662,UCBPlayer,58,308,366,1,45,UCBPlayer
6663,UCBPlayer,122,287,409,17,36,UCBPlayer
6664,UCBPlayer,85,290,375,10,45,UCBPlayer
6665,UCBPlayer,65,285,350,0,50,UCBPlayer
6666,UCBPlayer,53,303,356,0,48,UCBPlayer
6667,UCBPlayer,46,346,392,3,37,UCBPlayer
6668,UCBPlayer,66,301,367,2,45,UCBPlayer
6669,UCBPlayer,65,300,365,3,46,UCBPlayer
6670,UCBPlayer,55,310,365,0,45,UCBPlayer
6671,UCBPlayer,58,283,341,0,53,UCBPlayer
6672,UCBPlayer,54,299,353,0,49,UCBPlayer
6673,UCBPlayer,78,273,351,4,51,UCBPlayer
6674,UCBPlayer,60,275,335,0,55,UCBPlayer
6675,UCBPlayer,51,311,362,0,46,UCBPlayer
6676,UCBPlayer,56,291,347,0,51,UCBPlayer
6677,UCBPlayer,53,303,356,0,48,UCBPlayer
6678,UCBPlayer,52,307,359,0,47,UCBPlayer
6679,UCBPlayer,53,298,351,1,50,UCBPlayer
6680,UCBPlayer,95,275,370,8,46,UCBPlayer
6681,UCBPlayer,56,291,347,0,51,UCBPlayer
6682,UCBPlayer,52,307,359,0,47,UCBPlayer
6683,UCBPlayer,59,324,383,3,40,UCBPlayer
6684,UCBPlayer,52,307,359,0,47,UCBPlayer
6685,UCBPlayer,72,292,364,5,47,UCBPlayer
6686,UCBPlayer,58,298,356,0,48,UCBPlayer
6687,UCBPlayer,59,324,383,3,40,UCBPlayer
6688,UCBPlayer,62,292,354,1,49,UCBPlayer
6689,UCBPlayer,46,331,377,0,41,UCBPlayer
6690,UCBPlayer,54,299,353,0,49,UCBPlayer
6691,UCBPlayer,60,275,335,0,55,UCBPlayer
6692,UCBPlayer,121,266,387,13,42,UCBPlayer
6693,UCBPlayer,57,287,344,0,52,UCBPlayer
6694,UCBPlayer,58,283,341,0,53,UCBPlayer
6695,UCBPlayer,65,310,375,4,43,UCBPlayer
6696,UCBPlayer,84,289,373,8,45,UCBPlayer
6697,UCBPlayer,65,280,345,1,52,UCBPlayer
6698,UCBPlayer,59,279,338,0,54,UCBPlayer
6699,UCBPlayer,51,311,362,0,46,UCBPlayer
6700,UCBPlayer,63,278,341,0,53,UCBPlayer
6701,UCBPlayer,55,305,360,1,47,UCBPlayer
6702,UCBPlayer,88,263,351,4,51,UCBPlayer
6703,UCBPlayer,58,318,376,2,42,UCBPlayer
6704,UCBPlayer,71,306,377,3,42,UCBPlayer
6705,UCBPlayer,47,327,374,0,42,UCBPlayer
6706,UCBPlayer,77,267,344,3,53,UCBPlayer
6707,UCBPlayer,57,307,364,2,46,UCBPlayer
6708,UCBPlayer,65,310,375,4,43,UCBPlayer
6709,UCBPlayer,62,312,374,3,43,UCBPlayer
6710,UCBPlayer,60,290,350,0,50,UCBPlayer
6711,UCBPlayer,59,279,338,0,54,UCBPlayer
6712,UCBPlayer,59,279,338,0,54,UCBPlayer
6713,UCBPlayer,57,287,344,0,52,UCBPlayer
6714,UCBPlayer,68,258,326,0,58,UCBPlayer
6715,UCBPlayer,66,311,377,3,42,UCBPlayer
6716,UCBPlayer,52,307,359,0,47,UCBPlayer
6717,UCBPlayer,60,285,345,1,52,UCBPlayer
6718,UCBPlayer,58,308,366,1,45,UCBPlayer
6719,UCBPlayer,61,306,367,2,45,UCBPlayer
6720,UCBPlayer,81,251,332,3,57,UCBPlayer
6721,UCBPlayer,54,299,353,0,49,UCBPlayer
6722,UCBPlayer,58,283,341,0,53,UCBPlayer
6723,UCBPlayer,63,298,361,2,47,UCBPlayer
6724,UCBPlayer,48,323,371,0,43,UCBPlayer
6725,UCBPlayer,59,279,338,0,54,UCBPlayer
6726,UCBPlayer,70,305,375,4,43,UCBPlayer
6727,UCBPlayer,61,306,367,2,45,UCBPlayer
6728,UCBPlayer,58,323,381,1,40,UCBPlayer
6729,UCBPlayer,63,273,336,1,55,UCBPlayer
6730,UCBPlayer,108,293,401,12,37,UCBPlayer
6731,UCBPlayer,54,314,368,0,44,UCBPlayer
6732,UCBPlayer,60,300,360,1,47,UCBPlayer
6733,UCBPlayer,75,275,350,3,51,UCBPlayer
6734,UCBPlayer,49,319,368,0,44,UCBPlayer
6735,UCBPlayer,48,323,371,0,43,UCBPlayer
6736,UCBPlayer,46,331,377,0,41,UCBPlayer
6737,UCBPlayer,56,291,347,0,51,UCBPlayer
6738,UCBPlayer,58,308,366,1,45,UCBPlayer
6739,UCBPlayer,51,311,362,0,46,UCBPlayer
6740,UCBPlayer,59,314,373,2,43,UCBPlayer
6741,UCBPlayer,87,262,349,5,52,UCBPlayer
6742,UCBPlayer,55,295,350,0,50,UCBPlayer
6743,UCBPlayer,73,273,346,2,52,UCBPlayer
6744,UCBPlayer,64,299,363,1,46,UCBPlayer
6745,UCBPlayer,60,300,360,1,47,UCBPlayer
6746,UCBPlayer,55,295,350,0,50,UCBPlayer
6747,UCBPlayer,50,325,375,1,42,UCBPlayer
6748,UCBPlayer,56,306,362,0,46,UCBPlayer
6749,UCBPlayer,63,288,351,1,50,UCBPlayer
6750,UCBPlayer,79,259,338,3,55,UCBPlayer
6751,UCBPlayer,72,282,354,4,50,UCBPlayer
6752,UCBPlayer,87,232,319,2,61,UCBPlayer
6753,UCBPlayer,87,272,359,6,49,UCBPlayer
6754,UCBPlayer,85,260,345,4,53,UCBPlayer
6755,UCBPlayer,49,329,378,1,41,UCBPlayer
6756,UCBPlayer,71,276,347,3,52,UCBPlayer
6757,UCBPlayer,49,319,368,0,44,UCBPlayer
6758,UCBPlayer,51,321,372,1,43,UCBPlayer
6759,UCBPlayer,80,305,385,5,40,UCBPlayer
6760,UCBPlayer,54,309,363,1,46,UCBPlayer
6761,UCBPlayer,67,282,349,2,51,UCBPlayer
6762,UCBPlayer,53,303,356,0,48,UCBPlayer
6763,UCBPlayer,52,307,359,0,47,UCBPlayer
6764,UCBPlayer,62,267,329,0,57,UCBPlayer
6765,UCBPlayer,53,313,366,1,45,UCBPlayer
6766,UCBPlayer,72,292,364,5,47,UCBPlayer
6767,UCBPlayer,55,330,385,2,39,UCBPlayer
6768,UCBPlayer,55,320,375,1,42,UCBPlayer
6769,UCBPlayer,54,299,353,0,49,UCBPlayer
6770,UCBPlayer,56,291,347,0,51,UCBPlayer
6771,UCBPlayer,56,301,357,1,48,UCBPlayer
6772,UCBPlayer,56,321,377,3,42,UCBPlayer
6773,UCBPlayer,55,310,365,0,45,UCBPlayer
6774,UCBPlayer,49,319,368,0,44,UCBPlayer
6775,UCBPlayer,56,291,347,0,51,UCBPlayer
6776,UCBPlayer,60,275,335,0,55,UCBPlayer
6777,UCBPlayer,59,279,338,0,54,UCBPlayer
6778,UCBPlayer,54,299,353,0,49,UCBPlayer
6779,UCBPlayer,56,301,357,1,48,UCBPlayer
6780,UCBPlayer,59,309,368,3,45,UCBPlayer
6781,UCBPlayer,84,239,323,3,60,UCBPlayer
6782,UCBPlayer,62,292,354,1,49,UCBPlayer
6783,UCBPlayer,89,254,343,5,54,UCBPlayer
6784,UCBPlayer,58,283,341,0,53,UCBPlayer
6785,UCBPlayer,55,295,350,0,50,UCBPlayer
6786,UCBPlayer,63,313,376,2,42,UCBPlayer
6787,UCBPlayer,57,287,344,0,52,UCBPlayer
6788,UCBPlayer,61,326,387,4,39,UCBPlayer
6789,UCBPlayer,51,311,362,0,46,UCBPlayer
6790,UCBPlayer,59,279,338,0,54,UCBPlayer
6791,UCBPlayer,66,266,332,0,56,UCBPlayer
6792,UCBPlayer,55,295,350,0,50,UCBPlayer
6793,UCBPlayer,62,292,354,1,49,UCBPlayer
6794,UCBPlayer,51,311,362,0,46,UCBPlayer
6795,UCBPlayer,71,276,347,3,52,UCBPlayer
6796,UCBPlayer,84,299,383,9,42,UCBPlayer
6797,UCBPlayer,53,303,356,0,48,UCBPlayer
6798,UCBPlayer,71,306,377,6,43,UCBPlayer
6799,UCBPlayer,72,287,359,3,48,UCBPlayer
6800,UCBPlayer,53,303,356,0,48,UCBPlayer
6801,UCBPlayer,64,294,358,2,48,UCBPlayer
6802,UCBPlayer,61,271,332,0,56,UCBPlayer
6803,UCBPlayer,56,291,347,0,51,UCBPlayer
6804,UCBPlayer,52,307,359,0,47,UCBPlayer
6805,UCBPlayer,55,295,350,0,50,UCBPlayer
6806,UCBPlayer,61,271,332,0,56,UCBPlayer
6807,UCBPlayer,45,335,380,0,40,UCBPlayer
6808,UCBPlayer,49,319,368,0,44,UCBPlayer
6809,UCBPlayer,72,272,344,3,53,UCBPlayer
6810,UCBPlayer,48,323,371,0,43,UCBPlayer
6811,UCBPlayer,63,283,346,2,52,UCBPlayer
6812,UCBPlayer,91,271,362,6,48,UCBPlayer
6813,UCBPlayer,74,284,358,5,49,UCBPlayer
6814,UCBPlayer,45,345,390,1,37,UCBPlayer
6815,UCBPlayer,62,282,344,0,52,UCBPlayer
6816,UCBPlayer,61,286,347,0,51,UCBPlayer
6817,UCBPlayer,68,293,361,2,47,UCBPlayer
6818,UCBPlayer,53,303,356,0,48,UCBPlayer
6819,UCBPlayer,50,315,365,0,45,UCBPlayer
6820,UCBPlayer,113,258,371,9,46,UCBPlayer
6821,UCBPlayer,56,291,347,0,51,UCBPlayer
6822,UCBPlayer,57,287,344,0,52,UCBPlayer
6823,UCBPlayer,58,283,341,0,53,UCBPlayer
6824,UCBPlayer,103,258,361,8,49,UCBPlayer
6825,UCBPlayer,70,295,365,3,46,UCBPlayer
6826,UCBPlayer,52,307,359,0,47,UCBPlayer
6827,UCBPlayer,67,287,354,4,50,UCBPlayer
6828,UCBPlayer,62,322,384,4,40,UCBPlayer
6829,UCBPlayer,85,260,345,4,53,UCBPlayer
6830,UCBPlayer,64,294,358,2,48,UCBPlayer
6831,UCBPlayer,69,299,368,3,45,UCBPlayer
6832,UCBPlayer,78,288,366,4,46,UCBPlayer
6833,UCBPlayer,47,312,359,0,47,UCBPlayer
6834,UCBPlayer,66,286,352,2,50,UCBPlayer
6835,UCBPlayer,66,286,352,2,50,UCBPlayer
6836,UCBPlayer,66,291,357,1,48,UCBPlayer
6837,UCBPlayer,57,287,344,0,52,UCBPlayer
6838,UCBPlayer,75,265,340,2,54,UCBPlayer
6839,UCBPlayer,58,283,341,0,53,UCBPlayer
6840,UCBPlayer,55,295,350,0,50,UCBPlayer
6841,UCBPlayer,112,252,364,8,48,UCBPlayer
6842,UCBPlayer,71,306,377,6,43,UCBPlayer
6843,UCBPlayer,72,297,369,4,45,UCBPlayer
6844,UCBPlayer,64,259,323,0,59,UCBPlayer
6845,UCBPlayer,62,282,344,0,52,UCBPlayer
6846,UCBPlayer,58,283,341,0,53,UCBPlayer
6847,UCBPlayer,66,276,342,1,53,UCBPlayer
6848,UCBPlayer,69,279,348,1,51,UCBPlayer
6849,UCBPlayer,60,275,335,0,55,UCBPlayer
6850,UCBPlayer,77,257,334,2,56,UCBPlayer
6851,UCBPlayer,83,263,346,5,53,UCBPlayer
6852,UCBPlayer,50,315,365,0,45,UCBPlayer
6853,UCBPlayer,60,310,370,2,44,UCBPlayer
6854,UCBPlayer,54,299,353,0,49,UCBPlayer
6855,UCBPlayer,64,304,368,3,45,UCBPlayer
6856,UCBPlayer,68,288,356,3,49,UCBPlayer
6857,UCBPlayer,59,334,393,4,37,UCBPlayer
6858,UCBPlayer,49,339,388,2,38,UCBPlayer
6859,UCBPlayer,71,276,347,3,52,UCBPlayer
6860,UCBPlayer,56,291,347,0,51,UCBPlayer
6861,UCBPlayer,81,281,362,6,48,UCBPlayer
6862,UCBPlayer,56,291,347,0,51,UCBPlayer
6863,UCBPlayer,83,268,351,4,51,UCBPlayer
6864,UCBPlayer,69,299,368,3,45,UCBPlayer
6865,UCBPlayer,67,282,349,2,51,UCBPlayer
6866,UCBPlayer,57,287,344,0,52,UCBPlayer
6867,UCBPlayer,160,225,385,17,44,UCBPlayer
6868,UCBPlayer,66,291,357,1,48,UCBPlayer
6869,UCBPlayer,55,295,350,0,50,UCBPlayer
6870,UCBPlayer,49,319,368,0,44,UCBPlayer
6871,UCBPlayer,83,303,386,9,41,UCBPlayer
6872,UCBPlayer,56,316,372,1,43,UCBPlayer
6873,UCBPlayer,51,311,362,0,46,UCBPlayer
6874,UCBPlayer,48,323,371,0,43,UCBPlayer
6875,UCBPlayer,50,315,365,0,45,UCBPlayer
6876,UCBPlayer,62,277,339,1,54,UCBPlayer
6877,UCBPlayer,68,293,361,2,47,UCBPlayer
6878,UCBPlayer,60,305,365,3,46,UCBPlayer
6879,UCBPlayer,80,285,365,6,47,UCBPlayer
6880,UCBPlayer,72,317,389,6,39,UCBPlayer
6881,UCBPlayer,69,274,343,2,53,UCBPlayer
6882,UCBPlayer,62,307,369,1,44,UCBPlayer
6883,UCBPlayer,57,302,359,0,47,UCBPlayer
6884,UCBPlayer,44,324,368,0,44,UCBPlayer
6885,UCBPlayer,62,302,364,2,46,UCBPlayer
6886,UCBPlayer,60,320,380,3,41,UCBPlayer
6887,UCBPlayer,52,307,359,0,47,UCBPlayer
6888,UCBPlayer,75,285,360,4,48,UCBPlayer
6889,UCBPlayer,55,295,350,0,50,UCBPlayer
6890,UCBPlayer,59,279,338,0,54,UCBPlayer
6891,UCBPlayer,66,276,342,1,53,UCBPlayer
6892,UCBPlayer,168,253,421,20,33,UCBPlayer
6893,UCBPlayer,69,264,333,1,56,UCBPlayer
6894,UCBPlayer,59,279,338,0,54,UCBPlayer
6895,UCBPlayer,68,298,366,4,46,UCBPlayer
6896,UCBPlayer,54,299,353,0,49,UCBPlayer
6897,UCBPlayer,56,291,347,0,51,UCBPlayer
6898,UCBPlayer,78,263,341,3,54,UCBPlayer
6899,UCBPlayer,62,282,344,0,52,UCBPlayer
6900,UCBPlayer,52,307,359,0,47,UCBPlayer
6901,UCBPlayer,48,323,371,0,43,UCBPlayer
6902,UCBPlayer,62,267,329,0,57,UCBPlayer
6903,UCBPlayer,104,284,388,8,40,UCBPlayer
6904,UCBPlayer,51,311,362,0,46,UCBPlayer
6905,UCBPlayer,48,323,371,0,43,UCBPlayer
6906,UCBPlayer,46,331,377,0,41,UCBPlayer
6907,UCBPlayer,86,286,372,7,45,UCBPlayer
6908,UCBPlayer,59,304,363,1,46,UCBPlayer
6909,UCBPlayer,42,347,389,0,37,UCBPlayer
6910,UCBPlayer,64,284,348,1,51,UCBPlayer
6911,UCBPlayer,49,319,368,0,44,UCBPlayer
6912,UCBPlayer,52,307,359,0,47,UCBPlayer
6913,UCBPlayer,87,262,349,5,52,UCBPlayer
6914,UCBPlayer,82,257,339,4,55,UCBPlayer
6915,UCBPlayer,57,287,344,0,52,UCBPlayer
6916,UCBPlayer,55,295,350,0,50,UCBPlayer
6917,UCBPlayer,53,303,356,0,48,UCBPlayer
6918,UCBPlayer,59,279,338,0,54,UCBPlayer
6919,UCBPlayer,57,297,354,1,49,UCBPlayer
6920,UCBPlayer,71,281,352,2,50,UCBPlayer
6921,UCBPlayer,50,315,365,0,45,UCBPlayer
6922,UCBPlayer,49,319,368,0,44,UCBPlayer
6923,UCBPlayer,54,299,353,0,49,UCBPlayer
6924,UCBPlayer,45,335,380,0,40,UCBPlayer
6925,UCBPlayer,55,325,380,3,41,UCBPlayer
6926,UCBPlayer,59,304,363,1,46,UCBPlayer
6927,UCBPlayer,77,292,369,4,45,UCBPlayer
6928,UCBPlayer,58,333,391,5,38,UCBPlayer
6929,UCBPlayer,68,323,391,2,37,UCBPlayer
6930,UCBPlayer,63,298,361,2,47,UCBPlayer
6931,UCBPlayer,69,254,323,0,59,UCBPlayer
6932,UCBPlayer,60,305,365,3,46,UCBPlayer
6933,UCBPlayer,96,271,367,8,47,UCBPlayer
6934,UCBPlayer,65,265,330,1,57,UCBPlayer
6935,UCBPlayer,45,335,380,0,40,UCBPlayer
6936,UCBPlayer,89,254,343,5,54,UCBPlayer
6937,UCBPlayer,62,332,394,5,37,UCBPlayer
6938,UCBPlayer,68,258,326,0,58,UCBPlayer
6939,UCBPlayer,293,183,476,36,20,Player A
6940,UCBPlayer,82,277,359,6,49,UCBPlayer
6941,UCBPlayer,80,305,385,8,41,UCBPlayer
6942,UCBPlayer,50,315,365,0,45,UCBPlayer
6943,UCBPlayer,68,278,346,2,52,UCBPlayer
6944,UCBPlayer,54,299,353,0,49,UCBPlayer
6945,UCBPlayer,61,271,332,0,56,UCBPlayer
6946,UCBPlayer,114,259,373,14,47,UCBPlayer
6947,UCBPlayer,72,252,324,1,59,UCBPlayer
6948,UCBPlayer,52,307,359,0,47,UCBPlayer
6949,UCBPlayer,52,307,359,0,47,UCBPlayer
6950,UCBPlayer,66,286,352,2,50,UCBPlayer
6951,UCBPlayer,43,343,386,0,38,UCBPlayer
6952,UCBPlayer,50,315,365,0,45,UCBPlayer
6953,UCBPlayer,94,234,328,5,59,UCBPlayer
6954,UCBPlayer,81,296,377,6,43,UCBPlayer
6955,UCBPlayer,57,287,344,0,52,UCBPlayer
6956,UCBPlayer,77,277,354,4,50,UCBPlayer
6957,UCBPlayer,53,303,356,0,48,UCBPlayer
6958,UCBPlayer,76,301,377,3,42,UCBPlayer
6959,UCBPlayer,54,299,353,0,49,UCBPlayer
6960,UCBPlayer,46,331,377,0,41,UCBPlayer
6961,UCBPlayer,80,300,380,6,42,UCBPlayer
6962,UCBPlayer,73,283,356,6,50,UCBPlayer
6963,UCBPlayer,106,271,377,12,45,UCBPlayer
6964,UCBPlayer,52,322,374,0,42,UCBPlayer
6965,UCBPlayer,53,303,356,0,48,UCBPlayer
6966,UCBPlayer,114,279,393,10,39,UCBPlayer
6967,UCBPlayer,47,327,374,0,42,UCBPlayer
6968,UCBPlayer,53,303,356,0,48,UCBPlayer
6969,UCBPlayer,65,270,335,0,55,UCBPlayer
6970,UCBPlayer,51,321,372,1,43,UCBPlayer
6971,UCBPlayer,58,298,356,0,48,UCBPlayer
6972,UCBPlayer,48,323,371,0,43,UCBPlayer
6973,UCBPlayer,68,298,366,4,46,UCBPlayer
6974,UCBPlayer,59,279,338,0,54,UCBPlayer
6975,UCBPlayer,63,278,341,0,53,UCBPlayer
6976,UCBPlayer,61,271,332,0,56,UCBPlayer
6977,UCBPlayer,56,291,347,0,51,UCBPlayer
6978,UCBPlayer,57,287,344,0,52,UCBPlayer
6979,UCBPlayer,56,301,357,1,48,UCBPlayer
6980,UCBPlayer,67,292,359,3,48,UCBPlayer
6981,UCBPlayer,59,304,363,1,46,UCBPlayer
6982,UCBPlayer,59,289,348,1,51,UCBPlayer
6983,UCBPlayer,62,282,344,0,52,UCBPlayer
6984,UCBPlayer,48,328,376,2,42,UCBPlayer
6985,UCBPlayer,314,184,498,43,15,Player A
6986,UCBPlayer,79,289,368,6,46,UCBPlayer
6987,UCBPlayer,51,311,362,0,46,UCBPlayer
6988,UCBPlayer,55,295,350,0,50,UCBPlayer
6989,UCBPlayer,61,296,357,1,48,UCBPlayer
6990,UCBPlayer,62,302,364,2,46,UCBPlayer
6991,UCBPlayer,77,267,344,3,53,UCBPlayer
6992,UCBPlayer,63,263,326,0,58,UCBPlayer
6993,UCBPlayer,60,300,360,1,47,UCBPlayer
6994,UCBPlayer,53,303,356,0,48,UCBPlayer
6995,UCBPlayer,62,267,329,0,57,UCBPlayer
6996,UCBPlayer,49,319,368,0,44,UCBPlayer
6997,UCBPlayer,55,295,350,0,50,UCBPlayer
6998,UCBPlayer,54,299,353,0,49,UCBPlayer
6999,UCBPlayer,51,321,372,1,43,UCBPlayer
7000,UCBPlayer,57,312,369,1,44,UCBPlayer
7001,UCBPlayer,85,275,360,7,49,UCBPlayer
7002,UCBPlayer,61,286,347,0,51,UCBPlayer
7003,UCBPlayer,91,251,342,4,54,UCBPlayer
7004,UCBPlayer,64,314,378,4,42,UCBPlayer
7005,UCBPlayer,45,335,380,0,40,UCBPlayer
7006,UCBPlayer,78,263,341,3,54,UCBPlayer
7007,UCBPlayer,63,298,361,2,47,UCBPlayer
7008,UCBPlayer,51,321,372,1,43,UCBPlayer
7009,UCBPlayer,59,294,353,0,49,UCBPlayer
7010,UCBPlayer,47,327,374,0,42,UCBPlayer
7011,UCBPlayer,56,291,347,0,51,UCBPlayer
7012,UCBPlayer,66,276,342,1,53,UCBPlayer
7013,UCBPlayer,59,304,363,1,46,UCBPlayer
7014,UCBPlayer,58,283,341,0,53,UCBPlayer
7015,UCBPlayer,55,295,350,0,50,UCBPlayer
7016,UCBPlayer,57,287,344,0,52,UCBPlayer
7017,UCBPlayer,53,303,356,0,48,UCBPlayer
7018,UCBPlayer,53,303,356,0,48,UCBPlayer
7019,UCBPlayer,53,303,356,0,48,UCBPlayer
7020,UCBPlayer,53,303,356,0,48,UCBPlayer
7021,UCBPlayer,72,312,384,4,40,UCBPlayer
7022,UCBPlayer,52,307,359,0,47,UCBPlayer
7023,UCBPlayer,69,294,363,4,47,UCBPlayer
7024,UCBPlayer,93,283,376,8,44,UCBPlayer
7025,UCBPlayer,54,299,353,0,49,UCBPlayer
7026,UCBPlayer,53,303,356,0,48,UCBPlayer
7027,UCBPlayer,50,325,375,1,42,UCBPlayer
7028,UCBPlayer,59,304,363,1,46,UCBPlayer
7029,UCBPlayer,86,271,357,7,50,UCBPlayer
7030,UCBPlayer,91,261,352,5,51,UCBPlayer
7031,UCBPlayer,50,315,365,0,45,UCBPlayer
7032,UCBPlayer,48,333,381,1,40,UCBPlayer
7033,UCBPlayer,56,306,362,0,46,UCBPlayer
7034,UCBPlayer,58,283,341,0,53,UCBPlayer
7035,UCBPlayer,56,301,357,1,48,UCBPlayer
7036,UCBPlayer,52,317,369,1,44,UCBPlayer
7037,UCBPlayer,60,290,350,0,50,UCBPlayer
7038,UCBPlayer,49,319,368,0,44,UCBPlayer
7039,UCBPlayer,56,326,382,2,40,UCBPlayer
7040,UCBPlayer,45,335,380,0,40,UCBPlayer
7041,UCBPlayer,55,320,375,1,42,UCBPlayer
7042,UCBPlayer,52,307,359,0,47,UCBPlayer
7043,UCBPlayer,66,276,342,1,53,UCBPlayer
7044,UCBPlayer,72,287,359,3,48,UCBPlayer
7045,UCBPlayer,85,260,345,4,53,UCBPlayer
7046,UCBPlayer,59,324,383,3,40,UCBPlayer
7047,UCBPlayer,57,287,344,0,52,UCBPlayer
7048,UCBPlayer,62,307,369,1,44,UCBPlayer
7049,UCBPlayer,63,288,351,1,50,UCBPlayer
7050,UCBPlayer,58,283,341,0,53,UCBPlayer
7051,UCBPlayer,98,263,361,8,49,UCBPlayer
7052,UCBPlayer,84,274,358,5,49,UCBPlayer
7053,UCBPlayer,71,271,342,1,53,UCBPlayer
7054,UCBPlayer,71,256,327,1,58,UCBPlayer
7055,UCBPlayer,58,328,386,3,39,UCBPlayer
7056,UCBPlayer,65,280,345,1,52,UCBPlayer
7057,UCBPlayer,59,304,363,1,46,UCBPlayer
7058,UCBPlayer,50,315,365,0,45,UCBPlayer
7059,UCBPlayer,64,294,358,2,48,UCBPlayer
7060,UCBPlayer,77,282,359,3,48,UCBPlayer
7061,UCBPlayer,51,321,372,1,43,UCBPlayer
7062,UCBPlayer,60,300,360,1,47,UCBPlayer
7063,UCBPlayer,68,288,356,3,49,UCBPlayer
7064,UCBPlayer,63,263,326,0,58,UCBPlayer
7065,UCBPlayer,74,289,363,4,47,UCBPlayer
7066,UCBPlayer,71,266,337,2,55,UCBPlayer
7067,UCBPlayer,46,331,377,0,41,UCBPlayer
7068,UCBPlayer,51,311,362,0,46,UCBPlayer
7069,UCBPlayer,136,266,402,13,37,UCBPlayer
7070,UCBPlayer,62,267,329,0,57,UCBPlayer
7071,UCBPlayer,41,351,392,0,36,UCBPlayer
7072,UCBPlayer,60,275,335,0,55,UCBPlayer
7073,UCBPlayer,43,353,396,1,35,UCBPlayer
7074,UCBPlayer,61,286,347,0,51,UCBPlayer
7075,UCBPlayer,46,331,377,0,41,UCBPlayer
7076,UCBPlayer,91,291,382,8,42,UCBPlayer
7077,UCBPlayer,51,311,362,0,46,UCBPlayer
7078,UCBPlayer,57,297,354,1,49,UCBPlayer
7079,UCBPlayer,59,294,353,0,49,UCBPlayer
7080,UCBPlayer,68,303,371,3,44,UCBPlayer
7081,UCBPlayer,64,259,323,0,59,UCBPlayer
7082,UCBPlayer,76,286,362,3,47,UCBPlayer
7083,UCBPlayer,56,301,357,1,48,UCBPlayer
7084,UCBPlayer,69,254,323,0,59,UCBPlayer
7085,UCBPlayer,50,315,365,0,45,UCBPlayer
7086,UCBPlayer,55,305,360,1,47,UCBPlayer
7087,UCBPlayer,132,242,374,12,46,UCBPlayer
7088,UCBPlayer,56,306,362,0,46,UCBPlayer
7089,UCBPlayer,91,266,357,7,50,UCBPlayer
7090,UCBPlayer,69,294,363,4,47,UCBPlayer
7091,UCBPlayer,52,307,359,0,47,UCBPlayer
7092,UCBPlayer,68,258,326,0,58,UCBPlayer
7093,UCBPlayer,154,244,398,18,40,UCBPlayer
7094,UCBPlayer,49,329,378,1,41,UCBPlayer
7095,UCBPlayer,171,261,432,25,31,UCBPlayer
7096,UCBPlayer,62,292,354,1,49,UCBPlayer
7097,UCBPlayer,80,320,400,11,37,UCBPlayer
7098,UCBPlayer,82,287,369,4,45,UCBPlayer
7099,UCBPlayer,54,299,353,0,49,UCBPlayer
7100,UCBPlayer,55,295,350,0,50,UCBPlayer
7101,UCBPlayer,59,279,338,0,54,UCBPlayer
7102,UCBPlayer,56,301,357,1,48,UCBPlayer
7103,UCBPlayer,80,290,370,5,45,UCBPlayer
7104,UCBPlayer,103,248,351,7,52,UCBPlayer
7105,UCBPlayer,108,263,371,6,45,UCBPlayer
7106,UCBPlayer,61,296,357,1,48,UCBPlayer
7107,UCBPlayer,63,308,371,3,44,UCBPlayer
7108,UCBPlayer,58,283,341,0,53,UCBPlayer
7109,UCBPlayer,101,271,372,10,46,UCBPlayer
7110,UCBPlayer,68,258,326,0,58,UCBPlayer
7111,UCBPlayer,58,283,341,0,53,UCBPlayer
7112,UCBPlayer,49,319,368,0,44,UCBPlayer
7113,UCBPlayer,72,292,364,5,47,UCBPlayer
7114,UCBPlayer,51,311,362,0,46,UCBPlayer
7115,UCBPlayer,78,233,311,0,63,UCBPlayer
7116,UCBPlayer,57,287,344,0,52,UCBPlayer
7117,UCBPlayer,53,303,356,0,48,UCBPlayer
7118,UCBPlayer,57,312,369,1,44,UCBPlayer
7119,UCBPlayer,56,291,347,0,51,UCBPlayer
7120,UCBPlayer,113,303,416,15,33,UCBPlayer
7121,UCBPlayer,66,266,332,0,56,UCBPlayer
7122,UCBPlayer,64,259,323,0,59,UCBPlayer
7123,UCBPlayer,70,285,355,2,49,UCBPlayer
7124,UCBPlayer,49,319,368,0,44,UCBPlayer
7125,UCBPlayer,50,315,365,0,45,UCBPlayer
7126,UCBPlayer,116,276,392,9,39,UCBPlayer
7127,UCBPlayer,60,275,335,0,55,UCBPlayer
7128,UCBPlayer,61,301,362,3,47,UCBPlayer
7129,UCBPlayer,70,320,390,7,39,UCBPlayer
7130,UCBPlayer,79,299,378,7,43,UCBPlayer
7131,UCBPlayer,62,297,359,3,48,UCBPlayer
7132,UCBPlayer,64,299,363,1,46,UCBPlayer
7133,UCBPlayer,98,233,331,5,58,UCBPlayer
7134,UCBPlayer,52,337,389,3,38,UCBPlayer
7135,UCBPlayer,74,269,343,2,53,UCBPlayer
7136,UCBPlayer,54,329,383,0,39,UCBPlayer
7137,UCBPlayer,50,320,370,2,44,UCBPlayer
7138,UCBPlayer,125,245,370,11,47,UCBPlayer
7139,UCBPlayer,61,296,357,1,48,UCBPlayer
7140,UCBPlayer,79,249,328,2,58,UCBPlayer
7141,UCBPlayer,61,306,367,2,45,UCBPlayer
7142,UCBPlayer,58,283,341,0,53,UCBPlayer
7143,UCBPlayer,59,279,338,0,54,UCBPlayer
7144,UCBPlayer,58,283,341,0,53,UCBPlayer
7145,UCBPlayer,65,270,335,0,55,UCBPlayer
7146,UCBPlayer,141,296,437,21,28,UCBPlayer
7147,UCBPlayer,60,275,335,0,55,UCBPlayer
7148,UCBPlayer,49,319,368,0,44,UCBPlayer
7149,UCBPlayer,59,279,338,0,54,UCBPlayer
7150,UCBPlayer,73,293,366,4,46,UCBPlayer
7151,UCBPlayer,57,312,369,1,44,UCBPlayer
7152,UCBPlayer,59,279,338,0,54,UCBPlayer
7153,UCBPlayer,60,275,335,0,55,UCBPlayer
7154,UCBPlayer,58,283,341,0,53,UCBPlayer
7155,UCBPlayer,61,271,332,0,56,UCBPlayer
7156,UCBPlayer,67,282,349,2,51,UCBPlayer
7157,UCBPlayer,51,311,362,0,46,UCBPlayer
7158,UCBPlayer,48,323,371,0,43,UCBPlayer
7159,UCBPlayer,46,341,387,1,38,UCBPlayer
7160,UCBPlayer,66,306,372,4,44,UCBPlayer
7161,UCBPlayer,90,250,340,5,55,UCBPlayer
7162,UCBPlayer,135,265,400,17,39,UCBPlayer
7163,UCBPlayer,71,286,357,4,49,UCBPlayer
7164,UCBPlayer,107,262,369,13,48,UCBPlayer
7165,UCBPlayer,95,305,400,11,37,UCBPlayer
7166,UCBPlayer,51,311,362,0,46,UCBPlayer
7167,UCBPlayer,70,290,360,4,48,UCBPlayer
7168,UCBPlayer,54,299,353,0,49,UCBPlayer
7169,UCBPlayer,81,266,347,3,52,UCBPlayer
7170,UCBPlayer,47,327,374,0,42,UCBPlayer
7171,UCBPlayer,52,307,359,0,47,UCBPlayer
7172,UCBPlayer,48,323,371,0,43,UCBPlayer
7173,UCBPlayer,57,327,384,4,40,UCBPlayer
7174,UCBPlayer,101,286,387,13,42,UCBPlayer
7175,UCBPlayer,55,295,350,0,50,UCBPlayer
7176,UCBPlayer,49,319,368,0,44,UCBPlayer
7177,UCBPlayer,73,278,351,4,51,UCBPlayer
7178,UCBPlayer,72,307,379,5,42,UCBPlayer
7179,UCBPlayer,45,335,380,0,40,UCBPlayer
7180,UCBPlayer,57,287,344,0,52,UCBPlayer
7181,UCBPlayer,61,271,332,0,56,UCBPlayer
7182,UCBPlayer,69,294,363,4,47,UCBPlayer
7183,UCBPlayer,122,277,399,13,38,UCBPlayer
7184,UCBPlayer,54,314,368,0,44,UCBPlayer
7185,UCBPlayer,54,299,353,0,49,UCBPlayer
7186,UCBPlayer,44,339,383,0,39,UCBPlayer
7187,UCBPlayer,52,307,359,0,47,UCBPlayer
7188,UCBPlayer,54,299,353,0,49,UCBPlayer
7189,UCBPlayer,58,278,336,1,55,UCBPlayer
7190,UCBPlayer,73,273,346,2,52,UCBPlayer
7191,UCBPlayer,65,280,345,1,52,UCBPlayer
7192,UCBPlayer,56,291,347,0,51,UCBPlayer
7193,UCBPlayer,55,295,350,0,50,UCBPlayer
7194,UCBPlayer,78,293,371,6,45,UCBPlayer
7195,UCBPlayer,65,300,365,3,46,UCBPlayer
7196,UCBPlayer,57,287,344,0,52,UCBPlayer
7197,UCBPlayer,94,239,333,4,57,UCBPlayer
7198,UCBPlayer,98,268,366,7,47,UCBPlayer
7199,UCBPlayer,59,304,363,1,46,UCBPlayer
7200,UCBPlayer,57,287,344,0,52,UCBPlayer
7201,UCBPlayer,90,285,375,7,44,UCBPlayer
7202,UCBPlayer,49,319,368,0,44,UCBPlayer
7203,UCBPlayer,54,324,378,1,41,UCBPlayer
7204,UCBPlayer,57,287,344,0,52,UCBPlayer
7205,UCBPlayer,50,315,365,0,45,UCBPlayer
7206,UCBPlayer,58,293,351,1,50,UCBPlayer
7207,UCBPlayer,82,252,334,2,56,UCBPlayer
7208,UCBPlayer,64,284,348,1,51,UCBPlayer
7209,UCBPlayer,54,299,353,0,49,UCBPlayer
7210,UCBPlayer,58,298,356,0,48,UCBPlayer
7211,UCBPlayer,77,257,334,2,56,UCBPlayer
7212,UCBPlayer,45,335,380,0,40,UCBPlayer
7213,UCBPlayer,90,260,350,6,52,UCBPlayer
7214,UCBPlayer,64,299,363,1,46,UCBPlayer
7215,UCBPlayer,93,293,386,6,40,UCBPlayer
7216,UCBPlayer,94,254,348,4,52,UCBPlayer
7217,UCBPlayer,68,288,356,3,49,UCBPlayer
7218,UCBPlayer,68,258,326,0,58,UCBPlayer
7219,UCBPlayer,60,300,360,1,47,UCBPlayer
7220,UCBPlayer,56,291,347,0,51,UCBPlayer
7221,UCBPlayer,76,271,347,3,52,UCBPlayer
7222,UCBPlayer,92,257,349,5,52,UCBPlayer
7223,UCBPlayer,63,288,351,1,50,UCBPlayer
7224,UCBPlayer,87,317,404,9,35,UCBPlayer
7225,UCBPlayer,42,347,389,0,37,UCBPlayer
7226,UCBPlayer,58,303,361,2,47,UCBPlayer
7227,UCBPlayer,62,317,379,2,41,UCBPlayer
7228,UCBPlayer,58,303,361,2,47,UCBPlayer
7229,UCBPlayer,77,287,364,5,47,UCBPlayer
7230,UCBPlayer,51,311,362,0,46,UCBPlayer
7231,UCBPlayer,46,331,377,0,41,UCBPlayer
7232,UCBPlayer,57,287,344,0,52,UCBPlayer
7233,UCBPlayer,60,295,355,2,49,UCBPlayer
7234,UCBPlayer,73,273,346,2,52,UCBPlayer
7235,UCBPlayer,86,281,367,5,46,UCBPlayer
7236,UCBPlayer,69,294,363,1,46,UCBPlayer
7237,UCBPlayer,56,311,367,2,45,UCBPlayer
7238,UCBPlayer,63,308,371,3,44,UCBPlayer
7239,UCBPlayer,87,282,369,7,46,UCBPlayer
7240,UCBPlayer,88,248,336,4,56,UCBPlayer
7241,UCBPlayer,60,310,370,2,44,UCBPlayer
7242,UCBPlayer,58,308,366,1,45,UCBPlayer
7243,UCBPlayer,61,271,332,0,56,UCBPlayer
7244,UCBPlayer,59,314,373,2,43,UCBPlayer
7245,UCBPlayer,57,287,344,0,52,UCBPlayer
7246,UCBPlayer,55,295,350,0,50,UCBPlayer
7247,UCBPlayer,59,304,363,1,46,UCBPlayer
7248,UCBPlayer,71,306,377,6,43,UCBPlayer
7249,UCBPlayer,66,291,357,1,48,UCBPlayer
7250,UCBPlayer,59,324,383,3,40,UCBPlayer
7251,UCBPlayer,58,283,341,0,53,UCBPlayer
7252,UCBPlayer,73,283,356,3,49,UCBPlayer
7253,UCBPlayer,55,295,350,0,50,UCBPlayer
7254,UCBPlayer,97,277,374,6,44,UCBPlayer
7255,UCBPlayer,58,343,401,3,34,UCBPlayer
7256,UCBPlayer,50,315,365,0,45,UCBPlayer
7257,UCBPlayer,55,320,375,1,42,UCBPlayer
7258,UCBPlayer,90,290,380,6,42,UCBPlayer
7259,UCBPlayer,70,315,385,5,40,UCBPlayer
7260,UCBPlayer,52,307,359,0,47,UCBPlayer
7261,UCBPlayer,76,296,372,7,45,UCBPlayer
7262,UCBPlayer,64,274,338,0,54,UCBPlayer
7263,UCBPlayer,53,303,356,0,48,UCBPlayer
7264,UCBPlayer,53,303,356,0,48,UCBPlayer
7265,UCBPlayer,57,297,354,1,49,UCBPlayer
7266,UCBPlayer,64,284,348,1,51,UCBPlayer
7267,UCBPlayer,57,287,344,0,52,UCBPlayer
7268,UCBPlayer,137,247,384,16,44,UCBPlayer
7269,UCBPlayer,165,255,420,25,35,UCBPlayer
7270,UCBPlayer,148,243,391,11,40,UCBPlayer
7271,UCBPlayer,53,323,376,2,42,UCBPlayer
7272,UCBPlayer,60,330,390,4,38,UCBPlayer
7273,UCBPlayer,48,323,371,0,43,UCBPlayer
7274,UCBPlayer,100,245,345,4,53,UCBPlayer
7275,UCBPlayer,57,287,344,0,52,UCBPlayer
7276,UCBPlayer,59,279,338,0,54,UCBPlayer
7277,UCBPlayer,56,291,347,0,51,UCBPlayer
7278,UCBPlayer,56,291,347,0,51,UCBPlayer
7279,UCBPlayer,47,327,374,0,42,UCBPlayer
7280,UCBPlayer,66,311,377,3,42,UCBPlayer
7281,UCBPlayer,49,319,368,0,44,UCBPlayer
7282,UCBPlayer,53,303,356,0,48,UCBPlayer
7283,UCBPlayer,50,315,365,0,45,UCBPlayer
7284,UCBPlayer,57,307,364,2,46,UCBPlayer
7285,UCBPlayer,70,275,345,1,52,UCBPlayer
7286,UCBPlayer,88,263,351,4,51,UCBPlayer
7287,UCBPlayer,67,262,329,0,57,UCBPlayer
7288,UCBPlayer,58,293,351,1,50,UCBPlayer
7289,UCBPlayer,58,303,361,2,47,UCBPlayer
7290,UCBPlayer,85,280,365,6,47,UCBPlayer
7291,UCBPlayer,67,282,349,2,51,UCBPlayer
7292,UCBPlayer,94,284,378,7,43,UCBPlayer
7293,UCBPlayer,69,254,323,0,59,UCBPlayer
7294,UCBPlayer,51,311,362,0,46,UCBPlayer
7295,UCBPlayer,53,303,356,0,48,UCBPlayer
7296,UCBPlayer,63,298,361,2,47,UCBPlayer
7297,UCBPlayer,68,278,346,2,52,UCBPlayer
7298,UCBPlayer,45,335,380,0,40,UCBPlayer
7299,UCBPlayer,59,279,338,0,54,UCBPlayer
7300,UCBPlayer,104,294,398,12,38,UCBPlayer
7301,UCBPlayer,67,267,334,2,56,UCBPlayer
7302,UCBPlayer,78,288,366,4,46,UCBPlayer
7303,UCBPlayer,57,287,344,0,52,UCBPlayer
7304,UCBPlayer,81,301,382,8,42,UCBPlayer
7305,UCBPlayer,40,355,395,0,35,UCBPlayer
7306,UCBPlayer,45,335,380,0,40,UCBPlayer
7307,UCBPlayer,219,224,443,27,28,UCBPlayer
7308,UCBPlayer,63,298,361,2,47,UCBPlayer
7309,UCBPlayer,62,292,354,1,49,UCBPlayer
7310,UCBPlayer,67,302,369,4,45,UCBPlayer
7311,UCBPlayer,48,323,371,0,43,UCBPlayer
7312,UCBPlayer,56,291,347,0,51,UCBPlayer
7313,UCBPlayer,68,278,346,2,52,UCBPlayer
7314,UCBPlayer,72,282,354,4,50,UCBPlayer
7315,UCBPlayer,66,266,332,0,56,UCBPlayer
7316,UCBPlayer,69,309,378,4,42,UCBPlayer
7317,UCBPlayer,51,311,362,0,46,UCBPlayer
7318,UCBPlayer,52,307,359,0,47,UCBPlayer
7319,UCBPlayer,68,298,366,4,46,UCBPlayer
7320,UCBPlayer,63,278,341,0,53,UCBPlayer
7321,UCBPlayer,75,280,355,5,50,UCBPlayer
7322,UCBPlayer,56,326,382,2,40,UCBPlayer
7323,UCBPlayer,57,287,344,0,52,UCBPlayer
7324,UCBPlayer,102,272,374,9,45,UCBPlayer
7325,UCBPlayer,110,280,390,13,41,UCBPlayer
7326,UCBPlayer,52,307,359,0,47,UCBPlayer
7327,UCBPlayer,52,307,359,0,47,UCBPlayer
7328,UCBPlayer,52,307,359,0,47,UCBPlayer
7329,UCBPlayer,57,312,369,1,44,UCBPlayer
7330,UCBPlayer,50,325,375,1,42,UCBPlayer
7331,UCBPlayer,56,331,387,4,39,UCBPlayer
7332,UCBPlayer,66,316,382,5,41,UCBPlayer
7333,UCBPlayer,54,299,353,0,49,UCBPlayer
7334,UCBPlayer,84,289,373,5,44,UCBPlayer
7335,UCBPlayer,56,301,357,1,48,UCBPlayer
7336,UCBPlayer,72,287,359,3,48,UCBPlayer
7337,UCBPlayer,53,323,376,2,42,UCBPlayer
7338,UCBPlayer,51,326,377,0,41,UCBPlayer
7339,UCBPlayer,62,282,344,0,52,UCBPlayer
7340,UCBPlayer,55,310,365,3,46,UCBPlayer
7341,UCBPlayer,81,276,357,4,49,UCBPlayer
7342,UCBPlayer,64,274,338,0,54,UCBPlayer
7343,UCBPlayer,126,271,397,11,38,UCBPlayer
7344,UCBPlayer,60,310,370,2,44,UCBPlayer
7345,UCBPlayer,43,343,386,0,38,UCBPlayer
7346,UCBPlayer,55,295,350,0,50,UCBPlayer
7347,UCBPlayer,59,279,338,0,54,UCBPlayer
7348,UCBPlayer,46,331,377,0,41,UCBPlayer
7349,UCBPlayer,96,246,342,7,55,UCBPlayer
7350,UCBPlayer,58,308,366,1,45,UCBPlayer
7351,UCBPlayer,60,275,335,0,55,UCBPlayer
7352,UCBPlayer,69,289,358,2,48,UCBPlayer
7353,UCBPlayer,56,291,347,0,51,UCBPlayer
7354,UCBPlayer,64,294,358,2,48,UCBPlayer
7355,UCBPlayer,61,296,357,1,48,UCBPlayer
7356,UCBPlayer,75,310,385,8,41,UCBPlayer
7357,UCBPlayer,55,330,385,2,39,UCBPlayer
7358,UCBPlayer,85,280,365,6,47,UCBPlayer
7359,UCBPlayer,49,319,368,0,44,UCBPlayer
7360,UCBPlayer,56,291,347,0,51,UCBPlayer
7361,UCBPlayer,61,316,377,3,42,UCBPlayer
7362,UCBPlayer,53,303,356,0,48,UCBPlayer
7363,UCBPlayer,59,279,338,0,54,UCBPlayer
7364,UCBPlayer,63,298,361,2,47,UCBPlayer
7365,UCBPlayer,58,283,341,0,53,UCBPlayer
7366,UCBPlayer,54,314,368,0,44,UCBPlayer
7367,UCBPlayer,51,311,362,0,46,UCBPlayer
7368,UCBPlayer,54,299,353,0,49,UCBPlayer
7369,UCBPlayer,71,256,327,1,58,UCBPlayer
7370,UCBPlayer,53,303,356,0,48,UCBPlayer
7371,UCBPlayer,50,315,365,0,45,UCBPlayer
7372,UCBPlayer,107,277,384,10,42,UCBPlayer
7373,UCBPlayer,85,245,330,4,58,UCBPlayer
7374,UCBPlayer,54,299,353,0,49,UCBPlayer
7375,UCBPlayer,66,286,352,2,50,UCBPlayer
7376,UCBPlayer,57,287,344,0,52,UCBPlayer
7377,UCBPlayer,58,283,341,0,53,UCBPlayer
7378,UCBPlayer,59,324,383,3,40,UCBPlayer
7379,UCBPlayer,56,291,347,0,51,UCBPlayer
7380,UCBPlayer,59,304,363,1,46,UCBPlayer
7381,UCBPlayer,57,287,344,0,52,UCBPlayer
7382,UCBPlayer,52,307,359,0,47,UCBPlayer
7383,UCBPlayer,56,301,357,1,48,UCBPlayer
7384,UCBPlayer,59,294,353,0,49,UCBPlayer
7385,UCBPlayer,96,266,362,6,48,UCBPlayer
7386,UCBPlayer,48,323,371,0,43,UCBPlayer
7387,UCBPlayer,58,283,341,0,53,UCBPlayer
7388,UCBPlayer,77,257,334,2,56,UCBPlayer
7389,UCBPlayer,53,303,356,0,48,UCBPlayer
7390,UCBPlayer,67,297,364,5,47,UCBPlayer
7391,UCBPlayer,109,279,388,11,41,UCBPlayer
7392,UCBPlayer,103,258,361,5,48,UCBPlayer
7393,UCBPlayer,47,322,369,1,44,UCBPlayer
7394,UCBPlayer,54,334,388,2,38,UCBPlayer
7395,UCBPlayer,60,275,335,0,55,UCBPlayer
7396,UCBPlayer,61,296,357,1,48,UCBPlayer
7397,UCBPlayer,95,265,360,7,49,UCBPlayer
7398,UCBPlayer,78,253,331,2,57,UCBPlayer
7399,UCBPlayer,62,292,354,1,49,UCBPlayer
7400,UCBPlayer,49,319,368,0,44,UCBPlayer
7401,UCBPlayer,67,292,359,3,48,UCBPlayer
7402,UCBPlayer,75,275,350,3,51,UCBPlayer
7403,UCBPlayer,67,302,369,4,45,UCBPlayer
7404,UCBPlayer,57,287,344,0,52,UCBPlayer
7405,UCBPlayer,68,293,361,2,47,UCBPlayer
7406,UCBPlayer,54,299,353,0,49,UCBPlayer
7407,UCBPlayer,56,291,347,0,51,UCBPlayer
7408,UCBPlayer,64,284,348,1,51,UCBPlayer
7409,UCBPlayer,54,299,353,0,49,UCBPlayer
7410,UCBPlayer,76,261,337,2,55,UCBPlayer
7411,UCBPlayer,87,262,349,5,52,UCBPlayer
7412,UCBPlayer,61,316,377,3,42,UCBPlayer
7413,UCBPlayer,51,311,362,0,46,UCBPlayer
7414,UCBPlayer,53,303,356,0,48,UCBPlayer
7415,UCBPlayer,56,291,347,0,51,UCBPlayer
7416,UCBPlayer,68,268,336,1,55,UCBPlayer
7417,UCBPlayer,63,298,361,2,47,UCBPlayer
7418,UCBPlayer,49,319,368,0,44,UCBPlayer
7419,UCBPlayer,95,275,370,8,46,UCBPlayer
7420,UCBPlayer,58,308,366,1,45,UCBPlayer
7421,UCBPlayer,65,290,355,2,49,UCBPlayer
7422,UCBPlayer,104,284,388,11,41,UCBPlayer
7423,UCBPlayer,80,295,375,4,43,UCBPlayer
7424,UCBPlayer,58,308,366,1,45,UCBPlayer
7425,UCBPlayer,68,278,346,2,52,UCBPlayer
7426,UCBPlayer,51,321,372,1,43,UCBPlayer
7427,UCBPlayer,75,280,355,5,50,UCBPlayer
7428,UCBPlayer,59,294,353,0,49,UCBPlayer
7429,UCBPlayer,57,297,354,1,49,UCBPlayer
7430,UCBPlayer,73,278,351,1,50,UCBPlayer
7431,UCBPlayer,55,295,350,0,50,UCBPlayer
7432,UCBPlayer,58,283,341,0,53,UCBPlayer
7433,UCBPlayer,109,254,363,10,49,UCBPlayer
7434,UCBPlayer,61,311,372,4,44,UCBPlayer
7435,UCBPlayer,80,295,375,4,43,UCBPlayer
7436,UCBPlayer,70,285,355,2,49,UCBPlayer
7437,UCBPlayer,55,295,350,0,50,UCBPlayer
7438,UCBPlayer,54,299,353,0,49,UCBPlayer
7439,UCBPlayer,52,307,359,0,47,UCBPlayer
7440,UCBPlayer,69,319,388,5,39,UCBPlayer
7441,UCBPlayer,55,310,365,0,45,UCBPlayer
7442,UCBPlayer,45,330,375,1,42,UCBPlayer
7443,UCBPlayer,87,282,369,7,46,UCBPlayer
7444,UCBPlayer,116,261,377,15,46,UCBPlayer
7445,UCBPlayer,61,296,357,1,48,UCBPlayer
7446,UCBPlayer,60,275,335,0,55,UCBPlayer
7447,UCBPlayer,57,287,344,0,52,UCBPlayer
7448,UCBPlayer,61,271,332,0,56,UCBPlayer
7449,UCBPlayer,163,253,416,21,35,UCBPlayer
7450,UCBPlayer,54,299,353,0,49,UCBPlayer
7451,UCBPlayer,51,311,362,0,46,UCBPlayer
7452,UCBPlayer,53,303,356,0,48,UCBPlayer
7453,UCBPlayer,57,287,344,0,52,UCBPlayer
7454,UCBPlayer,56,291,347,0,51,UCBPlayer
7455,UCBPlayer,64,259,323,0,59,UCBPlayer
7456,UCBPlayer,69,309,378,4,42,UCBPlayer
7457,UCBPlayer,59,294,353,0,49,UCBPlayer
7458,UCBPlayer,54,299,353,0,49,UCBPlayer
7459,UCBPlayer,65,310,375,4,43,UCBPlayer
7460,UCBPlayer,96,251,347,6,53,UCBPlayer
7461,UCBPlayer,58,313,371,3,44,UCBPlayer
7462,UCBPlayer,111,246,357,7,50,UCBPlayer
7463,UCBPlayer,146,201,347,9,54,UCBPlayer
7464,UCBPlayer,88,273,361,8,49,UCBPlayer
7465,UCBPlayer,64,314,378,4,42,UCBPlayer
7466,UCBPlayer,68,308,376,5,43,UCBPlayer
7467,UCBPlayer,75,275,350,3,51,UCBPlayer
7468,UCBPlayer,63,298,361,2,47,UCBPlayer
7469,UCBPlayer,50,315,365,0,45,UCBPlayer
7470,UCBPlayer,59,304,363,1,46,UCBPlayer
7471,UCBPlayer,53,303,356,0,48,UCBPlayer
7472,UCBPlayer,51,321,372,1,43,UCBPlayer
7473,UCBPlayer,82,242,324,1,59,UCBPlayer
7474,UCBPlayer,44,339,383,0,39,UCBPlayer
7475,UCBPlayer,48,323,371,0,43,UCBPlayer
7476,UCBPlayer,87,302,389,9,40,UCBPlayer
7477,UCBPlayer,81,266,347,3,52,UCBPlayer
7478,UCBPlayer,53,303,356,0,48,UCBPlayer
7479,UCBPlayer,81,296,377,6,43,UCBPlayer
7480,UCBPlayer,140,265,405,16,37,UCBPlayer
7481,UCBPlayer,215,220,435,25,30,UCBPlayer
7482,UCBPlayer,55,295,350,0,50,UCBPlayer
7483,UCBPlayer,82,282,364,5,47,UCBPlayer
7484,UCBPlayer,64,304,368,3,45,UCBPlayer
7485,UCBPlayer,92,297,389,9,40,UCBPlayer
7486,UCBPlayer,48,323,371,0,43,UCBPlayer
7487,UCBPlayer,58,283,341,0,53,UCBPlayer
7488,UCBPlayer,70,260,330,1,57,UCBPlayer
7489,UCBPlayer,52,307,359,0,47,UCBPlayer
7490,UCBPlayer,58,283,341,0,53,UCBPlayer
7491,UCBPlayer,77,282,359,3,48,UCBPlayer
7492,UCBPlayer,65,280,345,1,52,UCBPlayer
7493,UCBPlayer,88,283,371,6,45,UCBPlayer
7494,UCBPlayer,50,310,360,1,47,UCBPlayer
7495,UCBPlayer,50,345,395,3,36,UCBPlayer
7496,UCBPlayer,81,281,362,3,47,UCBPlayer
7497,UCBPlayer,74,269,343,2,53,UCBPlayer
7498,UCBPlayer,67,272,339,1,54,UCBPlayer
7499,UCBPlayer,74,284,358,5,49,UCBPlayer
7500,UCBPlayer,70,265,335,0,55,UCBPlayer
7501,UCBPlayer,58,283,341,0,53,UCBPlayer
7502,UCBPlayer,54,299,353,0,49,UCBPlayer
7503,UCBPlayer,68,283,351,1,50,UCBPlayer
7504,UCBPlayer,56,331,387,4,39,UCBPlayer
7505,UCBPlayer,67,317,384,4,40,UCBPlayer
7506,UCBPlayer,68,278,346,2,52,UCBPlayer
7507,UCBPlayer,54,299,353,0,49,UCBPlayer
7508,UCBPlayer,48,323,371,0,43,UCBPlayer
7509,UCBPlayer,90,250,340,5,55,UCBPlayer
7510,UCBPlayer,73,263,336,1,55,UCBPlayer
7511,UCBPlayer,57,287,344,0,52,UCBPlayer
7512,UCBPlayer,74,304,378,7,43,UCBPlayer
7513,UCBPlayer,100,280,380,6,42,UCBPlayer
7514,UCBPlayer,54,299,353,0,49,UCBPlayer
7515,UCBPlayer,65,300,365,3,46,UCBPlayer
7516,UCBPlayer,58,283,341,0,53,UCBPlayer
7517,UCBPlayer,58,308,366,1,45,UCBPlayer
7518,UCBPlayer,104,254,358,8,50,UCBPlayer
7519,UCBPlayer,73,263,336,1,55,UCBPlayer
7520,UCBPlayer,63,263,326,0,58,UCBPlayer
7521,UCBPlayer,61,296,357,1,48,UCBPlayer
7522,UCBPlayer,61,296,357,1,48,UCBPlayer
7523,UCBPlayer,60,275,335,0,55,UCBPlayer
7524,UCBPlayer,122,272,394,14,40,UCBPlayer
7525,UCBPlayer,52,307,359,0,47,UCBPlayer
7526,UCBPlayer,66,276,342,1,53,UCBPlayer
7527,UCBPlayer,57,287,344,0,52,UCBPlayer
7528,UCBPlayer,84,249,333,4,57,UCBPlayer
7529,UCBPlayer,55,320,375,1,42,UCBPlayer
7530,UCBPlayer,59,279,338,0,54,UCBPlayer
7531,UCBPlayer,73,288,361,5,48,UCBPlayer
7532,UCBPlayer,57,302,359,0,47,UCBPlayer
7533,UCBPlayer,50,315,365,0,45,UCBPlayer
7534,UCBPlayer,53,303,356,0,48,UCBPlayer
7535,UCBPlayer,55,305,360,1,47,UCBPlayer
7536,UCBPlayer,65,270,335,0,55,UCBPlayer
7537,UCBPlayer,65,280,345,1,52,UCBPlayer
7538,UCBPlayer,104,279,383,9,42,UCBPlayer
7539,UCBPlayer,86,281,367,5,46,UCBPlayer
7540,UCBPlayer,65,280,345,1,52,UCBPlayer
7541,UCBPlayer,57,287,344,0,52,UCBPlayer
7542,UCBPlayer,49,319,368,0,44,UCBPlayer
7543,UCBPlayer,67,277,344,3,53,UCBPlayer
7544,UCBPlayer,98,278,376,8,44,UCBPlayer
7545,UCBPlayer,68,293,361,5,48,UCBPlayer
7546,UCBPlayer,91,281,372,7,45,UCBPlayer
7547,UCBPlayer,86,291,377,9,44,UCBPlayer
7548,UCBPlayer,58,283,341,0,53,UCBPlayer
7549,UCBPlayer,57,287,344,0,52,UCBPlayer
7550,UCBPlayer,55,295,350,0,50,UCBPlayer
7551,UCBPlayer,42,347,389,0,37,UCBPlayer
7552,UCBPlayer,60,300,360,1,47,UCBPlayer
7553,UCBPlayer,55,295,350,0,50,UCBPlayer
7554,UCBPlayer,58,283,341,0,53,UCBPlayer
7555,UCBPlayer,62,292,354,1,49,UCBPlayer
7556,UCBPlayer,67,272,339,1,54,UCBPlayer
7557,UCBPlayer,70,325,395,9,38,UCBPlayer
7558,UCBPlayer,61,296,357,1,48,UCBPlayer
7559,UCBPlayer,55,295,350,0,50,UCBPlayer
7560,UCBPlayer,57,287,344,0,52,UCBPlayer
7561,UCBPlayer,56,316,372,1,43,UCBPlayer
7562,UCBPlayer,58,293,351,1,50,UCBPlayer
7563,UCBPlayer,55,330,385,2,39,UCBPlayer
7564,UCBPlayer,61,286,347,0,51,UCBPlayer
7565,UCBPlayer,75,285,360,4,48,UCBPlayer
7566,UCBPlayer,66,326,392,6,38,UCBPlayer
7567,UCBPlayer,58,308,366,1,45,UCBPlayer
7568,UCBPlayer,55,295,350,0,50,UCBPlayer
7569,UCBPlayer,52,307,359,0,47,UCBPlayer
7570,UCBPlayer,50,315,365,0,45,UCBPlayer
7571,UCBPlayer,54,329,383,3,40,UCBPlayer
7572,UCBPlayer,79,249,328,2,58,UCBPlayer
7573,UCBPlayer,104,269,373,11,46,UCBPlayer
7574,UCBPlayer,58,283,341,0,53,UCBPlayer
7575,UCBPlayer,44,339,383,0,39,UCBPlayer
7576,UCBPlayer,60,300,360,1,47,UCBPlayer
7577,UCBPlayer,54,329,383,3,40,UCBPlayer
7578,UCBPlayer,55,310,365,0,45,UCBPlayer
7579,UCBPlayer,49,319,368,0,44,UCBPlayer
7580,UCBPlayer,56,316,372,1,43,UCBPlayer
7581,UCBPlayer,50,315,365,0,45,UCBPlayer
7582,UCBPlayer,86,251,337,5,56,UCBPlayer
7583,UCBPlayer,55,305,360,1,47,UCBPlayer
7584,UCBPlayer,48,323,371,0,43,UCBPlayer
7585,UCBPlayer,62,267,329,0,57,UCBPlayer
7586,UCBPlayer,48,323,371,0,43,UCBPlayer
7587,UCBPlayer,82,257,339,4,55,UCBPlayer
7588,UCBPlayer,55,320,375,1,42,UCBPlayer
7589,UCBPlayer,61,286,347,0,51,UCBPlayer
7590,UCBPlayer,44,339,383,0,39,UCBPlayer
7591,UCBPlayer,84,279,363,4,47,UCBPlayer
7592,UCBPlayer,49,319,368,0,44,UCBPlayer
7593,UCBPlayer,108,253,361,11,50,UCBPlayer
7594,UCBPlayer,72,297,369,1,44,UCBPlayer
7595,UCBPlayer,74,259,333,4,57,UCBPlayer
7596,UCBPlayer,66,331,397,2,35,UCBPlayer
7597,UCBPlayer,40,355,395,0,35,UCBPlayer
7598,UCBPlayer,51,296,347,0,51,UCBPlayer
7599,UCBPlayer,59,279,338,0,54,UCBPlayer
7600,UCBPlayer,64,304,368,3,45,UCBPlayer
7601,UCBPlayer,59,314,373,2,43,UCBPlayer
7602,UCBPlayer,46,331,377,0,41,UCBPlayer
7603,UCBPlayer,45,335,380,0,40,UCBPlayer
7604,UCBPlayer,70,280,350,3,51,UCBPlayer
7605,UCBPlayer,62,302,364,2,46,UCBPlayer
7606,UCBPlayer,78,308,386,6,40,UCBPlayer
7607,UCBPlayer,50,315,365,0,45,UCBPlayer
7608,UCBPlayer,56,291,347,0,51,UCBPlayer
7609,UCBPlayer,62,292,354,1,49,UCBPlayer
7610,UCBPlayer,72,242,314,0,62,UCBPlayer
7611,UCBPlayer,60,275,335,0,55,UCBPlayer
7612,UCBPlayer,64,274,338,0,54,UCBPlayer
7613,UCBPlayer,53,303,356,0,48,UCBPlayer
7614,UCBPlayer,73,268,341,3,54,UCBPlayer
7615,UCBPlayer,88,268,356,6,50,UCBPlayer
7616,UCBPlayer,49,319,368,0,44,UCBPlayer
7617,UCBPlayer,63,288,351,1,50,UCBPlayer
7618,UCBPlayer,57,287,344,0,52,UCBPlayer
7619,UCBPlayer,60,290,350,0,50,UCBPlayer
7620,UCBPlayer,65,280,345,1,52,UCBPlayer
7621,UCBPlayer,67,292,359,3,48,UCBPlayer
7622,UCBPlayer,64,274,338,0,54,UCBPlayer
7623,UCBPlayer,64,284,348,1,51,UCBPlayer
7624,UCBPlayer,50,315,365,0,45,UCBPlayer
7625,UCBPlayer,67,297,364,2,46,UCBPlayer
7626,UCBPlayer,61,271,332,0,56,UCBPlayer
7627,UCBPlayer,53,303,356,0,48,UCBPlayer
7628,UCBPlayer,69,284,353,3,50,UCBPlayer
7629,UCBPlayer,67,282,349,2,51,UCBPlayer
7630,UCBPlayer,57,287,344,0,52,UCBPlayer
7631,UCBPlayer,95,280,375,7,44,UCBPlayer
7632,UCBPlayer,58,283,341,0,53,UCBPlayer
7633,UCBPlayer,62,292,354,1,49,UCBPlayer
7634,UCBPlayer,131,281,412,20,36,UCBPlayer
7635,UCBPlayer,100,290,390,10,40,UCBPlayer
7636,UCBPlayer,64,304,368,3,45,UCBPlayer
7637,UCBPlayer,59,294,353,0,49,UCBPlayer
7638,UCBPlayer,58,283,341,0,53,UCBPlayer
7639,UCBPlayer,57,307,364,2,46,UCBPlayer
7640,UCBPlayer,67,282,349,2,51,UCBPlayer
7641,UCBPlayer,101,281,382,11,43,UCBPlayer
7642,UCBPlayer,73,303,376,2,42,UCBPlayer
7643,UCBPlayer,52,307,359,0,47,UCBPlayer
7644,UCBPlayer,46,331,377,0,41,UCBPlayer
7645,UCBPlayer,54,299,353,0,49,UCBPlayer
7646,UCBPlayer,61,301,362,3,47,UCBPlayer
7647,UCBPlayer,66,291,357,1,48,UCBPlayer
7648,UCBPlayer,68,288,356,3,49,UCBPlayer
7649,UCBPlayer,65,290,355,2,49,UCBPlayer
7650,UCBPlayer,50,315,365,0,45,UCBPlayer
7651,UCBPlayer,66,266,332,0,56,UCBPlayer
7652,UCBPlayer,61,271,332,0,56,UCBPlayer
7653,UCBPlayer,74,249,323,0,59,UCBPlayer
7654,UCBPlayer,82,287,369,7,46,UCBPlayer
7655,UCBPlayer,50,315,365,0,45,UCBPlayer
7656,UCBPlayer,54,299,353,0,49,UCBPlayer
7657,UCBPlayer,74,279,353,3,50,UCBPlayer
7658,UCBPlayer,58,283,341,0,53,UCBPlayer
7659,UCBPlayer,71,276,347,3,52,UCBPlayer
7660,UCBPlayer,68,293,361,2,47,UCBPlayer
7661,UCBPlayer,69,314,383,6,41,UCBPlayer
7662,UCBPlayer,77,307,384,7,41,UCBPlayer
7663,UCBPlayer,74,284,358,5,49,UCBPlayer
7664,UCBPlayer,59,324,383,3,40,UCBPlayer
7665,UCBPlayer,53,303,356,0,48,UCBPlayer
7666,UCBPlayer,56,316,372,1,43,UCBPlayer
7667,UCBPlayer,55,295,350,0,50,UCBPlayer
7668,UCBPlayer,54,299,353,0,49,UCBPlayer
7669,UCBPlayer,48,323,371,0,43,UCBPlayer
7670,UCBPlayer,89,249,338,3,55,UCBPlayer
7671,UCBPlayer,119,259,378,13,45,UCBPlayer
7672,UCBPlayer,68,258,326,0,58,UCBPlayer
7673,UCBPlayer,75,290,365,6,47,UCBPlayer
7674,UCBPlayer,64,274,338,0,54,UCBPlayer
7675,UCBPlayer,83,248,331,2,57,UCBPlayer
7676,UCBPlayer,49,319,368,0,44,UCBPlayer
7677,UCBPlayer,55,315,370,2,44,UCBPlayer
7678,UCBPlayer,61,316,377,3,42,UCBPlayer
7679,UCBPlayer,53,338,391,2,37,UCBPlayer
7680,UCBPlayer,67,282,349,2,51,UCBPlayer
7681,UCBPlayer,54,299,353,0,49,UCBPlayer
7682,UCBPlayer,60,275,335,0,55,UCBPlayer
7683,UCBPlayer,57,287,344,0,52,UCBPlayer
7684,UCBPlayer,54,309,363,1,46,UCBPlayer
7685,UCBPlayer,83,278,361,2,47,UCBPlayer
7686,UCBPlayer,54,299,353,0,49,UCBPlayer
7687,UCBPlayer,48,323,371,0,43,UCBPlayer
7688,UCBPlayer,47,327,374,0,42,UCBPlayer
7689,UCBPlayer,54,299,353,0,49,UCBPlayer
7690,UCBPlayer,72,287,359,6,49,UCBPlayer
7691,UCBPlayer,64,289,353,0,49,UCBPlayer
7692,UCBPlayer,60,275,335,0,55,UCBPlayer
7693,UCBPlayer,57,342,399,7,36,UCBPlayer
7694,UCBPlayer,70,290,360,1,47,UCBPlayer
7695,UCBPlayer,67,262,329,0,57,UCBPlayer
7696,UCBPlayer,51,311,362,0,46,UCBPlayer
7697,UCBPlayer,58,283,341,0,53,UCBPlayer
7698,UCBPlayer,49,319,368,0,44,UCBPlayer
7699,UCBPlayer,57,287,344,0,52,UCBPlayer
7700,UCBPlayer,83,263,346,5,53,UCBPlayer
7701,UCBPlayer,128,233,361,8,49,UCBPlayer
7702,UCBPlayer,61,296,357,1,48,UCBPlayer
7703,UCBPlayer,57,287,344,0,52,UCBPlayer
7704,UCBPlayer,51,311,362,0,46,UCBPlayer
7705,UCBPlayer,54,299,353,0,49,UCBPlayer
7706,UCBPlayer,45,335,380,0,40,UCBPlayer
7707,UCBPlayer,67,282,349,2,51,UCBPlayer
7708,UCBPlayer,59,279,338,0,54,UCBPlayer
7709,UCBPlayer,111,266,377,9,44,UCBPlayer
7710,UCBPlayer,37,367,404,0,32,UCBPlayer
7711,UCBPlayer,49,319,368,0,44,UCBPlayer
7712,UCBPlayer,67,272,339,1,54,UCBPlayer
7713,UCBPlayer,58,283,341,0,53,UCBPlayer
7714,UCBPlayer,76,271,347,3,52,UCBPlayer
7715,UCBPlayer,48,323,371,0,43,UCBPlayer
7716,UCBPlayer,64,284,348,1,51,UCBPlayer
7717,UCBPlayer,55,295,350,0,50,UCBPlayer
7718,UCBPlayer,51,331,382,2,40,UCBPlayer
7719,UCBPlayer,77,312,389,6,39,UCBPlayer
7720,UCBPlayer,55,295,350,0,50,UCBPlayer
7721,UCBPlayer,84,274,358,5,49,UCBPlayer
7722,UCBPlayer,63,288,351,1,50,UCBPlayer
7723,UCBPlayer,52,317,369,1,44,UCBPlayer
7724,UCBPlayer,64,309,373,2,43,UCBPlayer
7725,UCBPlayer,165,250,415,17,34,UCBPlayer
7726,UCBPlayer,44,339,383,0,39,UCBPlayer
7727,UCBPlayer,54,299,353,0,49,UCBPlayer
7728,UCBPlayer,55,295,350,0,50,UCBPlayer
7729,UCBPlayer,86,281,367,5,46,UCBPlayer
7730,UCBPlayer,51,311,362,0,46,UCBPlayer
7731,UCBPlayer,54,299,353,0,49,UCBPlayer
7732,UCBPlayer,92,222,314,3,63,UCBPlayer
7733,UCBPlayer,54,299,353,0,49,UCBPlayer
7734,UCBPlayer,52,307,359,0,47,UCBPlayer
7735,UCBPlayer,63,263,326,0,58,UCBPlayer
7736,UCBPlayer,59,279,338,0,54,UCBPlayer
7737,UCBPlayer,56,291,347,0,51,UCBPlayer
7738,UCBPlayer,69,294,363,4,47,UCBPlayer
7739,UCBPlayer,56,291,347,0,51,UCBPlayer
7740,UCBPlayer,59,294,353,0,49,UCBPlayer
7741,UCBPlayer,57,287,344,0,52,UCBPlayer
7742,UCBPlayer,56,291,347,0,51,UCBPlayer
7743,UCBPlayer,49,329,378,1,41,UCBPlayer
7744,UCBPlayer,60,310,370,2,44,UCBPlayer
7745,UCBPlayer,57,307,364,2,46,UCBPlayer
7746,UCBPlayer,71,306,377,6,43,UCBPlayer
7747,UCBPlayer,70,295,365,3,46,UCBPlayer
7748,UCBPlayer,50,315,365,0,45,UCBPlayer
7749,UCBPlayer,50,315,365,0,45,UCBPlayer
7750,UCBPlayer,57,287,344,0,52,UCBPlayer
7751,UCBPlayer,56,291,347,0,51,UCBPlayer
7752,UCBPlayer,80,270,350,3,51,UCBPlayer
7753,UCBPlayer,64,324,388,5,39,UCBPlayer
7754,UCBPlayer,49,319,368,0,44,UCBPlayer
7755,UCBPlayer,58,283,341,0,53,UCBPlayer
7756,UCBPlayer,68,298,366,4,46,UCBPlayer
7757,UCBPlayer,60,300,360,1,47,UCBPlayer
7758,UCBPlayer,51,311,362,0,46,UCBPlayer
7759,UCBPlayer,60,275,335,0,55,UCBPlayer
7760,UCBPlayer,64,274,338,0,54,UCBPlayer
7761,UCBPlayer,63,263,326,0,58,UCBPlayer
7762,UCBPlayer,65,295,360,1,47,UCBPlayer
7763,UCBPlayer,76,281,357,4,49,UCBPlayer
7764,UCBPlayer,52,307,359,0,47,UCBPlayer
7765,UCBPlayer,54,324,378,1,41,UCBPlayer
7766,UCBPlayer,85,270,355,5,50,UCBPlayer
7767,UCBPlayer,79,269,348,4,52,UCBPlayer
7768,UCBPlayer,52,307,359,0,47,UCBPlayer
7769,UCBPlayer,57,287,344,0,52,UCBPlayer
7770,UCBPlayer,55,295,350,0,50,UCBPlayer
7771,UCBPlayer,55,295,350,0,50,UCBPlayer
7772,UCBPlayer,70,260,330,1,57,UCBPlayer
7773,UCBPlayer,68,293,361,2,47,UCBPlayer
7774,UCBPlayer,58,298,356,0,48,UCBPlayer
7775,UCBPlayer,59,279,338,0,54,UCBPlayer
7776,UCBPlayer,105,230,335,6,57,UCBPlayer
7777,UCBPlayer,74,294,368,6,46,UCBPlayer
7778,UCBPlayer,74,284,358,5,49,UCBPlayer
7779,UCBPlayer,57,322,379,2,41,UCBPlayer
7780,UCBPlayer,76,271,347,3,52,UCBPlayer
7781,UCBPlayer,57,327,384,1,39,UCBPlayer
7782,UCBPlayer,64,294,358,2,48,UCBPlayer
7783,UCBPlayer,43,343,386,0,38,UCBPlayer
7784,UCBPlayer,58,283,341,0,53,UCBPlayer
7785,UCBPlayer,80,300,380,6,42,UCBPlayer
7786,UCBPlayer,112,267,379,8,43,UCBPlayer
7787,UCBPlayer,52,307,359,0,47,UCBPlayer
7788,UCBPlayer,58,283,341,0,53,UCBPlayer
7789,UCBPlayer,47,327,374,0,42,UCBPlayer
7790,UCBPlayer,80,265,345,4,53,UCBPlayer
7791,UCBPlayer,72,282,354,4,50,UCBPlayer
7792,UCBPlayer,63,303,366,1,45,UCBPlayer
7793,UCBPlayer,49,319,368,0,44,UCBPlayer
7794,UCBPlayer,72,252,324,1,59,UCBPlayer
7795,UCBPlayer,55,325,380,3,41,UCBPlayer
7796,UCBPlayer,75,290,365,6,47,UCBPlayer
7797,UCBPlayer,55,325,380,0,40,UCBPlayer
7798,UCBPlayer,48,323,371,0,43,UCBPlayer
7799,UCBPlayer,53,303,356,0,48,UCBPlayer
7800,UCBPlayer,56,296,352,2,50,UCBPlayer
7801,UCBPlayer,135,250,385,14,43,UCBPlayer
7802,UCBPlayer,61,271,332,0,56,UCBPlayer
7803,UCBPlayer,59,279,338,0,54,UCBPlayer
7804,UCBPlayer,90,295,385,8,41,UCBPlayer
7805,UCBPlayer,63,288,351,1,50,UCBPlayer
7806,UCBPlayer,80,265,345,4,53,UCBPlayer
7807,UCBPlayer,56,291,347,0,51,UCBPlayer
7808,UCBPlayer,66,296,362,3,47,UCBPlayer
7809,UCBPlayer,64,309,373,2,43,UCBPlayer
7810,UCBPlayer,67,292,359,3,48,UCBPlayer
7811,UCBPlayer,57,287,344,0,52,UCBPlayer
7812,UCBPlayer,287,182,469,41,24,Player A
7813,UCBPlayer,55,310,365,0,45,UCBPlayer
7814,UCBPlayer,50,315,365,0,45,UCBPlayer
7815,UCBPlayer,67,262,329,0,57,UCBPlayer
7816,UCBPlayer,59,279,338,0,54,UCBPlayer
7817,UCBPlayer,49,319,368,0,44,UCBPlayer
7818,UCBPlayer,172,232,404,21,39,UCBPlayer
7819,UCBPlayer,64,259,323,0,59,UCBPlayer
7820,UCBPlayer,70,260,330,1,57,UCBPlayer
7821,UCBPlayer,87,307,394,8,38,UCBPlayer
7822,UCBPlayer,75,290,365,3,46,UCBPlayer
7823,UCBPlayer,63,278,341,0,53,UCBPlayer
7824,UCBPlayer,84,279,363,7,48,UCBPlayer
7825,UCBPlayer,55,295,350,0,50,UCBPlayer
7826,UCBPlayer,43,343,386,0,38,UCBPlayer
7827,UCBPlayer,71,281,352,2,50,UCBPlayer
7828,UCBPlayer,70,280,350,3,51,UCBPlayer
7829,UCBPlayer,54,299,353,0,49,UCBPlayer
7830,UCBPlayer,57,287,344,0,52,UCBPlayer
7831,UCBPlayer,74,284,358,5,49,UCBPlayer
7832,UCBPlayer,80,275,355,5,50,UCBPlayer
7833,UCBPlayer,58,303,361,2,47,UCBPlayer
7834,UCBPlayer,56,316,372,1,43,UCBPlayer
7835,UCBPlayer,64,324,388,5,39,UCBPlayer
7836,UCBPlayer,65,300,365,3,46,UCBPlayer
7837,UCBPlayer,65,300,365,3,46,UCBPlayer
7838,UCBPlayer,46,331,377,0,41,UCBPlayer
7839,UCBPlayer,58,323,381,4,41,UCBPlayer
7840,UCBPlayer,73,283,356,3,49,UCBPlayer
7841,UCBPlayer,62,267,329,0,57,UCBPlayer
7842,UCBPlayer,113,268,381,13,44,UCBPlayer
7843,UCBPlayer,139,234,373,14,47,UCBPlayer
7844,UCBPlayer,62,282,344,0,52,UCBPlayer
7845,UCBPlayer,62,287,349,2,51,UCBPlayer
7846,UCBPlayer,65,280,345,1,52,UCBPlayer
7847,UCBPlayer,60,275,335,0,55,UCBPlayer
7848,UCBPlayer,67,282,349,2,51,UCBPlayer
7849,UCBPlayer,66,301,367,2,45,UCBPlayer
7850,UCBPlayer,64,259,323,0,59,UCBPlayer
7851,UCBPlayer,57,282,339,1,54,UCBPlayer
7852,UCBPlayer,50,330,380,0,40,UCBPlayer
7853,UCBPlayer,52,292,344,0,52,UCBPlayer
7854,UCBPlayer,59,279,338,0,54,UCBPlayer
7855,UCBPlayer,47,327,374,0,42,UCBPlayer
7856,UCBPlayer,49,319,368,0,44,UCBPlayer
7857,UCBPlayer,59,314,373,2,43,UCBPlayer
7858,UCBPlayer,52,332,384,1,39,UCBPlayer
7859,UCBPlayer,233,228,461,30,23,Player A
7860,UCBPlayer,73,293,366,4,46,UCBPlayer
7861,UCBPlayer,54,299,353,0,49,UCBPlayer
7862,UCBPlayer,67,302,369,4,45,UCBPlayer
7863,UCBPlayer,177,232,409,23,38,UCBPlayer
7864,UCBPlayer,61,271,332,0,56,UCBPlayer
7865,UCBPlayer,64,284,348,1,51,UCBPlayer
7866,UCBPlayer,63,308,371,3,44,UCBPlayer
7867,UCBPlayer,53,303,356,0,48,UCBPlayer
7868,UCBPlayer,59,279,338,0,54,UCBPlayer
7869,UCBPlayer,144,244,388,14,42,UCBPlayer
7870,UCBPlayer,173,258,431,24,31,UCBPlayer
7871,UCBPlayer,81,261,342,4,54,UCBPlayer
7872,UCBPlayer,89,299,388,8,40,UCBPlayer
7873,UCBPlayer,56,291,347,0,51,UCBPlayer
7874,UCBPlayer,48,323,371,0,43,UCBPlayer
7875,UCBPlayer,64,284,348,1,51,UCBPlayer
7876,UCBPlayer,51,311,362,0,46,UCBPlayer
7877,UCBPlayer,47,327,374,0,42,UCBPlayer
7878,UCBPlayer,54,299,353,0,49,UCBPlayer
7879,UCBPlayer,86,311,397,8,37,UCBPlayer
7880,UCBPlayer,47,327,374,0,42,UCBPlayer
7881,UCBPlayer,84,284,368,6,46,UCBPlayer
7882,UCBPlayer,50,315,365,0,45,UCBPlayer
7883,UCBPlayer,53,303,356,0,48,UCBPlayer
7884,UCBPlayer,67,292,359,3,48,UCBPlayer
7885,UCBPlayer,69,309,378,4,42,UCBPlayer
7886,UCBPlayer,72,277,349,2,51,UCBPlayer
7887,UCBPlayer,49,319,368,0,44,UCBPlayer
7888,UCBPlayer,125,270,395,12,39,UCBPlayer
7889,UCBPlayer,55,295,350,0,50,UCBPlayer
7890,UCBPlayer,56,301,357,1,48,UCBPlayer
7891,UCBPlayer,139,214,353,12,53,UCBPlayer
7892,UCBPlayer,84,284,368,3,45,UCBPlayer
7893,UCBPlayer,98,283,381,10,43,UCBPlayer
7894,UCBPlayer,51,311,362,0,46,UCBPlayer
7895,UCBPlayer,56,291,347,0,51,UCBPlayer
7896,UCBPlayer,55,295,350,0,50,UCBPlayer
7897,UCBPlayer,55,295,350,0,50,UCBPlayer
7898,UCBPlayer,52,307,359,0,47,UCBPlayer
7899,UCBPlayer,83,258,341,3,54,UCBPlayer
7900,UCBPlayer,58,293,351,1,50,UCBPlayer
7901,UCBPlayer,82,292,374,6,44,UCBPlayer
7902,UCBPlayer,48,323,371,0,43,UCBPlayer
7903,UCBPlayer,57,282,339,1,54,UCBPlayer
7904,UCBPlayer,170,230,400,14,38,UCBPlayer
7905,UCBPlayer,53,303,356,0,48,UCBPlayer
7906,UCBPlayer,108,268,376,8,44,UCBPlayer
7907,UCBPlayer,65,280,345,1,52,UCBPlayer
7908,UCBPlayer,70,290,360,4,48,UCBPlayer
7909,UCBPlayer,55,295,350,0,50,UCBPlayer
7910,UCBPlayer,70,250,320,0,60,UCBPlayer
7911,UCBPlayer,66,266,332,0,56,UCBPlayer
7912,UCBPlayer,58,308,366,1,45,UCBPlayer
7913,UCBPlayer,62,302,364,2,46,UCBPlayer
7914,UCBPlayer,56,291,347,0,51,UCBPlayer
7915,UCBPlayer,85,285,370,5,45,UCBPlayer
7916,UCBPlayer,50,315,365,0,45,UCBPlayer
7917,UCBPlayer,106,271,377,12,45,UCBPlayer
7918,UCBPlayer,57,287,344,0,52,UCBPlayer
7919,UCBPlayer,78,288,366,4,46,UCBPlayer
7920,UCBPlayer,55,295,350,0,50,UCBPlayer
7921,UCBPlayer,76,281,357,4,49,UCBPlayer
7922,UCBPlayer,82,267,349,5,52,UCBPlayer
7923,UCBPlayer,54,299,353,0,49,UCBPlayer
7924,UCBPlayer,57,297,354,1,49,UCBPlayer
7925,UCBPlayer,64,274,338,0,54,UCBPlayer
7926,UCBPlayer,63,298,361,2,47,UCBPlayer
7927,UCBPlayer,46,341,387,1,38,UCBPlayer
7928,UCBPlayer,70,280,350,3,51,UCBPlayer
7929,UCBPlayer,66,286,352,2,50,UCBPlayer
7930,UCBPlayer,57,287,344,0,52,UCBPlayer
7931,UCBPlayer,61,306,367,2,45,UCBPlayer
7932,UCBPlayer,63,298,361,2,47,UCBPlayer
7933,UCBPlayer,65,280,345,1,52,UCBPlayer
7934,UCBPlayer,63,288,351,1,50,UCBPlayer
7935,UCBPlayer,68,268,336,1,55,UCBPlayer
7936,UCBPlayer,74,299,373,5,44,UCBPlayer
7937,UCBPlayer,64,294,358,2,48,UCBPlayer
7938,UCBPlayer,81,246,327,1,58,UCBPlayer
7939,UCBPlayer,54,299,353,0,49,UCBPlayer
7940,UCBPlayer,51,311,362,0,46,UCBPlayer
7941,UCBPlayer,56,301,357,1,48,UCBPlayer
7942,UCBPlayer,73,273,346,2,52,UCBPlayer
7943,UCBPlayer,50,315,365,0,45,UCBPlayer
7944,UCBPlayer,52,317,369,1,44,UCBPlayer
7945,UCBPlayer,69,284,353,3,50,UCBPlayer
7946,UCBPlayer,81,291,372,7,45,UCBPlayer
7947,UCBPlayer,69,284,353,3,50,UCBPlayer
7948,UCBPlayer,66,301,367,2,45,UCBPlayer
7949,UCBPlayer,50,315,365,0,45,UCBPlayer
7950,UCBPlayer,55,295,350,0,50,UCBPlayer
7951,UCBPlayer,62,277,339,1,54,UCBPlayer
7952,UCBPlayer,81,271,352,5,51,UCBPlayer
7953,UCBPlayer,49,324,373,2,43,UCBPlayer
7954,UCBPlayer,65,295,360,1,47,UCBPlayer
7955,UCBPlayer,75,265,340,2,54,UCBPlayer
7956,UCBPlayer,52,332,384,1,39,UCBPlayer
7957,UCBPlayer,50,315,365,0,45,UCBPlayer
7958,UCBPlayer,74,299,373,5,44,UCBPlayer
7959,UCBPlayer,52,307,359,0,47,UCBPlayer
7960,UCBPlayer,58,283,341,0,53,UCBPlayer
7961,UCBPlayer,49,319,368,0,44,UCBPlayer
7962,UCBPlayer,136,226,362,12,50,UCBPlayer
7963,UCBPlayer,52,307,359,0,47,UCBPlayer
7964,UCBPlayer,49,319,368,0,44,UCBPlayer
7965,UCBPlayer,62,292,354,1,49,UCBPlayer
7966,UCBPlayer,52,307,359,0,47,UCBPlayer
7967,UCBPlayer,54,314,368,0,44,UCBPlayer
7968,UCBPlayer,57,332,389,3,38,UCBPlayer
7969,UCBPlayer,50,335,385,2,39,UCBPlayer
7970,UCBPlayer,61,296,357,1,48,UCBPlayer
7971,UCBPlayer,54,299,353,0,49,UCBPlayer
7972,UCBPlayer,51,311,362,0,46,UCBPlayer
7973,UCBPlayer,51,311,362,0,46,UCBPlayer
7974,UCBPlayer,47,327,374,0,42,UCBPlayer
7975,UCBPlayer,66,296,362,3,47,UCBPlayer
7976,UCBPlayer,49,319,368,0,44,UCBPlayer
7977,UCBPlayer,59,304,363,1,46,UCBPlayer
7978,UCBPlayer,69,264,333,1,56,UCBPlayer
7979,UCBPlayer,63,298,361,2,47,UCBPlayer
7980,UCBPlayer,63,263,326,0,58,UCBPlayer
7981,UCBPlayer,70,305,375,4,43,UCBPlayer
7982,UCBPlayer,60,310,370,2,44,UCBPlayer
7983,UCBPlayer,64,284,348,1,51,UCBPlayer
7984,UCBPlayer,55,295,350,0,50,UCBPlayer
7985,UCBPlayer,89,259,348,4,52,UCBPlayer
7986,UCBPlayer,54,309,363,1,46,UCBPlayer
7987,UCBPlayer,55,310,365,0,45,UCBPlayer
7988,UCBPlayer,55,295,350,0,50,UCBPlayer
7989,UCBPlayer,94,254,348,7,53,UCBPlayer
7990,UCBPlayer,58,283,341,0,53,UCBPlayer
7991,UCBPlayer,60,285,345,1,52,UCBPlayer
7992,UCBPlayer,81,261,342,4,54,UCBPlayer
7993,UCBPlayer,65,305,370,2,44,UCBPlayer
7994,UCBPlayer,57,287,344,0,52,UCBPlayer
7995,UCBPlayer,58,283,341,0,53,UCBPlayer
7996,UCBPlayer,57,287,344,0,52,UCBPlayer
7997,UCBPlayer,62,267,329,0,57,UCBPlayer
7998,UCBPlayer,52,307,359,0,47,UCBPlayer
7999,UCBPlayer,60,275,335,0,55,UCBPlayer
8000,UCBPlayer,107,257,364,11,49,UCBPlayer
8001,UCBPlayer,51,311,362,0,46,UCBPlayer
8002,UCBPlayer,59,299,358,2,48,UCBPlayer
8003,UCBPlayer,75,245,320,0,60,UCBPlayer
8004,UCBPlayer,48,328,376,2,42,UCBPlayer
8005,UCBPlayer,71,316,387,4,39,UCBPlayer
8006,UCBPlayer,49,304,353,0,49,UCBPlayer
8007,UCBPlayer,62,312,374,3,43,UCBPlayer
8008,UCBPlayer,51,311,362,0,46,UCBPlayer
8009,UCBPlayer,57,287,344,0,52,UCBPlayer
8010,UCBPlayer,53,303,356,0,48,UCBPlayer
8011,UCBPlayer,44,339,383,0,39,UCBPlayer
8012,UCBPlayer,58,283,341,0,53,UCBPlayer
8013,UCBPlayer,80,270,350,3,51,UCBPlayer
8014,UCBPlayer,48,333,381,1,40,UCBPlayer
8015,UCBPlayer,60,325,385,2,39,UCBPlayer
8016,UCBPlayer,63,308,371,3,44,UCBPlayer
8017,UCBPlayer,57,287,344,0,52,UCBPlayer
8018,UCBPlayer,59,279,338,0,54,UCBPlayer
8019,UCBPlayer,70,290,360,4,48,UCBPlayer
8020,UCBPlayer,66,286,352,2,50,UCBPlayer
8021,UCBPlayer,61,271,332,0,56,UCBPlayer
8022,UCBPlayer,112,277,389,12,41,UCBPlayer
8023,UCBPlayer,52,307,359,0,47,UCBPlayer
8024,UCBPlayer,58,283,341,0,53,UCBPlayer
8025,UCBPlayer,68,303,371,3,44,UCBPlayer
8026,UCBPlayer,64,309,373,2,43,UCBPlayer
8027,UCBPlayer,64,294,358,2,48,UCBPlayer
8028,UCBPlayer,46,341,387,1,38,UCBPlayer
8029,UCBPlayer,65,305,370,2,44,UCBPlayer
8030,UCBPlayer,62,292,354,1,49,UCBPlayer
8031,UCBPlayer,54,299,353,0,49,UCBPlayer
8032,UCBPlayer,50,315,365,0,45,UCBPlayer
8033,UCBPlayer,53,303,356,0,48,UCBPlayer
8034,UCBPlayer,51,311,362,0,46,UCBPlayer
8035,UCBPlayer,58,283,341,0,53,UCBPlayer
8036,UCBPlayer,68,268,336,1,55,UCBPlayer
8037,UCBPlayer,54,309,363,1,46,UCBPlayer
8038,UCBPlayer,59,304,363,1,46,UCBPlayer
8039,UCBPlayer,61,286,347,0,51,UCBPlayer
8040,UCBPlayer,64,274,338,0,54,UCBPlayer
8041,UCBPlayer,52,307,359,0,47,UCBPlayer
8042,UCBPlayer,77,302,379,5,42,UCBPlayer
8043,UCBPlayer,124,269,393,10,39,UCBPlayer
8044,UCBPlayer,66,296,362,3,47,UCBPlayer
8045,UCBPlayer,74,289,363,4,47,UCBPlayer
8046,UCBPlayer,49,319,368,0,44,UCBPlayer
8047,UCBPlayer,53,303,356,0,48,UCBPlayer
8048,UCBPlayer,43,343,386,0,38,UCBPlayer
8049,UCBPlayer,50,320,370,2,44,UCBPlayer
8050,UCBPlayer,63,303,366,1,45,UCBPlayer
8051,UCBPlayer,57,312,369,1,44,UCBPlayer
8052,UCBPlayer,67,262,329,0,57,UCBPlayer
8053,UCBPlayer,67,282,349,2,51,UCBPlayer
8054,UCBPlayer,62,307,369,4,45,UCBPlayer
8055,UCBPlayer,91,296,387,10,41,UCBPlayer
8056,UCBPlayer,73,278,351,1,50,UCBPlayer
8057,UCBPlayer,48,308,356,0,48,UCBPlayer
8058,UCBPlayer,82,282,364,5,47,UCBPlayer
8059,UCBPlayer,53,303,356,0,48,UCBPlayer
8060,UCBPlayer,47,327,374,0,42,UCBPlayer
8061,UCBPlayer,52,307,359,0,47,UCBPlayer
8062,UCBPlayer,58,283,341,0,53,UCBPlayer
8063,UCBPlayer,53,303,356,0,48,UCBPlayer
8064,UCBPlayer,58,283,341,0,53,UCBPlayer
8065,UCBPlayer,116,261,377,12,45,UCBPlayer
8066,UCBPlayer,57,287,344,0,52,UCBPlayer
8067,UCBPlayer,43,343,386,0,38,UCBPlayer
8068,UCBPlayer,69,304,373,5,44,UCBPlayer
8069,UCBPlayer,96,296,392,9,39,UCBPlayer
8070,UCBPlayer,55,295,350,0,50,UCBPlayer
8071,UCBPlayer,73,308,381,7,42,UCBPlayer
8072,UCBPlayer,67,297,364,2,46,UCBPlayer
8073,UCBPlayer,87,287,374,9,45,UCBPlayer
8074,UCBPlayer,103,258,361,8,49,UCBPlayer
8075,UCBPlayer,96,261,357,7,50,UCBPlayer
8076,UCBPlayer,53,303,356,0,48,UCBPlayer
8077,UCBPlayer,53,328,381,1,40,UCBPlayer
8078,UCBPlayer,72,282,354,4,50,UCBPlayer
8079,UCBPlayer,90,305,395,6,37,UCBPlayer
8080,UCBPlayer,52,307,359,0,47,UCBPlayer
8081,UCBPlayer,84,284,368,6,46,UCBPlayer
8082,UCBPlayer,88,263,351,4,51,UCBPlayer
8083,UCBPlayer,56,291,347,0,51,UCBPlayer
8084,UCBPlayer,48,323,371,0,43,UCBPlayer
8085,UCBPlayer,61,296,357,1,48,UCBPlayer
8086,UCBPlayer,57,312,369,1,44,UCBPlayer
8087,UCBPlayer,73,288,361,5,48,UCBPlayer
8088,UCBPlayer,54,299,353,0,49,UCBPlayer
8089,UCBPlayer,48,323,371,0,43,UCBPlayer
8090,UCBPlayer,60,275,335,0,55,UCBPlayer
8091,UCBPlayer,54,309,363,1,46,UCBPlayer
8092,UCBPlayer,58,298,356,0,48,UCBPlayer
8093,UCBPlayer,78,263,341,3,54,UCBPlayer
8094,UCBPlayer,52,307,359,0,47,UCBPlayer
8095,UCBPlayer,52,307,359,0,47,UCBPlayer
8096,UCBPlayer,49,319,368,0,44,UCBPlayer
8097,UCBPlayer,56,291,347,0,51,UCBPlayer
8098,UCBPlayer,66,266,332,0,56,UCBPlayer
8099,UCBPlayer,67,287,354,1,49,UCBPlayer
8100,UCBPlayer,70,275,345,1,52,UCBPlayer
8101,UCBPlayer,53,303,356,0,48,UCBPlayer
8102,UCBPlayer,61,296,357,1,48,UCBPlayer
8103,UCBPlayer,53,303,356,0,48,UCBPlayer
8104,UCBPlayer,57,287,344,0,52,UCBPlayer
8105,UCBPlayer,60,290,350,3,51,UCBPlayer
8106,UCBPlayer,90,275,365,9,48,UCBPlayer
8107,UCBPlayer,55,330,385,2,39,UCBPlayer
8108,UCBPlayer,83,278,361,5,48,UCBPlayer
8109,UCBPlayer,52,307,359,0,47,UCBPlayer
8110,UCBPlayer,74,314,388,8,40,UCBPlayer
8111,UCBPlayer,89,289,378,10,44,UCBPlayer
8112,UCBPlayer,64,304,368,3,45,UCBPlayer
8113,UCBPlayer,92,277,369,10,47,UCBPlayer
8114,UCBPlayer,53,303,356,0,48,UCBPlayer
8115,UCBPlayer,59,314,373,2,43,UCBPlayer
8116,UCBPlayer,70,280,350,3,51,UCBPlayer
8117,UCBPlayer,54,334,388,2,38,UCBPlayer
8118,UCBPlayer,58,308,366,1,45,UCBPlayer
8119,UCBPlayer,59,314,373,2,43,UCBPlayer
8120,UCBPlayer,54,299,353,0,49,UCBPlayer
8121,UCBPlayer,66,286,352,2,50,UCBPlayer
8122,UCBPlayer,70,300,370,5,45,UCBPlayer
8123,UCBPlayer,85,270,355,5,50,UCBPlayer
8124,UCBPlayer,107,282,389,9,40,UCBPlayer
8125,UCBPlayer,54,299,353,0,49,UCBPlayer
8126,UCBPlayer,76,271,347,3,52,UCBPlayer
8127,UCBPlayer,79,289,368,6,46,UCBPlayer
8128,UCBPlayer,59,304,363,1,46,UCBPlayer
8129,UCBPlayer,57,287,344,0,52,UCBPlayer
8130,UCBPlayer,57,307,364,2,46,UCBPlayer
8131,UCBPlayer,60,290,350,0,50,UCBPlayer
8132,UCBPlayer,51,311,362,0,46,UCBPlayer
8133,UCBPlayer,52,307,359,0,47,UCBPlayer
8134,UCBPlayer,61,271,332,0,56,UCBPlayer
8135,UCBPlayer,51,311,362,0,46,UCBPlayer
8136,UCBPlayer,49,319,368,0,44,UCBPlayer
8137,UCBPlayer,56,291,347,0,51,UCBPlayer
8138,UCBPlayer,55,295,350,0,50,UCBPlayer
8139,UCBPlayer,50,315,365,0,45,UCBPlayer
8140,UCBPlayer,64,284,348,1,51,UCBPlayer
8141,UCBPlayer,59,279,338,0,54,UCBPlayer
8142,UCBPlayer,53,303,356,0,48,UCBPlayer
8143,UCBPlayer,52,307,359,0,47,UCBPlayer
8144,UCBPlayer,58,283,341,0,53,UCBPlayer
8145,UCBPlayer,56,291,347,0,51,UCBPlayer
8146,UCBPlayer,55,295,350,0,50,UCBPlayer
8147,UCBPlayer,101,251,352,5,51,UCBPlayer
8148,UCBPlayer,48,323,371,0,43,UCBPlayer
8149,UCBPlayer,73,293,366,4,46,UCBPlayer
8150,UCBPlayer,87,277,364,5,47,UCBPlayer
8151,UCBPlayer,62,312,374,3,43,UCBPlayer
8152,UCBPlayer,71,296,367,5,46,UCBPlayer
8153,UCBPlayer,75,285,360,4,48,UCBPlayer
8154,UCBPlayer,64,294,358,2,48,UCBPlayer
8155,UCBPlayer,51,311,362,0,46,UCBPlayer
8156,UCBPlayer,66,276,342,1,53,UCBPlayer
8157,UCBPlayer,73,283,356,3,49,UCBPlayer
8158,UCBPlayer,56,301,357,1,48,UCBPlayer
8159,UCBPlayer,82,267,349,5,52,UCBPlayer
8160,UCBPlayer,151,256,407,21,38,UCBPlayer
8161,UCBPlayer,58,283,341,0,53,UCBPlayer
8162,UCBPlayer,126,266,392,12,40,UCBPlayer
8163,UCBPlayer,97,257,354,7,51,UCBPlayer
8164,UCBPlayer,48,323,371,0,43,UCBPlayer
8165,UCBPlayer,82,262,344,3,53,UCBPlayer
8166,UCBPlayer,63,323,386,3,39,UCBPlayer
8167,UCBPlayer,85,270,355,5,50,UCBPlayer
8168,UCBPlayer,55,295,350,0,50,UCBPlayer
8169,UCBPlayer,77,302,379,5,42,UCBPlayer
8170,UCBPlayer,91,281,372,10,46,UCBPlayer
8171,UCBPlayer,55,295,350,0,50,UCBPlayer
8172,UCBPlayer,62,267,329,0,57,UCBPlayer
8173,UCBPlayer,69,254,323,0,59,UCBPlayer
8174,UCBPlayer,79,264,343,2,53,UCBPlayer
8175,UCBPlayer,51,321,372,1,43,UCBPlayer
8176,UCBPlayer,79,309,388,8,40,UCBPlayer
8177,UCBPlayer,66,296,362,3,47,UCBPlayer
8178,UCBPlayer,72,277,349,2,51,UCBPlayer
8179,UCBPlayer,54,299,353,0,49,UCBPlayer
8180,UCBPlayer,49,319,368,0,44,UCBPlayer
8181,UCBPlayer,88,248,336,4,56,UCBPlayer
8182,UCBPlayer,61,271,332,0,56,UCBPlayer
8183,UCBPlayer,72,267,339,1,54,UCBPlayer
8184,UCBPlayer,74,284,358,5,49,UCBPlayer
8185,UCBPlayer,53,313,366,1,45,UCBPlayer
8186,UCBPlayer,65,280,345,1,52,UCBPlayer
8187,UCBPlayer,71,281,352,2,50,UCBPlayer
8188,UCBPlayer,55,295,350,0,50,UCBPlayer
8189,UCBPlayer,66,286,352,2,50,UCBPlayer
8190,UCBPlayer,56,291,347,0,51,UCBPlayer
8191,UCBPlayer,104,264,368,9,47,UCBPlayer
8192,UCBPlayer,83,268,351,4,51,UCBPlayer
8193,UCBPlayer,53,303,356,0,48,UCBPlayer
8194,UCBPlayer,69,309,378,4,42,UCBPlayer
8195,UCBPlayer,61,281,342,1,53,UCBPlayer
8196,UCBPlayer,62,322,384,4,40,UCBPlayer
8197,UCBPlayer,63,308,371,3,44,UCBPlayer
8198,UCBPlayer,65,310,375,4,43,UCBPlayer
8199,UCBPlayer,57,302,359,0,47,UCBPlayer
8200,UCBPlayer,72,262,334,2,56,UCBPlayer
8201,UCBPlayer,83,278,361,5,48,UCBPlayer
8202,UCBPlayer,75,255,330,1,57,UCBPlayer
8203,UCBPlayer,50,315,365,0,45,UCBPlayer
8204,UCBPlayer,55,295,350,0,50,UCBPlayer
8205,UCBPlayer,50,315,365,0,45,UCBPlayer
8206,UCBPlayer,53,303,356,0,48,UCBPlayer
8207,UCBPlayer,83,253,336,4,56,UCBPlayer
8208,UCBPlayer,48,318,366,1,45,UCBPlayer
8209,UCBPlayer,72,277,349,2,51,UCBPlayer
8210,UCBPlayer,56,276,332,0,56,UCBPlayer
8211,UCBPlayer,48,323,371,0,43,UCBPlayer
8212,UCBPlayer,92,287,379,8,43,UCBPlayer
8213,UCBPlayer,76,316,392,9,39,UCBPlayer
8214,UCBPlayer,58,283,341,0,53,UCBPlayer
8215,UCBPlayer,51,311,362,0,46,UCBPlayer
8216,UCBPlayer,62,307,369,1,44,UCBPlayer
8217,UCBPlayer,56,291,347,0,51,UCBPlayer
8218,UCBPlayer,64,259,323,0,59,UCBPlayer
8219,UCBPlayer,55,295,350,0,50,UCBPlayer
8220,UCBPlayer,52,307,359,0,47,UCBPlayer
8221,UCBPlayer,60,275,335,0,55,UCBPlayer
8222,UCBPlayer,55,330,385,2,39,UCBPlayer
8223,UCBPlayer,65,300,365,3,46,UCBPlayer
8224,UCBPlayer,67,287,354,1,49,UCBPlayer
8225,UCBPlayer,61,271,332,0,56,UCBPlayer
8226,UCBPlayer,88,278,366,4,46,UCBPlayer
8227,UCBPlayer,68,258,326,0,58,UCBPlayer
8228,UCBPlayer,70,270,340,2,54,UCBPlayer
8229,UCBPlayer,168,268,436,17,27,UCBPlayer
8230,UCBPlayer,57,287,344,0,52,UCBPlayer
8231,UCBPlayer,96,231,327,4,59,UCBPlayer
8232,UCBPlayer,51,311,362,0,46,UCBPlayer
8233,UCBPlayer,53,303,356,0,48,UCBPlayer
8234,UCBPlayer,100,280,380,12,44,UCBPlayer
8235,UCBPlayer,75,300,375,4,43,UCBPlayer
8236,UCBPlayer,63,288,351,1,50,UCBPlayer
8237,UCBPlayer,53,303,356,0,48,UCBPlayer
8238,UCBPlayer,99,314,413,9,32,UCBPlayer
8239,UCBPlayer,51,311,362,0,46,UCBPlayer
8240,UCBPlayer,66,306,372,4,44,UCBPlayer
8241,UCBPlayer,66,306,372,4,44,UCBPlayer
8242,UCBPlayer,49,339,388,2,38,UCBPlayer
8243,UCBPlayer,78,263,341,3,54,UCBPlayer
8244,UCBPlayer,60,275,335,0,55,UCBPlayer
8245,UCBPlayer,52,307,359,0,47,UCBPlayer
8246,UCBPlayer,94,284,378,10,44,UCBPlayer
8247,UCBPlayer,67,282,349,2,51,UCBPlayer
8248,UCBPlayer,85,290,375,4,43,UCBPlayer
8249,UCBPlayer,67,317,384,7,41,UCBPlayer
8250,UCBPlayer,81,286,367,5,46,UCBPlayer
8251,UCBPlayer,59,279,338,0,54,UCBPlayer
8252,UCBPlayer,73,288,361,5,48,UCBPlayer
8253,UCBPlayer,72,287,359,3,48,UCBPlayer
8254,UCBPlayer,74,309,383,6,41,UCBPlayer
8255,UCBPlayer,86,301,387,4,39,UCBPlayer
8256,UCBPlayer,59,279,338,0,54,UCBPlayer
8257,UCBPlayer,60,285,345,1,52,UCBPlayer
8258,UCBPlayer,49,339,388,2,38,UCBPlayer
8259,UCBPlayer,91,271,362,6,48,UCBPlayer
8260,UCBPlayer,49,314,363,1,46,UCBPlayer
8261,UCBPlayer,60,330,390,4,38,UCBPlayer
8262,UCBPlayer,79,289,368,6,46,UCBPlayer
8263,UCBPlayer,52,307,359,0,47,UCBPlayer
8264,UCBPlayer,57,287,344,0,52,UCBPlayer
8265,UCBPlayer,61,296,357,1,48,UCBPlayer
8266,UCBPlayer,47,347,394,2,36,UCBPlayer
8267,UCBPlayer,53,303,356,0,48,UCBPlayer
8268,UCBPlayer,68,288,356,3,49,UCBPlayer
8269,UCBPlayer,67,302,369,4,45,UCBPlayer
8270,UCBPlayer,113,283,396,16,40,UCBPlayer
8271,UCBPlayer,71,266,337,2,55,UCBPlayer
8272,UCBPlayer,57,302,359,0,47,UCBPlayer
8273,UCBPlayer,61,296,357,1,48,UCBPlayer
8274,UCBPlayer,192,237,429,25,32,UCBPlayer
8275,UCBPlayer,101,281,382,11,43,UCBPlayer
8276,UCBPlayer,58,308,366,1,45,UCBPlayer
8277,UCBPlayer,68,258,326,0,58,UCBPlayer
8278,UCBPlayer,61,311,372,1,43,UCBPlayer
8279,UCBPlayer,55,295,350,0,50,UCBPlayer
8280,UCBPlayer,66,266,332,0,56,UCBPlayer
8281,UCBPlayer,54,299,353,0,49,UCBPlayer
8282,UCBPlayer,108,278,386,15,43,UCBPlayer
8283,UCBPlayer,77,267,344,3,53,UCBPlayer
8284,UCBPlayer,68,288,356,3,49,UCBPlayer
8285,UCBPlayer,53,303,356,0,48,UCBPlayer
8286,UCBPlayer,60,300,360,1,47,UCBPlayer
8287,UCBPlayer,64,259,323,0,59,UCBPlayer
8288,UCBPlayer,53,303,356,0,48,UCBPlayer
8289,UCBPlayer,160,275,435,22,29,UCBPlayer
8290,UCBPlayer,48,323,371,0,43,UCBPlayer
8291,UCBPlayer,46,331,377,0,41,UCBPlayer
8292,UCBPlayer,60,285,345,1,52,UCBPlayer
8293,UCBPlayer,66,306,372,4,44,UCBPlayer
8294,UCBPlayer,76,281,357,4,49,UCBPlayer
8295,UCBPlayer,73,288,361,5,48,UCBPlayer
8296,UCBPlayer,77,247,324,1,59,UCBPlayer
8297,UCBPlayer,61,286,347,0,51,UCBPlayer
8298,UCBPlayer,66,301,367,2,45,UCBPlayer
8299,UCBPlayer,66,276,342,1,53,UCBPlayer
8300,UCBPlayer,74,324,398,6,36,UCBPlayer
8301,UCBPlayer,52,307,359,0,47,UCBPlayer
8302,UCBPlayer,49,319,368,0,44,UCBPlayer
8303,UCBPlayer,61,286,347,0,51,UCBPlayer
8304,UCBPlayer,57,287,344,0,52,UCBPlayer
8305,UCBPlayer,56,291,347,0,51,UCBPlayer
8306,UCBPlayer,48,343,391,2,37,UCBPlayer
8307,UCBPlayer,75,265,340,2,54,UCBPlayer
8308,UCBPlayer,67,287,354,1,49,UCBPlayer
8309,UCBPlayer,73,298,371,3,44,UCBPlayer
8310,UCBPlayer,52,322,374,0,42,UCBPlayer
8311,UCBPlayer,47,322,369,1,44,UCBPlayer
8312,UCBPlayer,53,318,371,0,43,UCBPlayer
8313,UCBPlayer,169,234,403,17,38,UCBPlayer
8314,UCBPlayer,59,304,363,1,46,UCBPlayer
8315,UCBPlayer,61,296,357,1,48,UCBPlayer
8316,UCBPlayer,60,275,335,0,55,UCBPlayer
8317,UCBPlayer,90,260,350,6,52,UCBPlayer
8318,UCBPlayer,50,315,365,0,45,UCBPlayer
8319,UCBPlayer,49,319,368,0,44,UCBPlayer
8320,UCBPlayer,52,307,359,0,47,UCBPlayer
8321,UCBPlayer,80,255,335,3,56,UCBPlayer
8322,UCBPlayer,64,304,368,3,45,UCBPlayer
8323,UCBPlayer,66,286,352,2,50,UCBPlayer
8324,UCBPlayer,212,227,439,29,30,UCBPlayer
8325,UCBPlayer,63,298,361,2,47,UCBPlayer
8326,UCBPlayer,51,311,362,0,46,UCBPlayer
8327,UCBPlayer,52,307,359,0,47,UCBPlayer
8328,UCBPlayer,92,287,379,8,43,UCBPlayer
8329,UCBPlayer,53,303,356,0,48,UCBPlayer
8330,UCBPlayer,60,275,335,0,55,UCBPlayer
8331,UCBPlayer,54,299,353,0,49,UCBPlayer
8332,UCBPlayer,54,299,353,0,49,UCBPlayer
8333,UCBPlayer,53,303,356,0,48,UCBPlayer
8334,UCBPlayer,66,286,352,2,50,UCBPlayer
8335,UCBPlayer,59,279,338,0,54,UCBPlayer
8336,UCBPlayer,51,311,362,0,46,UCBPlayer
8337,UCBPlayer,55,320,375,1,42,UCBPlayer
8338,UCBPlayer,55,295,350,0,50,UCBPlayer
8339,UCBPlayer,57,287,344,0,52,UCBPlayer
8340,UCBPlayer,60,300,360,1,47,UCBPlayer
8341,UCBPlayer,76,271,347,3,52,UCBPlayer
8342,UCBPlayer,65,290,355,2,49,UCBPlayer
8343,UCBPlayer,53,303,356,0,48,UCBPlayer
8344,UCBPlayer,55,295,350,0,50,UCBPlayer
8345,UCBPlayer,65,280,345,1,52,UCBPlayer
8346,UCBPlayer,61,301,362,3,47,UCBPlayer
8347,UCBPlayer,61,306,367,2,45,UCBPlayer
8348,UCBPlayer,59,294,353,0,49,UCBPlayer
8349,UCBPlayer,57,307,364,2,46,UCBPlayer
8350,UCBPlayer,73,253,326,0,58,UCBPlayer
8351,UCBPlayer,52,307,359,0,47,UCBPlayer
8352,UCBPlayer,58,308,366,1,45,UCBPlayer
8353,UCBPlayer,95,270,365,6,47,UCBPlayer
8354,UCBPlayer,59,279,338,0,54,UCBPlayer
8355,UCBPlayer,72,302,374,6,44,UCBPlayer
8356,UCBPlayer,68,283,351,1,50,UCBPlayer
8357,UCBPlayer,51,311,362,0,46,UCBPlayer
8358,UCBPlayer,77,257,334,2,56,UCBPlayer
8359,UCBPlayer,61,291,352,2,50,UCBPlayer
8360,UCBPlayer,69,314,383,6,41,UCBPlayer
8361,UCBPlayer,65,280,345,1,52,UCBPlayer
8362,UCBPlayer,57,312,369,1,44,UCBPlayer
8363,UCBPlayer,73,283,356,3,49,UCBPlayer
8364,UCBPlayer,48,323,371,0,43,UCBPlayer
8365,UCBPlayer,66,286,352,2,50,UCBPlayer
8366,UCBPlayer,69,254,323,0,59,UCBPlayer
8367,UCBPlayer,79,289,368,6,46,UCBPlayer
8368,UCBPlayer,52,307,359,0,47,UCBPlayer
8369,UCBPlayer,50,315,365,0,45,UCBPlayer
8370,UCBPlayer,58,283,341,0,53,UCBPlayer
8371,UCBPlayer,80,320,400,11,37,UCBPlayer
8372,UCBPlayer,59,279,338,0,54,UCBPlayer
8373,UCBPlayer,52,307,359,0,47,UCBPlayer
8374,UCBPlayer,67,282,349,2,51,UCBPlayer
8375,UCBPlayer,54,329,383,3,40,UCBPlayer
8376,UCBPlayer,68,303,371,3,44,UCBPlayer
8377,UCBPlayer,62,267,329,0,57,UCBPlayer
8378,UCBPlayer,91,231,322,2,60,UCBPlayer
8379,UCBPlayer,81,261,342,4,54,UCBPlayer
8380,UCBPlayer,89,294,383,9,42,UCBPlayer
8381,UCBPlayer,51,311,362,0,46,UCBPlayer
8382,UCBPlayer,61,271,332,0,56,UCBPlayer
8383,UCBPlayer,51,311,362,0,46,UCBPlayer
8384,UCBPlayer,58,283,341,0,53,UCBPlayer
8385,UCBPlayer,44,339,383,0,39,UCBPlayer
8386,UCBPlayer,54,299,353,0,49,UCBPlayer
8387,UCBPlayer,47,327,374,0,42,UCBPlayer
8388,UCBPlayer,58,283,341,0,53,UCBPlayer
8389,UCBPlayer,52,317,369,1,44,UCBPlayer
8390,UCBPlayer,100,275,375,10,45,UCBPlayer
8391,UCBPlayer,87,307,394,8,38,UCBPlayer
8392,UCBPlayer,76,291,367,5,46,UCBPlayer
8393,UCBPlayer,57,312,369,1,44,UCBPlayer
8394,UCBPlayer,69,284,353,3,50,UCBPlayer
8395,UCBPlayer,59,294,353,0,49,UCBPlayer
8396,UCBPlayer,47,327,374,0,42,UCBPlayer
8397,UCBPlayer,48,323,371,0,43,UCBPlayer
8398,UCBPlayer,49,319,368,0,44,UCBPlayer
8399,UCBPlayer,50,315,365,0,45,UCBPlayer
8400,UCBPlayer,69,264,333,1,56,UCBPlayer
8401,UCBPlayer,61,311,372,4,44,UCBPlayer
8402,UCBPlayer,114,249,363,10,49,UCBPlayer
8403,UCBPlayer,76,321,397,5,36,UCBPlayer
8404,UCBPlayer,53,303,356,0,48,UCBPlayer
8405,UCBPlayer,71,316,387,4,39,UCBPlayer
8406,UCBPlayer,53,303,356,0,48,UCBPlayer
8407,UCBPlayer,54,299,353,0,49,UCBPlayer
8408,UCBPlayer,86,266,352,5,51,UCBPlayer
8409,UCBPlayer,183,248,431,24,31,UCBPlayer
8410,UCBPlayer,64,274,338,0,54,UCBPlayer
8411,UCBPlayer,60,285,345,1,52,UCBPlayer
8412,UCBPlayer,53,323,376,2,42,UCBPlayer
8413,UCBPlayer,81,271,352,5,51,UCBPlayer
8414,UCBPlayer,73,293,366,4,46,UCBPlayer
8415,UCBPlayer,50,315,365,0,45,UCBPlayer
8416,UCBPlayer,54,299,353,0,49,UCBPlayer
8417,UCBPlayer,56,291,347,0,51,UCBPlayer
8418,UCBPlayer,62,267,329,0,57,UCBPlayer
8419,UCBPlayer,47,327,374,0,42,UCBPlayer
8420,UCBPlayer,69,264,333,1,56,UCBPlayer
8421,UCBPlayer,54,299,353,0,49,UCBPlayer
8422,UCBPlayer,55,295,350,0,50,UCBPlayer
8423,UCBPlayer,48,323,371,0,43,UCBPlayer
8424,UCBPlayer,59,279,338,0,54,UCBPlayer
8425,UCBPlayer,54,299,353,0,49,UCBPlayer
8426,UCBPlayer,47,327,374,0,42,UCBPlayer
8427,UCBPlayer,141,256,397,14,39,UCBPlayer
8428,UCBPlayer,64,284,348,1,51,UCBPlayer
8429,UCBPlayer,52,307,359,0,47,UCBPlayer
8430,UCBPlayer,91,316,407,12,35,UCBPlayer
8431,UCBPlayer,59,279,338,0,54,UCBPlayer
8432,UCBPlayer,52,307,359,0,47,UCBPlayer
8433,UCBPlayer,89,279,368,6,46,UCBPlayer
8434,UCBPlayer,50,315,365,0,45,UCBPlayer
8435,UCBPlayer,51,321,372,1,43,UCBPlayer
8436,UCBPlayer,79,314,393,4,37,UCBPlayer
8437,UCBPlayer,69,274,343,2,53,UCBPlayer
8438,UCBPlayer,51,311,362,0,46,UCBPlayer
8439,UCBPlayer,56,301,357,1,48,UCBPlayer
8440,UCBPlayer,56,306,362,0,46,UCBPlayer
8441,UCBPlayer,60,320,380,3,41,UCBPlayer
8442,UCBPlayer,47,327,374,0,42,UCBPlayer
8443,UCBPlayer,107,292,399,7,36,UCBPlayer
8444,UCBPlayer,67,302,369,4,45,UCBPlayer
8445,UCBPlayer,52,307,359,0,47,UCBPlayer
8446,UCBPlayer,47,327,374,0,42,UCBPlayer
8447,UCBPlayer,69,304,373,5,44,UCBPlayer
8448,UCBPlayer,71,271,342,1,53,UCBPlayer
8449,UCBPlayer,69,264,333,1,56,UCBPlayer
8450,UCBPlayer,53,303,356,0,48,UCBPlayer
8451,UCBPlayer,56,291,347,0,51,UCBPlayer
8452,UCBPlayer,67,292,359,3,48,UCBPlayer
8453,UCBPlayer,54,299,353,0,49,UCBPlayer
8454,UCBPlayer,58,318,376,2,42,UCBPlayer
8455,UCBPlayer,52,307,359,0,47,UCBPlayer
8456,UCBPlayer,55,295,350,0,50,UCBPlayer
8457,UCBPlayer,66,281,347,3,52,UCBPlayer
8458,UCBPlayer,84,259,343,5,54,UCBPlayer
8459,UCBPlayer,60,275,335,0,55,UCBPlayer
8460,UCBPlayer,52,307,359,0,47,UCBPlayer
8461,UCBPlayer,50,315,365,0,45,UCBPlayer
8462,UCBPlayer,46,326,372,1,43,UCBPlayer
8463,UCBPlayer,54,339,393,4,37,UCBPlayer
8464,UCBPlayer,92,292,384,10,42,UCBPlayer
8465,UCBPlayer,60,300,360,1,47,UCBPlayer
8466,UCBPlayer,46,331,377,0,41,UCBPlayer
8467,UCBPlayer,70,260,330,1,57,UCBPlayer
8468,UCBPlayer,60,300,360,1,47,UCBPlayer
8469,UCBPlayer,77,267,344,3,53,UCBPlayer
8470,UCBPlayer,58,283,341,0,53,UCBPlayer
8471,UCBPlayer,52,307,359,0,47,UCBPlayer
8472,UCBPlayer,115,280,395,15,40,UCBPlayer
8473,UCBPlayer,104,254,358,8,50,UCBPlayer
8474,UCBPlayer,60,310,370,2,44,UCBPlayer
8475,UCBPlayer,59,324,383,3,40,UCBPlayer
8476,UCBPlayer,82,292,374,6,44,UCBPlayer
8477,UCBPlayer,55,295,350,0,50,UCBPlayer
8478,UCBPlayer,68,308,376,5,43,UCBPlayer
8479,UCBPlayer,57,287,344,0,52,UCBPlayer
8480,UCBPlayer,60,275,335,0,55,UCBPlayer
8481,UCBPlayer,50,315,365,0,45,UCBPlayer
8482,UCBPlayer,53,303,356,0,48,UCBPlayer
8483,UCBPlayer,82,257,339,4,55,UCBPlayer
8484,UCBPlayer,118,273,391,11,40,UCBPlayer
8485,UCBPlayer,45,335,380,0,40,UCBPlayer
8486,UCBPlayer,56,316,372,1,43,UCBPlayer
8487,UCBPlayer,61,296,357,1,48,UCBPlayer
8488,UCBPlayer,54,309,363,1,46,UCBPlayer
8489,UCBPlayer,68,338,406,8,34,UCBPlayer
8490,UCBPlayer,48,323,371,0,43,UCBPlayer
8491,UCBPlayer,56,301,357,1,48,UCBPlayer
8492,UCBPlayer,60,290,350,0,50,UCBPlayer
8493,UCBPlayer,55,295,350,0,50,UCBPlayer
8494,UCBPlayer,51,311,362,0,46,UCBPlayer
8495,UCBPlayer,55,295,350,0,50,UCBPlayer
8496,UCBPlayer,55,305,360,1,47,UCBPlayer
8497,UCBPlayer,60,310,370,2,44,UCBPlayer
8498,UCBPlayer,49,339,388,2,38,UCBPlayer
8499,UCBPlayer,64,284,348,1,51,UCBPlayer
8500,UCBPlayer,66,276,342,1,53,UCBPlayer
8501,UCBPlayer,56,291,347,0,51,UCBPlayer
8502,UCBPlayer,52,307,359,0,47,UCBPlayer
8503,UCBPlayer,64,319,383,6,41,UCBPlayer
8504,UCBPlayer,115,250,365,9,48,UCBPlayer
8505,UCBPlayer,119,254,373,8,45,UCBPlayer
8506,UCBPlayer,78,278,356,3,49,UCBPlayer
8507,UCBPlayer,59,279,338,0,54,UCBPlayer
8508,UCBPlayer,51,311,362,0,46,UCBPlayer
8509,UCBPlayer,61,286,347,3,52,UCBPlayer
8510,UCBPlayer,67,307,374,3,43,UCBPlayer
8511,UCBPlayer,58,293,351,1,50,UCBPlayer
8512,UCBPlayer,65,320,385,5,40,UCBPlayer
8513,UCBPlayer,121,246,367,14,49,UCBPlayer
8514,UCBPlayer,73,278,351,1,50,UCBPlayer
8515,UCBPlayer,83,263,346,5,53,UCBPlayer
8516,UCBPlayer,46,316,362,0,46,UCBPlayer
8517,UCBPlayer,146,226,372,13,47,UCBPlayer
8518,UCBPlayer,64,304,368,3,45,UCBPlayer
8519,UCBPlayer,53,303,356,0,48,UCBPlayer
8520,UCBPlayer,63,288,351,1,50,UCBPlayer
8521,UCBPlayer,48,323,371,0,43,UCBPlayer
8522,UCBPlayer,68,268,336,1,55,UCBPlayer
8523,UCBPlayer,62,312,374,3,43,UCBPlayer
8524,UCBPlayer,50,315,365,0,45,UCBPlayer
8525,UCBPlayer,69,274,343,2,53,UCBPlayer
8526,UCBPlayer,70,270,340,2,54,UCBPlayer
8527,UCBPlayer,65,265,330,1,57,UCBPlayer
8528,UCBPlayer,87,267,354,7,51,UCBPlayer
8529,UCBPlayer,60,290,350,0,50,UCBPlayer
8530,UCBPlayer,127,272,399,13,38,UCBPlayer
8531,UCBPlayer,61,311,372,1,43,UCBPlayer
8532,UCBPlayer,47,327,374,0,42,UCBPlayer
8533,UCBPlayer,55,295,350,0,50,UCBPlayer
8534,UCBPlayer,59,279,338,0,54,UCBPlayer
8535,UCBPlayer,68,288,356,3,49,UCBPlayer
8536,UCBPlayer,65,290,355,2,49,UCBPlayer
8537,UCBPlayer,53,303,356,0,48,UCBPlayer
8538,UCBPlayer,68,278,346,2,52,UCBPlayer
8539,UCBPlayer,62,267,329,0,57,UCBPlayer
8540,UCBPlayer,51,311,362,0,46,UCBPlayer
8541,UCBPlayer,64,294,358,2,48,UCBPlayer
8542,UCBPlayer,84,294,378,4,42,UCBPlayer
8543,UCBPlayer,51,311,362,0,46,UCBPlayer
8544,UCBPlayer,59,279,338,0,54,UCBPlayer
8545,UCBPlayer,57,312,369,1,44,UCBPlayer
8546,UCBPlayer,69,284,353,3,50,UCBPlayer
8547,UCBPlayer,48,323,371,0,43,UCBPlayer
8548,UCBPlayer,54,319,373,2,43,UCBPlayer
8549,UCBPlayer,62,292,354,1,49,UCBPlayer
8550,UCBPlayer,67,272,339,1,54,UCBPlayer
8551,UCBPlayer,71,276,347,3,52,UCBPlayer
8552,UCBPlayer,77,282,359,3,48,UCBPlayer
8553,UCBPlayer,61,296,357,1,48,UCBPlayer
8554,UCBPlayer,58,293,351,1,50,UCBPlayer
8555,UCBPlayer,57,322,379,2,41,UCBPlayer
8556,UCBPlayer,57,302,359,0,47,UCBPlayer
8557,UCBPlayer,52,307,359,0,47,UCBPlayer
8558,UCBPlayer,49,319,368,0,44,UCBPlayer
8559,UCBPlayer,49,319,368,0,44,UCBPlayer
8560,UCBPlayer,57,287,344,0,52,UCBPlayer
8561,UCBPlayer,54,299,353,0,49,UCBPlayer
8562,UCBPlayer,54,304,358,2,48,UCBPlayer
8563,UCBPlayer,82,262,344,3,53,UCBPlayer
8564,UCBPlayer,57,287,344,0,52,UCBPlayer
8565,UCBPlayer,50,325,375,1,42,UCBPlayer
8566,UCBPlayer,82,267,349,2,51,UCBPlayer
8567,UCBPlayer,46,316,362,0,46,UCBPlayer
8568,UCBPlayer,73,318,391,5,38,UCBPlayer
8569,UCBPlayer,61,311,372,1,43,UCBPlayer
8570,UCBPlayer,64,274,338,0,54,UCBPlayer
8571,UCBPlayer,55,295,350,0,50,UCBPlayer
8572,UCBPlayer,51,311,362,0,46,UCBPlayer
8573,UCBPlayer,55,295,350,0,50,UCBPlayer
8574,UCBPlayer,75,310,385,5,40,UCBPlayer
8575,UCBPlayer,55,340,395,3,36,UCBPlayer
8576,UCBPlayer,86,256,342,4,54,UCBPlayer
8577,UCBPlayer,68,258,326,0,58,UCBPlayer
8578,UCBPlayer,58,283,341,0,53,UCBPlayer
8579,UCBPlayer,48,323,371,0,43,UCBPlayer
8580,UCBPlayer,136,256,392,18,42,UCBPlayer
8581,UCBPlayer,50,315,365,0,45,UCBPlayer
8582,UCBPlayer,73,298,371,6,45,UCBPlayer
8583,UCBPlayer,58,298,356,0,48,UCBPlayer
8584,UCBPlayer,58,283,341,0,53,UCBPlayer
8585,UCBPlayer,51,321,372,1,43,UCBPlayer
8586,UCBPlayer,61,296,357,1,48,UCBPlayer
8587,UCBPlayer,49,319,368,0,44,UCBPlayer
8588,UCBPlayer,48,343,391,2,37,UCBPlayer
8589,UCBPlayer,72,277,349,2,51,UCBPlayer
8590,UCBPlayer,59,314,373,2,43,UCBPlayer
8591,UCBPlayer,78,273,351,4,51,UCBPlayer
8592,UCBPlayer,61,291,352,2,50,UCBPlayer
8593,UCBPlayer,71,271,342,1,53,UCBPlayer
8594,UCBPlayer,56,311,367,2,45,UCBPlayer
8595,UCBPlayer,79,279,358,5,49,UCBPlayer
8596,UCBPlayer,64,284,348,1,51,UCBPlayer
8597,UCBPlayer,78,253,331,2,57,UCBPlayer
8598,UCBPlayer,46,331,377,0,41,UCBPlayer
8599,UCBPlayer,66,251,317,0,61,UCBPlayer
8600,UCBPlayer,50,315,365,0,45,UCBPlayer
8601,UCBPlayer,46,341,387,1,38,UCBPlayer
8602,UCBPlayer,61,286,347,0,51,UCBPlayer
8603,UCBPlayer,65,310,375,4,43,UCBPlayer
8604,UCBPlayer,61,296,357,1,48,UCBPlayer
8605,UCBPlayer,74,314,388,5,39,UCBPlayer
8606,UCBPlayer,56,311,367,2,45,UCBPlayer
8607,UCBPlayer,51,336,387,1,38,UCBPlayer
8608,UCBPlayer,72,277,349,2,51,UCBPlayer
8609,UCBPlayer,52,307,359,0,47,UCBPlayer
8610,UCBPlayer,56,301,357,1,48,UCBPlayer
8611,UCBPlayer,56,321,377,3,42,UCBPlayer
8612,UCBPlayer,69,299,368,3,45,UCBPlayer
8613,UCBPlayer,59,289,348,1,51,UCBPlayer
8614,UCBPlayer,68,258,326,0,58,UCBPlayer
8615,UCBPlayer,56,311,367,2,45,UCBPlayer
8616,UCBPlayer,63,288,351,1,50,UCBPlayer
8617,UCBPlayer,58,298,356,0,48,UCBPlayer
8618,UCBPlayer,61,271,332,0,56,UCBPlayer
8619,UCBPlayer,75,290,365,3,46,UCBPlayer
8620,UCBPlayer,65,280,345,1,52,UCBPlayer
8621,UCBPlayer,59,304,363,1,46,UCBPlayer
8622,UCBPlayer,69,294,363,4,47,UCBPlayer
8623,UCBPlayer,61,296,357,1,48,UCBPlayer
8624,UCBPlayer,62,267,329,0,57,UCBPlayer
8625,UCBPlayer,48,323,371,0,43,UCBPlayer
8626,UCBPlayer,55,295,350,0,50,UCBPlayer
8627,UCBPlayer,71,296,367,5,46,UCBPlayer
8628,UCBPlayer,61,306,367,2,45,UCBPlayer
8629,UCBPlayer,56,291,347,0,51,UCBPlayer
8630,UCBPlayer,56,291,347,0,51,UCBPlayer
8631,UCBPlayer,82,277,359,6,49,UCBPlayer
8632,UCBPlayer,58,308,366,1,45,UCBPlayer
8633,UCBPlayer,56,316,372,1,43,UCBPlayer
8634,UCBPlayer,61,271,332,0,56,UCBPlayer
8635,UCBPlayer,54,299,353,0,49,UCBPlayer
8636,UCBPlayer,47,327,374,0,42,UCBPlayer
8637,UCBPlayer,74,299,373,5,44,UCBPlayer
8638,UCBPlayer,68,278,346,2,52,UCBPlayer
8639,UCBPlayer,65,290,355,2,49,UCBPlayer
8640,UCBPlayer,59,304,363,1,46,UCBPlayer
8641,UCBPlayer,46,331,377,0,41,UCBPlayer
8642,UCBPlayer,60,310,370,2,44,UCBPlayer
8643,UCBPlayer,56,291,347,0,51,UCBPlayer
8644,UCBPlayer,67,287,354,1,49,UCBPlayer
8645,UCBPlayer,55,305,360,1,47,UCBPlayer
8646,UCBPlayer,89,289,378,10,44,UCBPlayer
8647,UCBPlayer,58,298,356,0,48,UCBPlayer
8648,UCBPlayer,64,319,383,3,40,UCBPlayer
8649,UCBPlayer,72,307,379,5,42,UCBPlayer
8650,UCBPlayer,61,271,332,0,56,UCBPlayer
8651,UCBPlayer,54,314,368,0,44,UCBPlayer
8652,UCBPlayer,54,299,353,0,49,UCBPlayer
8653,UCBPlayer,51,311,362,0,46,UCBPlayer
8654,UCBPlayer,59,319,378,4,42,UCBPlayer
8655,UCBPlayer,103,248,351,7,52,UCBPlayer
8656,UCBPlayer,79,294,373,5,44,UCBPlayer
8657,UCBPlayer,66,296,362,3,47,UCBPlayer
8658,UCBPlayer,74,284,358,5,49,UCBPlayer
8659,UCBPlayer,65,285,350,0,50,UCBPlayer
8660,UCBPlayer,73,263,336,1,55,UCBPlayer
8661,UCBPlayer,50,330,380,0,40,UCBPlayer
8662,UCBPlayer,57,287,344,0,52,UCBPlayer
8663,UCBPlayer,80,265,345,4,53,UCBPlayer
8664,UCBPlayer,52,307,359,0,47,UCBPlayer
8665,UCBPlayer,67,297,364,5,47,UCBPlayer
8666,UCBPlayer,105,270,375,10,45,UCBPlayer
8667,UCBPlayer,67,267,334,2,56,UCBPlayer
8668,UCBPlayer,83,268,351,4,51,UCBPlayer
8669,UCBPlayer,58,298,356,0,48,UCBPlayer
8670,UCBPlayer,117,267,384,13,43,UCBPlayer
8671,UCBPlayer,54,299,353,0,49,UCBPlayer
8672,UCBPlayer,56,291,347,0,51,UCBPlayer
8673,UCBPlayer,55,295,350,0,50,UCBPlayer
8674,UCBPlayer,58,283,341,0,53,UCBPlayer
8675,UCBPlayer,46,331,377,0,41,UCBPlayer
8676,UCBPlayer,66,296,362,3,47,UCBPlayer
8677,UCBPlayer,52,307,359,0,47,UCBPlayer
8678,UCBPlayer,57,287,344,0,52,UCBPlayer
8679,UCBPlayer,68,278,346,2,52,UCBPlayer
8680,UCBPlayer,56,326,382,2,40,UCBPlayer
8681,UCBPlayer,56,291,347,0,51,UCBPlayer
8682,UCBPlayer,59,304,363,1,46,UCBPlayer
8683,UCBPlayer,78,273,351,4,51,UCBPlayer
8684,UCBPlayer,56,291,347,0,51,UCBPlayer
8685,UCBPlayer,51,311,362,0,46,UCBPlayer
8686,UCBPlayer,56,291,347,0,51,UCBPlayer
8687,UCBPlayer,49,319,368,0,44,UCBPlayer
8688,UCBPlayer,66,261,327,1,58,UCBPlayer
8689,UCBPlayer,49,319,368,0,44,UCBPlayer
8690,UCBPlayer,52,307,359,0,47,UCBPlayer
8691,UCBPlayer,56,301,357,1,48,UCBPlayer
8692,UCBPlayer,60,290,350,0,50,UCBPlayer
8693,UCBPlayer,51,311,362,0,46,UCBPlayer
8694,UCBPlayer,58,318,376,2,42,UCBPlayer
8695,UCBPlayer,59,279,338,0,54,UCBPlayer
8696,UCBPlayer,54,299,353,0,49,UCBPlayer
8697,UCBPlayer,55,295,350,0,50,UCBPlayer
8698,UCBPlayer,65,290,355,2,49,UCBPlayer
8699,UCBPlayer,52,307,359,0,47,UCBPlayer
8700,UCBPlayer,58,283,341,0,53,UCBPlayer
8701,UCBPlayer,59,279,338,0,54,UCBPlayer
8702,UCBPlayer,100,260,360,7,49,UCBPlayer
8703,UCBPlayer,81,291,372,4,44,UCBPlayer
8704,UCBPlayer,61,306,367,2,45,UCBPlayer
8705,UCBPlayer,59,279,338,0,54,UCBPlayer
8706,UCBPlayer,56,291,347,0,51,UCBPlayer
8707,UCBPlayer,75,275,350,6,52,UCBPlayer
8708,UCBPlayer,75,305,380,6,42,UCBPlayer
8709,UCBPlayer,67,272,339,1,54,UCBPlayer
8710,UCBPlayer,60,300,360,1,47,UCBPlayer
8711,UCBPlayer,55,310,365,0,45,UCBPlayer
8712,UCBPlayer,56,301,357,1,48,UCBPlayer
8713,UCBPlayer,98,268,366,7,47,UCBPlayer
8714,UCBPlayer,65,310,375,4,43,UCBPlayer
8715,UCBPlayer,71,291,362,3,47,UCBPlayer
8716,UCBPlayer,137,272,409,17,36,UCBPlayer
8717,UCBPlayer,58,298,356,0,48,UCBPlayer
8718,UCBPlayer,55,305,360,1,47,UCBPlayer
8719,UCBPlayer,53,313,366,1,45,UCBPlayer
8720,UCBPlayer,105,255,360,7,49,UCBPlayer
8721,UCBPlayer,146,256,402,19,39,UCBPlayer
8722,UCBPlayer,80,285,365,6,47,UCBPlayer
8723,UCBPlayer,82,287,369,7,46,UCBPlayer
8724,UCBPlayer,58,283,341,0,53,UCBPlayer
8725,UCBPlayer,50,315,365,0,45,UCBPlayer
8726,UCBPlayer,45,335,380,0,40,UCBPlayer
8727,UCBPlayer,54,299,353,0,49,UCBPlayer
8728,UCBPlayer,73,263,336,1,55,UCBPlayer
8729,UCBPlayer,60,275,335,0,55,UCBPlayer
8730,UCBPlayer,77,292,369,4,45,UCBPlayer
8731,UCBPlayer,62,267,329,0,57,UCBPlayer
8732,UCBPlayer,78,253,331,2,57,UCBPlayer
8733,UCBPlayer,56,291,347,0,51,UCBPlayer
8734,UCBPlayer,50,315,365,0,45,UCBPlayer
8735,UCBPlayer,53,303,356,0,48,UCBPlayer
8736,UCBPlayer,52,317,369,1,44,UCBPlayer
8737,UCBPlayer,64,294,358,2,48,UCBPlayer
8738,UCBPlayer,58,308,366,1,45,UCBPlayer
8739,UCBPlayer,51,311,362,0,46,UCBPlayer
8740,UCBPlayer,69,274,343,2,53,UCBPlayer
8741,UCBPlayer,51,311,362,0,46,UCBPlayer
8742,UCBPlayer,50,315,365,0,45,UCBPlayer
8743,UCBPlayer,68,258,326,0,58,UCBPlayer
8744,UCBPlayer,52,307,359,0,47,UCBPlayer
8745,UCBPlayer,89,294,383,6,41,UCBPlayer
8746,UCBPlayer,62,267,329,0,57,UCBPlayer
8747,UCBPlayer,46,331,377,0,41,UCBPlayer
8748,UCBPlayer,82,262,344,6,54,UCBPlayer
8749,UCBPlayer,54,299,353,0,49,UCBPlayer
8750,UCBPlayer,151,211,362,15,51,UCBPlayer
8751,UCBPlayer,89,274,363,7,48,UCBPlayer
8752,UCBPlayer,59,279,338,0,54,UCBPlayer
8753,UCBPlayer,46,331,377,0,41,UCBPlayer
8754,UCBPlayer,90,265,355,5,50,UCBPlayer
8755,UCBPlayer,142,237,379,17,46,UCBPlayer
8756,UCBPlayer,59,339,398,3,35,UCBPlayer
8757,UCBPlayer,54,309,363,1,46,UCBPlayer
8758,UCBPlayer,120,225,345,10,55,UCBPlayer
8759,UCBPlayer,58,308,366,1,45,UCBPlayer
8760,UCBPlayer,62,287,349,2,51,UCBPlayer
8761,UCBPlayer,84,279,363,7,48,UCBPlayer
8762,UCBPlayer,55,310,365,0,45,UCBPlayer
8763,UCBPlayer,73,283,356,3,49,UCBPlayer
8764,UCBPlayer,58,298,356,0,48,UCBPlayer
8765,UCBPlayer,58,298,356,3,49,UCBPlayer
8766,UCBPlayer,63,303,366,1,45,UCBPlayer
8767,UCBPlayer,58,293,351,1,50,UCBPlayer
8768,UCBPlayer,65,300,365,3,46,UCBPlayer
8769,UCBPlayer,90,275,365,3,46,UCBPlayer
8770,UCBPlayer,56,291,347,0,51,UCBPlayer
8771,UCBPlayer,45,320,365,0,45,UCBPlayer
8772,UCBPlayer,69,264,333,1,56,UCBPlayer
8773,UCBPlayer,67,262,329,0,57,UCBPlayer
8774,UCBPlayer,63,308,371,3,44,UCBPlayer
8775,UCBPlayer,53,303,356,0,48,UCBPlayer
8776,UCBPlayer,51,311,362,0,46,UCBPlayer
8777,UCBPlayer,52,307,359,0,47,UCBPlayer
8778,UCBPlayer,69,279,348,1,51,UCBPlayer
8779,UCBPlayer,93,298,391,11,40,UCBPlayer
8780,UCBPlayer,54,299,353,0,49,UCBPlayer
8781,UCBPlayer,67,272,339,1,54,UCBPlayer
8782,UCBPlayer,60,275,335,0,55,UCBPlayer
8783,UCBPlayer,73,278,351,4,51,UCBPlayer
8784,UCBPlayer,92,262,354,7,51,UCBPlayer
8785,UCBPlayer,51,311,362,0,46,UCBPlayer
8786,UCBPlayer,66,296,362,3,47,UCBPlayer
8787,UCBPlayer,65,270,335,0,55,UCBPlayer
8788,UCBPlayer,85,275,360,4,48,UCBPlayer
8789,UCBPlayer,54,299,353,0,49,UCBPlayer
8790,UCBPlayer,118,288,406,14,36,UCBPlayer
8791,UCBPlayer,55,315,370,2,44,UCBPlayer
8792,UCBPlayer,66,296,362,3,47,UCBPlayer
8793,UCBPlayer,55,295,350,0,50,UCBPlayer
8794,UCBPlayer,79,304,383,6,41,UCBPlayer
8795,UCBPlayer,52,307,359,0,47,UCBPlayer
8796,UCBPlayer,64,304,368,3,45,UCBPlayer
8797,UCBPlayer,79,259,338,3,55,UCBPlayer
8798,UCBPlayer,62,267,329,0,57,UCBPlayer
8799,UCBPlayer,64,284,348,1,51,UCBPlayer
8800,UCBPlayer,53,303,356,0,48,UCBPlayer
8801,UCBPlayer,56,291,347,0,51,UCBPlayer
8802,UCBPlayer,65,310,375,4,43,UCBPlayer
8803,UCBPlayer,50,315,365,0,45,UCBPlayer
8804,UCBPlayer,50,325,375,1,42,UCBPlayer
8805,UCBPlayer,57,302,359,0,47,UCBPlayer
8806,UCBPlayer,55,335,390,4,38,UCBPlayer
8807,UCBPlayer,76,291,367,5,46,UCBPlayer
8808,UCBPlayer,60,310,370,2,44,UCBPlayer
8809,UCBPlayer,65,320,385,5,40,UCBPlayer
8810,UCBPlayer,77,277,354,4,50,UCBPlayer
8811,UCBPlayer,69,299,368,3,45,UCBPlayer
8812,UCBPlayer,115,240,355,11,52,UCBPlayer
8813,UCBPlayer,68,283,351,1,50,UCBPlayer
8814,UCBPlayer,76,261,337,2,55,UCBPlayer
8815,UCBPlayer,69,264,333,1,56,UCBPlayer
8816,UCBPlayer,64,299,363,4,47,UCBPlayer
8817,UCBPlayer,59,294,353,0,49,UCBPlayer
8818,UCBPlayer,51,321,372,1,43,UCBPlayer
8819,UCBPlayer,58,323,381,4,41,UCBPlayer
8820,UCBPlayer,73,278,351,1,50,UCBPlayer
8821,UCBPlayer,55,290,345,1,52,UCBPlayer
8822,UCBPlayer,74,259,333,1,56,UCBPlayer
8823,UCBPlayer,58,283,341,0,53,UCBPlayer
8824,UCBPlayer,57,287,344,0,52,UCBPlayer
8825,UCBPlayer,56,291,347,0,51,UCBPlayer
8826,UCBPlayer,75,305,380,6,42,UCBPlayer
8827,UCBPlayer,149,264,413,15,34,UCBPlayer
8828,UCBPlayer,52,307,359,0,47,UCBPlayer
8829,UCBPlayer,51,311,362,0,46,UCBPlayer
8830,UCBPlayer,89,269,358,8,50,UCBPlayer
8831,UCBPlayer,47,327,374,0,42,UCBPlayer
8832,UCBPlayer,52,307,359,0,47,UCBPlayer
8833,UCBPlayer,58,308,366,1,45,UCBPlayer
8834,UCBPlayer,64,304,368,3,45,UCBPlayer
8835,UCBPlayer,41,351,392,0,36,UCBPlayer
8836,UCBPlayer,53,313,366,1,45,UCBPlayer
8837,UCBPlayer,73,273,346,2,52,UCBPlayer
8838,UCBPlayer,104,259,363,10,49,UCBPlayer
8839,UCBPlayer,54,299,353,0,49,UCBPlayer
8840,UCBPlayer,80,275,355,5,50,UCBPlayer
8841,UCBPlayer,94,289,383,12,43,UCBPlayer
8842,UCBPlayer,66,311,377,3,42,UCBPlayer
8843,UCBPlayer,139,254,393,13,40,UCBPlayer
8844,UCBPlayer,52,307,359,0,47,UCBPlayer
8845,UCBPlayer,59,279,338,0,54,UCBPlayer
8846,UCBPlayer,63,308,371,3,44,UCBPlayer
8847,UCBPlayer,50,315,365,0,45,UCBPlayer
8848,UCBPlayer,123,258,381,13,44,UCBPlayer
8849,UCBPlayer,64,259,323,0,59,UCBPlayer
8850,UCBPlayer,84,264,348,4,52,UCBPlayer
8851,UCBPlayer,55,295,350,0,50,UCBPlayer
8852,UCBPlayer,53,313,366,1,45,UCBPlayer
8853,UCBPlayer,79,284,363,4,47,UCBPlayer
8854,UCBPlayer,56,291,347,0,51,UCBPlayer
8855,UCBPlayer,58,283,341,0,53,UCBPlayer
8856,UCBPlayer,51,311,362,0,46,UCBPlayer
8857,UCBPlayer,56,301,357,1,48,UCBPlayer
8858,UCBPlayer,53,318,371,0,43,UCBPlayer
8859,UCBPlayer,59,279,338,0,54,UCBPlayer
8860,UCBPlayer,61,296,357,1,48,UCBPlayer
8861,UCBPlayer,62,287,349,2,51,UCBPlayer
8862,UCBPlayer,62,282,344,0,52,UCBPlayer
8863,UCBPlayer,65,300,365,6,47,UCBPlayer
8864,UCBPlayer,84,249,333,1,56,UCBPlayer
8865,UCBPlayer,64,299,363,1,46,UCBPlayer
8866,UCBPlayer,60,275,335,0,55,UCBPlayer
8867,UCBPlayer,60,305,365,3,46,UCBPlayer
8868,UCBPlayer,58,298,356,0,48,UCBPlayer
8869,UCBPlayer,53,303,356,0,48,UCBPlayer
8870,UCBPlayer,51,311,362,0,46,UCBPlayer
8871,UCBPlayer,46,331,377,0,41,UCBPlayer
8872,UCBPlayer,53,298,351,1,50,UCBPlayer
8873,UCBPlayer,92,247,339,4,55,UCBPlayer
8874,UCBPlayer,51,311,362,0,46,UCBPlayer
8875,UCBPlayer,60,275,335,0,55,UCBPlayer
8876,UCBPlayer,61,316,377,3,42,UCBPlayer
8877,UCBPlayer,68,258,326,0,58,UCBPlayer
8878,UCBPlayer,50,315,365,0,45,UCBPlayer
8879,UCBPlayer,51,311,362,0,46,UCBPlayer
8880,UCBPlayer,57,287,344,0,52,UCBPlayer
8881,UCBPlayer,96,261,357,7,50,UCBPlayer
8882,UCBPlayer,70,280,350,3,51,UCBPlayer
8883,UCBPlayer,67,282,349,2,51,UCBPlayer
8884,UCBPlayer,56,291,347,0,51,UCBPlayer
8885,UCBPlayer,51,311,362,0,46,UCBPlayer
8886,UCBPlayer,76,291,367,5,46,UCBPlayer
8887,UCBPlayer,71,256,327,1,58,UCBPlayer
8888,UCBPlayer,61,306,367,2,45,UCBPlayer
8889,UCBPlayer,56,291,347,0,51,UCBPlayer
8890,UCBPlayer,51,311,362,0,46,UCBPlayer
8891,UCBPlayer,52,307,359,0,47,UCBPlayer
8892,UCBPlayer,60,300,360,1,47,UCBPlayer
8893,UCBPlayer,47,327,374,0,42,UCBPlayer
8894,UCBPlayer,108,273,381,7,42,UCBPlayer
8895,UCBPlayer,94,299,393,10,39,UCBPlayer
8896,UCBPlayer,51,311,362,0,46,UCBPlayer
8897,UCBPlayer,47,327,374,0,42,UCBPlayer
8898,UCBPlayer,53,303,356,0,48,UCBPlayer
8899,UCBPlayer,49,319,368,0,44,UCBPlayer
8900,UCBPlayer,70,300,370,5,45,UCBPlayer
8901,UCBPlayer,50,315,365,0,45,UCBPlayer
8902,UCBPlayer,63,298,361,2,47,UCBPlayer
8903,UCBPlayer,57,317,374,3,43,UCBPlayer
8904,UCBPlayer,74,284,358,2,48,UCBPlayer
8905,UCBPlayer,104,279,383,12,43,UCBPlayer
8906,UCBPlayer,65,315,380,6,42,UCBPlayer
8907,UCBPlayer,66,281,347,0,51,UCBPlayer
8908,UCBPlayer,129,274,403,20,39,UCBPlayer
8909,UCBPlayer,77,277,354,1,49,UCBPlayer
8910,UCBPlayer,61,296,357,1,48,UCBPlayer
8911,UCBPlayer,55,295,350,0,50,UCBPlayer
8912,UCBPlayer,67,272,339,1,54,UCBPlayer
8913,UCBPlayer,54,319,373,2,43,UCBPlayer
8914,UCBPlayer,76,266,342,1,53,UCBPlayer
8915,UCBPlayer,56,291,347,0,51,UCBPlayer
8916,UCBPlayer,60,275,335,0,55,UCBPlayer
8917,UCBPlayer,73,263,336,1,55,UCBPlayer
8918,UCBPlayer,78,308,386,6,40,UCBPlayer
8919,UCBPlayer,68,283,351,1,50,UCBPlayer
8920,UCBPlayer,71,281,352,5,51,UCBPlayer
8921,UCBPlayer,90,290,380,6,42,UCBPlayer
8922,UCBPlayer,67,297,364,2,46,UCBPlayer
8923,UCBPlayer,51,311,362,0,46,UCBPlayer
8924,UCBPlayer,45,320,365,0,45,UCBPlayer
8925,UCBPlayer,65,290,355,2,49,UCBPlayer
8926,UCBPlayer,53,303,356,0,48,UCBPlayer
8927,UCBPlayer,58,283,341,0,53,UCBPlayer
8928,UCBPlayer,91,296,387,7,40,UCBPlayer
8929,UCBPlayer,88,303,391,8,39,UCBPlayer
8930,UCBPlayer,63,308,371,3,44,UCBPlayer
8931,UCBPlayer,66,311,377,3,42,UCBPlayer
8932,UCBPlayer,62,267,329,0,57,UCBPlayer
8933,UCBPlayer,99,284,383,9,42,UCBPlayer
8934,UCBPlayer,58,283,341,0,53,UCBPlayer
8935,UCBPlayer,48,323,371,0,43,UCBPlayer
8936,UCBPlayer,68,268,336,1,55,UCBPlayer
8937,UCBPlayer,46,331,377,0,41,UCBPlayer
8938,UCBPlayer,54,299,353,0,49,UCBPlayer
8939,UCBPlayer,120,255,375,13,46,UCBPlayer
8940,UCBPlayer,50,315,365,0,45,UCBPlayer
8941,UCBPlayer,51,311,362,0,46,UCBPlayer
8942,UCBPlayer,70,285,355,2,49,UCBPlayer
8943,UCBPlayer,52,317,369,1,44,UCBPlayer
8944,UCBPlayer,69,299,368,3,45,UCBPlayer
8945,UCBPlayer,68,288,356,3,49,UCBPlayer
8946,UCBPlayer,56,291,347,0,51,UCBPlayer
8947,UCBPlayer,53,313,366,1,45,UCBPlayer
8948,UCBPlayer,88,303,391,5,38,UCBPlayer
8949,UCBPlayer,191,221,412,23,37,UCBPlayer
8950,UCBPlayer,55,310,365,0,45,UCBPlayer
8951,UCBPlayer,55,315,370,2,44,UCBPlayer
8952,UCBPlayer,65,270,335,0,55,UCBPlayer
8953,UCBPlayer,66,296,362,3,47,UCBPlayer
8954,UCBPlayer,56,301,357,1,48,UCBPlayer
8955,UCBPlayer,64,284,348,1,51,UCBPlayer
8956,UCBPlayer,63,293,356,3,49,UCBPlayer
8957,UCBPlayer,60,310,370,2,44,UCBPlayer
8958,UCBPlayer,73,308,381,7,42,UCBPlayer
8959,UCBPlayer,69,289,358,2,48,UCBPlayer
8960,UCBPlayer,53,313,366,1,45,UCBPlayer
8961,UCBPlayer,73,283,356,3,49,UCBPlayer
8962,UCBPlayer,53,303,356,0,48,UCBPlayer
8963,UCBPlayer,66,286,352,2,50,UCBPlayer
8964,UCBPlayer,79,279,358,5,49,UCBPlayer
8965,UCBPlayer,71,281,352,2,50,UCBPlayer
8966,UCBPlayer,56,291,347,0,51,UCBPlayer
8967,UCBPlayer,66,261,327,1,58,UCBPlayer
8968,UCBPlayer,54,299,353,0,49,UCBPlayer
8969,UCBPlayer,52,307,359,0,47,UCBPlayer
8970,UCBPlayer,51,311,362,0,46,UCBPlayer
8971,UCBPlayer,43,343,386,0,38,UCBPlayer
8972,UCBPlayer,56,321,377,3,42,UCBPlayer
8973,UCBPlayer,98,248,346,5,53,UCBPlayer
8974,UCBPlayer,60,300,360,1,47,UCBPlayer
8975,UCBPlayer,62,292,354,1,49,UCBPlayer
8976,UCBPlayer,55,295,350,0,50,UCBPlayer
8977,UCBPlayer,53,303,356,0,48,UCBPlayer
8978,UCBPlayer,83,243,326,3,59,UCBPlayer
8979,UCBPlayer,55,325,380,3,41,UCBPlayer
8980,UCBPlayer,89,274,363,7,48,UCBPlayer
8981,UCBPlayer,58,283,341,0,53,UCBPlayer
8982,UCBPlayer,61,306,367,2,45,UCBPlayer
8983,UCBPlayer,72,262,334,2,56,UCBPlayer
8984,UCBPlayer,77,287,364,5,47,UCBPlayer
8985,UCBPlayer,73,283,356,3,49,UCBPlayer
8986,UCBPlayer,67,292,359,3,48,UCBPlayer
8987,UCBPlayer,52,307,359,0,47,UCBPlayer
8988,UCBPlayer,66,266,332,0,56,UCBPlayer
8989,UCBPlayer,53,303,356,0,48,UCBPlayer
8990,UCBPlayer,64,309,373,2,43,UCBPlayer
8991,UCBPlayer,108,253,361,8,49,UCBPlayer
8992,UCBPlayer,60,275,335,0,55,UCBPlayer
8993,UCBPlayer,72,287,359,3,48,UCBPlayer
8994,UCBPlayer,143,263,406,14,36,UCBPlayer
8995,UCBPlayer,74,264,338,3,55,UCBPlayer
8996,UCBPlayer,43,343,386,0,38,UCBPlayer
8997,UCBPlayer,123,258,381,13,44,UCBPlayer
8998,UCBPlayer,61,296,357,1,48,UCBPlayer
8999,UCBPlayer,51,311,362,0,46,UCBPlayer
9000,UCBPlayer,181,236,417,25,36,UCBPlayer
9001,UCBPlayer,54,299,353,0,49,UCBPlayer
9002,UCBPlayer,64,304,368,3,45,UCBPlayer
9003,UCBPlayer,51,311,362,0,46,UCBPlayer
9004,UCBPlayer,51,311,362,0,46,UCBPlayer
9005,UCBPlayer,79,254,333,1,56,UCBPlayer
9006,UCBPlayer,49,319,368,0,44,UCBPlayer
9007,UCBPlayer,59,279,338,0,54,UCBPlayer
9008,UCBPlayer,51,311,362,0,46,UCBPlayer
9009,UCBPlayer,66,306,372,4,44,UCBPlayer
9010,UCBPlayer,62,282,344,0,52,UCBPlayer
9011,UCBPlayer,63,278,341,0,53,UCBPlayer
9012,UCBPlayer,74,294,368,3,45,UCBPlayer
9013,UCBPlayer,63,298,361,2,47,UCBPlayer
9014,UCBPlayer,56,311,367,2,45,UCBPlayer
9015,UCBPlayer,88,293,381,10,43,UCBPlayer
9016,UCBPlayer,58,293,351,1,50,UCBPlayer
9017,UCBPlayer,47,327,374,0,42,UCBPlayer
9018,UCBPlayer,62,292,354,1,49,UCBPlayer
9019,UCBPlayer,65,305,370,2,44,UCBPlayer
9020,UCBPlayer,55,305,360,1,47,UCBPlayer
9021,UCBPlayer,68,298,366,4,46,UCBPlayer
9022,UCBPlayer,54,309,363,1,46,UCBPlayer
9023,UCBPlayer,80,275,355,5,50,UCBPlayer
9024,UCBPlayer,58,328,386,3,39,UCBPlayer
9025,UCBPlayer,93,278,371,6,45,UCBPlayer
9026,UCBPlayer,64,259,323,0,59,UCBPlayer
9027,UCBPlayer,52,307,359,0,47,UCBPlayer
9028,UCBPlayer,55,295,350,0,50,UCBPlayer
9029,UCBPlayer,48,323,371,0,43,UCBPlayer
9030,UCBPlayer,57,287,344,0,52,UCBPlayer
9031,UCBPlayer,96,286,382,8,42,UCBPlayer
9032,UCBPlayer,62,302,364,2,46,UCBPlayer
9033,UCBPlayer,89,259,348,4,52,UCBPlayer
9034,UCBPlayer,62,267,329,0,57,UCBPlayer
9035,UCBPlayer,54,299,353,0,49,UCBPlayer
9036,UCBPlayer,46,331,377,0,41,UCBPlayer
9037,UCBPlayer,68,328,396,7,37,UCBPlayer
9038,UCBPlayer,70,260,330,1,57,UCBPlayer
9039,UCBPlayer,54,299,353,0,49,UCBPlayer
9040,UCBPlayer,48,323,371,0,43,UCBPlayer
9041,UCBPlayer,67,302,369,4,45,UCBPlayer
9042,UCBPlayer,46,331,377,0,41,UCBPlayer
9043,UCBPlayer,79,294,373,5,44,UCBPlayer
9044,UCBPlayer,53,303,356,0,48,UCBPlayer
9045,UCBPlayer,56,291,347,0,51,UCBPlayer
9046,UCBPlayer,63,278,341,0,53,UCBPlayer
9047,UCBPlayer,73,248,321,1,60,UCBPlayer
9048,UCBPlayer,49,319,368,0,44,UCBPlayer
9049,UCBPlayer,65,300,365,3,46,UCBPlayer
9050,UCBPlayer,50,325,375,1,42,UCBPlayer
9051,UCBPlayer,60,300,360,1,47,UCBPlayer
9052,UCBPlayer,52,317,369,1,44,UCBPlayer
9053,UCBPlayer,78,253,331,2,57,UCBPlayer
9054,UCBPlayer,63,263,326,0,58,UCBPlayer
9055,UCBPlayer,83,268,351,4,51,UCBPlayer
9056,UCBPlayer,60,300,360,1,47,UCBPlayer
9057,UCBPlayer,58,283,341,0,53,UCBPlayer
9058,UCBPlayer,53,303,356,0,48,UCBPlayer
9059,UCBPlayer,51,341,392,3,37,UCBPlayer
9060,UCBPlayer,71,306,377,6,43,UCBPlayer
9061,UCBPlayer,81,246,327,1,58,UCBPlayer
9062,UCBPlayer,109,289,398,15,39,UCBPlayer
9063,UCBPlayer,54,299,353,0,49,UCBPlayer
9064,UCBPlayer,56,301,357,1,48,UCBPlayer
9065,UCBPlayer,57,312,369,1,44,UCBPlayer
9066,UCBPlayer,59,289,348,1,51,UCBPlayer
9067,UCBPlayer,68,258,326,0,58,UCBPlayer
9068,UCBPlayer,70,315,385,5,40,UCBPlayer
9069,UCBPlayer,56,301,357,1,48,UCBPlayer
9070,UCBPlayer,59,304,363,1,46,UCBPlayer
9071,UCBPlayer,48,323,371,0,43,UCBPlayer
9072,UCBPlayer,64,274,338,0,54,UCBPlayer
9073,UCBPlayer,63,288,351,1,50,UCBPlayer
9074,UCBPlayer,48,323,371,0,43,UCBPlayer
9075,UCBPlayer,53,303,356,0,48,UCBPlayer
9076,UCBPlayer,53,303,356,0,48,UCBPlayer
9077,UCBPlayer,50,300,350,0,50,UCBPlayer
9078,UCBPlayer,67,302,369,4,45,UCBPlayer
9079,UCBPlayer,105,260,365,12,49,UCBPlayer
9080,UCBPlayer,54,299,353,0,49,UCBPlayer
9081,UCBPlayer,72,322,394,8,38,UCBPlayer
9082,UCBPlayer,96,301,397,11,38,UCBPlayer
9083,UCBPlayer,58,283,341,0,53,UCBPlayer
9084,UCBPlayer,65,280,345,1,52,UCBPlayer
9085,UCBPlayer,56,291,347,0,51,UCBPlayer
9086,UCBPlayer,51,311,362,0,46,UCBPlayer
9087,UCBPlayer,96,291,387,10,41,UCBPlayer
9088,UCBPlayer,85,270,355,5,50,UCBPlayer
9089,UCBPlayer,58,283,341,0,53,UCBPlayer
9090,UCBPlayer,114,264,378,13,45,UCBPlayer
9091,UCBPlayer,63,288,351,1,50,UCBPlayer
9092,UCBPlayer,67,272,339,1,54,UCBPlayer
9093,UCBPlayer,72,262,334,2,56,UCBPlayer
9094,UCBPlayer,53,318,371,0,43,UCBPlayer
9095,UCBPlayer,61,271,332,0,56,UCBPlayer
9096,UCBPlayer,71,296,367,2,45,UCBPlayer
9097,UCBPlayer,47,327,374,0,42,UCBPlayer
9098,UCBPlayer,58,283,341,0,53,UCBPlayer
9099,UCBPlayer,61,306,367,2,45,UCBPlayer
9100,UCBPlayer,60,275,335,0,55,UCBPlayer
9101,UCBPlayer,67,282,349,2,51,UCBPlayer
9102,UCBPlayer,64,304,368,3,45,UCBPlayer
9103,UCBPlayer,53,303,356,0,48,UCBPlayer
9104,UCBPlayer,82,267,349,5,52,UCBPlayer
9105,UCBPlayer,54,299,353,0,49,UCBPlayer
9106,UCBPlayer,50,315,365,0,45,UCBPlayer
9107,UCBPlayer,69,304,373,5,44,UCBPlayer
9108,UCBPlayer,54,299,353,0,49,UCBPlayer
9109,UCBPlayer,55,295,350,0,50,UCBPlayer
9110,UCBPlayer,49,319,368,0,44,UCBPlayer
9111,UCBPlayer,75,285,360,4,48,UCBPlayer
9112,UCBPlayer,67,292,359,3,48,UCBPlayer
9113,UCBPlayer,50,315,365,0,45,UCBPlayer
9114,UCBPlayer,58,303,361,2,47,UCBPlayer
9115,UCBPlayer,55,310,365,0,45,UCBPlayer
9116,UCBPlayer,51,311,362,0,46,UCBPlayer
9117,UCBPlayer,62,317,379,5,42,UCBPlayer
9118,UCBPlayer,69,289,358,2,48,UCBPlayer
9119,UCBPlayer,59,289,348,1,51,UCBPlayer
9120,UCBPlayer,71,296,367,2,45,UCBPlayer
9121,UCBPlayer,53,303,356,0,48,UCBPlayer
9122,UCBPlayer,51,311,362,0,46,UCBPlayer
9123,UCBPlayer,58,303,361,2,47,UCBPlayer
9124,UCBPlayer,65,290,355,2,49,UCBPlayer
9125,UCBPlayer,49,319,368,0,44,UCBPlayer
9126,UCBPlayer,54,309,363,1,46,UCBPlayer
9127,UCBPlayer,56,336,392,3,37,UCBPlayer
9128,UCBPlayer,55,310,365,0,45,UCBPlayer
9129,UCBPlayer,117,272,389,15,42,UCBPlayer
9130,UCBPlayer,57,287,344,0,52,UCBPlayer
9131,UCBPlayer,57,287,344,0,52,UCBPlayer
9132,UCBPlayer,46,331,377,0,41,UCBPlayer
9133,UCBPlayer,51,311,362,0,46,UCBPlayer
9134,UCBPlayer,87,267,354,4,50,UCBPlayer
9135,UCBPlayer,57,312,369,1,44,UCBPlayer
9136,UCBPlayer,60,310,370,2,44,UCBPlayer
9137,UCBPlayer,97,287,384,7,41,UCBPlayer
9138,UCBPlayer,76,301,377,6,43,UCBPlayer
9139,UCBPlayer,71,256,327,1,58,UCBPlayer
9140,UCBPlayer,43,343,386,0,38,UCBPlayer
9141,UCBPlayer,121,276,397,14,39,UCBPlayer
9142,UCBPlayer,57,287,344,0,52,UCBPlayer
9143,UCBPlayer,62,307,369,1,44,UCBPlayer
9144,UCBPlayer,55,320,375,1,42,UCBPlayer
9145,UCBPlayer,93,278,371,9,46,UCBPlayer
9146,UCBPlayer,88,263,351,4,51,UCBPlayer
9147,UCBPlayer,60,300,360,1,47,UCBPlayer
9148,UCBPlayer,59,279,338,0,54,UCBPlayer
9149,UCBPlayer,96,281,377,6,43,UCBPlayer
9150,UCBPlayer,67,272,339,1,54,UCBPlayer
9151,UCBPlayer,57,287,344,0,52,UCBPlayer
9152,UCBPlayer,52,307,359,0,47,UCBPlayer
9153,UCBPlayer,69,284,353,3,50,UCBPlayer
9154,UCBPlayer,56,291,347,0,51,UCBPlayer
9155,UCBPlayer,74,274,348,4,52,UCBPlayer
9156,UCBPlayer,57,287,344,0,52,UCBPlayer
9157,UCBPlayer,68,278,346,2,52,UCBPlayer
9158,UCBPlayer,63,278,341,0,53,UCBPlayer
9159,UCBPlayer,71,286,357,4,49,UCBPlayer
9160,UCBPlayer,51,311,362,0,46,UCBPlayer
9161,UCBPlayer,62,292,354,1,49,UCBPlayer
9162,UCBPlayer,69,269,338,3,55,UCBPlayer
9163,UCBPlayer,71,286,357,1,48,UCBPlayer
9164,UCBPlayer,62,312,374,3,43,UCBPlayer
9165,UCBPlayer,52,317,369,1,44,UCBPlayer
9166,UCBPlayer,60,310,370,2,44,UCBPlayer
9167,UCBPlayer,61,306,367,2,45,UCBPlayer
9168,UCBPlayer,47,327,374,0,42,UCBPlayer
9169,UCBPlayer,59,279,338,0,54,UCBPlayer
9170,UCBPlayer,55,295,350,0,50,UCBPlayer
9171,UCBPlayer,56,291,347,0,51,UCBPlayer
9172,UCBPlayer,53,303,356,0,48,UCBPlayer
9173,UCBPlayer,53,303,356,0,48,UCBPlayer
9174,UCBPlayer,56,301,357,1,48,UCBPlayer
9175,UCBPlayer,44,339,383,0,39,UCBPlayer
9176,UCBPlayer,56,291,347,0,51,UCBPlayer
9177,UCBPlayer,58,293,351,1,50,UCBPlayer
9178,UCBPlayer,73,263,336,1,55,UCBPlayer
9179,UCBPlayer,40,340,380,0,40,UCBPlayer
9180,UCBPlayer,84,264,348,4,52,UCBPlayer
9181,UCBPlayer,64,274,338,0,54,UCBPlayer
9182,UCBPlayer,133,258,391,14,41,UCBPlayer
9183,UCBPlayer,75,275,350,3,51,UCBPlayer
9184,UCBPlayer,61,271,332,0,56,UCBPlayer
9185,UCBPlayer,54,299,353,0,49,UCBPlayer
9186,UCBPlayer,59,314,373,2,43,UCBPlayer
9187,UCBPlayer,48,323,371,0,43,UCBPlayer
9188,UCBPlayer,75,300,375,4,43,UCBPlayer
9189,UCBPlayer,79,269,348,4,52,UCBPlayer
9190,UCBPlayer,76,266,342,1,53,UCBPlayer
9191,UCBPlayer,52,307,359,0,47,UCBPlayer
9192,UCBPlayer,78,298,376,5,43,UCBPlayer
9193,UCBPlayer,244,194,438,28,30,Player A
9194,UCBPlayer,72,302,374,6,44,UCBPlayer
9195,UCBPlayer,51,311,362,0,46,UCBPlayer
9196,UCBPlayer,57,322,379,2,41,UCBPlayer
9197,UCBPlayer,45,335,380,0,40,UCBPlayer
9198,UCBPlayer,70,280,350,3,51,UCBPlayer
9199,UCBPlayer,74,289,363,4,47,UCBPlayer
9200,UCBPlayer,50,325,375,1,42,UCBPlayer
9201,UCBPlayer,76,286,362,3,47,UCBPlayer
9202,UCBPlayer,56,291,347,0,51,UCBPlayer
9203,UCBPlayer,69,304,373,5,44,UCBPlayer
9204,UCBPlayer,72,272,344,3,53,UCBPlayer
9205,UCBPlayer,90,275,365,6,47,UCBPlayer
9206,UCBPlayer,87,297,384,7,41,UCBPlayer
9207,UCBPlayer,91,266,357,7,50,UCBPlayer
9208,UCBPlayer,60,275,335,0,55,UCBPlayer
9209,UCBPlayer,65,270,335,0,55,UCBPlayer
9210,UCBPlayer,64,284,348,1,51,UCBPlayer
9211,UCBPlayer,48,333,381,1,40,UCBPlayer
9212,UCBPlayer,157,267,424,20,32,UCBPlayer
9213,UCBPlayer,53,303,356,0,48,UCBPlayer
9214,UCBPlayer,61,271,332,0,56,UCBPlayer
9215,UCBPlayer,56,301,357,1,48,UCBPlayer
9216,UCBPlayer,130,285,415,17,34,UCBPlayer
9217,UCBPlayer,131,271,402,10,36,UCBPlayer
9218,UCBPlayer,54,299,353,0,49,UCBPlayer
9219,UCBPlayer,46,331,377,0,41,UCBPlayer
9220,UCBPlayer,53,313,366,1,45,UCBPlayer
9221,UCBPlayer,60,300,360,1,47,UCBPlayer
9222,UCBPlayer,70,290,360,4,48,UCBPlayer
9223,UCBPlayer,80,285,365,6,47,UCBPlayer
9224,UCBPlayer,54,309,363,1,46,UCBPlayer
9225,UCBPlayer,69,294,363,4,47,UCBPlayer
9226,UCBPlayer,81,276,357,4,49,UCBPlayer
9227,UCBPlayer,110,280,390,10,40,UCBPlayer
9228,UCBPlayer,49,329,378,1,41,UCBPlayer
9229,UCBPlayer,41,346,387,1,38,UCBPlayer
9230,UCBPlayer,61,296,357,1,48,UCBPlayer
9231,UCBPlayer,61,286,347,0,51,UCBPlayer
9232,UCBPlayer,47,327,374,0,42,UCBPlayer
9233,UCBPlayer,62,292,354,1,49,UCBPlayer
9234,UCBPlayer,57,312,369,1,44,UCBPlayer
9235,UCBPlayer,63,263,326,0,58,UCBPlayer
9236,UCBPlayer,50,315,365,0,45,UCBPlayer
9237,UCBPlayer,87,287,374,9,45,UCBPlayer
9238,UCBPlayer,70,285,355,2,49,UCBPlayer
9239,UCBPlayer,98,263,361,8,49,UCBPlayer
9240,UCBPlayer,66,276,342,1,53,UCBPlayer
9241,UCBPlayer,55,295,350,0,50,UCBPlayer
9242,UCBPlayer,66,276,342,1,53,UCBPlayer
9243,UCBPlayer,55,295,350,0,50,UCBPlayer
9244,UCBPlayer,52,307,359,0,47,UCBPlayer
9245,UCBPlayer,76,266,342,4,54,UCBPlayer
9246,UCBPlayer,103,293,396,10,38,UCBPlayer
9247,UCBPlayer,53,303,356,0,48,UCBPlayer
9248,UCBPlayer,62,292,354,1,49,UCBPlayer
9249,UCBPlayer,52,307,359,0,47,UCBPlayer
9250,UCBPlayer,48,323,371,0,43,UCBPlayer
9251,UCBPlayer,52,307,359,0,47,UCBPlayer
9252,UCBPlayer,79,259,338,3,55,UCBPlayer
9253,UCBPlayer,59,279,338,0,54,UCBPlayer
9254,UCBPlayer,62,292,354,1,49,UCBPlayer
9255,UCBPlayer,62,267,329,0,57,UCBPlayer
9256,UCBPlayer,53,303,356,0,48,UCBPlayer
9257,UCBPlayer,64,294,358,2,48,UCBPlayer
9258,UCBPlayer,53,303,356,0,48,UCBPlayer
9259,UCBPlayer,59,279,338,0,54,UCBPlayer
9260,UCBPlayer,60,310,370,2,44,UCBPlayer
9261,UCBPlayer,55,305,360,1,47,UCBPlayer
9262,UCBPlayer,56,306,362,0,46,UCBPlayer
9263,UCBPlayer,58,313,371,3,44,UCBPlayer
9264,UCBPlayer,59,304,363,1,46,UCBPlayer
9265,UCBPlayer,69,274,343,2,53,UCBPlayer
9266,UCBPlayer,50,330,380,0,40,UCBPlayer
9267,UCBPlayer,55,295,350,0,50,UCBPlayer
9268,UCBPlayer,55,305,360,1,47,UCBPlayer
9269,UCBPlayer,74,309,383,6,41,UCBPlayer
9270,UCBPlayer,52,307,359,0,47,UCBPlayer
9271,UCBPlayer,57,287,344,0,52,UCBPlayer
9272,UCBPlayer,55,295,350,0,50,UCBPlayer
9273,UCBPlayer,61,291,352,2,50,UCBPlayer
9274,UCBPlayer,60,290,350,0,50,UCBPlayer
9275,UCBPlayer,60,295,355,2,49,UCBPlayer
9276,UCBPlayer,60,310,370,2,44,UCBPlayer
9277,UCBPlayer,74,234,308,0,64,UCBPlayer
9278,UCBPlayer,49,314,363,1,46,UCBPlayer
9279,UCBPlayer,68,283,351,1,50,UCBPlayer
9280,UCBPlayer,42,342,384,1,39,UCBPlayer
9281,UCBPlayer,51,326,377,0,41,UCBPlayer
9282,UCBPlayer,76,281,357,4,49,UCBPlayer
9283,UCBPlayer,61,271,332,0,56,UCBPlayer
9284,UCBPlayer,50,315,365,0,45,UCBPlayer
9285,UCBPlayer,59,279,338,0,54,UCBPlayer
9286,UCBPlayer,69,264,333,1,56,UCBPlayer
9287,UCBPlayer,56,291,347,0,51,UCBPlayer
9288,UCBPlayer,68,268,336,1,55,UCBPlayer
9289,UCBPlayer,56,326,382,2,40,UCBPlayer
9290,UCBPlayer,60,275,335,0,55,UCBPlayer
9291,UCBPlayer,100,240,340,5,55,UCBPlayer
9292,UCBPlayer,108,283,391,14,41,UCBPlayer
9293,UCBPlayer,47,327,374,0,42,UCBPlayer
9294,UCBPlayer,62,267,329,0,57,UCBPlayer
9295,UCBPlayer,70,290,360,1,47,UCBPlayer
9296,UCBPlayer,59,279,338,0,54,UCBPlayer
9297,UCBPlayer,59,279,338,0,54,UCBPlayer
9298,UCBPlayer,56,291,347,0,51,UCBPlayer
9299,UCBPlayer,63,308,371,3,44,UCBPlayer
9300,UCBPlayer,53,303,356,0,48,UCBPlayer
9301,UCBPlayer,63,298,361,2,47,UCBPlayer
9302,UCBPlayer,55,295,350,0,50,UCBPlayer
9303,UCBPlayer,58,298,356,0,48,UCBPlayer
9304,UCBPlayer,69,274,343,2,53,UCBPlayer
9305,UCBPlayer,64,294,358,2,48,UCBPlayer
9306,UCBPlayer,58,283,341,0,53,UCBPlayer
9307,UCBPlayer,87,287,374,6,44,UCBPlayer
9308,UCBPlayer,62,277,339,1,54,UCBPlayer
9309,UCBPlayer,69,254,323,0,59,UCBPlayer
9310,UCBPlayer,50,315,365,0,45,UCBPlayer
9311,UCBPlayer,62,267,329,0,57,UCBPlayer
9312,UCBPlayer,65,270,335,0,55,UCBPlayer
9313,UCBPlayer,78,293,371,3,44,UCBPlayer
9314,UCBPlayer,58,283,341,0,53,UCBPlayer
9315,UCBPlayer,79,289,368,3,45,UCBPlayer
9316,UCBPlayer,59,279,338,0,54,UCBPlayer
9317,UCBPlayer,77,292,369,7,46,UCBPlayer
9318,UCBPlayer,97,287,384,10,42,UCBPlayer
9319,UCBPlayer,59,279,338,0,54,UCBPlayer
9320,UCBPlayer,65,280,345,1,52,UCBPlayer
9321,UCBPlayer,68,268,336,1,55,UCBPlayer
9322,UCBPlayer,57,287,344,0,52,UCBPlayer
9323,UCBPlayer,85,245,330,4,58,UCBPlayer
9324,UCBPlayer,65,280,345,1,52,UCBPlayer
9325,UCBPlayer,49,319,368,0,44,UCBPlayer
9326,UCBPlayer,51,311,362,0,46,UCBPlayer
9327,UCBPlayer,47,327,374,0,42,UCBPlayer
9328,UCBPlayer,51,321,372,1,43,UCBPlayer
9329,UCBPlayer,85,260,345,4,53,UCBPlayer
9330,UCBPlayer,51,311,362,0,46,UCBPlayer
9331,UCBPlayer,58,283,341,0,53,UCBPlayer
9332,UCBPlayer,42,332,374,0,42,UCBPlayer
9333,UCBPlayer,65,280,345,1,52,UCBPlayer
9334,UCBPlayer,57,287,344,0,52,UCBPlayer
9335,UCBPlayer,59,279,338,0,54,UCBPlayer
9336,UCBPlayer,71,291,362,3,47,UCBPlayer
9337,UCBPlayer,69,274,343,2,53,UCBPlayer
9338,UCBPlayer,67,302,369,4,45,UCBPlayer
9339,UCBPlayer,64,284,348,1,51,UCBPlayer
9340,UCBPlayer,68,298,366,4,46,UCBPlayer
9341,UCBPlayer,57,322,379,2,41,UCBPlayer
9342,UCBPlayer,67,297,364,2,46,UCBPlayer
9343,UCBPlayer,59,304,363,1,46,UCBPlayer
9344,UCBPlayer,53,303,356,0,48,UCBPlayer
9345,UCBPlayer,55,295,350,0,50,UCBPlayer
9346,UCBPlayer,77,302,379,5,42,UCBPlayer
9347,UCBPlayer,81,276,357,4,49,UCBPlayer
9348,UCBPlayer,95,265,360,7,49,UCBPlayer
9349,UCBPlayer,139,294,433,20,29,UCBPlayer
9350,UCBPlayer,71,276,347,3,52,UCBPlayer
9351,UCBPlayer,79,299,378,7,43,UCBPlayer
9352,UCBPlayer,75,265,340,2,54,UCBPlayer
9353,UCBPlayer,52,307,359,0,47,UCBPlayer
9354,UCBPlayer,52,307,359,0,47,UCBPlayer
9355,UCBPlayer,58,308,366,1,45,UCBPlayer
9356,UCBPlayer,53,303,356,0,48,UCBPlayer
9357,UCBPlayer,54,309,363,1,46,UCBPlayer
9358,UCBPlayer,64,274,338,0,54,UCBPlayer
9359,UCBPlayer,53,303,356,0,48,UCBPlayer
9360,UCBPlayer,54,299,353,0,49,UCBPlayer
9361,UCBPlayer,56,291,347,0,51,UCBPlayer
9362,UCBPlayer,99,259,358,8,50,UCBPlayer
9363,UCBPlayer,69,274,343,2,53,UCBPlayer
9364,UCBPlayer,57,287,344,0,52,UCBPlayer
9365,UCBPlayer,80,270,350,3,51,UCBPlayer
9366,UCBPlayer,50,315,365,0,45,UCBPlayer
9367,UCBPlayer,51,311,362,0,46,UCBPlayer
9368,UCBPlayer,56,291,347,0,51,UCBPlayer
9369,UCBPlayer,51,311,362,0,46,UCBPlayer
9370,UCBPlayer,109,259,368,12,48,UCBPlayer
9371,UCBPlayer,71,281,352,2,50,UCBPlayer
9372,UCBPlayer,50,315,365,0,45,UCBPlayer
9373,UCBPlayer,48,323,371,0,43,UCBPlayer
9374,UCBPlayer,93,278,371,6,45,UCBPlayer
9375,UCBPlayer,237,192,429,28,33,Player A
9376,UCBPlayer,82,262,344,6,54,UCBPlayer
9377,UCBPlayer,128,248,376,8,44,UCBPlayer
9378,UCBPlayer,87,262,349,5,52,UCBPlayer
9379,UCBPlayer,73,308,381,4,41,UCBPlayer
9380,UCBPlayer,53,313,366,1,45,UCBPlayer
9381,UCBPlayer,63,298,361,2,47,UCBPlayer
9382,UCBPlayer,50,325,375,1,42,UCBPlayer
9383,UCBPlayer,56,306,362,0,46,UCBPlayer
9384,UCBPlayer,58,283,341,0,53,UCBPlayer
9385,UCBPlayer,47,327,374,0,42,UCBPlayer
9386,UCBPlayer,75,305,380,6,42,UCBPlayer
9387,UCBPlayer,59,324,383,3,40,UCBPlayer
9388,UCBPlayer,70,260,330,1,57,UCBPlayer
9389,UCBPlayer,69,254,323,0,59,UCBPlayer
9390,UCBPlayer,64,294,358,2,48,UCBPlayer
9391,UCBPlayer,55,295,350,0,50,UCBPlayer
9392,UCBPlayer,56,291,347,0,51,UCBPlayer
9393,UCBPlayer,55,325,380,3,41,UCBPlayer
9394,UCBPlayer,71,271,342,1,53,UCBPlayer
9395,UCBPlayer,64,284,348,1,51,UCBPlayer
9396,UCBPlayer,73,298,371,6,45,UCBPlayer
9397,UCBPlayer,78,263,341,3,54,UCBPlayer
9398,UCBPlayer,53,303,356,0,48,UCBPlayer
9399,UCBPlayer,51,311,362,0,46,UCBPlayer
9400,UCBPlayer,53,303,356,0,48,UCBPlayer
9401,UCBPlayer,70,260,330,1,57,UCBPlayer
9402,UCBPlayer,76,271,347,3,52,UCBPlayer
9403,UCBPlayer,64,284,348,1,51,UCBPlayer
9404,UCBPlayer,95,260,355,8,51,UCBPlayer
9405,UCBPlayer,53,303,356,0,48,UCBPlayer
9406,UCBPlayer,60,275,335,0,55,UCBPlayer
9407,UCBPlayer,54,299,353,0,49,UCBPlayer
9408,UCBPlayer,72,287,359,3,48,UCBPlayer
9409,UCBPlayer,59,289,348,1,51,UCBPlayer
9410,UCBPlayer,98,268,366,7,47,UCBPlayer
9411,UCBPlayer,68,298,366,4,46,UCBPlayer
9412,UCBPlayer,72,277,349,2,51,UCBPlayer
9413,UCBPlayer,64,304,368,3,45,UCBPlayer
9414,UCBPlayer,74,289,363,4,47,UCBPlayer
9415,UCBPlayer,184,199,383,21,46,UCBPlayer
9416,UCBPlayer,257,232,489,43,18,Player A
9417,UCBPlayer,58,328,386,3,39,UCBPlayer
9418,UCBPlayer,72,252,324,1,59,UCBPlayer
9419,UCBPlayer,62,267,329,0,57,UCBPlayer
9420,UCBPlayer,53,303,356,0,48,UCBPlayer
9421,UCBPlayer,76,296,372,7,45,UCBPlayer
9422,UCBPlayer,79,284,363,7,48,UCBPlayer
9423,UCBPlayer,58,308,366,1,45,UCBPlayer
9424,UCBPlayer,59,279,338,0,54,UCBPlayer
9425,UCBPlayer,59,289,348,1,51,UCBPlayer
9426,UCBPlayer,99,279,378,10,44,UCBPlayer
9427,UCBPlayer,102,272,374,6,44,UCBPlayer
9428,UCBPlayer,72,322,394,8,38,UCBPlayer
9429,UCBPlayer,170,240,410,18,36,UCBPlayer
9430,UCBPlayer,74,279,353,3,50,UCBPlayer
9431,UCBPlayer,72,267,339,1,54,UCBPlayer
9432,UCBPlayer,56,291,347,0,51,UCBPlayer
9433,UCBPlayer,64,269,333,1,56,UCBPlayer
9434,UCBPlayer,62,317,379,2,41,UCBPlayer
9435,UCBPlayer,54,299,353,0,49,UCBPlayer
9436,UCBPlayer,62,307,369,1,44,UCBPlayer
9437,UCBPlayer,152,247,399,16,39,UCBPlayer
9438,UCBPlayer,66,306,372,4,44,UCBPlayer
9439,UCBPlayer,50,315,365,0,45,UCBPlayer
9440,UCBPlayer,62,312,374,3,43,UCBPlayer
9441,UCBPlayer,47,327,374,0,42,UCBPlayer
9442,UCBPlayer,53,303,356,0,48,UCBPlayer
9443,UCBPlayer,53,303,356,0,48,UCBPlayer
9444,UCBPlayer,59,279,338,0,54,UCBPlayer
9445,UCBPlayer,110,265,375,10,45,UCBPlayer
9446,UCBPlayer,60,300,360,1,47,UCBPlayer
9447,UCBPlayer,61,306,367,2,45,UCBPlayer
9448,UCBPlayer,88,258,346,5,53,UCBPlayer
9449,UCBPlayer,54,299,353,0,49,UCBPlayer
9450,UCBPlayer,62,302,364,2,46,UCBPlayer
9451,UCBPlayer,57,312,369,1,44,UCBPlayer
9452,UCBPlayer,72,292,364,5,47,UCBPlayer
9453,UCBPlayer,60,315,375,1,42,UCBPlayer
9454,UCBPlayer,52,307,359,0,47,UCBPlayer
9455,UCBPlayer,88,273,361,5,48,UCBPlayer
9456,UCBPlayer,47,327,374,0,42,UCBPlayer
9457,UCBPlayer,47,327,374,0,42,UCBPlayer
9458,UCBPlayer,62,292,354,1,49,UCBPlayer
9459,UCBPlayer,66,316,382,5,41,UCBPlayer
9460,UCBPlayer,56,291,347,0,51,UCBPlayer
9461,UCBPlayer,51,311,362,0,46,UCBPlayer
9462,UCBPlayer,63,288,351,1,50,UCBPlayer
9463,UCBPlayer,59,279,338,0,54,UCBPlayer
9464,UCBPlayer,58,308,366,1,45,UCBPlayer
9465,UCBPlayer,60,290,350,0,50,UCBPlayer
9466,UCBPlayer,69,264,333,1,56,UCBPlayer
9467,UCBPlayer,52,317,369,1,44,UCBPlayer
9468,UCBPlayer,62,302,364,2,46,UCBPlayer
9469,UCBPlayer,63,298,361,2,47,UCBPlayer
9470,UCBPlayer,64,284,348,1,51,UCBPlayer
9471,UCBPlayer,65,275,340,2,54,UCBPlayer
9472,UCBPlayer,87,307,394,11,39,UCBPlayer
9473,UCBPlayer,83,268,351,4,51,UCBPlayer
9474,UCBPlayer,60,275,335,0,55,UCBPlayer
9475,UCBPlayer,57,297,354,1,49,UCBPlayer
9476,UCBPlayer,67,322,389,3,38,UCBPlayer
9477,UCBPlayer,58,283,341,0,53,UCBPlayer
9478,UCBPlayer,67,287,354,1,49,UCBPlayer
9479,UCBPlayer,55,295,350,0,50,UCBPlayer
9480,UCBPlayer,63,298,361,5,48,UCBPlayer
9481,UCBPlayer,102,252,354,7,51,UCBPlayer
9482,UCBPlayer,106,281,387,10,41,UCBPlayer
9483,UCBPlayer,55,320,375,1,42,UCBPlayer
9484,UCBPlayer,52,307,359,0,47,UCBPlayer
9485,UCBPlayer,44,324,368,0,44,UCBPlayer
9486,UCBPlayer,87,277,364,5,47,UCBPlayer
9487,UCBPlayer,46,331,377,0,41,UCBPlayer
9488,UCBPlayer,68,268,336,1,55,UCBPlayer
9489,UCBPlayer,53,303,356,0,48,UCBPlayer
9490,UCBPlayer,49,319,368,0,44,UCBPlayer
9491,UCBPlayer,54,299,353,0,49,UCBPlayer
9492,UCBPlayer,63,308,371,3,44,UCBPlayer
9493,UCBPlayer,80,300,380,9,43,UCBPlayer
9494,UCBPlayer,62,312,374,3,43,UCBPlayer
9495,UCBPlayer,59,279,338,0,54,UCBPlayer
9496,UCBPlayer,61,286,347,0,51,UCBPlayer
9497,UCBPlayer,62,302,364,2,46,UCBPlayer
9498,UCBPlayer,55,295,350,0,50,UCBPlayer
9499,UCBPlayer,191,241,432,25,31,UCBPlayer
9500,UCBPlayer,58,283,341,0,53,UCBPlayer
9501,UCBPlayer,143,268,411,19,36,UCBPlayer
9502,UCBPlayer,72,297,369,4,45,UCBPlayer
9503,UCBPlayer,47,327,374,0,42,UCBPlayer
9504,UCBPlayer,64,324,388,5,39,UCBPlayer
9505,UCBPlayer,46,331,377,0,41,UCBPlayer
9506,UCBPlayer,63,318,381,4,41,UCBPlayer
9507,UCBPlayer,71,256,327,1,58,UCBPlayer
9508,UCBPlayer,83,243,326,3,59,UCBPlayer
9509,UCBPlayer,133,253,386,15,43,UCBPlayer
9510,UCBPlayer,60,275,335,0,55,UCBPlayer
9511,UCBPlayer,69,274,343,2,53,UCBPlayer
9512,UCBPlayer,51,311,362,0,46,UCBPlayer
9513,UCBPlayer,77,277,354,4,50,UCBPlayer
9514,UCBPlayer,53,313,366,1,45,UCBPlayer
9515,UCBPlayer,88,283,371,6,45,UCBPlayer
9516,UCBPlayer,50,315,365,0,45,UCBPlayer
9517,UCBPlayer,54,309,363,1,46,UCBPlayer
9518,UCBPlayer,64,284,348,1,51,UCBPlayer
9519,UCBPlayer,62,317,379,2,41,UCBPlayer
9520,UCBPlayer,55,295,350,0,50,UCBPlayer
9521,UCBPlayer,107,287,394,8,38,UCBPlayer
9522,UCBPlayer,62,267,329,0,57,UCBPlayer
9523,UCBPlayer,72,242,314,0,62,UCBPlayer
9524,UCBPlayer,63,288,351,1,50,UCBPlayer
9525,UCBPlayer,54,319,373,2,43,UCBPlayer
9526,UCBPlayer,56,326,382,2,40,UCBPlayer
9527,UCBPlayer,61,296,357,1,48,UCBPlayer
9528,UCBPlayer,53,313,366,1,45,UCBPlayer
9529,UCBPlayer,51,326,377,0,41,UCBPlayer
9530,UCBPlayer,54,299,353,0,49,UCBPlayer
9531,UCBPlayer,58,283,341,0,53,UCBPlayer
9532,UCBPlayer,59,294,353,0,49,UCBPlayer
9533,UCBPlayer,61,301,362,3,47,UCBPlayer
9534,UCBPlayer,80,300,380,6,42,UCBPlayer
9535,UCBPlayer,74,244,318,1,61,UCBPlayer
9536,UCBPlayer,76,261,337,2,55,UCBPlayer
9537,UCBPlayer,57,287,344,0,52,UCBPlayer
9538,UCBPlayer,58,308,366,1,45,UCBPlayer
9539,UCBPlayer,44,339,383,0,39,UCBPlayer
9540,UCBPlayer,125,235,360,10,50,UCBPlayer
9541,UCBPlayer,65,280,345,1,52,UCBPlayer
9542,UCBPlayer,52,307,359,0,47,UCBPlayer
9543,UCBPlayer,55,295,350,0,50,UCBPlayer
9544,UCBPlayer,52,307,359,0,47,UCBPlayer
9545,UCBPlayer,70,305,375,4,43,UCBPlayer
9546,UCBPlayer,48,323,371,0,43,UCBPlayer
9547,UCBPlayer,75,305,380,6,42,UCBPlayer
9548,UCBPlayer,63,308,371,3,44,UCBPlayer
9549,UCBPlayer,48,323,371,0,43,UCBPlayer
9550,UCBPlayer,54,299,353,0,49,UCBPlayer
9551,UCBPlayer,54,299,353,0,49,UCBPlayer
9552,UCBPlayer,62,292,354,1,49,UCBPlayer
9553,UCBPlayer,72,277,349,2,51,UCBPlayer
9554,UCBPlayer,52,307,359,0,47,UCBPlayer
9555,UCBPlayer,60,275,335,0,55,UCBPlayer
9556,UCBPlayer,117,272,389,12,41,UCBPlayer
9557,UCBPlayer,71,256,327,1,58,UCBPlayer
9558,UCBPlayer,87,267,354,4,50,UCBPlayer
9559,UCBPlayer,59,279,338,0,54,UCBPlayer
9560,UCBPlayer,54,299,353,0,49,UCBPlayer
9561,UCBPlayer,58,283,341,0,53,UCBPlayer
9562,UCBPlayer,54,299,353,0,49,UCBPlayer
9563,UCBPlayer,63,288,351,1,50,UCBPlayer
9564,UCBPlayer,54,309,363,1,46,UCBPlayer
9565,UCBPlayer,81,286,367,5,46,UCBPlayer
9566,UCBPlayer,57,287,344,0,52,UCBPlayer
9567,UCBPlayer,90,275,365,9,48,UCBPlayer
9568,UCBPlayer,79,289,368,6,46,UCBPlayer
9569,UCBPlayer,53,303,356,0,48,UCBPlayer
9570,UCBPlayer,57,287,344,0,52,UCBPlayer
9571,UCBPlayer,49,319,368,0,44,UCBPlayer
9572,UCBPlayer,52,307,359,0,47,UCBPlayer
9573,UCBPlayer,62,267,329,0,57,UCBPlayer
9574,UCBPlayer,68,268,336,1,55,UCBPlayer
9575,UCBPlayer,96,291,387,7,40,UCBPlayer
9576,UCBPlayer,68,308,376,5,43,UCBPlayer
9577,UCBPlayer,94,284,378,7,43,UCBPlayer
9578,UCBPlayer,64,309,373,5,44,UCBPlayer
9579,UCBPlayer,108,248,356,9,51,UCBPlayer
9580,UCBPlayer,68,293,361,2,47,UCBPlayer
9581,UCBPlayer,50,320,370,2,44,UCBPlayer
9582,UCBPlayer,81,276,357,4,49,UCBPlayer
9583,UCBPlayer,52,307,359,0,47,UCBPlayer
9584,UCBPlayer,54,294,348,1,51,UCBPlayer
9585,UCBPlayer,67,317,384,4,40,UCBPlayer
9586,UCBPlayer,47,322,369,1,44,UCBPlayer
9587,UCBPlayer,65,320,385,5,40,UCBPlayer
9588,UCBPlayer,94,299,393,10,39,UCBPlayer
9589,UCBPlayer,67,262,329,0,57,UCBPlayer
9590,UCBPlayer,55,295,350,0,50,UCBPlayer
9591,UCBPlayer,110,265,375,10,45,UCBPlayer
9592,UCBPlayer,91,281,372,7,45,UCBPlayer
9593,UCBPlayer,266,201,467,36,23,Player A
9594,UCBPlayer,48,323,371,0,43,UCBPlayer
9595,UCBPlayer,54,299,353,0,49,UCBPlayer
9596,UCBPlayer,48,323,371,0,43,UCBPlayer
9597,UCBPlayer,56,291,347,0,51,UCBPlayer
9598,UCBPlayer,51,311,362,0,46,UCBPlayer
9599,UCBPlayer,66,306,372,4,44,UCBPlayer
9600,UCBPlayer,48,343,391,2,37,UCBPlayer
9601,UCBPlayer,54,299,353,0,49,UCBPlayer
9602,UCBPlayer,53,303,356,0,48,UCBPlayer
9603,UCBPlayer,55,295,350,0,50,UCBPlayer
9604,UCBPlayer,58,283,341,0,53,UCBPlayer
9605,UCBPlayer,61,321,382,2,40,UCBPlayer
9606,UCBPlayer,59,314,373,2,43,UCBPlayer
9607,UCBPlayer,89,259,348,4,52,UCBPlayer
9608,UCBPlayer,57,287,344,0,52,UCBPlayer
9609,UCBPlayer,67,272,339,1,54,UCBPlayer
9610,UCBPlayer,61,306,367,2,45,UCBPlayer
9611,UCBPlayer,71,286,357,4,49,UCBPlayer
9612,UCBPlayer,65,290,355,2,49,UCBPlayer
9613,UCBPlayer,55,295,350,0,50,UCBPlayer
9614,UCBPlayer,65,270,335,0,55,UCBPlayer
9615,UCBPlayer,60,310,370,2,44,UCBPlayer
9616,UCBPlayer,62,267,329,0,57,UCBPlayer
9617,UCBPlayer,75,285,360,4,48,UCBPlayer
9618,UCBPlayer,54,299,353,0,49,UCBPlayer
9619,UCBPlayer,65,300,365,3,46,UCBPlayer
9620,UCBPlayer,54,299,353,0,49,UCBPlayer
9621,UCBPlayer,59,279,338,0,54,UCBPlayer
9622,UCBPlayer,60,275,335,0,55,UCBPlayer
9623,UCBPlayer,48,323,371,0,43,UCBPlayer
9624,UCBPlayer,62,267,329,0,57,UCBPlayer
9625,UCBPlayer,94,264,358,5,49,UCBPlayer
9626,UCBPlayer,60,275,335,0,55,UCBPlayer
9627,UCBPlayer,62,282,344,0,52,UCBPlayer
9628,UCBPlayer,57,297,354,1,49,UCBPlayer
9629,UCBPlayer,63,318,381,4,41,UCBPlayer
9630,UCBPlayer,72,277,349,2,51,UCBPlayer
9631,UCBPlayer,46,331,377,0,41,UCBPlayer
9632,UCBPlayer,54,309,363,1,46,UCBPlayer
9633,UCBPlayer,66,286,352,2,50,UCBPlayer
9634,UCBPlayer,52,322,374,0,42,UCBPlayer
9635,UCBPlayer,55,295,350,0,50,UCBPlayer
9636,UCBPlayer,63,263,326,0,58,UCBPlayer
9637,UCBPlayer,49,319,368,0,44,UCBPlayer
9638,UCBPlayer,50,300,350,0,50,UCBPlayer
9639,UCBPlayer,51,311,362,0,46,UCBPlayer
9640,UCBPlayer,53,303,356,0,48,UCBPlayer
9641,UCBPlayer,52,307,359,0,47,UCBPlayer
9642,UCBPlayer,50,340,390,1,37,UCBPlayer
9643,UCBPlayer,77,267,344,3,53,UCBPlayer
9644,UCBPlayer,68,258,326,0,58,UCBPlayer
9645,UCBPlayer,86,271,357,7,50,UCBPlayer
9646,UCBPlayer,56,291,347,0,51,UCBPlayer
9647,UCBPlayer,99,259,358,8,50,UCBPlayer
9648,UCBPlayer,68,318,386,6,40,UCBPlayer
9649,UCBPlayer,48,333,381,1,40,UCBPlayer
9650,UCBPlayer,69,314,383,6,41,UCBPlayer
9651,UCBPlayer,66,266,332,0,56,UCBPlayer
9652,UCBPlayer,66,296,362,3,47,UCBPlayer
9653,UCBPlayer,56,316,372,1,43,UCBPlayer
9654,UCBPlayer,65,290,355,2,49,UCBPlayer
9655,UCBPlayer,50,315,365,0,45,UCBPlayer
9656,UCBPlayer,50,315,365,0,45,UCBPlayer
9657,UCBPlayer,82,277,359,6,49,UCBPlayer
9658,UCBPlayer,78,288,366,4,46,UCBPlayer
9659,UCBPlayer,64,284,348,1,51,UCBPlayer
9660,UCBPlayer,56,301,357,1,48,UCBPlayer
9661,UCBPlayer,64,274,338,0,54,UCBPlayer
9662,UCBPlayer,52,307,359,0,47,UCBPlayer
9663,UCBPlayer,68,278,346,2,52,UCBPlayer
9664,UCBPlayer,84,264,348,4,52,UCBPlayer
9665,UCBPlayer,46,331,377,0,41,UCBPlayer
9666,UCBPlayer,63,263,326,0,58,UCBPlayer
9667,UCBPlayer,50,315,365,0,45,UCBPlayer
9668,UCBPlayer,97,297,394,11,39,UCBPlayer
9669,UCBPlayer,56,291,347,0,51,UCBPlayer
9670,UCBPlayer,76,261,337,2,55,UCBPlayer
9671,UCBPlayer,54,299,353,0,49,UCBPlayer
9672,UCBPlayer,52,307,359,0,47,UCBPlayer
9673,UCBPlayer,63,263,326,0,58,UCBPlayer
9674,UCBPlayer,53,303,356,0,48,UCBPlayer
9675,UCBPlayer,55,295,350,0,50,UCBPlayer
9676,UCBPlayer,57,297,354,1,49,UCBPlayer
9677,UCBPlayer,74,259,333,1,56,UCBPlayer
9678,UCBPlayer,64,284,348,1,51,UCBPlayer
9679,UCBPlayer,54,299,353,0,49,UCBPlayer
9680,UCBPlayer,55,295,350,0,50,UCBPlayer
9681,UCBPlayer,89,284,373,5,44,UCBPlayer
9682,UCBPlayer,59,279,338,0,54,UCBPlayer
9683,UCBPlayer,51,311,362,0,46,UCBPlayer
9684,UCBPlayer,61,271,332,0,56,UCBPlayer
9685,UCBPlayer,71,256,327,1,58,UCBPlayer
9686,UCBPlayer,49,319,368,0,44,UCBPlayer
9687,UCBPlayer,56,291,347,0,51,UCBPlayer
9688,UCBPlayer,43,338,381,1,40,UCBPlayer
9689,UCBPlayer,74,259,333,1,56,UCBPlayer
9690,UCBPlayer,55,295,350,0,50,UCBPlayer
9691,UCBPlayer,121,281,402,13,37,UCBPlayer
9692,UCBPlayer,55,295,350,0,50,UCBPlayer
9693,UCBPlayer,60,275,335,0,55,UCBPlayer
9694,UCBPlayer,59,279,338,0,54,UCBPlayer
9695,UCBPlayer,101,241,342,7,55,UCBPlayer
9696,UCBPlayer,51,311,362,0,46,UCBPlayer
9697,UCBPlayer,48,323,371,0,43,UCBPlayer
9698,UCBPlayer,56,291,347,0,51,UCBPlayer
9699,UCBPlayer,108,293,401,18,39,UCBPlayer
9700,UCBPlayer,59,304,363,1,46,UCBPlayer
9701,UCBPlayer,58,283,341,0,53,UCBPlayer
9702,UCBPlayer,56,291,347,0,51,UCBPlayer
9703,UCBPlayer,46,331,377,0,41,UCBPlayer
9704,UCBPlayer,68,288,356,3,49,UCBPlayer
9705,UCBPlayer,173,238,411,22,37,UCBPlayer
9706,UCBPlayer,52,307,359,0,47,UCBPlayer
9707,UCBPlayer,52,307,359,0,47,UCBPlayer
9708,UCBPlayer,51,311,362,0,46,UCBPlayer
9709,UCBPlayer,64,294,358,2,48,UCBPlayer
9710,UCBPlayer,62,267,329,0,57,UCBPlayer
9711,UCBPlayer,68,268,336,1,55,UCBPlayer
9712,UCBPlayer,54,299,353,0,49,UCBPlayer
9713,UCBPlayer,51,311,362,0,46,UCBPlayer
9714,UCBPlayer,52,342,394,2,36,UCBPlayer
9715,UCBPlayer,57,287,344,0,52,UCBPlayer
9716,UCBPlayer,56,291,347,0,51,UCBPlayer
9717,UCBPlayer,50,315,365,0,45,UCBPlayer
9718,UCBPlayer,58,283,341,0,53,UCBPlayer
9719,UCBPlayer,54,329,383,3,40,UCBPlayer
9720,UCBPlayer,59,304,363,1,46,UCBPlayer
9721,UCBPlayer,69,279,348,1,51,UCBPlayer
9722,UCBPlayer,63,273,336,1,55,UCBPlayer
9723,UCBPlayer,94,259,353,6,51,UCBPlayer
9724,UCBPlayer,60,310,370,2,44,UCBPlayer
9725,UCBPlayer,53,303,356,0,48,UCBPlayer
9726,UCBPlayer,79,284,363,4,47,UCBPlayer
9727,UCBPlayer,50,315,365,0,45,UCBPlayer
9728,UCBPlayer,57,287,344,0,52,UCBPlayer
9729,UCBPlayer,104,274,378,10,44,UCBPlayer
9730,UCBPlayer,55,295,350,0,50,UCBPlayer
9731,UCBPlayer,55,320,375,1,42,UCBPlayer
9732,UCBPlayer,71,286,357,4,49,UCBPlayer
9733,UCBPlayer,117,242,359,9,50,UCBPlayer
9734,UCBPlayer,86,276,362,6,48,UCBPlayer
9735,UCBPlayer,155,255,410,18,36,UCBPlayer
9736,UCBPlayer,53,318,371,0,43,UCBPlayer
9737,UCBPlayer,55,295,350,0,50,UCBPlayer
9738,UCBPlayer,49,329,378,1,41,UCBPlayer
9739,UCBPlayer,71,276,347,3,52,UCBPlayer
9740,UCBPlayer,78,273,351,4,51,UCBPlayer
9741,UCBPlayer,66,266,332,0,56,UCBPlayer
9742,UCBPlayer,202,222,424,23,33,UCBPlayer
9743,UCBPlayer,55,295,350,0,50,UCBPlayer
9744,UCBPlayer,48,323,371,0,43,UCBPlayer
9745,UCBPlayer,94,274,368,9,47,UCBPlayer
9746,UCBPlayer,50,315,365,0,45,UCBPlayer
9747,UCBPlayer,62,267,329,0,57,UCBPlayer
9748,UCBPlayer,59,279,338,0,54,UCBPlayer
9749,UCBPlayer,54,299,353,0,49,UCBPlayer
9750,UCBPlayer,62,312,374,3,43,UCBPlayer
9751,UCBPlayer,60,275,335,0,55,UCBPlayer
9752,UCBPlayer,74,269,343,2,53,UCBPlayer
9753,UCBPlayer,73,303,376,2,42,UCBPlayer
9754,UCBPlayer,61,296,357,1,48,UCBPlayer
9755,UCBPlayer,54,299,353,0,49,UCBPlayer
9756,UCBPlayer,73,283,356,3,49,UCBPlayer
9757,UCBPlayer,76,271,347,3,52,UCBPlayer
9758,UCBPlayer,60,275,335,0,55,UCBPlayer
9759,UCBPlayer,70,285,355,2,49,UCBPlayer
9760,UCBPlayer,74,274,348,4,52,UCBPlayer
9761,UCBPlayer,59,304,363,1,46,UCBPlayer
9762,UCBPlayer,55,295,350,0,50,UCBPlayer
9763,UCBPlayer,48,323,371,0,43,UCBPlayer
9764,UCBPlayer,57,287,344,0,52,UCBPlayer
9765,UCBPlayer,55,305,360,1,47,UCBPlayer
9766,UCBPlayer,62,292,354,1,49,UCBPlayer
9767,UCBPlayer,50,315,365,0,45,UCBPlayer
9768,UCBPlayer,58,283,341,0,53,UCBPlayer
9769,UCBPlayer,54,309,363,1,46,UCBPlayer
9770,UCBPlayer,104,259,363,7,48,UCBPlayer
9771,UCBPlayer,76,291,367,5,46,UCBPlayer
9772,UCBPlayer,71,291,362,3,47,UCBPlayer
9773,UCBPlayer,62,292,354,1,49,UCBPlayer
9774,UCBPlayer,57,287,344,0,52,UCBPlayer
9775,UCBPlayer,54,299,353,0,49,UCBPlayer
9776,UCBPlayer,56,291,347,0,51,UCBPlayer
9777,UCBPlayer,56,301,357,1,48,UCBPlayer
9778,UCBPlayer,82,247,329,3,58,UCBPlayer
9779,UCBPlayer,53,303,356,0,48,UCBPlayer
9780,UCBPlayer,51,311,362,0,46,UCBPlayer
9781,UCBPlayer,63,298,361,2,47,UCBPlayer
9782,UCBPlayer,50,315,365,0,45,UCBPlayer
9783,UCBPlayer,57,287,344,0,52,UCBPlayer
9784,UCBPlayer,57,287,344,0,52,UCBPlayer
9785,UCBPlayer,52,307,359,0,47,UCBPlayer
9786,UCBPlayer,60,275,335,0,55,UCBPlayer
9787,UCBPlayer,61,286,347,0,51,UCBPlayer
9788,UCBPlayer,62,297,359,3,48,UCBPlayer
9789,UCBPlayer,73,288,361,2,47,UCBPlayer
9790,UCBPlayer,46,326,372,1,43,UCBPlayer
9791,UCBPlayer,118,273,391,14,41,UCBPlayer
9792,UCBPlayer,54,299,353,0,49,UCBPlayer
9793,UCBPlayer,81,256,337,2,55,UCBPlayer
9794,UCBPlayer,51,311,362,0,46,UCBPlayer
9795,UCBPlayer,62,292,354,1,49,UCBPlayer
9796,UCBPlayer,66,306,372,4,44,UCBPlayer
9797,UCBPlayer,66,286,352,2,50,UCBPlayer
9798,UCBPlayer,95,285,380,12,44,UCBPlayer
9799,UCBPlayer,61,296,357,1,48,UCBPlayer
9800,UCBPlayer,78,263,341,3,54,UCBPlayer
9801,UCBPlayer,66,286,352,2,50,UCBPlayer
9802,UCBPlayer,64,259,323,0,59,UCBPlayer
9803,UCBPlayer,113,263,376,14,46,UCBPlayer
9804,UCBPlayer,51,311,362,0,46,UCBPlayer
9805,UCBPlayer,49,329,378,1,41,UCBPlayer
9806,UCBPlayer,254,174,428,30,34,Player A
9807,UCBPlayer,64,309,373,2,43,UCBPlayer
9808,UCBPlayer,49,319,368,0,44,UCBPlayer
9809,UCBPlayer,68,268,336,1,55,UCBPlayer
9810,UCBPlayer,64,284,348,1,51,UCBPlayer
9811,UCBPlayer,67,282,349,2,51,UCBPlayer
9812,UCBPlayer,64,259,323,0,59,UCBPlayer
9813,UCBPlayer,65,280,345,1,52,UCBPlayer
9814,UCBPlayer,70,310,380,3,41,UCBPlayer
9815,UCBPlayer,156,281,437,21,28,UCBPlayer
9816,UCBPlayer,56,291,347,0,51,UCBPlayer
9817,UCBPlayer,67,282,349,2,51,UCBPlayer
9818,UCBPlayer,60,275,335,0,55,UCBPlayer
9819,UCBPlayer,58,283,341,0,53,UCBPlayer
9820,UCBPlayer,62,292,354,1,49,UCBPlayer
9821,UCBPlayer,50,315,365,0,45,UCBPlayer
9822,UCBPlayer,48,323,371,0,43,UCBPlayer
9823,UCBPlayer,54,299,353,0,49,UCBPlayer
9824,UCBPlayer,85,265,350,3,51,UCBPlayer
9825,UCBPlayer,66,286,352,2,50,UCBPlayer
9826,UCBPlayer,72,277,349,2,51,UCBPlayer
9827,UCBPlayer,50,315,365,0,45,UCBPlayer
9828,UCBPlayer,56,291,347,0,51,UCBPlayer
9829,UCBPlayer,58,293,351,1,50,UCBPlayer
9830,UCBPlayer,66,286,352,2,50,UCBPlayer
9831,UCBPlayer,54,314,368,0,44,UCBPlayer
9832,UCBPlayer,49,339,388,2,38,UCBPlayer
9833,UCBPlayer,55,320,375,1,42,UCBPlayer
9834,UCBPlayer,53,313,366,1,45,UCBPlayer
9835,UCBPlayer,58,308,366,1,45,UCBPlayer
9836,UCBPlayer,59,294,353,0,49,UCBPlayer
9837,UCBPlayer,82,267,349,5,52,UCBPlayer
9838,UCBPlayer,67,292,359,3,48,UCBPlayer
9839,UCBPlayer,64,289,353,3,50,UCBPlayer
9840,UCBPlayer,73,283,356,3,49,UCBPlayer
9841,UCBPlayer,59,319,378,1,41,UCBPlayer
9842,UCBPlayer,49,304,353,0,49,UCBPlayer
9843,UCBPlayer,82,272,354,4,50,UCBPlayer
9844,UCBPlayer,48,323,371,0,43,UCBPlayer
9845,UCBPlayer,55,295,350,0,50,UCBPlayer
9846,UCBPlayer,61,321,382,2,40,UCBPlayer
9847,UCBPlayer,71,291,362,3,47,UCBPlayer
9848,UCBPlayer,53,303,356,0,48,UCBPlayer
9849,UCBPlayer,75,285,360,4,48,UCBPlayer
9850,UCBPlayer,56,291,347,0,51,UCBPlayer
9851,UCBPlayer,64,284,348,1,51,UCBPlayer
9852,UCBPlayer,83,288,371,6,45,UCBPlayer
9853,UCBPlayer,89,299,388,5,39,UCBPlayer
9854,UCBPlayer,49,319,368,0,44,UCBPlayer
9855,UCBPlayer,44,339,383,0,39,UCBPlayer
9856,UCBPlayer,98,273,371,6,45,UCBPlayer
9857,UCBPlayer,62,292,354,1,49,UCBPlayer
9858,UCBPlayer,70,270,340,2,54,UCBPlayer
9859,UCBPlayer,63,308,371,3,44,UCBPlayer
9860,UCBPlayer,54,299,353,0,49,UCBPlayer
9861,UCBPlayer,49,319,368,0,44,UCBPlayer
9862,UCBPlayer,45,335,380,0,40,UCBPlayer
9863,UCBPlayer,70,270,340,2,54,UCBPlayer
9864,UCBPlayer,71,326,397,5,36,UCBPlayer
9865,UCBPlayer,71,291,362,3,47,UCBPlayer
9866,UCBPlayer,75,280,355,5,50,UCBPlayer
9867,UCBPlayer,61,296,357,1,48,UCBPlayer
9868,UCBPlayer,55,295,350,0,50,UCBPlayer
9869,UCBPlayer,59,279,338,0,54,UCBPlayer
9870,UCBPlayer,69,299,368,3,45,UCBPlayer
9871,UCBPlayer,59,304,363,1,46,UCBPlayer
9872,UCBPlayer,55,295,350,0,50,UCBPlayer
9873,UCBPlayer,55,295,350,0,50,UCBPlayer
9874,UCBPlayer,52,307,359,0,47,UCBPlayer
9875,UCBPlayer,57,312,369,1,44,UCBPlayer
9876,UCBPlayer,51,311,362,0,46,UCBPlayer
9877,UCBPlayer,50,325,375,1,42,UCBPlayer
9878,UCBPlayer,66,316,382,5,41,UCBPlayer
9879,UCBPlayer,43,343,386,0,38,UCBPlayer
9880,UCBPlayer,55,305,360,1,47,UCBPlayer
9881,UCBPlayer,61,296,357,1,48,UCBPlayer
9882,UCBPlayer,45,335,380,0,40,UCBPlayer
9883,UCBPlayer,55,305,360,1,47,UCBPlayer
9884,UCBPlayer,67,322,389,6,39,UCBPlayer
9885,UCBPlayer,92,287,379,11,44,UCBPlayer
9886,UCBPlayer,51,311,362,0,46,UCBPlayer
9887,UCBPlayer,94,259,353,6,51,UCBPlayer
9888,UCBPlayer,61,281,342,1,53,UCBPlayer
9889,UCBPlayer,61,286,347,0,51,UCBPlayer
9890,UCBPlayer,56,301,357,1,48,UCBPlayer
9891,UCBPlayer,55,335,390,4,38,UCBPlayer
9892,UCBPlayer,87,272,359,6,49,UCBPlayer
9893,UCBPlayer,57,312,369,1,44,UCBPlayer
9894,UCBPlayer,75,275,350,3,51,UCBPlayer
9895,UCBPlayer,75,310,385,8,41,UCBPlayer
9896,UCBPlayer,44,339,383,0,39,UCBPlayer
9897,UCBPlayer,56,291,347,0,51,UCBPlayer
9898,UCBPlayer,66,276,342,1,53,UCBPlayer
9899,UCBPlayer,70,250,320,0,60,UCBPlayer
9900,UCBPlayer,64,284,348,1,51,UCBPlayer
9901,UCBPlayer,102,322,424,14,30,UCBPlayer
9902,UCBPlayer,51,311,362,0,46,UCBPlayer
9903,UCBPlayer,62,302,364,2,46,UCBPlayer
9904,UCBPlayer,49,319,368,0,44,UCBPlayer
9905,UCBPlayer,63,298,361,2,47,UCBPlayer
9906,UCBPlayer,54,299,353,0,49,UCBPlayer
9907,UCBPlayer,45,335,380,0,40,UCBPlayer
9908,UCBPlayer,57,322,379,2,41,UCBPlayer
9909,UCBPlayer,57,287,344,0,52,UCBPlayer
9910,UCBPlayer,51,321,372,1,43,UCBPlayer
9911,UCBPlayer,57,312,369,1,44,UCBPlayer
9912,UCBPlayer,46,331,377,0,41,UCBPlayer
9913,UCBPlayer,64,324,388,5,39,UCBPlayer
9914,UCBPlayer,50,315,365,0,45,UCBPlayer
9915,UCBPlayer,71,246,317,0,61,UCBPlayer
9916,UCBPlayer,60,275,335,0,55,UCBPlayer
9917,UCBPlayer,144,259,403,14,37,UCBPlayer
9918,UCBPlayer,99,259,358,8,50,UCBPlayer
9919,UCBPlayer,65,280,345,1,52,UCBPlayer
9920,UCBPlayer,66,286,352,2,50,UCBPlayer
9921,UCBPlayer,58,283,341,0,53,UCBPlayer
9922,UCBPlayer,68,288,356,3,49,UCBPlayer
9923,UCBPlayer,63,288,351,1,50,UCBPlayer
9924,UCBPlayer,46,331,377,0,41,UCBPlayer
9925,UCBPlayer,50,315,365,0,45,UCBPlayer
9926,UCBPlayer,52,307,359,0,47,UCBPlayer
9927,UCBPlayer,56,301,357,1,48,UCBPlayer
9928,UCBPlayer,62,292,354,1,49,UCBPlayer
9929,UCBPlayer,51,311,362,0,46,UCBPlayer
9930,UCBPlayer,93,253,346,5,53,UCBPlayer
9931,UCBPlayer,71,281,352,2,50,UCBPlayer
9932,UCBPlayer,55,305,360,1,47,UCBPlayer
9933,UCBPlayer,79,269,348,4,52,UCBPlayer
9934,UCBPlayer,73,278,351,4,51,UCBPlayer
9935,UCBPlayer,83,283,366,4,46,UCBPlayer
9936,UCBPlayer,59,279,338,0,54,UCBPlayer
9937,UCBPlayer,54,299,353,0,49,UCBPlayer
9938,UCBPlayer,58,283,341,0,53,UCBPlayer
9939,UCBPlayer,64,274,338,0,54,UCBPlayer
9940,UCBPlayer,54,299,353,0,49,UCBPlayer
9941,UCBPlayer,59,294,353,3,50,UCBPlayer
9942,UCBPlayer,62,302,364,2,46,UCBPlayer
9943,UCBPlayer,61,316,377,3,42,UCBPlayer
9944,UCBPlayer,65,270,335,0,55,UCBPlayer
9945,UCBPlayer,86,256,342,4,54,UCBPlayer
9946,UCBPlayer,57,287,344,0,52,UCBPlayer
9947,UCBPlayer,70,250,320,0,60,UCBPlayer
9948,UCBPlayer,137,292,429,19,30,UCBPlayer
9949,UCBPlayer,44,339,383,0,39,UCBPlayer
9950,UCBPlayer,70,250,320,0,60,UCBPlayer
9951,UCBPlayer,50,315,365,0,45,UCBPlayer
9952,UCBPlayer,57,287,344,0,52,UCBPlayer
9953,UCBPlayer,62,267,329,0,57,UCBPlayer
9954,UCBPlayer,61,286,347,0,51,UCBPlayer
9955,UCBPlayer,63,263,326,0,58,UCBPlayer
9956,UCBPlayer,69,289,358,2,48,UCBPlayer
9957,UCBPlayer,85,255,340,2,54,UCBPlayer
9958,UCBPlayer,56,291,347,0,51,UCBPlayer
9959,UCBPlayer,46,331,377,0,41,UCBPlayer
9960,UCBPlayer,71,291,362,3,47,UCBPlayer
9961,UCBPlayer,71,321,392,6,38,UCBPlayer
9962,UCBPlayer,43,343,386,0,38,UCBPlayer
9963,UCBPlayer,61,311,372,4,44,UCBPlayer
9964,UCBPlayer,67,307,374,3,43,UCBPlayer
9965,UCBPlayer,60,275,335,0,55,UCBPlayer
9966,UCBPlayer,105,255,360,7,49,UCBPlayer
9967,UCBPlayer,66,266,332,0,56,UCBPlayer
9968,UCBPlayer,66,286,352,2,50,UCBPlayer
9969,UCBPlayer,59,304,363,1,46,UCBPlayer
9970,UCBPlayer,46,331,377,0,41,UCBPlayer
9971,UCBPlayer,58,303,361,2,47,UCBPlayer
9972,UCBPlayer,61,286,347,0,51,UCBPlayer
9973,UCBPlayer,54,299,353,0,49,UCBPlayer
9974,UCBPlayer,51,311,362,0,46,UCBPlayer
9975,UCBPlayer,68,268,336,1,55,UCBPlayer
9976,UCBPlayer,47,327,374,0,42,UCBPlayer
9977,UCBPlayer,58,283,341,0,53,UCBPlayer
9978,UCBPlayer,51,311,362,0,46,UCBPlayer
9979,UCBPlayer,52,307,359,0,47,UCBPlayer
9980,UCBPlayer,58,283,341,0,53,UCBPlayer
9981,UCBPlayer,43,353,396,1,35,UCBPlayer
9982,UCBPlayer,52,317,369,1,44,UCBPlayer
9983,UCBPlayer,62,292,354,1,49,UCBPlayer
9984,UCBPlayer,57,297,354,1,49,UCBPlayer
9985,UCBPlayer,61,286,347,0,51,UCBPlayer
9986,UCBPlayer,49,319,368,0,44,UCBPlayer
9987,UCBPlayer,48,328,376,2,42,UCBPlayer
9988,UCBPlayer,79,294,373,5,44,UCBPlayer
9989,UCBPlayer,51,311,362,0,46,UCBPlayer
9990,UCBPlayer,62,282,344,0,52,UCBPlayer
9991,UCBPlayer,59,279,338,0,54,UCBPlayer
9992,UCBPlayer,45,330,375,1,42,UCBPlayer
9993,UCBPlayer,66,301,367,2,45,UCBPlayer
9994,UCBPlayer,61,271,332,0,56,UCBPlayer
9995,UCBPlayer,69,249,318,1,61,UCBPlayer
9996,UCBPlayer,65,300,365,3,46,UCBPlayer
9997,UCBPlayer,127,237,364,11,49,UCBPlayer
9998,UCBPlayer,60,275,335,0,55,UCBPlayer
9999,UCBPlayer,60,275,335,0,55,UCBPlayer
10000,UCBPlayer,56,291,347,0,51,UCBPlayer
10001,UCBPlayer,60,275,335,0,55,UCBPlayer
10002,UCBPlayer,80,255,335,3,56,UCBPlayer
10003,UCBPlayer,43,343,386,0,38,UCBPlayer
10004,UCBPlayer,59,304,363,1,46,UCBPlayer
10005,UCBPlayer,61,271,332,0,56,UCBPlayer
10006,UCBPlayer,53,303,356,0,48,UCBPlayer
10007,UCBPlayer,64,304,368,3,45,UCBPlayer
10008,UCBPlayer,55,320,375,1,42,UCBPlayer
10009,UCBPlayer,53,313,366,1,45,UCBPlayer
10010,UCBPlayer,105,280,385,11,42,UCBPlayer
10011,UCBPlayer,61,271,332,0,56,UCBPlayer
10012,UCBPlayer,78,278,356,3,49,UCBPlayer
10013,UCBPlayer,105,265,370,11,47,UCBPlayer
10014,UCBPlayer,66,251,317,0,61,UCBPlayer
10015,UCBPlayer,76,296,372,7,45,UCBPlayer
10016,UCBPlayer,86,271,357,7,50,UCBPlayer
10017,UCBPlayer,58,308,366,1,45,UCBPlayer
10018,UCBPlayer,52,317,369,1,44,UCBPlayer
10019,UCBPlayer,44,339,383,0,39,UCBPlayer
10020,UCBPlayer,50,315,365,0,45,UCBPlayer
10021,UCBPlayer,52,307,359,0,47,UCBPlayer
10022,UCBPlayer,47,327,374,0,42,UCBPlayer
10023,UCBPlayer,51,311,362,0,46,UCBPlayer
10024,UCBPlayer,79,279,358,2,48,UCBPlayer
10025,UCBPlayer,58,283,341,0,53,UCBPlayer
10026,UCBPlayer,46,331,377,0,41,UCBPlayer
10027,UCBPlayer,54,299,353,0,49,UCBPlayer
10028,UCBPlayer,54,299,353,0,49,UCBPlayer
10029,UCBPlayer,130,265,395,15,40,UCBPlayer
10030,UCBPlayer,54,299,353,0,49,UCBPlayer
10031,UCBPlayer,56,321,377,3,42,UCBPlayer
10032,UCBPlayer,94,249,343,5,54,UCBPlayer
10033,UCBPlayer,71,311,382,8,42,UCBPlayer
10034,UCBPlayer,54,314,368,0,44,UCBPlayer
10035,UCBPlayer,80,255,335,3,56,UCBPlayer
10036,UCBPlayer,101,291,392,9,39,UCBPlayer
10037,UCBPlayer,48,323,371,0,43,UCBPlayer
10038,UCBPlayer,84,264,348,4,52,UCBPlayer
10039,UCBPlayer,57,287,344,0,52,UCBPlayer
10040,UCBPlayer,54,299,353,0,49,UCBPlayer
10041,UCBPlayer,60,300,360,1,47,UCBPlayer
10042,UCBPlayer,59,279,338,0,54,UCBPlayer
10043,UCBPlayer,62,277,339,1,54,UCBPlayer
10044,UCBPlayer,64,299,363,4,47,UCBPlayer
10045,UCBPlayer,61,321,382,2,40,UCBPlayer
10046,UCBPlayer,54,284,338,0,54,UCBPlayer
10047,UCBPlayer,67,282,349,2,51,UCBPlayer
10048,UCBPlayer,54,299,353,0,49,UCBPlayer
10049,UCBPlayer,64,284,348,1,51,UCBPlayer
10050,UCBPlayer,59,314,373,2,43,UCBPlayer
10051,UCBPlayer,82,277,359,6,49,UCBPlayer
10052,UCBPlayer,63,298,361,2,47,UCBPlayer
10053,UCBPlayer,66,276,342,1,53,UCBPlayer
10054,UCBPlayer,55,310,365,0,45,UCBPlayer
10055,UCBPlayer,54,299,353,0,49,UCBPlayer
10056,UCBPlayer,98,248,346,8,54,UCBPlayer
10057,UCBPlayer,59,279,338,0,54,UCBPlayer
10058,UCBPlayer,48,323,371,0,43,UCBPlayer
10059,UCBPlayer,63,298,361,2,47,UCBPlayer
10060,UCBPlayer,70,300,370,5,45,UCBPlayer
10061,UCBPlayer,66,296,362,3,47,UCBPlayer
10062,UCBPlayer,87,272,359,6,49,UCBPlayer
10063,UCBPlayer,61,271,332,0,56,UCBPlayer
10064,UCBPlayer,115,285,400,14,38,UCBPlayer
10065,UCBPlayer,51,311,362,0,46,UCBPlayer
10066,UCBPlayer,68,268,336,1,55,UCBPlayer
10067,UCBPlayer,53,303,356,0,48,UCBPlayer
10068,UCBPlayer,64,284,348,1,51,UCBPlayer
10069,UCBPlayer,50,315,365,0,45,UCBPlayer
10070,UCBPlayer,52,307,359,0,47,UCBPlayer
10071,UCBPlayer,55,295,350,0,50,UCBPlayer
10072,UCBPlayer,79,259,338,3,55,UCBPlayer
10073,UCBPlayer,104,254,358,8,50,UCBPlayer
10074,UCBPlayer,53,303,356,0,48,UCBPlayer
10075,UCBPlayer,51,321,372,1,43,UCBPlayer
10076,UCBPlayer,60,300,360,1,47,UCBPlayer
10077,UCBPlayer,50,325,375,1,42,UCBPlayer
10078,UCBPlayer,89,279,368,6,46,UCBPlayer
10079,UCBPlayer,48,323,371,0,43,UCBPlayer
10080,UCBPlayer,50,325,375,1,42,UCBPlayer
10081,UCBPlayer,56,306,362,0,46,UCBPlayer
10082,UCBPlayer,58,283,341,0,53,UCBPlayer
10083,UCBPlayer,97,262,359,6,49,UCBPlayer
10084,UCBPlayer,56,291,347,0,51,UCBPlayer
10085,UCBPlayer,64,309,373,2,43,UCBPlayer
10086,UCBPlayer,45,335,380,0,40,UCBPlayer
10087,UCBPlayer,59,279,338,0,54,UCBPlayer
10088,UCBPlayer,63,278,341,0,53,UCBPlayer
10089,UCBPlayer,49,319,368,0,44,UCBPlayer
10090,UCBPlayer,55,295,350,0,50,UCBPlayer
10091,UCBPlayer,58,293,351,1,50,UCBPlayer
10092,UCBPlayer,72,262,334,2,56,UCBPlayer
10093,UCBPlayer,64,314,378,4,42,UCBPlayer
10094,UCBPlayer,72,292,364,2,46,UCBPlayer
10095,UCBPlayer,56,296,352,2,50,UCBPlayer
10096,UCBPlayer,75,260,335,0,55,UCBPlayer
10097,UCBPlayer,49,304,353,0,49,UCBPlayer
10098,UCBPlayer,58,318,376,2,42,UCBPlayer
10099,UCBPlayer,81,296,377,6,43,UCBPlayer
10100,UCBPlayer,79,279,358,5,49,UCBPlayer
10101,UCBPlayer,82,262,344,3,53,UCBPlayer
10102,UCBPlayer,57,287,344,0,52,UCBPlayer
10103,UCBPlayer,55,295,350,0,50,UCBPlayer
10104,UCBPlayer,74,279,353,3,50,UCBPlayer
10105,UCBPlayer,69,329,398,6,36,UCBPlayer
10106,UCBPlayer,59,279,338,0,54,UCBPlayer
10107,UCBPlayer,47,327,374,0,42,UCBPlayer
10108,UCBPlayer,53,303,356,0,48,UCBPlayer
10109,UCBPlayer,75,290,365,3,46,UCBPlayer
10110,UCBPlayer,44,339,383,0,39,UCBPlayer
10111,UCBPlayer,53,303,356,0,48,UCBPlayer
10112,UCBPlayer,70,285,355,2,49,UCBPlayer
10113,UCBPlayer,54,299,353,0,49,UCBPlayer
10114,UCBPlayer,67,272,339,1,54,UCBPlayer
10115,UCBPlayer,60,300,360,1,47,UCBPlayer
10116,UCBPlayer,60,275,335,0,55,UCBPlayer
10117,UCBPlayer,65,270,335,0,55,UCBPlayer
10118,UCBPlayer,74,299,373,5,44,UCBPlayer
10119,UCBPlayer,53,313,366,1,45,UCBPlayer
10120,UCBPlayer,68,288,356,3,49,UCBPlayer
10121,UCBPlayer,51,311,362,0,46,UCBPlayer
10122,UCBPlayer,50,315,365,0,45,UCBPlayer
10123,UCBPlayer,50,315,365,0,45,UCBPlayer
10124,UCBPlayer,67,307,374,3,43,UCBPlayer
10125,UCBPlayer,58,283,341,0,53,UCBPlayer
10126,UCBPlayer,52,307,359,0,47,UCBPlayer
10127,UCBPlayer,67,307,374,3,43,UCBPlayer
10128,UCBPlayer,56,291,347,0,51,UCBPlayer
10129,UCBPlayer,49,319,368,0,44,UCBPlayer
10130,UCBPlayer,66,296,362,3,47,UCBPlayer
10131,UCBPlayer,61,286,347,0,51,UCBPlayer
10132,UCBPlayer,61,271,332,0,56,UCBPlayer
10133,UCBPlayer,75,295,370,5,45,UCBPlayer
10134,UCBPlayer,59,279,338,0,54,UCBPlayer
10135,UCBPlayer,67,297,364,5,47,UCBPlayer
10136,UCBPlayer,97,267,364,5,47,UCBPlayer
10137,UCBPlayer,63,273,336,1,55,UCBPlayer
10138,UCBPlayer,90,265,355,5,50,UCBPlayer
10139,UCBPlayer,60,275,335,0,55,UCBPlayer
10140,UCBPlayer,60,275,335,0,55,UCBPlayer
10141,UCBPlayer,81,281,362,6,48,UCBPlayer
10142,UCBPlayer,58,333,391,2,37,UCBPlayer
10143,UCBPlayer,51,336,387,1,38,UCBPlayer
10144,UCBPlayer,54,299,353,0,49,UCBPlayer
10145,UCBPlayer,55,305,360,1,47,UCBPlayer
10146,UCBPlayer,60,295,355,2,49,UCBPlayer
10147,UCBPlayer,57,327,384,1,39,UCBPlayer
10148,UCBPlayer,54,284,338,0,54,UCBPlayer
10149,UCBPlayer,57,287,344,0,52,UCBPlayer
10150,UCBPlayer,45,335,380,0,40,UCBPlayer
10151,UCBPlayer,65,280,345,1,52,UCBPlayer
10152,UCBPlayer,59,279,338,0,54,UCBPlayer
10153,UCBPlayer,92,272,364,5,47,UCBPlayer
10154,UCBPlayer,48,323,371,0,43,UCBPlayer
10155,UCBPlayer,95,280,375,7,44,UCBPlayer
10156,UCBPlayer,51,311,362,0,46,UCBPlayer
10157,UCBPlayer,65,270,335,0,55,UCBPlayer
10158,UCBPlayer,59,279,338,0,54,UCBPlayer
10159,UCBPlayer,56,291,347,0,51,UCBPlayer
10160,UCBPlayer,59,304,363,1,46,UCBPlayer
10161,UCBPlayer,51,311,362,0,46,UCBPlayer
10162,UCBPlayer,61,316,377,3,42,UCBPlayer
10163,UCBPlayer,95,295,390,10,40,UCBPlayer
10164,UCBPlayer,45,345,390,1,37,UCBPlayer
10165,UCBPlayer,57,287,344,0,52,UCBPlayer
10166,UCBPlayer,64,284,348,1,51,UCBPlayer
10167,UCBPlayer,78,308,386,6,40,UCBPlayer
10168,UCBPlayer,108,268,376,8,44,UCBPlayer
10169,UCBPlayer,58,298,356,0,48,UCBPlayer
10170,UCBPlayer,81,291,372,7,45,UCBPlayer
10171,UCBPlayer,48,333,381,1,40,UCBPlayer
10172,UCBPlayer,77,297,374,6,44,UCBPlayer
10173,UCBPlayer,54,299,353,0,49,UCBPlayer
10174,UCBPlayer,55,295,350,0,50,UCBPlayer
10175,UCBPlayer,63,298,361,2,47,UCBPlayer
10176,UCBPlayer,51,311,362,0,46,UCBPlayer
10177,UCBPlayer,55,315,370,2,44,UCBPlayer
10178,UCBPlayer,67,272,339,1,54,UCBPlayer
10179,UCBPlayer,71,246,317,0,61,UCBPlayer
10180,UCBPlayer,66,296,362,3,47,UCBPlayer
10181,UCBPlayer,55,295,350,0,50,UCBPlayer
10182,UCBPlayer,55,315,370,2,44,UCBPlayer
10183,UCBPlayer,56,316,372,1,43,UCBPlayer
10184,UCBPlayer,68,268,336,1,55,UCBPlayer
10185,UCBPlayer,41,351,392,0,36,UCBPlayer
10186,UCBPlayer,78,278,356,3,49,UCBPlayer
10187,UCBPlayer,66,266,332,0,56,UCBPlayer
10188,UCBPlayer,85,275,360,7,49,UCBPlayer
10189,UCBPlayer,66,301,367,2,45,UCBPlayer
10190,UCBPlayer,54,309,363,1,46,UCBPlayer
10191,UCBPlayer,60,290,350,0,50,UCBPlayer
10192,UCBPlayer,55,295,350,0,50,UCBPlayer
10193,UCBPlayer,55,295,350,0,50,UCBPlayer
10194,UCBPlayer,74,269,343,2,53,UCBPlayer
10195,UCBPlayer,54,309,363,1,46,UCBPlayer
10196,UCBPlayer,68,268,336,1,55,UCBPlayer
10197,UCBPlayer,70,260,330,1,57,UCBPlayer
10198,UCBPlayer,56,286,342,1,53,UCBPlayer
10199,UCBPlayer,58,298,356,0,48,UCBPlayer
10200,UCBPlayer,62,292,354,1,49,UCBPlayer
10201,UCBPlayer,57,287,344,0,52,UCBPlayer
10202,UCBPlayer,48,323,371,0,43,UCBPlayer
10203,UCBPlayer,87,282,369,7,46,UCBPlayer
10204,UCBPlayer,56,291,347,0,51,UCBPlayer
10205,UCBPlayer,72,252,324,1,59,UCBPlayer
10206,UCBPlayer,92,307,399,10,37,UCBPlayer
10207,UCBPlayer,70,270,340,2,54,UCBPlayer
10208,UCBPlayer,51,311,362,0,46,UCBPlayer
10209,UCBPlayer,50,315,365,0,45,UCBPlayer
10210,UCBPlayer,59,279,338,0,54,UCBPlayer
10211,UCBPlayer,46,331,377,0,41,UCBPlayer
10212,UCBPlayer,53,303,356,0,48,UCBPlayer
10213,UCBPlayer,64,294,358,2,48,UCBPlayer
10214,UCBPlayer,62,302,364,2,46,UCBPlayer
10215,UCBPlayer,50,315,365,0,45,UCBPlayer
10216,UCBPlayer,56,291,347,0,51,UCBPlayer
10217,UCBPlayer,47,327,374,0,42,UCBPlayer
10218,UCBPlayer,59,279,338,0,54,UCBPlayer
10219,UCBPlayer,88,303,391,11,40,UCBPlayer
10220,UCBPlayer,58,283,341,0,53,UCBPlayer
10221,UCBPlayer,120,250,370,11,47,UCBPlayer
10222,UCBPlayer,63,288,351,1,50,UCBPlayer
10223,UCBPlayer,92,292,384,10,42,UCBPlayer
10224,UCBPlayer,108,253,361,8,49,UCBPlayer
10225,UCBPlayer,54,299,353,0,49,UCBPlayer
10226,UCBPlayer,112,262,374,9,45,UCBPlayer
10227,UCBPlayer,54,299,353,0,49,UCBPlayer
10228,UCBPlayer,65,270,335,0,55,UCBPlayer
10229,UCBPlayer,58,283,341,0,53,UCBPlayer
10230,UCBPlayer,87,272,359,6,49,UCBPlayer
10231,UCBPlayer,62,267,329,0,57,UCBPlayer
10232,UCBPlayer,49,319,368,0,44,UCBPlayer
10233,UCBPlayer,56,326,382,5,41,UCBPlayer
10234,UCBPlayer,73,303,376,5,43,UCBPlayer
10235,UCBPlayer,60,290,350,0,50,UCBPlayer
10236,UCBPlayer,53,313,366,1,45,UCBPlayer
10237,UCBPlayer,60,300,360,1,47,UCBPlayer
10238,UCBPlayer,57,287,344,0,52,UCBPlayer
10239,UCBPlayer,49,319,368,0,44,UCBPlayer
10240,UCBPlayer,51,311,362,0,46,UCBPlayer
10241,UCBPlayer,57,297,354,1,49,UCBPlayer
10242,UCBPlayer,66,276,342,1,53,UCBPlayer
10243,UCBPlayer,89,279,368,6,46,UCBPlayer
10244,UCBPlayer,53,303,356,0,48,UCBPlayer
10245,UCBPlayer,55,295,350,0,50,UCBPlayer
10246,UCBPlayer,50,315,365,0,45,UCBPlayer
10247,UCBPlayer,51,311,362,0,46,UCBPlayer
10248,UCBPlayer,48,323,371,0,43,UCBPlayer
10249,UCBPlayer,59,279,338,0,54,UCBPlayer
10250,UCBPlayer,44,324,368,0,44,UCBPlayer
10251,UCBPlayer,53,303,356,0,48,UCBPlayer
10252,UCBPlayer,73,283,356,3,49,UCBPlayer
10253,UCBPlayer,67,272,339,1,54,UCBPlayer
10254,UCBPlayer,66,276,342,1,53,UCBPlayer
10255,UCBPlayer,61,271,332,0,56,UCBPlayer
10256,UCBPlayer,67,312,379,5,42,UCBPlayer
10257,UCBPlayer,89,304,393,7,38,UCBPlayer
10258,UCBPlayer,43,343,386,0,38,UCBPlayer
10259,UCBPlayer,70,290,360,4,48,UCBPlayer
10260,UCBPlayer,73,278,351,1,50,UCBPlayer
10261,UCBPlayer,90,260,350,6,52,UCBPlayer
10262,UCBPlayer,59,294,353,0,49,UCBPlayer
10263,UCBPlayer,44,339,383,0,39,UCBPlayer
10264,UCBPlayer,59,279,338,0,54,UCBPlayer
10265,UCBPlayer,140,245,385,11,42,UCBPlayer
10266,UCBPlayer,48,323,371,0,43,UCBPlayer
10267,UCBPlayer,78,273,351,4,51,UCBPlayer
10268,UCBPlayer,57,312,369,1,44,UCBPlayer
10269,UCBPlayer,57,287,344,0,52,UCBPlayer
10270,UCBPlayer,139,264,403,14,37,UCBPlayer
10271,UCBPlayer,57,287,344,0,52,UCBPlayer
10272,UCBPlayer,52,307,359,0,47,UCBPlayer
10273,UCBPlayer,102,312,414,13,33,UCBPlayer
10274,UCBPlayer,63,313,376,2,42,UCBPlayer
10275,UCBPlayer,64,284,348,1,51,UCBPlayer
10276,UCBPlayer,60,310,370,2,44,UCBPlayer
10277,UCBPlayer,52,317,369,1,44,UCBPlayer
10278,UCBPlayer,58,318,376,2,42,UCBPlayer
10279,UCBPlayer,50,315,365,0,45,UCBPlayer
10280,UCBPlayer,121,266,387,13,42,UCBPlayer
10281,UCBPlayer,92,277,369,7,46,UCBPlayer
10282,UCBPlayer,49,329,378,1,41,UCBPlayer
10283,UCBPlayer,78,273,351,4,51,UCBPlayer
10284,UCBPlayer,53,303,356,0,48,UCBPlayer
10285,UCBPlayer,59,279,338,0,54,UCBPlayer
10286,UCBPlayer,128,293,421,17,32,UCBPlayer
10287,UCBPlayer,116,276,392,6,38,UCBPlayer
10288,UCBPlayer,62,277,339,1,54,UCBPlayer
10289,UCBPlayer,56,306,362,0,46,UCBPlayer
10290,UCBPlayer,54,319,373,2,43,UCBPlayer
10291,UCBPlayer,99,259,358,8,50,UCBPlayer
10292,UCBPlayer,71,286,357,4,49,UCBPlayer
10293,UCBPlayer,69,274,343,2,53,UCBPlayer
10294,UCBPlayer,62,282,344,0,52,UCBPlayer
10295,UCBPlayer,67,287,354,1,49,UCBPlayer
10296,UCBPlayer,50,310,360,1,47,UCBPlayer
10297,UCBPlayer,63,293,356,0,48,UCBPlayer
10298,UCBPlayer,48,323,371,0,43,UCBPlayer
10299,UCBPlayer,56,301,357,1,48,UCBPlayer
10300,UCBPlayer,73,283,356,3,49,UCBPlayer
10301,UCBPlayer,96,281,377,9,44,UCBPlayer
10302,UCBPlayer,50,315,365,0,45,UCBPlayer
10303,UCBPlayer,49,319,368,0,44,UCBPlayer
10304,UCBPlayer,52,307,359,0,47,UCBPlayer
10305,UCBPlayer,60,300,360,1,47,UCBPlayer
10306,UCBPlayer,85,285,370,8,46,UCBPlayer
10307,UCBPlayer,49,319,368,0,44,UCBPlayer
10308,UCBPlayer,69,274,343,2,53,UCBPlayer
10309,UCBPlayer,46,331,377,0,41,UCBPlayer
10310,UCBPlayer,85,290,375,7,44,UCBPlayer
10311,UCBPlayer,51,311,362,0,46,UCBPlayer
10312,UCBPlayer,51,311,362,0,46,UCBPlayer
10313,UCBPlayer,54,299,353,0,49,UCBPlayer
10314,UCBPlayer,62,317,379,2,41,UCBPlayer
10315,UCBPlayer,56,291,347,0,51,UCBPlayer
10316,UCBPlayer,76,261,337,2,55,UCBPlayer
10317,UCBPlayer,54,299,353,0,49,UCBPlayer
10318,UCBPlayer,48,323,371,0,43,UCBPlayer
10319,UCBPlayer,55,295,350,0,50,UCBPlayer
10320,UCBPlayer,56,311,367,2,45,UCBPlayer
10321,UCBPlayer,158,273,431,24,31,UCBPlayer
10322,UCBPlayer,63,288,351,1,50,UCBPlayer
10323,UCBPlayer,58,283,341,0,53,UCBPlayer
10324,UCBPlayer,62,267,329,0,57,UCBPlayer
10325,UCBPlayer,58,308,366,1,45,UCBPlayer
10326,UCBPlayer,63,323,386,6,40,UCBPlayer
10327,UCBPlayer,65,310,375,4,43,UCBPlayer
10328,UCBPlayer,58,318,376,2,42,UCBPlayer
10329,UCBPlayer,57,287,344,0,52,UCBPlayer
10330,UCBPlayer,52,307,359,0,47,UCBPlayer
10331,UCBPlayer,49,319,368,0,44,UCBPlayer
10332,UCBPlayer,56,291,347,0,51,UCBPlayer
10333,UCBPlayer,51,311,362,0,46,UCBPlayer
10334,UCBPlayer,58,283,341,0,53,UCBPlayer
10335,UCBPlayer,63,288,351,1,50,UCBPlayer
10336,UCBPlayer,58,298,356,0,48,UCBPlayer
10337,UCBPlayer,51,311,362,0,46,UCBPlayer
10338,UCBPlayer,48,323,371,0,43,UCBPlayer
10339,UCBPlayer,50,315,365,0,45,UCBPlayer
10340,UCBPlayer,54,299,353,0,49,UCBPlayer
10341,UCBPlayer,57,287,344,0,52,UCBPlayer
10342,UCBPlayer,57,287,344,0,52,UCBPlayer
10343,UCBPlayer,68,268,336,1,55,UCBPlayer
10344,UCBPlayer,57,302,359,0,47,UCBPlayer
10345,UCBPlayer,53,303,356,0,48,UCBPlayer
10346,UCBPlayer,66,271,337,2,55,UCBPlayer
10347,UCBPlayer,59,324,383,3,40,UCBPlayer
10348,UCBPlayer,77,267,344,3,53,UCBPlayer
10349,UCBPlayer,54,299,353,0,49,UCBPlayer
10350,UCBPlayer,57,292,349,2,51,UCBPlayer
10351,UCBPlayer,66,291,357,1,48,UCBPlayer
10352,UCBPlayer,78,238,316,2,62,UCBPlayer
10353,UCBPlayer,58,283,341,0,53,UCBPlayer
10354,UCBPlayer,65,300,365,3,46,UCBPlayer
10355,UCBPlayer,47,327,374,0,42,UCBPlayer
10356,UCBPlayer,70,260,330,1,57,UCBPlayer
10357,UCBPlayer,79,259,338,3,55,UCBPlayer
10358,UCBPlayer,58,318,376,2,42,UCBPlayer
10359,UCBPlayer,60,300,360,1,47,UCBPlayer
10360,UCBPlayer,60,320,380,3,41,UCBPlayer
10361,UCBPlayer,74,289,363,4,47,UCBPlayer
10362,UCBPlayer,66,286,352,2,50,UCBPlayer
10363,UCBPlayer,81,311,392,9,39,UCBPlayer
10364,UCBPlayer,95,295,390,10,40,UCBPlayer
10365,UCBPlayer,155,235,390,16,42,UCBPlayer
10366,UCBPlayer,53,303,356,0,48,UCBPlayer
10367,UCBPlayer,71,266,337,2,55,UCBPlayer
10368,UCBPlayer,60,330,390,4,38,UCBPlayer
10369,UCBPlayer,61,286,347,0,51,UCBPlayer
10370,UCBPlayer,68,318,386,6,40,UCBPlayer
10371,UCBPlayer,237,207,444,31,29,Player A
10372,UCBPlayer,133,268,401,9,36,UCBPlayer
10373,UCBPlayer,56,291,347,0,51,UCBPlayer
10374,UCBPlayer,84,279,363,7,48,UCBPlayer
10375,UCBPlayer,74,279,353,3,50,UCBPlayer
10376,UCBPlayer,63,308,371,3,44,UCBPlayer
10377,UCBPlayer,55,295,350,0,50,UCBPlayer
10378,UCBPlayer,58,303,361,2,47,UCBPlayer
10379,UCBPlayer,60,290,350,0,50,UCBPlayer
10380,UCBPlayer,52,307,359,0,47,UCBPlayer
10381,UCBPlayer,84,324,408,7,33,UCBPlayer
10382,UCBPlayer,56,291,347,0,51,UCBPlayer
10383,UCBPlayer,58,283,341,0,53,UCBPlayer
10384,UCBPlayer,168,228,396,22,42,UCBPlayer
10385,UCBPlayer,86,296,382,2,40,UCBPlayer
10386,UCBPlayer,49,329,378,1,41,UCBPlayer
10387,UCBPlayer,53,318,371,0,43,UCBPlayer
10388,UCBPlayer,66,311,377,3,42,UCBPlayer
10389,UCBPlayer,69,299,368,3,45,UCBPlayer
10390,UCBPlayer,59,299,358,2,48,UCBPlayer
10391,UCBPlayer,74,284,358,2,48,UCBPlayer
10392,UCBPlayer,60,285,345,1,52,UCBPlayer
10393,UCBPlayer,79,259,338,3,55,UCBPlayer
10394,UCBPlayer,62,292,354,1,49,UCBPlayer
10395,UCBPlayer,51,331,382,2,40,UCBPlayer
10396,UCBPlayer,60,300,360,1,47,UCBPlayer
10397,UCBPlayer,63,313,376,5,43,UCBPlayer
10398,UCBPlayer,82,282,364,5,47,UCBPlayer
10399,UCBPlayer,63,278,341,0,53,UCBPlayer
10400,UCBPlayer,67,272,339,1,54,UCBPlayer
10401,UCBPlayer,65,275,340,2,54,UCBPlayer
10402,UCBPlayer,121,256,377,12,45,UCBPlayer
10403,UCBPlayer,75,275,350,3,51,UCBPlayer
10404,UCBPlayer,55,295,350,0,50,UCBPlayer
10405,UCBPlayer,67,272,339,1,54,UCBPlayer
10406,UCBPlayer,71,281,352,2,50,UCBPlayer
10407,UCBPlayer,80,265,345,4,53,UCBPlayer
10408,UCBPlayer,54,299,353,0,49,UCBPlayer
10409,UCBPlayer,85,260,345,4,53,UCBPlayer
10410,UCBPlayer,61,296,357,1,48,UCBPlayer
10411,UCBPlayer,79,304,383,6,41,UCBPlayer
10412,UCBPlayer,64,309,373,2,43,UCBPlayer
10413,UCBPlayer,64,304,368,3,45,UCBPlayer
10414,UCBPlayer,100,245,345,7,54,UCBPlayer
10415,UCBPlayer,70,285,355,2,49,UCBPlayer
10416,UCBPlayer,60,290,350,0,50,UCBPlayer
10417,UCBPlayer,56,316,372,1,43,UCBPlayer
10418,UCBPlayer,51,311,362,0,46,UCBPlayer
10419,UCBPlayer,59,314,373,2,43,UCBPlayer
10420,UCBPlayer,63,288,351,1,50,UCBPlayer
10421,UCBPlayer,63,263,326,0,58,UCBPlayer
10422,UCBPlayer,66,276,342,1,53,UCBPlayer
10423,UCBPlayer,58,283,341,0,53,UCBPlayer
10424,UCBPlayer,67,302,369,4,45,UCBPlayer
10425,UCBPlayer,64,304,368,3,45,UCBPlayer
10426,UCBPlayer,59,279,338,0,54,UCBPlayer
10427,UCBPlayer,84,284,368,9,47,UCBPlayer
10428,UCBPlayer,48,323,371,0,43,UCBPlayer
10429,UCBPlayer,52,307,359,0,47,UCBPlayer
10430,UCBPlayer,74,299,373,5,44,UCBPlayer
10431,UCBPlayer,68,293,361,2,47,UCBPlayer
10432,UCBPlayer,53,303,356,0,48,UCBPlayer
10433,UCBPlayer,55,295,350,0,50,UCBPlayer
10434,UCBPlayer,66,311,377,3,42,UCBPlayer
10435,UCBPlayer,59,279,338,0,54,UCBPlayer
10436,UCBPlayer,67,282,349,2,51,UCBPlayer
10437,UCBPlayer,56,311,367,2,45,UCBPlayer
10438,UCBPlayer,63,278,341,0,53,UCBPlayer
10439,UCBPlayer,50,325,375,1,42,UCBPlayer
10440,UCBPlayer,82,282,364,5,47,UCBPlayer
10441,UCBPlayer,60,320,380,3,41,UCBPlayer
10442,UCBPlayer,68,278,346,2,52,UCBPlayer
10443,UCBPlayer,57,317,374,3,43,UCBPlayer
10444,UCBPlayer,67,272,339,1,54,UCBPlayer
10445,UCBPlayer,50,315,365,0,45,UCBPlayer
10446,UCBPlayer,72,277,349,2,51,UCBPlayer
10447,UCBPlayer,58,313,371,3,44,UCBPlayer
10448,UCBPlayer,59,304,363,1,46,UCBPlayer
10449,UCBPlayer,69,264,333,1,56,UCBPlayer
10450,UCBPlayer,83,303,386,9,41,UCBPlayer
10451,UCBPlayer,72,282,354,1,49,UCBPlayer
10452,UCBPlayer,58,293,351,1,50,UCBPlayer
10453,UCBPlayer,78,243,321,1,60,UCBPlayer
10454,UCBPlayer,50,300,350,0,50,UCBPlayer
10455,UCBPlayer,43,353,396,1,35,UCBPlayer
10456,UCBPlayer,55,320,375,1,42,UCBPlayer
10457,UCBPlayer,58,283,341,0,53,UCBPlayer
10458,UCBPlayer,59,314,373,2,43,UCBPlayer
10459,UCBPlayer,68,318,386,6,40,UCBPlayer
10460,UCBPlayer,82,297,379,8,43,UCBPlayer
10461,UCBPlayer,60,330,390,4,38,UCBPlayer
10462,UCBPlayer,65,305,370,2,44,UCBPlayer
10463,UCBPlayer,80,280,360,4,48,UCBPlayer
10464,UCBPlayer,118,288,406,14,36,UCBPlayer
10465,UCBPlayer,55,295,350,0,50,UCBPlayer
10466,UCBPlayer,62,292,354,1,49,UCBPlayer
10467,UCBPlayer,59,314,373,2,43,UCBPlayer
10468,UCBPlayer,57,287,344,0,52,UCBPlayer
10469,UCBPlayer,49,319,368,0,44,UCBPlayer
10470,UCBPlayer,60,275,335,0,55,UCBPlayer
10471,UCBPlayer,63,278,341,0,53,UCBPlayer
10472,UCBPlayer,116,276,392,12,40,UCBPlayer
10473,UCBPlayer,59,279,338,0,54,UCBPlayer
10474,UCBPlayer,63,278,341,0,53,UCBPlayer
10475,UCBPlayer,51,311,362,0,46,UCBPlayer
10476,UCBPlayer,55,295,350,0,50,UCBPlayer
10477,UCBPlayer,48,323,371,0,43,UCBPlayer
10478,UCBPlayer,68,278,346,2,52,UCBPlayer
10479,UCBPlayer,69,299,368,3,45,UCBPlayer
10480,UCBPlayer,60,300,360,1,47,UCBPlayer
10481,UCBPlayer,61,296,357,1,48,UCBPlayer
10482,UCBPlayer,60,275,335,0,55,UCBPlayer
10483,UCBPlayer,86,256,342,4,54,UCBPlayer
10484,UCBPlayer,72,307,379,5,42,UCBPlayer
10485,UCBPlayer,52,307,359,0,47,UCBPlayer
10486,UCBPlayer,96,236,332,3,57,UCBPlayer
10487,UCBPlayer,49,319,368,0,44,UCBPlayer
10488,UCBPlayer,63,298,361,2,47,UCBPlayer
10489,UCBPlayer,50,315,365,0,45,UCBPlayer
10490,UCBPlayer,53,303,356,0,48,UCBPlayer
10491,UCBPlayer,63,288,351,1,50,UCBPlayer
10492,UCBPlayer,48,323,371,0,43,UCBPlayer
10493,UCBPlayer,119,264,383,12,43,UCBPlayer
10494,UCBPlayer,81,306,387,4,39,UCBPlayer
10495,UCBPlayer,80,245,325,2,59,UCBPlayer
10496,UCBPlayer,58,308,366,1,45,UCBPlayer
10497,UCBPlayer,56,291,347,0,51,UCBPlayer
10498,UCBPlayer,63,263,326,0,58,UCBPlayer
10499,UCBPlayer,73,273,346,2,52,UCBPlayer
10500,UCBPlayer,78,283,361,5,48,UCBPlayer
10501,UCBPlayer,53,303,356,0,48,UCBPlayer
10502,UCBPlayer,46,341,387,1,38,UCBPlayer
10503,UCBPlayer,58,298,356,0,48,UCBPlayer
10504,UCBPlayer,52,302,354,1,49,UCBPlayer
10505,UCBPlayer,95,270,365,9,48,UCBPlayer
10506,UCBPlayer,50,315,365,0,45,UCBPlayer
10507,UCBPlayer,55,295,350,0,50,UCBPlayer
10508,UCBPlayer,51,311,362,0,46,UCBPlayer
10509,UCBPlayer,49,319,368,0,44,UCBPlayer
10510,UCBPlayer,96,281,377,9,44,UCBPlayer
10511,UCBPlayer,68,258,326,0,58,UCBPlayer
10512,UCBPlayer,64,274,338,0,54,UCBPlayer
10513,UCBPlayer,65,310,375,4,43,UCBPlayer
10514,UCBPlayer,75,290,365,6,47,UCBPlayer
10515,UCBPlayer,56,316,372,1,43,UCBPlayer
10516,UCBPlayer,70,250,320,0,60,UCBPlayer
10517,UCBPlayer,142,247,389,15,42,UCBPlayer
10518,UCBPlayer,55,295,350,0,50,UCBPlayer
10519,UCBPlayer,51,311,362,0,46,UCBPlayer
10520,UCBPlayer,87,267,354,4,50,UCBPlayer
10521,UCBPlayer,69,289,358,2,48,UCBPlayer
10522,UCBPlayer,93,293,386,9,41,UCBPlayer
10523,UCBPlayer,52,307,359,0,47,UCBPlayer
10524,UCBPlayer,61,296,357,1,48,UCBPlayer
10525,UCBPlayer,60,310,370,2,44,UCBPlayer
10526,UCBPlayer,53,303,356,0,48,UCBPlayer
10527,UCBPlayer,69,254,323,0,59,UCBPlayer
10528,UCBPlayer,56,291,347,0,51,UCBPlayer
10529,UCBPlayer,65,290,355,2,49,UCBPlayer
10530,UCBPlayer,66,276,342,1,53,UCBPlayer
10531,UCBPlayer,80,290,370,8,46,UCBPlayer
10532,UCBPlayer,64,294,358,2,48,UCBPlayer
10533,UCBPlayer,84,314,398,6,36,UCBPlayer
10534,UCBPlayer,74,269,343,2,53,UCBPlayer
10535,UCBPlayer,101,276,377,9,44,UCBPlayer
10536,UCBPlayer,58,293,351,1,50,UCBPlayer
10537,UCBPlayer,59,304,363,1,46,UCBPlayer
10538,UCBPlayer,57,312,369,1,44,UCBPlayer
10539,UCBPlayer,58,318,376,2,42,UCBPlayer
10540,UCBPlayer,53,303,356,0,48,UCBPlayer
10541,UCBPlayer,60,295,355,2,49,UCBPlayer
10542,UCBPlayer,68,268,336,1,55,UCBPlayer
10543,UCBPlayer,57,307,364,2,46,UCBPlayer
10544,UCBPlayer,56,306,362,0,46,UCBPlayer
10545,UCBPlayer,59,279,338,0,54,UCBPlayer
10546,UCBPlayer,54,309,363,1,46,UCBPlayer
10547,UCBPlayer,45,335,380,0,40,UCBPlayer
10548,UCBPlayer,55,295,350,0,50,UCBPlayer
10549,UCBPlayer,55,295,350,0,50,UCBPlayer
10550,UCBPlayer,50,315,365,0,45,UCBPlayer
10551,UCBPlayer,62,277,339,1,54,UCBPlayer
10552,UCBPlayer,58,328,386,3,39,UCBPlayer
10553,UCBPlayer,77,282,359,6,49,UCBPlayer
10554,UCBPlayer,104,274,378,10,44,UCBPlayer
10555,UCBPlayer,79,289,368,3,45,UCBPlayer
10556,UCBPlayer,52,292,344,0,52,UCBPlayer
10557,UCBPlayer,53,303,356,0,48,UCBPlayer
10558,UCBPlayer,170,240,410,21,37,UCBPlayer
10559,UCBPlayer,56,291,347,0,51,UCBPlayer
10560,UCBPlayer,62,292,354,1,49,UCBPlayer
10561,UCBPlayer,44,339,383,0,39,UCBPlayer
10562,UCBPlayer,51,311,362,0,46,UCBPlayer
10563,UCBPlayer,57,287,344,0,52,UCBPlayer
10564,UCBPlayer,62,302,364,2,46,UCBPlayer
10565,UCBPlayer,60,275,335,0,55,UCBPlayer
10566,UCBPlayer,52,317,369,1,44,UCBPlayer
10567,UCBPlayer,72,262,334,2,56,UCBPlayer
10568,UCBPlayer,59,314,373,2,43,UCBPlayer
10569,UCBPlayer,47,327,374,0,42,UCBPlayer
10570,UCBPlayer,65,310,375,4,43,UCBPlayer
10571,UCBPlayer,52,307,359,0,47,UCBPlayer
10572,UCBPlayer,55,330,385,2,39,UCBPlayer
10573,UCBPlayer,74,304,378,4,42,UCBPlayer
10574,UCBPlayer,42,347,389,0,37,UCBPlayer
10575,UCBPlayer,90,265,355,5,50,UCBPlayer
10576,UCBPlayer,55,295,350,0,50,UCBPlayer
10577,UCBPlayer,52,307,359,0,47,UCBPlayer
10578,UCBPlayer,51,311,362,0,46,UCBPlayer
10579,UCBPlayer,55,295,350,0,50,UCBPlayer
10580,UCBPlayer,53,303,356,0,48,UCBPlayer
10581,UCBPlayer,52,307,359,0,47,UCBPlayer
10582,UCBPlayer,56,291,347,0,51,UCBPlayer
10583,UCBPlayer,80,305,385,8,41,UCBPlayer
10584,UCBPlayer,55,295,350,0,50,UCBPlayer
10585,UCBPlayer,47,327,374,0,42,UCBPlayer
10586,UCBPlayer,45,335,380,0,40,UCBPlayer
10587,UCBPlayer,70,270,340,2,54,UCBPlayer
10588,UCBPlayer,62,302,364,2,46,UCBPlayer
10589,UCBPlayer,56,291,347,0,51,UCBPlayer
10590,UCBPlayer,62,267,329,0,57,UCBPlayer
10591,UCBPlayer,51,311,362,0,46,UCBPlayer
10592,UCBPlayer,58,283,341,0,53,UCBPlayer
10593,UCBPlayer,59,294,353,0,49,UCBPlayer
10594,UCBPlayer,48,323,371,0,43,UCBPlayer
10595,UCBPlayer,50,315,365,0,45,UCBPlayer
10596,UCBPlayer,70,300,370,2,44,UCBPlayer
10597,UCBPlayer,54,299,353,0,49,UCBPlayer
10598,UCBPlayer,45,335,380,0,40,UCBPlayer
10599,UCBPlayer,82,282,364,5,47,UCBPlayer
10600,UCBPlayer,50,315,365,0,45,UCBPlayer
10601,UCBPlayer,67,307,374,3,43,UCBPlayer
10602,UCBPlayer,75,265,340,2,54,UCBPlayer
10603,UCBPlayer,61,271,332,0,56,UCBPlayer
10604,UCBPlayer,52,327,379,2,41,UCBPlayer
10605,UCBPlayer,80,285,365,6,47,UCBPlayer
10606,UCBPlayer,44,334,378,1,41,UCBPlayer
10607,UCBPlayer,149,254,403,17,38,UCBPlayer
10608,UCBPlayer,49,319,368,0,44,UCBPlayer
10609,UCBPlayer,101,281,382,11,43,UCBPlayer
10610,UCBPlayer,68,268,336,1,55,UCBPlayer
10611,UCBPlayer,113,288,401,15,38,UCBPlayer
10612,UCBPlayer,55,295,350,0,50,UCBPlayer
10613,UCBPlayer,65,290,355,2,49,UCBPlayer
10614,UCBPlayer,58,283,341,0,53,UCBPlayer
10615,UCBPlayer,56,316,372,1,43,UCBPlayer
10616,UCBPlayer,88,283,371,6,45,UCBPlayer
10617,UCBPlayer,57,287,344,0,52,UCBPlayer
10618,UCBPlayer,64,284,348,1,51,UCBPlayer
10619,UCBPlayer,56,291,347,0,51,UCBPlayer
10620,UCBPlayer,54,324,378,1,41,UCBPlayer
10621,UCBPlayer,82,267,349,5,52,UCBPlayer
10622,UCBPlayer,71,296,367,5,46,UCBPlayer
10623,UCBPlayer,71,281,352,2,50,UCBPlayer
10624,UCBPlayer,50,315,365,0,45,UCBPlayer
10625,UCBPlayer,87,307,394,11,39,UCBPlayer
10626,UCBPlayer,71,261,332,0,56,UCBPlayer
10627,UCBPlayer,65,290,355,2,49,UCBPlayer
10628,UCBPlayer,61,306,367,2,45,UCBPlayer
10629,UCBPlayer,51,321,372,1,43,UCBPlayer
10630,UCBPlayer,63,298,361,2,47,UCBPlayer
10631,UCBPlayer,52,307,359,0,47,UCBPlayer
10632,UCBPlayer,74,264,338,3,55,UCBPlayer
10633,UCBPlayer,103,263,366,10,48,UCBPlayer
10634,UCBPlayer,71,266,337,2,55,UCBPlayer
10635,UCBPlayer,58,298,356,0,48,UCBPlayer
10636,UCBPlayer,58,293,351,1,50,UCBPlayer
10637,UCBPlayer,107,252,359,9,50,UCBPlayer
10638,UCBPlayer,53,333,386,3,39,UCBPlayer
10639,UCBPlayer,68,288,356,3,49,UCBPlayer
10640,UCBPlayer,58,313,371,3,44,UCBPlayer
10641,UCBPlayer,76,296,372,4,44,UCBPlayer
10642,UCBPlayer,50,315,365,0,45,UCBPlayer
10643,UCBPlayer,64,259,323,0,59,UCBPlayer
10644,UCBPlayer,97,282,379,8,43,UCBPlayer
10645,UCBPlayer,51,311,362,0,46,UCBPlayer
10646,UCBPlayer,89,299,388,8,40,UCBPlayer
10647,UCBPlayer,55,295,350,0,50,UCBPlayer
10648,UCBPlayer,50,315,365,0,45,UCBPlayer
10649,UCBPlayer,56,301,357,1,48,UCBPlayer
10650,UCBPlayer,55,325,380,3,41,UCBPlayer
10651,UCBPlayer,54,334,388,2,38,UCBPlayer
10652,UCBPlayer,51,311,362,0,46,UCBPlayer
10653,UCBPlayer,81,241,322,2,60,UCBPlayer
10654,UCBPlayer,53,323,376,2,42,UCBPlayer
10655,UCBPlayer,62,282,344,0,52,UCBPlayer
10656,UCBPlayer,51,311,362,0,46,UCBPlayer
10657,UCBPlayer,44,334,378,1,41,UCBPlayer
10658,UCBPlayer,59,294,353,0,49,UCBPlayer
10659,UCBPlayer,99,289,388,11,41,UCBPlayer
10660,UCBPlayer,69,254,323,0,59,UCBPlayer
10661,UCBPlayer,70,280,350,3,51,UCBPlayer
10662,UCBPlayer,72,282,354,1,49,UCBPlayer
10663,UCBPlayer,83,278,361,5,48,UCBPlayer
10664,UCBPlayer,55,340,395,3,36,UCBPlayer
10665,UCBPlayer,65,300,365,3,46,UCBPlayer
10666,UCBPlayer,75,280,355,2,49,UCBPlayer
10667,UCBPlayer,52,307,359,0,47,UCBPlayer
10668,UCBPlayer,56,291,347,0,51,UCBPlayer
10669,UCBPlayer,71,256,327,1,58,UCBPlayer
10670,UCBPlayer,88,283,371,9,46,UCBPlayer
10671,UCBPlayer,57,312,369,1,44,UCBPlayer
10672,UCBPlayer,102,262,364,8,48,UCBPlayer
10673,UCBPlayer,58,283,341,0,53,UCBPlayer
10674,UCBPlayer,80,265,345,4,53,UCBPlayer
10675,UCBPlayer,150,245,395,15,40,UCBPlayer
10676,UCBPlayer,56,291,347,0,51,UCBPlayer
10677,UCBPlayer,58,283,341,0,53,UCBPlayer
10678,UCBPlayer,59,314,373,2,43,UCBPlayer
10679,UCBPlayer,79,304,383,9,42,UCBPlayer
10680,UCBPlayer,86,286,372,7,45,UCBPlayer
10681,UCBPlayer,60,310,370,2,44,UCBPlayer
10682,UCBPlayer,92,267,359,6,49,UCBPlayer
10683,UCBPlayer,52,307,359,0,47,UCBPlayer
10684,UCBPlayer,59,279,338,0,54,UCBPlayer
10685,UCBPlayer,74,279,353,3,50,UCBPlayer
10686,UCBPlayer,68,278,346,2,52,UCBPlayer
10687,UCBPlayer,95,285,380,12,44,UCBPlayer
10688,UCBPlayer,86,266,352,5,51,UCBPlayer
10689,UCBPlayer,102,257,359,9,50,UCBPlayer
10690,UCBPlayer,64,274,338,0,54,UCBPlayer
10691,UCBPlayer,53,303,356,0,48,UCBPlayer
10692,UCBPlayer,52,307,359,0,47,UCBPlayer
10693,UCBPlayer,94,279,373,11,46,UCBPlayer
10694,UCBPlayer,52,307,359,0,47,UCBPlayer
10695,UCBPlayer,59,289,348,1,51,UCBPlayer
10696,UCBPlayer,102,287,389,9,40,UCBPlayer
10697,UCBPlayer,76,301,377,3,42,UCBPlayer
10698,UCBPlayer,67,292,359,3,48,UCBPlayer
10699,UCBPlayer,50,315,365,0,45,UCBPlayer
10700,UCBPlayer,51,311,362,0,46,UCBPlayer
10701,UCBPlayer,53,303,356,0,48,UCBPlayer
10702,UCBPlayer,51,311,362,0,46,UCBPlayer
10703,UCBPlayer,52,307,359,0,47,UCBPlayer
10704,UCBPlayer,52,307,359,0,47,UCBPlayer
10705,UCBPlayer,58,298,356,3,49,UCBPlayer
10706,UCBPlayer,75,280,355,2,49,UCBPlayer
10707,UCBPlayer,69,284,353,3,50,UCBPlayer
10708,UCBPlayer,91,276,367,5,46,UCBPlayer
10709,UCBPlayer,48,308,356,0,48,UCBPlayer
10710,UCBPlayer,50,315,365,0,45,UCBPlayer
10711,UCBPlayer,49,319,368,0,44,UCBPlayer
10712,UCBPlayer,51,311,362,0,46,UCBPlayer
10713,UCBPlayer,55,295,350,0,50,UCBPlayer
10714,UCBPlayer,54,324,378,1,41,UCBPlayer
10715,UCBPlayer,49,319,368,0,44,UCBPlayer
10716,UCBPlayer,57,327,384,1,39,UCBPlayer
10717,UCBPlayer,86,271,357,4,49,UCBPlayer
10718,UCBPlayer,76,281,357,4,49,UCBPlayer
10719,UCBPlayer,71,306,377,6,43,UCBPlayer
10720,UCBPlayer,83,273,356,6,50,UCBPlayer
10721,UCBPlayer,139,229,368,12,48,UCBPlayer
10722,UCBPlayer,48,333,381,1,40,UCBPlayer
10723,UCBPlayer,65,280,345,1,52,UCBPlayer
10724,UCBPlayer,70,290,360,4,48,UCBPlayer
10725,UCBPlayer,69,299,368,3,45,UCBPlayer
10726,UCBPlayer,61,296,357,1,48,UCBPlayer
10727,UCBPlayer,55,295,350,0,50,UCBPlayer
10728,UCBPlayer,60,275,335,0,55,UCBPlayer
10729,UCBPlayer,54,299,353,0,49,UCBPlayer
10730,UCBPlayer,69,284,353,3,50,UCBPlayer
10731,UCBPlayer,136,281,417,13,32,UCBPlayer
10732,UCBPlayer,45,335,380,0,40,UCBPlayer
10733,UCBPlayer,60,275,335,0,55,UCBPlayer
10734,UCBPlayer,64,299,363,1,46,UCBPlayer
10735,UCBPlayer,112,282,394,14,40,UCBPlayer
10736,UCBPlayer,82,287,369,7,46,UCBPlayer
10737,UCBPlayer,52,307,359,0,47,UCBPlayer
10738,UCBPlayer,45,335,380,0,40,UCBPlayer
10739,UCBPlayer,61,296,357,1,48,UCBPlayer
10740,UCBPlayer,93,283,376,8,44,UCBPlayer
10741,UCBPlayer,107,262,369,10,47,UCBPlayer
10742,UCBPlayer,67,282,349,2,51,UCBPlayer
10743,UCBPlayer,59,279,338,0,54,UCBPlayer
10744,UCBPlayer,53,303,356,0,48,UCBPlayer
10745,UCBPlayer,53,303,356,0,48,UCBPlayer
10746,UCBPlayer,75,285,360,4,48,UCBPlayer
10747,UCBPlayer,74,259,333,1,56,UCBPlayer
10748,UCBPlayer,59,319,378,4,42,UCBPlayer
10749,UCBPlayer,57,337,394,5,37,UCBPlayer
10750,UCBPlayer,57,312,369,1,44,UCBPlayer
10751,UCBPlayer,59,304,363,1,46,UCBPlayer
10752,UCBPlayer,61,286,347,0,51,UCBPlayer
10753,UCBPlayer,77,267,344,3,53,UCBPlayer
10754,UCBPlayer,79,264,343,2,53,UCBPlayer
10755,UCBPlayer,73,298,371,6,45,UCBPlayer
10756,UCBPlayer,86,246,332,0,56,UCBPlayer
10757,UCBPlayer,83,253,336,4,56,UCBPlayer
10758,UCBPlayer,50,315,365,0,45,UCBPlayer
10759,UCBPlayer,58,283,341,0,53,UCBPlayer
10760,UCBPlayer,41,336,377,0,41,UCBPlayer
10761,UCBPlayer,57,287,344,0,52,UCBPlayer
10762,UCBPlayer,50,315,365,0,45,UCBPlayer
10763,UCBPlayer,78,288,366,4,46,UCBPlayer
10764,UCBPlayer,81,291,372,7,45,UCBPlayer
10765,UCBPlayer,168,233,401,21,40,UCBPlayer
10766,UCBPlayer,57,287,344,0,52,UCBPlayer
10767,UCBPlayer,61,271,332,0,56,UCBPlayer
10768,UCBPlayer,67,292,359,3,48,UCBPlayer
10769,UCBPlayer,55,330,385,2,39,UCBPlayer
10770,UCBPlayer,53,303,356,0,48,UCBPlayer
10771,UCBPlayer,66,306,372,4,44,UCBPlayer
10772,UCBPlayer,68,258,326,0,58,UCBPlayer
10773,UCBPlayer,57,287,344,0,52,UCBPlayer
10774,UCBPlayer,48,323,371,0,43,UCBPlayer
10775,UCBPlayer,82,287,369,7,46,UCBPlayer
10776,UCBPlayer,86,276,362,6,48,UCBPlayer
10777,UCBPlayer,61,296,357,1,48,UCBPlayer
10778,UCBPlayer,98,263,361,5,48,UCBPlayer
10779,UCBPlayer,64,284,348,1,51,UCBPlayer
10780,UCBPlayer,53,303,356,0,48,UCBPlayer
10781,UCBPlayer,66,326,392,6,38,UCBPlayer
10782,UCBPlayer,51,311,362,0,46,UCBPlayer
10783,UCBPlayer,70,250,320,0,60,UCBPlayer
10784,UCBPlayer,52,307,359,0,47,UCBPlayer
10785,UCBPlayer,91,251,342,4,54,UCBPlayer
10786,UCBPlayer,72,262,334,2,56,UCBPlayer
10787,UCBPlayer,47,327,374,0,42,UCBPlayer
10788,UCBPlayer,55,305,360,1,47,UCBPlayer
10789,UCBPlayer,64,284,348,1,51,UCBPlayer
10790,UCBPlayer,54,309,363,1,46,UCBPlayer
10791,UCBPlayer,64,294,358,2,48,UCBPlayer
10792,UCBPlayer,67,287,354,1,49,UCBPlayer
10793,UCBPlayer,56,291,347,0,51,UCBPlayer
10794,UCBPlayer,65,290,355,2,49,UCBPlayer
10795,UCBPlayer,54,309,363,1,46,UCBPlayer
10796,UCBPlayer,68,258,326,0,58,UCBPlayer
10797,UCBPlayer,54,299,353,0,49,UCBPlayer
10798,UCBPlayer,56,311,367,2,45,UCBPlayer
10799,UCBPlayer,63,278,341,0,53,UCBPlayer
10800,UCBPlayer,51,311,362,0,46,UCBPlayer
10801,UCBPlayer,55,295,350,0,50,UCBPlayer
10802,UCBPlayer,56,311,367,2,45,UCBPlayer
10803,UCBPlayer,91,251,342,4,54,UCBPlayer
10804,UCBPlayer,43,353,396,1,35,UCBPlayer
10805,UCBPlayer,87,297,384,7,41,UCBPlayer
10806,UCBPlayer,54,304,358,2,48,UCBPlayer
10807,UCBPlayer,80,280,360,4,48,UCBPlayer
10808,UCBPlayer,62,282,344,0,52,UCBPlayer
10809,UCBPlayer,59,279,338,0,54,UCBPlayer
10810,UCBPlayer,55,290,345,1,52,UCBPlayer
10811,UCBPlayer,80,280,360,4,48,UCBPlayer
10812,UCBPlayer,64,314,378,4,42,UCBPlayer
10813,UCBPlayer,64,304,368,3,45,UCBPlayer
10814,UCBPlayer,63,323,386,3,39,UCBPlayer
10815,UCBPlayer,57,312,369,1,44,UCBPlayer
10816,UCBPlayer,120,270,390,16,42,UCBPlayer
10817,UCBPlayer,58,283,341,0,53,UCBPlayer
10818,UCBPlayer,75,300,375,4,43,UCBPlayer
10819,UCBPlayer,68,293,361,2,47,UCBPlayer
10820,UCBPlayer,50,315,365,0,45,UCBPlayer
10821,UCBPlayer,74,304,378,7,43,UCBPlayer
10822,UCBPlayer,67,287,354,1,49,UCBPlayer
10823,UCBPlayer,87,282,369,7,46,UCBPlayer
10824,UCBPlayer,63,308,371,3,44,UCBPlayer
10825,UCBPlayer,63,288,351,1,50,UCBPlayer
10826,UCBPlayer,49,319,368,0,44,UCBPlayer
10827,UCBPlayer,63,263,326,0,58,UCBPlayer
10828,UCBPlayer,55,295,350,0,50,UCBPlayer
10829,UCBPlayer,53,303,356,0,48,UCBPlayer
10830,UCBPlayer,67,302,369,4,45,UCBPlayer
10831,UCBPlayer,85,270,355,5,50,UCBPlayer
10832,UCBPlayer,56,291,347,0,51,UCBPlayer
10833,UCBPlayer,49,319,368,0,44,UCBPlayer
10834,UCBPlayer,50,315,365,0,45,UCBPlayer
10835,UCBPlayer,56,291,347,0,51,UCBPlayer
10836,UCBPlayer,59,304,363,1,46,UCBPlayer
10837,UCBPlayer,55,305,360,1,47,UCBPlayer
10838,UCBPlayer,56,306,362,0,46,UCBPlayer
10839,UCBPlayer,69,264,333,1,56,UCBPlayer
10840,UCBPlayer,55,295,350,0,50,UCBPlayer
10841,UCBPlayer,54,299,353,0,49,UCBPlayer
10842,UCBPlayer,61,286,347,0,51,UCBPlayer
10843,UCBPlayer,51,311,362,0,46,UCBPlayer
10844,UCBPlayer,62,292,354,1,49,UCBPlayer
10845,UCBPlayer,62,292,354,1,49,UCBPlayer
10846,UCBPlayer,57,287,344,0,52,UCBPlayer
10847,UCBPlayer,128,288,416,15,33,UCBPlayer
10848,UCBPlayer,78,283,361,2,47,UCBPlayer
10849,UCBPlayer,52,327,379,2,41,UCBPlayer
10850,UCBPlayer,62,302,364,2,46,UCBPlayer
10851,UCBPlayer,52,307,359,0,47,UCBPlayer
10852,UCBPlayer,52,322,374,3,43,UCBPlayer
10853,UCBPlayer,73,283,356,3,49,UCBPlayer
10854,UCBPlayer,60,310,370,2,44,UCBPlayer
10855,UCBPlayer,62,312,374,3,43,UCBPlayer
10856,UCBPlayer,73,273,346,2,52,UCBPlayer
10857,UCBPlayer,73,303,376,2,42,UCBPlayer
10858,UCBPlayer,50,315,365,0,45,UCBPlayer
10859,UCBPlayer,63,298,361,2,47,UCBPlayer
10860,UCBPlayer,81,296,377,6,43,UCBPlayer
10861,UCBPlayer,93,273,366,7,47,UCBPlayer
10862,UCBPlayer,43,328,371,0,43,UCBPlayer
10863,UCBPlayer,72,312,384,7,41,UCBPlayer
10864,UCBPlayer,93,303,396,10,38,UCBPlayer
10865,UCBPlayer,62,312,374,3,43,UCBPlayer
10866,UCBPlayer,55,295,350,0,50,UCBPlayer
10867,UCBPlayer,84,279,363,7,48,UCBPlayer
10868,UCBPlayer,58,283,341,0,53,UCBPlayer
10869,UCBPlayer,58,283,341,0,53,UCBPlayer
10870,UCBPlayer,96,286,382,5,41,UCBPlayer
10871,UCBPlayer,65,320,385,5,40,UCBPlayer
10872,UCBPlayer,93,238,331,5,58,UCBPlayer
10873,UCBPlayer,79,239,318,1,61,UCBPlayer
10874,UCBPlayer,51,311,362,0,46,UCBPlayer
10875,UCBPlayer,49,329,378,1,41,UCBPlayer
10876,UCBPlayer,57,287,344,0,52,UCBPlayer
10877,UCBPlayer,70,285,355,2,49,UCBPlayer
10878,UCBPlayer,73,273,346,2,52,UCBPlayer
10879,UCBPlayer,69,314,383,6,41,UCBPlayer
10880,UCBPlayer,56,291,347,0,51,UCBPlayer
10881,UCBPlayer,76,276,352,2,50,UCBPlayer
10882,UCBPlayer,57,287,344,0,52,UCBPlayer
10883,UCBPlayer,53,303,356,0,48,UCBPlayer
10884,UCBPlayer,65,290,355,2,49,UCBPlayer
10885,UCBPlayer,63,298,361,2,47,UCBPlayer
10886,UCBPlayer,92,287,379,8,43,UCBPlayer
10887,UCBPlayer,56,291,347,0,51,UCBPlayer
10888,UCBPlayer,56,291,347,0,51,UCBPlayer
10889,UCBPlayer,140,240,380,15,45,UCBPlayer
10890,UCBPlayer,67,297,364,2,46,UCBPlayer
10891,UCBPlayer,52,307,359,0,47,UCBPlayer
10892,UCBPlayer,58,308,366,1,45,UCBPlayer
10893,UCBPlayer,61,271,332,0,56,UCBPlayer
10894,UCBPlayer,60,300,360,1,47,UCBPlayer
10895,UCBPlayer,87,292,379,5,42,UCBPlayer
10896,UCBPlayer,51,311,362,0,46,UCBPlayer
10897,UCBPlayer,48,323,371,0,43,UCBPlayer
10898,UCBPlayer,61,296,357,1,48,UCBPlayer
10899,UCBPlayer,55,295,350,0,50,UCBPlayer
10900,UCBPlayer,118,258,376,8,44,UCBPlayer
10901,UCBPlayer,58,298,356,0,48,UCBPlayer
10902,UCBPlayer,53,303,356,0,48,UCBPlayer
10903,UCBPlayer,56,301,357,1,48,UCBPlayer
10904,UCBPlayer,56,306,362,0,46,UCBPlayer
10905,UCBPlayer,57,312,369,1,44,UCBPlayer
10906,UCBPlayer,71,281,352,2,50,UCBPlayer
10907,UCBPlayer,50,315,365,0,45,UCBPlayer
10908,UCBPlayer,60,285,345,1,52,UCBPlayer
10909,UCBPlayer,70,270,340,2,54,UCBPlayer
10910,UCBPlayer,55,315,370,2,44,UCBPlayer
10911,UCBPlayer,78,268,346,2,52,UCBPlayer
10912,UCBPlayer,49,314,363,1,46,UCBPlayer
10913,UCBPlayer,96,256,352,5,51,UCBPlayer
10914,UCBPlayer,91,276,367,5,46,UCBPlayer
10915,UCBPlayer,66,296,362,3,47,UCBPlayer
10916,UCBPlayer,58,283,341,0,53,UCBPlayer
10917,UCBPlayer,58,308,366,1,45,UCBPlayer
10918,UCBPlayer,64,284,348,1,51,UCBPlayer
10919,UCBPlayer,81,291,372,7,45,UCBPlayer
10920,UCBPlayer,59,279,338,0,54,UCBPlayer
10921,UCBPlayer,47,327,374,0,42,UCBPlayer
10922,UCBPlayer,74,269,343,2,53,UCBPlayer
10923,UCBPlayer,59,279,338,0,54,UCBPlayer
10924,UCBPlayer,70,295,365,3,46,UCBPlayer
10925,UCBPlayer,74,269,343,2,53,UCBPlayer
10926,UCBPlayer,62,267,329,0,57,UCBPlayer
10927,UCBPlayer,65,270,335,0,55,UCBPlayer
10928,UCBPlayer,58,318,376,2,42,UCBPlayer
10929,UCBPlayer,49,319,368,0,44,UCBPlayer
10930,UCBPlayer,55,295,350,0,50,UCBPlayer
10931,UCBPlayer,46,331,377,0,41,UCBPlayer
10932,UCBPlayer,58,283,341,0,53,UCBPlayer
10933,UCBPlayer,89,259,348,4,52,UCBPlayer
10934,UCBPlayer,55,320,375,1,42,UCBPlayer
10935,UCBPlayer,88,283,371,9,46,UCBPlayer
10936,UCBPlayer,66,301,367,2,45,UCBPlayer
10937,UCBPlayer,67,282,349,2,51,UCBPlayer
10938,UCBPlayer,51,311,362,0,46,UCBPlayer
10939,UCBPlayer,56,291,347,0,51,UCBPlayer
10940,UCBPlayer,93,253,346,5,53,UCBPlayer
10941,UCBPlayer,69,289,358,2,48,UCBPlayer
10942,UCBPlayer,59,279,338,0,54,UCBPlayer
10943,UCBPlayer,144,259,403,14,37,UCBPlayer
10944,UCBPlayer,52,327,379,2,41,UCBPlayer
10945,UCBPlayer,82,237,319,2,61,UCBPlayer
10946,UCBPlayer,152,257,409,17,36,UCBPlayer
10947,UCBPlayer,144,279,423,16,31,UCBPlayer
10948,UCBPlayer,54,314,368,0,44,UCBPlayer
10949,UCBPlayer,63,263,326,0,58,UCBPlayer
10950,UCBPlayer,62,307,369,4,45,UCBPlayer
10951,UCBPlayer,120,260,380,12,44,UCBPlayer
10952,UCBPlayer,41,351,392,0,36,UCBPlayer
10953,UCBPlayer,58,283,341,0,53,UCBPlayer
10954,UCBPlayer,71,286,357,4,49,UCBPlayer
10955,UCBPlayer,51,311,362,0,46,UCBPlayer
10956,UCBPlayer,85,250,335,3,56,UCBPlayer
10957,UCBPlayer,65,280,345,1,52,UCBPlayer
10958,UCBPlayer,54,299,353,0,49,UCBPlayer
10959,UCBPlayer,48,323,371,0,43,UCBPlayer
10960,UCBPlayer,48,323,371,0,43,UCBPlayer
10961,UCBPlayer,59,279,338,0,54,UCBPlayer
10962,UCBPlayer,48,328,376,2,42,UCBPlayer
10963,UCBPlayer,92,312,404,9,35,UCBPlayer
10964,UCBPlayer,45,320,365,0,45,UCBPlayer
10965,UCBPlayer,124,244,368,9,47,UCBPlayer
10966,UCBPlayer,50,315,365,0,45,UCBPlayer
10967,UCBPlayer,60,275,335,0,55,UCBPlayer
10968,UCBPlayer,172,237,409,20,37,UCBPlayer
10969,UCBPlayer,62,337,399,7,36,UCBPlayer
10970,UCBPlayer,120,240,360,13,51,UCBPlayer
10971,UCBPlayer,56,291,347,0,51,UCBPlayer
10972,UCBPlayer,75,265,340,2,54,UCBPlayer
10973,UCBPlayer,48,323,371,0,43,UCBPlayer
10974,UCBPlayer,142,232,374,12,46,UCBPlayer
10975,UCBPlayer,60,275,335,0,55,UCBPlayer
10976,UCBPlayer,62,322,384,4,40,UCBPlayer
10977,UCBPlayer,107,267,374,9,45,UCBPlayer
10978,UCBPlayer,50,315,365,0,45,UCBPlayer
10979,UCBPlayer,64,274,338,0,54,UCBPlayer
10980,UCBPlayer,71,276,347,3,52,UCBPlayer
10981,UCBPlayer,58,308,366,1,45,UCBPlayer
10982,UCBPlayer,53,328,381,1,40,UCBPlayer
10983,UCBPlayer,59,314,373,2,43,UCBPlayer
10984,UCBPlayer,112,262,374,9,45,UCBPlayer
10985,UCBPlayer,68,293,361,2,47,UCBPlayer
10986,UCBPlayer,78,293,371,6,45,UCBPlayer
10987,UCBPlayer,66,276,342,1,53,UCBPlayer
10988,UCBPlayer,93,263,356,6,50,UCBPlayer
10989,UCBPlayer,49,319,368,0,44,UCBPlayer
10990,UCBPlayer,177,212,389,18,43,UCBPlayer
10991,UCBPlayer,69,284,353,3,50,UCBPlayer
10992,UCBPlayer,58,313,371,3,44,UCBPlayer
10993,UCBPlayer,58,298,356,0,48,UCBPlayer
10994,UCBPlayer,79,304,383,6,41,UCBPlayer
10995,UCBPlayer,71,286,357,4,49,UCBPlayer
10996,UCBPlayer,53,313,366,1,45,UCBPlayer
10997,UCBPlayer,74,259,333,1,56,UCBPlayer
10998,UCBPlayer,84,289,373,5,44,UCBPlayer
10999,UCBPlayer,50,315,365,0,45,UCBPlayer
11000,UCBPlayer,74,309,383,6,41,UCBPlayer
11001,UCBPlayer,61,286,347,0,51,UCBPlayer
11002,UCBPlayer,52,307,359,0,47,UCBPlayer
11003,UCBPlayer,51,311,362,0,46,UCBPlayer
11004,UCBPlayer,72,282,354,4,50,UCBPlayer
11005,UCBPlayer,78,318,396,10,38,UCBPlayer
11006,UCBPlayer,67,307,374,3,43,UCBPlayer
11007,UCBPlayer,78,258,336,1,55,UCBPlayer
11008,UCBPlayer,58,283,341,0,53,UCBPlayer
11009,UCBPlayer,54,299,353,0,49,UCBPlayer
11010,UCBPlayer,70,265,335,3,56,UCBPlayer
11011,UCBPlayer,68,293,361,2,47,UCBPlayer
11012,UCBPlayer,57,302,359,0,47,UCBPlayer
11013,UCBPlayer,45,335,380,0,40,UCBPlayer
11014,UCBPlayer,49,314,363,1,46,UCBPlayer
11015,UCBPlayer,66,276,342,1,53,UCBPlayer
11016,UCBPlayer,50,315,365,0,45,UCBPlayer
11017,UCBPlayer,52,307,359,0,47,UCBPlayer
11018,UCBPlayer,101,281,382,11,43,UCBPlayer
11019,UCBPlayer,99,279,378,7,43,UCBPlayer
11020,UCBPlayer,68,258,326,0,58,UCBPlayer
11021,UCBPlayer,52,307,359,0,47,UCBPlayer
11022,UCBPlayer,68,298,366,4,46,UCBPlayer
11023,UCBPlayer,49,329,378,1,41,UCBPlayer
11024,UCBPlayer,50,315,365,0,45,UCBPlayer
11025,UCBPlayer,41,351,392,0,36,UCBPlayer
11026,UCBPlayer,66,276,342,1,53,UCBPlayer
11027,UCBPlayer,73,273,346,2,52,UCBPlayer
11028,UCBPlayer,123,238,361,11,50,UCBPlayer
11029,UCBPlayer,81,286,367,5,46,UCBPlayer
11030,UCBPlayer,68,278,346,2,52,UCBPlayer
11031,UCBPlayer,52,307,359,0,47,UCBPlayer
11032,UCBPlayer,52,307,359,0,47,UCBPlayer
11033,UCBPlayer,46,331,377,0,41,UCBPlayer
11034,UCBPlayer,60,275,335,0,55,UCBPlayer
11035,UCBPlayer,55,295,350,0,50,UCBPlayer
11036,UCBPlayer,81,301,382,5,41,UCBPlayer
11037,UCBPlayer,49,319,368,0,44,UCBPlayer
11038,UCBPlayer,47,327,374,0,42,UCBPlayer
11039,UCBPlayer,65,280,345,1,52,UCBPlayer
11040,UCBPlayer,73,263,336,1,55,UCBPlayer
11041,UCBPlayer,48,323,371,0,43,UCBPlayer
11042,UCBPlayer,55,295,350,0,50,UCBPlayer
11043,UCBPlayer,56,291,347,0,51,UCBPlayer
11044,UCBPlayer,56,301,357,1,48,UCBPlayer
11045,UCBPlayer,66,286,352,2,50,UCBPlayer
11046,UCBPlayer,54,299,353,0,49,UCBPlayer
11047,UCBPlayer,45,335,380,0,40,UCBPlayer
11048,UCBPlayer,52,307,359,0,47,UCBPlayer
11049,UCBPlayer,91,256,347,6,53,UCBPlayer
11050,UCBPlayer,64,284,348,1,51,UCBPlayer
11051,UCBPlayer,51,311,362,0,46,UCBPlayer
11052,UCBPlayer,67,282,349,2,51,UCBPlayer
11053,UCBPlayer,62,287,349,2,51,UCBPlayer
11054,UCBPlayer,63,348,411,7,32,UCBPlayer
11055,UCBPlayer,90,285,375,10,45,UCBPlayer
11056,UCBPlayer,53,323,376,2,42,UCBPlayer
11057,UCBPlayer,91,311,402,10,36,UCBPlayer
11058,UCBPlayer,66,296,362,3,47,UCBPlayer
11059,UCBPlayer,54,309,363,1,46,UCBPlayer
11060,UCBPlayer,56,306,362,0,46,UCBPlayer
11061,UCBPlayer,61,271,332,0,56,UCBPlayer
11062,UCBPlayer,72,292,364,2,46,UCBPlayer
11063,UCBPlayer,65,285,350,3,51,UCBPlayer
11064,UCBPlayer,112,272,384,7,41,UCBPlayer
11065,UCBPlayer,64,274,338,0,54,UCBPlayer
11066,UCBPlayer,55,280,335,0,55,UCBPlayer
11067,UCBPlayer,47,327,374,0,42,UCBPlayer
11068,UCBPlayer,54,299,353,0,49,UCBPlayer
11069,UCBPlayer,62,302,364,2,46,UCBPlayer
11070,UCBPlayer,162,232,394,17,41,UCBPlayer
11071,UCBPlayer,143,263,406,14,36,UCBPlayer
11072,UCBPlayer,64,304,368,3,45,UCBPlayer
11073,UCBPlayer,66,286,352,2,50,UCBPlayer
11074,UCBPlayer,73,288,361,2,47,UCBPlayer
11075,UCBPlayer,51,311,362,0,46,UCBPlayer
11076,UCBPlayer,52,307,359,0,47,UCBPlayer
11077,UCBPlayer,54,299,353,0,49,UCBPlayer
11078,UCBPlayer,49,319,368,0,44,UCBPlayer
11079,UCBPlayer,66,306,372,4,44,UCBPlayer
11080,UCBPlayer,67,272,339,1,54,UCBPlayer
11081,UCBPlayer,52,307,359,0,47,UCBPlayer
11082,UCBPlayer,96,261,357,7,50,UCBPlayer
11083,UCBPlayer,57,287,344,0,52,UCBPlayer
11084,UCBPlayer,90,290,380,6,42,UCBPlayer
11085,UCBPlayer,49,329,378,1,41,UCBPlayer
11086,UCBPlayer,118,253,371,12,47,UCBPlayer
11087,UCBPlayer,64,294,358,2,48,UCBPlayer
11088,UCBPlayer,120,260,380,12,44,UCBPlayer
11089,UCBPlayer,51,311,362,0,46,UCBPlayer
11090,UCBPlayer,55,295,350,0,50,UCBPlayer
11091,UCBPlayer,46,331,377,0,41,UCBPlayer
11092,UCBPlayer,68,298,366,4,46,UCBPlayer
11093,UCBPlayer,53,303,356,0,48,UCBPlayer
11094,UCBPlayer,51,311,362,0,46,UCBPlayer
11095,UCBPlayer,56,291,347,0,51,UCBPlayer
11096,UCBPlayer,72,287,359,3,48,UCBPlayer
11097,UCBPlayer,79,259,338,3,55,UCBPlayer
11098,UCBPlayer,56,301,357,1,48,UCBPlayer
11099,UCBPlayer,63,298,361,2,47,UCBPlayer
11100,UCBPlayer,72,267,339,1,54,UCBPlayer
11101,UCBPlayer,109,269,378,7,43,UCBPlayer
11102,UCBPlayer,57,287,344,0,52,UCBPlayer
11103,UCBPlayer,66,311,377,3,42,UCBPlayer
11104,UCBPlayer,55,295,350,0,50,UCBPlayer
11105,UCBPlayer,49,319,368,0,44,UCBPlayer
11106,UCBPlayer,51,311,362,0,46,UCBPlayer
11107,UCBPlayer,55,320,375,1,42,UCBPlayer
11108,UCBPlayer,56,291,347,0,51,UCBPlayer
11109,UCBPlayer,57,287,344,0,52,UCBPlayer
11110,UCBPlayer,87,287,374,6,44,UCBPlayer
11111,UCBPlayer,73,278,351,1,50,UCBPlayer
11112,UCBPlayer,52,307,359,0,47,UCBPlayer
11113,UCBPlayer,68,258,326,0,58,UCBPlayer
11114,UCBPlayer,49,329,378,1,41,UCBPlayer
11115,UCBPlayer,68,278,346,2,52,UCBPlayer
11116,UCBPlayer,53,318,371,0,43,UCBPlayer
11117,UCBPlayer,56,276,332,0,56,UCBPlayer
11118,UCBPlayer,71,256,327,1,58,UCBPlayer
11119,UCBPlayer,62,292,354,1,49,UCBPlayer
11120,UCBPlayer,79,289,368,3,45,UCBPlayer
11121,UCBPlayer,51,311,362,0,46,UCBPlayer
11122,UCBPlayer,52,307,359,0,47,UCBPlayer
11123,UCBPlayer,56,291,347,0,51,UCBPlayer
11124,UCBPlayer,54,299,353,0,49,UCBPlayer
11125,UCBPlayer,62,302,364,2,46,UCBPlayer
11126,UCBPlayer,50,315,365,0,45,UCBPlayer
11127,UCBPlayer,80,285,365,6,47,UCBPlayer
11128,UCBPlayer,44,349,393,1,36,UCBPlayer
11129,UCBPlayer,59,279,338,0,54,UCBPlayer
11130,UCBPlayer,51,311,362,0,46,UCBPlayer
11131,UCBPlayer,61,271,332,0,56,UCBPlayer
11132,UCBPlayer,60,275,335,0,55,UCBPlayer
11133,UCBPlayer,53,318,371,0,43,UCBPlayer
11134,UCBPlayer,105,265,370,8,46,UCBPlayer
11135,UCBPlayer,49,319,368,0,44,UCBPlayer
11136,UCBPlayer,58,283,341,0,53,UCBPlayer
11137,UCBPlayer,52,307,359,0,47,UCBPlayer
11138,UCBPlayer,157,232,389,18,43,UCBPlayer
11139,UCBPlayer,75,295,370,5,45,UCBPlayer
11140,UCBPlayer,60,275,335,0,55,UCBPlayer
11141,UCBPlayer,76,281,357,4,49,UCBPlayer
11142,UCBPlayer,88,278,366,4,46,UCBPlayer
11143,UCBPlayer,54,299,353,0,49,UCBPlayer
11144,UCBPlayer,80,270,350,3,51,UCBPlayer
11145,UCBPlayer,74,274,348,4,52,UCBPlayer
11146,UCBPlayer,59,279,338,0,54,UCBPlayer
11147,UCBPlayer,48,323,371,0,43,UCBPlayer
11148,UCBPlayer,54,299,353,0,49,UCBPlayer
11149,UCBPlayer,82,247,329,3,58,UCBPlayer
11150,UCBPlayer,69,274,343,2,53,UCBPlayer
11151,UCBPlayer,52,332,384,1,39,UCBPlayer
11152,UCBPlayer,56,291,347,0,51,UCBPlayer
11153,UCBPlayer,59,279,338,0,54,UCBPlayer
11154,UCBPlayer,55,330,385,2,39,UCBPlayer
11155,UCBPlayer,58,283,341,0,53,UCBPlayer
11156,UCBPlayer,52,307,359,0,47,UCBPlayer
11157,UCBPlayer,73,273,346,2,52,UCBPlayer
11158,UCBPlayer,77,267,344,3,53,UCBPlayer
11159,UCBPlayer,68,283,351,1,50,UCBPlayer
11160,UCBPlayer,56,291,347,0,51,UCBPlayer
11161,UCBPlayer,54,299,353,0,49,UCBPlayer
11162,UCBPlayer,71,306,377,3,42,UCBPlayer
11163,UCBPlayer,72,277,349,2,51,UCBPlayer
11164,UCBPlayer,54,324,378,4,42,UCBPlayer
11165,UCBPlayer,80,260,340,2,54,UCBPlayer
11166,UCBPlayer,59,304,363,1,46,UCBPlayer
11167,UCBPlayer,57,282,339,1,54,UCBPlayer
11168,UCBPlayer,59,304,363,1,46,UCBPlayer
11169,UCBPlayer,61,316,377,3,42,UCBPlayer
11170,UCBPlayer,67,282,349,2,51,UCBPlayer
11171,UCBPlayer,55,330,385,2,39,UCBPlayer
11172,UCBPlayer,49,319,368,0,44,UCBPlayer
11173,UCBPlayer,53,303,356,0,48,UCBPlayer
11174,UCBPlayer,52,307,359,0,47,UCBPlayer
11175,UCBPlayer,58,318,376,2,42,UCBPlayer
11176,UCBPlayer,52,307,359,0,47,UCBPlayer
11177,UCBPlayer,99,284,383,12,43,UCBPlayer
11178,UCBPlayer,58,283,341,0,53,UCBPlayer
11179,UCBPlayer,114,254,368,15,49,UCBPlayer
11180,UCBPlayer,63,288,351,1,50,UCBPlayer
11181,UCBPlayer,113,283,396,16,40,UCBPlayer
11182,UCBPlayer,55,295,350,0,50,UCBPlayer
11183,UCBPlayer,60,310,370,2,44,UCBPlayer
11184,UCBPlayer,57,287,344,0,52,UCBPlayer
11185,UCBPlayer,55,305,360,1,47,UCBPlayer
11186,UCBPlayer,79,299,378,7,43,UCBPlayer
11187,UCBPlayer,47,327,374,0,42,UCBPlayer
11188,UCBPlayer,61,296,357,1,48,UCBPlayer
11189,UCBPlayer,65,280,345,1,52,UCBPlayer
11190,UCBPlayer,52,307,359,0,47,UCBPlayer
11191,UCBPlayer,51,311,362,0,46,UCBPlayer
11192,UCBPlayer,58,283,341,0,53,UCBPlayer
11193,UCBPlayer,55,295,350,0,50,UCBPlayer
11194,UCBPlayer,55,295,350,0,50,UCBPlayer
11195,UCBPlayer,60,275,335,0,55,UCBPlayer
11196,UCBPlayer,62,267,329,0,57,UCBPlayer
11197,UCBPlayer,56,291,347,0,51,UCBPlayer
11198,UCBPlayer,62,302,364,2,46,UCBPlayer
11199,UCBPlayer,53,303,356,0,48,UCBPlayer
11200,UCBPlayer,56,291,347,0,51,UCBPlayer
11201,UCBPlayer,68,293,361,2,47,UCBPlayer
11202,UCBPlayer,49,319,368,0,44,UCBPlayer
11203,UCBPlayer,77,262,339,4,55,UCBPlayer
11204,UCBPlayer,57,287,344,0,52,UCBPlayer
11205,UCBPlayer,52,307,359,0,47,UCBPlayer
11206,UCBPlayer,53,303,356,0,48,UCBPlayer
11207,UCBPlayer,67,272,339,1,54,UCBPlayer
11208,UCBPlayer,61,271,332,0,56,UCBPlayer
11209,UCBPlayer,79,279,358,5,49,UCBPlayer
11210,UCBPlayer,57,287,344,0,52,UCBPlayer
11211,UCBPlayer,63,283,346,2,52,UCBPlayer
11212,UCBPlayer,66,296,362,3,47,UCBPlayer
11213,UCBPlayer,53,303,356,0,48,UCBPlayer
11214,UCBPlayer,51,311,362,0,46,UCBPlayer
11215,UCBPlayer,54,294,348,1,51,UCBPlayer
11216,UCBPlayer,83,238,321,1,60,UCBPlayer
11217,UCBPlayer,55,290,345,1,52,UCBPlayer
11218,UCBPlayer,75,280,355,2,49,UCBPlayer
11219,UCBPlayer,46,316,362,0,46,UCBPlayer
11220,UCBPlayer,68,288,356,3,49,UCBPlayer
11221,UCBPlayer,70,250,320,0,60,UCBPlayer
11222,UCBPlayer,75,230,305,0,65,UCBPlayer
11223,UCBPlayer,52,307,359,0,47,UCBPlayer
11224,UCBPlayer,66,296,362,3,47,UCBPlayer
11225,UCBPlayer,59,304,363,1,46,UCBPlayer
11226,UCBPlayer,58,283,341,0,53,UCBPlayer
11227,UCBPlayer,87,267,354,4,50,UCBPlayer
11228,UCBPlayer,69,289,358,2,48,UCBPlayer
11229,UCBPlayer,48,333,381,1,40,UCBPlayer
11230,UCBPlayer,58,298,356,0,48,UCBPlayer
11231,UCBPlayer,45,335,380,0,40,UCBPlayer
11232,UCBPlayer,65,290,355,2,49,UCBPlayer
11233,UCBPlayer,66,311,377,3,42,UCBPlayer
11234,UCBPlayer,54,299,353,0,49,UCBPlayer
11235,UCBPlayer,60,310,370,2,44,UCBPlayer
11236,UCBPlayer,56,311,367,2,45,UCBPlayer
11237,UCBPlayer,57,322,379,2,41,UCBPlayer
11238,UCBPlayer,101,281,382,8,42,UCBPlayer
11239,UCBPlayer,55,295,350,0,50,UCBPlayer
11240,UCBPlayer,55,295,350,0,50,UCBPlayer
11241,UCBPlayer,55,295,350,0,50,UCBPlayer
11242,UCBPlayer,92,267,359,6,49,UCBPlayer
11243,UCBPlayer,72,312,384,4,40,UCBPlayer
11244,UCBPlayer,74,234,308,0,64,UCBPlayer
11245,UCBPlayer,52,317,369,1,44,UCBPlayer
11246,UCBPlayer,72,287,359,3,48,UCBPlayer
11247,UCBPlayer,68,278,346,2,52,UCBPlayer
11248,UCBPlayer,49,339,388,2,38,UCBPlayer
11249,UCBPlayer,70,290,360,4,48,UCBPlayer
11250,UCBPlayer,54,299,353,0,49,UCBPlayer
11251,UCBPlayer,64,274,338,0,54,UCBPlayer
11252,UCBPlayer,54,299,353,0,49,UCBPlayer
11253,UCBPlayer,56,291,347,0,51,UCBPlayer
11254,UCBPlayer,57,297,354,1,49,UCBPlayer
11255,UCBPlayer,72,267,339,1,54,UCBPlayer
11256,UCBPlayer,59,279,338,0,54,UCBPlayer
11257,UCBPlayer,47,327,374,0,42,UCBPlayer
11258,UCBPlayer,68,298,366,4,46,UCBPlayer
11259,UCBPlayer,62,292,354,1,49,UCBPlayer
11260,UCBPlayer,53,303,356,0,48,UCBPlayer
11261,UCBPlayer,115,245,360,13,51,UCBPlayer
11262,UCBPlayer,70,300,370,2,44,UCBPlayer
11263,UCBPlayer,56,301,357,1,48,UCBPlayer
11264,UCBPlayer,55,310,365,0,45,UCBPlayer
11265,UCBPlayer,55,305,360,1,47,UCBPlayer
11266,UCBPlayer,60,290,350,0,50,UCBPlayer
11267,UCBPlayer,57,297,354,1,49,UCBPlayer
11268,UCBPlayer,55,320,375,1,42,UCBPlayer
11269,UCBPlayer,55,290,345,1,52,UCBPlayer
11270,UCBPlayer,64,284,348,1,51,UCBPlayer
11271,UCBPlayer,61,306,367,2,45,UCBPlayer
11272,UCBPlayer,69,264,333,1,56,UCBPlayer
11273,UCBPlayer,96,291,387,7,40,UCBPlayer
11274,UCBPlayer,53,303,356,0,48,UCBPlayer
11275,UCBPlayer,52,307,359,0,47,UCBPlayer
11276,UCBPlayer,71,286,357,4,49,UCBPlayer
11277,UCBPlayer,51,311,362,0,46,UCBPlayer
11278,UCBPlayer,58,308,366,1,45,UCBPlayer
11279,UCBPlayer,55,295,350,0,50,UCBPlayer
11280,UCBPlayer,64,294,358,2,48,UCBPlayer
11281,UCBPlayer,60,275,335,0,55,UCBPlayer
11282,UCBPlayer,54,299,353,0,49,UCBPlayer
11283,UCBPlayer,67,272,339,1,54,UCBPlayer
11284,UCBPlayer,78,263,341,3,54,UCBPlayer
11285,UCBPlayer,48,323,371,0,43,UCBPlayer
11286,UCBPlayer,52,327,379,2,41,UCBPlayer
11287,UCBPlayer,101,286,387,13,42,UCBPlayer
11288,UCBPlayer,52,332,384,1,39,UCBPlayer
11289,UCBPlayer,63,303,366,1,45,UCBPlayer
11290,UCBPlayer,62,292,354,1,49,UCBPlayer
11291,UCBPlayer,54,299,353,0,49,UCBPlayer
11292,UCBPlayer,77,282,359,3,48,UCBPlayer
11293,UCBPlayer,56,301,357,1,48,UCBPlayer
11294,UCBPlayer,73,268,341,3,54,UCBPlayer
11295,UCBPlayer,61,296,357,1,48,UCBPlayer
11296,UCBPlayer,68,268,336,1,55,UCBPlayer
11297,UCBPlayer,61,271,332,0,56,UCBPlayer
11298,UCBPlayer,49,319,368,0,44,UCBPlayer
11299,UCBPlayer,62,267,329,0,57,UCBPlayer
11300,UCBPlayer,50,315,365,0,45,UCBPlayer
11301,UCBPlayer,62,292,354,1,49,UCBPlayer
11302,UCBPlayer,71,286,357,4,49,UCBPlayer
11303,UCBPlayer,100,255,355,8,51,UCBPlayer
11304,UCBPlayer,55,295,350,0,50,UCBPlayer
11305,UCBPlayer,55,295,350,0,50,UCBPlayer
11306,UCBPlayer,53,303,356,0,48,UCBPlayer
11307,UCBPlayer,72,272,344,3,53,UCBPlayer
11308,UCBPlayer,53,303,356,0,48,UCBPlayer
11309,UCBPlayer,95,285,380,12,44,UCBPlayer
11310,UCBPlayer,122,262,384,10,42,UCBPlayer
11311,UCBPlayer,60,275,335,0,55,UCBPlayer
11312,UCBPlayer,62,282,344,0,52,UCBPlayer
11313,UCBPlayer,60,300,360,1,47,UCBPlayer
11314,UCBPlayer,56,291,347,0,51,UCBPlayer
11315,UCBPlayer,68,268,336,1,55,UCBPlayer
11316,UCBPlayer,53,308,361,2,47,UCBPlayer
11317,UCBPlayer,64,299,363,1,46,UCBPlayer
11318,UCBPlayer,50,340,390,1,37,UCBPlayer
11319,UCBPlayer,57,292,349,2,51,UCBPlayer
11320,UCBPlayer,68,303,371,3,44,UCBPlayer
11321,UCBPlayer,54,284,338,0,54,UCBPlayer
11322,UCBPlayer,54,299,353,0,49,UCBPlayer
11323,UCBPlayer,48,323,371,0,43,UCBPlayer
11324,UCBPlayer,60,275,335,0,55,UCBPlayer
11325,UCBPlayer,67,287,354,1,49,UCBPlayer
11326,UCBPlayer,55,295,350,0,50,UCBPlayer
11327,UCBPlayer,59,279,338,0,54,UCBPlayer
11328,UCBPlayer,74,299,373,5,44,UCBPlayer
11329,UCBPlayer,63,318,381,4,41,UCBPlayer
11330,UCBPlayer,58,283,341,0,53,UCBPlayer
11331,UCBPlayer,58,283,341,0,53,UCBPlayer
11332,UCBPlayer,62,282,344,0,52,UCBPlayer
11333,UCBPlayer,49,319,368,0,44,UCBPlayer
11334,UCBPlayer,77,262,339,1,54,UCBPlayer
11335,UCBPlayer,51,321,372,1,43,UCBPlayer
11336,UCBPlayer,53,318,371,0,43,UCBPlayer
11337,UCBPlayer,54,299,353,0,49,UCBPlayer
11338,UCBPlayer,57,287,344,0,52,UCBPlayer
11339,UCBPlayer,62,292,354,1,49,UCBPlayer
11340,UCBPlayer,54,299,353,0,49,UCBPlayer
11341,UCBPlayer,72,322,394,5,37,UCBPlayer
11342,UCBPlayer,50,315,365,0,45,UCBPlayer
11343,UCBPlayer,53,303,356,0,48,UCBPlayer
11344,UCBPlayer,55,295,350,0,50,UCBPlayer
11345,UCBPlayer,50,315,365,0,45,UCBPlayer
11346,UCBPlayer,53,303,356,0,48,UCBPlayer
11347,UCBPlayer,69,284,353,3,50,UCBPlayer
11348,UCBPlayer,78,263,341,3,54,UCBPlayer
11349,UCBPlayer,52,307,359,0,47,UCBPlayer
11350,UCBPlayer,58,308,366,1,45,UCBPlayer
11351,UCBPlayer,55,295,350,0,50,UCBPlayer
11352,UCBPlayer,57,297,354,1,49,UCBPlayer
11353,UCBPlayer,54,319,373,2,43,UCBPlayer
11354,UCBPlayer,59,304,363,1,46,UCBPlayer
11355,UCBPlayer,81,296,377,6,43,UCBPlayer
11356,UCBPlayer,52,317,369,1,44,UCBPlayer
11357,UCBPlayer,60,300,360,1,47,UCBPlayer
11358,UCBPlayer,58,283,341,0,53,UCBPlayer
11359,UCBPlayer,78,308,386,6,40,UCBPlayer
11360,UCBPlayer,54,299,353,0,49,UCBPlayer
11361,UCBPlayer,93,248,341,6,55,UCBPlayer
11362,UCBPlayer,57,287,344,0,52,UCBPlayer
11363,UCBPlayer,49,329,378,1,41,UCBPlayer
11364,UCBPlayer,68,288,356,3,49,UCBPlayer
11365,UCBPlayer,101,241,342,7,55,UCBPlayer
11366,UCBPlayer,101,271,372,7,45,UCBPlayer
11367,UCBPlayer,75,290,365,3,46,UCBPlayer
11368,UCBPlayer,75,275,350,3,51,UCBPlayer
11369,UCBPlayer,68,278,346,2,52,UCBPlayer
11370,UCBPlayer,61,296,357,1,48,UCBPlayer
11371,UCBPlayer,87,267,354,10,52,UCBPlayer
11372,UCBPlayer,76,281,357,4,49,UCBPlayer
11373,UCBPlayer,49,319,368,0,44,UCBPlayer
11374,UCBPlayer,60,300,360,1,47,UCBPlayer
11375,UCBPlayer,83,263,346,5,53,UCBPlayer
11376,UCBPlayer,53,303,356,0,48,UCBPlayer
11377,UCBPlayer,74,294,368,6,46,UCBPlayer
11378,UCBPlayer,95,275,370,8,46,UCBPlayer
11379,UCBPlayer,59,279,338,0,54,UCBPlayer
11380,UCBPlayer,54,299,353,0,49,UCBPlayer
11381,UCBPlayer,75,285,360,4,48,UCBPlayer
11382,UCBPlayer,44,339,383,0,39,UCBPlayer
11383,UCBPlayer,60,275,335,0,55,UCBPlayer
11384,UCBPlayer,55,295,350,0,50,UCBPlayer
11385,UCBPlayer,51,321,372,1,43,UCBPlayer
11386,UCBPlayer,53,328,381,1,40,UCBPlayer
11387,UCBPlayer,52,307,359,0,47,UCBPlayer
11388,UCBPlayer,66,306,372,4,44,UCBPlayer
11389,UCBPlayer,61,286,347,0,51,UCBPlayer
11390,UCBPlayer,65,290,355,2,49,UCBPlayer
11391,UCBPlayer,47,327,374,0,42,UCBPlayer
11392,UCBPlayer,53,323,376,2,42,UCBPlayer
11393,UCBPlayer,71,271,342,1,53,UCBPlayer
11394,UCBPlayer,58,283,341,0,53,UCBPlayer
11395,UCBPlayer,56,291,347,0,51,UCBPlayer
11396,UCBPlayer,57,287,344,0,52,UCBPlayer
11397,UCBPlayer,55,295,350,0,50,UCBPlayer
11398,UCBPlayer,73,263,336,1,55,UCBPlayer
11399,UCBPlayer,47,327,374,0,42,UCBPlayer
11400,UCBPlayer,49,319,368,0,44,UCBPlayer
11401,UCBPlayer,55,295,350,0,50,UCBPlayer
11402,UCBPlayer,144,249,393,16,41,UCBPlayer
11403,UCBPlayer,59,279,338,0,54,UCBPlayer
11404,UCBPlayer,57,287,344,0,52,UCBPlayer
11405,UCBPlayer,51,311,362,0,46,UCBPlayer
11406,UCBPlayer,44,349,393,1,36,UCBPlayer
11407,UCBPlayer,70,305,375,4,43,UCBPlayer
11408,UCBPlayer,61,286,347,0,51,UCBPlayer
11409,UCBPlayer,58,283,341,0,53,UCBPlayer
11410,UCBPlayer,62,302,364,2,46,UCBPlayer
11411,UCBPlayer,78,283,361,5,48,UCBPlayer
11412,UCBPlayer,80,290,370,5,45,UCBPlayer
11413,UCBPlayer,73,273,346,2,52,UCBPlayer
11414,UCBPlayer,48,323,371,0,43,UCBPlayer
11415,UCBPlayer,59,279,338,0,54,UCBPlayer
11416,UCBPlayer,54,299,353,0,49,UCBPlayer
11417,UCBPlayer,60,275,335,0,55,UCBPlayer
11418,UCBPlayer,79,269,348,4,52,UCBPlayer
11419,UCBPlayer,162,227,389,18,43,UCBPlayer
11420,UCBPlayer,59,314,373,2,43,UCBPlayer
11421,UCBPlayer,65,295,360,4,48,UCBPlayer
11422,UCBPlayer,91,256,347,6,53,UCBPlayer
11423,UCBPlayer,56,306,362,0,46,UCBPlayer
11424,UCBPlayer,54,299,353,0,49,UCBPlayer
11425,UCBPlayer,67,292,359,3,48,UCBPlayer
11426,UCBPlayer,60,300,360,1,47,UCBPlayer
11427,UCBPlayer,70,300,370,5,45,UCBPlayer
11428,UCBPlayer,76,291,367,5,46,UCBPlayer
11429,UCBPlayer,46,331,377,0,41,UCBPlayer
11430,UCBPlayer,50,315,365,0,45,UCBPlayer
11431,UCBPlayer,73,263,336,4,56,UCBPlayer
11432,UCBPlayer,66,281,347,0,51,UCBPlayer
11433,UCBPlayer,77,267,344,3,53,UCBPlayer
11434,UCBPlayer,52,307,359,0,47,UCBPlayer
11435,UCBPlayer,58,318,376,2,42,UCBPlayer
11436,UCBPlayer,60,300,360,1,47,UCBPlayer
11437,UCBPlayer,63,298,361,2,47,UCBPlayer
11438,UCBPlayer,60,275,335,0,55,UCBPlayer
11439,UCBPlayer,68,258,326,0,58,UCBPlayer
11440,UCBPlayer,67,292,359,3,48,UCBPlayer
11441,UCBPlayer,51,311,362,0,46,UCBPlayer
11442,UCBPlayer,64,284,348,1,51,UCBPlayer
11443,UCBPlayer,52,307,359,0,47,UCBPlayer
11444,UCBPlayer,60,300,360,1,47,UCBPlayer
11445,UCBPlayer,55,295,350,0,50,UCBPlayer
11446,UCBPlayer,72,277,349,2,51,UCBPlayer
11447,UCBPlayer,51,311,362,0,46,UCBPlayer
11448,UCBPlayer,58,308,366,1,45,UCBPlayer
11449,UCBPlayer,57,287,344,0,52,UCBPlayer
11450,UCBPlayer,59,279,338,0,54,UCBPlayer
11451,UCBPlayer,58,318,376,2,42,UCBPlayer
11452,UCBPlayer,46,331,377,0,41,UCBPlayer
11453,UCBPlayer,51,311,362,0,46,UCBPlayer
11454,UCBPlayer,51,311,362,0,46,UCBPlayer
11455,UCBPlayer,45,345,390,1,37,UCBPlayer
11456,UCBPlayer,64,299,363,1,46,UCBPlayer
11457,UCBPlayer,56,311,367,2,45,UCBPlayer
11458,UCBPlayer,79,264,343,2,53,UCBPlayer
11459,UCBPlayer,68,303,371,3,44,UCBPlayer
11460,UCBPlayer,59,304,363,1,46,UCBPlayer
11461,UCBPlayer,54,299,353,0,49,UCBPlayer
11462,UCBPlayer,67,272,339,1,54,UCBPlayer
11463,UCBPlayer,52,307,359,0,47,UCBPlayer
11464,UCBPlayer,59,279,338,0,54,UCBPlayer
11465,UCBPlayer,65,270,335,0,55,UCBPlayer
11466,UCBPlayer,53,313,366,1,45,UCBPlayer
11467,UCBPlayer,65,300,365,3,46,UCBPlayer
11468,UCBPlayer,77,267,344,3,53,UCBPlayer
11469,UCBPlayer,55,295,350,0,50,UCBPlayer
11470,UCBPlayer,97,277,374,9,45,UCBPlayer
11471,UCBPlayer,56,291,347,0,51,UCBPlayer
11472,UCBPlayer,66,271,337,2,55,UCBPlayer
11473,UCBPlayer,108,278,386,15,43,UCBPlayer
11474,UCBPlayer,63,288,351,1,50,UCBPlayer
11475,UCBPlayer,54,299,353,0,49,UCBPlayer
11476,UCBPlayer,58,308,366,1,45,UCBPlayer
11477,UCBPlayer,58,283,341,0,53,UCBPlayer
11478,UCBPlayer,60,275,335,0,55,UCBPlayer
11479,UCBPlayer,78,263,341,3,54,UCBPlayer
11480,UCBPlayer,60,275,335,0,55,UCBPlayer
11481,UCBPlayer,91,261,352,5,51,UCBPlayer
11482,UCBPlayer,97,252,349,5,52,UCBPlayer
11483,UCBPlayer,67,302,369,4,45,UCBPlayer
11484,UCBPlayer,94,319,413,12,33,UCBPlayer
11485,UCBPlayer,68,298,366,4,46,UCBPlayer
11486,UCBPlayer,66,296,362,3,47,UCBPlayer
11487,UCBPlayer,67,282,349,2,51,UCBPlayer
11488,UCBPlayer,76,281,357,4,49,UCBPlayer
11489,UCBPlayer,61,296,357,1,48,UCBPlayer
11490,UCBPlayer,60,275,335,0,55,UCBPlayer
11491,UCBPlayer,65,290,355,2,49,UCBPlayer
11492,UCBPlayer,48,323,371,0,43,UCBPlayer
11493,UCBPlayer,84,259,343,2,53,UCBPlayer
11494,UCBPlayer,66,286,352,2,50,UCBPlayer
11495,UCBPlayer,62,302,364,2,46,UCBPlayer
11496,UCBPlayer,75,270,345,4,53,UCBPlayer
11497,UCBPlayer,69,294,363,1,46,UCBPlayer
11498,UCBPlayer,51,311,362,0,46,UCBPlayer
11499,UCBPlayer,51,311,362,0,46,UCBPlayer
11500,UCBPlayer,62,312,374,3,43,UCBPlayer
11501,UCBPlayer,72,272,344,3,53,UCBPlayer
11502,UCBPlayer,83,258,341,3,54,UCBPlayer
11503,UCBPlayer,70,270,340,2,54,UCBPlayer
11504,UCBPlayer,60,300,360,1,47,UCBPlayer
11505,UCBPlayer,67,297,364,5,47,UCBPlayer
11506,UCBPlayer,71,271,342,1,53,UCBPlayer
11507,UCBPlayer,65,290,355,2,49,UCBPlayer
11508,UCBPlayer,65,270,335,0,55,UCBPlayer
11509,UCBPlayer,67,297,364,2,46,UCBPlayer
11510,UCBPlayer,65,280,345,1,52,UCBPlayer
0,JointPQPlayer,274,194,468,34,22,Player A
1,JointPQPlayer,117,302,419,15,32,JointPQPlayer
2,JointPQPlayer,257,232,489,37,16,Player A
3,JointPQPlayer,288,203,491,33,14,Player A
4,JointPQPlayer,277,192,469,26,19,Player A
5,JointPQPlayer,147,247,394,11,39,JointPQPlayer
6,JointPQPlayer,216,246,462,40,26,JointPQPlayer
7,JointPQPlayer,305,200,505,35,10,Player A
8,JointPQPlayer,292,192,484,32,16,Player A
9,JointPQPlayer,303,198,501,37,12,Player A
10,JointPQPlayer,287,217,504,37,11,Player A
11,JointPQPlayer,310,190,500,33,11,Player A
12,JointPQPlayer,259,229,488,36,16,Player A
13,JointPQPlayer,226,241,467,36,23,JointPQPlayer
14,JointPQPlayer,142,237,379,8,43,JointPQPlayer
15,JointPQPlayer,313,178,491,33,14,Player A
16,JointPQPlayer,308,173,481,35,18,Player A
17,JointPQPlayer,278,218,496,35,13,Player A
18,JointPQPlayer,190,245,435,22,29,JointPQPlayer
19,JointPQPlayer,289,234,523,47,8,Player A
20,JointPQPlayer,320,180,500,42,14,Player A
21,JointPQPlayer,303,203,506,42,12,Player A
22,JointPQPlayer,203,243,446,21,25,JointPQPlayer
23,JointPQPlayer,281,231,512,45,11,Player A
24,JointPQPlayer,312,187,499,38,13,Player A
25,JointPQPlayer,281,176,457,29,24,Player A
26,JointPQPlayer,281,201,482,33,17,Player A
27,JointPQPlayer,268,198,466,26,20,Player A
28,JointPQPlayer,267,212,479,36,19,Player A
29,JointPQPlayer,182,212,394,11,39,JointPQPlayer
30,JointPQPlayer,157,277,434,18,28,JointPQPlayer
31,JointPQPlayer,227,257,484,35,17,JointPQPlayer
32,JointPQPlayer,299,184,483,34,17,Player A
33,JointPQPlayer,166,266,432,19,29,JointPQPlayer
34,JointPQPlayer,303,173,476,30,18,Player A
35,JointPQPlayer,274,234,508,38,10,Player A
36,JointPQPlayer,297,192,489,34,15,Player A
37,JointPQPlayer,291,196,487,35,16,Player A
38,JointPQPlayer,327,177,504,31,9,Player A
39,JointPQPlayer,272,222,494,36,14,Player A
40,JointPQPlayer,307,202,509,39,10,Player A
41,JointPQPlayer,329,144,473,30,19,Player A
42,JointPQPlayer,157,237,394,20,42,JointPQPlayer
43,JointPQPlayer,295,205,500,42,14,Player A
44,JointPQPlayer,176,256,432,19,29,JointPQPlayer
45,JointPQPlayer,156,246,402,19,39,JointPQPlayer
46,JointPQPlayer,306,186,492,37,15,Player A
47,JointPQPlayer,292,192,484,32,16,Player A
48,JointPQPlayer,273,223,496,35,13,Player A
49,JointPQPlayer,278,198,476,33,19,Player A
50,JointPQPlayer,117,272,389,9,40,JointPQPlayer
51,JointPQPlayer,328,178,506,33,9,Player A
52,JointPQPlayer,304,204,508,41,11,Player A
53,JointPQPlayer,287,207,494,33,13,Player A
54,JointPQPlayer,301,196,497,33,12,Player A
55,JointPQPlayer,298,188,486,28,14,Player A
56,JointPQPlayer,296,201,497,39,14,Player A
57,JointPQPlayer,307,192,499,38,13,Player A
58,JointPQPlayer,329,184,513,40,9,Player A
59,JointPQPlayer,265,235,500,36,12,Player A
60,JointPQPlayer,269,229,498,40,14,Player A
61,JointPQPlayer,202,232,434,18,28,JointPQPlayer
62,JointPQPlayer,320,175,495,28,11,Player A
63,JointPQPlayer,306,166,472,26,18,Player A
64,JointPQPlayer,279,194,473,39,22,Player A
65,JointPQPlayer,171,206,377,3,42,JointPQPlayer
66,JointPQPlayer,308,198,506,33,9,Player A
67,JointPQPlayer,288,198,486,37,17,Player A
68,JointPQPlayer,306,166,472,32,20,Player A
69,JointPQPlayer,278,203,481,38,19,Player A
70,JointPQPlayer,287,177,464,33,23,Player A
71,JointPQPlayer,252,237,489,37,16,Player A
72,JointPQPlayer,326,161,487,29,14,Player A
73,JointPQPlayer,320,165,485,36,17,Player A
74,JointPQPlayer,126,286,412,11,33,JointPQPlayer
75,JointPQPlayer,289,209,498,40,14,Player A
76,JointPQPlayer,302,177,479,33,18,Player A
77,JointPQPlayer,170,265,435,16,27,JointPQPlayer
78,JointPQPlayer,292,197,489,40,17,Player A
79,JointPQPlayer,263,198,461,24,21,Player A
80,JointPQPlayer,282,217,499,35,12,Player A
81,JointPQPlayer,319,184,503,39,12,Player A
82,JointPQPlayer,323,163,486,34,16,Player A
83,JointPQPlayer,165,260,425,12,29,JointPQPlayer
84,JointPQPlayer,282,197,479,33,18,Player A
85,JointPQPlayer,280,205,485,36,17,Player A
86,JointPQPlayer,297,187,484,32,16,Player A
87,JointPQPlayer,296,206,502,38,12,Player A
88,JointPQPlayer,288,198,486,31,15,Player A
89,JointPQPlayer,160,215,375,7,44,JointPQPlayer
90,JointPQPlayer,295,190,485,39,18,Player A
91,JointPQPlayer,238,203,441,22,27,Player A
92,JointPQPlayer,280,220,500,45,15,Player A
93,JointPQPlayer,294,194,488,33,15,Player A
94,JointPQPlayer,167,272,439,23,28,JointPQPlayer
95,JointPQPlayer,292,197,489,37,16,Player A
96,JointPQPlayer,171,211,382,11,43,JointPQPlayer
97,JointPQPlayer,305,195,500,42,14,Player A
98,JointPQPlayer,259,199,458,21,21,Player A
99,JointPQPlayer,146,271,417,16,33,JointPQPlayer
100,JointPQPlayer,121,291,412,11,33,JointPQPlayer
101,JointPQPlayer,136,271,407,12,35,JointPQPlayer
102,JointPQPlayer,293,193,486,28,14,Player A
103,JointPQPlayer,219,234,453,28,25,JointPQPlayer
104,JointPQPlayer,154,259,413,21,36,JointPQPlayer
105,JointPQPlayer,267,217,484,32,16,Player A
106,JointPQPlayer,279,214,493,38,15,Player A
107,JointPQPlayer,258,228,486,34,16,Player A
108,JointPQPlayer,305,185,490,38,16,Player A
109,JointPQPlayer,308,183,491,36,15,Player A
110,JointPQPlayer,134,299,433,14,27,JointPQPlayer
111,JointPQPlayer,289,184,473,33,20,Player A
112,JointPQPlayer,297,187,484,35,17,Player A
113,JointPQPlayer,285,175,460,23,21,Player A
114,JointPQPlayer,321,171,492,31,13,Player A
115,JointPQPlayer,313,173,486,34,16,Player A
116,JointPQPlayer,294,194,488,42,18,Player A
117,JointPQPlayer,153,253,406,11,35,JointPQPlayer
118,JointPQPlayer,285,200,485,33,16,Player A
119,JointPQPlayer,294,179,473,33,20,Player A
120,JointPQPlayer,293,193,486,40,18,Player A
121,JointPQPlayer,133,258,391,14,41,JointPQPlayer
122,JointPQPlayer,167,267,434,21,29,JointPQPlayer
123,JointPQPlayer,318,198,516,46,10,Player A
124,JointPQPlayer,123,293,416,12,32,JointPQPlayer
125,JointPQPlayer,147,242,389,9,40,JointPQPlayer
126,JointPQPlayer,270,205,475,35,20,Player A
127,JointPQPlayer,326,181,507,40,11,Player A
128,JointPQPlayer,226,191,417,19,34,Player A
129,JointPQPlayer,290,215,505,41,12,Player A
130,JointPQPlayer,284,224,508,41,11,Player A
131,JointPQPlayer,136,266,402,13,37,JointPQPlayer
132,JointPQPlayer,312,167,479,33,18,Player A
133,JointPQPlayer,155,255,410,12,34,JointPQPlayer
134,JointPQPlayer,287,187,474,34,20,Player A
135,JointPQPlayer,318,193,511,38,9,Player A
136,JointPQPlayer,167,257,424,17,31,JointPQPlayer
137,JointPQPlayer,285,185,470,27,19,Player A
138,JointPQPlayer,263,238,501,46,15,Player A
139,JointPQPlayer,253,183,436,20,28,Player A
140,JointPQPlayer,307,197,504,37,11,Player A
141,JointPQPlayer,282,182,464,30,22,Player A
142,JointPQPlayer,299,194,493,38,15,Player A
143,JointPQPlayer,286,186,472,35,21,Player A
144,JointPQPlayer,303,173,476,33,19,Player A
145,JointPQPlayer,308,198,506,36,10,Player A
146,JointPQPlayer,274,204,478,32,18,Player A
147,JointPQPlayer,160,275,435,13,26,JointPQPlayer
148,JointPQPlayer,304,164,468,31,21,Player A
149,JointPQPlayer,304,164,468,28,20,Player A
150,JointPQPlayer,249,219,468,25,19,Player A
151,JointPQPlayer,224,229,453,28,25,JointPQPlayer
152,JointPQPlayer,307,192,499,38,13,Player A
153,JointPQPlayer,136,281,417,22,35,JointPQPlayer
154,JointPQPlayer,267,207,474,31,19,Player A
155,JointPQPlayer,141,291,432,19,29,JointPQPlayer
156,JointPQPlayer,192,262,454,26,24,JointPQPlayer
157,JointPQPlayer,310,185,495,37,14,Player A
158,JointPQPlayer,289,189,478,29,17,Player A
159,JointPQPlayer,304,184,488,27,13,Player A
160,JointPQPlayer,281,191,472,35,21,Player A
161,JointPQPlayer,138,248,386,12,42,JointPQPlayer
162,JointPQPlayer,307,177,484,32,16,Player A
163,JointPQPlayer,268,198,466,29,21,Player A
164,JointPQPlayer,302,187,489,34,15,Player A
165,JointPQPlayer,283,203,486,37,17,Player A
166,JointPQPlayer,278,223,501,34,11,Player A
167,JointPQPlayer,144,264,408,10,34,JointPQPlayer
168,JointPQPlayer,314,174,488,30,14,Player A
169,JointPQPlayer,151,251,402,16,38,JointPQPlayer
170,JointPQPlayer,146,256,402,13,37,JointPQPlayer
171,JointPQPlayer,290,205,495,37,14,Player A
172,JointPQPlayer,255,225,480,37,19,Player A
173,JointPQPlayer,311,176,487,35,16,Player A
174,JointPQPlayer,265,200,465,28,21,Player A
175,JointPQPlayer,302,182,484,35,17,Player A
176,JointPQPlayer,284,169,453,28,25,Player A
177,JointPQPlayer,304,184,488,30,14,Player A
178,JointPQPlayer,301,191,492,37,15,Player A
179,JointPQPlayer,298,193,491,27,12,Player A
180,JointPQPlayer,279,189,468,28,20,Player A
181,JointPQPlayer,325,185,510,40,10,Player A
182,JointPQPlayer,255,225,480,28,16,Player A
183,JointPQPlayer,296,186,482,30,16,Player A
184,JointPQPlayer,301,196,497,33,12,Player A
185,JointPQPlayer,142,282,424,14,30,JointPQPlayer
186,JointPQPlayer,273,208,481,32,17,Player A
187,JointPQPlayer,289,194,483,31,16,Player A
188,JointPQPlayer,296,196,492,31,13,Player A
189,JointPQPlayer,324,189,513,37,8,Player A
190,JointPQPlayer,277,207,484,29,15,Player A
191,JointPQPlayer,286,211,497,39,14,Player A
192,JointPQPlayer,130,275,405,13,36,JointPQPlayer
193,JointPQPlayer,284,194,478,32,18,Player A
194,JointPQPlayer,283,208,491,36,15,Player A
195,JointPQPlayer,174,229,403,17,38,JointPQPlayer
196,JointPQPlayer,266,201,467,30,21,Player A
197,JointPQPlayer,146,251,397,17,40,JointPQPlayer
198,JointPQPlayer,170,275,445,17,24,JointPQPlayer
199,JointPQPlayer,289,204,493,35,14,Player A
200,JointPQPlayer,270,220,490,35,15,Player A
201,JointPQPlayer,142,217,359,12,51,JointPQPlayer
202,JointPQPlayer,268,203,471,28,19,Player A
203,JointPQPlayer,294,174,468,28,20,Player A
204,JointPQPlayer,266,226,492,40,16,Player A
205,JointPQPlayer,262,202,464,27,21,Player A
206,JointPQPlayer,182,252,434,21,29,JointPQPlayer
207,JointPQPlayer,297,202,499,32,11,Player A
208,JointPQPlayer,326,176,502,32,10,Player A
209,JointPQPlayer,130,285,415,8,31,JointPQPlayer
210,JointPQPlayer,267,222,489,43,18,Player A
211,JointPQPlayer,279,209,488,36,16,Player A
212,JointPQPlayer,286,171,457,29,24,Player A
213,JointPQPlayer,314,174,488,27,13,Player A
214,JointPQPlayer,277,202,479,33,18,Player A
215,JointPQPlayer,281,186,467,24,19,Player A
216,JointPQPlayer,297,192,489,37,16,Player A
217,JointPQPlayer,239,244,483,34,17,JointPQPlayer
218,JointPQPlayer,294,184,478,35,19,Player A
219,JointPQPlayer,317,177,494,36,14,Player A
220,JointPQPlayer,314,184,498,37,13,Player A
221,JointPQPlayer,270,205,475,32,19,Player A
222,JointPQPlayer,324,184,508,32,8,Player A
223,JointPQPlayer,283,218,501,40,13,Player A
224,JointPQPlayer,273,183,456,31,25,Player A
225,JointPQPlayer,256,226,482,33,17,Player A
226,JointPQPlayer,272,202,474,31,19,Player A
227,JointPQPlayer,165,245,410,15,35,JointPQPlayer
228,JointPQPlayer,257,207,464,30,22,Player A
229,JointPQPlayer,264,189,453,25,24,Player A
230,JointPQPlayer,240,225,465,28,21,Player A
231,JointPQPlayer,305,180,485,36,17,Player A
232,JointPQPlayer,339,159,498,34,12,Player A
233,JointPQPlayer,310,185,495,34,13,Player A
234,JointPQPlayer,225,210,435,25,30,Player A
235,JointPQPlayer,294,204,498,37,13,Player A
236,JointPQPlayer,304,204,508,38,10,Player A
237,JointPQPlayer,172,247,419,9,30,JointPQPlayer
238,JointPQPlayer,268,213,481,29,16,Player A
239,JointPQPlayer,303,183,486,31,15,Player A
240,JointPQPlayer,248,213,461,24,21,Player A
241,JointPQPlayer,271,201,472,32,20,Player A
242,JointPQPlayer,275,225,500,45,15,Player A
243,JointPQPlayer,135,255,390,10,40,JointPQPlayer
244,JointPQPlayer,274,209,483,31,16,Player A
245,JointPQPlayer,270,210,480,28,16,Player A
246,JointPQPlayer,312,177,489,31,14,Player A
247,JointPQPlayer,140,275,415,14,33,JointPQPlayer
248,JointPQPlayer,288,213,501,34,11,Player A
249,JointPQPlayer,267,202,469,29,20,Player A
250,JointPQPlayer,137,257,394,11,39,JointPQPlayer
251,JointPQPlayer,310,195,505,38,11,Player A
252,JointPQPlayer,223,233,456,25,23,JointPQPlayer
253,JointPQPlayer,282,207,489,37,16,Player A
254,JointPQPlayer,305,195,500,36,12,Player A
255,JointPQPlayer,307,187,494,30,12,Player A
256,JointPQPlayer,280,200,480,31,17,Player A
257,JointPQPlayer,305,170,475,32,19,Player A
258,JointPQPlayer,260,190,450,25,25,Player A
259,JointPQPlayer,274,204,478,32,18,Player A
260,JointPQPlayer,288,213,501,40,13,Player A
261,JointPQPlayer,129,294,423,13,30,JointPQPlayer
262,JointPQPlayer,162,272,434,21,29,JointPQPlayer
263,JointPQPlayer,145,250,395,15,40,JointPQPlayer
264,JointPQPlayer,276,216,492,37,15,Player A
265,JointPQPlayer,271,211,482,36,18,Player A
266,JointPQPlayer,287,207,494,36,14,Player A
267,JointPQPlayer,325,180,505,38,11,Player A
268,JointPQPlayer,174,219,393,19,42,JointPQPlayer
269,JointPQPlayer,308,183,491,33,14,Player A
270,JointPQPlayer,129,274,403,8,35,JointPQPlayer
271,JointPQPlayer,311,186,497,33,12,Player A
272,JointPQPlayer,283,208,491,36,15,Player A
273,JointPQPlayer,291,181,472,26,18,Player A
274,JointPQPlayer,285,195,480,31,17,Player A
275,JointPQPlayer,263,213,476,33,19,Player A
276,JointPQPlayer,165,245,410,15,35,JointPQPlayer
277,JointPQPlayer,291,216,507,40,11,Player A
278,JointPQPlayer,304,189,493,38,15,Player A
279,JointPQPlayer,297,192,489,40,17,Player A
280,JointPQPlayer,277,212,489,40,17,Player A
281,JointPQPlayer,157,237,394,14,40,JointPQPlayer
282,JointPQPlayer,151,206,357,7,50,JointPQPlayer
283,JointPQPlayer,323,168,491,36,15,Player A
284,JointPQPlayer,327,167,494,42,16,Player A
285,JointPQPlayer,114,294,408,13,35,JointPQPlayer
286,JointPQPlayer,283,198,481,35,18,Player A
287,JointPQPlayer,213,228,441,19,26,JointPQPlayer
288,JointPQPlayer,304,189,493,29,12,Player A
289,JointPQPlayer,320,170,490,32,14,Player A
290,JointPQPlayer,307,172,479,33,18,Player A
291,JointPQPlayer,273,203,476,27,17,Player A
292,JointPQPlayer,289,179,468,31,21,Player A
293,JointPQPlayer,271,211,482,33,17,Player A
294,JointPQPlayer,303,193,496,35,13,Player A
295,JointPQPlayer,158,223,381,16,45,JointPQPlayer
296,JointPQPlayer,162,237,399,16,39,JointPQPlayer
297,JointPQPlayer,308,198,506,45,13,Player A
298,JointPQPlayer,282,202,484,29,15,Player A
299,JointPQPlayer,267,202,469,29,20,Player A
300,JointPQPlayer,289,209,498,43,15,Player A
301,JointPQPlayer,305,190,495,37,14,Player A
302,JointPQPlayer,168,253,421,11,30,JointPQPlayer
303,JointPQPlayer,287,212,499,35,12,Player A
304,JointPQPlayer,132,267,399,13,38,JointPQPlayer
305,JointPQPlayer,270,230,500,36,12,Player A
306,JointPQPlayer,286,211,497,39,14,Player A
307,JointPQPlayer,274,194,468,25,19,Player A
308,JointPQPlayer,303,188,491,36,15,Player A
309,JointPQPlayer,286,196,482,42,20,Player A
310,JointPQPlayer,286,231,517,44,9,Player A
311,JointPQPlayer,169,244,413,12,33,JointPQPlayer
312,JointPQPlayer,290,190,480,25,15,Player A
313,JointPQPlayer,241,191,432,25,31,Player A
314,JointPQPlayer,321,176,497,36,13,Player A
315,JointPQPlayer,271,221,492,37,15,Player A
316,JointPQPlayer,289,179,468,34,22,Player A
317,JointPQPlayer,290,195,485,33,16,Player A
318,JointPQPlayer,170,240,410,15,35,JointPQPlayer
319,JointPQPlayer,301,206,507,46,13,Player A
320,JointPQPlayer,294,199,493,35,14,Player A
321,JointPQPlayer,290,180,470,30,20,Player A
322,JointPQPlayer,300,200,500,36,12,Player A
323,JointPQPlayer,281,201,482,33,17,Player A
324,JointPQPlayer,193,228,421,20,33,JointPQPlayer
325,JointPQPlayer,313,178,491,33,14,Player A
326,JointPQPlayer,276,196,472,35,21,Player A
327,JointPQPlayer,284,184,468,31,21,Player A
328,JointPQPlayer,309,199,508,38,10,Player A
329,JointPQPlayer,282,202,484,38,18,Player A
330,JointPQPlayer,280,205,485,33,16,Player A
331,JointPQPlayer,290,190,480,34,18,Player A
332,JointPQPlayer,299,179,478,29,17,Player A
333,JointPQPlayer,302,187,489,34,15,Player A
334,JointPQPlayer,285,205,490,35,15,Player A
335,JointPQPlayer,303,178,481,32,17,Player A
336,JointPQPlayer,154,264,418,14,32,JointPQPlayer
337,JointPQPlayer,294,214,508,38,10,Player A
338,JointPQPlayer,222,242,464,27,21,JointPQPlayer
339,JointPQPlayer,266,206,472,32,20,Player A
340,JointPQPlayer,305,210,515,39,8,Player A
341,JointPQPlayer,298,188,486,37,17,Player A
342,JointPQPlayer,313,183,496,38,14,Player A
343,JointPQPlayer,308,193,501,43,14,Player A
344,JointPQPlayer,271,216,487,32,15,Player A
345,JointPQPlayer,304,189,493,38,15,Player A
346,JointPQPlayer,280,210,490,26,12,Player A
347,JointPQPlayer,311,196,507,43,12,Player A
348,JointPQPlayer,264,209,473,30,19,Player A
349,JointPQPlayer,158,198,356,9,51,JointPQPlayer
350,JointPQPlayer,277,207,484,38,18,Player A
351,JointPQPlayer,156,251,407,15,36,JointPQPlayer
352,JointPQPlayer,277,202,479,36,19,Player A
353,JointPQPlayer,289,209,498,34,12,Player A
354,JointPQPlayer,313,173,486,34,16,Player A
355,JointPQPlayer,311,186,497,39,14,Player A
356,JointPQPlayer,288,188,476,36,20,Player A
357,JointPQPlayer,234,224,458,27,23,Player A
358,JointPQPlayer,281,186,467,27,20,Player A
359,JointPQPlayer,287,202,489,34,15,Player A
360,JointPQPlayer,133,263,396,16,40,JointPQPlayer
361,JointPQPlayer,325,185,510,40,10,Player A
362,JointPQPlayer,305,165,470,27,19,Player A
363,JointPQPlayer,307,202,509,39,10,Player A
364,JointPQPlayer,290,220,510,46,12,Player A
365,JointPQPlayer,326,161,487,35,16,Player A
366,JointPQPlayer,281,211,492,40,16,Player A
367,JointPQPlayer,302,177,479,33,18,Player A
368,JointPQPlayer,199,229,428,21,31,JointPQPlayer
369,JointPQPlayer,306,196,502,38,12,Player A
370,JointPQPlayer,311,171,482,39,19,Player A
371,JointPQPlayer,133,243,376,5,43,JointPQPlayer
372,JointPQPlayer,282,202,484,32,16,Player A
373,JointPQPlayer,255,215,470,33,21,Player A
374,JointPQPlayer,315,155,470,30,20,Player A
375,JointPQPlayer,275,220,495,31,12,Player A
376,JointPQPlayer,279,209,488,39,17,Player A
377,JointPQPlayer,132,222,354,7,51,JointPQPlayer
378,JointPQPlayer,322,177,499,35,12,Player A
379,JointPQPlayer,301,206,507,40,11,Player A
380,JointPQPlayer,289,189,478,29,17,Player A
381,JointPQPlayer,143,293,436,14,26,JointPQPlayer
382,JointPQPlayer,273,198,471,28,19,Player A
383,JointPQPlayer,241,211,452,21,23,Player A
384,JointPQPlayer,312,177,489,34,15,Player A
385,JointPQPlayer,168,203,371,12,47,JointPQPlayer
386,JointPQPlayer,280,215,495,40,15,Player A
387,JointPQPlayer,264,224,488,30,14,Player A
388,JointPQPlayer,143,278,421,14,31,JointPQPlayer
389,JointPQPlayer,241,241,482,39,19,Tie
390,JointPQPlayer,144,249,393,13,40,JointPQPlayer
391,JointPQPlayer,127,287,414,13,33,JointPQPlayer
392,JointPQPlayer,292,192,484,35,17,Player A
393,JointPQPlayer,134,279,413,12,33,JointPQPlayer
394,JointPQPlayer,145,240,385,11,42,JointPQPlayer
395,JointPQPlayer,263,213,476,33,19,Player A
396,JointPQPlayer,150,260,410,12,34,JointPQPlayer
397,JointPQPlayer,294,199,493,35,14,Player A
398,JointPQPlayer,288,188,476,33,19,Player A
399,JointPQPlayer,243,218,461,30,23,Player A
400,JointPQPlayer,298,188,486,34,16,Player A
401,JointPQPlayer,276,186,462,31,23,Player A
402,JointPQPlayer,275,220,495,34,13,Player A
403,JointPQPlayer,309,174,483,28,15,Player A
404,JointPQPlayer,273,193,466,29,21,Player A
405,JointPQPlayer,159,239,398,15,39,JointPQPlayer
406,JointPQPlayer,305,180,485,33,16,Player A
407,JointPQPlayer,192,222,414,16,34,JointPQPlayer
408,JointPQPlayer,272,192,464,27,21,Player A
409,JointPQPlayer,151,246,397,14,39,JointPQPlayer
410,JointPQPlayer,309,174,483,34,17,Player A
411,JointPQPlayer,322,192,514,35,7,Player A
412,JointPQPlayer,180,255,435,22,29,JointPQPlayer
413,JointPQPlayer,291,206,497,42,15,Player A
414,JointPQPlayer,295,195,490,35,15,Player A
415,JointPQPlayer,148,253,401,18,39,JointPQPlayer
416,JointPQPlayer,316,186,502,32,10,Player A
417,JointPQPlayer,289,194,483,37,18,Player A
418,JointPQPlayer,203,238,441,25,28,JointPQPlayer
419,JointPQPlayer,253,213,466,29,21,Player A
420,JointPQPlayer,307,187,494,36,14,Player A
421,JointPQPlayer,289,189,478,29,17,Player A
422,JointPQPlayer,284,199,483,31,16,Player A
423,JointPQPlayer,288,193,481,32,17,Player A
424,JointPQPlayer,277,202,479,33,18,Player A
425,JointPQPlayer,307,202,509,36,9,Player A
426,JointPQPlayer,326,171,497,39,14,Player A
427,JointPQPlayer,303,198,501,37,12,Player A
428,JointPQPlayer,255,220,475,26,17,Player A
429,JointPQPlayer,152,247,399,16,39,JointPQPlayer
430,JointPQPlayer,144,259,403,14,37,JointPQPlayer
431,JointPQPlayer,257,212,469,32,21,Player A
432,JointPQPlayer,145,270,415,17,34,JointPQPlayer
433,JointPQPlayer,271,196,467,27,20,Player A
434,JointPQPlayer,284,209,493,41,16,Player A
435,JointPQPlayer,270,220,490,35,15,Player A
436,JointPQPlayer,312,202,514,41,9,Player A
437,JointPQPlayer,280,190,470,24,18,Player A
438,JointPQPlayer,158,248,406,11,35,JointPQPlayer
439,JointPQPlayer,282,217,499,38,13,Player A
440,JointPQPlayer,136,291,427,14,29,JointPQPlayer
441,JointPQPlayer,268,213,481,35,18,Player A
442,JointPQPlayer,264,204,468,34,22,Player A
443,JointPQPlayer,296,201,497,30,11,Player A
444,JointPQPlayer,282,212,494,39,15,Player A
445,JointPQPlayer,275,215,490,38,16,Player A
446,JointPQPlayer,327,182,509,39,10,Player A
447,JointPQPlayer,267,207,474,31,19,Player A
448,JointPQPlayer,152,267,419,15,32,JointPQPlayer
449,JointPQPlayer,285,210,495,40,15,Player A
450,JointPQPlayer,270,225,495,43,16,Player A
451,JointPQPlayer,266,231,497,36,13,Player A
452,JointPQPlayer,314,184,498,37,13,Player A
453,JointPQPlayer,311,171,482,30,16,Player A
454,JointPQPlayer,285,210,495,40,15,Player A
455,JointPQPlayer,293,208,501,34,11,Player A
456,JointPQPlayer,290,205,495,37,14,Player A
457,JointPQPlayer,281,231,512,42,10,Player A
458,JointPQPlayer,257,222,479,33,18,Player A
459,JointPQPlayer,303,183,486,28,14,Player A
460,JointPQPlayer,283,203,486,34,16,Player A
461,JointPQPlayer,315,185,500,33,11,Player A
462,JointPQPlayer,195,235,430,20,30,JointPQPlayer
463,JointPQPlayer,154,239,393,16,41,JointPQPlayer
464,JointPQPlayer,291,201,492,40,16,Player A
465,JointPQPlayer,212,217,429,22,31,JointPQPlayer
466,JointPQPlayer,294,209,503,33,10,Player A
467,JointPQPlayer,277,177,454,23,23,Player A
468,JointPQPlayer,154,229,383,12,43,JointPQPlayer
469,JointPQPlayer,309,194,503,42,13,Player A
470,JointPQPlayer,294,189,483,34,17,Player A
471,JointPQPlayer,327,187,514,32,6,Player A
472,JointPQPlayer,282,202,484,32,16,Player A
473,JointPQPlayer,256,241,497,39,14,Player A
474,JointPQPlayer,302,182,484,29,15,Player A
475,JointPQPlayer,164,259,423,13,30,JointPQPlayer
476,JointPQPlayer,333,168,501,34,11,Player A
477,JointPQPlayer,109,289,398,12,38,JointPQPlayer
478,JointPQPlayer,268,198,466,29,21,Player A
479,JointPQPlayer,224,224,448,26,26,Tie
480,JointPQPlayer,155,225,380,12,44,JointPQPlayer
481,JointPQPlayer,144,289,433,23,30,JointPQPlayer
482,JointPQPlayer,261,211,472,29,19,Player A
483,JointPQPlayer,292,172,464,27,21,Player A
484,JointPQPlayer,305,205,510,31,7,Player A
485,JointPQPlayer,266,201,467,33,22,Player A
486,JointPQPlayer,158,253,411,16,35,JointPQPlayer
487,JointPQPlayer,289,204,493,41,16,Player A
488,JointPQPlayer,308,183,491,39,16,Player A
489,JointPQPlayer,160,245,405,16,37,JointPQPlayer
490,JointPQPlayer,185,255,440,21,27,JointPQPlayer
491,JointPQPlayer,299,149,448,23,25,Player A
492,JointPQPlayer,264,204,468,34,22,Player A
493,JointPQPlayer,155,265,420,13,31,JointPQPlayer
494,JointPQPlayer,296,206,502,29,9,Player A
495,JointPQPlayer,296,186,482,33,17,Player A
496,JointPQPlayer,277,227,504,40,12,Player A
497,JointPQPlayer,270,235,505,35,10,Player A
498,JointPQPlayer,267,227,494,42,16,Player A
499,JointPQPlayer,319,184,503,42,13,Player A
500,JointPQPlayer,307,202,509,36,9,Player A
501,JointPQPlayer,287,202,489,34,15,Player A
502,JointPQPlayer,301,181,482,33,17,Player A
503,JointPQPlayer,328,163,491,27,12,Player A
504,JointPQPlayer,250,230,480,34,18,Player A
505,JointPQPlayer,122,287,409,11,34,JointPQPlayer
506,JointPQPlayer,289,189,478,35,19,Player A
507,JointPQPlayer,248,223,471,37,22,Player A
508,JointPQPlayer,183,203,386,6,40,JointPQPlayer
509,JointPQPlayer,290,165,455,33,26,Player A
510,JointPQPlayer,308,173,481,32,17,Player A
511,JointPQPlayer,259,219,478,38,20,Player A
512,JointPQPlayer,290,200,490,35,15,Player A
513,JointPQPlayer,304,194,498,34,12,Player A
514,JointPQPlayer,243,228,471,31,20,Player A
515,JointPQPlayer,289,194,483,34,17,Player A
516,JointPQPlayer,181,251,432,25,31,JointPQPlayer
517,JointPQPlayer,302,157,459,25,22,Player A
518,JointPQPlayer,256,211,467,27,20,Player A
519,JointPQPlayer,272,192,464,36,24,Player A
520,JointPQPlayer,326,156,482,33,17,Player A
521,JointPQPlayer,133,283,416,12,32,JointPQPlayer
522,JointPQPlayer,296,176,472,35,21,Player A
523,JointPQPlayer,273,228,501,31,10,Player A
524,JointPQPlayer,258,208,466,26,20,Player A
525,JointPQPlayer,288,193,481,32,17,Player A
526,JointPQPlayer,302,207,509,42,11,Player A
527,JointPQPlayer,159,279,438,16,26,JointPQPlayer
528,JointPQPlayer,148,233,381,13,44,JointPQPlayer
529,JointPQPlayer,282,157,439,23,28,Player A
530,JointPQPlayer,156,281,437,21,28,JointPQPlayer
531,JointPQPlayer,269,229,498,34,12,Player A
532,JointPQPlayer,306,176,482,33,17,Player A
533,JointPQPlayer,299,184,483,28,15,Player A
534,JointPQPlayer,275,200,475,29,18,Player A
535,JointPQPlayer,296,186,482,33,17,Player A
536,JointPQPlayer,236,216,452,33,27,Player A
537,JointPQPlayer,290,185,475,26,17,Player A
538,JointPQPlayer,316,176,492,31,13,Player A
539,JointPQPlayer,252,227,479,33,18,Player A
540,JointPQPlayer,315,190,505,44,13,Player A
541,JointPQPlayer,281,196,477,25,16,Player A
542,JointPQPlayer,288,193,481,29,16,Player A
543,JointPQPlayer,280,195,475,29,18,Player A
544,JointPQPlayer,251,221,472,29,19,Player A
545,JointPQPlayer,247,202,449,24,25,Player A
546,JointPQPlayer,289,184,473,27,18,Player A
547,JointPQPlayer,277,197,474,37,21,Player A
548,JointPQPlayer,311,186,497,36,13,Player A
549,JointPQPlayer,271,206,477,37,20,Player A
550,JointPQPlayer,294,179,473,27,18,Player A
551,JointPQPlayer,292,212,504,40,12,Player A
552,JointPQPlayer,148,268,416,12,32,JointPQPlayer
553,JointPQPlayer,276,221,497,36,13,Player A
554,JointPQPlayer,229,234,463,29,22,JointPQPlayer
555,JointPQPlayer,285,210,495,31,12,Player A
556,JointPQPlayer,275,205,480,34,18,Player A
557,JointPQPlayer,263,208,471,28,19,Player A
558,JointPQPlayer,133,283,416,12,32,JointPQPlayer
559,JointPQPlayer,276,221,497,48,17,Player A
560,JointPQPlayer,305,200,505,35,10,Player A
561,JointPQPlayer,146,266,412,17,35,JointPQPlayer
562,JointPQPlayer,317,172,489,25,12,Player A
563,JointPQPlayer,171,251,422,18,32,JointPQPlayer
564,JointPQPlayer,296,176,472,32,20,Player A
565,JointPQPlayer,327,172,499,35,12,Player A
566,JointPQPlayer,183,238,421,23,34,JointPQPlayer
567,JointPQPlayer,238,223,461,33,24,Player A
568,JointPQPlayer,313,198,511,38,9,Player A
569,JointPQPlayer,267,207,474,34,20,Player A
570,JointPQPlayer,302,197,499,38,13,Player A
571,JointPQPlayer,307,197,504,34,10,Player A
572,JointPQPlayer,290,210,500,42,14,Player A
573,JointPQPlayer,304,194,498,31,11,Player A
574,JointPQPlayer,277,202,479,33,18,Player A
575,JointPQPlayer,239,194,433,14,27,Player A
576,JointPQPlayer,159,254,413,18,35,JointPQPlayer
577,JointPQPlayer,253,223,476,27,17,Player A
578,JointPQPlayer,320,165,485,33,16,Player A
579,JointPQPlayer,289,174,463,32,23,Player A
580,JointPQPlayer,310,180,490,44,18,Player A
581,JointPQPlayer,188,248,436,23,29,JointPQPlayer
582,JointPQPlayer,275,195,470,33,21,Player A
583,JointPQPlayer,295,195,490,32,14,Player A
584,JointPQPlayer,247,227,474,34,20,Player A
585,JointPQPlayer,339,174,513,43,10,Player A
586,JointPQPlayer,277,197,474,31,19,Player A
587,JointPQPlayer,289,204,493,38,15,Player A
588,JointPQPlayer,303,178,481,35,18,Player A
589,JointPQPlayer,192,242,434,18,28,JointPQPlayer
590,JointPQPlayer,258,218,476,30,18,Player A
591,JointPQPlayer,307,157,464,30,22,Player A
592,JointPQPlayer,229,204,433,20,29,Player A
593,JointPQPlayer,255,215,470,36,22,Player A
594,JointPQPlayer,298,188,486,40,18,Player A
595,JointPQPlayer,262,192,454,26,24,Player A
596,JointPQPlayer,292,197,489,34,15,Player A
597,JointPQPlayer,280,200,480,34,18,Player A
598,JointPQPlayer,276,181,457,23,22,Player A
599,JointPQPlayer,308,188,496,38,14,Player A
600,JointPQPlayer,302,182,484,32,16,Player A
601,JointPQPlayer,310,180,490,35,15,Player A
602,JointPQPlayer,272,197,469,35,22,Player A
603,JointPQPlayer,258,213,471,34,21,Player A
604,JointPQPlayer,268,198,466,29,21,Player A
605,JointPQPlayer,301,201,502,41,13,Player A
606,JointPQPlayer,288,188,476,27,17,Player A
607,JointPQPlayer,279,199,478,29,17,Player A
608,JointPQPlayer,336,171,507,37,10,Player A
609,JointPQPlayer,285,200,485,33,16,Player A
610,JointPQPlayer,289,204,493,38,15,Player A
611,JointPQPlayer,138,278,416,15,33,JointPQPlayer
612,JointPQPlayer,140,245,385,5,40,JointPQPlayer
613,JointPQPlayer,294,199,493,35,14,Player A
614,JointPQPlayer,283,178,461,27,22,Player A
615,JointPQPlayer,250,230,480,34,18,Player A
616,JointPQPlayer,287,202,489,34,15,Player A
617,JointPQPlayer,303,193,496,38,14,Player A
618,JointPQPlayer,275,205,480,34,18,Player A
619,JointPQPlayer,244,224,468,28,20,Player A
620,JointPQPlayer,263,203,466,26,20,Player A
621,JointPQPlayer,311,201,512,39,9,Player A
622,JointPQPlayer,274,204,478,26,16,Player A
623,JointPQPlayer,288,208,496,41,15,Player A
624,JointPQPlayer,313,178,491,30,13,Player A
625,JointPQPlayer,288,208,496,38,14,Player A
626,JointPQPlayer,164,254,418,17,33,JointPQPlayer
627,JointPQPlayer,268,213,481,32,17,Player A
628,JointPQPlayer,288,203,491,33,14,Player A
629,JointPQPlayer,278,208,486,34,16,Player A
630,JointPQPlayer,287,192,479,36,19,Player A
631,JointPQPlayer,264,214,478,29,17,Player A
632,JointPQPlayer,301,201,502,35,11,Player A
633,JointPQPlayer,154,254,408,13,35,JointPQPlayer
634,JointPQPlayer,306,171,477,31,18,Player A
635,JointPQPlayer,153,263,416,15,33,JointPQPlayer
636,JointPQPlayer,293,213,506,42,12,Player A
637,JointPQPlayer,287,207,494,39,15,Player A
638,JointPQPlayer,308,203,511,41,10,Player A
639,JointPQPlayer,309,194,503,36,11,Player A
640,JointPQPlayer,323,188,511,38,9,Player A
641,JointPQPlayer,310,150,460,23,21,Player A
642,JointPQPlayer,303,178,481,32,17,Player A
643,JointPQPlayer,296,196,492,40,16,Player A
644,JointPQPlayer,294,219,513,43,10,Player A
645,JointPQPlayer,262,197,459,34,25,Player A
646,JointPQPlayer,288,213,501,40,13,Player A
647,JointPQPlayer,306,191,497,36,13,Player A
648,JointPQPlayer,279,234,513,40,9,Player A
649,JointPQPlayer,300,185,485,33,16,Player A
650,JointPQPlayer,329,189,518,39,7,Player A
651,JointPQPlayer,273,213,486,40,18,Player A
652,JointPQPlayer,143,253,396,16,40,JointPQPlayer
653,JointPQPlayer,266,186,452,27,25,Player A
654,JointPQPlayer,281,191,472,23,17,Player A
655,JointPQPlayer,132,297,429,16,29,JointPQPlayer
656,JointPQPlayer,157,282,439,20,27,JointPQPlayer
657,JointPQPlayer,154,264,418,17,33,JointPQPlayer
658,JointPQPlayer,286,211,497,33,12,Player A
659,JointPQPlayer,270,225,495,37,14,Player A
660,JointPQPlayer,303,178,481,35,18,Player A
661,JointPQPlayer,300,170,470,27,19,Player A
662,JointPQPlayer,316,181,497,36,13,Player A
663,JointPQPlayer,293,198,491,30,13,Player A
664,JointPQPlayer,277,212,489,40,17,Player A
665,JointPQPlayer,294,204,498,40,14,Player A
666,JointPQPlayer,275,215,490,32,14,Player A
667,JointPQPlayer,286,216,502,38,12,Player A
668,JointPQPlayer,289,209,498,40,14,Player A
669,JointPQPlayer,298,183,481,32,17,Player A
670,JointPQPlayer,282,177,459,31,24,Player A
671,JointPQPlayer,247,242,489,40,17,Player A
672,JointPQPlayer,286,211,497,33,12,Player A
673,JointPQPlayer,229,219,448,29,27,Player A
674,JointPQPlayer,282,192,474,28,18,Player A
675,JointPQPlayer,268,223,491,39,16,Player A
676,JointPQPlayer,157,262,419,12,31,JointPQPlayer
677,JointPQPlayer,305,195,500,39,13,Player A
678,JointPQPlayer,309,179,488,42,18,Player A
679,JointPQPlayer,290,200,490,38,16,Player A
680,JointPQPlayer,302,192,494,36,14,Player A
681,JointPQPlayer,149,244,393,13,40,JointPQPlayer
682,JointPQPlayer,293,188,481,29,16,Player A
683,JointPQPlayer,295,205,500,36,12,Player A
684,JointPQPlayer,270,225,495,34,13,Player A
685,JointPQPlayer,281,191,472,32,20,Player A
686,JointPQPlayer,286,221,507,40,11,Player A
687,JointPQPlayer,304,159,463,29,22,Player A
688,JointPQPlayer,306,176,482,36,18,Player A
689,JointPQPlayer,292,192,484,35,17,Player A
690,JointPQPlayer,284,209,493,41,16,Player A
691,JointPQPlayer,298,193,491,36,15,Player A
692,JointPQPlayer,327,172,499,38,13,Player A
693,JointPQPlayer,277,217,494,27,11,Player A
694,JointPQPlayer,154,214,368,12,48,JointPQPlayer
695,JointPQPlayer,127,262,389,12,41,JointPQPlayer
696,JointPQPlayer,280,230,510,40,10,Player A
697,JointPQPlayer,287,207,494,36,14,Player A
698,JointPQPlayer,277,197,474,28,18,Player A
699,JointPQPlayer,295,190,485,33,16,Player A
700,JointPQPlayer,323,188,511,44,11,Player A
701,JointPQPlayer,306,171,477,28,17,Player A
702,JointPQPlayer,310,200,510,37,9,Player A
703,JointPQPlayer,272,207,479,27,16,Player A
704,JointPQPlayer,300,180,480,34,18,Player A
705,JointPQPlayer,230,215,445,26,27,Player A
706,JointPQPlayer,301,181,482,27,15,Player A
707,JointPQPlayer,287,192,479,36,19,Player A
708,JointPQPlayer,266,231,497,45,16,Player A
709,JointPQPlayer,141,296,437,12,25,JointPQPlayer
710,JointPQPlayer,258,213,471,37,22,Player A
711,JointPQPlayer,275,205,480,31,17,Player A
712,JointPQPlayer,297,197,494,36,14,Player A
713,JointPQPlayer,312,182,494,33,13,Player A
714,JointPQPlayer,263,218,481,41,20,Player A
715,JointPQPlayer,143,268,411,13,34,JointPQPlayer
716,JointPQPlayer,329,169,498,34,12,Player A
717,JointPQPlayer,300,180,480,34,18,Player A
718,JointPQPlayer,146,271,417,10,31,JointPQPlayer
719,JointPQPlayer,295,165,460,26,22,Player A
720,JointPQPlayer,271,221,492,37,15,Player A
721,JointPQPlayer,268,223,491,36,15,Player A
722,JointPQPlayer,297,187,484,32,16,Player A
723,JointPQPlayer,288,203,491,36,15,Player A
724,JointPQPlayer,291,196,487,29,14,Player A
725,JointPQPlayer,188,233,421,11,30,JointPQPlayer
726,JointPQPlayer,295,180,475,35,20,Player A
727,JointPQPlayer,282,192,474,31,19,Player A
728,JointPQPlayer,302,177,479,36,19,Player A
729,JointPQPlayer,246,246,492,37,15,Tie
730,JointPQPlayer,265,210,475,32,19,Player A
731,JointPQPlayer,296,196,492,37,15,Player A
732,JointPQPlayer,288,208,496,38,14,Player A
733,JointPQPlayer,254,214,468,37,23,Player A
734,JointPQPlayer,265,215,480,28,16,Player A
735,JointPQPlayer,256,221,477,34,19,Player A
736,JointPQPlayer,242,217,459,31,24,Player A
737,JointPQPlayer,167,257,424,17,31,JointPQPlayer
738,JointPQPlayer,176,271,447,22,25,JointPQPlayer
739,JointPQPlayer,241,221,462,28,22,Player A
740,JointPQPlayer,291,191,482,33,17,Player A
741,JointPQPlayer,291,206,497,42,15,Player A
742,JointPQPlayer,267,207,474,37,21,Player A
743,JointPQPlayer,298,178,476,36,20,Player A
744,JointPQPlayer,301,176,477,28,17,Player A
745,JointPQPlayer,160,225,385,11,42,JointPQPlayer
746,JointPQPlayer,292,207,499,32,11,Player A
747,JointPQPlayer,301,191,492,31,13,Player A
748,JointPQPlayer,325,175,500,39,13,Player A
749,JointPQPlayer,252,227,479,36,19,Player A
750,JointPQPlayer,291,211,502,32,10,Player A
751,JointPQPlayer,301,201,502,41,13,Player A
752,JointPQPlayer,188,243,431,18,29,JointPQPlayer
753,JointPQPlayer,271,231,502,41,13,Player A
754,JointPQPlayer,289,199,488,33,15,Player A
755,JointPQPlayer,137,282,419,18,33,JointPQPlayer
756,JointPQPlayer,296,181,477,31,18,Player A
757,JointPQPlayer,251,206,457,20,21,Player A
758,JointPQPlayer,259,209,468,34,22,Player A
759,JointPQPlayer,283,218,501,43,14,Player A
760,JointPQPlayer,306,191,497,39,14,Player A
761,JointPQPlayer,283,198,481,35,18,Player A
762,JointPQPlayer,298,198,496,35,13,Player A
763,JointPQPlayer,140,270,410,9,33,JointPQPlayer
764,JointPQPlayer,308,188,496,32,12,Player A
765,JointPQPlayer,165,230,395,12,39,JointPQPlayer
766,JointPQPlayer,141,271,412,20,36,JointPQPlayer
767,JointPQPlayer,276,206,482,36,18,Player A
768,JointPQPlayer,299,189,488,36,16,Player A
769,JointPQPlayer,266,201,467,33,22,Player A
770,JointPQPlayer,153,263,416,12,32,JointPQPlayer
771,JointPQPlayer,215,240,455,24,23,JointPQPlayer
772,JointPQPlayer,278,193,471,28,19,Player A
773,JointPQPlayer,299,174,473,30,19,Player A
774,JointPQPlayer,303,203,506,36,10,Player A
775,JointPQPlayer,302,202,504,37,11,Player A
776,JointPQPlayer,265,235,500,45,15,Player A
777,JointPQPlayer,163,273,436,17,27,JointPQPlayer
778,JointPQPlayer,304,199,503,36,11,Player A
779,JointPQPlayer,253,208,461,24,21,Player A
780,JointPQPlayer,282,192,474,37,21,Player A
781,JointPQPlayer,300,190,490,35,15,Player A
782,JointPQPlayer,134,254,388,8,40,JointPQPlayer
783,JointPQPlayer,295,190,485,36,17,Player A
784,JointPQPlayer,336,186,522,43,7,Player A
785,JointPQPlayer,324,174,498,40,14,Player A
786,JointPQPlayer,146,291,437,18,27,JointPQPlayer
787,JointPQPlayer,276,216,492,37,15,Player A
788,JointPQPlayer,320,190,510,40,10,Player A
789,JointPQPlayer,300,175,475,23,16,Player A
790,JointPQPlayer,304,204,508,41,11,Player A
791,JointPQPlayer,152,242,394,8,38,JointPQPlayer
792,JointPQPlayer,299,199,498,31,11,Player A
793,JointPQPlayer,152,257,409,11,34,JointPQPlayer
794,JointPQPlayer,305,195,500,33,11,Player A
795,JointPQPlayer,164,229,393,16,41,JointPQPlayer
796,JointPQPlayer,149,274,423,19,32,JointPQPlayer
797,JointPQPlayer,279,229,508,35,9,Player A
798,JointPQPlayer,293,178,471,25,18,Player A
799,JointPQPlayer,293,183,476,30,18,Player A
800,JointPQPlayer,302,192,494,39,15,Player A
801,JointPQPlayer,289,219,508,35,9,Player A
802,JointPQPlayer,299,199,498,34,12,Player A
803,JointPQPlayer,300,185,485,33,16,Player A
804,JointPQPlayer,140,240,380,15,45,JointPQPlayer
805,JointPQPlayer,177,272,449,24,25,JointPQPlayer
806,JointPQPlayer,297,202,499,38,13,Player A
807,JointPQPlayer,210,225,435,22,29,JointPQPlayer
808,JointPQPlayer,139,259,398,12,38,JointPQPlayer
809,JointPQPlayer,266,221,487,35,16,Player A
810,JointPQPlayer,298,188,486,34,16,Player A
811,JointPQPlayer,285,195,480,37,19,Player A
812,JointPQPlayer,286,221,507,31,8,Player A
813,JointPQPlayer,327,167,494,33,13,Player A
814,JointPQPlayer,254,224,478,32,18,Player A
815,JointPQPlayer,294,204,498,34,12,Player A
816,JointPQPlayer,151,241,392,9,39,JointPQPlayer
817,JointPQPlayer,281,211,492,31,13,Player A
818,JointPQPlayer,259,224,483,34,17,Player A
819,JointPQPlayer,278,178,456,28,24,Player A
820,JointPQPlayer,255,220,475,35,20,Player A
821,JointPQPlayer,267,197,464,39,25,Player A
822,JointPQPlayer,316,186,502,38,12,Player A
823,JointPQPlayer,297,182,479,24,15,Player A
824,JointPQPlayer,283,208,491,33,14,Player A
825,JointPQPlayer,264,214,478,32,18,Player A
826,JointPQPlayer,303,183,486,37,17,Player A
827,JointPQPlayer,289,199,488,33,15,Player A
828,JointPQPlayer,283,193,476,24,16,Player A
829,JointPQPlayer,245,210,455,24,23,Player A
830,JointPQPlayer,291,181,472,32,20,Player A
831,JointPQPlayer,319,174,493,38,15,Player A
832,JointPQPlayer,275,180,455,27,24,Player A
833,JointPQPlayer,262,227,489,37,16,Player A
834,JointPQPlayer,296,201,497,42,15,Player A
835,JointPQPlayer,249,239,488,36,16,Player A
836,JointPQPlayer,275,205,480,37,19,Player A
837,JointPQPlayer,297,182,479,36,19,Player A
838,JointPQPlayer,296,166,462,28,22,Player A
839,JointPQPlayer,282,217,499,32,11,Player A
840,JointPQPlayer,159,254,413,15,34,JointPQPlayer
841,JointPQPlayer,288,218,506,36,10,Player A
842,JointPQPlayer,267,242,509,39,10,Player A
843,JointPQPlayer,328,183,511,38,9,Player A
844,JointPQPlayer,208,258,466,23,19,JointPQPlayer
845,JointPQPlayer,148,248,396,10,38,JointPQPlayer
846,JointPQPlayer,309,164,473,30,19,Player A
847,JointPQPlayer,273,193,466,35,23,Player A
848,JointPQPlayer,158,268,426,19,31,JointPQPlayer
849,JointPQPlayer,107,302,409,11,34,JointPQPlayer
850,JointPQPlayer,260,210,470,27,19,Player A
851,JointPQPlayer,149,299,448,17,23,JointPQPlayer
852,JointPQPlayer,276,206,482,42,20,Player A
853,JointPQPlayer,310,205,515,45,10,Player A
854,JointPQPlayer,321,161,482,27,15,Player A
855,JointPQPlayer,281,201,482,39,19,Player A
856,JointPQPlayer,144,264,408,19,37,JointPQPlayer
857,JointPQPlayer,281,206,487,38,17,Player A
858,JointPQPlayer,293,188,481,29,16,Player A
859,JointPQPlayer,246,231,477,28,17,Player A
860,JointPQPlayer,327,182,509,45,12,Player A
861,JointPQPlayer,291,186,477,31,18,Player A
862,JointPQPlayer,310,165,475,29,18,Player A
863,JointPQPlayer,275,200,475,35,20,Player A
864,JointPQPlayer,326,181,507,34,9,Player A
865,JointPQPlayer,296,171,467,30,21,Player A
866,JointPQPlayer,161,266,427,17,30,JointPQPlayer
867,JointPQPlayer,164,279,443,21,26,JointPQPlayer
868,JointPQPlayer,330,145,475,26,17,Player A
869,JointPQPlayer,294,194,488,36,16,Player A
870,JointPQPlayer,283,203,486,28,14,Player A
871,JointPQPlayer,150,290,440,21,27,JointPQPlayer
872,JointPQPlayer,230,240,470,24,18,JointPQPlayer
873,JointPQPlayer,239,234,473,24,17,Player A
874,JointPQPlayer,294,189,483,34,17,Player A
875,JointPQPlayer,285,205,490,35,15,Player A
876,JointPQPlayer,314,149,463,26,21,Player A
877,JointPQPlayer,285,195,480,37,19,Player A
878,JointPQPlayer,288,208,496,35,13,Player A
879,JointPQPlayer,260,245,505,41,12,Player A
880,JointPQPlayer,253,213,466,26,20,Player A
881,JointPQPlayer,303,173,476,33,19,Player A
882,JointPQPlayer,288,183,471,31,20,Player A
883,JointPQPlayer,309,189,498,37,13,Player A
884,JointPQPlayer,306,171,477,34,19,Player A
885,JointPQPlayer,299,214,513,49,12,Player A
886,JointPQPlayer,287,207,494,39,15,Player A
887,JointPQPlayer,297,177,474,31,19,Player A
888,JointPQPlayer,269,204,473,30,19,Player A
889,JointPQPlayer,262,222,484,38,18,Player A
890,JointPQPlayer,308,168,476,33,19,Player A
891,JointPQPlayer,310,180,490,29,13,Player A
892,JointPQPlayer,232,212,444,28,28,Player A
893,JointPQPlayer,122,297,419,9,30,JointPQPlayer
894,JointPQPlayer,289,184,473,33,20,Player A
895,JointPQPlayer,289,204,493,32,13,Player A
896,JointPQPlayer,280,215,495,40,15,Player A
897,JointPQPlayer,297,212,509,42,11,Player A
898,JointPQPlayer,278,193,471,34,21,Player A
899,JointPQPlayer,169,259,428,15,29,JointPQPlayer
900,JointPQPlayer,288,188,476,36,20,Player A
901,JointPQPlayer,296,186,482,30,16,Player A
902,JointPQPlayer,260,220,480,28,16,Player A
903,JointPQPlayer,301,196,497,42,15,Player A
904,JointPQPlayer,290,205,495,37,14,Player A
905,JointPQPlayer,166,241,407,24,39,JointPQPlayer
906,JointPQPlayer,272,217,489,37,16,Player A
907,JointPQPlayer,313,193,506,36,10,Player A
908,JointPQPlayer,286,206,492,40,16,Player A
909,JointPQPlayer,294,194,488,36,16,Player A
910,JointPQPlayer,168,238,406,14,36,JointPQPlayer
911,JointPQPlayer,286,226,512,42,10,Player A
912,JointPQPlayer,288,213,501,40,13,Player A
913,JointPQPlayer,304,189,493,35,14,Player A
914,JointPQPlayer,152,262,414,13,33,JointPQPlayer
915,JointPQPlayer,168,258,426,16,30,JointPQPlayer
916,JointPQPlayer,263,188,451,26,25,Player A
917,JointPQPlayer,223,198,421,23,34,Player A
918,JointPQPlayer,250,210,460,23,21,Player A
919,JointPQPlayer,295,215,510,40,10,Player A
920,JointPQPlayer,297,212,509,42,11,Player A
921,JointPQPlayer,291,211,502,41,13,Player A
922,JointPQPlayer,266,211,477,31,18,Player A
923,JointPQPlayer,269,209,478,32,18,Player A
924,JointPQPlayer,186,266,452,24,24,JointPQPlayer
925,JointPQPlayer,275,210,485,39,18,Player A
926,JointPQPlayer,305,170,475,32,19,Player A
927,JointPQPlayer,310,195,505,44,13,Player A
928,JointPQPlayer,152,232,384,10,42,JointPQPlayer
929,JointPQPlayer,293,208,501,49,16,Player A
930,JointPQPlayer,121,261,382,14,44,JointPQPlayer
931,JointPQPlayer,316,176,492,31,13,Player A
932,JointPQPlayer,288,188,476,33,19,Player A
933,JointPQPlayer,164,229,393,13,40,JointPQPlayer
934,JointPQPlayer,272,212,484,32,16,Player A
935,JointPQPlayer,280,200,480,37,19,Player A
936,JointPQPlayer,257,227,484,35,17,Player A
937,JointPQPlayer,285,200,485,36,17,Player A
938,JointPQPlayer,305,180,485,36,17,Player A
939,JointPQPlayer,305,175,480,34,18,Player A
940,JointPQPlayer,298,198,496,29,11,Player A
941,JointPQPlayer,308,198,506,36,10,Player A
942,JointPQPlayer,144,259,403,14,37,JointPQPlayer
943,JointPQPlayer,212,232,444,22,26,JointPQPlayer
944,JointPQPlayer,290,180,470,30,20,Player A
945,JointPQPlayer,285,205,490,32,14,Player A
946,JointPQPlayer,326,176,502,32,10,Player A
947,JointPQPlayer,137,297,434,15,27,JointPQPlayer
948,JointPQPlayer,273,208,481,41,20,Player A
949,JointPQPlayer,219,259,478,32,18,JointPQPlayer
950,JointPQPlayer,319,174,493,32,13,Player A
951,JointPQPlayer,266,201,467,30,21,Player A
952,JointPQPlayer,283,193,476,30,18,Player A
953,JointPQPlayer,271,211,482,33,17,Player A
954,JointPQPlayer,197,232,429,19,30,JointPQPlayer
955,JointPQPlayer,143,273,416,18,34,JointPQPlayer
956,JointPQPlayer,298,203,501,40,13,Player A
957,JointPQPlayer,227,227,454,20,22,Tie
958,JointPQPlayer,221,246,467,27,20,JointPQPlayer
959,JointPQPlayer,127,282,409,20,37,JointPQPlayer
960,JointPQPlayer,314,189,503,42,13,Player A
961,JointPQPlayer,243,213,456,25,23,Player A
962,JointPQPlayer,279,194,473,33,20,Player A
963,JointPQPlayer,284,194,478,26,16,Player A
964,JointPQPlayer,266,206,472,38,22,Player A
965,JointPQPlayer,305,180,485,30,15,Player A
966,JointPQPlayer,172,242,414,13,33,JointPQPlayer
967,JointPQPlayer,286,186,472,29,19,Player A
968,JointPQPlayer,297,187,484,41,19,Player A
969,JointPQPlayer,263,208,471,28,19,Player A
970,JointPQPlayer,320,175,495,31,12,Player A
971,JointPQPlayer,298,178,476,27,17,Player A
972,JointPQPlayer,292,207,499,32,11,Player A
973,JointPQPlayer,298,193,491,30,13,Player A
974,JointPQPlayer,312,197,509,36,9,Player A
975,JointPQPlayer,288,203,491,39,16,Player A
976,JointPQPlayer,185,235,420,16,32,JointPQPlayer
977,JointPQPlayer,274,214,488,33,15,Player A
978,JointPQPlayer,282,202,484,35,17,Player A
979,JointPQPlayer,260,195,455,30,25,Player A
980,JointPQPlayer,286,211,497,39,14,Player A
981,JointPQPlayer,166,236,402,13,37,JointPQPlayer
982,JointPQPlayer,280,205,485,30,15,Player A
983,JointPQPlayer,311,181,492,31,13,Player A
984,JointPQPlayer,157,267,424,14,30,JointPQPlayer
985,JointPQPlayer,306,186,492,31,13,Player A
986,JointPQPlayer,214,249,463,26,21,JointPQPlayer
987,JointPQPlayer,206,236,442,23,27,JointPQPlayer
988,JointPQPlayer,290,195,485,33,16,Player A
989,JointPQPlayer,317,172,489,37,16,Player A
990,JointPQPlayer,175,255,430,17,29,JointPQPlayer
991,JointPQPlayer,146,261,407,15,36,JointPQPlayer
992,JointPQPlayer,294,174,468,25,19,Player A
993,JointPQPlayer,254,239,493,38,15,Player A
994,JointPQPlayer,303,188,491,33,14,Player A
995,JointPQPlayer,296,211,507,40,11,Player A
996,JointPQPlayer,307,167,474,28,18,Player A
997,JointPQPlayer,258,248,506,48,14,Player A
998,JointPQPlayer,281,211,492,37,15,Player A
999,JointPQPlayer,303,193,496,32,12,Player A
1000,JointPQPlayer,246,226,472,29,19,Player A
1001,JointPQPlayer,291,166,457,29,24,Player A
1002,JointPQPlayer,244,224,468,31,21,Player A
1003,JointPQPlayer,231,241,472,35,21,JointPQPlayer
1004,JointPQPlayer,313,198,511,35,8,Player A
1005,JointPQPlayer,325,145,470,24,18,Player A
1006,JointPQPlayer,274,209,483,37,18,Player A
1007,JointPQPlayer,284,194,478,29,17,Player A
1008,JointPQPlayer,322,197,519,49,10,Player A
1009,JointPQPlayer,310,165,475,29,18,Player A
1010,JointPQPlayer,253,198,451,32,27,Player A
1011,JointPQPlayer,301,196,497,33,12,Player A
1012,JointPQPlayer,299,199,498,31,11,Player A
1013,JointPQPlayer,322,182,504,43,13,Player A
1014,JointPQPlayer,308,198,506,39,11,Player A
1015,JointPQPlayer,307,177,484,35,17,Player A
1016,JointPQPlayer,274,184,458,33,25,Player A
1017,JointPQPlayer,277,217,494,39,15,Player A
1018,JointPQPlayer,303,188,491,33,14,Player A
1019,JointPQPlayer,229,214,443,27,28,Player A
1020,JointPQPlayer,272,217,489,40,17,Player A
1021,JointPQPlayer,286,201,487,35,16,Player A
1022,JointPQPlayer,168,243,411,13,34,JointPQPlayer
1023,JointPQPlayer,294,199,493,41,16,Player A
1024,JointPQPlayer,278,198,476,24,16,Player A
1025,JointPQPlayer,294,199,493,35,14,Player A
1026,JointPQPlayer,266,201,467,30,21,Player A
1027,JointPQPlayer,303,173,476,33,19,Player A
1028,JointPQPlayer,214,219,433,23,30,JointPQPlayer
1029,JointPQPlayer,272,207,479,36,19,Player A
1030,JointPQPlayer,291,201,492,28,12,Player A
1031,JointPQPlayer,275,195,470,33,21,Player A
1032,JointPQPlayer,174,229,403,14,37,JointPQPlayer
1033,JointPQPlayer,267,207,474,34,20,Player A
1034,JointPQPlayer,287,177,464,24,20,Player A
1035,JointPQPlayer,156,276,432,22,30,JointPQPlayer
1036,JointPQPlayer,273,203,476,33,19,Player A
1037,JointPQPlayer,292,207,499,32,11,Player A
1038,JointPQPlayer,173,258,431,12,27,JointPQPlayer
1039,JointPQPlayer,312,192,504,34,10,Player A
1040,JointPQPlayer,277,182,459,25,22,Player A
1041,JointPQPlayer,170,250,420,19,33,JointPQPlayer
1042,JointPQPlayer,301,191,492,34,14,Player A
1043,JointPQPlayer,283,203,486,37,17,Player A
1044,JointPQPlayer,288,208,496,38,14,Player A
1045,JointPQPlayer,292,202,494,33,13,Player A
1046,JointPQPlayer,306,176,482,30,16,Player A
1047,JointPQPlayer,282,197,479,33,18,Player A
1048,JointPQPlayer,191,196,387,16,43,JointPQPlayer
1049,JointPQPlayer,273,198,471,34,21,Player A
1050,JointPQPlayer,239,244,483,40,19,JointPQPlayer
1051,JointPQPlayer,298,188,486,25,13,Player A
1052,JointPQPlayer,285,205,490,35,15,Player A
1053,JointPQPlayer,301,206,507,43,12,Player A
1054,JointPQPlayer,147,267,414,19,35,JointPQPlayer
1055,JointPQPlayer,294,204,498,40,14,Player A
1056,JointPQPlayer,275,215,490,32,14,Player A
1057,JointPQPlayer,288,193,481,41,20,Player A
1058,JointPQPlayer,304,209,513,37,8,Player A
1059,JointPQPlayer,271,216,487,32,15,Player A
1060,JointPQPlayer,317,162,479,30,17,Player A
1061,JointPQPlayer,288,203,491,33,14,Player A
1062,JointPQPlayer,262,207,469,32,21,Player A
1063,JointPQPlayer,288,203,491,39,16,Player A
1064,JointPQPlayer,264,219,483,28,15,Player A
1065,JointPQPlayer,293,208,501,31,10,Player A
1066,JointPQPlayer,273,198,471,34,21,Player A
1067,JointPQPlayer,160,250,410,15,35,JointPQPlayer
1068,JointPQPlayer,283,203,486,31,15,Player A
1069,JointPQPlayer,155,290,445,14,23,JointPQPlayer
1070,JointPQPlayer,305,185,490,29,13,Player A
1071,JointPQPlayer,284,189,473,30,19,Player A
1072,JointPQPlayer,203,228,431,21,30,JointPQPlayer
1073,JointPQPlayer,158,278,436,17,27,JointPQPlayer
1074,JointPQPlayer,286,196,482,33,17,Player A
1075,JointPQPlayer,263,193,456,37,27,Player A
1076,JointPQPlayer,305,175,480,34,18,Player A
1077,JointPQPlayer,307,202,509,39,10,Player A
1078,JointPQPlayer,305,185,490,35,15,Player A
1079,JointPQPlayer,271,201,472,26,18,Player A
1080,JointPQPlayer,276,216,492,40,16,Player A
1081,JointPQPlayer,265,230,495,40,15,Player A
1082,JointPQPlayer,294,204,498,37,13,Player A
1083,JointPQPlayer,303,198,501,43,14,Player A
1084,JointPQPlayer,294,184,478,32,18,Player A
1085,JointPQPlayer,258,218,476,39,21,Player A
1086,JointPQPlayer,291,191,482,33,17,Player A
1087,JointPQPlayer,306,191,497,39,14,Player A
1088,JointPQPlayer,235,230,465,28,21,Player A
1089,JointPQPlayer,160,270,430,26,32,JointPQPlayer
1090,JointPQPlayer,248,223,471,31,20,Player A
1091,JointPQPlayer,258,203,461,27,22,Player A
1092,JointPQPlayer,290,205,495,34,13,Player A
1093,JointPQPlayer,303,188,491,36,15,Player A
1094,JointPQPlayer,302,202,504,34,10,Player A
1095,JointPQPlayer,346,166,512,39,9,Player A
1096,JointPQPlayer,317,187,504,40,12,Player A
1097,JointPQPlayer,301,196,497,39,14,Player A
1098,JointPQPlayer,280,195,475,32,19,Player A
1099,JointPQPlayer,270,215,485,42,19,Player A
1100,JointPQPlayer,150,255,405,10,35,JointPQPlayer
1101,JointPQPlayer,274,199,473,36,21,Player A
1102,JointPQPlayer,218,233,451,23,24,JointPQPlayer
1103,JointPQPlayer,282,207,489,40,17,Player A
1104,JointPQPlayer,174,234,408,16,36,JointPQPlayer
1105,JointPQPlayer,288,198,486,28,14,Player A
1106,JointPQPlayer,257,222,479,27,16,Player A
1107,JointPQPlayer,259,209,468,31,21,Player A
1108,JointPQPlayer,303,183,486,31,15,Player A
1109,JointPQPlayer,214,259,473,27,18,JointPQPlayer
1110,JointPQPlayer,266,196,462,31,23,Player A
1111,JointPQPlayer,144,264,408,19,37,JointPQPlayer
1112,JointPQPlayer,275,215,490,35,15,Player A
1113,JointPQPlayer,309,179,488,36,16,Player A
1114,JointPQPlayer,276,206,482,27,15,Player A
1115,JointPQPlayer,304,194,498,34,12,Player A
1116,JointPQPlayer,230,225,455,27,24,Player A
1117,JointPQPlayer,283,198,481,32,17,Player A
1118,JointPQPlayer,161,266,427,17,30,JointPQPlayer
1119,JointPQPlayer,267,232,499,41,14,Player A
1120,JointPQPlayer,142,262,404,15,37,JointPQPlayer
1121,JointPQPlayer,138,288,426,7,27,JointPQPlayer
1122,JointPQPlayer,287,182,469,26,19,Player A
1123,JointPQPlayer,165,240,405,13,36,JointPQPlayer
1124,JointPQPlayer,208,223,431,24,31,JointPQPlayer
1125,JointPQPlayer,305,190,495,31,12,Player A
1126,JointPQPlayer,311,206,517,53,12,Player A
1127,JointPQPlayer,151,251,402,16,38,JointPQPlayer
1128,JointPQPlayer,300,190,490,32,14,Player A
1129,JointPQPlayer,265,225,490,38,16,Player A
1130,JointPQPlayer,304,189,493,38,15,Player A
1131,JointPQPlayer,264,194,458,33,25,Player A
1132,JointPQPlayer,275,195,470,33,21,Player A
1133,JointPQPlayer,311,186,497,30,11,Player A
1134,JointPQPlayer,287,202,489,34,15,Player A
1135,JointPQPlayer,225,210,435,19,28,Player A
1136,JointPQPlayer,154,259,413,18,35,JointPQPlayer
1137,JointPQPlayer,275,205,480,34,18,Player A
1138,JointPQPlayer,277,202,479,30,17,Player A
1139,JointPQPlayer,293,173,466,29,21,Player A
1140,JointPQPlayer,283,193,476,36,20,Player A
1141,JointPQPlayer,151,246,397,8,37,JointPQPlayer
1142,JointPQPlayer,288,193,481,38,19,Player A
1143,JointPQPlayer,328,173,501,34,11,Player A
1144,JointPQPlayer,140,290,430,20,30,JointPQPlayer
1145,JointPQPlayer,319,179,498,34,12,Player A
1146,JointPQPlayer,287,197,484,29,15,Player A
1147,JointPQPlayer,275,200,475,32,19,Player A
1148,JointPQPlayer,224,239,463,32,23,JointPQPlayer
1149,JointPQPlayer,243,218,461,30,23,Player A
1150,JointPQPlayer,321,181,502,38,12,Player A
1151,JointPQPlayer,248,223,471,28,19,Player A
1152,JointPQPlayer,303,198,501,40,13,Player A
1153,JointPQPlayer,241,211,452,24,24,Player A
1154,JointPQPlayer,267,182,449,27,26,Player A
1155,JointPQPlayer,271,196,467,33,22,Player A
1156,JointPQPlayer,286,186,472,29,19,Player A
1157,JointPQPlayer,299,199,498,34,12,Player A
1158,JointPQPlayer,304,194,498,34,12,Player A
1159,JointPQPlayer,140,240,380,12,44,JointPQPlayer
1160,JointPQPlayer,299,184,483,28,15,Player A
1161,JointPQPlayer,302,192,494,39,15,Player A
1162,JointPQPlayer,295,195,490,35,15,Player A
1163,JointPQPlayer,257,227,484,35,17,Player A
1164,JointPQPlayer,293,193,486,37,17,Player A
1165,JointPQPlayer,300,185,485,39,18,Player A
1166,JointPQPlayer,293,193,486,34,16,Player A
1167,JointPQPlayer,256,191,447,22,25,Player A
1168,JointPQPlayer,124,304,428,18,30,JointPQPlayer
1169,JointPQPlayer,146,261,407,18,37,JointPQPlayer
1170,JointPQPlayer,162,227,389,12,41,JointPQPlayer
1171,JointPQPlayer,282,207,489,37,16,Player A
1172,JointPQPlayer,306,201,507,40,11,Player A
1173,JointPQPlayer,322,197,519,49,10,Player A
1174,JointPQPlayer,316,181,497,33,12,Player A
1175,JointPQPlayer,257,202,459,28,23,Player A
1176,JointPQPlayer,132,272,404,12,36,JointPQPlayer
1177,JointPQPlayer,310,195,505,41,12,Player A
1178,JointPQPlayer,300,195,495,34,13,Player A
1179,JointPQPlayer,312,167,479,33,18,Player A
1180,JointPQPlayer,150,255,405,13,36,JointPQPlayer
1181,JointPQPlayer,292,212,504,46,14,Player A
1182,JointPQPlayer,275,210,485,33,16,Player A
1183,JointPQPlayer,300,195,495,34,13,Player A
1184,JointPQPlayer,281,186,467,27,20,Player A
1185,JointPQPlayer,137,272,409,14,35,JointPQPlayer
1186,JointPQPlayer,318,163,481,29,16,Player A
1187,JointPQPlayer,125,260,385,11,42,JointPQPlayer
1188,JointPQPlayer,137,277,414,19,35,JointPQPlayer
1189,JointPQPlayer,262,207,469,32,21,Player A
1190,JointPQPlayer,308,188,496,38,14,Player A
1191,JointPQPlayer,278,213,491,36,15,Player A
1192,JointPQPlayer,288,193,481,38,19,Player A
1193,JointPQPlayer,293,198,491,36,15,Player A
1194,JointPQPlayer,199,239,438,22,28,JointPQPlayer
1195,JointPQPlayer,319,179,498,34,12,Player A
1196,JointPQPlayer,267,212,479,36,19,Player A
1197,JointPQPlayer,291,186,477,31,18,Player A
1198,JointPQPlayer,266,211,477,28,17,Player A
1199,JointPQPlayer,189,244,433,20,29,JointPQPlayer
1200,JointPQPlayer,232,237,469,35,22,JointPQPlayer
1201,JointPQPlayer,132,237,369,7,46,JointPQPlayer
1202,JointPQPlayer,300,195,495,37,14,Player A
1203,JointPQPlayer,308,198,506,39,11,Player A
1204,JointPQPlayer,294,174,468,31,21,Player A
1205,JointPQPlayer,168,243,411,19,36,JointPQPlayer
1206,JointPQPlayer,311,176,487,35,16,Player A
1207,JointPQPlayer,326,166,492,31,13,Player A
1208,JointPQPlayer,271,211,482,36,18,Player A
1209,JointPQPlayer,288,173,461,33,24,Player A
1210,JointPQPlayer,282,192,474,34,20,Player A
1211,JointPQPlayer,251,256,507,37,10,JointPQPlayer
1212,JointPQPlayer,304,189,493,35,14,Player A
1213,JointPQPlayer,166,261,427,17,30,JointPQPlayer
1214,JointPQPlayer,304,179,483,31,16,Player A
1215,JointPQPlayer,291,181,472,26,18,Player A
1216,JointPQPlayer,276,211,487,38,17,Player A
1217,JointPQPlayer,261,231,492,37,15,Player A
1218,JointPQPlayer,316,171,487,32,15,Player A
1219,JointPQPlayer,297,182,479,36,19,Player A
1220,JointPQPlayer,287,202,489,40,17,Player A
1221,JointPQPlayer,285,205,490,38,16,Player A
1222,JointPQPlayer,159,274,433,26,31,JointPQPlayer
1223,JointPQPlayer,132,247,379,11,44,JointPQPlayer
1224,JointPQPlayer,218,213,431,21,30,Player A
1225,JointPQPlayer,264,219,483,31,16,Player A
1226,JointPQPlayer,319,169,488,33,15,Player A
1227,JointPQPlayer,154,264,418,17,33,JointPQPlayer
1228,JointPQPlayer,307,192,499,35,12,Player A
1229,JointPQPlayer,266,226,492,34,14,Player A
1230,JointPQPlayer,289,189,478,32,18,Player A
1231,JointPQPlayer,277,197,474,28,18,Player A
1232,JointPQPlayer,300,195,495,34,13,Player A
1233,JointPQPlayer,316,176,492,31,13,Player A
1234,JointPQPlayer,165,245,410,18,36,JointPQPlayer
1235,JointPQPlayer,283,213,496,32,12,Player A
1236,JointPQPlayer,312,177,489,37,16,Player A
1237,JointPQPlayer,307,187,494,30,12,Player A
1238,JointPQPlayer,277,222,499,38,13,Player A
1239,JointPQPlayer,277,222,499,41,14,Player A
1240,JointPQPlayer,293,213,506,36,10,Player A
1241,JointPQPlayer,252,242,494,33,13,Player A
1242,JointPQPlayer,280,195,475,35,20,Player A
1243,JointPQPlayer,259,204,463,29,22,Player A
1244,JointPQPlayer,189,244,433,20,29,JointPQPlayer
1245,JointPQPlayer,296,176,472,29,19,Player A
1246,JointPQPlayer,270,200,470,30,20,Player A
1247,JointPQPlayer,241,226,467,30,21,Player A
1248,JointPQPlayer,303,173,476,30,18,Player A
1249,JointPQPlayer,325,175,500,42,14,Player A
1250,JointPQPlayer,308,178,486,31,15,Player A
1251,JointPQPlayer,285,200,485,36,17,Player A
1252,JointPQPlayer,278,213,491,36,15,Player A
1253,JointPQPlayer,329,184,513,40,9,Player A
1254,JointPQPlayer,293,218,511,47,12,Player A
1255,JointPQPlayer,237,227,464,30,22,Player A
1256,JointPQPlayer,163,233,396,13,39,JointPQPlayer
1257,JointPQPlayer,138,293,431,18,29,JointPQPlayer
1258,JointPQPlayer,174,219,393,16,41,JointPQPlayer
1259,JointPQPlayer,147,257,404,12,36,JointPQPlayer
1260,JointPQPlayer,249,229,478,35,19,Player A
1261,JointPQPlayer,322,177,499,41,14,Player A
1262,JointPQPlayer,329,159,488,36,16,Player A
1263,JointPQPlayer,304,199,503,42,13,Player A
1264,JointPQPlayer,270,205,475,29,18,Player A
1265,JointPQPlayer,284,219,503,39,12,Player A
1266,JointPQPlayer,144,279,423,19,32,JointPQPlayer
1267,JointPQPlayer,280,180,460,23,21,Player A
1268,JointPQPlayer,150,245,395,15,40,JointPQPlayer
1269,JointPQPlayer,129,264,393,7,38,JointPQPlayer
1270,JointPQPlayer,130,275,405,10,35,JointPQPlayer
1271,JointPQPlayer,155,255,410,18,36,JointPQPlayer
1272,JointPQPlayer,296,211,507,34,9,Player A
1273,JointPQPlayer,251,191,442,23,27,Player A
1274,JointPQPlayer,155,250,405,13,36,JointPQPlayer
1275,JointPQPlayer,277,192,469,32,21,Player A
1276,JointPQPlayer,301,201,502,35,11,Player A
1277,JointPQPlayer,264,204,468,31,21,Player A
1278,JointPQPlayer,249,234,483,40,19,Player A
1279,JointPQPlayer,314,164,478,32,18,Player A
1280,JointPQPlayer,300,195,495,37,14,Player A
1281,JointPQPlayer,162,252,414,13,33,JointPQPlayer
1282,JointPQPlayer,283,218,501,49,16,Player A
1283,JointPQPlayer,287,182,469,20,17,Player A
1284,JointPQPlayer,285,205,490,32,14,Player A
1285,JointPQPlayer,292,202,494,39,15,Player A
1286,JointPQPlayer,169,234,403,17,38,JointPQPlayer
1287,JointPQPlayer,180,240,420,19,33,JointPQPlayer
1288,JointPQPlayer,297,202,499,32,11,Player A
1289,JointPQPlayer,295,195,490,38,16,Player A
1290,JointPQPlayer,298,193,491,36,15,Player A
1291,JointPQPlayer,282,207,489,34,15,Player A
1292,JointPQPlayer,170,285,455,18,21,JointPQPlayer
1293,JointPQPlayer,134,274,408,19,37,JointPQPlayer
1294,JointPQPlayer,294,194,488,39,17,Player A
1295,JointPQPlayer,126,256,382,8,42,JointPQPlayer
1296,JointPQPlayer,319,174,493,35,14,Player A
1297,JointPQPlayer,255,225,480,31,17,Player A
1298,JointPQPlayer,277,217,494,36,14,Player A
1299,JointPQPlayer,279,209,488,33,15,Player A
1300,JointPQPlayer,161,251,412,17,35,JointPQPlayer
1301,JointPQPlayer,285,225,510,37,9,Player A
1302,JointPQPlayer,303,193,496,41,15,Player A
1303,JointPQPlayer,296,176,472,29,19,Player A
1304,JointPQPlayer,272,202,474,37,21,Player A
1305,JointPQPlayer,314,189,503,33,10,Player A
1306,JointPQPlayer,273,218,491,36,15,Player A
1307,JointPQPlayer,184,244,428,24,32,JointPQPlayer
1308,JointPQPlayer,280,225,505,29,8,Player A
1309,JointPQPlayer,298,173,471,28,19,Player A
1310,JointPQPlayer,281,221,502,38,12,Player A
1311,JointPQPlayer,322,172,494,33,13,Player A
1312,JointPQPlayer,121,286,407,15,36,JointPQPlayer
1313,JointPQPlayer,291,176,467,27,20,Player A
1314,JointPQPlayer,272,202,474,25,17,Player A
1315,JointPQPlayer,170,250,420,16,32,JointPQPlayer
1316,JointPQPlayer,279,234,513,40,9,Player A
1317,JointPQPlayer,138,253,391,8,39,JointPQPlayer
1318,JointPQPlayer,142,267,409,17,36,JointPQPlayer
1319,JointPQPlayer,283,188,471,31,20,Player A
1320,JointPQPlayer,249,224,473,36,21,Player A
1321,JointPQPlayer,256,226,482,33,17,Player A
1322,JointPQPlayer,261,196,457,29,24,Player A
1323,JointPQPlayer,150,245,395,12,39,JointPQPlayer
1324,JointPQPlayer,287,197,484,35,17,Player A
1325,JointPQPlayer,330,180,510,40,10,Player A
1326,JointPQPlayer,165,235,400,14,38,JointPQPlayer
1327,JointPQPlayer,283,198,481,32,17,Player A
1328,JointPQPlayer,307,192,499,32,11,Player A
1329,JointPQPlayer,108,293,401,15,38,JointPQPlayer
1330,JointPQPlayer,130,280,410,15,35,JointPQPlayer
1331,JointPQPlayer,144,229,373,8,45,JointPQPlayer
1332,JointPQPlayer,259,239,498,37,13,Player A
1333,JointPQPlayer,260,210,470,27,19,Player A
1334,JointPQPlayer,290,205,495,28,11,Player A
1335,JointPQPlayer,290,180,470,30,20,Player A
1336,JointPQPlayer,268,203,471,34,21,Player A
1337,JointPQPlayer,131,266,397,14,39,JointPQPlayer
1338,JointPQPlayer,283,213,496,38,14,Player A
1339,JointPQPlayer,306,186,492,37,15,Player A
1340,JointPQPlayer,289,199,488,36,16,Player A
1341,JointPQPlayer,237,212,449,24,25,Player A
1342,JointPQPlayer,241,226,467,27,20,Player A
1343,JointPQPlayer,327,172,499,38,13,Player A
1344,JointPQPlayer,331,161,492,40,16,Player A
1345,JointPQPlayer,278,208,486,34,16,Player A
1346,JointPQPlayer,151,261,412,17,35,JointPQPlayer
1347,JointPQPlayer,305,185,490,29,13,Player A
1348,JointPQPlayer,298,198,496,38,14,Player A
1349,JointPQPlayer,242,207,449,30,27,Player A
1350,JointPQPlayer,288,203,491,30,13,Player A
1351,JointPQPlayer,284,209,493,35,14,Player A
1352,JointPQPlayer,329,174,503,39,12,Player A
1353,JointPQPlayer,161,246,407,12,35,JointPQPlayer
1354,JointPQPlayer,303,188,491,33,14,Player A
1355,JointPQPlayer,273,208,481,38,19,Player A
1356,JointPQPlayer,259,219,478,35,19,Player A
1357,JointPQPlayer,288,218,506,36,10,Player A
1358,JointPQPlayer,264,224,488,45,19,Player A
1359,JointPQPlayer,301,176,477,37,20,Player A
1360,JointPQPlayer,260,220,480,37,19,Player A
1361,JointPQPlayer,281,206,487,38,17,Player A
1362,JointPQPlayer,281,186,467,27,20,Player A
1363,JointPQPlayer,284,224,508,35,9,Player A
1364,JointPQPlayer,149,249,398,12,38,JointPQPlayer
1365,JointPQPlayer,298,208,506,42,12,Player A
1366,JointPQPlayer,306,161,467,27,20,Player A
1367,JointPQPlayer,284,209,493,35,14,Player A
1368,JointPQPlayer,319,169,488,33,15,Player A
1369,JointPQPlayer,304,199,503,36,11,Player A
1370,JointPQPlayer,298,198,496,35,13,Player A
1371,JointPQPlayer,131,281,412,14,34,JointPQPlayer
1372,JointPQPlayer,280,215,495,40,15,Player A
1373,JointPQPlayer,150,250,400,14,38,JointPQPlayer
1374,JointPQPlayer,310,170,480,34,18,Player A
1375,JointPQPlayer,133,283,416,12,32,JointPQPlayer
1376,JointPQPlayer,279,184,463,29,22,Player A
1377,JointPQPlayer,268,218,486,31,15,Player A
1378,JointPQPlayer,140,265,405,19,38,JointPQPlayer
1379,JointPQPlayer,174,269,443,24,27,JointPQPlayer
1380,JointPQPlayer,281,196,477,31,18,Player A
1381,JointPQPlayer,269,219,488,39,17,Player A
1382,JointPQPlayer,299,179,478,35,19,Player A
1383,JointPQPlayer,284,194,478,32,18,Player A
1384,JointPQPlayer,317,172,489,34,15,Player A
1385,JointPQPlayer,245,220,465,25,20,Player A
1386,JointPQPlayer,286,216,502,35,11,Player A
1387,JointPQPlayer,296,196,492,37,15,Player A
1388,JointPQPlayer,279,199,478,38,20,Player A
1389,JointPQPlayer,295,180,475,29,18,Player A
1390,JointPQPlayer,283,193,476,30,18,Player A
1391,JointPQPlayer,268,223,491,30,13,Player A
1392,JointPQPlayer,295,210,505,35,10,Player A
1393,JointPQPlayer,306,186,492,34,14,Player A
1394,JointPQPlayer,169,254,423,16,31,JointPQPlayer
1395,JointPQPlayer,310,175,485,36,17,Player A
1396,JointPQPlayer,276,191,467,27,20,Player A
1397,JointPQPlayer,278,198,476,36,20,Player A
1398,JointPQPlayer,140,275,415,14,33,JointPQPlayer
1399,JointPQPlayer,299,189,488,30,14,Player A
1400,JointPQPlayer,254,234,488,36,16,Player A
1401,JointPQPlayer,251,211,462,31,23,Player A
1402,JointPQPlayer,146,256,402,16,38,JointPQPlayer
1403,JointPQPlayer,243,203,446,33,29,Player A
1404,JointPQPlayer,277,182,459,28,23,Player A
1405,JointPQPlayer,138,273,411,10,33,JointPQPlayer
1406,JointPQPlayer,316,171,487,32,15,Player A
1407,JointPQPlayer,141,271,412,8,32,JointPQPlayer
1408,JointPQPlayer,168,258,426,19,31,JointPQPlayer
1409,JointPQPlayer,139,269,408,16,36,JointPQPlayer
1410,JointPQPlayer,162,257,419,18,33,JointPQPlayer
1411,JointPQPlayer,303,188,491,33,14,Player A
1412,JointPQPlayer,291,191,482,33,17,Player A
1413,JointPQPlayer,316,186,502,38,12,Player A
1414,JointPQPlayer,317,177,494,33,13,Player A
1415,JointPQPlayer,186,236,422,15,31,JointPQPlayer
1416,JointPQPlayer,270,220,490,38,16,Player A
1417,JointPQPlayer,269,204,473,27,18,Player A
1418,JointPQPlayer,266,196,462,28,22,Player A
1419,JointPQPlayer,112,307,419,12,31,JointPQPlayer
1420,JointPQPlayer,287,212,499,35,12,Player A
1421,JointPQPlayer,281,206,487,32,15,Player A
1422,JointPQPlayer,283,208,491,36,15,Player A
1423,JointPQPlayer,296,191,487,32,15,Player A
1424,JointPQPlayer,303,203,506,39,11,Player A
1425,JointPQPlayer,285,200,485,30,15,Player A
1426,JointPQPlayer,302,187,489,31,14,Player A
1427,JointPQPlayer,298,188,486,31,15,Player A
1428,JointPQPlayer,307,182,489,31,14,Player A
1429,JointPQPlayer,216,216,432,22,30,Tie
1430,JointPQPlayer,312,202,514,44,10,Player A
1431,JointPQPlayer,301,206,507,37,10,Player A
1432,JointPQPlayer,258,223,481,38,19,Player A
1433,JointPQPlayer,281,206,487,32,15,Player A
1434,JointPQPlayer,260,210,470,33,21,Player A
1435,JointPQPlayer,222,237,459,28,23,JointPQPlayer
1436,JointPQPlayer,308,193,501,37,12,Player A
1437,JointPQPlayer,183,233,416,21,35,JointPQPlayer
1438,JointPQPlayer,281,211,492,37,15,Player A
1439,JointPQPlayer,301,216,517,38,7,Player A
1440,JointPQPlayer,273,203,476,33,19,Player A
1441,JointPQPlayer,238,238,476,30,18,Tie
1442,JointPQPlayer,147,287,434,21,29,JointPQPlayer
1443,JointPQPlayer,149,249,398,9,37,JointPQPlayer
1444,JointPQPlayer,258,223,481,38,19,Player A
1445,JointPQPlayer,133,273,406,11,35,JointPQPlayer
1446,JointPQPlayer,259,214,473,33,20,Player A
1447,JointPQPlayer,167,227,394,11,39,JointPQPlayer
1448,JointPQPlayer,143,268,411,13,34,JointPQPlayer
1449,JointPQPlayer,312,177,489,34,15,Player A
1450,JointPQPlayer,269,234,503,42,13,Player A
1451,JointPQPlayer,269,209,478,29,17,Player A
1452,JointPQPlayer,278,208,486,34,16,Player A
1453,JointPQPlayer,296,191,487,29,14,Player A
1454,JointPQPlayer,149,279,428,15,29,JointPQPlayer
1455,JointPQPlayer,199,239,438,13,25,JointPQPlayer
1456,JointPQPlayer,275,205,480,34,18,Player A
1457,JointPQPlayer,129,284,413,12,33,JointPQPlayer
1458,JointPQPlayer,150,295,445,23,26,JointPQPlayer
1459,JointPQPlayer,260,200,460,29,23,Player A
1460,JointPQPlayer,318,173,491,36,15,Player A
1461,JointPQPlayer,268,228,496,38,14,Player A
1462,JointPQPlayer,309,204,513,46,11,Player A
1463,JointPQPlayer,129,294,423,13,30,JointPQPlayer
1464,JointPQPlayer,279,204,483,34,17,Player A
1465,JointPQPlayer,288,208,496,41,15,Player A
1466,JointPQPlayer,291,191,482,33,17,Player A
1467,JointPQPlayer,118,273,391,8,39,JointPQPlayer
1468,JointPQPlayer,326,166,492,31,13,Player A
1469,JointPQPlayer,286,186,472,35,21,Player A
1470,JointPQPlayer,323,173,496,38,14,Player A
1471,JointPQPlayer,272,222,494,33,13,Player A
1472,JointPQPlayer,265,225,490,32,14,Player A
1473,JointPQPlayer,317,197,514,38,8,Player A
1474,JointPQPlayer,315,200,515,39,8,Player A
1475,JointPQPlayer,136,261,397,11,38,JointPQPlayer
1476,JointPQPlayer,246,226,472,29,19,Player A
1477,JointPQPlayer,308,178,486,34,16,Player A
1478,JointPQPlayer,294,209,503,45,14,Player A
1479,JointPQPlayer,285,200,485,33,16,Player A
1480,JointPQPlayer,277,207,484,32,16,Player A
1481,JointPQPlayer,283,218,501,40,13,Player A
1482,JointPQPlayer,153,253,406,14,36,JointPQPlayer
1483,JointPQPlayer,295,190,485,30,15,Player A
1484,JointPQPlayer,284,204,488,36,16,Player A
1485,JointPQPlayer,318,183,501,37,12,Player A
1486,JointPQPlayer,269,209,478,29,17,Player A
1487,JointPQPlayer,321,176,497,39,14,Player A
1488,JointPQPlayer,177,237,414,19,35,JointPQPlayer
1489,JointPQPlayer,227,217,444,25,27,Player A
1490,JointPQPlayer,301,196,497,36,13,Player A
1491,JointPQPlayer,151,276,427,17,30,JointPQPlayer
1492,JointPQPlayer,344,169,513,34,7,Player A
1493,JointPQPlayer,271,191,462,25,21,Player A
1494,JointPQPlayer,158,268,426,19,31,JointPQPlayer
1495,JointPQPlayer,147,282,429,13,28,JointPQPlayer
1496,JointPQPlayer,164,249,413,15,34,JointPQPlayer
1497,JointPQPlayer,291,201,492,40,16,Player A
1498,JointPQPlayer,304,194,498,37,13,Player A
1499,JointPQPlayer,286,206,492,40,16,Player A
1500,JointPQPlayer,305,195,500,39,13,Player A
1501,JointPQPlayer,282,207,489,40,17,Player A
1502,JointPQPlayer,317,172,489,31,14,Player A
1503,JointPQPlayer,167,202,369,10,47,JointPQPlayer
1504,JointPQPlayer,249,249,498,34,12,Tie
1505,JointPQPlayer,298,183,481,35,18,Player A
1506,JointPQPlayer,261,226,487,35,16,Player A
1507,JointPQPlayer,282,207,489,37,16,Player A
1508,JointPQPlayer,252,227,479,36,19,Player A
1509,JointPQPlayer,311,166,477,28,17,Player A
1510,JointPQPlayer,279,214,493,41,16,Player A
1511,JointPQPlayer,285,205,490,44,18,Player A
1512,JointPQPlayer,322,177,499,32,11,Player A
1513,JointPQPlayer,305,180,485,30,15,Player A
1514,JointPQPlayer,238,223,461,30,23,Player A
1515,JointPQPlayer,182,242,424,23,33,JointPQPlayer
1516,JointPQPlayer,284,199,483,37,18,Player A
1517,JointPQPlayer,295,180,475,26,17,Player A
1518,JointPQPlayer,296,206,502,35,11,Player A
1519,JointPQPlayer,319,174,493,23,10,Player A
1520,JointPQPlayer,277,187,464,33,23,Player A
1521,JointPQPlayer,301,176,477,34,19,Player A
1522,JointPQPlayer,266,211,477,25,16,Player A
1523,JointPQPlayer,159,264,423,10,29,JointPQPlayer
1524,JointPQPlayer,135,270,405,19,38,JointPQPlayer
1525,JointPQPlayer,284,214,498,37,13,Player A
1526,JointPQPlayer,278,208,486,37,17,Player A
1527,JointPQPlayer,179,239,418,17,33,JointPQPlayer
1528,JointPQPlayer,310,180,490,29,13,Player A
1529,JointPQPlayer,315,190,505,38,11,Player A
1530,JointPQPlayer,280,205,485,30,15,Player A
1531,JointPQPlayer,293,203,496,32,12,Player A
1532,JointPQPlayer,279,194,473,33,20,Player A
1533,JointPQPlayer,297,197,494,39,15,Player A
1534,JointPQPlayer,282,187,469,29,20,Player A
1535,JointPQPlayer,264,214,478,41,21,Player A
1536,JointPQPlayer,268,218,486,34,16,Player A
1537,JointPQPlayer,336,161,497,27,10,Player A
1538,JointPQPlayer,284,204,488,36,16,Player A
1539,JointPQPlayer,267,212,479,33,18,Player A
1540,JointPQPlayer,288,188,476,30,18,Player A
1541,JointPQPlayer,280,195,475,26,17,Player A
1542,JointPQPlayer,321,171,492,43,17,Player A
1543,JointPQPlayer,297,197,494,39,15,Player A
1544,JointPQPlayer,307,187,494,39,15,Player A
1545,JointPQPlayer,300,195,495,37,14,Player A
1546,JointPQPlayer,298,188,486,43,19,Player A
1547,JointPQPlayer,284,214,498,40,14,Player A
1548,JointPQPlayer,179,239,418,23,35,JointPQPlayer
1549,JointPQPlayer,326,181,507,43,12,Player A
1550,JointPQPlayer,285,205,490,35,15,Player A
1551,JointPQPlayer,245,210,455,39,28,Player A
1552,JointPQPlayer,278,213,491,36,15,Player A
1553,JointPQPlayer,174,239,413,21,36,JointPQPlayer
1554,JointPQPlayer,340,150,490,29,13,Player A
1555,JointPQPlayer,289,219,508,38,10,Player A
1556,JointPQPlayer,280,195,475,38,21,Player A
1557,JointPQPlayer,163,243,406,20,38,JointPQPlayer
1558,JointPQPlayer,282,172,454,29,25,Player A
1559,JointPQPlayer,285,225,510,43,11,Player A
1560,JointPQPlayer,169,254,423,22,33,JointPQPlayer
1561,JointPQPlayer,218,208,426,22,32,Player A
1562,JointPQPlayer,277,207,484,35,17,Player A
1563,JointPQPlayer,294,189,483,34,17,Player A
1564,JointPQPlayer,280,205,485,39,18,Player A
1565,JointPQPlayer,295,215,510,40,10,Player A
1566,JointPQPlayer,279,199,478,35,19,Player A
1567,JointPQPlayer,279,229,508,38,10,Player A
1568,JointPQPlayer,248,238,486,37,17,Player A
1569,JointPQPlayer,273,203,476,33,19,Player A
1570,JointPQPlayer,156,241,397,11,38,JointPQPlayer
1571,JointPQPlayer,302,202,504,37,11,Player A
1572,JointPQPlayer,279,204,483,34,17,Player A
1573,JointPQPlayer,270,235,505,35,10,Player A
1574,JointPQPlayer,309,184,493,32,13,Player A
1575,JointPQPlayer,280,215,495,37,14,Player A
1576,JointPQPlayer,322,167,489,34,15,Player A
1577,JointPQPlayer,331,166,497,30,11,Player A
1578,JointPQPlayer,277,207,484,32,16,Player A
1579,JointPQPlayer,152,242,394,17,41,JointPQPlayer
1580,JointPQPlayer,287,212,499,35,12,Player A
1581,JointPQPlayer,302,172,474,31,19,Player A
1582,JointPQPlayer,291,196,487,32,15,Player A
1583,JointPQPlayer,266,231,497,33,12,Player A
1584,JointPQPlayer,293,173,466,32,22,Player A
1585,JointPQPlayer,286,201,487,41,18,Player A
1586,JointPQPlayer,260,230,490,35,15,Player A
1587,JointPQPlayer,325,180,505,35,10,Player A
1588,JointPQPlayer,286,216,502,41,13,Player A
1589,JointPQPlayer,287,197,484,32,16,Player A
1590,JointPQPlayer,125,265,390,10,40,JointPQPlayer
1591,JointPQPlayer,284,184,468,31,21,Player A
1592,JointPQPlayer,308,178,486,37,17,Player A
1593,JointPQPlayer,231,201,432,22,30,Player A
1594,JointPQPlayer,306,196,502,29,9,Player A
1595,JointPQPlayer,301,181,482,33,17,Player A
1596,JointPQPlayer,141,261,402,16,38,JointPQPlayer
1597,JointPQPlayer,288,193,481,35,18,Player A
1598,JointPQPlayer,322,177,499,41,14,Player A
1599,JointPQPlayer,297,187,484,32,16,Player A
1600,JointPQPlayer,293,173,466,32,22,Player A
1601,JointPQPlayer,301,191,492,34,14,Player A
1602,JointPQPlayer,283,188,471,31,20,Player A
1603,JointPQPlayer,277,227,504,37,11,Player A
1604,JointPQPlayer,301,166,467,27,20,Player A
1605,JointPQPlayer,137,277,414,16,34,JointPQPlayer
1606,JointPQPlayer,284,184,468,34,22,Player A
1607,JointPQPlayer,308,183,491,33,14,Player A
1608,JointPQPlayer,298,183,481,29,16,Player A
1609,JointPQPlayer,293,223,516,37,7,Player A
1610,JointPQPlayer,310,190,500,33,11,Player A
1611,JointPQPlayer,264,199,463,26,21,Player A
1612,JointPQPlayer,266,181,447,22,25,Player A
1613,JointPQPlayer,270,230,500,39,13,Player A
1614,JointPQPlayer,305,190,495,31,12,Player A
1615,JointPQPlayer,315,175,490,32,14,Player A
1616,JointPQPlayer,315,175,490,32,14,Player A
1617,JointPQPlayer,285,205,490,35,15,Player A
1618,JointPQPlayer,140,265,405,13,36,JointPQPlayer
1619,JointPQPlayer,315,160,475,35,20,Player A
1620,JointPQPlayer,275,195,470,30,20,Player A
1621,JointPQPlayer,290,205,495,40,15,Player A
1622,JointPQPlayer,318,173,491,30,13,Player A
1623,JointPQPlayer,295,200,495,31,12,Player A
1624,JointPQPlayer,259,224,483,34,17,Player A
1625,JointPQPlayer,264,194,458,30,24,Player A
1626,JointPQPlayer,259,229,488,33,15,Player A
1627,JointPQPlayer,263,203,466,32,22,Player A
1628,JointPQPlayer,154,244,398,15,39,JointPQPlayer
1629,JointPQPlayer,332,162,494,30,12,Player A
1630,JointPQPlayer,301,196,497,36,13,Player A
1631,JointPQPlayer,127,287,414,13,33,JointPQPlayer
1632,JointPQPlayer,301,186,487,29,14,Player A
1633,JointPQPlayer,298,188,486,28,14,Player A
1634,JointPQPlayer,300,200,500,39,13,Player A
1635,JointPQPlayer,328,173,501,34,11,Player A
1636,JointPQPlayer,196,216,412,14,34,JointPQPlayer
1637,JointPQPlayer,321,181,502,38,12,Player A
1638,JointPQPlayer,327,167,494,33,13,Player A
1639,JointPQPlayer,284,219,503,30,9,Player A
1640,JointPQPlayer,303,173,476,33,19,Player A
1641,JointPQPlayer,257,207,464,36,24,Player A
1642,JointPQPlayer,251,221,472,32,20,Player A
1643,JointPQPlayer,127,247,374,12,46,JointPQPlayer
1644,JointPQPlayer,283,208,491,30,13,Player A
1645,JointPQPlayer,185,245,430,26,32,JointPQPlayer
1646,JointPQPlayer,261,211,472,32,20,Player A
1647,JointPQPlayer,118,283,401,9,36,JointPQPlayer
1648,JointPQPlayer,302,187,489,31,14,Player A
1649,JointPQPlayer,133,268,401,9,36,JointPQPlayer
1650,JointPQPlayer,298,203,501,34,11,Player A
1651,JointPQPlayer,171,241,412,11,33,JointPQPlayer
1652,JointPQPlayer,320,175,495,34,13,Player A
1653,JointPQPlayer,299,199,498,40,14,Player A
1654,JointPQPlayer,311,191,502,38,12,Player A
1655,JointPQPlayer,173,228,401,15,38,JointPQPlayer
1656,JointPQPlayer,153,258,411,10,33,JointPQPlayer
1657,JointPQPlayer,273,193,466,26,20,Player A
1658,JointPQPlayer,289,209,498,37,13,Player A
1659,JointPQPlayer,186,236,422,24,34,JointPQPlayer
1660,JointPQPlayer,266,216,482,39,19,Player A
1661,JointPQPlayer,280,195,475,26,17,Player A
1662,JointPQPlayer,324,169,493,29,12,Player A
1663,JointPQPlayer,211,236,447,34,29,JointPQPlayer
1664,JointPQPlayer,290,180,470,27,19,Player A
1665,JointPQPlayer,139,249,388,17,43,JointPQPlayer
1666,JointPQPlayer,292,207,499,38,13,Player A
1667,JointPQPlayer,308,203,511,38,9,Player A
1668,JointPQPlayer,289,204,493,38,15,Player A
1669,JointPQPlayer,307,192,499,38,13,Player A
1670,JointPQPlayer,298,183,481,26,15,Player A
1671,JointPQPlayer,283,203,486,34,16,Player A
1672,JointPQPlayer,284,224,508,47,13,Player A
1673,JointPQPlayer,144,284,428,15,29,JointPQPlayer
1674,JointPQPlayer,295,200,495,43,16,Player A
1675,JointPQPlayer,284,199,483,37,18,Player A
1676,JointPQPlayer,298,198,496,38,14,Player A
1677,JointPQPlayer,280,205,485,39,18,Player A
1678,JointPQPlayer,280,210,490,32,14,Player A
1679,JointPQPlayer,316,181,497,39,14,Player A
1680,JointPQPlayer,268,198,466,35,23,Player A
1681,JointPQPlayer,160,240,400,14,38,JointPQPlayer
1682,JointPQPlayer,263,198,461,24,21,Player A
1683,JointPQPlayer,297,212,509,42,11,Player A
1684,JointPQPlayer,300,200,500,45,15,Player A
1685,JointPQPlayer,271,211,482,36,18,Player A
1686,JointPQPlayer,139,254,393,13,40,JointPQPlayer
1687,JointPQPlayer,134,234,368,12,48,JointPQPlayer
1688,JointPQPlayer,280,200,480,28,16,Player A
1689,JointPQPlayer,259,189,448,26,26,Player A
1690,JointPQPlayer,285,215,500,42,14,Player A
1691,JointPQPlayer,314,164,478,29,17,Player A
1692,JointPQPlayer,276,221,497,39,14,Player A
1693,JointPQPlayer,275,200,475,26,17,Player A
1694,JointPQPlayer,294,199,493,29,12,Player A
1695,JointPQPlayer,296,186,482,36,18,Player A
1696,JointPQPlayer,254,224,478,41,21,Player A
1697,JointPQPlayer,269,204,473,36,21,Player A
1698,JointPQPlayer,307,177,484,26,14,Player A
1699,JointPQPlayer,251,206,457,23,22,Player A
1700,JointPQPlayer,147,252,399,10,37,JointPQPlayer
1701,JointPQPlayer,179,249,428,21,31,JointPQPlayer
1702,JointPQPlayer,302,197,499,35,12,Player A
1703,JointPQPlayer,286,211,497,33,12,Player A
1704,JointPQPlayer,252,217,469,32,21,Player A
1705,JointPQPlayer,299,194,493,38,15,Player A
1706,JointPQPlayer,180,250,430,17,29,JointPQPlayer
1707,JointPQPlayer,258,198,456,31,25,Player A
1708,JointPQPlayer,262,217,479,33,18,Player A
1709,JointPQPlayer,288,183,471,28,19,Player A
1710,JointPQPlayer,162,252,414,13,33,JointPQPlayer
1711,JointPQPlayer,292,192,484,32,16,Player A
1712,JointPQPlayer,301,176,477,40,21,Player A
1713,JointPQPlayer,309,204,513,34,7,Player A
1714,JointPQPlayer,291,176,467,30,21,Player A
1715,JointPQPlayer,294,179,473,24,17,Player A
1716,JointPQPlayer,134,254,388,11,41,JointPQPlayer
1717,JointPQPlayer,259,219,478,32,18,Player A
1718,JointPQPlayer,294,204,498,40,14,Player A
1719,JointPQPlayer,172,272,444,25,27,JointPQPlayer
1720,JointPQPlayer,297,187,484,38,18,Player A
1721,JointPQPlayer,265,205,470,39,23,Player A
1722,JointPQPlayer,322,157,479,30,17,Player A
1723,JointPQPlayer,298,208,506,33,9,Player A
1724,JointPQPlayer,323,173,496,35,13,Player A
1725,JointPQPlayer,313,188,501,34,11,Player A
1726,JointPQPlayer,213,213,426,13,29,Tie
1727,JointPQPlayer,208,243,451,29,26,JointPQPlayer
1728,JointPQPlayer,325,160,485,27,14,Player A
1729,JointPQPlayer,291,196,487,35,16,Player A
1730,JointPQPlayer,284,184,468,25,19,Player A
1731,JointPQPlayer,280,200,480,31,17,Player A
1732,JointPQPlayer,137,272,409,17,36,JointPQPlayer
1733,JointPQPlayer,279,209,488,36,16,Player A
1734,JointPQPlayer,284,184,468,25,19,Player A
1735,JointPQPlayer,269,209,478,26,16,Player A
1736,JointPQPlayer,269,219,488,33,15,Player A
1737,JointPQPlayer,281,196,477,31,18,Player A
1738,JointPQPlayer,162,262,424,17,31,JointPQPlayer
1739,JointPQPlayer,283,198,481,32,17,Player A
1740,JointPQPlayer,263,218,481,38,19,Player A
1741,JointPQPlayer,285,185,470,30,20,Player A
1742,JointPQPlayer,264,219,483,37,18,Player A
1743,JointPQPlayer,277,207,484,35,17,Player A
1744,JointPQPlayer,291,201,492,31,13,Player A
1745,JointPQPlayer,280,210,490,41,17,Player A
1746,JointPQPlayer,291,201,492,37,15,Player A
1747,JointPQPlayer,150,285,435,16,27,JointPQPlayer
1748,JointPQPlayer,126,291,417,10,31,JointPQPlayer
1749,JointPQPlayer,262,187,449,18,23,Player A
1750,JointPQPlayer,317,177,494,33,13,Player A
1751,JointPQPlayer,313,168,481,35,18,Player A
1752,JointPQPlayer,125,235,360,4,48,JointPQPlayer
1753,JointPQPlayer,298,198,496,35,13,Player A
1754,JointPQPlayer,301,191,492,31,13,Player A
1755,JointPQPlayer,212,237,449,24,25,JointPQPlayer
1756,JointPQPlayer,292,207,499,35,12,Player A
1757,JointPQPlayer,295,195,490,32,14,Player A
1758,JointPQPlayer,271,206,477,37,20,Player A
1759,JointPQPlayer,145,275,420,19,33,JointPQPlayer
1760,JointPQPlayer,285,190,475,35,20,Player A
1761,JointPQPlayer,275,195,470,36,22,Player A
1762,JointPQPlayer,287,192,479,30,17,Player A
1763,JointPQPlayer,306,196,502,35,11,Player A
1764,JointPQPlayer,149,244,393,13,40,JointPQPlayer
1765,JointPQPlayer,288,203,491,36,15,Player A
1766,JointPQPlayer,253,203,456,31,25,Player A
1767,JointPQPlayer,125,240,365,9,48,JointPQPlayer
1768,JointPQPlayer,306,181,487,38,17,Player A
1769,JointPQPlayer,268,223,491,36,15,Player A
1770,JointPQPlayer,138,258,396,13,39,JointPQPlayer
1771,JointPQPlayer,260,230,490,35,15,Player A
1772,JointPQPlayer,164,239,403,11,36,JointPQPlayer
1773,JointPQPlayer,277,222,499,44,15,Player A
1774,JointPQPlayer,306,206,512,42,10,Player A
1775,JointPQPlayer,212,202,414,16,34,Player A
1776,JointPQPlayer,287,197,484,38,18,Player A
1777,JointPQPlayer,233,233,466,35,23,Tie
1778,JointPQPlayer,168,263,431,18,29,JointPQPlayer
1779,JointPQPlayer,275,210,485,27,14,Player A
1780,JointPQPlayer,259,219,478,29,17,Player A
1781,JointPQPlayer,302,177,479,36,19,Player A
1782,JointPQPlayer,316,191,507,40,11,Player A
1783,JointPQPlayer,138,233,371,12,47,JointPQPlayer
1784,JointPQPlayer,251,241,492,40,16,Player A
1785,JointPQPlayer,257,237,494,36,14,Player A
1786,JointPQPlayer,315,160,475,29,18,Player A
1787,JointPQPlayer,289,194,483,34,17,Player A
1788,JointPQPlayer,282,192,474,34,20,Player A
1789,JointPQPlayer,306,201,507,40,11,Player A
1790,JointPQPlayer,273,188,461,27,22,Player A
1791,JointPQPlayer,156,291,447,22,25,JointPQPlayer
1792,JointPQPlayer,158,253,411,10,33,JointPQPlayer
1793,JointPQPlayer,306,191,497,36,13,Player A
1794,JointPQPlayer,110,255,365,9,48,JointPQPlayer
1795,JointPQPlayer,277,212,489,34,15,Player A
1796,JointPQPlayer,276,191,467,21,18,Player A
1797,JointPQPlayer,272,222,494,42,16,Player A
1798,JointPQPlayer,302,187,489,34,15,Player A
1799,JointPQPlayer,272,212,484,35,17,Player A
1800,JointPQPlayer,319,199,518,42,8,Player A
1801,JointPQPlayer,308,183,491,30,13,Player A
1802,JointPQPlayer,266,216,482,30,16,Player A
1803,JointPQPlayer,291,186,477,31,18,Player A
1804,JointPQPlayer,291,196,487,38,17,Player A
1805,JointPQPlayer,253,233,486,31,15,Player A
1806,JointPQPlayer,239,229,468,28,20,Player A
1807,JointPQPlayer,260,215,475,32,19,Player A
1808,JointPQPlayer,201,221,422,18,32,JointPQPlayer
1809,JointPQPlayer,309,174,483,34,17,Player A
1810,JointPQPlayer,289,194,483,37,18,Player A
1811,JointPQPlayer,241,221,462,25,21,Player A
1812,JointPQPlayer,313,178,491,33,14,Player A
1813,JointPQPlayer,312,167,479,33,18,Player A
1814,JointPQPlayer,261,201,462,22,20,Player A
1815,JointPQPlayer,270,205,475,35,20,Player A
1816,JointPQPlayer,293,193,486,28,14,Player A
1817,JointPQPlayer,287,202,489,31,14,Player A
1818,JointPQPlayer,291,201,492,34,14,Player A
1819,JointPQPlayer,229,249,478,32,18,JointPQPlayer
1820,JointPQPlayer,297,192,489,34,15,Player A
1821,JointPQPlayer,288,208,496,32,12,Player A
1822,JointPQPlayer,287,207,494,33,13,Player A
1823,JointPQPlayer,274,194,468,25,19,Player A
1824,JointPQPlayer,264,204,468,28,20,Player A
1825,JointPQPlayer,271,191,462,31,23,Player A
1826,JointPQPlayer,278,203,481,35,18,Player A
1827,JointPQPlayer,304,194,498,40,14,Player A
1828,JointPQPlayer,295,190,485,30,15,Player A
1829,JointPQPlayer,157,267,424,14,30,JointPQPlayer
1830,JointPQPlayer,284,194,478,32,18,Player A
1831,JointPQPlayer,177,242,419,9,30,JointPQPlayer
1832,JointPQPlayer,153,258,411,16,35,JointPQPlayer
1833,JointPQPlayer,313,188,501,37,12,Player A
1834,JointPQPlayer,156,256,412,11,33,JointPQPlayer
1835,JointPQPlayer,120,280,400,8,36,JointPQPlayer
1836,JointPQPlayer,297,217,514,44,10,Player A
1837,JointPQPlayer,171,236,407,12,35,JointPQPlayer
1838,JointPQPlayer,283,203,486,28,14,Player A
1839,JointPQPlayer,270,220,490,41,17,Player A
1840,JointPQPlayer,275,210,485,30,15,Player A
1841,JointPQPlayer,338,148,486,31,15,Player A
1842,JointPQPlayer,247,212,459,28,23,Player A
1843,JointPQPlayer,269,204,473,24,17,Player A
1844,JointPQPlayer,312,177,489,31,14,Player A
1845,JointPQPlayer,294,209,503,39,12,Player A
1846,JointPQPlayer,294,184,478,29,17,Player A
1847,JointPQPlayer,157,237,394,17,41,JointPQPlayer
1848,JointPQPlayer,293,188,481,38,19,Player A
1849,JointPQPlayer,223,213,436,23,29,Player A
1850,JointPQPlayer,283,193,476,33,19,Player A
1851,JointPQPlayer,301,181,482,30,16,Player A
1852,JointPQPlayer,256,201,457,29,24,Player A
1853,JointPQPlayer,281,216,497,39,14,Player A
1854,JointPQPlayer,316,181,497,36,13,Player A
1855,JointPQPlayer,284,199,483,40,19,Player A
1856,JointPQPlayer,286,201,487,35,16,Player A
1857,JointPQPlayer,301,181,482,39,19,Player A
1858,JointPQPlayer,275,205,480,34,18,Player A
1859,JointPQPlayer,323,173,496,41,15,Player A
1860,JointPQPlayer,220,220,440,24,28,Tie
1861,JointPQPlayer,290,195,485,36,17,Player A
1862,JointPQPlayer,284,199,483,34,17,Player A
1863,JointPQPlayer,166,256,422,27,35,JointPQPlayer
1864,JointPQPlayer,278,213,491,36,15,Player A
1865,JointPQPlayer,189,249,438,19,27,JointPQPlayer
1866,JointPQPlayer,320,175,495,31,12,Player A
1867,JointPQPlayer,316,166,482,24,14,Player A
1868,JointPQPlayer,292,207,499,35,12,Player A
1869,JointPQPlayer,285,190,475,29,18,Player A
1870,JointPQPlayer,285,220,505,47,14,Player A
1871,JointPQPlayer,271,231,502,38,12,Player A
1872,JointPQPlayer,286,196,482,33,17,Player A
1873,JointPQPlayer,252,222,474,34,20,Player A
1874,JointPQPlayer,321,166,487,32,15,Player A
1875,JointPQPlayer,274,194,468,25,19,Player A
1876,JointPQPlayer,277,192,469,35,22,Player A
1877,JointPQPlayer,278,203,481,26,15,Player A
1878,JointPQPlayer,287,197,484,32,16,Player A
1879,JointPQPlayer,276,176,452,24,24,Player A
1880,JointPQPlayer,250,220,470,36,22,Player A
1881,JointPQPlayer,291,206,497,36,13,Player A
1882,JointPQPlayer,173,233,406,20,38,JointPQPlayer
1883,JointPQPlayer,298,203,501,37,12,Player A
1884,JointPQPlayer,309,174,483,34,17,Player A
1885,JointPQPlayer,282,207,489,34,15,Player A
1886,JointPQPlayer,302,197,499,29,10,Player A
1887,JointPQPlayer,304,174,478,32,18,Player A
1888,JointPQPlayer,282,197,479,36,19,Player A
1889,JointPQPlayer,302,192,494,33,13,Player A
1890,JointPQPlayer,337,182,519,34,5,Player A
1891,JointPQPlayer,248,208,456,25,23,Player A
1892,JointPQPlayer,286,211,497,42,15,Player A
1893,JointPQPlayer,298,198,496,32,12,Player A
1894,JointPQPlayer,151,276,427,17,30,JointPQPlayer
1895,JointPQPlayer,307,192,499,41,14,Player A
1896,JointPQPlayer,259,184,443,24,27,Player A
1897,JointPQPlayer,305,195,500,42,14,Player A
1898,JointPQPlayer,220,220,440,21,27,Tie
1899,JointPQPlayer,134,289,423,16,31,JointPQPlayer
1900,JointPQPlayer,280,200,480,34,18,Player A
1901,JointPQPlayer,311,186,497,36,13,Player A
1902,JointPQPlayer,252,222,474,28,18,Player A
1903,JointPQPlayer,284,184,468,31,21,Player A
1904,JointPQPlayer,287,217,504,37,11,Player A
1905,JointPQPlayer,286,201,487,35,16,Player A
1906,JointPQPlayer,323,168,491,33,14,Player A
1907,JointPQPlayer,130,275,405,10,35,JointPQPlayer
1908,JointPQPlayer,294,199,493,32,13,Player A
1909,JointPQPlayer,185,245,430,20,30,JointPQPlayer
1910,JointPQPlayer,266,201,467,24,19,Player A
1911,JointPQPlayer,220,250,470,24,18,JointPQPlayer
1912,JointPQPlayer,278,203,481,35,18,Player A
1913,JointPQPlayer,171,261,432,19,29,JointPQPlayer
1914,JointPQPlayer,319,169,488,36,16,Player A
1915,JointPQPlayer,134,284,418,14,32,JointPQPlayer
1916,JointPQPlayer,128,268,396,13,39,JointPQPlayer
1917,JointPQPlayer,289,189,478,35,19,Player A
1918,JointPQPlayer,284,189,473,36,21,Player A
1919,JointPQPlayer,210,225,435,22,29,JointPQPlayer
1920,JointPQPlayer,308,188,496,35,13,Player A
1921,JointPQPlayer,289,169,458,27,23,Player A
1922,JointPQPlayer,300,215,515,39,8,Player A
1923,JointPQPlayer,304,189,493,35,14,Player A
1924,JointPQPlayer,307,202,509,33,8,Player A
1925,JointPQPlayer,286,191,477,34,19,Player A
1926,JointPQPlayer,304,184,488,30,14,Player A
1927,JointPQPlayer,175,220,395,12,39,JointPQPlayer
1928,JointPQPlayer,246,226,472,26,18,Player A
1929,JointPQPlayer,287,227,514,35,7,Player A
1930,JointPQPlayer,306,176,482,33,17,Player A
1931,JointPQPlayer,196,256,452,21,23,JointPQPlayer
1932,JointPQPlayer,303,168,471,28,19,Player A
1933,JointPQPlayer,253,223,476,30,18,Player A
1934,JointPQPlayer,287,207,494,39,15,Player A
1935,JointPQPlayer,158,248,406,11,35,JointPQPlayer
1936,JointPQPlayer,269,204,473,30,19,Player A
1937,JointPQPlayer,281,211,492,40,16,Player A
1938,JointPQPlayer,286,201,487,35,16,Player A
1939,JointPQPlayer,135,285,420,13,31,JointPQPlayer
1940,JointPQPlayer,316,171,487,38,17,Player A
1941,JointPQPlayer,305,185,490,32,14,Player A
1942,JointPQPlayer,221,211,432,13,27,Player A
1943,JointPQPlayer,148,278,426,22,32,JointPQPlayer
1944,JointPQPlayer,312,207,519,46,9,Player A
1945,JointPQPlayer,284,209,493,38,15,Player A
1946,JointPQPlayer,290,170,460,29,23,Player A
1947,JointPQPlayer,263,228,491,36,15,Player A
1948,JointPQPlayer,280,185,465,28,21,Player A
1949,JointPQPlayer,281,211,492,37,15,Player A
1950,JointPQPlayer,283,203,486,37,17,Player A
1951,JointPQPlayer,302,177,479,30,17,Player A
1952,JointPQPlayer,266,216,482,33,17,Player A
1953,JointPQPlayer,229,209,438,28,30,Player A
1954,JointPQPlayer,291,201,492,40,16,Player A
1955,JointPQPlayer,258,223,481,38,19,Player A
1956,JointPQPlayer,291,186,477,34,19,Player A
1957,JointPQPlayer,293,193,486,34,16,Player A
1958,JointPQPlayer,284,204,488,39,17,Player A
1959,JointPQPlayer,282,197,479,30,17,Player A
1960,JointPQPlayer,289,189,478,35,19,Player A
1961,JointPQPlayer,317,162,479,30,17,Player A
1962,JointPQPlayer,298,183,481,26,15,Player A
1963,JointPQPlayer,266,221,487,38,17,Player A
1964,JointPQPlayer,306,201,507,40,11,Player A
1965,JointPQPlayer,301,191,492,34,14,Player A
1966,JointPQPlayer,313,183,496,38,14,Player A
1967,JointPQPlayer,155,260,415,11,32,JointPQPlayer
1968,JointPQPlayer,276,186,462,28,22,Player A
1969,JointPQPlayer,288,188,476,36,20,Player A
1970,JointPQPlayer,146,246,392,15,41,JointPQPlayer
1971,JointPQPlayer,309,184,493,29,12,Player A
1972,JointPQPlayer,261,221,482,39,19,Player A
1973,JointPQPlayer,284,179,463,32,23,Player A
1974,JointPQPlayer,317,192,509,42,11,Player A
1975,JointPQPlayer,271,201,472,29,19,Player A
1976,JointPQPlayer,275,205,480,34,18,Player A
1977,JointPQPlayer,288,203,491,39,16,Player A
1978,JointPQPlayer,286,196,482,33,17,Player A
1979,JointPQPlayer,309,204,513,37,8,Player A
1980,JointPQPlayer,169,249,418,20,34,JointPQPlayer
1981,JointPQPlayer,300,195,495,34,13,Player A
1982,JointPQPlayer,289,209,498,34,12,Player A
1983,JointPQPlayer,169,264,433,20,29,JointPQPlayer
1984,JointPQPlayer,299,194,493,35,14,Player A
1985,JointPQPlayer,313,183,496,44,16,Player A
1986,JointPQPlayer,137,277,414,16,34,JointPQPlayer
1987,JointPQPlayer,299,214,513,46,11,Player A
1988,JointPQPlayer,299,189,488,30,14,Player A
1989,JointPQPlayer,261,221,482,27,15,Player A
1990,JointPQPlayer,124,279,403,17,38,JointPQPlayer
1991,JointPQPlayer,283,188,471,28,19,Player A
1992,JointPQPlayer,292,182,474,34,20,Player A
1993,JointPQPlayer,322,162,484,32,16,Player A
1994,JointPQPlayer,294,194,488,36,16,Player A
1995,JointPQPlayer,289,189,478,29,17,Player A
1996,JointPQPlayer,284,209,493,38,15,Player A
1997,JointPQPlayer,273,183,456,31,25,Player A
1998,JointPQPlayer,236,231,467,30,21,Player A
1999,JointPQPlayer,241,201,442,26,28,Player A
2000,JointPQPlayer,282,212,494,39,15,Player A
2001,JointPQPlayer,297,197,494,39,15,Player A
2002,JointPQPlayer,289,214,503,42,13,Player A
2003,JointPQPlayer,310,175,485,30,15,Player A
2004,JointPQPlayer,283,193,476,30,18,Player A
2005,JointPQPlayer,251,231,482,33,17,Player A
2006,JointPQPlayer,310,190,500,36,12,Player A
2007,JointPQPlayer,280,175,455,27,24,Player A
2008,JointPQPlayer,288,178,466,29,21,Player A
2009,JointPQPlayer,274,204,478,38,20,Player A
2010,JointPQPlayer,293,188,481,35,18,Player A
2011,JointPQPlayer,237,227,464,24,20,Player A
2012,JointPQPlayer,282,202,484,35,17,Player A
2013,JointPQPlayer,127,282,409,11,34,JointPQPlayer
2014,JointPQPlayer,137,262,399,13,38,JointPQPlayer
2015,JointPQPlayer,314,174,488,36,16,Player A
2016,JointPQPlayer,288,198,486,31,15,Player A
2017,JointPQPlayer,130,280,410,9,33,JointPQPlayer
2018,JointPQPlayer,266,216,482,33,17,Player A
2019,JointPQPlayer,149,249,398,18,40,JointPQPlayer
2020,JointPQPlayer,293,203,496,35,13,Player A
2021,JointPQPlayer,173,258,431,18,29,JointPQPlayer
2022,JointPQPlayer,326,166,492,31,13,Player A
2023,JointPQPlayer,128,298,426,13,29,JointPQPlayer
2024,JointPQPlayer,123,283,406,14,36,JointPQPlayer
2025,JointPQPlayer,299,169,468,28,20,Player A
2026,JointPQPlayer,139,259,398,15,39,JointPQPlayer
2027,JointPQPlayer,301,186,487,32,15,Player A
2028,JointPQPlayer,143,253,396,13,39,JointPQPlayer
2029,JointPQPlayer,282,212,494,33,13,Player A
2030,JointPQPlayer,277,207,484,32,16,Player A
2031,JointPQPlayer,192,272,464,18,18,JointPQPlayer
2032,JointPQPlayer,323,168,491,33,14,Player A
2033,JointPQPlayer,301,196,497,36,13,Player A
2034,JointPQPlayer,130,270,400,17,39,JointPQPlayer
2035,JointPQPlayer,141,271,412,14,34,JointPQPlayer
2036,JointPQPlayer,281,196,477,28,17,Player A
2037,JointPQPlayer,311,171,482,33,17,Player A
2038,JointPQPlayer,276,196,472,32,20,Player A
2039,JointPQPlayer,292,197,489,40,17,Player A
2040,JointPQPlayer,304,169,473,36,21,Player A
2041,JointPQPlayer,299,174,473,36,21,Player A
2042,JointPQPlayer,315,190,505,35,10,Player A
2043,JointPQPlayer,279,199,478,38,20,Player A
2044,JointPQPlayer,232,192,424,23,33,Player A
2045,JointPQPlayer,311,176,487,32,15,Player A
2046,JointPQPlayer,131,286,417,13,32,JointPQPlayer
2047,JointPQPlayer,312,187,499,38,13,Player A
2048,JointPQPlayer,310,150,460,26,22,Player A
2049,JointPQPlayer,320,170,490,41,17,Player A
2050,JointPQPlayer,306,176,482,30,16,Player A
2051,JointPQPlayer,325,180,505,38,11,Player A
2052,JointPQPlayer,270,200,470,27,19,Player A
2053,JointPQPlayer,306,161,467,24,19,Player A
2054,JointPQPlayer,300,195,495,34,13,Player A
2055,JointPQPlayer,257,222,479,30,17,Player A
2056,JointPQPlayer,306,191,497,33,12,Player A
2057,JointPQPlayer,308,183,491,39,16,Player A
2058,JointPQPlayer,283,203,486,40,18,Player A
2059,JointPQPlayer,292,187,479,36,19,Player A
2060,JointPQPlayer,267,207,474,34,20,Player A
2061,JointPQPlayer,312,162,474,19,15,Player A
2062,JointPQPlayer,193,268,461,24,21,JointPQPlayer
2063,JointPQPlayer,274,174,448,26,26,Player A
2064,JointPQPlayer,271,231,502,44,14,Player A
2065,JointPQPlayer,280,210,490,35,15,Player A
2066,JointPQPlayer,276,196,472,29,19,Player A
2067,JointPQPlayer,309,149,458,24,22,Player A
2068,JointPQPlayer,268,183,451,26,25,Player A
2069,JointPQPlayer,295,205,500,39,13,Player A
2070,JointPQPlayer,221,246,467,30,21,JointPQPlayer
2071,JointPQPlayer,139,249,388,11,41,JointPQPlayer
2072,JointPQPlayer,282,172,454,23,23,Player A
2073,JointPQPlayer,303,198,501,37,12,Player A
2074,JointPQPlayer,276,216,492,37,15,Player A
2075,JointPQPlayer,264,214,478,38,20,Player A
2076,JointPQPlayer,301,191,492,37,15,Player A
2077,JointPQPlayer,277,182,459,37,26,Player A
2078,JointPQPlayer,302,192,494,39,15,Player A
2079,JointPQPlayer,328,193,521,45,8,Player A
2080,JointPQPlayer,201,251,452,21,23,JointPQPlayer
2081,JointPQPlayer,313,193,506,39,11,Player A
2082,JointPQPlayer,285,200,485,30,15,Player A
2083,JointPQPlayer,158,248,406,17,37,JointPQPlayer
2084,JointPQPlayer,262,202,464,27,21,Player A
2085,JointPQPlayer,318,203,521,42,7,Player A
2086,JointPQPlayer,194,239,433,23,30,JointPQPlayer
2087,JointPQPlayer,323,168,491,36,15,Player A
2088,JointPQPlayer,167,252,419,21,34,JointPQPlayer
2089,JointPQPlayer,282,197,479,39,20,Player A
2090,JointPQPlayer,301,196,497,39,14,Player A
2091,JointPQPlayer,137,262,399,16,39,JointPQPlayer
2092,JointPQPlayer,288,203,491,33,14,Player A
2093,JointPQPlayer,132,267,399,19,40,JointPQPlayer
2094,JointPQPlayer,138,263,401,12,37,JointPQPlayer
2095,JointPQPlayer,290,215,505,41,12,Player A
2096,JointPQPlayer,281,181,462,25,21,Player A
2097,JointPQPlayer,280,200,480,34,18,Player A
2098,JointPQPlayer,283,198,481,32,17,Player A
2099,JointPQPlayer,274,194,468,34,22,Player A
2100,JointPQPlayer,138,253,391,14,41,JointPQPlayer
2101,JointPQPlayer,267,197,464,27,21,Player A
2102,JointPQPlayer,269,189,458,27,23,Player A
2103,JointPQPlayer,291,191,482,36,18,Player A
2104,JointPQPlayer,269,219,488,36,16,Player A
2105,JointPQPlayer,136,271,407,12,35,JointPQPlayer
2106,JointPQPlayer,292,197,489,34,15,Player A
2107,JointPQPlayer,276,191,467,27,20,Player A
2108,JointPQPlayer,310,195,505,35,10,Player A
2109,JointPQPlayer,292,192,484,32,16,Player A
2110,JointPQPlayer,319,189,508,38,10,Player A
2111,JointPQPlayer,294,194,488,33,15,Player A
2112,JointPQPlayer,272,217,489,34,15,Player A
2113,JointPQPlayer,256,221,477,25,16,Player A
2114,JointPQPlayer,308,193,501,40,13,Player A
2115,JointPQPlayer,159,224,383,12,43,JointPQPlayer
2116,JointPQPlayer,259,229,488,33,15,Player A
2117,JointPQPlayer,309,184,493,41,16,Player A
2118,JointPQPlayer,266,226,492,37,15,Player A
2119,JointPQPlayer,270,225,495,43,16,Player A
2120,JointPQPlayer,259,214,473,36,21,Player A
2121,JointPQPlayer,301,196,497,42,15,Player A
2122,JointPQPlayer,205,230,435,19,28,JointPQPlayer
2123,JointPQPlayer,320,175,495,37,14,Player A
2124,JointPQPlayer,305,205,510,37,9,Player A
2125,JointPQPlayer,259,239,498,37,13,Player A
2126,JointPQPlayer,171,236,407,12,35,JointPQPlayer
2127,JointPQPlayer,292,192,484,29,15,Player A
2128,JointPQPlayer,292,167,459,25,22,Player A
2129,JointPQPlayer,159,234,393,16,41,JointPQPlayer
2130,JointPQPlayer,293,223,516,37,7,Player A
2131,JointPQPlayer,144,254,398,12,38,JointPQPlayer
2132,JointPQPlayer,301,206,507,46,13,Player A
2133,JointPQPlayer,292,202,494,36,14,Player A
2134,JointPQPlayer,293,178,471,25,18,Player A
2135,JointPQPlayer,311,201,512,33,7,Player A
2136,JointPQPlayer,289,174,463,32,23,Player A
2137,JointPQPlayer,129,269,398,6,36,JointPQPlayer
2138,JointPQPlayer,285,175,460,26,22,Player A
2139,JointPQPlayer,304,179,483,34,17,Player A
2140,JointPQPlayer,138,253,391,8,39,JointPQPlayer
2141,JointPQPlayer,294,184,478,35,19,Player A
2142,JointPQPlayer,258,203,461,24,21,Player A
2143,JointPQPlayer,314,189,503,36,11,Player A
2144,JointPQPlayer,178,248,426,22,32,JointPQPlayer
2145,JointPQPlayer,138,258,396,13,39,JointPQPlayer
2146,JointPQPlayer,300,210,510,40,10,Player A
2147,JointPQPlayer,267,217,484,35,17,Player A
2148,JointPQPlayer,185,230,415,14,33,JointPQPlayer
2149,JointPQPlayer,277,197,474,28,18,Player A
2150,JointPQPlayer,159,264,423,13,30,JointPQPlayer
2151,JointPQPlayer,256,216,472,35,21,Player A
2152,JointPQPlayer,130,290,420,10,30,JointPQPlayer
2153,JointPQPlayer,319,184,503,42,13,Player A
2154,JointPQPlayer,284,194,478,32,18,Player A
2155,JointPQPlayer,281,206,487,35,16,Player A
2156,JointPQPlayer,147,267,414,16,34,JointPQPlayer
2157,JointPQPlayer,318,188,506,36,10,Player A
2158,JointPQPlayer,288,198,486,34,16,Player A
2159,JointPQPlayer,237,187,424,20,32,Player A
2160,JointPQPlayer,298,203,501,37,12,Player A
2161,JointPQPlayer,285,220,505,41,12,Player A
2162,JointPQPlayer,299,194,493,29,12,Player A
2163,JointPQPlayer,257,197,454,29,25,Player A
2164,JointPQPlayer,248,238,486,40,18,Player A
2165,JointPQPlayer,278,203,481,35,18,Player A
2166,JointPQPlayer,225,235,460,29,23,JointPQPlayer
2167,JointPQPlayer,271,211,482,36,18,Player A
2168,JointPQPlayer,132,272,404,12,36,JointPQPlayer
2169,JointPQPlayer,227,222,449,21,24,Player A
2170,JointPQPlayer,294,194,488,33,15,Player A
2171,JointPQPlayer,303,193,496,38,14,Player A
2172,JointPQPlayer,223,243,466,29,21,JointPQPlayer
2173,JointPQPlayer,151,246,397,8,37,JointPQPlayer
2174,JointPQPlayer,316,171,487,35,16,Player A
2175,JointPQPlayer,269,189,458,24,22,Player A
2176,JointPQPlayer,299,204,503,36,11,Player A
2177,JointPQPlayer,302,182,484,38,18,Player A
2178,JointPQPlayer,299,184,483,28,15,Player A
2179,JointPQPlayer,308,188,496,38,14,Player A
2180,JointPQPlayer,304,184,488,36,16,Player A
2181,JointPQPlayer,174,239,413,12,33,JointPQPlayer
2182,JointPQPlayer,291,201,492,40,16,Player A
2183,JointPQPlayer,301,221,522,43,7,Player A
2184,JointPQPlayer,310,180,490,35,15,Player A
2185,JointPQPlayer,312,192,504,28,8,Player A
2186,JointPQPlayer,158,253,411,13,34,JointPQPlayer
2187,JointPQPlayer,148,228,376,17,47,JointPQPlayer
2188,JointPQPlayer,303,193,496,38,14,Player A
2189,JointPQPlayer,166,231,397,17,40,JointPQPlayer
2190,JointPQPlayer,307,207,514,44,10,Player A
2191,JointPQPlayer,201,251,452,21,23,JointPQPlayer
2192,JointPQPlayer,171,251,422,21,33,JointPQPlayer
2193,JointPQPlayer,160,255,415,11,32,JointPQPlayer
2194,JointPQPlayer,303,178,481,29,16,Player A
2195,JointPQPlayer,129,299,428,18,30,JointPQPlayer
2196,JointPQPlayer,167,247,414,10,32,JointPQPlayer
2197,JointPQPlayer,265,205,470,30,20,Player A
2198,JointPQPlayer,152,262,414,16,34,JointPQPlayer
2199,JointPQPlayer,286,191,477,34,19,Player A
2200,JointPQPlayer,327,182,509,42,11,Player A
2201,JointPQPlayer,297,207,504,43,13,Player A
2202,JointPQPlayer,300,180,480,28,16,Player A
2203,JointPQPlayer,288,188,476,33,19,Player A
2204,JointPQPlayer,306,166,472,32,20,Player A
2205,JointPQPlayer,300,190,490,38,16,Player A
2206,JointPQPlayer,299,214,513,37,8,Player A
2207,JointPQPlayer,318,188,506,42,12,Player A
2208,JointPQPlayer,279,219,498,40,14,Player A
2209,JointPQPlayer,289,169,458,30,24,Player A
2210,JointPQPlayer,121,286,407,12,35,JointPQPlayer
2211,JointPQPlayer,267,222,489,34,15,Player A
2212,JointPQPlayer,312,192,504,40,12,Player A
2213,JointPQPlayer,294,199,493,32,13,Player A
2214,JointPQPlayer,304,199,503,45,14,Player A
2215,JointPQPlayer,249,234,483,34,17,Player A
2216,JointPQPlayer,251,211,462,28,22,Player A
2217,JointPQPlayer,318,163,481,29,16,Player A
2218,JointPQPlayer,315,170,485,27,14,Player A
2219,JointPQPlayer,181,251,432,22,30,JointPQPlayer
2220,JointPQPlayer,293,208,501,43,14,Player A
2221,JointPQPlayer,313,158,471,28,19,Player A
2222,JointPQPlayer,284,194,478,32,18,Player A
2223,JointPQPlayer,284,184,468,31,21,Player A
2224,JointPQPlayer,275,205,480,31,17,Player A
2225,JointPQPlayer,261,226,487,41,18,Player A
2226,JointPQPlayer,248,218,466,32,22,Player A
2227,JointPQPlayer,302,167,469,32,21,Player A
2228,JointPQPlayer,281,191,472,35,21,Player A
2229,JointPQPlayer,172,267,439,14,25,JointPQPlayer
2230,JointPQPlayer,267,212,479,33,18,Player A
2231,JointPQPlayer,263,223,486,28,14,Player A
2232,JointPQPlayer,167,247,414,22,36,JointPQPlayer
2233,JointPQPlayer,129,279,408,13,35,JointPQPlayer
2234,JointPQPlayer,294,209,503,36,11,Player A
2235,JointPQPlayer,271,226,497,39,14,Player A
2236,JointPQPlayer,120,290,410,12,34,JointPQPlayer
2237,JointPQPlayer,323,178,501,37,12,Player A
2238,JointPQPlayer,281,191,472,38,22,Player A
2239,JointPQPlayer,297,197,494,36,14,Player A
2240,JointPQPlayer,315,175,490,35,15,Player A
2241,JointPQPlayer,328,153,481,32,17,Player A
2242,JointPQPlayer,292,192,484,35,17,Player A
2243,JointPQPlayer,302,202,504,37,11,Player A
2244,JointPQPlayer,119,284,403,17,38,JointPQPlayer
2245,JointPQPlayer,314,174,488,30,14,Player A
2246,JointPQPlayer,278,203,481,26,15,Player A
2247,JointPQPlayer,281,206,487,35,16,Player A
2248,JointPQPlayer,248,208,456,31,25,Player A
2249,JointPQPlayer,267,202,469,32,21,Player A
2250,JointPQPlayer,262,202,464,30,22,Player A
2251,JointPQPlayer,144,254,398,9,37,JointPQPlayer
2252,JointPQPlayer,159,234,393,10,39,JointPQPlayer
2253,JointPQPlayer,120,285,405,7,34,JointPQPlayer
2254,JointPQPlayer,205,225,430,20,30,JointPQPlayer
2255,JointPQPlayer,284,209,493,32,13,Player A
2256,JointPQPlayer,125,255,380,12,44,JointPQPlayer
2257,JointPQPlayer,155,275,430,11,27,JointPQPlayer
2258,JointPQPlayer,193,238,431,12,27,JointPQPlayer
2259,JointPQPlayer,170,235,405,10,35,JointPQPlayer
2260,JointPQPlayer,204,219,423,19,32,JointPQPlayer
2261,JointPQPlayer,323,163,486,25,13,Player A
2262,JointPQPlayer,286,196,482,30,16,Player A
2263,JointPQPlayer,135,280,415,17,34,JointPQPlayer
2264,JointPQPlayer,281,226,507,43,12,Player A
2265,JointPQPlayer,272,182,454,26,24,Player A
2266,JointPQPlayer,163,238,401,18,39,JointPQPlayer
2267,JointPQPlayer,160,260,420,19,33,JointPQPlayer
2268,JointPQPlayer,293,208,501,34,11,Player A
2269,JointPQPlayer,272,222,494,39,15,Player A
2270,JointPQPlayer,205,250,455,27,24,JointPQPlayer
2271,JointPQPlayer,228,228,456,25,23,Tie
2272,JointPQPlayer,131,266,397,14,39,JointPQPlayer
2273,JointPQPlayer,331,171,502,32,10,Player A
2274,JointPQPlayer,276,211,487,35,16,Player A
2275,JointPQPlayer,295,205,500,36,12,Player A
2276,JointPQPlayer,286,186,472,32,20,Player A
2277,JointPQPlayer,135,235,370,8,46,JointPQPlayer
2278,JointPQPlayer,311,186,497,36,13,Player A
2279,JointPQPlayer,276,196,472,32,20,Player A
2280,JointPQPlayer,294,189,483,31,16,Player A
2281,JointPQPlayer,124,264,388,14,42,JointPQPlayer
2282,JointPQPlayer,279,194,473,33,20,Player A
2283,JointPQPlayer,300,190,490,32,14,Player A
2284,JointPQPlayer,327,167,494,33,13,Player A
2285,JointPQPlayer,253,218,471,28,19,Player A
2286,JointPQPlayer,151,281,432,13,27,JointPQPlayer
2287,JointPQPlayer,157,237,394,20,42,JointPQPlayer
2288,JointPQPlayer,161,296,457,20,21,JointPQPlayer
2289,JointPQPlayer,266,221,487,32,15,Player A
2290,JointPQPlayer,293,198,491,36,15,Player A
2291,JointPQPlayer,301,191,492,34,14,Player A
2292,JointPQPlayer,335,175,510,46,12,Player A
2293,JointPQPlayer,318,183,501,37,12,Player A
2294,JointPQPlayer,267,237,504,40,12,Player A
2295,JointPQPlayer,306,166,472,29,19,Player A
2296,JointPQPlayer,169,259,428,27,33,JointPQPlayer
2297,JointPQPlayer,269,209,478,32,18,Player A
2298,JointPQPlayer,300,165,465,28,21,Player A
2299,JointPQPlayer,287,197,484,32,16,Player A
2300,JointPQPlayer,282,217,499,41,14,Player A
2301,JointPQPlayer,313,188,501,40,13,Player A
2302,JointPQPlayer,283,218,501,46,15,Player A
2303,JointPQPlayer,130,285,415,14,33,JointPQPlayer
2304,JointPQPlayer,171,241,412,17,35,JointPQPlayer
2305,JointPQPlayer,266,196,462,34,24,Player A
2306,JointPQPlayer,272,207,479,33,18,Player A
2307,JointPQPlayer,267,202,469,35,22,Player A
2308,JointPQPlayer,318,193,511,38,9,Player A
2309,JointPQPlayer,253,208,461,30,23,Player A
2310,JointPQPlayer,285,185,470,30,20,Player A
2311,JointPQPlayer,172,232,404,12,36,JointPQPlayer
2312,JointPQPlayer,256,211,467,30,21,Player A
2313,JointPQPlayer,287,207,494,33,13,Player A
2314,JointPQPlayer,275,210,485,33,16,Player A
2315,JointPQPlayer,291,201,492,37,15,Player A
2316,JointPQPlayer,287,227,514,38,8,Player A
2317,JointPQPlayer,307,192,499,38,13,Player A
2318,JointPQPlayer,142,272,414,19,35,JointPQPlayer
2319,JointPQPlayer,275,240,515,39,8,Player A
2320,JointPQPlayer,152,277,429,16,29,JointPQPlayer
2321,JointPQPlayer,159,254,413,21,36,JointPQPlayer
2322,JointPQPlayer,296,186,482,33,17,Player A
2323,JointPQPlayer,266,206,472,32,20,Player A
2324,JointPQPlayer,301,201,502,38,12,Player A
2325,JointPQPlayer,139,249,388,8,40,JointPQPlayer
2326,JointPQPlayer,315,190,505,38,11,Player A
2327,JointPQPlayer,314,169,483,34,17,Player A
2328,JointPQPlayer,143,268,411,16,35,JointPQPlayer
2329,JointPQPlayer,153,258,411,7,32,JointPQPlayer
2330,JointPQPlayer,285,205,490,41,17,Player A
2331,JointPQPlayer,159,254,413,18,35,JointPQPlayer
2332,JointPQPlayer,306,196,502,35,11,Player A
2333,JointPQPlayer,279,199,478,35,19,Player A
2334,JointPQPlayer,284,194,478,29,17,Player A
2335,JointPQPlayer,153,248,401,12,37,JointPQPlayer
2336,JointPQPlayer,118,283,401,12,37,JointPQPlayer
2337,JointPQPlayer,266,221,487,44,19,Player A
2338,JointPQPlayer,250,255,505,47,14,JointPQPlayer
2339,JointPQPlayer,319,179,498,40,14,Player A
2340,JointPQPlayer,254,239,493,41,16,Player A
2341,JointPQPlayer,152,232,384,10,42,JointPQPlayer
2342,JointPQPlayer,305,180,485,36,17,Player A
2343,JointPQPlayer,297,187,484,32,16,Player A
2344,JointPQPlayer,262,227,489,43,18,Player A
2345,JointPQPlayer,169,259,428,21,31,JointPQPlayer
2346,JointPQPlayer,302,192,494,36,14,Player A
2347,JointPQPlayer,293,188,481,29,16,Player A
2348,JointPQPlayer,265,200,465,31,22,Player A
2349,JointPQPlayer,295,170,465,28,21,Player A
2350,JointPQPlayer,193,258,451,20,23,JointPQPlayer
2351,JointPQPlayer,296,191,487,32,15,Player A
2352,JointPQPlayer,297,192,489,31,14,Player A
2353,JointPQPlayer,163,228,391,8,39,JointPQPlayer
2354,JointPQPlayer,304,189,493,41,16,Player A
2355,JointPQPlayer,298,193,491,30,13,Player A
2356,JointPQPlayer,130,265,395,12,39,JointPQPlayer
2357,JointPQPlayer,276,201,477,28,17,Player A
2358,JointPQPlayer,271,201,472,29,19,Player A
2359,JointPQPlayer,172,247,419,15,32,JointPQPlayer
2360,JointPQPlayer,288,198,486,31,15,Player A
2361,JointPQPlayer,309,174,483,28,15,Player A
2362,JointPQPlayer,292,187,479,33,18,Player A
2363,JointPQPlayer,258,243,501,37,12,Player A
2364,JointPQPlayer,114,289,403,11,36,JointPQPlayer
2365,JointPQPlayer,292,182,474,28,18,Player A
2366,JointPQPlayer,163,238,401,15,38,JointPQPlayer
2367,JointPQPlayer,306,191,497,42,15,Player A
2368,JointPQPlayer,319,164,483,34,17,Player A
2369,JointPQPlayer,297,187,484,29,15,Player A
2370,JointPQPlayer,267,207,474,19,15,Player A
2371,JointPQPlayer,295,185,480,31,17,Player A
2372,JointPQPlayer,275,190,465,28,21,Player A
2373,JointPQPlayer,335,185,520,41,7,Player A
2374,JointPQPlayer,144,259,403,14,37,JointPQPlayer
2375,JointPQPlayer,289,189,478,26,16,Player A
2376,JointPQPlayer,285,210,495,37,14,Player A
2377,JointPQPlayer,294,194,488,33,15,Player A
2378,JointPQPlayer,308,213,521,42,7,Player A
2379,JointPQPlayer,273,198,471,28,19,Player A
2380,JointPQPlayer,282,192,474,34,20,Player A
2381,JointPQPlayer,283,193,476,33,19,Player A
2382,JointPQPlayer,154,259,413,18,35,JointPQPlayer
2383,JointPQPlayer,264,239,503,36,11,Player A
2384,JointPQPlayer,239,209,448,32,28,Player A
2385,JointPQPlayer,128,268,396,16,40,JointPQPlayer
2386,JointPQPlayer,267,222,489,34,15,Player A
2387,JointPQPlayer,295,165,460,29,23,Player A
2388,JointPQPlayer,300,170,470,27,19,Player A
2389,JointPQPlayer,159,249,408,16,36,JointPQPlayer
2390,JointPQPlayer,283,208,491,39,16,Player A
2391,JointPQPlayer,299,179,478,32,18,Player A
2392,JointPQPlayer,148,253,401,12,37,JointPQPlayer
2393,JointPQPlayer,177,242,419,15,32,JointPQPlayer
2394,JointPQPlayer,265,225,490,41,17,Player A
2395,JointPQPlayer,251,236,487,35,16,Player A
2396,JointPQPlayer,295,180,475,35,20,Player A
2397,JointPQPlayer,255,215,470,39,23,Player A
2398,JointPQPlayer,308,153,461,27,22,Player A
2399,JointPQPlayer,283,193,476,27,17,Player A
2400,JointPQPlayer,280,240,520,41,7,Player A
2401,JointPQPlayer,289,214,503,39,12,Player A
2402,JointPQPlayer,200,245,445,26,27,JointPQPlayer
2403,JointPQPlayer,306,176,482,33,17,Player A
2404,JointPQPlayer,276,206,482,36,18,Player A
2405,JointPQPlayer,300,185,485,27,14,Player A
2406,JointPQPlayer,312,177,489,31,14,Player A
2407,JointPQPlayer,180,275,455,24,23,JointPQPlayer
2408,JointPQPlayer,291,211,502,29,9,Player A
2409,JointPQPlayer,178,218,396,10,38,JointPQPlayer
2410,JointPQPlayer,195,220,415,20,35,JointPQPlayer
2411,JointPQPlayer,256,221,477,40,21,Player A
2412,JointPQPlayer,289,194,483,31,16,Player A
2413,JointPQPlayer,283,218,501,43,14,Player A
2414,JointPQPlayer,243,213,456,28,24,Player A
2415,JointPQPlayer,325,175,500,45,15,Player A
2416,JointPQPlayer,290,200,490,32,14,Player A
2417,JointPQPlayer,145,240,385,14,43,JointPQPlayer
2418,JointPQPlayer,146,256,402,16,38,JointPQPlayer
2419,JointPQPlayer,302,172,474,28,18,Player A
2420,JointPQPlayer,279,199,478,35,19,Player A
2421,JointPQPlayer,313,178,491,33,14,Player A
2422,JointPQPlayer,299,204,503,36,11,Player A
2423,JointPQPlayer,239,244,483,28,15,JointPQPlayer
2424,JointPQPlayer,314,174,488,30,14,Player A
2425,JointPQPlayer,159,224,383,12,43,JointPQPlayer
2426,JointPQPlayer,150,260,410,15,35,JointPQPlayer
2427,JointPQPlayer,147,272,419,15,32,JointPQPlayer
2428,JointPQPlayer,267,222,489,40,17,Player A
2429,JointPQPlayer,276,176,452,24,24,Player A
2430,JointPQPlayer,292,187,479,27,16,Player A
2431,JointPQPlayer,322,157,479,33,18,Player A
2432,JointPQPlayer,242,222,464,24,20,Player A
2433,JointPQPlayer,163,258,421,17,32,JointPQPlayer
2434,JointPQPlayer,294,209,503,42,13,Player A
2435,JointPQPlayer,318,193,511,44,11,Player A
2436,JointPQPlayer,318,168,486,31,15,Player A
2437,JointPQPlayer,124,289,413,15,34,JointPQPlayer
2438,JointPQPlayer,305,195,500,33,11,Player A
2439,JointPQPlayer,198,233,431,18,29,JointPQPlayer
2440,JointPQPlayer,280,190,470,30,20,Player A
2441,JointPQPlayer,235,225,460,38,26,Player A
2442,JointPQPlayer,322,167,489,43,18,Player A
2443,JointPQPlayer,284,219,503,42,13,Player A
2444,JointPQPlayer,302,172,474,37,21,Player A
2445,JointPQPlayer,308,183,491,42,17,Player A
2446,JointPQPlayer,298,183,481,26,15,Player A
2447,JointPQPlayer,335,165,500,30,10,Player A
2448,JointPQPlayer,268,233,501,43,14,Player A
2449,JointPQPlayer,258,178,436,23,29,Player A
2450,JointPQPlayer,304,194,498,37,13,Player A
2451,JointPQPlayer,196,231,427,20,31,JointPQPlayer
2452,JointPQPlayer,248,203,451,26,25,Player A
2453,JointPQPlayer,252,207,459,34,25,Player A
2454,JointPQPlayer,286,186,472,38,22,Player A
2455,JointPQPlayer,280,210,490,38,16,Player A
2456,JointPQPlayer,282,202,484,35,17,Player A
2457,JointPQPlayer,297,187,484,32,16,Player A
2458,JointPQPlayer,142,267,409,8,33,JointPQPlayer
2459,JointPQPlayer,303,213,516,37,7,Player A
2460,JointPQPlayer,273,218,491,39,16,Player A
2461,JointPQPlayer,292,202,494,30,12,Player A
2462,JointPQPlayer,288,178,466,29,21,Player A
2463,JointPQPlayer,281,211,492,37,15,Player A
2464,JointPQPlayer,295,195,490,38,16,Player A
2465,JointPQPlayer,153,253,406,11,35,JointPQPlayer
2466,JointPQPlayer,317,162,479,33,18,Player A
2467,JointPQPlayer,204,264,468,28,20,JointPQPlayer
2468,JointPQPlayer,141,256,397,11,38,JointPQPlayer
2469,JointPQPlayer,291,186,477,31,18,Player A
2470,JointPQPlayer,275,225,500,36,12,Player A
2471,JointPQPlayer,287,222,509,39,10,Player A
2472,JointPQPlayer,288,183,471,31,20,Player A
2473,JointPQPlayer,163,223,386,15,43,JointPQPlayer
2474,JointPQPlayer,312,167,479,33,18,Player A
2475,JointPQPlayer,152,237,389,12,41,JointPQPlayer
2476,JointPQPlayer,151,251,402,13,37,JointPQPlayer
2477,JointPQPlayer,139,254,393,10,39,JointPQPlayer
2478,JointPQPlayer,282,207,489,37,16,Player A
2479,JointPQPlayer,156,271,427,17,30,JointPQPlayer
2480,JointPQPlayer,143,253,396,16,40,JointPQPlayer
2481,JointPQPlayer,268,208,476,36,20,Player A
2482,JointPQPlayer,264,204,468,28,20,Player A
2483,JointPQPlayer,255,205,460,29,23,Player A
2484,JointPQPlayer,165,250,415,14,33,JointPQPlayer
2485,JointPQPlayer,223,228,451,23,24,JointPQPlayer
2486,JointPQPlayer,129,264,393,10,39,JointPQPlayer
2487,JointPQPlayer,252,227,479,33,18,Player A
2488,JointPQPlayer,270,225,495,40,15,Player A
2489,JointPQPlayer,328,198,526,44,6,Player A
2490,JointPQPlayer,270,210,480,31,17,Player A
2491,JointPQPlayer,292,192,484,44,20,Player A
2492,JointPQPlayer,146,276,422,15,31,JointPQPlayer
2493,JointPQPlayer,314,189,503,36,11,Player A
2494,JointPQPlayer,300,205,505,41,12,Player A
2495,JointPQPlayer,150,255,405,13,36,JointPQPlayer
2496,JointPQPlayer,279,189,468,28,20,Player A
2497,JointPQPlayer,326,156,482,33,17,Player A
2498,JointPQPlayer,164,254,418,17,33,JointPQPlayer
2499,JointPQPlayer,320,190,510,37,9,Player A
2500,JointPQPlayer,304,189,493,35,14,Player A
2501,JointPQPlayer,168,243,411,19,36,JointPQPlayer
2502,JointPQPlayer,163,223,386,12,42,JointPQPlayer
2503,JointPQPlayer,279,204,483,31,16,Player A
2504,JointPQPlayer,319,169,488,30,14,Player A
2505,JointPQPlayer,270,195,465,40,25,Player A
2506,JointPQPlayer,331,181,512,36,8,Player A
2507,JointPQPlayer,132,277,409,17,36,JointPQPlayer
2508,JointPQPlayer,290,205,495,31,12,Player A
2509,JointPQPlayer,334,169,503,42,13,Player A
2510,JointPQPlayer,311,186,497,27,10,Player A
2511,JointPQPlayer,177,247,424,14,30,JointPQPlayer
2512,JointPQPlayer,140,270,410,12,34,JointPQPlayer
2513,JointPQPlayer,303,188,491,36,15,Player A
2514,JointPQPlayer,295,200,495,40,15,Player A
2515,JointPQPlayer,295,210,505,35,10,Player A
2516,JointPQPlayer,274,234,508,32,8,Player A
2517,JointPQPlayer,267,222,489,37,16,Player A
2518,JointPQPlayer,267,237,504,37,11,Player A
2519,JointPQPlayer,303,173,476,33,19,Player A
2520,JointPQPlayer,300,190,490,41,17,Player A
2521,JointPQPlayer,204,234,438,22,28,JointPQPlayer
2522,JointPQPlayer,268,218,486,34,16,Player A
2523,JointPQPlayer,298,188,486,31,15,Player A
2524,JointPQPlayer,331,171,502,38,12,Player A
2525,JointPQPlayer,295,180,475,32,19,Player A
2526,JointPQPlayer,287,207,494,39,15,Player A
2527,JointPQPlayer,240,225,465,31,22,Player A
2528,JointPQPlayer,277,207,484,35,17,Player A
2529,JointPQPlayer,286,211,497,39,14,Player A
2530,JointPQPlayer,309,184,493,35,14,Player A
2531,JointPQPlayer,279,194,473,33,20,Player A
2532,JointPQPlayer,303,193,496,38,14,Player A
2533,JointPQPlayer,310,185,495,37,14,Player A
2534,JointPQPlayer,251,236,487,41,18,Player A
2535,JointPQPlayer,283,193,476,30,18,Player A
2536,JointPQPlayer,278,213,491,36,15,Player A
2537,JointPQPlayer,275,190,465,31,22,Player A
2538,JointPQPlayer,294,194,488,30,14,Player A
2539,JointPQPlayer,256,196,452,33,27,Player A
2540,JointPQPlayer,196,231,427,20,31,JointPQPlayer
2541,JointPQPlayer,194,219,413,15,34,JointPQPlayer
2542,JointPQPlayer,155,245,400,17,39,JointPQPlayer
2543,JointPQPlayer,284,219,503,39,12,Player A
2544,JointPQPlayer,304,174,478,32,18,Player A
2545,JointPQPlayer,301,201,502,38,12,Player A
2546,JointPQPlayer,289,184,473,33,20,Player A
2547,JointPQPlayer,309,174,483,34,17,Player A
2548,JointPQPlayer,292,172,464,30,22,Player A
2549,JointPQPlayer,278,198,476,33,19,Player A
2550,JointPQPlayer,293,188,481,32,17,Player A
2551,JointPQPlayer,249,219,468,34,22,Player A
2552,JointPQPlayer,305,215,520,41,7,Player A
2553,JointPQPlayer,281,206,487,35,16,Player A
2554,JointPQPlayer,209,239,448,17,23,JointPQPlayer
2555,JointPQPlayer,289,189,478,41,21,Player A
2556,JointPQPlayer,293,193,486,31,15,Player A
2557,JointPQPlayer,139,274,413,12,33,JointPQPlayer
2558,JointPQPlayer,306,191,497,39,14,Player A
2559,JointPQPlayer,295,185,480,25,15,Player A
2560,JointPQPlayer,301,196,497,36,13,Player A
2561,JointPQPlayer,293,228,521,48,9,Player A
2562,JointPQPlayer,296,176,472,29,19,Player A
2563,JointPQPlayer,302,182,484,35,17,Player A
2564,JointPQPlayer,301,176,477,25,16,Player A
2565,JointPQPlayer,168,233,401,18,39,JointPQPlayer
2566,JointPQPlayer,157,247,404,15,37,JointPQPlayer
2567,JointPQPlayer,135,270,405,13,36,JointPQPlayer
2568,JointPQPlayer,284,194,478,35,19,Player A
2569,JointPQPlayer,201,226,427,26,33,JointPQPlayer
2570,JointPQPlayer,185,225,410,18,36,JointPQPlayer
2571,JointPQPlayer,286,226,512,36,8,Player A
2572,JointPQPlayer,256,196,452,30,26,Player A
2573,JointPQPlayer,298,198,496,35,13,Player A
2574,JointPQPlayer,304,174,478,32,18,Player A
2575,JointPQPlayer,275,225,500,39,13,Player A
2576,JointPQPlayer,297,187,484,38,18,Player A
2577,JointPQPlayer,284,204,488,30,14,Player A
2578,JointPQPlayer,141,281,422,15,31,JointPQPlayer
2579,JointPQPlayer,201,256,457,26,23,JointPQPlayer
2580,JointPQPlayer,315,170,485,36,17,Player A
2581,JointPQPlayer,273,183,456,34,26,Player A
2582,JointPQPlayer,153,253,406,11,35,JointPQPlayer
2583,JointPQPlayer,273,218,491,30,13,Player A
2584,JointPQPlayer,157,237,394,17,41,JointPQPlayer
2585,JointPQPlayer,209,229,438,28,30,JointPQPlayer
2586,JointPQPlayer,190,230,420,19,33,JointPQPlayer
2587,JointPQPlayer,253,218,471,34,21,Player A
2588,JointPQPlayer,307,197,504,34,10,Player A
2589,JointPQPlayer,140,255,395,12,39,JointPQPlayer
2590,JointPQPlayer,242,207,449,27,26,Player A
2591,JointPQPlayer,346,136,482,27,15,Player A
2592,JointPQPlayer,165,245,410,15,35,JointPQPlayer
2593,JointPQPlayer,302,202,504,40,12,Player A
2594,JointPQPlayer,286,201,487,32,15,Player A
2595,JointPQPlayer,297,192,489,34,15,Player A
2596,JointPQPlayer,278,208,486,40,18,Player A
2597,JointPQPlayer,309,184,493,35,14,Player A
2598,JointPQPlayer,242,237,479,30,17,Player A
2599,JointPQPlayer,277,182,459,31,24,Player A
2600,JointPQPlayer,160,220,380,15,45,JointPQPlayer
2601,JointPQPlayer,219,249,468,28,20,JointPQPlayer
2602,JointPQPlayer,314,179,493,38,15,Player A
2603,JointPQPlayer,247,187,434,21,29,Player A
2604,JointPQPlayer,129,274,403,14,37,JointPQPlayer
2605,JointPQPlayer,161,256,417,16,33,JointPQPlayer
2606,JointPQPlayer,144,264,408,19,37,JointPQPlayer
2607,JointPQPlayer,302,207,509,39,10,Player A
2608,JointPQPlayer,141,286,427,11,28,JointPQPlayer
2609,JointPQPlayer,125,275,400,17,39,JointPQPlayer
2610,JointPQPlayer,302,202,504,34,10,Player A
2611,JointPQPlayer,288,193,481,35,18,Player A
2612,JointPQPlayer,294,199,493,38,15,Player A
2613,JointPQPlayer,281,176,457,32,25,Player A
2614,JointPQPlayer,283,193,476,36,20,Player A
2615,JointPQPlayer,288,193,481,29,16,Player A
2616,JointPQPlayer,272,222,494,42,16,Player A
2617,JointPQPlayer,316,186,502,32,10,Player A
2618,JointPQPlayer,324,169,493,32,13,Player A
2619,JointPQPlayer,195,265,460,23,21,JointPQPlayer
2620,JointPQPlayer,160,230,390,13,41,JointPQPlayer
2621,JointPQPlayer,272,202,474,34,20,Player A
2622,JointPQPlayer,284,209,493,35,14,Player A
2623,JointPQPlayer,293,188,481,35,18,Player A
2624,JointPQPlayer,317,187,504,40,12,Player A
2625,JointPQPlayer,244,204,448,26,26,Player A
2626,JointPQPlayer,294,194,488,33,15,Player A
2627,JointPQPlayer,150,230,380,15,45,JointPQPlayer
2628,JointPQPlayer,149,249,398,15,39,JointPQPlayer
2629,JointPQPlayer,130,280,410,18,36,JointPQPlayer
2630,JointPQPlayer,300,170,470,30,20,Player A
2631,JointPQPlayer,305,195,500,36,12,Player A
2632,JointPQPlayer,274,229,503,39,12,Player A
2633,JointPQPlayer,288,198,486,37,17,Player A
2634,JointPQPlayer,269,224,493,41,16,Player A
2635,JointPQPlayer,323,153,476,33,19,Player A
2636,JointPQPlayer,283,208,491,36,15,Player A
2637,JointPQPlayer,145,255,400,14,38,JointPQPlayer
2638,JointPQPlayer,292,222,514,38,8,Player A
2639,JointPQPlayer,288,193,481,38,19,Player A
2640,JointPQPlayer,311,196,507,40,11,Player A
2641,JointPQPlayer,173,238,411,16,35,JointPQPlayer
2642,JointPQPlayer,310,180,490,35,15,Player A
2643,JointPQPlayer,282,207,489,34,15,Player A
2644,JointPQPlayer,152,247,399,13,38,JointPQPlayer
2645,JointPQPlayer,182,247,429,25,32,JointPQPlayer
2646,JointPQPlayer,319,164,483,31,16,Player A
2647,JointPQPlayer,227,217,444,28,28,Player A
2648,JointPQPlayer,133,263,396,16,40,JointPQPlayer
2649,JointPQPlayer,159,244,403,11,36,JointPQPlayer
2650,JointPQPlayer,154,259,413,21,36,JointPQPlayer
2651,JointPQPlayer,321,176,497,36,13,Player A
2652,JointPQPlayer,303,173,476,33,19,Player A
2653,JointPQPlayer,268,183,451,26,25,Player A
2654,JointPQPlayer,145,250,395,12,39,JointPQPlayer
2655,JointPQPlayer,259,219,478,26,16,Player A
2656,JointPQPlayer,302,197,499,32,11,Player A
2657,JointPQPlayer,268,198,466,32,22,Player A
2658,JointPQPlayer,283,193,476,36,20,Player A
2659,JointPQPlayer,292,197,489,40,17,Player A
2660,JointPQPlayer,284,194,478,26,16,Player A
2661,JointPQPlayer,307,172,479,30,17,Player A
2662,JointPQPlayer,295,200,495,40,15,Player A
2663,JointPQPlayer,132,272,404,9,35,JointPQPlayer
2664,JointPQPlayer,292,182,474,28,18,Player A
2665,JointPQPlayer,310,195,505,44,13,Player A
2666,JointPQPlayer,301,196,497,36,13,Player A
2667,JointPQPlayer,137,247,384,13,43,JointPQPlayer
2668,JointPQPlayer,336,161,497,39,14,Player A
2669,JointPQPlayer,292,177,469,29,20,Player A
2670,JointPQPlayer,295,190,485,24,13,Player A
2671,JointPQPlayer,340,150,490,32,14,Player A
2672,JointPQPlayer,149,244,393,13,40,JointPQPlayer
2673,JointPQPlayer,276,221,497,33,12,Player A
2674,JointPQPlayer,336,166,502,35,11,Player A
2675,JointPQPlayer,264,209,473,27,18,Player A
2676,JointPQPlayer,149,289,438,19,27,JointPQPlayer
2677,JointPQPlayer,287,187,474,28,18,Player A
2678,JointPQPlayer,286,226,512,39,9,Player A
2679,JointPQPlayer,252,232,484,32,16,Player A
2680,JointPQPlayer,146,246,392,12,40,JointPQPlayer
2681,JointPQPlayer,287,187,474,37,21,Player A
2682,JointPQPlayer,288,208,496,38,14,Player A
2683,JointPQPlayer,151,261,412,14,34,JointPQPlayer
2684,JointPQPlayer,147,282,429,16,29,JointPQPlayer
2685,JointPQPlayer,253,198,451,32,27,Player A
2686,JointPQPlayer,300,175,475,26,17,Player A
2687,JointPQPlayer,271,196,467,33,22,Player A
2688,JointPQPlayer,285,185,470,30,20,Player A
2689,JointPQPlayer,286,201,487,35,16,Player A
2690,JointPQPlayer,286,181,467,30,21,Player A
2691,JointPQPlayer,281,216,497,36,13,Player A
2692,JointPQPlayer,266,231,497,33,12,Player A
2693,JointPQPlayer,312,177,489,34,15,Player A
2694,JointPQPlayer,276,201,477,25,16,Player A
2695,JointPQPlayer,312,182,494,42,16,Player A
2696,JointPQPlayer,158,268,426,10,28,JointPQPlayer
2697,JointPQPlayer,281,226,507,43,12,Player A
2698,JointPQPlayer,274,214,488,39,17,Player A
2699,JointPQPlayer,291,221,512,36,8,Player A
2700,JointPQPlayer,287,197,484,38,18,Player A
2701,JointPQPlayer,228,233,461,30,23,JointPQPlayer
2702,JointPQPlayer,265,205,470,30,20,Player A
2703,JointPQPlayer,303,208,511,35,8,Player A
2704,JointPQPlayer,317,192,509,45,12,Player A
2705,JointPQPlayer,282,192,474,40,22,Player A
2706,JointPQPlayer,296,181,477,28,17,Player A
2707,JointPQPlayer,279,214,493,32,13,Player A
2708,JointPQPlayer,165,230,395,9,38,JointPQPlayer
2709,JointPQPlayer,145,270,415,14,33,JointPQPlayer
2710,JointPQPlayer,259,199,458,27,23,Player A
2711,JointPQPlayer,182,242,424,20,32,JointPQPlayer
2712,JointPQPlayer,308,188,496,35,13,Player A
2713,JointPQPlayer,266,191,457,26,23,Player A
2714,JointPQPlayer,298,198,496,41,15,Player A
2715,JointPQPlayer,287,207,494,33,13,Player A
2716,JointPQPlayer,142,277,419,18,33,JointPQPlayer
2717,JointPQPlayer,226,226,452,21,23,Tie
2718,JointPQPlayer,260,215,475,38,21,Player A
2719,JointPQPlayer,141,256,397,14,39,JointPQPlayer
2720,JointPQPlayer,160,240,400,11,37,JointPQPlayer
2721,JointPQPlayer,257,202,459,31,24,Player A
2722,JointPQPlayer,148,253,401,15,38,JointPQPlayer
2723,JointPQPlayer,179,234,413,18,35,JointPQPlayer
2724,JointPQPlayer,272,227,499,38,13,Player A
2725,JointPQPlayer,136,251,387,10,41,JointPQPlayer
2726,JointPQPlayer,188,233,421,14,31,JointPQPlayer
2727,JointPQPlayer,279,204,483,37,18,Player A
2728,JointPQPlayer,304,179,483,34,17,Player A
2729,JointPQPlayer,261,231,492,40,16,Player A
2730,JointPQPlayer,283,193,476,33,19,Player A
2731,JointPQPlayer,169,249,418,17,33,JointPQPlayer
2732,JointPQPlayer,124,309,433,14,27,JointPQPlayer
2733,JointPQPlayer,299,194,493,35,14,Player A
2734,JointPQPlayer,312,177,489,31,14,Player A
2735,JointPQPlayer,295,180,475,35,20,Player A
2736,JointPQPlayer,229,249,478,32,18,JointPQPlayer
2737,JointPQPlayer,275,200,475,32,19,Player A
2738,JointPQPlayer,135,255,390,7,39,JointPQPlayer
2739,JointPQPlayer,287,207,494,36,14,Player A
2740,JointPQPlayer,281,196,477,31,18,Player A
2741,JointPQPlayer,135,265,400,8,36,JointPQPlayer
2742,JointPQPlayer,269,204,473,36,21,Player A
2743,JointPQPlayer,314,184,498,37,13,Player A
2744,JointPQPlayer,269,204,473,33,20,Player A
2745,JointPQPlayer,294,189,483,31,16,Player A
2746,JointPQPlayer,252,202,454,23,23,Player A
2747,JointPQPlayer,327,162,489,31,14,Player A
2748,JointPQPlayer,308,163,471,28,19,Player A
2749,JointPQPlayer,291,186,477,34,19,Player A
2750,JointPQPlayer,281,171,452,27,25,Player A
2751,JointPQPlayer,283,178,461,27,22,Player A
2752,JointPQPlayer,152,232,384,16,44,JointPQPlayer
2753,JointPQPlayer,294,184,478,35,19,Player A
2754,JointPQPlayer,149,259,408,16,36,JointPQPlayer
2755,JointPQPlayer,269,214,483,37,18,Player A
2756,JointPQPlayer,250,210,460,23,21,Player A
2757,JointPQPlayer,304,189,493,38,15,Player A
2758,JointPQPlayer,302,182,484,26,14,Player A
2759,JointPQPlayer,155,255,410,12,34,JointPQPlayer
2760,JointPQPlayer,276,201,477,37,20,Player A
2761,JointPQPlayer,290,195,485,33,16,Player A
2762,JointPQPlayer,275,215,490,38,16,Player A
2763,JointPQPlayer,309,199,508,38,10,Player A
2764,JointPQPlayer,348,163,511,38,9,Player A
2765,JointPQPlayer,258,213,471,31,20,Player A
2766,JointPQPlayer,264,229,493,38,15,Player A
2767,JointPQPlayer,325,150,475,29,18,Player A
2768,JointPQPlayer,297,192,489,37,16,Player A
2769,JointPQPlayer,283,213,496,38,14,Player A
2770,JointPQPlayer,174,199,373,14,47,JointPQPlayer
2771,JointPQPlayer,171,256,427,20,31,JointPQPlayer
2772,JointPQPlayer,326,181,507,40,11,Player A
2773,JointPQPlayer,271,201,472,32,20,Player A
2774,JointPQPlayer,285,190,475,32,19,Player A
2775,JointPQPlayer,311,191,502,38,12,Player A
2776,JointPQPlayer,233,228,461,30,23,Player A
2777,JointPQPlayer,329,169,498,37,13,Player A
2778,JointPQPlayer,280,185,465,28,21,Player A
2779,JointPQPlayer,121,301,422,9,29,JointPQPlayer
2780,JointPQPlayer,294,204,498,31,11,Player A
2781,JointPQPlayer,281,206,487,41,18,Player A
2782,JointPQPlayer,146,256,402,16,38,JointPQPlayer
2783,JointPQPlayer,291,211,502,47,15,Player A
2784,JointPQPlayer,276,196,472,32,20,Player A
2785,JointPQPlayer,131,261,392,12,40,JointPQPlayer
2786,JointPQPlayer,327,167,494,33,13,Player A
2787,JointPQPlayer,289,199,488,33,15,Player A
2788,JointPQPlayer,289,189,478,29,17,Player A
2789,JointPQPlayer,175,220,395,12,39,JointPQPlayer
2790,JointPQPlayer,295,190,485,33,16,Player A
2791,JointPQPlayer,288,183,471,31,20,Player A
2792,JointPQPlayer,312,172,484,29,15,Player A
2793,JointPQPlayer,323,168,491,30,13,Player A
2794,JointPQPlayer,304,179,483,28,15,Player A
2795,JointPQPlayer,315,185,500,33,11,Player A
2796,JointPQPlayer,301,176,477,28,17,Player A
2797,JointPQPlayer,259,234,493,47,18,Player A
2798,JointPQPlayer,315,160,475,23,16,Player A
2799,JointPQPlayer,266,201,467,30,21,Player A
2800,JointPQPlayer,328,168,496,38,14,Player A
2801,JointPQPlayer,159,274,433,20,29,JointPQPlayer
2802,JointPQPlayer,269,204,473,30,19,Player A
2803,JointPQPlayer,268,198,466,26,20,Player A
2804,JointPQPlayer,283,193,476,33,19,Player A
2805,JointPQPlayer,295,200,495,34,13,Player A
2806,JointPQPlayer,146,261,407,12,35,JointPQPlayer
2807,JointPQPlayer,306,181,487,29,14,Player A
2808,JointPQPlayer,302,187,489,34,15,Player A
2809,JointPQPlayer,287,212,499,29,10,Player A
2810,JointPQPlayer,135,285,420,13,31,JointPQPlayer
2811,JointPQPlayer,290,210,500,39,13,Player A
2812,JointPQPlayer,280,210,490,38,16,Player A
2813,JointPQPlayer,295,215,510,37,9,Player A
2814,JointPQPlayer,281,191,472,35,21,Player A
2815,JointPQPlayer,264,194,458,21,21,Player A
2816,JointPQPlayer,320,195,515,42,9,Player A
2817,JointPQPlayer,316,161,477,34,19,Player A
2818,JointPQPlayer,276,206,482,36,18,Player A
2819,JointPQPlayer,275,220,495,34,13,Player A
2820,JointPQPlayer,274,224,498,43,15,Player A
2821,JointPQPlayer,135,260,395,18,41,JointPQPlayer
2822,JointPQPlayer,149,279,428,15,29,JointPQPlayer
2823,JointPQPlayer,286,191,477,31,18,Player A
2824,JointPQPlayer,157,272,429,19,30,JointPQPlayer
2825,JointPQPlayer,149,239,388,11,41,JointPQPlayer
2826,JointPQPlayer,242,217,459,22,21,Player A
2827,JointPQPlayer,286,211,497,39,14,Player A
2828,JointPQPlayer,302,187,489,31,14,Player A
2829,JointPQPlayer,298,198,496,41,15,Player A
2830,JointPQPlayer,253,218,471,25,18,Player A
2831,JointPQPlayer,279,219,498,37,13,Player A
2832,JointPQPlayer,296,166,462,25,21,Player A
2833,JointPQPlayer,292,207,499,41,14,Player A
2834,JointPQPlayer,141,256,397,11,38,JointPQPlayer
2835,JointPQPlayer,268,218,486,43,19,Player A
2836,JointPQPlayer,300,190,490,41,17,Player A
2837,JointPQPlayer,313,173,486,31,15,Player A
2838,JointPQPlayer,270,215,485,36,17,Player A
2839,JointPQPlayer,302,182,484,32,16,Player A
2840,JointPQPlayer,299,194,493,38,15,Player A
2841,JointPQPlayer,292,192,484,29,15,Player A
2842,JointPQPlayer,307,192,499,29,10,Player A
2843,JointPQPlayer,273,203,476,33,19,Player A
2844,JointPQPlayer,327,172,499,35,12,Player A
2845,JointPQPlayer,304,199,503,42,13,Player A
2846,JointPQPlayer,266,211,477,28,17,Player A
2847,JointPQPlayer,156,276,432,22,30,JointPQPlayer
2848,JointPQPlayer,132,257,389,15,42,JointPQPlayer
2849,JointPQPlayer,300,175,475,32,19,Player A
2850,JointPQPlayer,159,254,413,9,32,JointPQPlayer
2851,JointPQPlayer,312,187,499,41,14,Player A
2852,JointPQPlayer,291,176,467,18,17,Player A
2853,JointPQPlayer,153,263,416,15,33,JointPQPlayer
2854,JointPQPlayer,299,179,478,26,16,Player A
2855,JointPQPlayer,286,206,492,31,13,Player A
2856,JointPQPlayer,298,198,496,32,12,Player A
2857,JointPQPlayer,302,172,474,37,21,Player A
2858,JointPQPlayer,298,198,496,38,14,Player A
2859,JointPQPlayer,293,188,481,35,18,Player A
2860,JointPQPlayer,269,229,498,34,12,Player A
2861,JointPQPlayer,177,237,414,22,36,JointPQPlayer
2862,JointPQPlayer,303,208,511,38,9,Player A
2863,JointPQPlayer,276,216,492,28,12,Player A
2864,JointPQPlayer,149,274,423,16,31,JointPQPlayer
2865,JointPQPlayer,299,194,493,35,14,Player A
2866,JointPQPlayer,287,202,489,43,18,Player A
2867,JointPQPlayer,177,252,429,22,31,JointPQPlayer
2868,JointPQPlayer,301,186,487,29,14,Player A
2869,JointPQPlayer,301,186,487,35,16,Player A
2870,JointPQPlayer,267,202,469,29,20,Player A
2871,JointPQPlayer,129,289,418,17,33,JointPQPlayer
2872,JointPQPlayer,295,200,495,31,12,Player A
2873,JointPQPlayer,259,214,473,33,20,Player A
2874,JointPQPlayer,293,183,476,33,19,Player A
2875,JointPQPlayer,150,250,400,14,38,JointPQPlayer
2876,JointPQPlayer,283,223,506,39,11,Player A
2877,JointPQPlayer,262,217,479,30,17,Player A
2878,JointPQPlayer,277,222,499,41,14,Player A
2879,JointPQPlayer,228,208,436,26,30,Player A
2880,JointPQPlayer,321,166,487,29,14,Player A
2881,JointPQPlayer,145,270,415,11,32,JointPQPlayer
2882,JointPQPlayer,132,272,404,12,36,JointPQPlayer
2883,JointPQPlayer,287,162,449,21,24,Player A
2884,JointPQPlayer,330,155,485,30,15,Player A
2885,JointPQPlayer,256,216,472,29,19,Player A
2886,JointPQPlayer,170,215,385,11,42,JointPQPlayer
2887,JointPQPlayer,275,200,475,38,21,Player A
2888,JointPQPlayer,265,200,465,25,20,Player A
2889,JointPQPlayer,286,191,477,37,20,Player A
2890,JointPQPlayer,311,176,487,35,16,Player A
2891,JointPQPlayer,155,245,400,11,37,JointPQPlayer
2892,JointPQPlayer,296,206,502,38,12,Player A
2893,JointPQPlayer,283,193,476,30,18,Player A
2894,JointPQPlayer,317,162,479,27,16,Player A
2895,JointPQPlayer,122,292,414,10,32,JointPQPlayer
2896,JointPQPlayer,146,251,397,11,38,JointPQPlayer
2897,JointPQPlayer,280,195,475,32,19,Player A
2898,JointPQPlayer,250,220,470,30,20,Player A
2899,JointPQPlayer,154,224,378,16,46,JointPQPlayer
2900,JointPQPlayer,271,226,497,42,15,Player A
2901,JointPQPlayer,273,193,466,26,20,Player A
2902,JointPQPlayer,167,242,409,14,35,JointPQPlayer
2903,JointPQPlayer,308,203,511,44,11,Player A
2904,JointPQPlayer,264,224,488,36,16,Player A
2905,JointPQPlayer,132,227,359,9,50,JointPQPlayer
2906,JointPQPlayer,140,275,415,14,33,JointPQPlayer
2907,JointPQPlayer,309,189,498,40,14,Player A
2908,JointPQPlayer,310,185,495,40,15,Player A
2909,JointPQPlayer,297,207,504,31,9,Player A
2910,JointPQPlayer,227,212,439,20,27,Player A
2911,JointPQPlayer,295,190,485,36,17,Player A
2912,JointPQPlayer,287,212,499,35,12,Player A
2913,JointPQPlayer,303,193,496,41,15,Player A
2914,JointPQPlayer,320,170,490,26,12,Player A
2915,JointPQPlayer,307,177,484,29,15,Player A
2916,JointPQPlayer,281,216,497,30,11,Player A
2917,JointPQPlayer,279,204,483,31,16,Player A
2918,JointPQPlayer,271,221,492,37,15,Player A
2919,JointPQPlayer,287,207,494,30,12,Player A
2920,JointPQPlayer,287,212,499,35,12,Player A
2921,JointPQPlayer,161,256,417,16,33,JointPQPlayer
2922,JointPQPlayer,192,242,434,30,32,JointPQPlayer
2923,JointPQPlayer,268,223,491,36,15,Player A
2924,JointPQPlayer,299,179,478,35,19,Player A
2925,JointPQPlayer,287,197,484,38,18,Player A
2926,JointPQPlayer,149,254,403,14,37,JointPQPlayer
2927,JointPQPlayer,305,195,500,30,10,Player A
2928,JointPQPlayer,279,229,508,35,9,Player A
2929,JointPQPlayer,226,216,442,14,24,Player A
2930,JointPQPlayer,312,202,514,38,8,Player A
2931,JointPQPlayer,302,172,474,28,18,Player A
2932,JointPQPlayer,291,176,467,33,22,Player A
2933,JointPQPlayer,288,208,496,38,14,Player A
2934,JointPQPlayer,270,225,495,40,15,Player A
2935,JointPQPlayer,144,279,423,10,29,JointPQPlayer
2936,JointPQPlayer,146,281,427,14,29,JointPQPlayer
2937,JointPQPlayer,236,221,457,29,24,Player A
2938,JointPQPlayer,303,203,506,33,9,Player A
2939,JointPQPlayer,322,162,484,32,16,Player A
2940,JointPQPlayer,252,232,484,32,16,Player A
2941,JointPQPlayer,185,255,440,18,26,JointPQPlayer
2942,JointPQPlayer,279,214,493,38,15,Player A
2943,JointPQPlayer,325,180,505,32,9,Player A
2944,JointPQPlayer,150,260,410,9,33,JointPQPlayer
2945,JointPQPlayer,297,187,484,32,16,Player A
2946,JointPQPlayer,144,249,393,13,40,JointPQPlayer
2947,JointPQPlayer,263,228,491,33,14,Player A
2948,JointPQPlayer,139,239,378,13,45,JointPQPlayer
2949,JointPQPlayer,281,201,482,33,17,Player A
2950,JointPQPlayer,273,228,501,40,13,Player A
2951,JointPQPlayer,290,205,495,34,13,Player A
2952,JointPQPlayer,286,196,482,33,17,Player A
2953,JointPQPlayer,276,196,472,29,19,Player A
2954,JointPQPlayer,295,190,485,33,16,Player A
2955,JointPQPlayer,294,214,508,38,10,Player A
2956,JointPQPlayer,290,180,470,27,19,Player A
2957,JointPQPlayer,256,216,472,35,21,Player A
2958,JointPQPlayer,286,211,497,36,13,Player A
2959,JointPQPlayer,321,151,472,29,19,Player A
2960,JointPQPlayer,313,183,496,32,12,Player A
2961,JointPQPlayer,281,191,472,35,21,Player A
2962,JointPQPlayer,284,224,508,41,11,Player A
2963,JointPQPlayer,259,204,463,26,21,Player A
2964,JointPQPlayer,280,195,475,35,20,Player A
2965,JointPQPlayer,274,209,483,31,16,Player A
2966,JointPQPlayer,317,192,509,39,10,Player A
2967,JointPQPlayer,283,183,466,26,20,Player A
2968,JointPQPlayer,297,177,474,31,19,Player A
2969,JointPQPlayer,296,206,502,38,12,Player A
2970,JointPQPlayer,325,195,520,41,7,Player A
2971,JointPQPlayer,301,181,482,36,18,Player A
2972,JointPQPlayer,275,190,465,28,21,Player A
2973,JointPQPlayer,266,231,497,39,14,Player A
2974,JointPQPlayer,288,183,471,31,20,Player A
2975,JointPQPlayer,135,275,410,15,35,JointPQPlayer
2976,JointPQPlayer,203,218,421,26,35,JointPQPlayer
2977,JointPQPlayer,294,179,473,33,20,Player A
2978,JointPQPlayer,283,193,476,36,20,Player A
2979,JointPQPlayer,283,203,486,37,17,Player A
2980,JointPQPlayer,316,166,482,30,16,Player A
2981,JointPQPlayer,314,189,503,36,11,Player A
2982,JointPQPlayer,261,196,457,29,24,Player A
2983,JointPQPlayer,286,216,502,38,12,Player A
2984,JointPQPlayer,269,204,473,27,18,Player A
2985,JointPQPlayer,287,192,479,33,18,Player A
2986,JointPQPlayer,315,175,490,35,15,Player A
2987,JointPQPlayer,300,190,490,41,17,Player A
2988,JointPQPlayer,287,182,469,29,20,Player A
2989,JointPQPlayer,147,272,419,12,31,JointPQPlayer
2990,JointPQPlayer,173,253,426,19,31,JointPQPlayer
2991,JointPQPlayer,290,210,500,45,15,Player A
2992,JointPQPlayer,250,205,455,30,25,Player A
2993,JointPQPlayer,135,275,410,6,32,JointPQPlayer
2994,JointPQPlayer,263,203,466,29,21,Player A
2995,JointPQPlayer,250,200,450,28,26,Player A
2996,JointPQPlayer,233,203,436,17,27,Player A
2997,JointPQPlayer,200,250,450,19,23,JointPQPlayer
2998,JointPQPlayer,309,184,493,35,14,Player A
2999,JointPQPlayer,307,197,504,40,12,Player A
3000,JointPQPlayer,289,194,483,37,18,Player A
3001,JointPQPlayer,296,211,507,40,11,Player A
3002,JointPQPlayer,258,203,461,30,23,Player A
3003,JointPQPlayer,302,192,494,39,15,Player A
3004,JointPQPlayer,316,186,502,35,11,Player A
3005,JointPQPlayer,171,251,422,15,31,JointPQPlayer
3006,JointPQPlayer,257,217,474,34,20,Player A
3007,JointPQPlayer,280,220,500,42,14,Player A
3008,JointPQPlayer,302,182,484,35,17,Player A
3009,JointPQPlayer,148,273,421,20,33,JointPQPlayer
3010,JointPQPlayer,266,211,477,43,22,Player A
3011,JointPQPlayer,260,200,460,26,22,Player A
3012,JointPQPlayer,179,249,428,21,31,JointPQPlayer
3013,JointPQPlayer,316,186,502,35,11,Player A
3014,JointPQPlayer,156,261,417,13,32,JointPQPlayer
3015,JointPQPlayer,155,270,425,15,30,JointPQPlayer
3016,JointPQPlayer,289,199,488,36,16,Player A
3017,JointPQPlayer,258,238,496,35,13,Player A
3018,JointPQPlayer,148,283,431,18,29,JointPQPlayer
3019,JointPQPlayer,273,198,471,31,20,Player A
3020,JointPQPlayer,278,203,481,38,19,Player A
3021,JointPQPlayer,308,158,466,32,22,Player A
3022,JointPQPlayer,299,194,493,35,14,Player A
3023,JointPQPlayer,310,185,495,31,12,Player A
3024,JointPQPlayer,278,203,481,32,17,Player A
3025,JointPQPlayer,309,174,483,34,17,Player A
3026,JointPQPlayer,293,183,476,33,19,Player A
3027,JointPQPlayer,252,222,474,25,17,Player A
3028,JointPQPlayer,284,184,468,25,19,Player A
3029,JointPQPlayer,278,208,486,37,17,Player A
3030,JointPQPlayer,301,186,487,35,16,Player A
3031,JointPQPlayer,297,177,474,34,20,Player A
3032,JointPQPlayer,323,183,506,39,11,Player A
3033,JointPQPlayer,291,186,477,34,19,Player A
3034,JointPQPlayer,306,191,497,30,11,Player A
3035,JointPQPlayer,300,200,500,45,15,Player A
3036,JointPQPlayer,306,196,502,38,12,Player A
3037,JointPQPlayer,295,175,470,33,21,Player A
3038,JointPQPlayer,307,217,524,48,8,Player A
3039,JointPQPlayer,129,269,398,15,39,JointPQPlayer
3040,JointPQPlayer,309,169,478,35,19,Player A
3041,JointPQPlayer,151,251,402,13,37,JointPQPlayer
3042,JointPQPlayer,283,193,476,33,19,Player A
3043,JointPQPlayer,308,198,506,36,10,Player A
3044,JointPQPlayer,164,259,423,19,32,JointPQPlayer
3045,JointPQPlayer,164,224,388,14,42,JointPQPlayer
3046,JointPQPlayer,255,195,450,28,26,Player A
3047,JointPQPlayer,251,206,457,35,26,Player A
3048,JointPQPlayer,272,187,459,28,23,Player A
3049,JointPQPlayer,324,179,503,39,12,Player A
3050,JointPQPlayer,163,243,406,14,36,JointPQPlayer
3051,JointPQPlayer,287,207,494,33,13,Player A
3052,JointPQPlayer,285,220,505,38,11,Player A
3053,JointPQPlayer,319,174,493,35,14,Player A
3054,JointPQPlayer,328,168,496,38,14,Player A
3055,JointPQPlayer,295,205,500,42,14,Player A
3056,JointPQPlayer,294,199,493,26,11,Player A
3057,JointPQPlayer,308,173,481,35,18,Player A
3058,JointPQPlayer,316,171,487,35,16,Player A
3059,JointPQPlayer,285,200,485,30,15,Player A
3060,JointPQPlayer,271,206,477,34,19,Player A
3061,JointPQPlayer,123,288,411,10,33,JointPQPlayer
3062,JointPQPlayer,293,188,481,29,16,Player A
3063,JointPQPlayer,305,195,500,42,14,Player A
3064,JointPQPlayer,230,235,465,31,22,JointPQPlayer
3065,JointPQPlayer,291,196,487,38,17,Player A
3066,JointPQPlayer,155,255,410,18,36,JointPQPlayer
3067,JointPQPlayer,274,204,478,38,20,Player A
3068,JointPQPlayer,228,233,461,24,21,JointPQPlayer
3069,JointPQPlayer,250,210,460,32,24,Player A
3070,JointPQPlayer,288,198,486,34,16,Player A
3071,JointPQPlayer,207,237,444,19,25,JointPQPlayer
3072,JointPQPlayer,259,204,463,26,21,Player A
3073,JointPQPlayer,260,215,475,35,20,Player A
3074,JointPQPlayer,273,218,491,36,15,Player A
3075,JointPQPlayer,319,184,503,42,13,Player A
3076,JointPQPlayer,314,179,493,32,13,Player A
3077,JointPQPlayer,160,250,410,15,35,JointPQPlayer
3078,JointPQPlayer,314,189,503,42,13,Player A
3079,JointPQPlayer,139,269,408,13,35,JointPQPlayer
3080,JointPQPlayer,260,230,490,32,14,Player A
3081,JointPQPlayer,278,218,496,29,11,Player A
3082,JointPQPlayer,293,198,491,39,16,Player A
3083,JointPQPlayer,298,208,506,36,10,Player A
3084,JointPQPlayer,293,203,496,38,14,Player A
3085,JointPQPlayer,129,264,393,10,39,JointPQPlayer
3086,JointPQPlayer,265,225,490,41,17,Player A
3087,JointPQPlayer,285,200,485,33,16,Player A
3088,JointPQPlayer,295,165,460,26,22,Player A
3089,JointPQPlayer,279,219,498,37,13,Player A
3090,JointPQPlayer,317,182,499,35,12,Player A
3091,JointPQPlayer,294,194,488,36,16,Player A
3092,JointPQPlayer,285,185,470,42,24,Player A
3093,JointPQPlayer,296,186,482,33,17,Player A
3094,JointPQPlayer,143,268,411,10,33,JointPQPlayer
3095,JointPQPlayer,138,273,411,13,34,JointPQPlayer
3096,JointPQPlayer,276,201,477,34,19,Player A
3097,JointPQPlayer,310,210,520,44,8,Player A
3098,JointPQPlayer,307,172,479,30,17,Player A
3099,JointPQPlayer,152,267,419,12,31,JointPQPlayer
3100,JointPQPlayer,303,173,476,30,18,Player A
3101,JointPQPlayer,314,179,493,38,15,Player A
3102,JointPQPlayer,302,192,494,33,13,Player A
3103,JointPQPlayer,224,214,438,19,27,Player A
3104,JointPQPlayer,147,237,384,19,45,JointPQPlayer
3105,JointPQPlayer,311,196,507,31,8,Player A
3106,JointPQPlayer,158,243,401,9,36,JointPQPlayer
3107,JointPQPlayer,291,201,492,34,14,Player A
3108,JointPQPlayer,159,259,418,14,32,JointPQPlayer
3109,JointPQPlayer,261,211,472,35,21,Player A
3110,JointPQPlayer,292,192,484,32,16,Player A
3111,JointPQPlayer,283,198,481,35,18,Player A
3112,JointPQPlayer,248,223,471,31,20,Player A
3113,JointPQPlayer,262,187,449,18,23,Player A
3114,JointPQPlayer,287,212,499,35,12,Player A
3115,JointPQPlayer,247,227,474,37,21,Player A
3116,JointPQPlayer,152,257,409,11,34,JointPQPlayer
3117,JointPQPlayer,213,248,461,30,23,JointPQPlayer
3118,JointPQPlayer,251,191,442,23,27,Player A
3119,JointPQPlayer,315,175,490,32,14,Player A
3120,JointPQPlayer,269,229,498,37,13,Player A
3121,JointPQPlayer,290,190,480,31,17,Player A
3122,JointPQPlayer,145,270,415,17,34,JointPQPlayer
3123,JointPQPlayer,327,172,499,29,10,Player A
3124,JointPQPlayer,298,193,491,33,14,Player A
3125,JointPQPlayer,264,234,498,37,13,Player A
3126,JointPQPlayer,149,259,408,16,36,JointPQPlayer
3127,JointPQPlayer,255,230,485,30,15,Player A
3128,JointPQPlayer,253,223,476,33,19,Player A
3129,JointPQPlayer,167,262,429,16,29,JointPQPlayer
3130,JointPQPlayer,163,263,426,16,30,JointPQPlayer
3131,JointPQPlayer,301,186,487,35,16,Player A
3132,JointPQPlayer,294,184,478,32,18,Player A
3133,JointPQPlayer,284,189,473,33,20,Player A
3134,JointPQPlayer,157,242,399,19,40,JointPQPlayer
3135,JointPQPlayer,297,182,479,33,18,Player A
3136,JointPQPlayer,264,224,488,36,16,Player A
3137,JointPQPlayer,300,195,495,34,13,Player A
3138,JointPQPlayer,279,209,488,36,16,Player A
3139,JointPQPlayer,299,189,488,30,14,Player A
3140,JointPQPlayer,270,220,490,32,14,Player A
3141,JointPQPlayer,148,273,421,14,31,JointPQPlayer
3142,JointPQPlayer,277,217,494,36,14,Player A
3143,JointPQPlayer,290,200,490,44,18,Player A
3144,JointPQPlayer,321,191,512,42,10,Player A
3145,JointPQPlayer,290,195,485,33,16,Player A
3146,JointPQPlayer,273,218,491,39,16,Player A
3147,JointPQPlayer,148,273,421,14,31,JointPQPlayer
3148,JointPQPlayer,286,191,477,37,20,Player A
3149,JointPQPlayer,283,198,481,32,17,Player A
3150,JointPQPlayer,305,215,520,44,8,Player A
3151,JointPQPlayer,157,237,394,17,41,JointPQPlayer
3152,JointPQPlayer,282,187,469,23,18,Player A
3153,JointPQPlayer,253,233,486,34,16,Player A
3154,JointPQPlayer,249,219,468,37,23,Player A
3155,JointPQPlayer,163,228,391,11,40,JointPQPlayer
3156,JointPQPlayer,338,158,496,29,11,Player A
3157,JointPQPlayer,320,180,500,33,11,Player A
3158,JointPQPlayer,277,217,494,36,14,Player A
3159,JointPQPlayer,294,174,468,25,19,Player A
3160,JointPQPlayer,274,184,458,21,21,Player A
3161,JointPQPlayer,273,208,481,35,18,Player A
3162,JointPQPlayer,235,225,460,23,21,Player A
3163,JointPQPlayer,304,194,498,37,13,Player A
3164,JointPQPlayer,287,197,484,29,15,Player A
3165,JointPQPlayer,287,182,469,32,21,Player A
3166,JointPQPlayer,179,244,423,19,32,JointPQPlayer
3167,JointPQPlayer,269,214,483,37,18,Player A
3168,JointPQPlayer,237,222,459,25,22,Player A
3169,JointPQPlayer,284,194,478,38,20,Player A
3170,JointPQPlayer,293,218,511,47,12,Player A
3171,JointPQPlayer,326,161,487,29,14,Player A
3172,JointPQPlayer,302,197,499,38,13,Player A
3173,JointPQPlayer,295,210,505,41,12,Player A
3174,JointPQPlayer,297,192,489,37,16,Player A
3175,JointPQPlayer,280,190,470,27,19,Player A
3176,JointPQPlayer,293,203,496,38,14,Player A
3177,JointPQPlayer,232,212,444,28,28,Player A
3178,JointPQPlayer,135,280,415,14,33,JointPQPlayer
3179,JointPQPlayer,299,174,473,33,20,Player A
3180,JointPQPlayer,283,173,456,28,24,Player A
3181,JointPQPlayer,273,193,466,32,22,Player A
3182,JointPQPlayer,227,222,449,18,23,Player A
3183,JointPQPlayer,311,166,477,31,18,Player A
3184,JointPQPlayer,319,159,478,29,17,Player A
3185,JointPQPlayer,286,201,487,35,16,Player A
3186,JointPQPlayer,150,260,410,18,36,JointPQPlayer
3187,JointPQPlayer,153,248,401,15,38,JointPQPlayer
3188,JointPQPlayer,155,245,400,11,37,JointPQPlayer
3189,JointPQPlayer,229,239,468,25,19,JointPQPlayer
3190,JointPQPlayer,302,192,494,42,16,Player A
3191,JointPQPlayer,158,248,406,20,38,JointPQPlayer
3192,JointPQPlayer,304,174,478,29,17,Player A
3193,JointPQPlayer,139,269,408,19,37,JointPQPlayer
3194,JointPQPlayer,273,213,486,37,17,Player A
3195,JointPQPlayer,328,173,501,28,9,Player A
3196,JointPQPlayer,289,189,478,29,17,Player A
3197,JointPQPlayer,322,162,484,29,15,Player A
3198,JointPQPlayer,253,238,491,36,15,Player A
3199,JointPQPlayer,318,173,491,33,14,Player A
3200,JointPQPlayer,307,192,499,35,12,Player A
3201,JointPQPlayer,132,292,424,14,30,JointPQPlayer
3202,JointPQPlayer,296,201,497,33,12,Player A
3203,JointPQPlayer,157,252,409,14,35,JointPQPlayer
3204,JointPQPlayer,311,171,482,30,16,Player A
3205,JointPQPlayer,274,219,493,41,16,Player A
3206,JointPQPlayer,164,249,413,18,35,JointPQPlayer
3207,JointPQPlayer,284,194,478,29,17,Player A
3208,JointPQPlayer,336,171,507,37,10,Player A
3209,JointPQPlayer,142,272,414,16,34,JointPQPlayer
3210,JointPQPlayer,304,164,468,28,20,Player A
3211,JointPQPlayer,161,256,417,16,33,JointPQPlayer
3212,JointPQPlayer,257,177,434,21,29,Player A
3213,JointPQPlayer,302,202,504,46,14,Player A
3214,JointPQPlayer,275,200,475,32,19,Player A
3215,JointPQPlayer,317,177,494,36,14,Player A
3216,JointPQPlayer,275,210,485,30,15,Player A
3217,JointPQPlayer,291,176,467,30,21,Player A
3218,JointPQPlayer,281,216,497,39,14,Player A
3219,JointPQPlayer,313,183,496,35,13,Player A
3220,JointPQPlayer,269,214,483,34,17,Player A
3221,JointPQPlayer,299,194,493,32,13,Player A
3222,JointPQPlayer,172,222,394,11,39,JointPQPlayer
3223,JointPQPlayer,167,227,394,11,39,JointPQPlayer
3224,JointPQPlayer,267,182,449,30,27,Player A
3225,JointPQPlayer,293,203,496,38,14,Player A
3226,JointPQPlayer,307,192,499,35,12,Player A
3227,JointPQPlayer,163,263,426,19,31,JointPQPlayer
3228,JointPQPlayer,301,186,487,38,17,Player A
3229,JointPQPlayer,304,184,488,30,14,Player A
3230,JointPQPlayer,282,212,494,36,14,Player A
3231,JointPQPlayer,322,167,489,34,15,Player A
3232,JointPQPlayer,177,282,459,16,19,JointPQPlayer
3233,JointPQPlayer,300,160,460,29,23,Player A
3234,JointPQPlayer,162,242,404,18,38,JointPQPlayer
3235,JointPQPlayer,316,166,482,33,17,Player A
3236,JointPQPlayer,315,175,490,35,15,Player A
3237,JointPQPlayer,272,212,484,26,14,Player A
3238,JointPQPlayer,324,169,493,32,13,Player A
3239,JointPQPlayer,222,242,464,24,20,JointPQPlayer
3240,JointPQPlayer,317,177,494,33,13,Player A
3241,JointPQPlayer,138,253,391,11,40,JointPQPlayer
3242,JointPQPlayer,306,191,497,39,14,Player A
3243,JointPQPlayer,312,202,514,41,9,Player A
3244,JointPQPlayer,240,205,445,23,26,Player A
3245,JointPQPlayer,263,213,476,27,17,Player A
3246,JointPQPlayer,289,194,483,34,17,Player A
3247,JointPQPlayer,153,253,406,17,37,JointPQPlayer
3248,JointPQPlayer,287,197,484,35,17,Player A
3249,JointPQPlayer,273,198,471,34,21,Player A
3250,JointPQPlayer,270,205,475,32,19,Player A
3251,JointPQPlayer,285,205,490,35,15,Player A
3252,JointPQPlayer,315,180,495,37,14,Player A
3253,JointPQPlayer,296,186,482,36,18,Player A
3254,JointPQPlayer,296,181,477,28,17,Player A
3255,JointPQPlayer,231,226,457,26,23,Player A
3256,JointPQPlayer,251,236,487,35,16,Player A
3257,JointPQPlayer,236,256,492,40,16,JointPQPlayer
3258,JointPQPlayer,207,247,454,23,23,JointPQPlayer
3259,JointPQPlayer,312,172,484,35,17,Player A
3260,JointPQPlayer,301,201,502,47,15,Player A
3261,JointPQPlayer,313,193,506,42,12,Player A
3262,JointPQPlayer,340,150,490,32,14,Player A
3263,JointPQPlayer,252,207,459,31,24,Player A
3264,JointPQPlayer,226,206,432,13,27,Player A
3265,JointPQPlayer,140,260,400,14,38,JointPQPlayer
3266,JointPQPlayer,291,211,502,41,13,Player A
3267,JointPQPlayer,132,267,399,10,37,JointPQPlayer
3268,JointPQPlayer,294,174,468,25,19,Player A
3269,JointPQPlayer,275,220,495,34,13,Player A
3270,JointPQPlayer,307,177,484,29,15,Player A
3271,JointPQPlayer,315,185,500,39,13,Player A
3272,JointPQPlayer,309,189,498,34,12,Player A
3273,JointPQPlayer,257,232,489,34,15,Player A
3274,JointPQPlayer,315,175,490,35,15,Player A
3275,JointPQPlayer,273,213,486,37,17,Player A
3276,JointPQPlayer,236,206,442,20,26,Player A
3277,JointPQPlayer,294,189,483,37,18,Player A
3278,JointPQPlayer,210,220,430,20,30,JointPQPlayer
3279,JointPQPlayer,319,184,503,33,10,Player A
3280,JointPQPlayer,291,206,497,42,15,Player A
3281,JointPQPlayer,178,233,411,16,35,JointPQPlayer
3282,JointPQPlayer,335,175,510,40,10,Player A
3283,JointPQPlayer,295,190,485,30,15,Player A
3284,JointPQPlayer,293,198,491,33,14,Player A
3285,JointPQPlayer,305,195,500,36,12,Player A
3286,JointPQPlayer,308,188,496,38,14,Player A
3287,JointPQPlayer,295,190,485,36,17,Player A
3288,JointPQPlayer,154,259,413,12,33,JointPQPlayer
3289,JointPQPlayer,296,176,472,23,17,Player A
3290,JointPQPlayer,267,227,494,33,13,Player A
3291,JointPQPlayer,274,204,478,32,18,Player A
3292,JointPQPlayer,255,190,445,32,29,Player A
3293,JointPQPlayer,130,265,395,15,40,JointPQPlayer
3294,JointPQPlayer,294,194,488,36,16,Player A
3295,JointPQPlayer,257,217,474,28,18,Player A
3296,JointPQPlayer,312,172,484,35,17,Player A
3297,JointPQPlayer,301,191,492,34,14,Player A
3298,JointPQPlayer,287,182,469,35,22,Player A
3299,JointPQPlayer,285,205,490,38,16,Player A
3300,JointPQPlayer,142,272,414,16,34,JointPQPlayer
3301,JointPQPlayer,304,204,508,35,9,Player A
3302,JointPQPlayer,294,204,498,40,14,Player A
3303,JointPQPlayer,265,210,475,32,19,Player A
3304,JointPQPlayer,200,250,450,28,26,JointPQPlayer
3305,JointPQPlayer,206,221,427,17,30,JointPQPlayer
3306,JointPQPlayer,303,193,496,35,13,Player A
3307,JointPQPlayer,285,185,470,30,20,Player A
3308,JointPQPlayer,145,255,400,11,37,JointPQPlayer
3309,JointPQPlayer,293,198,491,39,16,Player A
3310,JointPQPlayer,245,225,470,30,20,Player A
3311,JointPQPlayer,333,173,506,39,11,Player A
3312,JointPQPlayer,190,255,445,20,25,JointPQPlayer
3313,JointPQPlayer,307,187,494,36,14,Player A
3314,JointPQPlayer,328,168,496,38,14,Player A
3315,JointPQPlayer,295,185,480,34,18,Player A
3316,JointPQPlayer,284,204,488,39,17,Player A
3317,JointPQPlayer,277,222,499,44,15,Player A
3318,JointPQPlayer,309,204,513,40,9,Player A
3319,JointPQPlayer,306,166,472,29,19,Player A
3320,JointPQPlayer,315,165,480,31,17,Player A
3321,JointPQPlayer,299,174,473,33,20,Player A
3322,JointPQPlayer,141,266,407,18,37,JointPQPlayer
3323,JointPQPlayer,274,214,488,36,16,Player A
3324,JointPQPlayer,282,212,494,36,14,Player A
3325,JointPQPlayer,284,209,493,35,14,Player A
3326,JointPQPlayer,186,256,442,20,26,JointPQPlayer
3327,JointPQPlayer,307,187,494,27,11,Player A
3328,JointPQPlayer,297,192,489,40,17,Player A
3329,JointPQPlayer,265,210,475,26,17,Player A
3330,JointPQPlayer,327,157,484,32,16,Player A
3331,JointPQPlayer,274,194,468,28,20,Player A
3332,JointPQPlayer,268,198,466,35,23,Player A
3333,JointPQPlayer,298,188,486,34,16,Player A
3334,JointPQPlayer,269,209,478,32,18,Player A
3335,JointPQPlayer,287,197,484,38,18,Player A
3336,JointPQPlayer,296,196,492,43,17,Player A
3337,JointPQPlayer,267,167,434,24,30,Player A
3338,JointPQPlayer,311,201,512,42,10,Player A
3339,JointPQPlayer,278,198,476,30,18,Player A
3340,JointPQPlayer,224,234,458,21,21,JointPQPlayer
3341,JointPQPlayer,298,183,481,35,18,Player A
3342,JointPQPlayer,260,225,485,27,14,Player A
3343,JointPQPlayer,148,238,386,9,41,JointPQPlayer
3344,JointPQPlayer,298,198,496,41,15,Player A
3345,JointPQPlayer,293,198,491,30,13,Player A
3346,JointPQPlayer,255,220,475,29,18,Player A
3347,JointPQPlayer,287,207,494,39,15,Player A
3348,JointPQPlayer,278,203,481,38,19,Player A
3349,JointPQPlayer,271,206,477,28,17,Player A
3350,JointPQPlayer,284,209,493,38,15,Player A
3351,JointPQPlayer,305,180,485,36,17,Player A
3352,JointPQPlayer,156,271,427,20,31,JointPQPlayer
3353,JointPQPlayer,291,191,482,36,18,Player A
3354,JointPQPlayer,236,221,457,26,23,Player A
3355,JointPQPlayer,264,214,478,35,19,Player A
3356,JointPQPlayer,285,205,490,32,14,Player A
3357,JointPQPlayer,281,191,472,38,22,Player A
3358,JointPQPlayer,313,183,496,35,13,Player A
3359,JointPQPlayer,283,193,476,33,19,Player A
3360,JointPQPlayer,285,200,485,30,15,Player A
3361,JointPQPlayer,315,185,500,33,11,Player A
3362,JointPQPlayer,266,206,472,29,19,Player A
3363,JointPQPlayer,135,265,400,11,37,JointPQPlayer
3364,JointPQPlayer,200,240,440,21,27,JointPQPlayer
3365,JointPQPlayer,322,172,494,33,13,Player A
3366,JointPQPlayer,284,174,458,27,23,Player A
3367,JointPQPlayer,150,250,400,11,37,JointPQPlayer
3368,JointPQPlayer,310,180,490,35,15,Player A
3369,JointPQPlayer,316,166,482,30,16,Player A
3370,JointPQPlayer,300,190,490,32,14,Player A
3371,JointPQPlayer,214,224,438,25,29,JointPQPlayer
3372,JointPQPlayer,279,189,468,28,20,Player A
3373,JointPQPlayer,306,196,502,41,13,Player A
3374,JointPQPlayer,257,217,474,34,20,Player A
3375,JointPQPlayer,309,179,488,33,15,Player A
3376,JointPQPlayer,312,182,494,33,13,Player A
3377,JointPQPlayer,292,192,484,35,17,Player A
3378,JointPQPlayer,294,204,498,37,13,Player A
3379,JointPQPlayer,251,216,467,24,19,Player A
3380,JointPQPlayer,264,209,473,36,21,Player A
3381,JointPQPlayer,269,209,478,38,20,Player A
3382,JointPQPlayer,153,268,421,20,33,JointPQPlayer
3383,JointPQPlayer,303,193,496,35,13,Player A
3384,JointPQPlayer,142,252,394,14,40,JointPQPlayer
3385,JointPQPlayer,191,246,437,24,29,JointPQPlayer
3386,JointPQPlayer,289,199,488,39,17,Player A
3387,JointPQPlayer,129,269,398,15,39,JointPQPlayer
3388,JointPQPlayer,332,167,499,35,12,Player A
3389,JointPQPlayer,303,168,471,31,20,Player A
3390,JointPQPlayer,304,209,513,37,8,Player A
3391,JointPQPlayer,286,206,492,37,15,Player A
3392,JointPQPlayer,283,213,496,44,16,Player A
3393,JointPQPlayer,307,182,489,37,16,Player A
3394,JointPQPlayer,229,259,488,33,15,JointPQPlayer
3395,JointPQPlayer,257,212,469,29,20,Player A
3396,JointPQPlayer,256,226,482,30,16,Player A
3397,JointPQPlayer,225,235,460,23,21,JointPQPlayer
3398,JointPQPlayer,306,171,477,31,18,Player A
3399,JointPQPlayer,161,246,407,12,35,JointPQPlayer
3400,JointPQPlayer,303,198,501,46,15,Player A
3401,JointPQPlayer,302,202,504,40,12,Player A
3402,JointPQPlayer,137,297,434,15,27,JointPQPlayer
3403,JointPQPlayer,294,194,488,33,15,Player A
3404,JointPQPlayer,288,203,491,42,17,Player A
3405,JointPQPlayer,137,247,384,10,42,JointPQPlayer
3406,JointPQPlayer,245,195,440,21,27,Player A
3407,JointPQPlayer,274,189,463,32,23,Player A
3408,JointPQPlayer,303,203,506,42,12,Player A
3409,JointPQPlayer,145,270,415,17,34,JointPQPlayer
3410,JointPQPlayer,306,186,492,31,13,Player A
3411,JointPQPlayer,245,210,455,27,24,Player A
3412,JointPQPlayer,300,190,490,38,16,Player A
3413,JointPQPlayer,256,221,477,37,20,Player A
3414,JointPQPlayer,304,204,508,38,10,Player A
3415,JointPQPlayer,166,256,422,27,35,JointPQPlayer
3416,JointPQPlayer,270,190,460,29,23,Player A
3417,JointPQPlayer,276,201,477,34,19,Player A
3418,JointPQPlayer,281,196,477,34,19,Player A
3419,JointPQPlayer,162,247,409,5,32,JointPQPlayer
3420,JointPQPlayer,270,205,475,26,17,Player A
3421,JointPQPlayer,318,183,501,40,13,Player A
3422,JointPQPlayer,274,219,493,35,14,Player A
3423,JointPQPlayer,280,185,465,28,21,Player A
3424,JointPQPlayer,247,217,464,24,20,Player A
3425,JointPQPlayer,130,265,395,18,41,JointPQPlayer
3426,JointPQPlayer,227,242,469,23,18,JointPQPlayer
3427,JointPQPlayer,281,196,477,31,18,Player A
3428,JointPQPlayer,298,193,491,36,15,Player A
3429,JointPQPlayer,137,277,414,13,33,JointPQPlayer
3430,JointPQPlayer,300,180,480,28,16,Player A
3431,JointPQPlayer,157,252,409,14,35,JointPQPlayer
3432,JointPQPlayer,158,273,431,15,28,JointPQPlayer
3433,JointPQPlayer,160,265,425,15,30,JointPQPlayer
3434,JointPQPlayer,152,237,389,12,41,JointPQPlayer
3435,JointPQPlayer,156,236,392,15,41,JointPQPlayer
3436,JointPQPlayer,290,165,455,30,25,Player A
3437,JointPQPlayer,294,194,488,36,16,Player A
3438,JointPQPlayer,309,184,493,35,14,Player A
3439,JointPQPlayer,290,195,485,33,16,Player A
3440,JointPQPlayer,279,204,483,31,16,Player A
3441,JointPQPlayer,163,223,386,12,42,JointPQPlayer
3442,JointPQPlayer,263,203,466,35,23,Player A
3443,JointPQPlayer,258,218,476,33,19,Player A
3444,JointPQPlayer,320,165,485,30,15,Player A
3445,JointPQPlayer,243,233,476,33,19,Player A
3446,JointPQPlayer,265,195,460,29,23,Player A
3447,JointPQPlayer,295,195,490,35,15,Player A
3448,JointPQPlayer,134,279,413,15,34,JointPQPlayer
3449,JointPQPlayer,142,262,404,18,38,JointPQPlayer
3450,JointPQPlayer,264,189,453,31,26,Player A
3451,JointPQPlayer,225,215,440,27,29,Player A
3452,JointPQPlayer,235,215,450,28,26,Player A
3453,JointPQPlayer,250,220,470,30,20,Player A
3454,JointPQPlayer,304,204,508,38,10,Player A
3455,JointPQPlayer,302,187,489,37,16,Player A
3456,JointPQPlayer,299,204,503,33,10,Player A
3457,JointPQPlayer,284,219,503,33,10,Player A
3458,JointPQPlayer,302,167,469,32,21,Player A
3459,JointPQPlayer,139,269,408,13,35,JointPQPlayer
3460,JointPQPlayer,305,180,485,36,17,Player A
3461,JointPQPlayer,293,208,501,46,15,Player A
3462,JointPQPlayer,298,203,501,34,11,Player A
3463,JointPQPlayer,154,259,413,15,34,JointPQPlayer
3464,JointPQPlayer,255,215,470,33,21,Player A
3465,JointPQPlayer,322,172,494,30,12,Player A
3466,JointPQPlayer,303,193,496,41,15,Player A
3467,JointPQPlayer,327,182,509,39,10,Player A
3468,JointPQPlayer,296,181,477,31,18,Player A
3469,JointPQPlayer,291,181,472,32,20,Player A
3470,JointPQPlayer,311,166,477,28,17,Player A
3471,JointPQPlayer,300,190,490,32,14,Player A
3472,JointPQPlayer,296,196,492,31,13,Player A
3473,JointPQPlayer,266,206,472,32,20,Player A
3474,JointPQPlayer,125,245,370,11,47,JointPQPlayer
3475,JointPQPlayer,289,179,468,31,21,Player A
3476,JointPQPlayer,252,242,494,39,15,Player A
3477,JointPQPlayer,282,237,519,49,10,Player A
3478,JointPQPlayer,145,240,385,11,42,JointPQPlayer
3479,JointPQPlayer,266,216,482,33,17,Player A
3480,JointPQPlayer,296,191,487,35,16,Player A
3481,JointPQPlayer,171,226,397,11,38,JointPQPlayer
3482,JointPQPlayer,287,187,474,25,17,Player A
3483,JointPQPlayer,287,207,494,33,13,Player A
3484,JointPQPlayer,304,184,488,33,15,Player A
3485,JointPQPlayer,301,186,487,35,16,Player A
3486,JointPQPlayer,305,215,520,41,7,Player A
3487,JointPQPlayer,289,199,488,33,15,Player A
3488,JointPQPlayer,321,156,477,25,16,Player A
3489,JointPQPlayer,151,246,397,14,39,JointPQPlayer
3490,JointPQPlayer,257,227,484,35,17,Player A
3491,JointPQPlayer,278,208,486,34,16,Player A
3492,JointPQPlayer,279,194,473,36,21,Player A
3493,JointPQPlayer,289,214,503,36,11,Player A
3494,JointPQPlayer,298,188,486,37,17,Player A
3495,JointPQPlayer,305,200,505,41,12,Player A
3496,JointPQPlayer,277,202,479,30,17,Player A
3497,JointPQPlayer,287,172,459,25,22,Player A
3498,JointPQPlayer,253,213,466,29,21,Player A
3499,JointPQPlayer,115,290,405,10,35,JointPQPlayer
3500,JointPQPlayer,271,211,482,36,18,Player A
3501,JointPQPlayer,203,243,446,24,26,JointPQPlayer
3502,JointPQPlayer,285,195,480,37,19,Player A
3503,JointPQPlayer,305,180,485,33,16,Player A
3504,JointPQPlayer,176,251,427,23,32,JointPQPlayer
3505,JointPQPlayer,295,190,485,36,17,Player A
3506,JointPQPlayer,318,168,486,34,16,Player A
3507,JointPQPlayer,281,191,472,29,19,Player A
3508,JointPQPlayer,185,260,445,17,24,JointPQPlayer
3509,JointPQPlayer,295,190,485,33,16,Player A
3510,JointPQPlayer,288,218,506,36,10,Player A
3511,JointPQPlayer,165,255,420,19,33,JointPQPlayer
3512,JointPQPlayer,311,186,497,36,13,Player A
3513,JointPQPlayer,145,270,415,11,32,JointPQPlayer
3514,JointPQPlayer,295,190,485,33,16,Player A
3515,JointPQPlayer,169,234,403,14,37,JointPQPlayer
3516,JointPQPlayer,309,179,488,36,16,Player A
3517,JointPQPlayer,270,220,490,41,17,Player A
3518,JointPQPlayer,295,190,485,36,17,Player A
3519,JointPQPlayer,309,164,473,27,18,Player A
3520,JointPQPlayer,251,216,467,33,22,Player A
3521,JointPQPlayer,190,255,445,20,25,JointPQPlayer
3522,JointPQPlayer,214,249,463,23,20,JointPQPlayer
3523,JointPQPlayer,311,171,482,27,15,Player A
3524,JointPQPlayer,242,237,479,36,19,Player A
3525,JointPQPlayer,148,283,431,18,29,JointPQPlayer
3526,JointPQPlayer,149,264,413,21,36,JointPQPlayer
3527,JointPQPlayer,277,212,489,37,16,Player A
3528,JointPQPlayer,290,195,485,30,15,Player A
3529,JointPQPlayer,293,198,491,33,14,Player A
3530,JointPQPlayer,272,212,484,38,18,Player A
3531,JointPQPlayer,160,290,450,31,27,JointPQPlayer
3532,JointPQPlayer,130,270,400,14,38,JointPQPlayer
3533,JointPQPlayer,309,179,488,36,16,Player A
3534,JointPQPlayer,276,226,502,35,11,Player A
3535,JointPQPlayer,128,248,376,8,44,JointPQPlayer
3536,JointPQPlayer,313,173,486,31,15,Player A
3537,JointPQPlayer,268,213,481,32,17,Player A
3538,JointPQPlayer,249,209,458,27,23,Player A
3539,JointPQPlayer,155,240,395,15,40,JointPQPlayer
3540,JointPQPlayer,292,187,479,27,16,Player A
3541,JointPQPlayer,300,200,500,33,11,Player A
3542,JointPQPlayer,309,194,503,39,12,Player A
3543,JointPQPlayer,305,190,495,34,13,Player A
3544,JointPQPlayer,283,223,506,39,11,Player A
3545,JointPQPlayer,300,195,495,40,15,Player A
3546,JointPQPlayer,315,180,495,34,13,Player A
3547,JointPQPlayer,252,232,484,38,18,Player A
3548,JointPQPlayer,266,206,472,26,18,Player A
3549,JointPQPlayer,313,173,486,28,14,Player A
3550,JointPQPlayer,285,190,475,29,18,Player A
3551,JointPQPlayer,277,167,444,28,28,Player A
3552,JointPQPlayer,239,224,463,32,23,Player A
3553,JointPQPlayer,263,198,461,27,22,Player A
3554,JointPQPlayer,263,213,476,27,17,Player A
3555,JointPQPlayer,217,237,454,26,24,JointPQPlayer
3556,JointPQPlayer,329,174,503,36,11,Player A
3557,JointPQPlayer,219,224,443,27,28,JointPQPlayer
3558,JointPQPlayer,314,174,488,36,16,Player A
3559,JointPQPlayer,292,182,474,28,18,Player A
3560,JointPQPlayer,284,214,498,31,11,Player A
3561,JointPQPlayer,286,206,492,37,15,Player A
3562,JointPQPlayer,119,279,398,12,38,JointPQPlayer
3563,JointPQPlayer,265,210,475,32,19,Player A
3564,JointPQPlayer,321,186,507,37,10,Player A
3565,JointPQPlayer,268,203,471,34,21,Player A
3566,JointPQPlayer,281,211,492,34,14,Player A
3567,JointPQPlayer,247,207,454,23,23,Player A
3568,JointPQPlayer,306,181,487,32,15,Player A
3569,JointPQPlayer,270,225,495,37,14,Player A
3570,JointPQPlayer,164,249,413,18,35,JointPQPlayer
3571,JointPQPlayer,272,207,479,36,19,Player A
3572,JointPQPlayer,279,184,463,32,23,Player A
3573,JointPQPlayer,271,201,472,35,21,Player A
3574,JointPQPlayer,281,186,467,30,21,Player A
3575,JointPQPlayer,291,211,502,35,11,Player A
3576,JointPQPlayer,321,171,492,31,13,Player A
3577,JointPQPlayer,300,190,490,35,15,Player A
3578,JointPQPlayer,194,239,433,20,29,JointPQPlayer
3579,JointPQPlayer,140,275,415,11,32,JointPQPlayer
3580,JointPQPlayer,304,189,493,35,14,Player A
3581,JointPQPlayer,297,177,474,31,19,Player A
3582,JointPQPlayer,284,189,473,24,17,Player A
3583,JointPQPlayer,265,235,500,33,11,Player A
3584,JointPQPlayer,152,252,404,9,35,JointPQPlayer
3585,JointPQPlayer,296,211,507,46,13,Player A
3586,JointPQPlayer,308,188,496,35,13,Player A
3587,JointPQPlayer,303,193,496,32,12,Player A
3588,JointPQPlayer,284,209,493,38,15,Player A
3589,JointPQPlayer,168,223,391,14,41,JointPQPlayer
3590,JointPQPlayer,283,223,506,42,12,Player A
3591,JointPQPlayer,288,188,476,36,20,Player A
3592,JointPQPlayer,234,249,483,31,16,JointPQPlayer
3593,JointPQPlayer,252,237,489,37,16,Player A
3594,JointPQPlayer,315,165,480,28,16,Player A
3595,JointPQPlayer,344,159,503,30,9,Player A
3596,JointPQPlayer,294,189,483,37,18,Player A
3597,JointPQPlayer,286,186,472,26,18,Player A
3598,JointPQPlayer,287,192,479,27,16,Player A
3599,JointPQPlayer,285,200,485,36,17,Player A
3600,JointPQPlayer,307,177,484,38,18,Player A
3601,JointPQPlayer,222,207,429,19,30,Player A
3602,JointPQPlayer,311,176,487,38,17,Player A
3603,JointPQPlayer,267,202,469,35,22,Player A
3604,JointPQPlayer,199,259,458,24,22,JointPQPlayer
3605,JointPQPlayer,245,215,460,29,23,Player A
3606,JointPQPlayer,281,191,472,32,20,Player A
3607,JointPQPlayer,261,206,467,30,21,Player A
3608,JointPQPlayer,146,281,427,20,31,JointPQPlayer
3609,JointPQPlayer,148,278,426,13,29,JointPQPlayer
3610,JointPQPlayer,269,219,488,36,16,Player A
3611,JointPQPlayer,275,210,485,30,15,Player A
3612,JointPQPlayer,289,189,478,29,17,Player A
3613,JointPQPlayer,292,192,484,35,17,Player A
3614,JointPQPlayer,196,236,432,19,29,JointPQPlayer
3615,JointPQPlayer,150,230,380,9,43,JointPQPlayer
3616,JointPQPlayer,242,232,474,31,19,Player A
3617,JointPQPlayer,164,259,423,22,33,JointPQPlayer
3618,JointPQPlayer,279,189,468,31,21,Player A
3619,JointPQPlayer,313,198,511,44,11,Player A
3620,JointPQPlayer,267,222,489,37,16,Player A
3621,JointPQPlayer,168,248,416,21,35,JointPQPlayer
3622,JointPQPlayer,275,175,450,28,26,Player A
3623,JointPQPlayer,292,202,494,36,14,Player A
3624,JointPQPlayer,314,194,508,38,10,Player A
3625,JointPQPlayer,245,220,465,37,24,Player A
3626,JointPQPlayer,309,189,498,43,15,Player A
3627,JointPQPlayer,292,187,479,33,18,Player A
3628,JointPQPlayer,235,235,470,27,19,Tie
3629,JointPQPlayer,139,269,408,10,34,JointPQPlayer
3630,JointPQPlayer,188,253,441,25,28,JointPQPlayer
3631,JointPQPlayer,118,273,391,8,39,JointPQPlayer
3632,JointPQPlayer,279,194,473,36,21,Player A
3633,JointPQPlayer,301,191,492,31,13,Player A
3634,JointPQPlayer,301,201,502,32,10,Player A
3635,JointPQPlayer,170,240,410,12,34,JointPQPlayer
3636,JointPQPlayer,283,213,496,38,14,Player A
3637,JointPQPlayer,292,202,494,36,14,Player A
3638,JointPQPlayer,296,196,492,34,14,Player A
3639,JointPQPlayer,330,160,490,32,14,Player A
3640,JointPQPlayer,326,161,487,32,15,Player A
3641,JointPQPlayer,277,187,464,24,20,Player A
3642,JointPQPlayer,289,179,468,28,20,Player A
3643,JointPQPlayer,177,262,439,20,27,JointPQPlayer
3644,JointPQPlayer,278,218,496,29,11,Player A
3645,JointPQPlayer,273,208,481,35,18,Player A
3646,JointPQPlayer,299,194,493,32,13,Player A
3647,JointPQPlayer,311,206,517,41,8,Player A
3648,JointPQPlayer,325,180,505,38,11,Player A
3649,JointPQPlayer,311,181,492,40,16,Player A
3650,JointPQPlayer,284,199,483,37,18,Player A
3651,JointPQPlayer,270,225,495,40,15,Player A
3652,JointPQPlayer,287,217,504,43,13,Player A
3653,JointPQPlayer,346,141,487,29,14,Player A
3654,JointPQPlayer,151,266,417,16,33,JointPQPlayer
3655,JointPQPlayer,275,215,490,38,16,Player A
3656,JointPQPlayer,254,204,458,36,26,Player A
3657,JointPQPlayer,315,180,495,34,13,Player A
3658,JointPQPlayer,157,257,414,16,34,JointPQPlayer
3659,JointPQPlayer,262,202,464,24,20,Player A
3660,JointPQPlayer,237,242,479,30,17,JointPQPlayer
3661,JointPQPlayer,284,179,463,26,21,Player A
3662,JointPQPlayer,291,196,487,38,17,Player A
3663,JointPQPlayer,299,194,493,47,18,Player A
3664,JointPQPlayer,140,265,405,22,39,JointPQPlayer
3665,JointPQPlayer,327,192,519,43,8,Player A
3666,JointPQPlayer,113,278,391,11,40,JointPQPlayer
3667,JointPQPlayer,292,192,484,32,16,Player A
3668,JointPQPlayer,317,172,489,34,15,Player A
3669,JointPQPlayer,149,254,403,17,38,JointPQPlayer
3670,JointPQPlayer,237,212,449,27,26,Player A
3671,JointPQPlayer,300,170,470,30,20,Player A
3672,JointPQPlayer,287,187,474,37,21,Player A
3673,JointPQPlayer,283,213,496,35,13,Player A
3674,JointPQPlayer,273,208,481,32,17,Player A
3675,JointPQPlayer,213,253,466,35,23,JointPQPlayer
3676,JointPQPlayer,165,255,420,16,32,JointPQPlayer
3677,JointPQPlayer,338,188,526,44,6,Player A
3678,JointPQPlayer,290,195,485,39,18,Player A
3679,JointPQPlayer,284,199,483,37,18,Player A
3680,JointPQPlayer,288,203,491,33,14,Player A
3681,JointPQPlayer,131,276,407,15,36,JointPQPlayer
3682,JointPQPlayer,276,191,467,27,20,Player A
3683,JointPQPlayer,305,165,470,21,17,Player A
3684,JointPQPlayer,299,189,488,27,13,Player A
3685,JointPQPlayer,288,208,496,35,13,Player A
3686,JointPQPlayer,279,209,488,36,16,Player A
3687,JointPQPlayer,290,190,480,31,17,Player A
3688,JointPQPlayer,282,187,469,29,20,Player A
3689,JointPQPlayer,255,235,490,32,14,Player A
3690,JointPQPlayer,275,190,465,31,22,Player A
3691,JointPQPlayer,126,291,417,10,31,JointPQPlayer
3692,JointPQPlayer,302,172,474,31,19,Player A
3693,JointPQPlayer,298,208,506,39,11,Player A
3694,JointPQPlayer,281,181,462,37,25,Player A
3695,JointPQPlayer,293,208,501,43,14,Player A
3696,JointPQPlayer,307,182,489,37,16,Player A
3697,JointPQPlayer,260,205,465,31,22,Player A
3698,JointPQPlayer,265,225,490,35,15,Player A
3699,JointPQPlayer,153,263,416,15,33,JointPQPlayer
3700,JointPQPlayer,303,168,471,34,21,Player A
3701,JointPQPlayer,251,231,482,33,17,Player A
3702,JointPQPlayer,306,161,467,24,19,Player A
3703,JointPQPlayer,154,264,418,20,34,JointPQPlayer
3704,JointPQPlayer,298,208,506,36,10,Player A
3705,JointPQPlayer,297,187,484,32,16,Player A
3706,JointPQPlayer,333,178,511,47,12,Player A
3707,JointPQPlayer,146,261,407,12,35,JointPQPlayer
3708,JointPQPlayer,295,170,465,28,21,Player A
3709,JointPQPlayer,269,189,458,27,23,Player A
3710,JointPQPlayer,246,221,467,27,20,Player A
3711,JointPQPlayer,280,220,500,39,13,Player A
3712,JointPQPlayer,301,206,507,40,11,Player A
3713,JointPQPlayer,310,190,500,33,11,Player A
3714,JointPQPlayer,299,189,488,36,16,Player A
3715,JointPQPlayer,278,178,456,25,23,Player A
3716,JointPQPlayer,324,164,488,30,14,Player A
3717,JointPQPlayer,133,283,416,15,33,JointPQPlayer
3718,JointPQPlayer,131,276,407,12,35,JointPQPlayer
3719,JointPQPlayer,282,207,489,40,17,Player A
3720,JointPQPlayer,295,190,485,33,16,Player A
3721,JointPQPlayer,165,240,405,16,37,JointPQPlayer
3722,JointPQPlayer,184,219,403,20,39,JointPQPlayer
3723,JointPQPlayer,251,211,462,25,21,Player A
3724,JointPQPlayer,161,246,407,12,35,JointPQPlayer
3725,JointPQPlayer,278,218,496,38,14,Player A
3726,JointPQPlayer,273,203,476,36,20,Player A
3727,JointPQPlayer,305,180,485,33,16,Player A
3728,JointPQPlayer,272,222,494,36,14,Player A
3729,JointPQPlayer,344,144,488,24,12,Player A
3730,JointPQPlayer,261,236,497,36,13,Player A
3731,JointPQPlayer,268,213,481,35,18,Player A
3732,JointPQPlayer,292,187,479,36,19,Player A
3733,JointPQPlayer,288,188,476,21,15,Player A
3734,JointPQPlayer,313,188,501,37,12,Player A
3735,JointPQPlayer,127,257,384,7,41,JointPQPlayer
3736,JointPQPlayer,287,187,474,37,21,Player A
3737,JointPQPlayer,284,174,458,24,22,Player A
3738,JointPQPlayer,187,217,404,15,37,JointPQPlayer
3739,JointPQPlayer,285,210,495,28,11,Player A
3740,JointPQPlayer,275,225,500,36,12,Player A
3741,JointPQPlayer,304,174,478,35,19,Player A
3742,JointPQPlayer,289,189,478,32,18,Player A
3743,JointPQPlayer,282,217,499,32,11,Player A
3744,JointPQPlayer,328,168,496,32,12,Player A
3745,JointPQPlayer,157,242,399,10,37,JointPQPlayer
3746,JointPQPlayer,272,217,489,37,16,Player A
3747,JointPQPlayer,241,221,462,28,22,Player A
3748,JointPQPlayer,319,184,503,39,12,Player A
3749,JointPQPlayer,230,215,445,26,27,Player A
3750,JointPQPlayer,305,180,485,36,17,Player A
3751,JointPQPlayer,305,195,500,33,11,Player A
3752,JointPQPlayer,312,177,489,31,14,Player A
3753,JointPQPlayer,290,195,485,30,15,Player A
3754,JointPQPlayer,284,214,498,34,12,Player A
3755,JointPQPlayer,173,263,436,17,27,JointPQPlayer
3756,JointPQPlayer,327,172,499,35,12,Player A
3757,JointPQPlayer,264,234,498,46,16,Player A
3758,JointPQPlayer,280,220,500,33,11,Player A
3759,JointPQPlayer,126,291,417,13,32,JointPQPlayer
3760,JointPQPlayer,237,232,469,26,19,Player A
3761,JointPQPlayer,287,202,489,28,13,Player A
3762,JointPQPlayer,269,224,493,32,13,Player A
3763,JointPQPlayer,277,202,479,30,17,Player A
3764,JointPQPlayer,255,205,460,32,24,Player A
3765,JointPQPlayer,275,195,470,30,20,Player A
3766,JointPQPlayer,321,191,512,39,9,Player A
3767,JointPQPlayer,261,206,467,27,20,Player A
3768,JointPQPlayer,263,208,471,28,19,Player A
3769,JointPQPlayer,275,205,480,37,19,Player A
3770,JointPQPlayer,285,195,480,31,17,Player A
3771,JointPQPlayer,325,175,500,33,11,Player A
3772,JointPQPlayer,267,197,464,27,21,Player A
3773,JointPQPlayer,284,204,488,36,16,Player A
3774,JointPQPlayer,285,215,500,33,11,Player A
3775,JointPQPlayer,229,209,438,22,28,Player A
3776,JointPQPlayer,135,270,405,10,35,JointPQPlayer
3777,JointPQPlayer,288,193,481,29,16,Player A
3778,JointPQPlayer,280,215,495,37,14,Player A
3779,JointPQPlayer,298,198,496,35,13,Player A
3780,JointPQPlayer,136,266,402,13,37,JointPQPlayer
3781,JointPQPlayer,293,213,506,42,12,Player A
3782,JointPQPlayer,265,180,445,29,28,Player A
3783,JointPQPlayer,281,201,482,30,16,Player A
3784,JointPQPlayer,296,191,487,38,17,Player A
3785,JointPQPlayer,318,178,496,35,13,Player A
3786,JointPQPlayer,239,214,453,28,25,Player A
3787,JointPQPlayer,159,249,408,16,36,JointPQPlayer
3788,JointPQPlayer,234,229,463,32,23,Player A
3789,JointPQPlayer,136,271,407,12,35,JointPQPlayer
3790,JointPQPlayer,302,182,484,32,16,Player A
3791,JointPQPlayer,198,218,416,21,35,JointPQPlayer
3792,JointPQPlayer,273,218,491,36,15,Player A
3793,JointPQPlayer,299,199,498,40,14,Player A
3794,JointPQPlayer,320,155,475,26,17,Player A
3795,JointPQPlayer,152,257,409,17,36,JointPQPlayer
3796,JointPQPlayer,292,207,499,35,12,Player A
3797,JointPQPlayer,306,196,502,38,12,Player A
3798,JointPQPlayer,277,222,499,35,12,Player A
3799,JointPQPlayer,314,199,513,40,9,Player A
3800,JointPQPlayer,282,207,489,34,15,Player A
3801,JointPQPlayer,316,181,497,36,13,Player A
3802,JointPQPlayer,258,233,491,36,15,Player A
3803,JointPQPlayer,313,203,516,31,5,Player A
3804,JointPQPlayer,291,176,467,27,20,Player A
3805,JointPQPlayer,248,213,461,39,26,Player A
3806,JointPQPlayer,287,207,494,39,15,Player A
3807,JointPQPlayer,142,262,404,15,37,JointPQPlayer
3808,JointPQPlayer,252,242,494,33,13,Player A
3809,JointPQPlayer,291,201,492,31,13,Player A
3810,JointPQPlayer,298,203,501,37,12,Player A
3811,JointPQPlayer,278,188,466,29,21,Player A
3812,JointPQPlayer,280,210,490,32,14,Player A
3813,JointPQPlayer,322,187,509,36,9,Player A
3814,JointPQPlayer,303,178,481,32,17,Player A
3815,JointPQPlayer,266,211,477,34,19,Player A
3816,JointPQPlayer,276,206,482,33,17,Player A
3817,JointPQPlayer,282,217,499,38,13,Player A
3818,JointPQPlayer,292,177,469,32,21,Player A
3819,JointPQPlayer,287,212,499,32,11,Player A
3820,JointPQPlayer,307,177,484,35,17,Player A
3821,JointPQPlayer,289,199,488,36,16,Player A
3822,JointPQPlayer,300,210,510,40,10,Player A
3823,JointPQPlayer,288,218,506,33,9,Player A
3824,JointPQPlayer,287,197,484,35,17,Player A
3825,JointPQPlayer,256,231,487,38,17,Player A
3826,JointPQPlayer,282,222,504,43,13,Player A
3827,JointPQPlayer,155,265,420,16,32,JointPQPlayer
3828,JointPQPlayer,175,225,400,14,38,JointPQPlayer
3829,JointPQPlayer,274,204,478,32,18,Player A
3830,JointPQPlayer,269,224,493,38,15,Player A
3831,JointPQPlayer,255,225,480,31,17,Player A
3832,JointPQPlayer,295,200,495,40,15,Player A
3833,JointPQPlayer,326,176,502,41,13,Player A
3834,JointPQPlayer,294,184,478,32,18,Player A
3835,JointPQPlayer,286,206,492,34,14,Player A
3836,JointPQPlayer,303,203,506,36,10,Player A
3837,JointPQPlayer,278,183,461,27,22,Player A
3838,JointPQPlayer,268,213,481,26,15,Player A
3839,JointPQPlayer,299,179,478,35,19,Player A
3840,JointPQPlayer,284,189,473,30,19,Player A
3841,JointPQPlayer,115,285,400,11,37,JointPQPlayer
3842,JointPQPlayer,264,219,483,34,17,Player A
3843,JointPQPlayer,295,190,485,33,16,Player A
3844,JointPQPlayer,138,253,391,8,39,JointPQPlayer
3845,JointPQPlayer,283,233,516,43,9,Player A
3846,JointPQPlayer,298,198,496,38,14,Player A
3847,JointPQPlayer,275,200,475,32,19,Player A
3848,JointPQPlayer,289,204,493,35,14,Player A
3849,JointPQPlayer,133,243,376,11,45,JointPQPlayer
3850,JointPQPlayer,173,218,391,11,40,JointPQPlayer
3851,JointPQPlayer,295,205,500,30,10,Player A
3852,JointPQPlayer,287,222,509,36,9,Player A
3853,JointPQPlayer,263,218,481,35,18,Player A
3854,JointPQPlayer,308,183,491,33,14,Player A
3855,JointPQPlayer,134,244,378,7,43,JointPQPlayer
3856,JointPQPlayer,321,176,497,36,13,Player A
3857,JointPQPlayer,244,214,458,30,24,Player A
3858,JointPQPlayer,249,214,463,29,22,Player A
3859,JointPQPlayer,227,217,444,22,26,Player A
3860,JointPQPlayer,174,249,423,19,32,JointPQPlayer
3861,JointPQPlayer,276,201,477,37,20,Player A
3862,JointPQPlayer,325,155,480,34,18,Player A
3863,JointPQPlayer,173,233,406,20,38,JointPQPlayer
3864,JointPQPlayer,314,184,498,31,11,Player A
3865,JointPQPlayer,285,220,505,41,12,Player A
3866,JointPQPlayer,286,186,472,35,21,Player A
3867,JointPQPlayer,293,183,476,27,17,Player A
3868,JointPQPlayer,281,206,487,38,17,Player A
3869,JointPQPlayer,278,203,481,29,16,Player A
3870,JointPQPlayer,278,208,486,34,16,Player A
3871,JointPQPlayer,234,229,463,32,23,Player A
3872,JointPQPlayer,325,170,495,34,13,Player A
3873,JointPQPlayer,303,188,491,36,15,Player A
3874,JointPQPlayer,273,208,481,23,14,Player A
3875,JointPQPlayer,293,208,501,37,12,Player A
3876,JointPQPlayer,265,235,500,36,12,Player A
3877,JointPQPlayer,274,219,493,41,16,Player A
3878,JointPQPlayer,326,161,487,29,14,Player A
3879,JointPQPlayer,290,200,490,35,15,Player A
3880,JointPQPlayer,187,237,424,20,32,JointPQPlayer
3881,JointPQPlayer,222,227,449,33,28,JointPQPlayer
3882,JointPQPlayer,232,212,444,28,28,Player A
3883,JointPQPlayer,140,260,400,14,38,JointPQPlayer
3884,JointPQPlayer,288,188,476,36,20,Player A
3885,JointPQPlayer,280,190,470,24,18,Player A
3886,JointPQPlayer,229,209,438,25,29,Player A
3887,JointPQPlayer,277,202,479,30,17,Player A
3888,JointPQPlayer,265,210,475,29,18,Player A
3889,JointPQPlayer,300,175,475,32,19,Player A
3890,JointPQPlayer,270,210,480,34,18,Player A
3891,JointPQPlayer,281,191,472,29,19,Player A
3892,JointPQPlayer,301,186,487,32,15,Player A
3893,JointPQPlayer,284,234,518,42,8,Player A
3894,JointPQPlayer,166,261,427,17,30,JointPQPlayer
3895,JointPQPlayer,295,190,485,39,18,Player A
3896,JointPQPlayer,260,230,490,29,13,Player A
3897,JointPQPlayer,184,234,418,20,34,JointPQPlayer
3898,JointPQPlayer,309,209,518,45,9,Player A
3899,JointPQPlayer,289,179,468,34,22,Player A
3900,JointPQPlayer,289,189,478,32,18,Player A
3901,JointPQPlayer,267,222,489,37,16,Player A
3902,JointPQPlayer,272,192,464,27,21,Player A
3903,JointPQPlayer,280,220,500,39,13,Player A
3904,JointPQPlayer,277,207,484,35,17,Player A
3905,JointPQPlayer,290,195,485,39,18,Player A
3906,JointPQPlayer,294,224,518,45,9,Player A
3907,JointPQPlayer,150,255,405,19,38,JointPQPlayer
3908,JointPQPlayer,307,187,494,33,13,Player A
3909,JointPQPlayer,302,192,494,39,15,Player A
3910,JointPQPlayer,290,165,455,21,22,Player A
3911,JointPQPlayer,319,169,488,33,15,Player A
3912,JointPQPlayer,315,175,490,29,13,Player A
3913,JointPQPlayer,133,268,401,9,36,JointPQPlayer
3914,JointPQPlayer,204,244,448,29,27,JointPQPlayer
3915,JointPQPlayer,306,186,492,34,14,Player A
3916,JointPQPlayer,279,204,483,28,15,Player A
3917,JointPQPlayer,285,210,495,46,17,Player A
3918,JointPQPlayer,276,196,472,32,20,Player A
3919,JointPQPlayer,260,235,495,40,15,Player A
3920,JointPQPlayer,214,229,443,21,26,JointPQPlayer
3921,JointPQPlayer,252,212,464,30,22,Player A
3922,JointPQPlayer,296,186,482,33,17,Player A
3923,JointPQPlayer,299,194,493,32,13,Player A
3924,JointPQPlayer,157,252,409,17,36,JointPQPlayer
3925,JointPQPlayer,249,229,478,38,20,Player A
3926,JointPQPlayer,215,235,450,22,24,JointPQPlayer
3927,JointPQPlayer,267,212,479,30,17,Player A
3928,JointPQPlayer,286,216,502,41,13,Player A
3929,JointPQPlayer,174,239,413,18,35,JointPQPlayer
3930,JointPQPlayer,296,196,492,34,14,Player A
3931,JointPQPlayer,283,233,516,46,10,Player A
3932,JointPQPlayer,281,206,487,38,17,Player A
3933,JointPQPlayer,231,241,472,29,19,JointPQPlayer
3934,JointPQPlayer,155,240,395,12,39,JointPQPlayer
3935,JointPQPlayer,277,207,484,32,16,Player A
3936,JointPQPlayer,273,218,491,36,15,Player A
3937,JointPQPlayer,296,201,497,30,11,Player A
3938,JointPQPlayer,324,179,503,39,12,Player A
3939,JointPQPlayer,289,194,483,34,17,Player A
3940,JointPQPlayer,306,201,507,37,10,Player A
3941,JointPQPlayer,128,273,401,12,37,JointPQPlayer
3942,JointPQPlayer,152,257,409,14,35,JointPQPlayer
3943,JointPQPlayer,287,197,484,32,16,Player A
3944,JointPQPlayer,142,252,394,8,38,JointPQPlayer
3945,JointPQPlayer,286,206,492,37,15,Player A
3946,JointPQPlayer,294,169,463,35,24,Player A
3947,JointPQPlayer,183,228,411,13,34,JointPQPlayer
3948,JointPQPlayer,297,177,474,31,19,Player A
3949,JointPQPlayer,297,202,499,32,11,Player A
3950,JointPQPlayer,290,195,485,33,16,Player A
3951,JointPQPlayer,279,174,453,28,25,Player A
3952,JointPQPlayer,290,190,480,37,19,Player A
3953,JointPQPlayer,301,186,487,35,16,Player A
3954,JointPQPlayer,305,195,500,33,11,Player A
3955,JointPQPlayer,145,255,400,14,38,JointPQPlayer
3956,JointPQPlayer,118,268,386,12,42,JointPQPlayer
3957,JointPQPlayer,149,259,408,19,37,JointPQPlayer
3958,JointPQPlayer,261,201,462,25,21,Player A
3959,JointPQPlayer,278,198,476,36,20,Player A
3960,JointPQPlayer,284,189,473,39,22,Player A
3961,JointPQPlayer,304,184,488,36,16,Player A
3962,JointPQPlayer,302,192,494,30,12,Player A
3963,JointPQPlayer,305,190,495,37,14,Player A
3964,JointPQPlayer,253,218,471,25,18,Player A
3965,JointPQPlayer,291,206,497,45,16,Player A
3966,JointPQPlayer,166,256,422,15,31,JointPQPlayer
3967,JointPQPlayer,327,167,494,30,12,Player A
3968,JointPQPlayer,294,209,503,39,12,Player A
3969,JointPQPlayer,283,198,481,32,17,Player A
3970,JointPQPlayer,284,204,488,39,17,Player A
3971,JointPQPlayer,285,205,490,38,16,Player A
3972,JointPQPlayer,151,266,417,16,33,JointPQPlayer
3973,JointPQPlayer,330,160,490,35,15,Player A
3974,JointPQPlayer,274,224,498,37,13,Player A
3975,JointPQPlayer,286,206,492,34,14,Player A
3976,JointPQPlayer,279,194,473,30,19,Player A
3977,JointPQPlayer,152,237,389,12,41,JointPQPlayer
3978,JointPQPlayer,284,184,468,28,20,Player A
3979,JointPQPlayer,283,188,471,25,18,Player A
3980,JointPQPlayer,170,215,385,14,43,JointPQPlayer
3981,JointPQPlayer,333,153,486,31,15,Player A
3982,JointPQPlayer,326,181,507,37,10,Player A
3983,JointPQPlayer,143,258,401,12,37,JointPQPlayer
3984,JointPQPlayer,158,268,426,13,29,JointPQPlayer
3985,JointPQPlayer,304,204,508,38,10,Player A
3986,JointPQPlayer,236,216,452,30,26,Player A
3987,JointPQPlayer,181,246,427,17,30,JointPQPlayer
3988,JointPQPlayer,283,168,451,23,24,Player A
3989,JointPQPlayer,310,190,500,36,12,Player A
3990,JointPQPlayer,272,187,459,31,24,Player A
3991,JointPQPlayer,194,244,438,22,28,JointPQPlayer
3992,JointPQPlayer,270,190,460,26,22,Player A
3993,JointPQPlayer,302,207,509,42,11,Player A
3994,JointPQPlayer,264,224,488,36,16,Player A
3995,JointPQPlayer,146,246,392,12,40,JointPQPlayer
3996,JointPQPlayer,298,193,491,30,13,Player A
3997,JointPQPlayer,294,189,483,31,16,Player A
3998,JointPQPlayer,191,216,407,12,35,JointPQPlayer
3999,JointPQPlayer,299,199,498,40,14,Player A
4000,JointPQPlayer,261,216,477,34,19,Player A
4001,JointPQPlayer,275,230,505,41,12,Player A
4002,JointPQPlayer,307,192,499,32,11,Player A
4003,JointPQPlayer,315,185,500,39,13,Player A
4004,JointPQPlayer,257,242,499,41,14,Player A
4005,JointPQPlayer,274,209,483,34,17,Player A
4006,JointPQPlayer,183,238,421,20,33,JointPQPlayer
4007,JointPQPlayer,269,209,478,35,19,Player A
4008,JointPQPlayer,308,163,471,37,22,Player A
4009,JointPQPlayer,296,186,482,30,16,Player A
4010,JointPQPlayer,277,207,484,35,17,Player A
4011,JointPQPlayer,316,191,507,34,9,Player A
4012,JointPQPlayer,265,210,475,35,20,Player A
4013,JointPQPlayer,261,191,452,27,25,Player A
4014,JointPQPlayer,238,223,461,24,21,Player A
4015,JointPQPlayer,271,206,477,31,18,Player A
4016,JointPQPlayer,328,168,496,38,14,Player A
4017,JointPQPlayer,255,220,475,35,20,Player A
4018,JointPQPlayer,291,201,492,34,14,Player A
4019,JointPQPlayer,298,213,511,38,9,Player A
4020,JointPQPlayer,289,194,483,28,15,Player A
4021,JointPQPlayer,303,173,476,27,17,Player A
4022,JointPQPlayer,311,176,487,32,15,Player A
4023,JointPQPlayer,296,196,492,40,16,Player A
4024,JointPQPlayer,298,203,501,40,13,Player A
4025,JointPQPlayer,292,217,509,39,10,Player A
4026,JointPQPlayer,254,209,463,29,22,Player A
4027,JointPQPlayer,295,180,475,29,18,Player A
4028,JointPQPlayer,136,266,402,10,36,JointPQPlayer
4029,JointPQPlayer,181,236,417,16,33,JointPQPlayer
4030,JointPQPlayer,169,254,423,19,32,JointPQPlayer
4031,JointPQPlayer,296,191,487,32,15,Player A
4032,JointPQPlayer,291,181,472,29,19,Player A
4033,JointPQPlayer,256,231,487,41,18,Player A
4034,JointPQPlayer,251,201,452,30,26,Player A
4035,JointPQPlayer,287,212,499,41,14,Player A
4036,JointPQPlayer,280,205,485,33,16,Player A
4037,JointPQPlayer,295,180,475,32,19,Player A
4038,JointPQPlayer,309,194,503,36,11,Player A
4039,JointPQPlayer,329,169,498,34,12,Player A
4040,JointPQPlayer,259,199,458,27,23,Player A
4041,JointPQPlayer,292,202,494,39,15,Player A
4042,JointPQPlayer,280,210,490,35,15,Player A
4043,JointPQPlayer,258,198,456,25,23,Player A
4044,JointPQPlayer,257,217,474,28,18,Player A
4045,JointPQPlayer,155,240,395,9,38,JointPQPlayer
4046,JointPQPlayer,141,256,397,23,42,JointPQPlayer
4047,JointPQPlayer,315,185,500,39,13,Player A
4048,JointPQPlayer,288,203,491,33,14,Player A
4049,JointPQPlayer,303,213,516,43,9,Player A
4050,JointPQPlayer,146,246,392,18,42,JointPQPlayer
4051,JointPQPlayer,164,239,403,11,36,JointPQPlayer
4052,JointPQPlayer,318,183,501,37,12,Player A
4053,JointPQPlayer,315,190,505,32,9,Player A
4054,JointPQPlayer,275,200,475,29,18,Player A
4055,JointPQPlayer,303,183,486,34,16,Player A
4056,JointPQPlayer,260,210,470,30,20,Player A
4057,JointPQPlayer,291,211,502,38,12,Player A
4058,JointPQPlayer,133,263,396,13,39,JointPQPlayer
4059,JointPQPlayer,146,261,407,12,35,JointPQPlayer
4060,JointPQPlayer,270,210,480,34,18,Player A
4061,JointPQPlayer,317,157,474,28,18,Player A
4062,JointPQPlayer,129,279,408,13,35,JointPQPlayer
4063,JointPQPlayer,306,191,497,36,13,Player A
4064,JointPQPlayer,305,155,460,20,20,Player A
4065,JointPQPlayer,301,206,507,37,10,Player A
4066,JointPQPlayer,138,243,381,10,43,JointPQPlayer
4067,JointPQPlayer,231,236,467,27,20,JointPQPlayer
4068,JointPQPlayer,163,273,436,20,28,JointPQPlayer
4069,JointPQPlayer,267,202,469,29,20,Player A
4070,JointPQPlayer,334,159,493,35,14,Player A
4071,JointPQPlayer,310,190,500,36,12,Player A
4072,JointPQPlayer,300,195,495,34,13,Player A
4073,JointPQPlayer,313,188,501,34,11,Player A
4074,JointPQPlayer,149,279,428,18,30,JointPQPlayer
4075,JointPQPlayer,152,237,389,12,41,JointPQPlayer
4076,JointPQPlayer,230,235,465,31,22,JointPQPlayer
4077,JointPQPlayer,282,207,489,37,16,Player A
4078,JointPQPlayer,327,192,519,40,7,Player A
4079,JointPQPlayer,112,307,419,12,31,JointPQPlayer
4080,JointPQPlayer,301,186,487,35,16,Player A
4081,JointPQPlayer,257,242,499,38,13,Player A
4082,JointPQPlayer,296,166,462,34,24,Player A
4083,JointPQPlayer,298,208,506,45,13,Player A
4084,JointPQPlayer,288,193,481,29,16,Player A
4085,JointPQPlayer,243,208,451,23,24,Player A
4086,JointPQPlayer,123,288,411,13,34,JointPQPlayer
4087,JointPQPlayer,317,177,494,36,14,Player A
4088,JointPQPlayer,171,251,422,12,30,JointPQPlayer
4089,JointPQPlayer,328,168,496,35,13,Player A
4090,JointPQPlayer,242,217,459,28,23,Player A
4091,JointPQPlayer,286,221,507,40,11,Player A
4092,JointPQPlayer,275,200,475,35,20,Player A
4093,JointPQPlayer,116,316,432,16,28,JointPQPlayer
4094,JointPQPlayer,325,170,495,34,13,Player A
4095,JointPQPlayer,159,249,408,13,35,JointPQPlayer
4096,JointPQPlayer,298,178,476,30,18,Player A
4097,JointPQPlayer,294,194,488,33,15,Player A
4098,JointPQPlayer,272,222,494,36,14,Player A
4099,JointPQPlayer,265,225,490,38,16,Player A
4100,JointPQPlayer,162,267,429,16,29,JointPQPlayer
4101,JointPQPlayer,243,238,481,32,17,Player A
4102,JointPQPlayer,127,267,394,14,40,JointPQPlayer
4103,JointPQPlayer,315,175,490,41,17,Player A
4104,JointPQPlayer,283,198,481,32,17,Player A
4105,JointPQPlayer,282,192,474,37,21,Player A
4106,JointPQPlayer,166,251,417,13,32,JointPQPlayer
4107,JointPQPlayer,257,197,454,23,23,Player A
4108,JointPQPlayer,278,208,486,37,17,Player A
4109,JointPQPlayer,301,191,492,37,15,Player A
4110,JointPQPlayer,210,235,445,20,25,JointPQPlayer
4111,JointPQPlayer,151,271,422,18,32,JointPQPlayer
4112,JointPQPlayer,230,220,450,28,26,Player A
4113,JointPQPlayer,275,225,500,39,13,Player A
4114,JointPQPlayer,268,203,471,28,19,Player A
4115,JointPQPlayer,307,182,489,31,14,Player A
4116,JointPQPlayer,221,266,487,35,16,JointPQPlayer
4117,JointPQPlayer,249,224,473,30,19,Player A
4118,JointPQPlayer,267,217,484,32,16,Player A
4119,JointPQPlayer,198,208,406,17,37,JointPQPlayer
4120,JointPQPlayer,140,245,385,8,41,JointPQPlayer
4121,JointPQPlayer,143,278,421,20,33,JointPQPlayer
4122,JointPQPlayer,299,199,498,43,15,Player A
4123,JointPQPlayer,165,290,455,21,22,JointPQPlayer
4124,JointPQPlayer,270,230,500,39,13,Player A
4125,JointPQPlayer,166,241,407,15,36,JointPQPlayer
4126,JointPQPlayer,287,192,479,30,17,Player A
4127,JointPQPlayer,147,262,409,17,36,JointPQPlayer
4128,JointPQPlayer,280,220,500,36,12,Player A
4129,JointPQPlayer,277,207,484,32,16,Player A
4130,JointPQPlayer,274,189,463,23,20,Player A
4131,JointPQPlayer,306,176,482,33,17,Player A
4132,JointPQPlayer,298,198,496,38,14,Player A
4133,JointPQPlayer,274,194,468,22,18,Player A
4134,JointPQPlayer,264,224,488,39,17,Player A
4135,JointPQPlayer,323,193,516,34,6,Player A
4136,JointPQPlayer,296,186,482,30,16,Player A
4137,JointPQPlayer,295,195,490,29,13,Player A
4138,JointPQPlayer,302,202,504,43,13,Player A
4139,JointPQPlayer,287,207,494,39,15,Player A
4140,JointPQPlayer,135,265,400,8,36,JointPQPlayer
4141,JointPQPlayer,134,269,403,11,36,JointPQPlayer
4142,JointPQPlayer,323,158,481,35,18,Player A
4143,JointPQPlayer,295,195,490,29,13,Player A
4144,JointPQPlayer,280,205,485,39,18,Player A
4145,JointPQPlayer,283,213,496,44,16,Player A
4146,JointPQPlayer,238,248,486,31,15,JointPQPlayer
4147,JointPQPlayer,164,214,378,16,46,JointPQPlayer
4148,JointPQPlayer,295,205,500,39,13,Player A
4149,JointPQPlayer,319,174,493,26,11,Player A
4150,JointPQPlayer,153,248,401,12,37,JointPQPlayer
4151,JointPQPlayer,157,262,419,12,31,JointPQPlayer
4152,JointPQPlayer,304,179,483,34,17,Player A
4153,JointPQPlayer,288,203,491,33,14,Player A
4154,JointPQPlayer,288,203,491,42,17,Player A
4155,JointPQPlayer,261,231,492,28,12,Player A
4156,JointPQPlayer,303,173,476,33,19,Player A
4157,JointPQPlayer,273,198,471,25,18,Player A
4158,JointPQPlayer,296,181,477,37,20,Player A
4159,JointPQPlayer,194,239,433,23,30,JointPQPlayer
4160,JointPQPlayer,271,221,492,37,15,Player A
4161,JointPQPlayer,274,194,468,22,18,Player A
4162,JointPQPlayer,299,164,463,23,20,Player A
4163,JointPQPlayer,273,228,501,43,14,Player A
4164,JointPQPlayer,133,293,426,13,29,JointPQPlayer
4165,JointPQPlayer,311,191,502,41,13,Player A
4166,JointPQPlayer,178,238,416,15,33,JointPQPlayer
4167,JointPQPlayer,152,277,429,22,31,JointPQPlayer
4168,JointPQPlayer,300,190,490,32,14,Player A
4169,JointPQPlayer,300,210,510,40,10,Player A
4170,JointPQPlayer,275,210,485,36,17,Player A
4171,JointPQPlayer,304,194,498,40,14,Player A
4172,JointPQPlayer,280,200,480,37,19,Player A
4173,JointPQPlayer,133,293,426,19,31,JointPQPlayer
4174,JointPQPlayer,293,203,496,38,14,Player A
4175,JointPQPlayer,136,266,402,13,37,JointPQPlayer
4176,JointPQPlayer,223,223,446,24,26,Tie
4177,JointPQPlayer,280,195,475,35,20,Player A
4178,JointPQPlayer,253,208,461,30,23,Player A
4179,JointPQPlayer,130,270,400,14,38,JointPQPlayer
4180,JointPQPlayer,338,168,506,39,11,Player A
4181,JointPQPlayer,285,200,485,39,18,Player A
4182,JointPQPlayer,304,204,508,38,10,Player A
4183,JointPQPlayer,153,268,421,17,32,JointPQPlayer
4184,JointPQPlayer,120,285,405,13,36,JointPQPlayer
4185,JointPQPlayer,287,212,499,41,14,Player A
4186,JointPQPlayer,288,158,446,24,26,Player A
4187,JointPQPlayer,307,197,504,40,12,Player A
4188,JointPQPlayer,300,180,480,34,18,Player A
4189,JointPQPlayer,294,214,508,44,12,Player A
4190,JointPQPlayer,306,191,497,33,12,Player A
4191,JointPQPlayer,301,186,487,35,16,Player A
4192,JointPQPlayer,245,210,455,27,24,Player A
4193,JointPQPlayer,295,190,485,33,16,Player A
4194,JointPQPlayer,314,189,503,30,9,Player A
4195,JointPQPlayer,293,188,481,32,17,Player A
4196,JointPQPlayer,301,171,472,38,22,Player A
4197,JointPQPlayer,304,174,478,38,20,Player A
4198,JointPQPlayer,327,192,519,43,8,Player A
4199,JointPQPlayer,264,199,463,23,20,Player A
4200,JointPQPlayer,307,177,484,29,15,Player A
4201,JointPQPlayer,155,250,405,16,37,JointPQPlayer
4202,JointPQPlayer,295,190,485,36,17,Player A
4203,JointPQPlayer,280,210,490,47,19,Player A
4204,JointPQPlayer,310,200,510,31,7,Player A
4205,JointPQPlayer,315,190,505,38,11,Player A
4206,JointPQPlayer,302,212,514,47,11,Player A
4207,JointPQPlayer,263,213,476,36,20,Player A
4208,JointPQPlayer,304,194,498,37,13,Player A
4209,JointPQPlayer,290,195,485,27,14,Player A
4210,JointPQPlayer,275,190,465,28,21,Player A
4211,JointPQPlayer,319,174,493,38,15,Player A
4212,JointPQPlayer,277,182,459,31,24,Player A
4213,JointPQPlayer,289,179,468,31,21,Player A
4214,JointPQPlayer,178,213,391,14,41,JointPQPlayer
4215,JointPQPlayer,117,302,419,6,29,JointPQPlayer
4216,JointPQPlayer,301,186,487,41,18,Player A
4217,JointPQPlayer,324,174,498,40,14,Player A
4218,JointPQPlayer,293,188,481,32,17,Player A
4219,JointPQPlayer,312,172,484,26,14,Player A
4220,JointPQPlayer,290,190,480,31,17,Player A
4221,JointPQPlayer,158,253,411,13,34,JointPQPlayer
4222,JointPQPlayer,301,196,497,39,14,Player A
4223,JointPQPlayer,152,277,429,13,28,JointPQPlayer
4224,JointPQPlayer,174,229,403,14,37,JointPQPlayer
4225,JointPQPlayer,293,203,496,41,15,Player A
4226,JointPQPlayer,299,184,483,31,16,Player A
4227,JointPQPlayer,314,174,488,33,15,Player A
4228,JointPQPlayer,273,218,491,39,16,Player A
4229,JointPQPlayer,307,207,514,41,9,Player A
4230,JointPQPlayer,139,284,423,16,31,JointPQPlayer
4231,JointPQPlayer,317,202,519,40,7,Player A
4232,JointPQPlayer,339,164,503,33,10,Player A
4233,JointPQPlayer,147,242,389,9,40,JointPQPlayer
4234,JointPQPlayer,156,241,397,17,40,JointPQPlayer
4235,JointPQPlayer,145,255,400,11,37,JointPQPlayer
4236,JointPQPlayer,313,188,501,37,12,Player A
4237,JointPQPlayer,294,209,503,45,14,Player A
4238,JointPQPlayer,274,224,498,37,13,Player A
4239,JointPQPlayer,272,202,474,34,20,Player A
4240,JointPQPlayer,289,194,483,43,20,Player A
4241,JointPQPlayer,295,205,500,27,9,Player A
4242,JointPQPlayer,296,196,492,37,15,Player A
4243,JointPQPlayer,309,184,493,35,14,Player A
4244,JointPQPlayer,280,210,490,38,16,Player A
4245,JointPQPlayer,273,208,481,38,19,Player A
4246,JointPQPlayer,323,188,511,38,9,Player A
4247,JointPQPlayer,314,174,488,33,15,Player A
4248,JointPQPlayer,265,210,475,29,18,Player A
4249,JointPQPlayer,170,255,425,21,32,JointPQPlayer
4250,JointPQPlayer,226,246,472,32,20,JointPQPlayer
4251,JointPQPlayer,310,195,505,35,10,Player A
4252,JointPQPlayer,147,272,419,15,32,JointPQPlayer
4253,JointPQPlayer,271,206,477,31,18,Player A
4254,JointPQPlayer,283,218,501,40,13,Player A
4255,JointPQPlayer,307,207,514,38,8,Player A
4256,JointPQPlayer,290,195,485,33,16,Player A
4257,JointPQPlayer,286,201,487,29,14,Player A
4258,JointPQPlayer,263,218,481,26,15,Player A
4259,JointPQPlayer,173,218,391,11,40,JointPQPlayer
4260,JointPQPlayer,279,194,473,30,19,Player A
4261,JointPQPlayer,244,194,438,22,28,Player A
4262,JointPQPlayer,155,265,420,19,33,JointPQPlayer
4263,JointPQPlayer,266,206,472,29,19,Player A
4264,JointPQPlayer,144,249,393,10,39,JointPQPlayer
4265,JointPQPlayer,266,231,497,33,12,Player A
4266,JointPQPlayer,237,232,469,26,19,Player A
4267,JointPQPlayer,304,174,478,32,18,Player A
4268,JointPQPlayer,296,216,512,42,10,Player A
4269,JointPQPlayer,278,213,491,39,16,Player A
4270,JointPQPlayer,317,182,499,38,13,Player A
4271,JointPQPlayer,299,184,483,31,16,Player A
4272,JointPQPlayer,294,204,498,37,13,Player A
4273,JointPQPlayer,251,231,482,36,18,Player A
4274,JointPQPlayer,292,192,484,26,14,Player A
4275,JointPQPlayer,277,217,494,36,14,Player A
4276,JointPQPlayer,214,249,463,26,21,JointPQPlayer
4277,JointPQPlayer,127,272,399,10,37,JointPQPlayer
4278,JointPQPlayer,200,250,450,19,23,JointPQPlayer
4279,JointPQPlayer,282,187,469,29,20,Player A
4280,JointPQPlayer,109,299,408,13,35,JointPQPlayer
4281,JointPQPlayer,306,196,502,41,13,Player A
4282,JointPQPlayer,271,226,497,36,13,Player A
4283,JointPQPlayer,312,202,514,35,7,Player A
4284,JointPQPlayer,286,191,477,34,19,Player A
4285,JointPQPlayer,131,246,377,9,44,JointPQPlayer
4286,JointPQPlayer,304,204,508,38,10,Player A
4287,JointPQPlayer,300,195,495,37,14,Player A
4288,JointPQPlayer,137,252,389,12,41,JointPQPlayer
4289,JointPQPlayer,260,210,470,33,21,Player A
4290,JointPQPlayer,282,177,459,28,23,Player A
4291,JointPQPlayer,273,213,486,34,16,Player A
4292,JointPQPlayer,311,176,487,32,15,Player A
4293,JointPQPlayer,302,182,484,35,17,Player A
4294,JointPQPlayer,248,233,481,29,16,Player A
4295,JointPQPlayer,284,199,483,31,16,Player A
4296,JointPQPlayer,283,198,481,29,16,Player A
4297,JointPQPlayer,274,204,478,35,19,Player A
4298,JointPQPlayer,284,199,483,34,17,Player A
4299,JointPQPlayer,297,192,489,37,16,Player A
4300,JointPQPlayer,311,176,487,38,17,Player A
4301,JointPQPlayer,278,178,456,31,25,Player A
4302,JointPQPlayer,303,168,471,25,18,Player A
4303,JointPQPlayer,306,181,487,32,15,Player A
4304,JointPQPlayer,326,156,482,30,16,Player A
4305,JointPQPlayer,306,206,512,36,8,Player A
4306,JointPQPlayer,292,192,484,29,15,Player A
4307,JointPQPlayer,163,268,431,21,30,JointPQPlayer
4308,JointPQPlayer,290,210,500,42,14,Player A
4309,JointPQPlayer,298,178,476,30,18,Player A
4310,JointPQPlayer,137,237,374,6,44,JointPQPlayer
4311,JointPQPlayer,296,206,502,38,12,Player A
4312,JointPQPlayer,151,246,397,14,39,JointPQPlayer
4313,JointPQPlayer,288,198,486,34,16,Player A
4314,JointPQPlayer,290,200,490,32,14,Player A
4315,JointPQPlayer,296,211,507,40,11,Player A
4316,JointPQPlayer,269,214,483,34,17,Player A
4317,JointPQPlayer,299,214,513,43,10,Player A
4318,JointPQPlayer,284,194,478,35,19,Player A
4319,JointPQPlayer,284,189,473,33,20,Player A
4320,JointPQPlayer,305,190,495,34,13,Player A
4321,JointPQPlayer,231,226,457,35,26,Player A
4322,JointPQPlayer,313,178,491,36,15,Player A
4323,JointPQPlayer,264,199,463,35,24,Player A
4324,JointPQPlayer,241,236,477,34,19,Player A
4325,JointPQPlayer,178,223,401,15,38,JointPQPlayer
4326,JointPQPlayer,304,199,503,39,12,Player A
4327,JointPQPlayer,259,209,468,37,23,Player A
4328,JointPQPlayer,284,209,493,38,15,Player A
4329,JointPQPlayer,134,274,408,10,34,JointPQPlayer
4330,JointPQPlayer,321,166,487,32,15,Player A
4331,JointPQPlayer,306,201,507,37,10,Player A
4332,JointPQPlayer,138,268,406,17,37,JointPQPlayer
4333,JointPQPlayer,239,219,458,33,25,Player A
4334,JointPQPlayer,294,209,503,42,13,Player A
4335,JointPQPlayer,293,193,486,34,16,Player A
4336,JointPQPlayer,283,213,496,35,13,Player A
4337,JointPQPlayer,257,222,479,33,18,Player A
4338,JointPQPlayer,308,208,516,43,9,Player A
4339,JointPQPlayer,270,215,485,30,15,Player A
4340,JointPQPlayer,145,255,400,11,37,JointPQPlayer
4341,JointPQPlayer,139,279,418,14,32,JointPQPlayer
4342,JointPQPlayer,285,200,485,33,16,Player A
4343,JointPQPlayer,299,214,513,46,11,Player A
4344,JointPQPlayer,301,191,492,37,15,Player A
4345,JointPQPlayer,289,174,463,35,24,Player A
4346,JointPQPlayer,266,206,472,35,21,Player A
4347,JointPQPlayer,280,205,485,30,15,Player A
4348,JointPQPlayer,262,232,494,36,14,Player A
4349,JointPQPlayer,296,191,487,35,16,Player A
4350,JointPQPlayer,303,178,481,32,17,Player A
4351,JointPQPlayer,291,191,482,36,18,Player A
4352,JointPQPlayer,276,221,497,39,14,Player A
4353,JointPQPlayer,261,221,482,33,17,Player A
4354,JointPQPlayer,290,225,515,39,8,Player A
4355,JointPQPlayer,302,172,474,28,18,Player A
4356,JointPQPlayer,282,222,504,37,11,Player A
4357,JointPQPlayer,261,226,487,35,16,Player A
4358,JointPQPlayer,162,252,414,19,35,JointPQPlayer
4359,JointPQPlayer,271,216,487,35,16,Player A
4360,JointPQPlayer,316,186,502,41,13,Player A
4361,JointPQPlayer,254,224,478,26,16,Player A
4362,JointPQPlayer,313,188,501,40,13,Player A
4363,JointPQPlayer,223,193,416,18,34,Player A
4364,JointPQPlayer,288,193,481,23,14,Player A
4365,JointPQPlayer,298,178,476,33,19,Player A
4366,JointPQPlayer,314,159,473,30,19,Player A
4367,JointPQPlayer,262,222,484,32,16,Player A
4368,JointPQPlayer,316,191,507,40,11,Player A
4369,JointPQPlayer,194,209,403,14,37,JointPQPlayer
4370,JointPQPlayer,230,260,490,38,16,JointPQPlayer
4371,JointPQPlayer,207,257,464,21,19,JointPQPlayer
4372,JointPQPlayer,322,187,509,36,9,Player A
4373,JointPQPlayer,172,242,414,13,33,JointPQPlayer
4374,JointPQPlayer,308,198,506,33,9,Player A
4375,JointPQPlayer,307,187,494,33,13,Player A
4376,JointPQPlayer,291,191,482,36,18,Player A
4377,JointPQPlayer,297,212,509,42,11,Player A
4378,JointPQPlayer,204,229,433,17,28,JointPQPlayer
4379,JointPQPlayer,323,163,486,34,16,Player A
4380,JointPQPlayer,281,211,492,34,14,Player A
4381,JointPQPlayer,126,281,407,15,36,JointPQPlayer
4382,JointPQPlayer,122,267,389,9,40,JointPQPlayer
4383,JointPQPlayer,167,257,424,14,30,JointPQPlayer
4384,JointPQPlayer,307,197,504,37,11,Player A
4385,JointPQPlayer,138,258,396,10,38,JointPQPlayer
4386,JointPQPlayer,272,177,449,24,25,Player A
4387,JointPQPlayer,148,253,401,21,40,JointPQPlayer
4388,JointPQPlayer,268,238,506,36,10,Player A
4389,JointPQPlayer,258,218,476,30,18,Player A
4390,JointPQPlayer,320,185,505,32,9,Player A
4391,JointPQPlayer,146,261,407,15,36,JointPQPlayer
4392,JointPQPlayer,278,228,506,36,10,Player A
4393,JointPQPlayer,273,213,486,34,16,Player A
4394,JointPQPlayer,273,203,476,36,20,Player A
4395,JointPQPlayer,300,195,495,37,14,Player A
4396,JointPQPlayer,272,217,489,34,15,Player A
4397,JointPQPlayer,277,212,489,37,16,Player A
4398,JointPQPlayer,273,223,496,38,14,Player A
4399,JointPQPlayer,156,261,417,19,34,JointPQPlayer
4400,JointPQPlayer,312,182,494,36,14,Player A
4401,JointPQPlayer,275,205,480,28,16,Player A
4402,JointPQPlayer,274,199,473,36,21,Player A
4403,JointPQPlayer,236,211,447,22,25,Player A
4404,JointPQPlayer,296,186,482,30,16,Player A
4405,JointPQPlayer,286,206,492,37,15,Player A
4406,JointPQPlayer,293,173,466,29,21,Player A
4407,JointPQPlayer,269,239,508,47,13,Player A
4408,JointPQPlayer,291,201,492,40,16,Player A
4409,JointPQPlayer,145,270,415,23,36,JointPQPlayer
4410,JointPQPlayer,155,260,415,17,34,JointPQPlayer
4411,JointPQPlayer,285,190,475,29,18,Player A
4412,JointPQPlayer,283,213,496,32,12,Player A
4413,JointPQPlayer,300,205,505,44,13,Player A
4414,JointPQPlayer,278,178,456,19,21,Player A
4415,JointPQPlayer,310,180,490,38,16,Player A
4416,JointPQPlayer,318,183,501,34,11,Player A
4417,JointPQPlayer,182,262,444,22,26,JointPQPlayer
4418,JointPQPlayer,334,179,513,43,10,Player A
4419,JointPQPlayer,310,185,495,28,11,Player A
4420,JointPQPlayer,162,252,414,13,33,JointPQPlayer
4421,JointPQPlayer,234,229,463,23,20,Player A
4422,JointPQPlayer,263,243,506,39,11,Player A
4423,JointPQPlayer,301,191,492,40,16,Player A
4424,JointPQPlayer,291,201,492,31,13,Player A
4425,JointPQPlayer,283,183,466,29,21,Player A
4426,JointPQPlayer,135,285,420,19,33,JointPQPlayer
4427,JointPQPlayer,350,170,520,38,6,Player A
4428,JointPQPlayer,285,220,505,41,12,Player A
4429,JointPQPlayer,314,169,483,34,17,Player A
4430,JointPQPlayer,156,281,437,21,28,JointPQPlayer
4431,JointPQPlayer,284,199,483,31,16,Player A
4432,JointPQPlayer,311,196,507,34,9,Player A
4433,JointPQPlayer,314,189,503,36,11,Player A
4434,JointPQPlayer,275,205,480,31,17,Player A
4435,JointPQPlayer,256,226,482,39,19,Player A
4436,JointPQPlayer,318,178,496,38,14,Player A
4437,JointPQPlayer,279,224,503,36,11,Player A
4438,JointPQPlayer,144,249,393,13,40,JointPQPlayer
4439,JointPQPlayer,290,205,495,37,14,Player A
4440,JointPQPlayer,272,212,484,38,18,Player A
4441,JointPQPlayer,134,294,428,18,30,JointPQPlayer
4442,JointPQPlayer,306,166,472,26,18,Player A
4443,JointPQPlayer,301,176,477,34,19,Player A
4444,JointPQPlayer,303,198,501,40,13,Player A
4445,JointPQPlayer,321,196,517,47,10,Player A
4446,JointPQPlayer,290,205,495,34,13,Player A
4447,JointPQPlayer,296,211,507,37,10,Player A
4448,JointPQPlayer,345,145,490,29,13,Player A
4449,JointPQPlayer,271,211,482,42,20,Player A
4450,JointPQPlayer,266,201,467,30,21,Player A
4451,JointPQPlayer,282,197,479,30,17,Player A
4452,JointPQPlayer,300,205,505,35,10,Player A
4453,JointPQPlayer,284,219,503,48,15,Player A
4454,JointPQPlayer,152,267,419,12,31,JointPQPlayer
4455,JointPQPlayer,249,219,468,28,20,Player A
4456,JointPQPlayer,289,199,488,33,15,Player A
4457,JointPQPlayer,127,267,394,14,40,JointPQPlayer
4458,JointPQPlayer,285,210,495,37,14,Player A
4459,JointPQPlayer,240,220,460,32,24,Player A
4460,JointPQPlayer,263,218,481,32,17,Player A
4461,JointPQPlayer,208,193,401,18,39,Player A
4462,JointPQPlayer,277,202,479,42,21,Player A
4463,JointPQPlayer,262,217,479,33,18,Player A
4464,JointPQPlayer,317,157,474,31,19,Player A
4465,JointPQPlayer,260,185,445,23,26,Player A
4466,JointPQPlayer,151,281,432,19,29,JointPQPlayer
4467,JointPQPlayer,277,187,464,33,23,Player A
4468,JointPQPlayer,130,250,380,12,44,JointPQPlayer
4469,JointPQPlayer,305,160,465,28,21,Player A
4470,JointPQPlayer,307,197,504,37,11,Player A
4471,JointPQPlayer,262,212,474,34,20,Player A
4472,JointPQPlayer,300,190,490,38,16,Player A
4473,JointPQPlayer,330,175,505,38,11,Player A
4474,JointPQPlayer,315,195,510,49,13,Player A
4475,JointPQPlayer,298,188,486,31,15,Player A
4476,JointPQPlayer,275,215,490,38,16,Player A
4477,JointPQPlayer,271,206,477,40,21,Player A
4478,JointPQPlayer,296,166,462,25,21,Player A
4479,JointPQPlayer,277,187,464,33,23,Player A
4480,JointPQPlayer,289,194,483,40,19,Player A
4481,JointPQPlayer,146,271,417,13,32,JointPQPlayer
4482,JointPQPlayer,290,190,480,34,18,Player A
4483,JointPQPlayer,312,197,509,42,11,Player A
4484,JointPQPlayer,142,257,399,16,39,JointPQPlayer
4485,JointPQPlayer,285,210,495,40,15,Player A
4486,JointPQPlayer,143,258,401,12,37,JointPQPlayer
4487,JointPQPlayer,316,181,497,36,13,Player A
4488,JointPQPlayer,302,197,499,35,12,Player A
4489,JointPQPlayer,276,211,487,41,18,Player A
4490,JointPQPlayer,299,204,503,42,13,Player A
4491,JointPQPlayer,219,224,443,21,26,JointPQPlayer
4492,JointPQPlayer,290,205,495,40,15,Player A
4493,JointPQPlayer,279,214,493,38,15,Player A
4494,JointPQPlayer,313,183,496,41,15,Player A
4495,JointPQPlayer,292,212,504,49,15,Player A
4496,JointPQPlayer,284,199,483,31,16,Player A
4497,JointPQPlayer,126,301,427,11,28,JointPQPlayer
4498,JointPQPlayer,288,188,476,36,20,Player A
4499,JointPQPlayer,279,184,463,32,23,Player A
4500,JointPQPlayer,140,260,400,14,38,JointPQPlayer
4501,JointPQPlayer,270,215,485,39,18,Player A
4502,JointPQPlayer,158,248,406,17,37,JointPQPlayer
4503,JointPQPlayer,285,200,485,33,16,Player A
4504,JointPQPlayer,274,219,493,41,16,Player A
4505,JointPQPlayer,285,200,485,30,15,Player A
4506,JointPQPlayer,303,198,501,37,12,Player A
4507,JointPQPlayer,285,215,500,39,13,Player A
4508,JointPQPlayer,288,203,491,39,16,Player A
4509,JointPQPlayer,245,225,470,27,19,Player A
4510,JointPQPlayer,237,237,474,28,18,Tie
4511,JointPQPlayer,161,271,432,19,29,JointPQPlayer
4512,JointPQPlayer,285,205,490,35,15,Player A
4513,JointPQPlayer,282,202,484,35,17,Player A
4514,JointPQPlayer,266,216,482,33,17,Player A
4515,JointPQPlayer,283,208,491,33,14,Player A
4516,JointPQPlayer,288,183,471,22,17,Player A
4517,JointPQPlayer,283,193,476,30,18,Player A
4518,JointPQPlayer,294,199,493,35,14,Player A
4519,JointPQPlayer,258,218,476,33,19,Player A
4520,JointPQPlayer,282,212,494,33,13,Player A
4521,JointPQPlayer,153,273,426,25,33,JointPQPlayer
4522,JointPQPlayer,212,227,439,29,30,JointPQPlayer
4523,JointPQPlayer,159,244,403,8,35,JointPQPlayer
4524,JointPQPlayer,293,193,486,34,16,Player A
4525,JointPQPlayer,250,235,485,33,16,Player A
4526,JointPQPlayer,278,228,506,42,12,Player A
4527,JointPQPlayer,147,247,394,17,41,JointPQPlayer
4528,JointPQPlayer,292,192,484,32,16,Player A
4529,JointPQPlayer,232,232,464,30,22,Tie
4530,JointPQPlayer,287,187,474,31,19,Player A
4531,JointPQPlayer,301,186,487,32,15,Player A
4532,JointPQPlayer,290,200,490,38,16,Player A
4533,JointPQPlayer,293,203,496,35,13,Player A
4534,JointPQPlayer,264,239,503,42,13,Player A
4535,JointPQPlayer,156,221,377,15,46,JointPQPlayer
4536,JointPQPlayer,287,202,489,40,17,Player A
4537,JointPQPlayer,252,237,489,37,16,Player A
4538,JointPQPlayer,302,217,519,40,7,Player A
4539,JointPQPlayer,158,238,396,10,38,JointPQPlayer
4540,JointPQPlayer,244,199,443,27,28,Player A
4541,JointPQPlayer,139,259,398,12,38,JointPQPlayer
4542,JointPQPlayer,291,196,487,35,16,Player A
4543,JointPQPlayer,293,173,466,29,21,Player A
4544,JointPQPlayer,118,268,386,12,42,JointPQPlayer
4545,JointPQPlayer,120,265,385,8,41,JointPQPlayer
4546,JointPQPlayer,303,193,496,38,14,Player A
4547,JointPQPlayer,310,170,480,37,19,Player A
4548,JointPQPlayer,288,193,481,35,18,Player A
4549,JointPQPlayer,298,193,491,36,15,Player A
4550,JointPQPlayer,285,200,485,36,17,Player A
4551,JointPQPlayer,279,199,478,29,17,Player A
4552,JointPQPlayer,141,246,387,10,41,JointPQPlayer
4553,JointPQPlayer,277,207,484,29,15,Player A
4554,JointPQPlayer,259,219,478,35,19,Player A
4555,JointPQPlayer,242,227,469,26,19,Player A
4556,JointPQPlayer,229,189,418,23,35,Player A
4557,JointPQPlayer,293,193,486,37,17,Player A
4558,JointPQPlayer,267,202,469,26,19,Player A
4559,JointPQPlayer,257,207,464,30,22,Player A
4560,JointPQPlayer,300,175,475,35,20,Player A
4561,JointPQPlayer,303,168,471,25,18,Player A
4562,JointPQPlayer,145,260,405,16,37,JointPQPlayer
4563,JointPQPlayer,290,185,475,26,17,Player A
4564,JointPQPlayer,305,200,505,35,10,Player A
4565,JointPQPlayer,144,294,438,13,25,JointPQPlayer
4566,JointPQPlayer,279,204,483,31,16,Player A
4567,JointPQPlayer,280,175,455,27,24,Player A
4568,JointPQPlayer,283,213,496,29,11,Player A
4569,JointPQPlayer,187,252,439,20,27,JointPQPlayer
4570,JointPQPlayer,298,183,481,35,18,Player A
4571,JointPQPlayer,291,196,487,32,15,Player A
4572,JointPQPlayer,303,183,486,34,16,Player A
4573,JointPQPlayer,259,239,498,37,13,Player A
4574,JointPQPlayer,247,217,464,27,21,Player A
4575,JointPQPlayer,236,236,472,35,21,Tie
4576,JointPQPlayer,294,189,483,31,16,Player A
4577,JointPQPlayer,239,219,458,30,24,Player A
4578,JointPQPlayer,285,170,455,18,21,Player A
4579,JointPQPlayer,287,192,479,30,17,Player A
4580,JointPQPlayer,300,200,500,33,11,Player A
4581,JointPQPlayer,250,215,465,37,24,Player A
4582,JointPQPlayer,277,197,474,31,19,Player A
4583,JointPQPlayer,286,196,482,39,19,Player A
4584,JointPQPlayer,301,191,492,34,14,Player A
4585,JointPQPlayer,313,178,491,36,15,Player A
4586,JointPQPlayer,276,211,487,35,16,Player A
4587,JointPQPlayer,263,213,476,36,20,Player A
4588,JointPQPlayer,158,243,401,15,38,JointPQPlayer
4589,JointPQPlayer,282,202,484,35,17,Player A
4590,JointPQPlayer,200,235,435,19,28,JointPQPlayer
4591,JointPQPlayer,296,191,487,32,15,Player A
4592,JointPQPlayer,269,229,498,34,12,Player A
4593,JointPQPlayer,250,215,465,31,22,Player A
4594,JointPQPlayer,310,175,485,33,16,Player A
4595,JointPQPlayer,296,191,487,35,16,Player A
4596,JointPQPlayer,265,225,490,38,16,Player A
4597,JointPQPlayer,211,226,437,24,29,JointPQPlayer
4598,JointPQPlayer,130,250,380,12,44,JointPQPlayer
4599,JointPQPlayer,267,217,484,44,20,Player A
4600,JointPQPlayer,150,275,425,18,31,JointPQPlayer
4601,JointPQPlayer,275,210,485,33,16,Player A
4602,JointPQPlayer,313,188,501,37,12,Player A
4603,JointPQPlayer,130,255,385,11,42,JointPQPlayer
4604,JointPQPlayer,157,257,414,10,32,JointPQPlayer
4605,JointPQPlayer,260,200,460,29,23,Player A
4606,JointPQPlayer,278,198,476,33,19,Player A
4607,JointPQPlayer,298,168,466,23,19,Player A
4608,JointPQPlayer,142,237,379,11,44,JointPQPlayer
4609,JointPQPlayer,285,205,490,35,15,Player A
4610,JointPQPlayer,138,268,406,17,37,JointPQPlayer
4611,JointPQPlayer,320,180,500,39,13,Player A
4612,JointPQPlayer,279,194,473,36,21,Player A
4613,JointPQPlayer,278,213,491,33,14,Player A
4614,JointPQPlayer,296,201,497,39,14,Player A
4615,JointPQPlayer,232,207,439,23,28,Player A
4616,JointPQPlayer,301,206,507,34,9,Player A
4617,JointPQPlayer,320,160,480,28,16,Player A
4618,JointPQPlayer,306,186,492,34,14,Player A
4619,JointPQPlayer,157,267,424,17,31,JointPQPlayer
4620,JointPQPlayer,287,182,469,29,20,Player A
4621,JointPQPlayer,269,199,468,34,22,Player A
4622,JointPQPlayer,298,158,456,31,25,Player A
4623,JointPQPlayer,293,203,496,35,13,Player A
4624,JointPQPlayer,167,232,399,16,39,JointPQPlayer
4625,JointPQPlayer,303,183,486,31,15,Player A
4626,JointPQPlayer,253,243,496,35,13,Player A
4627,JointPQPlayer,267,217,484,38,18,Player A
4628,JointPQPlayer,306,206,512,39,9,Player A
4629,JointPQPlayer,284,179,463,35,24,Player A
4630,JointPQPlayer,160,265,425,21,32,JointPQPlayer
4631,JointPQPlayer,302,197,499,35,12,Player A
4632,JointPQPlayer,284,199,483,31,16,Player A
4633,JointPQPlayer,302,182,484,29,15,Player A
4634,JointPQPlayer,267,207,474,31,19,Player A
4635,JointPQPlayer,277,222,499,41,14,Player A
4636,JointPQPlayer,199,264,463,26,21,JointPQPlayer
4637,JointPQPlayer,290,185,475,32,19,Player A
4638,JointPQPlayer,324,189,513,49,12,Player A
4639,JointPQPlayer,309,184,493,41,16,Player A
4640,JointPQPlayer,307,177,484,38,18,Player A
4641,JointPQPlayer,316,176,492,34,14,Player A
4642,JointPQPlayer,156,276,432,16,28,JointPQPlayer
4643,JointPQPlayer,283,213,496,32,12,Player A
4644,JointPQPlayer,329,164,493,35,14,Player A
4645,JointPQPlayer,230,235,465,25,20,JointPQPlayer
4646,JointPQPlayer,294,184,478,32,18,Player A
4647,JointPQPlayer,264,204,468,28,20,Player A
4648,JointPQPlayer,292,197,489,37,16,Player A
4649,JointPQPlayer,215,275,490,35,15,JointPQPlayer
4650,JointPQPlayer,266,231,497,36,13,Player A
4651,JointPQPlayer,279,189,468,25,19,Player A
4652,JointPQPlayer,279,219,498,37,13,Player A
4653,JointPQPlayer,277,212,489,31,14,Player A
4654,JointPQPlayer,166,261,427,14,29,JointPQPlayer
4655,JointPQPlayer,285,225,510,43,11,Player A
4656,JointPQPlayer,177,207,384,7,41,JointPQPlayer
4657,JointPQPlayer,234,224,458,24,22,Player A
4658,JointPQPlayer,276,181,457,23,22,Player A
4659,JointPQPlayer,265,195,460,29,23,Player A
4660,JointPQPlayer,262,192,454,26,24,Player A
4661,JointPQPlayer,313,193,506,39,11,Player A
4662,JointPQPlayer,118,288,406,14,36,JointPQPlayer
4663,JointPQPlayer,131,276,407,9,34,JointPQPlayer
4664,JointPQPlayer,313,193,506,36,10,Player A
4665,JointPQPlayer,264,194,458,24,22,Player A
4666,JointPQPlayer,207,207,414,25,37,Tie
4667,JointPQPlayer,298,193,491,33,14,Player A
4668,JointPQPlayer,281,191,472,29,19,Player A
4669,JointPQPlayer,291,191,482,33,17,Player A
4670,JointPQPlayer,147,247,394,11,39,JointPQPlayer
4671,JointPQPlayer,264,194,458,27,23,Player A
4672,JointPQPlayer,307,197,504,31,9,Player A
4673,JointPQPlayer,152,292,444,19,25,JointPQPlayer
4674,JointPQPlayer,289,204,493,35,14,Player A
4675,JointPQPlayer,117,282,399,13,38,JointPQPlayer
4676,JointPQPlayer,270,240,510,46,12,Player A
4677,JointPQPlayer,252,217,469,26,19,Player A
4678,JointPQPlayer,220,235,455,24,23,JointPQPlayer
4679,JointPQPlayer,298,183,481,38,19,Player A
4680,JointPQPlayer,260,195,455,27,24,Player A
4681,JointPQPlayer,155,245,400,11,37,JointPQPlayer
4682,JointPQPlayer,271,201,472,35,21,Player A
4683,JointPQPlayer,162,257,419,18,33,JointPQPlayer
4684,JointPQPlayer,239,259,498,34,12,JointPQPlayer
4685,JointPQPlayer,169,244,413,15,34,JointPQPlayer
4686,JointPQPlayer,290,185,475,32,19,Player A
4687,JointPQPlayer,282,207,489,40,17,Player A
4688,JointPQPlayer,146,271,417,16,33,JointPQPlayer
4689,JointPQPlayer,291,176,467,30,21,Player A
4690,JointPQPlayer,287,212,499,41,14,Player A
4691,JointPQPlayer,317,172,489,37,16,Player A
4692,JointPQPlayer,243,203,446,30,28,Player A
4693,JointPQPlayer,276,216,492,34,14,Player A
4694,JointPQPlayer,299,169,468,34,22,Player A
4695,JointPQPlayer,233,238,471,28,19,JointPQPlayer
4696,JointPQPlayer,237,252,489,34,15,JointPQPlayer
4697,JointPQPlayer,127,272,399,13,38,JointPQPlayer
4698,JointPQPlayer,235,230,465,28,21,Player A
4699,JointPQPlayer,156,226,382,11,43,JointPQPlayer
4700,JointPQPlayer,319,184,503,36,11,Player A
4701,JointPQPlayer,308,198,506,30,8,Player A
4702,JointPQPlayer,227,212,439,20,27,Player A
4703,JointPQPlayer,285,185,470,30,20,Player A
4704,JointPQPlayer,301,186,487,35,16,Player A
4705,JointPQPlayer,272,202,474,31,19,Player A
4706,JointPQPlayer,159,254,413,18,35,JointPQPlayer
4707,JointPQPlayer,255,220,475,26,17,Player A
4708,JointPQPlayer,290,200,490,35,15,Player A
4709,JointPQPlayer,262,212,474,31,19,Player A
4710,JointPQPlayer,315,160,475,29,18,Player A
4711,JointPQPlayer,281,206,487,38,17,Player A
4712,JointPQPlayer,336,166,502,35,11,Player A
4713,JointPQPlayer,272,217,489,37,16,Player A
4714,JointPQPlayer,154,219,373,8,45,JointPQPlayer
4715,JointPQPlayer,282,197,479,36,19,Player A
4716,JointPQPlayer,180,225,405,10,35,JointPQPlayer
4717,JointPQPlayer,250,220,470,30,20,Player A
4718,JointPQPlayer,306,196,502,32,10,Player A
4719,JointPQPlayer,296,201,497,36,13,Player A
4720,JointPQPlayer,291,186,477,31,18,Player A
4721,JointPQPlayer,287,202,489,43,18,Player A
4722,JointPQPlayer,292,207,499,32,11,Player A
4723,JointPQPlayer,267,227,494,36,14,Player A
4724,JointPQPlayer,293,213,506,39,11,Player A
4725,JointPQPlayer,287,207,494,36,14,Player A
4726,JointPQPlayer,141,236,377,6,43,JointPQPlayer
4727,JointPQPlayer,239,229,468,28,20,Player A
4728,JointPQPlayer,260,225,485,36,17,Player A
4729,JointPQPlayer,293,203,496,35,13,Player A
4730,JointPQPlayer,285,215,500,39,13,Player A
4731,JointPQPlayer,324,174,498,40,14,Player A
4732,JointPQPlayer,280,205,485,39,18,Player A
4733,JointPQPlayer,323,178,501,31,10,Player A
4734,JointPQPlayer,284,179,463,26,21,Player A
4735,JointPQPlayer,311,181,492,37,15,Player A
4736,JointPQPlayer,169,224,393,13,40,JointPQPlayer
4737,JointPQPlayer,263,208,471,40,23,Player A
4738,JointPQPlayer,241,261,502,44,14,JointPQPlayer
4739,JointPQPlayer,294,209,503,42,13,Player A
4740,JointPQPlayer,325,185,510,43,11,Player A
4741,JointPQPlayer,280,210,490,41,17,Player A
4742,JointPQPlayer,336,166,502,35,11,Player A
4743,JointPQPlayer,326,191,517,32,5,Player A
4744,JointPQPlayer,290,200,490,35,15,Player A
4745,JointPQPlayer,146,241,387,7,40,JointPQPlayer
4746,JointPQPlayer,223,223,446,18,24,Tie
4747,JointPQPlayer,204,244,448,23,25,JointPQPlayer
4748,JointPQPlayer,318,153,471,28,19,Player A
4749,JointPQPlayer,292,212,504,43,13,Player A
4750,JointPQPlayer,292,192,484,32,16,Player A
4751,JointPQPlayer,278,198,476,33,19,Player A
4752,JointPQPlayer,172,227,399,13,38,JointPQPlayer
4753,JointPQPlayer,317,167,484,35,17,Player A
4754,JointPQPlayer,299,179,478,32,18,Player A
4755,JointPQPlayer,302,202,504,43,13,Player A
4756,JointPQPlayer,282,232,514,44,10,Player A
4757,JointPQPlayer,143,263,406,14,36,JointPQPlayer
4758,JointPQPlayer,286,201,487,35,16,Player A
4759,JointPQPlayer,308,188,496,35,13,Player A
4760,JointPQPlayer,301,161,462,22,20,Player A
4761,JointPQPlayer,295,185,480,37,19,Player A
4762,JointPQPlayer,228,253,481,35,18,JointPQPlayer
4763,JointPQPlayer,134,264,398,12,38,JointPQPlayer
4764,JointPQPlayer,127,272,399,13,38,JointPQPlayer
4765,JointPQPlayer,164,239,403,14,37,JointPQPlayer
4766,JointPQPlayer,321,176,497,36,13,Player A
4767,JointPQPlayer,305,190,495,31,12,Player A
4768,JointPQPlayer,290,185,475,29,18,Player A
4769,JointPQPlayer,274,184,458,33,25,Player A
4770,JointPQPlayer,154,229,383,9,42,JointPQPlayer
4771,JointPQPlayer,286,191,477,34,19,Player A
4772,JointPQPlayer,264,194,458,30,24,Player A
4773,JointPQPlayer,283,203,486,34,16,Player A
4774,JointPQPlayer,287,187,474,37,21,Player A
4775,JointPQPlayer,277,212,489,40,17,Player A
4776,JointPQPlayer,226,246,472,32,20,JointPQPlayer
4777,JointPQPlayer,291,196,487,38,17,Player A
4778,JointPQPlayer,299,199,498,40,14,Player A
4779,JointPQPlayer,290,190,480,28,16,Player A
4780,JointPQPlayer,318,168,486,31,15,Player A
4781,JointPQPlayer,272,222,494,42,16,Player A
4782,JointPQPlayer,287,192,479,33,18,Player A
4783,JointPQPlayer,260,220,480,37,19,Player A
4784,JointPQPlayer,313,193,506,42,12,Player A
4785,JointPQPlayer,173,223,396,16,40,JointPQPlayer
4786,JointPQPlayer,302,187,489,40,17,Player A
4787,JointPQPlayer,163,253,416,15,33,JointPQPlayer
4788,JointPQPlayer,273,183,456,28,24,Player A
4789,JointPQPlayer,275,200,475,32,19,Player A
4790,JointPQPlayer,241,231,472,26,18,Player A
4791,JointPQPlayer,313,168,481,32,17,Player A
4792,JointPQPlayer,213,223,436,23,29,JointPQPlayer
4793,JointPQPlayer,307,182,489,34,15,Player A
4794,JointPQPlayer,141,266,407,12,35,JointPQPlayer
4795,JointPQPlayer,122,287,409,14,35,JointPQPlayer
4796,JointPQPlayer,246,216,462,25,21,Player A
4797,JointPQPlayer,272,227,499,44,15,Player A
4798,JointPQPlayer,273,203,476,36,20,Player A
4799,JointPQPlayer,174,249,423,22,33,JointPQPlayer
4800,JointPQPlayer,169,234,403,14,37,JointPQPlayer
4801,JointPQPlayer,258,208,466,29,21,Player A
4802,JointPQPlayer,256,206,462,34,24,Player A
4803,JointPQPlayer,269,234,503,42,13,Player A
4804,JointPQPlayer,295,210,505,41,12,Player A
4805,JointPQPlayer,260,220,480,34,18,Player A
4806,JointPQPlayer,297,207,504,43,13,Player A
4807,JointPQPlayer,282,212,494,36,14,Player A
4808,JointPQPlayer,259,209,468,25,19,Player A
4809,JointPQPlayer,252,232,484,38,18,Player A
4810,JointPQPlayer,275,195,470,30,20,Player A
4811,JointPQPlayer,304,179,483,31,16,Player A
4812,JointPQPlayer,288,198,486,31,15,Player A
4813,JointPQPlayer,324,164,488,33,15,Player A
4814,JointPQPlayer,194,224,418,14,32,JointPQPlayer
4815,JointPQPlayer,283,223,506,33,9,Player A
4816,JointPQPlayer,312,197,509,39,10,Player A
4817,JointPQPlayer,280,205,485,27,14,Player A
4818,JointPQPlayer,253,243,496,35,13,Player A
4819,JointPQPlayer,297,187,484,26,14,Player A
4820,JointPQPlayer,303,183,486,31,15,Player A
4821,JointPQPlayer,158,253,411,16,35,JointPQPlayer
4822,JointPQPlayer,170,265,435,16,27,JointPQPlayer
4823,JointPQPlayer,287,182,469,26,19,Player A
4824,JointPQPlayer,284,209,493,35,14,Player A
4825,JointPQPlayer,152,237,389,18,43,JointPQPlayer
4826,JointPQPlayer,248,228,476,42,22,Player A
4827,JointPQPlayer,270,220,490,38,16,Player A
4828,JointPQPlayer,287,187,474,25,17,Player A
4829,JointPQPlayer,129,249,378,10,44,JointPQPlayer
4830,JointPQPlayer,237,232,469,32,21,Player A
4831,JointPQPlayer,188,238,426,22,32,JointPQPlayer
4832,JointPQPlayer,297,182,479,30,17,Player A
4833,JointPQPlayer,248,213,461,36,25,Player A
4834,JointPQPlayer,322,192,514,38,8,Player A
4835,JointPQPlayer,275,210,485,39,18,Player A
4836,JointPQPlayer,163,238,401,15,38,JointPQPlayer
4837,JointPQPlayer,327,177,504,34,10,Player A
4838,JointPQPlayer,162,252,414,19,35,JointPQPlayer
4839,JointPQPlayer,342,162,504,31,9,Player A
4840,JointPQPlayer,295,190,485,33,16,Player A
4841,JointPQPlayer,322,192,514,35,7,Player A
4842,JointPQPlayer,297,192,489,34,15,Player A
4843,JointPQPlayer,238,238,476,30,18,Tie
4844,JointPQPlayer,309,169,478,32,18,Player A
4845,JointPQPlayer,273,213,486,31,15,Player A
4846,JointPQPlayer,291,206,497,39,14,Player A
4847,JointPQPlayer,272,222,494,33,13,Player A
4848,JointPQPlayer,145,275,420,16,32,JointPQPlayer
4849,JointPQPlayer,298,188,486,37,17,Player A
4850,JointPQPlayer,324,184,508,41,11,Player A
4851,JointPQPlayer,282,217,499,35,12,Player A
4852,JointPQPlayer,275,200,475,38,21,Player A
4853,JointPQPlayer,282,197,479,30,17,Player A
4854,JointPQPlayer,138,258,396,13,39,JointPQPlayer
4855,JointPQPlayer,150,255,405,13,36,JointPQPlayer
4856,JointPQPlayer,286,201,487,35,16,Player A
4857,JointPQPlayer,158,268,426,13,29,JointPQPlayer
4858,JointPQPlayer,312,182,494,30,12,Player A
4859,JointPQPlayer,332,157,489,34,15,Player A
4860,JointPQPlayer,315,175,490,29,13,Player A
4861,JointPQPlayer,318,178,496,38,14,Player A
4862,JointPQPlayer,282,207,489,37,16,Player A
4863,JointPQPlayer,274,219,493,32,13,Player A
4864,JointPQPlayer,279,199,478,35,19,Player A
4865,JointPQPlayer,297,222,519,34,5,Player A
4866,JointPQPlayer,331,156,487,29,14,Player A
4867,JointPQPlayer,314,179,493,35,14,Player A
4868,JointPQPlayer,149,259,408,16,36,JointPQPlayer
4869,JointPQPlayer,311,176,487,35,16,Player A
4870,JointPQPlayer,296,171,467,36,23,Player A
4871,JointPQPlayer,313,173,486,31,15,Player A
4872,JointPQPlayer,281,201,482,39,19,Player A
4873,JointPQPlayer,185,265,450,22,24,JointPQPlayer
4874,JointPQPlayer,147,257,404,15,37,JointPQPlayer
4875,JointPQPlayer,303,193,496,35,13,Player A
4876,JointPQPlayer,286,221,507,40,11,Player A
4877,JointPQPlayer,138,298,436,20,28,JointPQPlayer
4878,JointPQPlayer,152,242,394,14,40,JointPQPlayer
4879,JointPQPlayer,317,182,499,29,10,Player A
4880,JointPQPlayer,302,202,504,43,13,Player A
4881,JointPQPlayer,257,217,474,34,20,Player A
4882,JointPQPlayer,279,199,478,32,18,Player A
4883,JointPQPlayer,280,200,480,28,16,Player A
4884,JointPQPlayer,292,187,479,27,16,Player A
4885,JointPQPlayer,278,203,481,32,17,Player A
4886,JointPQPlayer,281,211,492,28,12,Player A
4887,JointPQPlayer,327,177,504,43,13,Player A
4888,JointPQPlayer,291,191,482,36,18,Player A
4889,JointPQPlayer,295,190,485,39,18,Player A
4890,JointPQPlayer,319,179,498,34,12,Player A
4891,JointPQPlayer,328,163,491,36,15,Player A
4892,JointPQPlayer,310,190,500,33,11,Player A
4893,JointPQPlayer,238,223,461,27,22,Player A
4894,JointPQPlayer,302,162,464,24,20,Player A
4895,JointPQPlayer,288,198,486,28,14,Player A
4896,JointPQPlayer,162,247,409,14,35,JointPQPlayer
4897,JointPQPlayer,272,217,489,37,16,Player A
4898,JointPQPlayer,240,235,475,41,22,Player A
4899,JointPQPlayer,295,215,510,43,11,Player A
4900,JointPQPlayer,300,195,495,43,16,Player A
4901,JointPQPlayer,144,244,388,8,40,JointPQPlayer
4902,JointPQPlayer,257,197,454,23,23,Player A
4903,JointPQPlayer,216,231,447,34,29,JointPQPlayer
4904,JointPQPlayer,155,275,430,20,30,JointPQPlayer
4905,JointPQPlayer,281,211,492,40,16,Player A
4906,JointPQPlayer,163,238,401,12,37,JointPQPlayer
4907,JointPQPlayer,160,250,410,12,34,JointPQPlayer
4908,JointPQPlayer,161,251,412,17,35,JointPQPlayer
4909,JointPQPlayer,269,209,478,32,18,Player A
4910,JointPQPlayer,285,175,460,29,23,Player A
4911,JointPQPlayer,268,218,486,37,17,Player A
4912,JointPQPlayer,277,222,499,32,11,Player A
4913,JointPQPlayer,309,184,493,38,15,Player A
4914,JointPQPlayer,288,188,476,30,18,Player A
4915,JointPQPlayer,312,177,489,34,15,Player A
4916,JointPQPlayer,120,290,410,12,34,JointPQPlayer
4917,JointPQPlayer,232,242,474,31,19,JointPQPlayer
4918,JointPQPlayer,144,244,388,14,42,JointPQPlayer
4919,JointPQPlayer,302,172,474,34,20,Player A
4920,JointPQPlayer,278,198,476,36,20,Player A
4921,JointPQPlayer,320,175,495,31,12,Player A
4922,JointPQPlayer,292,172,464,33,23,Player A
4923,JointPQPlayer,274,194,468,34,22,Player A
4924,JointPQPlayer,258,223,481,29,16,Player A
4925,JointPQPlayer,273,228,501,31,10,Player A
4926,JointPQPlayer,272,212,484,32,16,Player A
4927,JointPQPlayer,301,186,487,35,16,Player A
4928,JointPQPlayer,255,210,465,31,22,Player A
4929,JointPQPlayer,122,267,389,12,41,JointPQPlayer
4930,JointPQPlayer,223,223,446,24,26,Tie
4931,JointPQPlayer,123,298,421,14,31,JointPQPlayer
4932,JointPQPlayer,271,221,492,34,14,Player A
4933,JointPQPlayer,274,214,488,39,17,Player A
4934,JointPQPlayer,300,180,480,31,17,Player A
4935,JointPQPlayer,303,168,471,34,21,Player A
4936,JointPQPlayer,109,314,423,16,31,JointPQPlayer
4937,JointPQPlayer,142,267,409,14,35,JointPQPlayer
4938,JointPQPlayer,252,217,469,38,23,Player A
4939,JointPQPlayer,156,246,402,13,37,JointPQPlayer
4940,JointPQPlayer,288,208,496,41,15,Player A
4941,JointPQPlayer,279,204,483,31,16,Player A
4942,JointPQPlayer,142,247,389,12,41,JointPQPlayer
4943,JointPQPlayer,288,183,471,31,20,Player A
4944,JointPQPlayer,272,217,489,37,16,Player A
4945,JointPQPlayer,307,187,494,33,13,Player A
4946,JointPQPlayer,270,210,480,34,18,Player A
4947,JointPQPlayer,120,290,410,9,33,JointPQPlayer
4948,JointPQPlayer,290,205,495,40,15,Player A
4949,JointPQPlayer,319,184,503,42,13,Player A
4950,JointPQPlayer,291,176,467,30,21,Player A
0,revTitforTat,258,193,451,26,25,Player A
1,revTitforTat,241,211,452,24,24,Player A
2,revTitforTat,219,229,448,26,26,revTitforTat
3,revTitforTat,290,170,460,20,20,Player A
4,revTitforTat,210,245,455,21,22,revTitforTat
5,revTitforTat,214,234,448,26,26,revTitforTat
6,revTitforTat,208,238,446,27,27,revTitforTat
7,revTitforTat,209,239,448,26,26,revTitforTat
8,revTitforTat,270,180,450,25,25,Player A
9,revTitforTat,240,210,450,25,25,Player A
10,revTitforTat,253,198,451,26,25,Player A
11,revTitforTat,244,204,448,26,26,Player A
12,revTitforTat,205,245,450,25,25,revTitforTat
13,revTitforTat,241,206,447,25,26,Player A
14,revTitforTat,232,227,459,22,21,Player A
15,revTitforTat,236,211,447,25,26,Player A
16,revTitforTat,212,237,449,27,26,revTitforTat
17,revTitforTat,214,234,448,26,26,revTitforTat
18,revTitforTat,242,202,444,28,28,Player A
19,revTitforTat,249,204,453,22,23,Player A
20,revTitforTat,204,249,453,25,24,revTitforTat
21,revTitforTat,252,197,449,24,25,Player A
22,revTitforTat,264,184,448,26,26,Player A
23,revTitforTat,252,197,449,27,26,Player A
24,revTitforTat,172,282,454,23,23,revTitforTat
25,revTitforTat,222,217,439,29,30,Player A
26,revTitforTat,240,200,440,30,30,Player A
27,revTitforTat,204,239,443,30,29,revTitforTat
28,revTitforTat,200,235,435,31,32,revTitforTat
29,revTitforTat,247,212,459,22,21,Player A
30,revTitforTat,226,226,452,24,24,Tie
31,revTitforTat,242,207,449,24,25,Player A
32,revTitforTat,251,201,452,24,24,Player A
33,revTitforTat,205,245,450,25,25,revTitforTat
34,revTitforTat,189,264,453,25,24,revTitforTat
35,revTitforTat,222,227,449,24,25,revTitforTat
36,revTitforTat,208,233,441,31,30,revTitforTat
37,revTitforTat,228,218,446,27,27,Player A
38,revTitforTat,244,199,443,27,28,Player A
39,revTitforTat,246,201,447,28,27,Player A
40,revTitforTat,187,267,454,23,23,revTitforTat
41,revTitforTat,224,224,448,26,26,Tie
42,revTitforTat,256,196,452,24,24,Player A
43,revTitforTat,213,243,456,22,22,revTitforTat
44,revTitforTat,222,227,449,24,25,revTitforTat
45,revTitforTat,210,240,450,25,25,revTitforTat
46,revTitforTat,229,219,448,26,26,Player A
47,revTitforTat,210,235,445,29,28,revTitforTat
48,revTitforTat,192,247,439,29,30,revTitforTat
49,revTitforTat,267,182,449,27,26,Player A
50,revTitforTat,217,237,454,23,23,revTitforTat
51,revTitforTat,185,270,455,21,22,revTitforTat
52,revTitforTat,224,234,458,21,21,revTitforTat
53,revTitforTat,229,214,443,30,29,Player A
54,revTitforTat,231,216,447,25,26,Player A
55,revTitforTat,169,289,458,21,21,revTitforTat
56,revTitforTat,231,211,442,29,29,Player A
57,revTitforTat,214,239,453,25,24,revTitforTat
58,revTitforTat,251,196,447,25,26,Player A
59,revTitforTat,184,264,448,26,26,revTitforTat
60,revTitforTat,212,232,444,28,28,revTitforTat
61,revTitforTat,224,229,453,25,24,revTitforTat
62,revTitforTat,234,214,448,26,26,Player A
63,revTitforTat,192,262,454,23,23,revTitforTat
64,revTitforTat,205,240,445,26,27,revTitforTat
0,PatternPlayer,229,194,423,28,35,Player A
1,PatternPlayer,225,230,455,24,23,PatternPlayer
2,PatternPlayer,217,247,464,27,21,PatternPlayer
3,PatternPlayer,225,230,455,24,23,PatternPlayer
4,PatternPlayer,228,228,456,22,22,Tie
5,PatternPlayer,232,212,444,22,26,Player A
6,PatternPlayer,224,229,453,25,24,PatternPlayer
7,PatternPlayer,227,217,444,25,27,Player A
8,PatternPlayer,222,227,449,27,26,PatternPlayer
9,PatternPlayer,228,228,456,22,22,Tie
10,PatternPlayer,224,219,443,27,28,Player A
11,PatternPlayer,218,243,461,27,22,PatternPlayer
12,PatternPlayer,224,229,453,25,24,PatternPlayer
13,PatternPlayer,232,212,444,22,26,Player A
14,PatternPlayer,224,229,453,25,24,PatternPlayer
15,PatternPlayer,236,211,447,19,24,Player A
16,PatternPlayer,221,226,447,28,27,PatternPlayer
17,PatternPlayer,212,247,459,31,24,PatternPlayer
18,PatternPlayer,221,231,452,27,25,PatternPlayer
19,PatternPlayer,224,219,443,27,28,Player A
20,PatternPlayer,219,249,468,25,19,PatternPlayer
21,PatternPlayer,223,228,451,26,25,PatternPlayer
22,PatternPlayer,210,245,455,33,26,PatternPlayer
23,PatternPlayer,218,238,456,28,24,PatternPlayer
24,PatternPlayer,217,252,469,26,19,PatternPlayer
25,PatternPlayer,235,210,445,20,25,Player A
26,PatternPlayer,209,254,463,32,23,PatternPlayer
27,PatternPlayer,223,223,446,27,27,Tie
28,PatternPlayer,208,278,486,28,14,PatternPlayer
29,PatternPlayer,227,202,429,28,33,Player A
30,PatternPlayer,219,239,458,27,23,PatternPlayer
31,PatternPlayer,209,264,473,30,19,PatternPlayer
32,PatternPlayer,230,215,445,23,26,Player A
33,PatternPlayer,232,207,439,23,28,Player A
34,PatternPlayer,223,218,441,28,29,Player A
35,PatternPlayer,219,234,453,28,25,PatternPlayer
36,PatternPlayer,224,219,443,27,28,Player A
37,PatternPlayer,227,227,454,23,23,Tie
38,PatternPlayer,218,243,461,27,22,PatternPlayer
39,PatternPlayer,225,215,440,27,29,Player A
40,PatternPlayer,213,248,461,30,23,PatternPlayer
41,PatternPlayer,220,230,450,28,26,PatternPlayer
42,PatternPlayer,229,224,453,22,23,Player A
43,PatternPlayer,223,238,461,24,21,PatternPlayer
44,PatternPlayer,207,267,474,31,19,PatternPlayer
45,PatternPlayer,233,213,446,21,25,Player A
46,PatternPlayer,229,209,438,25,29,Player A
47,PatternPlayer,225,225,450,25,25,Tie
48,PatternPlayer,225,225,450,25,25,Tie
49,PatternPlayer,217,222,439,32,31,PatternPlayer
50,PatternPlayer,233,188,421,26,35,Player A
51,PatternPlayer,217,232,449,30,27,PatternPlayer
52,PatternPlayer,224,219,443,27,28,Player A
53,PatternPlayer,222,232,454,26,24,PatternPlayer
54,PatternPlayer,225,220,445,26,27,Player A
55,PatternPlayer,228,213,441,25,28,Player A
56,PatternPlayer,230,215,445,23,26,Player A
57,PatternPlayer,226,231,457,23,22,PatternPlayer
58,PatternPlayer,227,227,454,23,23,Tie
59,PatternPlayer,223,218,441,28,29,Player A
60,PatternPlayer,233,203,436,23,29,Player A
61,PatternPlayer,227,237,464,21,19,PatternPlayer
62,PatternPlayer,226,221,447,25,26,Player A
63,PatternPlayer,219,249,468,25,19,PatternPlayer
64,PatternPlayer,218,233,451,29,26,PatternPlayer
65,PatternPlayer,218,243,461,27,22,PatternPlayer
66,PatternPlayer,213,243,456,31,25,PatternPlayer
67,PatternPlayer,223,213,436,29,31,Player A
68,PatternPlayer,231,216,447,22,25,Player A
69,PatternPlayer,224,224,448,26,26,Tie
70,PatternPlayer,227,217,444,25,27,Player A
71,PatternPlayer,222,232,454,26,24,PatternPlayer
72,PatternPlayer,234,204,438,22,28,Player A
73,PatternPlayer,213,253,466,29,21,PatternPlayer
74,PatternPlayer,238,198,436,20,28,Player A
75,PatternPlayer,214,254,468,28,20,PatternPlayer
76,PatternPlayer,224,229,453,25,24,PatternPlayer
77,PatternPlayer,224,244,468,22,18,PatternPlayer
78,PatternPlayer,237,187,424,23,33,Player A
79,PatternPlayer,215,240,455,30,25,PatternPlayer
80,PatternPlayer,227,212,439,26,29,Player A
81,PatternPlayer,235,210,445,20,25,Player A
82,PatternPlayer,204,264,468,34,22,PatternPlayer
83,PatternPlayer,214,239,453,31,26,PatternPlayer
84,PatternPlayer,220,245,465,25,20,PatternPlayer
85,PatternPlayer,225,220,445,26,27,Player A
86,PatternPlayer,233,203,436,23,29,Player A
87,PatternPlayer,217,237,454,29,25,PatternPlayer
88,PatternPlayer,221,216,437,30,31,Player A
89,PatternPlayer,214,254,468,28,20,PatternPlayer
90,PatternPlayer,220,235,455,27,24,PatternPlayer
91,PatternPlayer,230,215,445,23,26,Player A
92,PatternPlayer,228,218,446,24,26,Player A
93,PatternPlayer,228,213,441,25,28,Player A
94,PatternPlayer,227,222,449,24,25,Player A
95,PatternPlayer,227,212,439,26,29,Player A
96,PatternPlayer,219,234,453,28,25,PatternPlayer
97,PatternPlayer,234,209,443,21,26,Player A
98,PatternPlayer,206,266,472,32,20,PatternPlayer
99,PatternPlayer,213,253,466,29,21,PatternPlayer
100,PatternPlayer,232,217,449,21,24,Player A
101,PatternPlayer,229,219,448,23,25,Player A
102,PatternPlayer,222,237,459,25,22,PatternPlayer
103,PatternPlayer,230,205,435,25,30,Player A
104,PatternPlayer,220,230,450,28,26,PatternPlayer
105,PatternPlayer,223,248,471,22,17,PatternPlayer
106,PatternPlayer,220,230,450,28,26,PatternPlayer
107,PatternPlayer,232,222,454,20,22,Player A
108,PatternPlayer,225,215,440,27,29,Player A
109,PatternPlayer,233,213,446,21,25,Player A
110,PatternPlayer,214,234,448,32,28,PatternPlayer
111,PatternPlayer,235,210,445,20,25,Player A
112,PatternPlayer,227,232,459,22,21,PatternPlayer
113,PatternPlayer,222,242,464,24,20,PatternPlayer
114,PatternPlayer,227,222,449,24,25,Player A
115,PatternPlayer,229,229,458,21,21,Tie
116,PatternPlayer,224,229,453,25,24,PatternPlayer
117,PatternPlayer,234,214,448,20,24,Player A
118,PatternPlayer,226,216,442,26,28,Player A
119,PatternPlayer,220,225,445,29,28,PatternPlayer
120,PatternPlayer,235,205,440,21,27,Player A
121,PatternPlayer,220,230,450,28,26,PatternPlayer
122,PatternPlayer,218,223,441,31,30,PatternPlayer
123,PatternPlayer,227,212,439,26,29,Player A
124,PatternPlayer,202,252,454,38,28,PatternPlayer
125,PatternPlayer,216,246,462,28,22,PatternPlayer
126,PatternPlayer,232,217,449,21,24,Player A
127,PatternPlayer,229,229,458,21,21,Tie
128,PatternPlayer,213,258,471,28,19,PatternPlayer
129,PatternPlayer,229,204,433,26,31,Player A
130,PatternPlayer,231,216,447,22,25,Player A
131,PatternPlayer,230,225,455,21,22,Player A
132,PatternPlayer,229,219,448,23,25,Player A
133,PatternPlayer,226,216,442,26,28,Player A
134,PatternPlayer,215,250,465,28,21,PatternPlayer
135,PatternPlayer,227,222,449,24,25,Player A
136,PatternPlayer,222,217,439,29,30,Player A
137,PatternPlayer,221,246,467,24,19,PatternPlayer
138,PatternPlayer,225,245,470,21,17,PatternPlayer
139,PatternPlayer,242,182,424,20,32,Player A
140,PatternPlayer,226,226,452,24,24,Tie
141,PatternPlayer,223,223,446,27,27,Tie
142,PatternPlayer,230,215,445,23,26,Player A
143,PatternPlayer,231,211,442,23,27,Player A
144,PatternPlayer,227,232,459,22,21,PatternPlayer
145,PatternPlayer,228,203,431,27,32,Player A
146,PatternPlayer,230,190,420,28,36,Player A
147,PatternPlayer,232,212,444,22,26,Player A
148,PatternPlayer,226,226,452,24,24,Tie
149,PatternPlayer,248,178,426,16,30,Player A
150,PatternPlayer,232,212,444,22,26,Player A
151,PatternPlayer,232,212,444,22,26,Player A
152,PatternPlayer,220,230,450,28,26,PatternPlayer
153,PatternPlayer,225,230,455,24,23,PatternPlayer
154,PatternPlayer,215,260,475,26,17,PatternPlayer
155,PatternPlayer,231,206,437,24,29,Player A
156,PatternPlayer,219,224,443,30,29,PatternPlayer
157,PatternPlayer,235,205,440,21,27,Player A
158,PatternPlayer,214,244,458,30,24,PatternPlayer
159,PatternPlayer,225,225,450,25,25,Tie
160,PatternPlayer,224,229,453,25,24,PatternPlayer
161,PatternPlayer,222,237,459,25,22,PatternPlayer
162,PatternPlayer,213,258,471,28,19,PatternPlayer
163,PatternPlayer,227,222,449,24,25,Player A
164,PatternPlayer,225,225,450,25,25,Tie
165,PatternPlayer,218,233,451,29,26,PatternPlayer
166,PatternPlayer,225,225,450,25,25,Tie
167,PatternPlayer,222,227,449,27,26,PatternPlayer
168,PatternPlayer,208,258,466,32,22,PatternPlayer
169,PatternPlayer,232,202,434,24,30,Player A
170,PatternPlayer,235,210,445,20,25,Player A
171,PatternPlayer,220,220,440,30,30,Tie
172,PatternPlayer,227,217,444,25,27,Player A
173,PatternPlayer,224,229,453,25,24,PatternPlayer
174,PatternPlayer,233,208,441,22,27,Player A
175,PatternPlayer,220,230,450,28,26,PatternPlayer
176,PatternPlayer,222,227,449,27,26,PatternPlayer
177,PatternPlayer,231,201,432,25,31,Player A
178,PatternPlayer,225,225,450,25,25,Tie
179,PatternPlayer,233,208,441,22,27,Player A
180,PatternPlayer,213,248,461,30,23,PatternPlayer
181,PatternPlayer,214,234,448,32,28,PatternPlayer
182,PatternPlayer,223,228,451,26,25,PatternPlayer
183,PatternPlayer,217,242,459,28,23,PatternPlayer
184,PatternPlayer,212,242,454,32,26,PatternPlayer
185,PatternPlayer,215,240,455,30,25,PatternPlayer
186,PatternPlayer,221,236,457,26,23,PatternPlayer
187,PatternPlayer,219,234,453,28,25,PatternPlayer
188,PatternPlayer,219,234,453,28,25,PatternPlayer
189,PatternPlayer,238,203,441,19,26,Player A
190,PatternPlayer,229,209,438,25,29,Player A
191,PatternPlayer,211,246,457,32,25,PatternPlayer
192,PatternPlayer,229,219,448,23,25,Player A
193,PatternPlayer,251,171,422,15,31,Player A
194,PatternPlayer,231,211,442,23,27,Player A
195,PatternPlayer,214,239,453,31,26,PatternPlayer
196,PatternPlayer,219,239,458,27,23,PatternPlayer
197,PatternPlayer,225,230,455,24,23,PatternPlayer
198,PatternPlayer,229,214,443,24,27,Player A
199,PatternPlayer,217,247,464,27,21,PatternPlayer
200,PatternPlayer,217,242,459,28,23,PatternPlayer
201,PatternPlayer,240,190,430,20,30,Player A
202,PatternPlayer,216,246,462,28,22,PatternPlayer
203,PatternPlayer,225,230,455,24,23,PatternPlayer
204,PatternPlayer,215,240,455,30,25,PatternPlayer
205,PatternPlayer,211,256,467,30,21,PatternPlayer
206,PatternPlayer,227,207,434,27,31,Player A
207,PatternPlayer,232,212,444,22,26,Player A
208,PatternPlayer,215,250,465,28,21,PatternPlayer
209,PatternPlayer,231,201,432,25,31,Player A
210,PatternPlayer,227,212,439,26,29,Player A
211,PatternPlayer,214,244,458,30,24,PatternPlayer
212,PatternPlayer,220,220,440,30,30,Tie
213,PatternPlayer,227,212,439,26,29,Player A
214,PatternPlayer,232,207,439,23,28,Player A
215,PatternPlayer,230,215,445,23,26,Player A
216,PatternPlayer,219,234,453,28,25,PatternPlayer
217,PatternPlayer,225,215,440,27,29,Player A
218,PatternPlayer,210,245,455,33,26,PatternPlayer
219,PatternPlayer,223,233,456,25,23,PatternPlayer
220,PatternPlayer,224,224,448,26,26,Tie
221,PatternPlayer,218,238,456,28,24,PatternPlayer
222,PatternPlayer,218,238,456,28,24,PatternPlayer
223,PatternPlayer,223,228,451,26,25,PatternPlayer
224,PatternPlayer,217,222,439,32,31,PatternPlayer
225,PatternPlayer,218,238,456,28,24,PatternPlayer
226,PatternPlayer,229,219,448,23,25,Player A
227,PatternPlayer,239,194,433,20,29,Player A
228,PatternPlayer,226,216,442,26,28,Player A
229,PatternPlayer,224,229,453,25,24,PatternPlayer
230,PatternPlayer,220,235,455,27,24,PatternPlayer
231,PatternPlayer,231,206,437,24,29,Player A
232,PatternPlayer,234,209,443,21,26,Player A
233,PatternPlayer,221,226,447,28,27,PatternPlayer
234,PatternPlayer,230,210,440,24,28,Player A
235,PatternPlayer,220,230,450,28,26,PatternPlayer
236,PatternPlayer,226,246,472,20,16,PatternPlayer
237,PatternPlayer,225,215,440,27,29,Player A
238,PatternPlayer,229,214,443,24,27,Player A
239,PatternPlayer,232,202,434,24,30,Player A
240,PatternPlayer,228,218,446,24,26,Player A
241,PatternPlayer,227,222,449,24,25,Player A
242,PatternPlayer,232,207,439,23,28,Player A
243,PatternPlayer,236,201,437,21,28,Player A
244,PatternPlayer,240,200,440,18,26,Player A
245,PatternPlayer,235,205,440,21,27,Player A
246,PatternPlayer,230,210,440,24,28,Player A
247,PatternPlayer,220,235,455,27,24,PatternPlayer
248,PatternPlayer,207,262,469,32,21,PatternPlayer
249,PatternPlayer,224,219,443,27,28,Player A
250,PatternPlayer,232,222,454,20,22,Player A
251,PatternPlayer,237,187,424,23,33,Player A
252,PatternPlayer,236,201,437,21,28,Player A
253,PatternPlayer,204,259,463,35,24,PatternPlayer
254,PatternPlayer,209,269,478,29,17,PatternPlayer
255,PatternPlayer,238,203,441,19,26,Player A
256,PatternPlayer,239,209,448,17,23,Player A
257,PatternPlayer,224,234,458,24,22,PatternPlayer
258,PatternPlayer,206,251,457,35,26,PatternPlayer
259,PatternPlayer,213,243,456,31,25,PatternPlayer
260,PatternPlayer,223,223,446,27,27,Tie
261,PatternPlayer,216,246,462,28,22,PatternPlayer
262,PatternPlayer,245,185,430,17,29,Player A
263,PatternPlayer,228,218,446,24,26,Player A
264,PatternPlayer,221,221,442,29,29,Tie
265,PatternPlayer,221,231,452,27,25,PatternPlayer
266,PatternPlayer,222,237,459,25,22,PatternPlayer
267,PatternPlayer,229,214,443,24,27,Player A
268,PatternPlayer,229,224,453,22,23,Player A
269,PatternPlayer,235,210,445,20,25,Player A
270,PatternPlayer,211,256,467,30,21,PatternPlayer
271,PatternPlayer,214,249,463,29,22,PatternPlayer
272,PatternPlayer,222,237,459,25,22,PatternPlayer
273,PatternPlayer,207,267,474,31,19,PatternPlayer
274,PatternPlayer,219,234,453,28,25,PatternPlayer
275,PatternPlayer,218,253,471,25,18,PatternPlayer
276,PatternPlayer,214,244,458,30,24,PatternPlayer
277,PatternPlayer,224,234,458,24,22,PatternPlayer
278,PatternPlayer,218,253,471,25,18,PatternPlayer
279,PatternPlayer,215,265,480,25,15,PatternPlayer
280,PatternPlayer,226,206,432,28,32,Player A
281,PatternPlayer,236,206,442,20,26,Player A
282,PatternPlayer,232,217,449,21,24,Player A
283,PatternPlayer,242,202,444,16,24,Player A
284,PatternPlayer,222,242,464,24,20,PatternPlayer
285,PatternPlayer,234,214,448,20,24,Player A
286,PatternPlayer,224,234,458,24,22,PatternPlayer
287,PatternPlayer,228,223,451,23,24,Player A
288,PatternPlayer,233,203,436,23,29,Player A
289,PatternPlayer,227,232,459,22,21,PatternPlayer
290,PatternPlayer,220,235,455,27,24,PatternPlayer
291,PatternPlayer,215,235,450,31,27,PatternPlayer
292,PatternPlayer,213,243,456,31,25,PatternPlayer
293,PatternPlayer,226,231,457,23,22,PatternPlayer
294,PatternPlayer,225,220,445,26,27,Player A
295,PatternPlayer,237,207,444,19,25,Player A
296,PatternPlayer,224,219,443,27,28,Player A
297,PatternPlayer,227,227,454,23,23,Tie
298,PatternPlayer,224,219,443,27,28,Player A
299,PatternPlayer,234,204,438,22,28,Player A
300,PatternPlayer,230,215,445,23,26,Player A
301,PatternPlayer,222,237,459,25,22,PatternPlayer
302,PatternPlayer,240,200,440,18,26,Player A
303,PatternPlayer,222,217,439,29,30,Player A
304,PatternPlayer,228,223,451,23,24,Player A
305,PatternPlayer,226,226,452,24,24,Tie
306,PatternPlayer,238,198,436,20,28,Player A
307,PatternPlayer,216,246,462,28,22,PatternPlayer
308,PatternPlayer,239,199,438,19,27,Player A
309,PatternPlayer,214,259,473,27,18,PatternPlayer
310,PatternPlayer,223,233,456,25,23,PatternPlayer
311,PatternPlayer,243,193,436,17,27,Player A
312,PatternPlayer,210,260,470,30,20,PatternPlayer
313,PatternPlayer,224,229,453,25,24,PatternPlayer
314,PatternPlayer,216,256,472,26,18,PatternPlayer
315,PatternPlayer,238,213,451,17,22,Player A
316,PatternPlayer,233,208,441,22,27,Player A
317,PatternPlayer,218,248,466,26,20,PatternPlayer
318,PatternPlayer,227,237,464,21,19,PatternPlayer
319,PatternPlayer,221,241,462,25,21,PatternPlayer
320,PatternPlayer,223,223,446,27,27,Tie
321,PatternPlayer,224,239,463,23,20,PatternPlayer
322,PatternPlayer,213,248,461,30,23,PatternPlayer
323,PatternPlayer,215,245,460,29,23,PatternPlayer
324,PatternPlayer,218,253,471,25,18,PatternPlayer
325,PatternPlayer,240,200,440,18,26,Player A
326,PatternPlayer,230,210,440,24,28,Player A
327,PatternPlayer,227,217,444,25,27,Player A
328,PatternPlayer,222,227,449,27,26,PatternPlayer
329,PatternPlayer,224,229,453,25,24,PatternPlayer
330,PatternPlayer,226,226,452,24,24,Tie
331,PatternPlayer,229,219,448,23,25,Player A
332,PatternPlayer,231,211,442,23,27,Player A
333,PatternPlayer,223,243,466,23,19,PatternPlayer
334,PatternPlayer,217,232,449,30,27,PatternPlayer
335,PatternPlayer,224,234,458,24,22,PatternPlayer
336,PatternPlayer,215,255,470,27,19,PatternPlayer
337,PatternPlayer,216,236,452,30,26,PatternPlayer
338,PatternPlayer,226,226,452,24,24,Tie
339,PatternPlayer,231,206,437,24,29,Player A
340,PatternPlayer,217,247,464,27,21,PatternPlayer
341,PatternPlayer,210,250,460,32,24,PatternPlayer
342,PatternPlayer,210,260,470,30,20,PatternPlayer
343,PatternPlayer,219,239,458,27,23,PatternPlayer
344,PatternPlayer,229,219,448,23,25,Player A
345,PatternPlayer,235,205,440,21,27,Player A
346,PatternPlayer,210,265,475,29,18,PatternPlayer
347,PatternPlayer,227,227,454,23,23,Tie
348,PatternPlayer,224,219,443,27,28,Player A
349,PatternPlayer,227,217,444,25,27,Player A
350,PatternPlayer,225,220,445,26,27,Player A
351,PatternPlayer,224,229,453,25,24,PatternPlayer
352,PatternPlayer,203,273,476,33,19,PatternPlayer
353,PatternPlayer,216,246,462,28,22,PatternPlayer
354,PatternPlayer,230,225,455,21,22,Player A
355,PatternPlayer,234,204,438,22,28,Player A
356,PatternPlayer,230,220,450,22,24,Player A
357,PatternPlayer,231,206,437,24,29,Player A
358,PatternPlayer,226,231,457,23,22,PatternPlayer
359,PatternPlayer,235,220,455,18,21,Player A
360,PatternPlayer,238,198,436,20,28,Player A
361,PatternPlayer,216,236,452,30,26,PatternPlayer
362,PatternPlayer,214,254,468,28,20,PatternPlayer
363,PatternPlayer,226,216,442,26,28,Player A
364,PatternPlayer,230,195,425,27,34,Player A
365,PatternPlayer,228,223,451,23,24,Player A
366,PatternPlayer,203,273,476,33,19,PatternPlayer
367,PatternPlayer,240,190,430,20,30,Player A
368,PatternPlayer,222,242,464,24,20,PatternPlayer
369,PatternPlayer,228,228,456,22,22,Tie
370,PatternPlayer,222,222,444,28,28,Tie
371,PatternPlayer,241,186,427,20,31,Player A
372,PatternPlayer,212,242,454,32,26,PatternPlayer
373,PatternPlayer,223,233,456,25,23,PatternPlayer
374,PatternPlayer,224,224,448,26,26,Tie
375,PatternPlayer,220,230,450,28,26,PatternPlayer
376,PatternPlayer,227,232,459,22,21,PatternPlayer
377,PatternPlayer,224,224,448,26,26,Tie
378,PatternPlayer,223,208,431,30,33,Player A
379,PatternPlayer,220,235,455,27,24,PatternPlayer
380,PatternPlayer,230,215,445,23,26,Player A
381,PatternPlayer,231,226,457,20,21,Player A
382,PatternPlayer,225,225,450,25,25,Tie
383,PatternPlayer,231,206,437,24,29,Player A
384,PatternPlayer,221,236,457,26,23,PatternPlayer
385,PatternPlayer,220,230,450,28,26,PatternPlayer
386,PatternPlayer,222,232,454,26,24,PatternPlayer
387,PatternPlayer,225,220,445,26,27,Player A
388,PatternPlayer,219,224,443,30,29,PatternPlayer
389,PatternPlayer,232,217,449,21,24,Player A
390,PatternPlayer,240,185,425,21,32,Player A
391,PatternPlayer,219,224,443,30,29,PatternPlayer
392,PatternPlayer,213,258,471,28,19,PatternPlayer
393,PatternPlayer,226,231,457,23,22,PatternPlayer
394,PatternPlayer,232,207,439,23,28,Player A
395,PatternPlayer,225,225,450,25,25,Tie
396,PatternPlayer,214,244,458,30,24,PatternPlayer
397,PatternPlayer,222,232,454,26,24,PatternPlayer
398,PatternPlayer,229,204,433,26,31,Player A
399,PatternPlayer,225,225,450,25,25,Tie
400,PatternPlayer,218,223,441,31,30,PatternPlayer
401,PatternPlayer,224,224,448,26,26,Tie
402,PatternPlayer,223,238,461,24,21,PatternPlayer
403,PatternPlayer,239,209,448,17,23,Player A
404,PatternPlayer,221,236,457,26,23,PatternPlayer
405,PatternPlayer,232,227,459,19,20,Player A
406,PatternPlayer,227,222,449,24,25,Player A
407,PatternPlayer,232,212,444,22,26,Player A
408,PatternPlayer,218,243,461,27,22,PatternPlayer
409,PatternPlayer,220,235,455,27,24,PatternPlayer
410,PatternPlayer,249,184,433,14,27,Player A
411,PatternPlayer,235,195,430,23,31,Player A
412,PatternPlayer,223,243,466,23,19,PatternPlayer
413,PatternPlayer,208,243,451,35,28,PatternPlayer
414,PatternPlayer,228,218,446,24,26,Player A
415,PatternPlayer,231,211,442,23,27,Player A
416,PatternPlayer,229,229,458,21,21,Tie
417,PatternPlayer,229,214,443,24,27,Player A
418,PatternPlayer,218,238,456,28,24,PatternPlayer
419,PatternPlayer,235,210,445,20,25,Player A
420,PatternPlayer,226,211,437,27,30,Player A
421,PatternPlayer,227,222,449,24,25,Player A
422,PatternPlayer,232,202,434,24,30,Player A
423,PatternPlayer,223,248,471,22,17,PatternPlayer
424,PatternPlayer,222,237,459,25,22,PatternPlayer
425,PatternPlayer,235,200,435,22,29,Player A
426,PatternPlayer,232,217,449,21,24,Player A
427,PatternPlayer,221,236,457,26,23,PatternPlayer
428,PatternPlayer,221,231,452,27,25,PatternPlayer
429,PatternPlayer,231,216,447,22,25,Player A
430,PatternPlayer,245,200,445,14,23,Player A
431,PatternPlayer,246,186,432,16,28,Player A
432,PatternPlayer,223,233,456,25,23,PatternPlayer
433,PatternPlayer,206,271,477,31,18,PatternPlayer
434,PatternPlayer,225,220,445,26,27,Player A
435,PatternPlayer,223,228,451,26,25,PatternPlayer
436,PatternPlayer,211,241,452,33,27,PatternPlayer
437,PatternPlayer,237,197,434,21,29,Player A
438,PatternPlayer,219,244,463,26,21,PatternPlayer
439,PatternPlayer,227,232,459,22,21,PatternPlayer
440,PatternPlayer,230,225,455,21,22,Player A
441,PatternPlayer,217,257,474,25,17,PatternPlayer
442,PatternPlayer,222,242,464,24,20,PatternPlayer
443,PatternPlayer,229,209,438,25,29,Player A
444,PatternPlayer,214,264,478,26,16,PatternPlayer
445,PatternPlayer,224,219,443,27,28,Player A
446,PatternPlayer,221,236,457,26,23,PatternPlayer
447,PatternPlayer,217,227,444,31,29,PatternPlayer
448,PatternPlayer,218,253,471,25,18,PatternPlayer
449,PatternPlayer,222,227,449,27,26,PatternPlayer
450,PatternPlayer,218,248,466,26,20,PatternPlayer
451,PatternPlayer,227,207,434,27,31,Player A
452,PatternPlayer,225,215,440,27,29,Player A
453,PatternPlayer,236,201,437,21,28,Player A
454,PatternPlayer,211,251,462,31,23,PatternPlayer
455,PatternPlayer,221,236,457,26,23,PatternPlayer
456,PatternPlayer,230,225,455,21,22,Player A
457,PatternPlayer,225,240,465,22,19,PatternPlayer
458,PatternPlayer,222,227,449,27,26,PatternPlayer
459,PatternPlayer,220,235,455,27,24,PatternPlayer
460,PatternPlayer,229,219,448,23,25,Player A
461,PatternPlayer,245,175,420,19,33,Player A
462,PatternPlayer,232,207,439,23,28,Player A
463,PatternPlayer,221,241,462,25,21,PatternPlayer
464,PatternPlayer,230,225,455,21,22,Player A
465,PatternPlayer,227,217,444,25,27,Player A
466,PatternPlayer,227,222,449,24,25,Player A
467,PatternPlayer,226,216,442,26,28,Player A
468,PatternPlayer,224,224,448,26,26,Tie
469,PatternPlayer,227,217,444,25,27,Player A
470,PatternPlayer,220,215,435,31,32,Player A
471,PatternPlayer,231,206,437,24,29,Player A
472,PatternPlayer,229,209,438,25,29,Player A
473,PatternPlayer,223,238,461,24,21,PatternPlayer
474,PatternPlayer,223,228,451,26,25,PatternPlayer
475,PatternPlayer,219,244,463,26,21,PatternPlayer
476,PatternPlayer,238,193,431,21,30,Player A
477,PatternPlayer,227,232,459,22,21,PatternPlayer
478,PatternPlayer,223,218,441,28,29,Player A
479,PatternPlayer,221,236,457,26,23,PatternPlayer
480,PatternPlayer,220,225,445,29,28,PatternPlayer
481,PatternPlayer,232,202,434,24,30,Player A
0,GrudgePlayer,144,259,403,11,36,GrudgePlayer
1,GrudgePlayer,123,258,381,10,43,GrudgePlayer
2,GrudgePlayer,146,251,397,17,40,GrudgePlayer
3,GrudgePlayer,149,259,408,19,37,GrudgePlayer
4,GrudgePlayer,158,278,436,17,27,GrudgePlayer
5,GrudgePlayer,109,244,353,6,51,GrudgePlayer
6,GrudgePlayer,126,256,382,8,42,GrudgePlayer
7,GrudgePlayer,141,266,407,15,36,GrudgePlayer
8,GrudgePlayer,142,267,409,14,35,GrudgePlayer
9,GrudgePlayer,126,271,397,8,37,GrudgePlayer
10,GrudgePlayer,138,268,406,14,36,GrudgePlayer
11,GrudgePlayer,117,252,369,4,45,GrudgePlayer
12,GrudgePlayer,135,260,395,15,40,GrudgePlayer
13,GrudgePlayer,118,238,356,9,51,GrudgePlayer
14,GrudgePlayer,145,255,400,11,37,GrudgePlayer
15,GrudgePlayer,125,255,380,6,42,GrudgePlayer
16,GrudgePlayer,123,263,386,9,41,GrudgePlayer
17,GrudgePlayer,140,245,385,14,43,GrudgePlayer
18,GrudgePlayer,135,270,405,10,35,GrudgePlayer
19,GrudgePlayer,146,251,397,14,39,GrudgePlayer
20,GrudgePlayer,133,253,386,9,41,GrudgePlayer
21,GrudgePlayer,142,247,389,15,42,GrudgePlayer
22,GrudgePlayer,134,274,408,7,33,GrudgePlayer
23,GrudgePlayer,152,262,414,16,34,GrudgePlayer
24,GrudgePlayer,143,268,411,13,34,GrudgePlayer
25,GrudgePlayer,136,261,397,11,38,GrudgePlayer
26,GrudgePlayer,130,240,370,8,46,GrudgePlayer
27,GrudgePlayer,132,262,394,11,39,GrudgePlayer
28,GrudgePlayer,137,262,399,10,37,GrudgePlayer
29,GrudgePlayer,169,299,468,19,17,GrudgePlayer
30,GrudgePlayer,122,237,359,9,50,GrudgePlayer
31,GrudgePlayer,144,254,398,15,39,GrudgePlayer
32,GrudgePlayer,149,259,408,16,36,GrudgePlayer
33,GrudgePlayer,141,266,407,15,36,GrudgePlayer
34,GrudgePlayer,140,250,390,10,40,GrudgePlayer
35,GrudgePlayer,125,260,385,8,41,GrudgePlayer
36,GrudgePlayer,160,260,420,22,34,GrudgePlayer
37,GrudgePlayer,140,260,400,11,37,GrudgePlayer
38,GrudgePlayer,122,262,384,10,42,GrudgePlayer
39,GrudgePlayer,133,268,401,9,36,GrudgePlayer
40,GrudgePlayer,154,254,408,19,37,GrudgePlayer
41,GrudgePlayer,114,249,363,7,48,GrudgePlayer
42,GrudgePlayer,151,266,417,19,34,GrudgePlayer
43,GrudgePlayer,138,268,406,17,37,GrudgePlayer
44,GrudgePlayer,149,279,428,18,30,GrudgePlayer
45,GrudgePlayer,138,278,416,12,32,GrudgePlayer
46,GrudgePlayer,117,252,369,7,46,GrudgePlayer
47,GrudgePlayer,129,259,388,11,41,GrudgePlayer
48,GrudgePlayer,143,273,416,15,33,GrudgePlayer
49,GrudgePlayer,126,256,382,8,42,GrudgePlayer
50,GrudgePlayer,119,254,373,8,45,GrudgePlayer
51,GrudgePlayer,161,276,437,18,27,GrudgePlayer
52,GrudgePlayer,133,258,391,14,41,GrudgePlayer
53,GrudgePlayer,124,274,398,12,38,GrudgePlayer
54,GrudgePlayer,145,275,420,13,31,GrudgePlayer
55,GrudgePlayer,131,281,412,11,33,GrudgePlayer
56,GrudgePlayer,126,266,392,6,38,GrudgePlayer
57,GrudgePlayer,132,257,389,9,40,GrudgePlayer
58,GrudgePlayer,136,251,387,13,42,GrudgePlayer
59,GrudgePlayer,113,243,356,6,50,GrudgePlayer
60,GrudgePlayer,132,267,399,10,37,GrudgePlayer
61,GrudgePlayer,153,268,421,20,33,GrudgePlayer
62,GrudgePlayer,129,254,383,12,43,GrudgePlayer
63,GrudgePlayer,142,277,419,15,32,GrudgePlayer
64,GrudgePlayer,130,260,390,7,39,GrudgePlayer
65,GrudgePlayer,132,277,409,8,33,GrudgePlayer
66,GrudgePlayer,125,245,370,11,47,GrudgePlayer
67,GrudgePlayer,135,270,405,10,35,GrudgePlayer
68,GrudgePlayer,133,283,416,12,32,GrudgePlayer
69,GrudgePlayer,128,258,386,9,41,GrudgePlayer
70,GrudgePlayer,147,272,419,15,32,GrudgePlayer
71,GrudgePlayer,125,255,380,12,44,GrudgePlayer
72,GrudgePlayer,127,272,399,10,37,GrudgePlayer
73,GrudgePlayer,124,274,398,6,36,GrudgePlayer
74,GrudgePlayer,142,267,409,14,35,GrudgePlayer
75,GrudgePlayer,139,249,388,14,42,GrudgePlayer
76,GrudgePlayer,146,261,407,15,36,GrudgePlayer
77,GrudgePlayer,146,241,387,10,41,GrudgePlayer
78,GrudgePlayer,131,261,392,9,39,GrudgePlayer
79,GrudgePlayer,131,261,392,6,38,GrudgePlayer
80,GrudgePlayer,141,281,422,18,32,GrudgePlayer
81,GrudgePlayer,155,285,440,15,25,GrudgePlayer
82,GrudgePlayer,151,266,417,19,34,GrudgePlayer
83,GrudgePlayer,148,268,416,15,33,GrudgePlayer
84,GrudgePlayer,134,259,393,16,41,GrudgePlayer
85,GrudgePlayer,122,252,374,6,44,GrudgePlayer
86,GrudgePlayer,125,250,375,7,44,GrudgePlayer
87,GrudgePlayer,168,278,446,21,25,GrudgePlayer
88,GrudgePlayer,140,275,415,14,33,GrudgePlayer
89,GrudgePlayer,145,270,415,17,34,GrudgePlayer
90,GrudgePlayer,119,274,393,7,38,GrudgePlayer
91,GrudgePlayer,130,250,380,9,43,GrudgePlayer
92,GrudgePlayer,129,259,388,11,41,GrudgePlayer
93,GrudgePlayer,138,248,386,12,42,GrudgePlayer
94,GrudgePlayer,124,264,388,5,39,GrudgePlayer
95,GrudgePlayer,113,248,361,2,47,GrudgePlayer
96,GrudgePlayer,125,230,355,8,51,GrudgePlayer
97,GrudgePlayer,132,247,379,8,43,GrudgePlayer
98,GrudgePlayer,138,268,406,14,36,GrudgePlayer
99,GrudgePlayer,127,262,389,12,41,GrudgePlayer
100,GrudgePlayer,144,264,408,19,37,GrudgePlayer
101,GrudgePlayer,121,266,387,7,40,GrudgePlayer
102,GrudgePlayer,179,284,463,26,21,GrudgePlayer
103,GrudgePlayer,117,277,394,5,37,GrudgePlayer
104,GrudgePlayer,134,279,413,12,33,GrudgePlayer
105,GrudgePlayer,126,286,412,5,31,GrudgePlayer
106,GrudgePlayer,112,237,349,5,52,GrudgePlayer
107,GrudgePlayer,136,266,402,13,37,GrudgePlayer
108,GrudgePlayer,152,282,434,18,28,GrudgePlayer
109,GrudgePlayer,125,250,375,7,44,GrudgePlayer
110,GrudgePlayer,146,251,397,11,38,GrudgePlayer
111,GrudgePlayer,109,234,343,2,53,GrudgePlayer
112,GrudgePlayer,109,254,363,4,47,GrudgePlayer
113,GrudgePlayer,147,277,424,14,30,GrudgePlayer
114,GrudgePlayer,139,239,378,13,45,GrudgePlayer
115,GrudgePlayer,143,273,416,18,34,GrudgePlayer
116,GrudgePlayer,107,237,344,3,53,GrudgePlayer
117,GrudgePlayer,141,281,422,15,31,GrudgePlayer
118,GrudgePlayer,133,283,416,12,32,GrudgePlayer
119,GrudgePlayer,136,276,412,11,33,GrudgePlayer
120,GrudgePlayer,107,262,369,1,44,GrudgePlayer
121,GrudgePlayer,168,283,451,20,23,GrudgePlayer
122,GrudgePlayer,133,278,411,16,35,GrudgePlayer
123,GrudgePlayer,143,253,396,16,40,GrudgePlayer
124,GrudgePlayer,144,264,408,16,36,GrudgePlayer
125,GrudgePlayer,142,252,394,11,39,GrudgePlayer
126,GrudgePlayer,158,283,441,22,27,GrudgePlayer
127,GrudgePlayer,147,272,419,21,34,GrudgePlayer
128,GrudgePlayer,159,279,438,16,26,GrudgePlayer
129,GrudgePlayer,134,264,398,12,38,GrudgePlayer
130,GrudgePlayer,127,252,379,8,43,GrudgePlayer
131,GrudgePlayer,133,263,396,13,39,GrudgePlayer
132,GrudgePlayer,141,266,407,12,35,GrudgePlayer
133,GrudgePlayer,128,248,376,5,43,GrudgePlayer
134,GrudgePlayer,129,259,388,14,42,GrudgePlayer
135,GrudgePlayer,132,272,404,6,34,GrudgePlayer
136,GrudgePlayer,151,261,412,17,35,GrudgePlayer
137,GrudgePlayer,141,256,397,14,39,GrudgePlayer
138,GrudgePlayer,138,248,386,9,41,GrudgePlayer
139,GrudgePlayer,129,274,403,8,35,GrudgePlayer
140,GrudgePlayer,150,260,410,15,35,GrudgePlayer
141,GrudgePlayer,128,273,401,9,36,GrudgePlayer
142,GrudgePlayer,149,274,423,13,30,GrudgePlayer
143,GrudgePlayer,140,285,425,15,30,GrudgePlayer
144,GrudgePlayer,156,286,442,14,24,GrudgePlayer
145,GrudgePlayer,191,276,467,33,22,GrudgePlayer
146,GrudgePlayer,148,258,406,20,38,GrudgePlayer
147,GrudgePlayer,134,259,393,10,39,GrudgePlayer
148,GrudgePlayer,152,272,424,23,33,GrudgePlayer
149,GrudgePlayer,141,271,412,8,32,GrudgePlayer
150,GrudgePlayer,146,256,402,16,38,GrudgePlayer
151,GrudgePlayer,141,256,397,14,39,GrudgePlayer
152,GrudgePlayer,133,263,396,13,39,GrudgePlayer
153,GrudgePlayer,131,261,392,12,40,GrudgePlayer
154,GrudgePlayer,160,270,430,17,29,GrudgePlayer
155,GrudgePlayer,112,252,364,5,47,GrudgePlayer
156,GrudgePlayer,173,278,451,23,24,GrudgePlayer
157,GrudgePlayer,130,255,385,11,42,GrudgePlayer
158,GrudgePlayer,161,281,442,20,26,GrudgePlayer
159,GrudgePlayer,134,254,388,11,41,GrudgePlayer
160,GrudgePlayer,131,246,377,9,44,GrudgePlayer
161,GrudgePlayer,133,263,396,10,38,GrudgePlayer
162,GrudgePlayer,142,257,399,13,38,GrudgePlayer
163,GrudgePlayer,132,267,399,13,38,GrudgePlayer
164,GrudgePlayer,150,260,410,18,36,GrudgePlayer
165,GrudgePlayer,141,261,402,13,37,GrudgePlayer
166,GrudgePlayer,124,244,368,9,47,GrudgePlayer
167,GrudgePlayer,145,250,395,15,40,GrudgePlayer
168,GrudgePlayer,144,259,403,14,37,GrudgePlayer
169,GrudgePlayer,134,264,398,15,39,GrudgePlayer
170,GrudgePlayer,173,283,456,22,22,GrudgePlayer
171,GrudgePlayer,117,252,369,7,46,GrudgePlayer
172,GrudgePlayer,123,248,371,9,46,GrudgePlayer
173,GrudgePlayer,114,254,368,6,46,GrudgePlayer
174,GrudgePlayer,131,256,387,13,42,GrudgePlayer
175,GrudgePlayer,127,272,399,7,36,GrudgePlayer
176,GrudgePlayer,152,267,419,18,33,GrudgePlayer
177,GrudgePlayer,140,270,410,12,34,GrudgePlayer
178,GrudgePlayer,122,257,379,5,42,GrudgePlayer
179,GrudgePlayer,144,264,408,13,35,GrudgePlayer
180,GrudgePlayer,133,263,396,13,39,GrudgePlayer
181,GrudgePlayer,136,261,397,11,38,GrudgePlayer
182,GrudgePlayer,148,248,396,19,41,GrudgePlayer
183,GrudgePlayer,147,252,399,16,39,GrudgePlayer
184,GrudgePlayer,138,253,391,11,40,GrudgePlayer
185,GrudgePlayer,154,249,403,14,37,GrudgePlayer
186,GrudgePlayer,149,274,423,22,33,GrudgePlayer
187,GrudgePlayer,168,273,441,25,28,GrudgePlayer
188,GrudgePlayer,155,275,430,17,29,GrudgePlayer
189,GrudgePlayer,139,279,418,14,32,GrudgePlayer
190,GrudgePlayer,145,250,395,15,40,GrudgePlayer
191,GrudgePlayer,139,259,398,12,38,GrudgePlayer
192,GrudgePlayer,139,269,408,7,33,GrudgePlayer
193,GrudgePlayer,135,255,390,10,40,GrudgePlayer
194,GrudgePlayer,156,291,447,19,24,GrudgePlayer
195,GrudgePlayer,164,254,418,20,34,GrudgePlayer
196,GrudgePlayer,142,252,394,14,40,GrudgePlayer
197,GrudgePlayer,149,264,413,18,35,GrudgePlayer
198,GrudgePlayer,120,260,380,6,42,GrudgePlayer
199,GrudgePlayer,130,255,385,11,42,GrudgePlayer
200,GrudgePlayer,134,269,403,8,35,GrudgePlayer
201,GrudgePlayer,140,265,405,16,37,GrudgePlayer
202,GrudgePlayer,131,266,397,11,38,GrudgePlayer
203,GrudgePlayer,137,272,409,11,34,GrudgePlayer
204,GrudgePlayer,143,273,416,12,32,GrudgePlayer
205,GrudgePlayer,115,255,370,5,45,GrudgePlayer
206,GrudgePlayer,129,269,398,9,37,GrudgePlayer
207,GrudgePlayer,129,269,398,12,38,GrudgePlayer
208,GrudgePlayer,125,255,380,9,43,GrudgePlayer
209,GrudgePlayer,169,264,433,23,30,GrudgePlayer
210,GrudgePlayer,144,264,408,10,34,GrudgePlayer
211,GrudgePlayer,117,247,364,8,48,GrudgePlayer
212,GrudgePlayer,138,258,396,13,39,GrudgePlayer
213,GrudgePlayer,144,279,423,16,31,GrudgePlayer
214,GrudgePlayer,141,251,392,12,40,GrudgePlayer
215,GrudgePlayer,125,245,370,8,46,GrudgePlayer
216,GrudgePlayer,135,275,410,12,34,GrudgePlayer
217,GrudgePlayer,128,243,371,9,46,GrudgePlayer
218,GrudgePlayer,140,250,390,10,40,GrudgePlayer
219,GrudgePlayer,134,274,408,10,34,GrudgePlayer
220,GrudgePlayer,120,250,370,8,46,GrudgePlayer
221,GrudgePlayer,120,270,390,10,40,GrudgePlayer
222,GrudgePlayer,147,277,424,17,31,GrudgePlayer
223,GrudgePlayer,140,255,395,15,40,GrudgePlayer
224,GrudgePlayer,118,233,351,7,52,GrudgePlayer
225,GrudgePlayer,150,285,435,19,28,GrudgePlayer
226,GrudgePlayer,148,273,421,17,32,GrudgePlayer
227,GrudgePlayer,147,262,409,17,36,GrudgePlayer
228,GrudgePlayer,150,280,430,20,30,GrudgePlayer
229,GrudgePlayer,149,259,408,16,36,GrudgePlayer
230,GrudgePlayer,128,263,391,8,39,GrudgePlayer
231,GrudgePlayer,140,245,385,14,43,GrudgePlayer
232,GrudgePlayer,152,262,414,13,33,GrudgePlayer
233,GrudgePlayer,144,269,413,12,33,GrudgePlayer
234,GrudgePlayer,140,265,405,16,37,GrudgePlayer
235,GrudgePlayer,109,249,358,2,48,GrudgePlayer
236,GrudgePlayer,153,268,421,14,31,GrudgePlayer
237,GrudgePlayer,135,255,390,7,39,GrudgePlayer
238,GrudgePlayer,130,275,405,10,35,GrudgePlayer
239,GrudgePlayer,140,265,405,13,36,GrudgePlayer
240,GrudgePlayer,142,252,394,11,39,GrudgePlayer
241,GrudgePlayer,135,260,395,15,40,GrudgePlayer
242,GrudgePlayer,130,255,385,8,41,GrudgePlayer
243,GrudgePlayer,139,249,388,17,43,GrudgePlayer
244,GrudgePlayer,137,267,404,12,36,GrudgePlayer
245,GrudgePlayer,151,271,422,15,31,GrudgePlayer
246,GrudgePlayer,155,260,415,17,34,GrudgePlayer
247,GrudgePlayer,138,268,406,11,35,GrudgePlayer
248,GrudgePlayer,150,260,410,15,35,GrudgePlayer
249,GrudgePlayer,142,242,384,13,43,GrudgePlayer
250,GrudgePlayer,128,263,391,8,39,GrudgePlayer
251,GrudgePlayer,136,256,392,12,40,GrudgePlayer
252,GrudgePlayer,128,238,366,10,48,GrudgePlayer
253,GrudgePlayer,142,252,394,14,40,GrudgePlayer
254,GrudgePlayer,144,269,413,15,34,GrudgePlayer
255,GrudgePlayer,131,261,392,12,40,GrudgePlayer
256,GrudgePlayer,142,267,409,11,34,GrudgePlayer
257,GrudgePlayer,143,283,426,13,29,GrudgePlayer
258,GrudgePlayer,139,274,413,15,34,GrudgePlayer
259,GrudgePlayer,128,238,366,10,48,GrudgePlayer
260,GrudgePlayer,119,254,373,8,45,GrudgePlayer
261,GrudgePlayer,147,282,429,13,28,GrudgePlayer
262,GrudgePlayer,141,251,392,9,39,GrudgePlayer
263,GrudgePlayer,138,268,406,14,36,GrudgePlayer
264,GrudgePlayer,155,270,425,18,31,GrudgePlayer
265,GrudgePlayer,118,263,381,4,41,GrudgePlayer
266,GrudgePlayer,131,256,387,10,41,GrudgePlayer
267,GrudgePlayer,143,268,411,13,34,GrudgePlayer
268,GrudgePlayer,169,264,433,26,31,GrudgePlayer
269,GrudgePlayer,144,259,403,14,37,GrudgePlayer
270,GrudgePlayer,140,270,410,9,33,GrudgePlayer
271,GrudgePlayer,127,257,384,7,41,GrudgePlayer
272,GrudgePlayer,156,266,422,18,32,GrudgePlayer
273,GrudgePlayer,121,261,382,5,41,GrudgePlayer
274,GrudgePlayer,142,262,404,18,38,GrudgePlayer
275,GrudgePlayer,127,257,384,13,43,GrudgePlayer
276,GrudgePlayer,139,269,408,10,34,GrudgePlayer
277,GrudgePlayer,158,268,426,16,30,GrudgePlayer
278,GrudgePlayer,133,258,391,11,40,GrudgePlayer
279,GrudgePlayer,127,257,384,10,42,GrudgePlayer
280,GrudgePlayer,118,263,381,7,42,GrudgePlayer
281,GrudgePlayer,118,273,391,5,38,GrudgePlayer
282,GrudgePlayer,160,280,440,18,26,GrudgePlayer
283,GrudgePlayer,137,262,399,16,39,GrudgePlayer
284,GrudgePlayer,115,255,370,5,45,GrudgePlayer
285,GrudgePlayer,145,260,405,19,38,GrudgePlayer
286,GrudgePlayer,138,268,406,11,35,GrudgePlayer
287,GrudgePlayer,154,259,413,24,37,GrudgePlayer
288,GrudgePlayer,127,257,384,7,41,GrudgePlayer
289,GrudgePlayer,151,246,397,14,39,GrudgePlayer
290,GrudgePlayer,120,245,365,9,48,GrudgePlayer
291,GrudgePlayer,131,246,377,12,45,GrudgePlayer
292,GrudgePlayer,146,276,422,15,31,GrudgePlayer
293,GrudgePlayer,152,287,439,14,25,GrudgePlayer
294,GrudgePlayer,122,232,354,7,51,GrudgePlayer
295,GrudgePlayer,159,274,433,17,28,GrudgePlayer
296,GrudgePlayer,139,269,408,13,35,GrudgePlayer
297,GrudgePlayer,147,257,404,15,37,GrudgePlayer
298,GrudgePlayer,150,260,410,18,36,GrudgePlayer
299,GrudgePlayer,134,249,383,9,42,GrudgePlayer
300,GrudgePlayer,134,254,388,11,41,GrudgePlayer
301,GrudgePlayer,132,262,394,14,40,GrudgePlayer
302,GrudgePlayer,117,247,364,8,48,GrudgePlayer
303,GrudgePlayer,157,277,434,18,28,GrudgePlayer
304,GrudgePlayer,148,288,436,17,27,GrudgePlayer
305,GrudgePlayer,127,267,394,14,40,GrudgePlayer
306,GrudgePlayer,142,262,404,12,36,GrudgePlayer
307,GrudgePlayer,140,260,400,14,38,GrudgePlayer
308,GrudgePlayer,142,262,404,15,37,GrudgePlayer
309,GrudgePlayer,144,269,413,15,34,GrudgePlayer
310,GrudgePlayer,144,274,418,11,31,GrudgePlayer
311,GrudgePlayer,139,264,403,14,37,GrudgePlayer
312,GrudgePlayer,125,265,390,13,41,GrudgePlayer
313,GrudgePlayer,144,254,398,18,40,GrudgePlayer
314,GrudgePlayer,119,254,373,5,44,GrudgePlayer
315,GrudgePlayer,129,254,383,12,43,GrudgePlayer
316,GrudgePlayer,150,265,415,14,33,GrudgePlayer
317,GrudgePlayer,159,289,448,17,23,GrudgePlayer
318,GrudgePlayer,125,270,395,6,37,GrudgePlayer
319,GrudgePlayer,126,231,357,4,49,GrudgePlayer
320,GrudgePlayer,128,258,386,15,43,GrudgePlayer
321,GrudgePlayer,165,270,435,25,30,GrudgePlayer
322,GrudgePlayer,124,229,353,9,52,GrudgePlayer
323,GrudgePlayer,152,272,424,14,30,GrudgePlayer
324,GrudgePlayer,156,266,422,18,32,GrudgePlayer
325,GrudgePlayer,140,255,395,12,39,GrudgePlayer
326,GrudgePlayer,144,274,418,14,32,GrudgePlayer
327,GrudgePlayer,135,260,395,9,38,GrudgePlayer
328,GrudgePlayer,135,280,415,11,32,GrudgePlayer
329,GrudgePlayer,136,261,397,11,38,GrudgePlayer
330,GrudgePlayer,124,249,373,8,45,GrudgePlayer
331,GrudgePlayer,146,256,402,13,37,GrudgePlayer
332,GrudgePlayer,148,268,416,12,32,GrudgePlayer
333,GrudgePlayer,154,284,438,16,26,GrudgePlayer
334,GrudgePlayer,144,269,413,18,35,GrudgePlayer
335,GrudgePlayer,176,271,447,25,26,GrudgePlayer
336,GrudgePlayer,150,275,425,18,31,GrudgePlayer
337,GrudgePlayer,154,279,433,17,28,GrudgePlayer
338,GrudgePlayer,115,270,385,8,41,GrudgePlayer
339,GrudgePlayer,154,274,428,15,29,GrudgePlayer
340,GrudgePlayer,134,259,393,7,38,GrudgePlayer
341,GrudgePlayer,125,260,385,11,42,GrudgePlayer
342,GrudgePlayer,135,265,400,14,38,GrudgePlayer
343,GrudgePlayer,116,256,372,7,45,GrudgePlayer
344,GrudgePlayer,156,281,437,21,28,GrudgePlayer
345,GrudgePlayer,156,261,417,19,34,GrudgePlayer
346,GrudgePlayer,140,270,410,15,35,GrudgePlayer
347,GrudgePlayer,130,270,400,11,37,GrudgePlayer
348,GrudgePlayer,133,263,396,10,38,GrudgePlayer
349,GrudgePlayer,120,260,380,6,42,GrudgePlayer
350,GrudgePlayer,117,262,379,5,42,GrudgePlayer
351,GrudgePlayer,104,239,343,5,54,GrudgePlayer
352,GrudgePlayer,136,251,387,13,42,GrudgePlayer
353,GrudgePlayer,169,274,443,24,27,GrudgePlayer
354,GrudgePlayer,168,268,436,23,29,GrudgePlayer
355,GrudgePlayer,130,245,375,10,45,GrudgePlayer
356,GrudgePlayer,129,234,363,7,48,GrudgePlayer
357,GrudgePlayer,126,251,377,9,44,GrudgePlayer
358,GrudgePlayer,146,276,422,15,31,GrudgePlayer
359,GrudgePlayer,164,244,408,19,37,GrudgePlayer
360,GrudgePlayer,128,263,391,11,40,GrudgePlayer
361,GrudgePlayer,131,251,382,8,42,GrudgePlayer
362,GrudgePlayer,141,266,407,18,37,GrudgePlayer
363,GrudgePlayer,150,265,415,17,34,GrudgePlayer
364,GrudgePlayer,138,253,391,8,39,GrudgePlayer
365,GrudgePlayer,139,254,393,13,40,GrudgePlayer
366,GrudgePlayer,142,267,409,20,37,GrudgePlayer
367,GrudgePlayer,148,268,416,18,34,GrudgePlayer
368,GrudgePlayer,156,286,442,23,27,GrudgePlayer
369,GrudgePlayer,125,245,370,8,46,GrudgePlayer
370,GrudgePlayer,140,265,405,16,37,GrudgePlayer
371,GrudgePlayer,152,262,414,16,34,GrudgePlayer
372,GrudgePlayer,126,271,397,11,38,GrudgePlayer
373,GrudgePlayer,129,254,383,9,42,GrudgePlayer
374,GrudgePlayer,160,275,435,22,29,GrudgePlayer
375,GrudgePlayer,164,284,448,23,25,GrudgePlayer
376,GrudgePlayer,137,262,399,10,37,GrudgePlayer
377,GrudgePlayer,136,261,397,8,37,GrudgePlayer
378,GrudgePlayer,113,253,366,4,46,GrudgePlayer
379,GrudgePlayer,136,251,387,16,43,GrudgePlayer
380,GrudgePlayer,120,265,385,5,40,GrudgePlayer
381,GrudgePlayer,144,269,413,12,33,GrudgePlayer
382,GrudgePlayer,127,267,394,11,39,GrudgePlayer
383,GrudgePlayer,142,257,399,13,38,GrudgePlayer
384,GrudgePlayer,152,272,424,17,31,GrudgePlayer
385,GrudgePlayer,131,266,397,8,37,GrudgePlayer
386,GrudgePlayer,121,251,372,4,44,GrudgePlayer
387,GrudgePlayer,146,261,407,12,35,GrudgePlayer
388,GrudgePlayer,133,263,396,7,37,GrudgePlayer
389,GrudgePlayer,120,225,345,7,54,GrudgePlayer
390,GrudgePlayer,119,269,388,8,40,GrudgePlayer
391,GrudgePlayer,142,262,404,12,36,GrudgePlayer
392,GrudgePlayer,144,259,403,14,37,GrudgePlayer
393,GrudgePlayer,127,267,394,11,39,GrudgePlayer
394,GrudgePlayer,142,272,414,16,34,GrudgePlayer
395,GrudgePlayer,152,257,409,14,35,GrudgePlayer
396,GrudgePlayer,128,253,381,13,44,GrudgePlayer
397,GrudgePlayer,113,258,371,3,44,GrudgePlayer
398,GrudgePlayer,158,288,446,21,25,GrudgePlayer
399,GrudgePlayer,153,278,431,15,28,GrudgePlayer
400,GrudgePlayer,143,258,401,12,37,GrudgePlayer
401,GrudgePlayer,128,253,381,7,42,GrudgePlayer
402,GrudgePlayer,135,280,415,11,32,GrudgePlayer
403,GrudgePlayer,137,262,399,7,36,GrudgePlayer
404,GrudgePlayer,138,268,406,11,35,GrudgePlayer
405,GrudgePlayer,126,251,377,9,44,GrudgePlayer
406,GrudgePlayer,128,248,376,8,44,GrudgePlayer
407,GrudgePlayer,140,275,415,14,33,GrudgePlayer
408,GrudgePlayer,129,249,378,10,44,GrudgePlayer
409,GrudgePlayer,126,246,372,7,45,GrudgePlayer
410,GrudgePlayer,151,266,417,19,34,GrudgePlayer
411,GrudgePlayer,135,265,400,11,37,GrudgePlayer
412,GrudgePlayer,137,267,404,12,36,GrudgePlayer
413,GrudgePlayer,148,263,411,16,35,GrudgePlayer
414,GrudgePlayer,124,259,383,9,42,GrudgePlayer
415,GrudgePlayer,141,246,387,16,43,GrudgePlayer
416,GrudgePlayer,129,259,388,11,41,GrudgePlayer
417,GrudgePlayer,140,285,425,9,28,GrudgePlayer
418,GrudgePlayer,119,244,363,7,48,GrudgePlayer
419,GrudgePlayer,148,258,406,14,36,GrudgePlayer
420,GrudgePlayer,132,272,404,15,37,GrudgePlayer
421,GrudgePlayer,118,228,346,5,53,GrudgePlayer
422,GrudgePlayer,145,270,415,14,33,GrudgePlayer
423,GrudgePlayer,141,266,407,12,35,GrudgePlayer
424,GrudgePlayer,153,273,426,16,30,GrudgePlayer
425,GrudgePlayer,122,267,389,9,40,GrudgePlayer
426,GrudgePlayer,121,251,372,10,46,GrudgePlayer
427,GrudgePlayer,154,289,443,12,23,GrudgePlayer
428,GrudgePlayer,131,246,377,12,45,GrudgePlayer
429,GrudgePlayer,126,256,382,8,42,GrudgePlayer
430,GrudgePlayer,171,276,447,22,25,GrudgePlayer
431,GrudgePlayer,140,265,405,16,37,GrudgePlayer
432,GrudgePlayer,158,268,426,22,32,GrudgePlayer
433,GrudgePlayer,177,272,449,27,26,GrudgePlayer
434,GrudgePlayer,161,291,452,21,23,GrudgePlayer
435,GrudgePlayer,137,257,394,17,41,GrudgePlayer
436,GrudgePlayer,158,263,421,17,32,GrudgePlayer
437,GrudgePlayer,136,266,402,13,37,GrudgePlayer
438,GrudgePlayer,132,257,389,12,41,GrudgePlayer
439,GrudgePlayer,139,259,398,12,38,GrudgePlayer
440,GrudgePlayer,130,255,385,11,42,GrudgePlayer
441,GrudgePlayer,135,245,380,9,43,GrudgePlayer
442,GrudgePlayer,146,256,402,19,39,GrudgePlayer
443,GrudgePlayer,128,253,381,4,41,GrudgePlayer
444,GrudgePlayer,136,271,407,12,35,GrudgePlayer
445,GrudgePlayer,125,245,370,8,46,GrudgePlayer
446,GrudgePlayer,140,260,400,14,38,GrudgePlayer
447,GrudgePlayer,147,277,424,14,30,GrudgePlayer
448,GrudgePlayer,144,264,408,16,36,GrudgePlayer
449,GrudgePlayer,157,257,414,19,35,GrudgePlayer
450,GrudgePlayer,150,270,420,19,33,GrudgePlayer
451,GrudgePlayer,127,277,404,6,34,GrudgePlayer
452,GrudgePlayer,131,266,397,8,37,GrudgePlayer
453,GrudgePlayer,139,284,423,13,30,GrudgePlayer
454,GrudgePlayer,129,274,403,11,36,GrudgePlayer
455,GrudgePlayer,130,255,385,8,41,GrudgePlayer
456,GrudgePlayer,155,285,440,15,25,GrudgePlayer
457,GrudgePlayer,138,258,396,10,38,GrudgePlayer
458,GrudgePlayer,127,262,389,9,40,GrudgePlayer
459,GrudgePlayer,135,275,410,12,34,GrudgePlayer
460,GrudgePlayer,138,258,396,13,39,GrudgePlayer
461,GrudgePlayer,137,267,404,12,36,GrudgePlayer
462,GrudgePlayer,128,243,371,9,46,GrudgePlayer
463,GrudgePlayer,130,265,395,9,38,GrudgePlayer
464,GrudgePlayer,136,256,392,15,41,GrudgePlayer
465,GrudgePlayer,137,267,404,15,37,GrudgePlayer
466,GrudgePlayer,143,263,406,14,36,GrudgePlayer
467,GrudgePlayer,140,270,410,15,35,GrudgePlayer
468,GrudgePlayer,127,247,374,6,44,GrudgePlayer
469,GrudgePlayer,137,257,394,17,41,GrudgePlayer
470,GrudgePlayer,114,264,378,7,43,GrudgePlayer
471,GrudgePlayer,141,281,422,12,30,GrudgePlayer
472,GrudgePlayer,176,266,442,29,29,GrudgePlayer
473,GrudgePlayer,119,259,378,10,44,GrudgePlayer
474,GrudgePlayer,147,272,419,12,31,GrudgePlayer
475,GrudgePlayer,147,257,404,15,37,GrudgePlayer
476,GrudgePlayer,121,246,367,8,47,GrudgePlayer
477,GrudgePlayer,147,287,434,15,27,GrudgePlayer
478,GrudgePlayer,140,255,395,9,38,GrudgePlayer
479,GrudgePlayer,153,268,421,17,32,GrudgePlayer
480,GrudgePlayer,138,268,406,14,36,GrudgePlayer
481,GrudgePlayer,121,251,372,7,45,GrudgePlayer
482,GrudgePlayer,142,257,399,13,38,GrudgePlayer
483,GrudgePlayer,148,268,416,18,34,GrudgePlayer
484,GrudgePlayer,146,256,402,16,38,GrudgePlayer
485,GrudgePlayer,144,264,408,16,36,GrudgePlayer
486,GrudgePlayer,119,259,378,7,43,GrudgePlayer
487,GrudgePlayer,137,267,404,12,36,GrudgePlayer
488,GrudgePlayer,139,284,423,10,29,GrudgePlayer
489,GrudgePlayer,119,269,388,2,38,GrudgePlayer
490,GrudgePlayer,133,248,381,13,44,GrudgePlayer
491,GrudgePlayer,142,252,394,11,39,GrudgePlayer
492,GrudgePlayer,150,275,425,18,31,GrudgePlayer
493,GrudgePlayer,136,276,412,14,34,GrudgePlayer
494,GrudgePlayer,117,257,374,6,44,GrudgePlayer
495,GrudgePlayer,157,277,434,18,28,GrudgePlayer
496,GrudgePlayer,153,268,421,17,32,GrudgePlayer
497,GrudgePlayer,130,280,410,12,34,GrudgePlayer
498,GrudgePlayer,129,249,378,13,45,GrudgePlayer
499,GrudgePlayer,118,263,381,7,42,GrudgePlayer
500,GrudgePlayer,137,242,379,8,43,GrudgePlayer
501,GrudgePlayer,168,268,436,26,30,GrudgePlayer
502,GrudgePlayer,118,253,371,9,46,GrudgePlayer
503,GrudgePlayer,156,291,447,16,23,GrudgePlayer
504,GrudgePlayer,139,264,403,11,36,GrudgePlayer
505,GrudgePlayer,116,261,377,6,43,GrudgePlayer
506,GrudgePlayer,171,276,447,28,27,GrudgePlayer
507,GrudgePlayer,151,251,402,22,40,GrudgePlayer
508,GrudgePlayer,140,265,405,13,36,GrudgePlayer
509,GrudgePlayer,132,267,399,7,36,GrudgePlayer
510,GrudgePlayer,165,275,440,21,27,GrudgePlayer
511,GrudgePlayer,133,278,411,13,34,GrudgePlayer
512,GrudgePlayer,141,266,407,15,36,GrudgePlayer
513,GrudgePlayer,167,277,444,25,27,GrudgePlayer
514,GrudgePlayer,163,283,446,21,25,GrudgePlayer
515,GrudgePlayer,126,251,377,9,44,GrudgePlayer
516,GrudgePlayer,122,272,394,11,39,GrudgePlayer
517,GrudgePlayer,137,257,394,14,40,GrudgePlayer
518,GrudgePlayer,129,264,393,7,38,GrudgePlayer
519,GrudgePlayer,146,261,407,18,37,GrudgePlayer
520,GrudgePlayer,154,264,418,17,33,GrudgePlayer
521,GrudgePlayer,137,262,399,10,37,GrudgePlayer
522,GrudgePlayer,135,235,370,8,46,GrudgePlayer
523,GrudgePlayer,135,255,390,13,41,GrudgePlayer
524,GrudgePlayer,132,257,389,12,41,GrudgePlayer
525,GrudgePlayer,120,235,355,8,51,GrudgePlayer
526,GrudgePlayer,138,243,381,10,43,GrudgePlayer
527,GrudgePlayer,143,253,396,16,40,GrudgePlayer
528,GrudgePlayer,112,247,359,3,48,GrudgePlayer
529,GrudgePlayer,119,259,378,7,43,GrudgePlayer
530,GrudgePlayer,121,236,357,7,50,GrudgePlayer
531,GrudgePlayer,139,259,398,18,40,GrudgePlayer
532,GrudgePlayer,113,238,351,10,53,GrudgePlayer
533,GrudgePlayer,125,265,390,7,39,GrudgePlayer
534,GrudgePlayer,147,267,414,16,34,GrudgePlayer
535,GrudgePlayer,132,242,374,18,48,GrudgePlayer
536,GrudgePlayer,112,257,369,4,45,GrudgePlayer
537,GrudgePlayer,126,246,372,7,45,GrudgePlayer
538,GrudgePlayer,127,277,404,9,35,GrudgePlayer
539,GrudgePlayer,120,250,370,8,46,GrudgePlayer
540,GrudgePlayer,132,257,389,9,40,GrudgePlayer
541,GrudgePlayer,122,262,384,10,42,GrudgePlayer
542,GrudgePlayer,146,256,402,19,39,GrudgePlayer
543,GrudgePlayer,152,272,424,17,31,GrudgePlayer
544,GrudgePlayer,144,279,423,13,30,GrudgePlayer
545,GrudgePlayer,153,273,426,16,30,GrudgePlayer
546,GrudgePlayer,126,256,382,8,42,GrudgePlayer
547,GrudgePlayer,136,266,402,10,36,GrudgePlayer
548,GrudgePlayer,126,256,382,11,43,GrudgePlayer
549,GrudgePlayer,142,277,419,12,31,GrudgePlayer
550,GrudgePlayer,147,277,424,17,31,GrudgePlayer
551,GrudgePlayer,117,272,389,9,40,GrudgePlayer
552,GrudgePlayer,140,270,410,15,35,GrudgePlayer
553,GrudgePlayer,161,286,447,19,24,GrudgePlayer
554,GrudgePlayer,133,253,386,12,42,GrudgePlayer
555,GrudgePlayer,133,278,411,13,34,GrudgePlayer
556,GrudgePlayer,113,258,371,6,45,GrudgePlayer
557,GrudgePlayer,128,248,376,11,45,GrudgePlayer
558,GrudgePlayer,151,256,407,18,37,GrudgePlayer
559,GrudgePlayer,144,284,428,15,29,GrudgePlayer
560,GrudgePlayer,125,265,390,7,39,GrudgePlayer
561,GrudgePlayer,119,244,363,10,49,GrudgePlayer
562,GrudgePlayer,149,264,413,15,34,GrudgePlayer
563,GrudgePlayer,129,254,383,6,41,GrudgePlayer
564,GrudgePlayer,163,278,441,22,27,GrudgePlayer
565,GrudgePlayer,155,280,435,19,28,GrudgePlayer
566,GrudgePlayer,108,253,361,5,48,GrudgePlayer
567,GrudgePlayer,123,263,386,9,41,GrudgePlayer
568,GrudgePlayer,143,273,416,12,32,GrudgePlayer
569,GrudgePlayer,138,263,401,12,37,GrudgePlayer
570,GrudgePlayer,142,267,409,17,36,GrudgePlayer
571,GrudgePlayer,125,265,390,7,39,GrudgePlayer
572,GrudgePlayer,148,268,416,18,34,GrudgePlayer
573,GrudgePlayer,141,261,402,16,38,GrudgePlayer
574,GrudgePlayer,135,260,395,15,40,GrudgePlayer
575,GrudgePlayer,132,237,369,10,47,GrudgePlayer
576,GrudgePlayer,175,270,445,29,28,GrudgePlayer
577,GrudgePlayer,159,269,428,18,30,GrudgePlayer
578,GrudgePlayer,130,280,410,12,34,GrudgePlayer
579,GrudgePlayer,133,253,386,9,41,GrudgePlayer
580,GrudgePlayer,116,266,382,5,41,GrudgePlayer
581,GrudgePlayer,152,272,424,20,32,GrudgePlayer
582,GrudgePlayer,138,253,391,11,40,GrudgePlayer
583,GrudgePlayer,136,261,397,11,38,GrudgePlayer
584,GrudgePlayer,140,265,405,16,37,GrudgePlayer
585,GrudgePlayer,129,264,393,7,38,GrudgePlayer
586,GrudgePlayer,128,253,381,10,43,GrudgePlayer
587,GrudgePlayer,109,244,353,3,50,GrudgePlayer
588,GrudgePlayer,166,266,432,22,30,GrudgePlayer
589,GrudgePlayer,170,280,450,25,25,GrudgePlayer
590,GrudgePlayer,149,264,413,15,34,GrudgePlayer
591,GrudgePlayer,151,261,412,23,37,GrudgePlayer
592,GrudgePlayer,146,271,417,16,33,GrudgePlayer
593,GrudgePlayer,121,246,367,8,47,GrudgePlayer
594,GrudgePlayer,127,262,389,12,41,GrudgePlayer
595,GrudgePlayer,145,240,385,14,43,GrudgePlayer
596,GrudgePlayer,154,269,423,19,32,GrudgePlayer
597,GrudgePlayer,161,271,432,19,29,GrudgePlayer
598,GrudgePlayer,129,269,398,9,37,GrudgePlayer
599,GrudgePlayer,135,275,410,12,34,GrudgePlayer
600,GrudgePlayer,151,261,412,17,35,GrudgePlayer
601,GrudgePlayer,147,247,394,17,41,GrudgePlayer
602,GrudgePlayer,148,263,411,16,35,GrudgePlayer
603,GrudgePlayer,141,281,422,9,29,GrudgePlayer
604,GrudgePlayer,151,266,417,16,33,GrudgePlayer
605,GrudgePlayer,117,247,364,8,48,GrudgePlayer
606,GrudgePlayer,129,279,408,10,34,GrudgePlayer
607,GrudgePlayer,145,265,410,12,34,GrudgePlayer
608,GrudgePlayer,151,281,432,16,28,GrudgePlayer
609,GrudgePlayer,129,259,388,8,40,GrudgePlayer
610,GrudgePlayer,145,260,405,13,36,GrudgePlayer
611,GrudgePlayer,130,245,375,10,45,GrudgePlayer
612,GrudgePlayer,150,275,425,21,32,GrudgePlayer
613,GrudgePlayer,148,258,406,17,37,GrudgePlayer
614,GrudgePlayer,114,254,368,6,46,GrudgePlayer
615,GrudgePlayer,118,248,366,4,46,GrudgePlayer
616,GrudgePlayer,127,262,389,15,42,GrudgePlayer
617,GrudgePlayer,116,261,377,3,42,GrudgePlayer
618,GrudgePlayer,150,255,405,22,39,GrudgePlayer
619,GrudgePlayer,130,260,390,13,41,GrudgePlayer
620,GrudgePlayer,154,269,423,19,32,GrudgePlayer
621,GrudgePlayer,126,281,407,9,34,GrudgePlayer
622,GrudgePlayer,136,261,397,11,38,GrudgePlayer
623,GrudgePlayer,133,243,376,8,44,GrudgePlayer
624,GrudgePlayer,135,265,400,11,37,GrudgePlayer
625,GrudgePlayer,124,269,393,7,38,GrudgePlayer
626,GrudgePlayer,123,263,386,6,40,GrudgePlayer
627,GrudgePlayer,129,254,383,9,42,GrudgePlayer
628,GrudgePlayer,140,270,410,12,34,GrudgePlayer
629,GrudgePlayer,128,268,396,4,36,GrudgePlayer
630,GrudgePlayer,149,259,408,16,36,GrudgePlayer
631,GrudgePlayer,146,286,432,13,27,GrudgePlayer
632,GrudgePlayer,138,238,376,14,46,GrudgePlayer
633,GrudgePlayer,138,258,396,13,39,GrudgePlayer
634,GrudgePlayer,120,245,365,9,48,GrudgePlayer
635,GrudgePlayer,143,263,406,14,36,GrudgePlayer
636,GrudgePlayer,133,258,391,11,40,GrudgePlayer
637,GrudgePlayer,132,272,404,12,36,GrudgePlayer
638,GrudgePlayer,136,271,407,12,35,GrudgePlayer
639,GrudgePlayer,142,262,404,12,36,GrudgePlayer
640,GrudgePlayer,139,279,418,11,31,GrudgePlayer
641,GrudgePlayer,133,273,406,11,35,GrudgePlayer
642,GrudgePlayer,130,275,405,10,35,GrudgePlayer
643,GrudgePlayer,143,278,421,11,30,GrudgePlayer
644,GrudgePlayer,119,259,378,4,42,GrudgePlayer
645,GrudgePlayer,146,281,427,17,30,GrudgePlayer
646,GrudgePlayer,146,256,402,13,37,GrudgePlayer
647,GrudgePlayer,150,270,420,10,30,GrudgePlayer
648,GrudgePlayer,136,276,412,11,33,GrudgePlayer
649,GrudgePlayer,135,280,415,8,31,GrudgePlayer
650,GrudgePlayer,122,272,394,5,37,GrudgePlayer
651,GrudgePlayer,162,277,439,20,27,GrudgePlayer
652,GrudgePlayer,125,255,380,12,44,GrudgePlayer
653,GrudgePlayer,160,270,430,17,29,GrudgePlayer
654,GrudgePlayer,145,265,410,15,35,GrudgePlayer
655,GrudgePlayer,150,285,435,13,26,GrudgePlayer
656,GrudgePlayer,123,233,356,6,50,GrudgePlayer
657,GrudgePlayer,137,242,379,14,45,GrudgePlayer
658,GrudgePlayer,148,278,426,19,31,GrudgePlayer
659,GrudgePlayer,144,259,403,14,37,GrudgePlayer
660,GrudgePlayer,140,265,405,13,36,GrudgePlayer
661,GrudgePlayer,137,262,399,13,38,GrudgePlayer
662,GrudgePlayer,171,296,467,24,19,GrudgePlayer
663,GrudgePlayer,142,272,414,13,33,GrudgePlayer
664,GrudgePlayer,149,269,418,14,32,GrudgePlayer
665,GrudgePlayer,151,286,437,18,27,GrudgePlayer
666,GrudgePlayer,150,270,420,16,32,GrudgePlayer
667,GrudgePlayer,145,250,395,15,40,GrudgePlayer
668,GrudgePlayer,145,250,395,18,41,GrudgePlayer
669,GrudgePlayer,146,266,412,17,35,GrudgePlayer
670,GrudgePlayer,127,257,384,10,42,GrudgePlayer
671,GrudgePlayer,131,241,372,13,47,GrudgePlayer
672,GrudgePlayer,144,279,423,10,29,GrudgePlayer
673,GrudgePlayer,138,258,396,13,39,GrudgePlayer
674,GrudgePlayer,162,277,439,20,27,GrudgePlayer
675,GrudgePlayer,139,259,398,15,39,GrudgePlayer
676,GrudgePlayer,115,275,390,7,39,GrudgePlayer
677,GrudgePlayer,133,253,386,12,42,GrudgePlayer
678,GrudgePlayer,124,249,373,8,45,GrudgePlayer
679,GrudgePlayer,150,275,425,21,32,GrudgePlayer
680,GrudgePlayer,144,269,413,18,35,GrudgePlayer
681,GrudgePlayer,122,272,394,8,38,GrudgePlayer
682,GrudgePlayer,129,244,373,8,45,GrudgePlayer
683,GrudgePlayer,128,263,391,8,39,GrudgePlayer
684,GrudgePlayer,150,285,435,19,28,GrudgePlayer
685,GrudgePlayer,139,269,408,13,35,GrudgePlayer
686,GrudgePlayer,153,273,426,16,30,GrudgePlayer
687,GrudgePlayer,139,264,403,11,36,GrudgePlayer
688,GrudgePlayer,122,267,389,6,39,GrudgePlayer
689,GrudgePlayer,157,262,419,21,34,GrudgePlayer
690,GrudgePlayer,134,269,403,11,36,GrudgePlayer
691,GrudgePlayer,139,264,403,14,37,GrudgePlayer
692,GrudgePlayer,127,267,394,11,39,GrudgePlayer
693,GrudgePlayer,135,265,400,14,38,GrudgePlayer
694,GrudgePlayer,151,261,412,17,35,GrudgePlayer
695,GrudgePlayer,134,254,388,11,41,GrudgePlayer
696,GrudgePlayer,140,250,390,10,40,GrudgePlayer
697,GrudgePlayer,130,255,385,11,42,GrudgePlayer
698,GrudgePlayer,134,264,398,12,38,GrudgePlayer
699,GrudgePlayer,117,257,374,9,45,GrudgePlayer
700,GrudgePlayer,119,229,348,7,53,GrudgePlayer
701,GrudgePlayer,142,247,389,12,41,GrudgePlayer
702,GrudgePlayer,155,265,420,16,32,GrudgePlayer
703,GrudgePlayer,150,275,425,15,30,GrudgePlayer
704,GrudgePlayer,134,249,383,15,44,GrudgePlayer
705,GrudgePlayer,143,268,411,19,36,GrudgePlayer
706,GrudgePlayer,138,268,406,14,36,GrudgePlayer
707,GrudgePlayer,139,274,413,15,34,GrudgePlayer
708,GrudgePlayer,130,275,405,7,34,GrudgePlayer
709,GrudgePlayer,146,266,412,14,34,GrudgePlayer
710,GrudgePlayer,132,257,389,9,40,GrudgePlayer
711,GrudgePlayer,150,260,410,18,36,GrudgePlayer
712,GrudgePlayer,162,262,424,20,32,GrudgePlayer
713,GrudgePlayer,150,265,415,14,33,GrudgePlayer
714,GrudgePlayer,160,290,450,22,24,GrudgePlayer
715,GrudgePlayer,142,267,409,17,36,GrudgePlayer
716,GrudgePlayer,157,267,424,14,30,GrudgePlayer
717,GrudgePlayer,128,273,401,9,36,GrudgePlayer
718,GrudgePlayer,145,270,415,14,33,GrudgePlayer
719,GrudgePlayer,154,284,438,19,27,GrudgePlayer
720,GrudgePlayer,149,254,403,17,38,GrudgePlayer
721,GrudgePlayer,153,263,416,18,34,GrudgePlayer
722,GrudgePlayer,130,245,375,7,44,GrudgePlayer
723,GrudgePlayer,167,277,444,25,27,GrudgePlayer
724,GrudgePlayer,134,264,398,9,37,GrudgePlayer
725,GrudgePlayer,142,267,409,14,35,GrudgePlayer
726,GrudgePlayer,115,270,385,8,41,GrudgePlayer
727,GrudgePlayer,144,289,433,17,28,GrudgePlayer
728,GrudgePlayer,139,264,403,14,37,GrudgePlayer
729,GrudgePlayer,142,272,414,13,33,GrudgePlayer
730,GrudgePlayer,161,261,422,21,33,GrudgePlayer
731,GrudgePlayer,150,255,405,16,37,GrudgePlayer
732,GrudgePlayer,132,277,409,14,35,GrudgePlayer
733,GrudgePlayer,126,241,367,11,48,GrudgePlayer
734,GrudgePlayer,121,241,362,6,48,GrudgePlayer
735,GrudgePlayer,133,278,411,13,34,GrudgePlayer
736,GrudgePlayer,147,262,409,20,37,GrudgePlayer
737,GrudgePlayer,140,245,385,14,43,GrudgePlayer
738,GrudgePlayer,144,264,408,13,35,GrudgePlayer
739,GrudgePlayer,111,261,372,7,45,GrudgePlayer
740,GrudgePlayer,132,252,384,13,43,GrudgePlayer
741,GrudgePlayer,127,267,394,8,38,GrudgePlayer
742,GrudgePlayer,145,265,410,15,35,GrudgePlayer
743,GrudgePlayer,143,238,381,13,44,GrudgePlayer
744,GrudgePlayer,133,268,401,12,37,GrudgePlayer
745,GrudgePlayer,146,276,422,12,30,GrudgePlayer
746,GrudgePlayer,138,233,371,12,47,GrudgePlayer
747,GrudgePlayer,129,244,373,11,46,GrudgePlayer
748,GrudgePlayer,131,266,397,11,38,GrudgePlayer
749,GrudgePlayer,132,267,399,13,38,GrudgePlayer
750,GrudgePlayer,146,246,392,18,42,GrudgePlayer
751,GrudgePlayer,145,265,410,12,34,GrudgePlayer
752,GrudgePlayer,130,245,375,10,45,GrudgePlayer
753,GrudgePlayer,138,273,411,13,34,GrudgePlayer
754,GrudgePlayer,151,256,407,15,36,GrudgePlayer
755,GrudgePlayer,147,267,414,13,33,GrudgePlayer
756,GrudgePlayer,119,254,373,8,45,GrudgePlayer
757,GrudgePlayer,141,266,407,12,35,GrudgePlayer
758,GrudgePlayer,148,263,411,19,36,GrudgePlayer
759,GrudgePlayer,160,280,440,15,25,GrudgePlayer
760,GrudgePlayer,150,285,435,16,27,GrudgePlayer
761,GrudgePlayer,159,259,418,20,34,GrudgePlayer
762,GrudgePlayer,129,254,383,9,42,GrudgePlayer
763,GrudgePlayer,140,280,420,13,31,GrudgePlayer
764,GrudgePlayer,117,252,369,4,45,GrudgePlayer
765,GrudgePlayer,124,284,408,10,34,GrudgePlayer
766,GrudgePlayer,139,269,408,10,34,GrudgePlayer
767,GrudgePlayer,137,277,414,13,33,GrudgePlayer
768,GrudgePlayer,128,273,401,9,36,GrudgePlayer
769,GrudgePlayer,122,272,394,11,39,GrudgePlayer
770,GrudgePlayer,128,248,376,8,44,GrudgePlayer
771,GrudgePlayer,138,253,391,11,40,GrudgePlayer
772,GrudgePlayer,157,262,419,15,32,GrudgePlayer
773,GrudgePlayer,133,263,396,13,39,GrudgePlayer
774,GrudgePlayer,159,274,433,17,28,GrudgePlayer
775,GrudgePlayer,118,268,386,6,40,GrudgePlayer
776,GrudgePlayer,141,276,417,16,33,GrudgePlayer
777,GrudgePlayer,133,268,401,15,38,GrudgePlayer
778,GrudgePlayer,142,272,414,19,35,GrudgePlayer
779,GrudgePlayer,132,267,399,7,36,GrudgePlayer
780,GrudgePlayer,107,242,349,5,52,GrudgePlayer
781,GrudgePlayer,133,253,386,9,41,GrudgePlayer
782,GrudgePlayer,126,241,367,8,47,GrudgePlayer
783,GrudgePlayer,119,239,358,8,50,GrudgePlayer
784,GrudgePlayer,126,256,382,11,43,GrudgePlayer
785,GrudgePlayer,137,247,384,13,43,GrudgePlayer
786,GrudgePlayer,122,262,384,7,41,GrudgePlayer
787,GrudgePlayer,125,265,390,7,39,GrudgePlayer
788,GrudgePlayer,161,266,427,20,31,GrudgePlayer
789,GrudgePlayer,138,258,396,13,39,GrudgePlayer
790,GrudgePlayer,132,247,379,8,43,GrudgePlayer
791,GrudgePlayer,135,275,410,9,33,GrudgePlayer
792,GrudgePlayer,134,264,398,9,37,GrudgePlayer
793,GrudgePlayer,140,255,395,15,40,GrudgePlayer
794,GrudgePlayer,141,281,422,15,31,GrudgePlayer
795,GrudgePlayer,157,267,424,17,31,GrudgePlayer
796,GrudgePlayer,143,273,416,18,34,GrudgePlayer
797,GrudgePlayer,134,264,398,6,36,GrudgePlayer
798,GrudgePlayer,131,251,382,8,42,GrudgePlayer
799,GrudgePlayer,132,252,384,10,42,GrudgePlayer
800,GrudgePlayer,151,266,417,16,33,GrudgePlayer
801,GrudgePlayer,138,278,416,12,32,GrudgePlayer
802,GrudgePlayer,133,258,391,11,40,GrudgePlayer
803,GrudgePlayer,139,249,388,11,41,GrudgePlayer
804,GrudgePlayer,132,272,404,12,36,GrudgePlayer
805,GrudgePlayer,170,265,435,25,30,GrudgePlayer
806,GrudgePlayer,140,270,410,15,35,GrudgePlayer
807,GrudgePlayer,143,263,406,20,38,GrudgePlayer
808,GrudgePlayer,121,236,357,7,50,GrudgePlayer
809,GrudgePlayer,160,255,415,23,36,GrudgePlayer
810,GrudgePlayer,117,257,374,3,43,GrudgePlayer
811,GrudgePlayer,139,254,393,10,39,GrudgePlayer
812,GrudgePlayer,151,266,417,16,33,GrudgePlayer
813,GrudgePlayer,138,278,416,12,32,GrudgePlayer
814,GrudgePlayer,162,257,419,18,33,GrudgePlayer
815,GrudgePlayer,113,263,376,5,43,GrudgePlayer
816,GrudgePlayer,135,275,410,12,34,GrudgePlayer
817,GrudgePlayer,121,266,387,10,41,GrudgePlayer
818,GrudgePlayer,144,264,408,19,37,GrudgePlayer
819,GrudgePlayer,154,269,423,16,31,GrudgePlayer
820,GrudgePlayer,123,243,366,10,48,GrudgePlayer
821,GrudgePlayer,137,257,394,11,39,GrudgePlayer
822,GrudgePlayer,176,281,457,29,24,GrudgePlayer
823,GrudgePlayer,131,251,382,11,43,GrudgePlayer
824,GrudgePlayer,133,233,366,7,47,GrudgePlayer
825,GrudgePlayer,139,264,403,11,36,GrudgePlayer
826,GrudgePlayer,141,251,392,15,41,GrudgePlayer
827,GrudgePlayer,135,265,400,11,37,GrudgePlayer
828,GrudgePlayer,147,242,389,18,43,GrudgePlayer
829,GrudgePlayer,143,283,426,16,30,GrudgePlayer
830,GrudgePlayer,155,270,425,21,32,GrudgePlayer
831,GrudgePlayer,161,281,442,20,26,GrudgePlayer
832,GrudgePlayer,133,248,381,7,42,GrudgePlayer
833,GrudgePlayer,128,258,386,9,41,GrudgePlayer
834,GrudgePlayer,146,261,407,12,35,GrudgePlayer
835,GrudgePlayer,159,279,438,19,27,GrudgePlayer
836,GrudgePlayer,150,265,415,20,35,GrudgePlayer
837,GrudgePlayer,122,262,384,7,41,GrudgePlayer
838,GrudgePlayer,128,258,386,9,41,GrudgePlayer
839,GrudgePlayer,146,251,397,11,38,GrudgePlayer
840,GrudgePlayer,119,229,348,7,53,GrudgePlayer
841,GrudgePlayer,159,264,423,19,32,GrudgePlayer
842,GrudgePlayer,167,292,459,19,20,GrudgePlayer
843,GrudgePlayer,131,241,372,10,46,GrudgePlayer
844,GrudgePlayer,156,266,422,24,34,GrudgePlayer
845,GrudgePlayer,135,280,415,11,32,GrudgePlayer
846,GrudgePlayer,131,251,382,5,41,GrudgePlayer
847,GrudgePlayer,164,279,443,24,27,GrudgePlayer
848,GrudgePlayer,124,234,358,8,50,GrudgePlayer
849,GrudgePlayer,147,272,419,15,32,GrudgePlayer
850,GrudgePlayer,146,266,412,17,35,GrudgePlayer
851,GrudgePlayer,122,262,384,10,42,GrudgePlayer
852,GrudgePlayer,142,257,399,13,38,GrudgePlayer
853,GrudgePlayer,153,293,446,18,24,GrudgePlayer
854,GrudgePlayer,164,269,433,20,29,GrudgePlayer
855,GrudgePlayer,128,253,381,7,42,GrudgePlayer
856,GrudgePlayer,122,267,389,6,39,GrudgePlayer
857,GrudgePlayer,162,262,424,20,32,GrudgePlayer
858,GrudgePlayer,140,275,415,17,34,GrudgePlayer
859,GrudgePlayer,120,255,375,7,44,GrudgePlayer
860,GrudgePlayer,142,247,389,15,42,GrudgePlayer
861,GrudgePlayer,138,258,396,10,38,GrudgePlayer
862,GrudgePlayer,126,251,377,6,43,GrudgePlayer
863,GrudgePlayer,142,262,404,18,38,GrudgePlayer
864,GrudgePlayer,117,262,379,8,43,GrudgePlayer
865,GrudgePlayer,139,259,398,15,39,GrudgePlayer
866,GrudgePlayer,109,249,358,5,49,GrudgePlayer
867,GrudgePlayer,154,274,428,21,31,GrudgePlayer
868,GrudgePlayer,160,275,435,22,29,GrudgePlayer
869,GrudgePlayer,156,276,432,16,28,GrudgePlayer
870,GrudgePlayer,120,255,375,4,43,GrudgePlayer
871,GrudgePlayer,130,260,390,7,39,GrudgePlayer
872,GrudgePlayer,135,270,405,7,34,GrudgePlayer
873,GrudgePlayer,130,275,405,7,34,GrudgePlayer
874,GrudgePlayer,120,275,395,9,38,GrudgePlayer
875,GrudgePlayer,118,238,356,9,51,GrudgePlayer
876,GrudgePlayer,128,258,386,6,40,GrudgePlayer
877,GrudgePlayer,123,253,376,8,44,GrudgePlayer
878,GrudgePlayer,148,258,406,17,37,GrudgePlayer
879,GrudgePlayer,134,264,398,12,38,GrudgePlayer
880,GrudgePlayer,160,255,415,17,34,GrudgePlayer
881,GrudgePlayer,158,273,431,18,29,GrudgePlayer
882,GrudgePlayer,145,260,405,19,38,GrudgePlayer
883,GrudgePlayer,132,257,389,12,41,GrudgePlayer
884,GrudgePlayer,150,255,405,19,38,GrudgePlayer
885,GrudgePlayer,140,265,405,13,36,GrudgePlayer
886,GrudgePlayer,121,246,367,11,48,GrudgePlayer
887,GrudgePlayer,118,258,376,5,43,GrudgePlayer
888,GrudgePlayer,137,262,399,13,38,GrudgePlayer
889,GrudgePlayer,128,238,366,10,48,GrudgePlayer
890,GrudgePlayer,144,269,413,18,35,GrudgePlayer
891,GrudgePlayer,140,270,410,12,34,GrudgePlayer
892,GrudgePlayer,131,266,397,5,36,GrudgePlayer
893,GrudgePlayer,126,271,397,11,38,GrudgePlayer
894,GrudgePlayer,140,265,405,13,36,GrudgePlayer
895,GrudgePlayer,128,268,396,10,38,GrudgePlayer
896,GrudgePlayer,165,285,450,22,24,GrudgePlayer
897,GrudgePlayer,125,240,365,6,47,GrudgePlayer
898,GrudgePlayer,121,266,387,4,39,GrudgePlayer
899,GrudgePlayer,131,256,387,10,41,GrudgePlayer
900,GrudgePlayer,134,249,383,9,42,GrudgePlayer
901,GrudgePlayer,133,253,386,12,42,GrudgePlayer
902,GrudgePlayer,153,278,431,15,28,GrudgePlayer
903,GrudgePlayer,131,286,417,10,31,GrudgePlayer
904,GrudgePlayer,142,257,399,16,39,GrudgePlayer
905,GrudgePlayer,175,265,440,27,29,GrudgePlayer
906,GrudgePlayer,134,264,398,12,38,GrudgePlayer
907,GrudgePlayer,159,269,428,18,30,GrudgePlayer
908,GrudgePlayer,147,272,419,18,33,GrudgePlayer
909,GrudgePlayer,112,242,354,4,50,GrudgePlayer
910,GrudgePlayer,143,258,401,12,37,GrudgePlayer
911,GrudgePlayer,142,277,419,15,32,GrudgePlayer
912,GrudgePlayer,125,260,385,11,42,GrudgePlayer
913,GrudgePlayer,152,267,419,15,32,GrudgePlayer
914,GrudgePlayer,137,247,384,10,42,GrudgePlayer
915,GrudgePlayer,156,256,412,23,37,GrudgePlayer
916,GrudgePlayer,146,266,412,17,35,GrudgePlayer
917,GrudgePlayer,129,264,393,13,40,GrudgePlayer
918,GrudgePlayer,139,264,403,8,35,GrudgePlayer
919,GrudgePlayer,136,246,382,14,44,GrudgePlayer
920,GrudgePlayer,144,249,393,16,41,GrudgePlayer
921,GrudgePlayer,122,262,384,10,42,GrudgePlayer
922,GrudgePlayer,152,257,409,17,36,GrudgePlayer
923,GrudgePlayer,108,233,341,3,54,GrudgePlayer
924,GrudgePlayer,128,248,376,11,45,GrudgePlayer
925,GrudgePlayer,133,273,406,14,36,GrudgePlayer
926,GrudgePlayer,142,257,399,13,38,GrudgePlayer
927,GrudgePlayer,116,246,362,6,48,GrudgePlayer
928,GrudgePlayer,143,278,421,17,32,GrudgePlayer
929,GrudgePlayer,141,251,392,12,40,GrudgePlayer
930,GrudgePlayer,147,267,414,16,34,GrudgePlayer
931,GrudgePlayer,146,256,402,19,39,GrudgePlayer
932,GrudgePlayer,123,253,376,8,44,GrudgePlayer
933,GrudgePlayer,141,261,402,16,38,GrudgePlayer
934,GrudgePlayer,134,249,383,9,42,GrudgePlayer
935,GrudgePlayer,145,275,420,16,32,GrudgePlayer
936,GrudgePlayer,143,273,416,15,33,GrudgePlayer
937,GrudgePlayer,133,268,401,12,37,GrudgePlayer
938,GrudgePlayer,153,268,421,20,33,GrudgePlayer
939,GrudgePlayer,146,256,402,16,38,GrudgePlayer
940,GrudgePlayer,164,284,448,20,24,GrudgePlayer
941,GrudgePlayer,141,246,387,16,43,GrudgePlayer
942,GrudgePlayer,133,273,406,8,34,GrudgePlayer
943,GrudgePlayer,137,247,384,10,42,GrudgePlayer
944,GrudgePlayer,137,257,394,17,41,GrudgePlayer
945,GrudgePlayer,140,270,410,12,34,GrudgePlayer
946,GrudgePlayer,115,225,340,8,56,GrudgePlayer
947,GrudgePlayer,163,268,431,21,30,GrudgePlayer
948,GrudgePlayer,143,263,406,14,36,GrudgePlayer
949,GrudgePlayer,134,274,408,10,34,GrudgePlayer
950,GrudgePlayer,142,267,409,11,34,GrudgePlayer
951,GrudgePlayer,124,249,373,8,45,GrudgePlayer
952,GrudgePlayer,123,253,376,8,44,GrudgePlayer
953,GrudgePlayer,139,254,393,16,41,GrudgePlayer
954,GrudgePlayer,130,280,410,12,34,GrudgePlayer
955,GrudgePlayer,137,267,404,9,35,GrudgePlayer
956,GrudgePlayer,131,251,382,11,43,GrudgePlayer
957,GrudgePlayer,127,257,384,10,42,GrudgePlayer
958,GrudgePlayer,135,265,400,14,38,GrudgePlayer
959,GrudgePlayer,135,260,395,9,38,GrudgePlayer
960,GrudgePlayer,122,272,394,5,37,GrudgePlayer
961,GrudgePlayer,127,272,399,7,36,GrudgePlayer
962,GrudgePlayer,133,258,391,8,39,GrudgePlayer
963,GrudgePlayer,145,265,410,9,33,GrudgePlayer
964,GrudgePlayer,142,267,409,11,34,GrudgePlayer
965,GrudgePlayer,136,271,407,9,34,GrudgePlayer
966,GrudgePlayer,146,261,407,15,36,GrudgePlayer
967,GrudgePlayer,144,264,408,16,36,GrudgePlayer
968,GrudgePlayer,152,287,439,17,26,GrudgePlayer
969,GrudgePlayer,153,263,416,15,33,GrudgePlayer
970,GrudgePlayer,134,269,403,11,36,GrudgePlayer
971,GrudgePlayer,165,290,455,18,21,GrudgePlayer
972,GrudgePlayer,154,279,433,17,28,GrudgePlayer
973,GrudgePlayer,122,272,394,5,37,GrudgePlayer
974,GrudgePlayer,130,270,400,14,38,GrudgePlayer
975,GrudgePlayer,153,273,426,16,30,GrudgePlayer
976,GrudgePlayer,159,274,433,23,30,GrudgePlayer
977,GrudgePlayer,138,253,391,14,41,GrudgePlayer
978,GrudgePlayer,128,273,401,9,36,GrudgePlayer
979,GrudgePlayer,124,254,378,7,43,GrudgePlayer
980,GrudgePlayer,139,269,408,7,33,GrudgePlayer
981,GrudgePlayer,120,245,365,6,47,GrudgePlayer
982,GrudgePlayer,145,275,420,13,31,GrudgePlayer
983,GrudgePlayer,125,260,385,8,41,GrudgePlayer
984,GrudgePlayer,130,250,380,9,43,GrudgePlayer
985,GrudgePlayer,162,262,424,17,31,GrudgePlayer
986,GrudgePlayer,138,263,401,12,37,GrudgePlayer
987,GrudgePlayer,144,264,408,7,33,GrudgePlayer
988,GrudgePlayer,137,267,404,12,36,GrudgePlayer
989,GrudgePlayer,159,259,418,20,34,GrudgePlayer
990,GrudgePlayer,159,289,448,17,23,GrudgePlayer
991,GrudgePlayer,120,240,360,4,48,GrudgePlayer
992,GrudgePlayer,143,268,411,19,36,GrudgePlayer
993,GrudgePlayer,133,263,396,10,38,GrudgePlayer
994,GrudgePlayer,130,250,380,9,43,GrudgePlayer
995,GrudgePlayer,154,269,423,19,32,GrudgePlayer
996,GrudgePlayer,145,260,405,16,37,GrudgePlayer
997,GrudgePlayer,141,286,427,14,29,GrudgePlayer
998,GrudgePlayer,135,260,395,12,39,GrudgePlayer
999,GrudgePlayer,148,273,421,11,30,GrudgePlayer
1000,GrudgePlayer,124,244,368,9,47,GrudgePlayer
1001,GrudgePlayer,125,275,400,11,37,GrudgePlayer
1002,GrudgePlayer,133,253,386,9,41,GrudgePlayer
1003,GrudgePlayer,120,270,390,4,38,GrudgePlayer
1004,GrudgePlayer,137,267,404,9,35,GrudgePlayer
1005,GrudgePlayer,131,251,382,11,43,GrudgePlayer
1006,GrudgePlayer,130,240,370,8,46,GrudgePlayer
1007,GrudgePlayer,125,265,390,7,39,GrudgePlayer
1008,GrudgePlayer,131,271,402,10,36,GrudgePlayer
1009,GrudgePlayer,157,272,429,16,29,GrudgePlayer
1010,GrudgePlayer,137,262,399,16,39,GrudgePlayer
1011,GrudgePlayer,129,249,378,13,45,GrudgePlayer
1012,GrudgePlayer,135,265,400,11,37,GrudgePlayer
1013,GrudgePlayer,133,258,391,14,41,GrudgePlayer
1014,GrudgePlayer,131,261,392,12,40,GrudgePlayer
1015,GrudgePlayer,108,248,356,6,50,GrudgePlayer
1016,GrudgePlayer,148,273,421,14,31,GrudgePlayer
1017,GrudgePlayer,143,278,421,17,32,GrudgePlayer
1018,GrudgePlayer,129,244,373,11,46,GrudgePlayer
1019,GrudgePlayer,134,259,393,13,40,GrudgePlayer
1020,GrudgePlayer,141,266,407,12,35,GrudgePlayer
1021,GrudgePlayer,129,279,408,7,33,GrudgePlayer
1022,GrudgePlayer,126,241,367,5,46,GrudgePlayer
1023,GrudgePlayer,145,260,405,13,36,GrudgePlayer
1024,GrudgePlayer,120,255,375,10,45,GrudgePlayer
1025,GrudgePlayer,126,236,362,6,48,GrudgePlayer
1026,GrudgePlayer,128,263,391,8,39,GrudgePlayer
1027,GrudgePlayer,122,272,394,11,39,GrudgePlayer
1028,GrudgePlayer,138,268,406,17,37,GrudgePlayer
1029,GrudgePlayer,135,270,405,13,36,GrudgePlayer
1030,GrudgePlayer,149,269,418,14,32,GrudgePlayer
1031,GrudgePlayer,144,259,403,14,37,GrudgePlayer
1032,GrudgePlayer,117,257,374,6,44,GrudgePlayer
1033,GrudgePlayer,147,257,404,18,38,GrudgePlayer
1034,GrudgePlayer,155,245,400,17,39,GrudgePlayer
1035,GrudgePlayer,127,252,379,8,43,GrudgePlayer
1036,GrudgePlayer,142,272,414,13,33,GrudgePlayer
1037,GrudgePlayer,147,252,399,16,39,GrudgePlayer
1038,GrudgePlayer,133,273,406,14,36,GrudgePlayer
1039,GrudgePlayer,134,259,393,10,39,GrudgePlayer
1040,GrudgePlayer,128,268,396,10,38,GrudgePlayer
1041,GrudgePlayer,131,276,407,12,35,GrudgePlayer
1042,GrudgePlayer,128,263,391,8,39,GrudgePlayer
1043,GrudgePlayer,144,274,418,14,32,GrudgePlayer
1044,GrudgePlayer,144,269,413,18,35,GrudgePlayer
1045,GrudgePlayer,147,252,399,16,39,GrudgePlayer
1046,GrudgePlayer,140,265,405,16,37,GrudgePlayer
1047,GrudgePlayer,139,244,383,15,44,GrudgePlayer
1048,GrudgePlayer,128,258,386,12,42,GrudgePlayer
1049,GrudgePlayer,105,245,350,6,52,GrudgePlayer
1050,GrudgePlayer,104,234,338,6,56,GrudgePlayer
1051,GrudgePlayer,137,257,394,11,39,GrudgePlayer
1052,GrudgePlayer,134,264,398,9,37,GrudgePlayer
1053,GrudgePlayer,140,265,405,13,36,GrudgePlayer
1054,GrudgePlayer,151,271,422,12,30,GrudgePlayer
1055,GrudgePlayer,138,253,391,11,40,GrudgePlayer
1056,GrudgePlayer,137,257,394,11,39,GrudgePlayer
1057,GrudgePlayer,131,251,382,11,43,GrudgePlayer
1058,GrudgePlayer,117,257,374,6,44,GrudgePlayer
1059,GrudgePlayer,141,256,397,11,38,GrudgePlayer
1060,GrudgePlayer,156,281,437,21,28,GrudgePlayer
1061,GrudgePlayer,128,258,386,9,41,GrudgePlayer
1062,GrudgePlayer,129,244,373,8,45,GrudgePlayer
1063,GrudgePlayer,152,267,419,18,33,GrudgePlayer
1064,GrudgePlayer,145,265,410,15,35,GrudgePlayer
1065,GrudgePlayer,149,274,423,13,30,GrudgePlayer
1066,GrudgePlayer,138,278,416,9,31,GrudgePlayer
1067,GrudgePlayer,130,245,375,10,45,GrudgePlayer
1068,GrudgePlayer,136,246,382,11,43,GrudgePlayer
1069,GrudgePlayer,143,258,401,15,38,GrudgePlayer
1070,GrudgePlayer,129,254,383,12,43,GrudgePlayer
1071,GrudgePlayer,153,268,421,17,32,GrudgePlayer
1072,GrudgePlayer,121,246,367,11,48,GrudgePlayer
1073,GrudgePlayer,154,269,423,19,32,GrudgePlayer
1074,GrudgePlayer,154,254,408,19,37,GrudgePlayer
1075,GrudgePlayer,127,272,399,7,36,GrudgePlayer
1076,GrudgePlayer,118,253,371,9,46,GrudgePlayer
1077,GrudgePlayer,151,271,422,18,32,GrudgePlayer
1078,GrudgePlayer,130,270,400,11,37,GrudgePlayer
1079,GrudgePlayer,180,275,455,27,24,GrudgePlayer
1080,GrudgePlayer,110,245,355,5,50,GrudgePlayer
1081,GrudgePlayer,115,260,375,7,44,GrudgePlayer
1082,GrudgePlayer,138,278,416,12,32,GrudgePlayer
1083,GrudgePlayer,134,259,393,13,40,GrudgePlayer
1084,GrudgePlayer,166,276,442,20,26,GrudgePlayer
1085,GrudgePlayer,145,260,405,13,36,GrudgePlayer
1086,GrudgePlayer,146,276,422,12,30,GrudgePlayer
1087,GrudgePlayer,136,261,397,11,38,GrudgePlayer
1088,GrudgePlayer,140,275,415,14,33,GrudgePlayer
1089,GrudgePlayer,131,261,392,12,40,GrudgePlayer
1090,GrudgePlayer,136,266,402,13,37,GrudgePlayer
1091,GrudgePlayer,147,277,424,14,30,GrudgePlayer
1092,GrudgePlayer,131,241,372,10,46,GrudgePlayer
1093,GrudgePlayer,143,268,411,10,33,GrudgePlayer
1094,GrudgePlayer,156,281,437,18,27,GrudgePlayer
1095,GrudgePlayer,142,262,404,15,37,GrudgePlayer
1096,GrudgePlayer,159,269,428,18,30,GrudgePlayer
1097,GrudgePlayer,139,274,413,12,33,GrudgePlayer
1098,GrudgePlayer,134,279,413,12,33,GrudgePlayer
1099,GrudgePlayer,132,267,399,10,37,GrudgePlayer
1100,GrudgePlayer,139,239,378,13,45,GrudgePlayer
1101,GrudgePlayer,139,259,398,15,39,GrudgePlayer
1102,GrudgePlayer,151,251,402,13,37,GrudgePlayer
1103,GrudgePlayer,144,244,388,14,42,GrudgePlayer
1104,GrudgePlayer,120,260,380,9,43,GrudgePlayer
1105,GrudgePlayer,134,264,398,9,37,GrudgePlayer
1106,GrudgePlayer,137,257,394,11,39,GrudgePlayer
1107,GrudgePlayer,152,262,414,16,34,GrudgePlayer
1108,GrudgePlayer,144,269,413,15,34,GrudgePlayer
1109,GrudgePlayer,154,284,438,16,26,GrudgePlayer
1110,GrudgePlayer,117,247,364,5,47,GrudgePlayer
1111,GrudgePlayer,165,275,440,21,27,GrudgePlayer
1112,GrudgePlayer,123,233,356,6,50,GrudgePlayer
1113,GrudgePlayer,165,275,440,21,27,GrudgePlayer
1114,GrudgePlayer,105,245,350,0,50,GrudgePlayer
1115,GrudgePlayer,140,255,395,9,38,GrudgePlayer
1116,GrudgePlayer,125,265,390,7,39,GrudgePlayer
1117,GrudgePlayer,137,257,394,14,40,GrudgePlayer
1118,GrudgePlayer,126,266,392,9,39,GrudgePlayer
1119,GrudgePlayer,142,282,424,14,30,GrudgePlayer
1120,GrudgePlayer,123,248,371,9,46,GrudgePlayer
1121,GrudgePlayer,144,279,423,10,29,GrudgePlayer
1122,GrudgePlayer,127,272,399,13,38,GrudgePlayer
1123,GrudgePlayer,158,278,436,14,26,GrudgePlayer
1124,GrudgePlayer,139,244,383,12,43,GrudgePlayer
1125,GrudgePlayer,129,274,403,11,36,GrudgePlayer
1126,GrudgePlayer,127,282,409,8,33,GrudgePlayer
1127,GrudgePlayer,145,275,420,10,30,GrudgePlayer
1128,GrudgePlayer,146,256,402,13,37,GrudgePlayer
1129,GrudgePlayer,122,247,369,7,46,GrudgePlayer
1130,GrudgePlayer,107,242,349,5,52,GrudgePlayer
1131,GrudgePlayer,116,281,397,5,36,GrudgePlayer
1132,GrudgePlayer,117,257,374,9,45,GrudgePlayer
1133,GrudgePlayer,114,244,358,5,49,GrudgePlayer
1134,GrudgePlayer,155,260,415,14,33,GrudgePlayer
1135,GrudgePlayer,137,262,399,10,37,GrudgePlayer
1136,GrudgePlayer,125,235,360,7,49,GrudgePlayer
1137,GrudgePlayer,103,253,356,3,49,GrudgePlayer
1138,GrudgePlayer,144,269,413,18,35,GrudgePlayer
1139,GrudgePlayer,153,273,426,16,30,GrudgePlayer
1140,GrudgePlayer,167,272,439,23,28,GrudgePlayer
1141,GrudgePlayer,135,260,395,9,38,GrudgePlayer
1142,GrudgePlayer,146,256,402,16,38,GrudgePlayer
1143,GrudgePlayer,128,248,376,11,45,GrudgePlayer
1144,GrudgePlayer,126,266,392,3,37,GrudgePlayer
1145,GrudgePlayer,156,281,437,18,27,GrudgePlayer
1146,GrudgePlayer,140,270,410,15,35,GrudgePlayer
1147,GrudgePlayer,149,264,413,18,35,GrudgePlayer
1148,GrudgePlayer,136,251,387,7,40,GrudgePlayer
1149,GrudgePlayer,131,266,397,8,37,GrudgePlayer
1150,GrudgePlayer,147,267,414,16,34,GrudgePlayer
1151,GrudgePlayer,127,252,379,11,44,GrudgePlayer
1152,GrudgePlayer,155,245,400,20,40,GrudgePlayer
1153,GrudgePlayer,135,245,380,9,43,GrudgePlayer
1154,GrudgePlayer,126,246,372,7,45,GrudgePlayer
1155,GrudgePlayer,128,258,386,9,41,GrudgePlayer
1156,GrudgePlayer,123,258,381,13,44,GrudgePlayer
1157,GrudgePlayer,152,287,439,17,26,GrudgePlayer
1158,GrudgePlayer,152,252,404,21,39,GrudgePlayer
1159,GrudgePlayer,135,245,380,12,44,GrudgePlayer
1160,GrudgePlayer,146,266,412,14,34,GrudgePlayer
1161,GrudgePlayer,140,255,395,15,40,GrudgePlayer
1162,GrudgePlayer,158,293,451,17,22,GrudgePlayer
1163,GrudgePlayer,129,274,403,11,36,GrudgePlayer
1164,GrudgePlayer,133,258,391,14,41,GrudgePlayer
1165,GrudgePlayer,145,275,420,19,33,GrudgePlayer
1166,GrudgePlayer,136,261,397,11,38,GrudgePlayer
1167,GrudgePlayer,132,242,374,9,45,GrudgePlayer
1168,GrudgePlayer,121,256,377,9,44,GrudgePlayer
1169,GrudgePlayer,120,250,370,8,46,GrudgePlayer
1170,GrudgePlayer,153,258,411,16,35,GrudgePlayer
1171,GrudgePlayer,130,265,395,12,39,GrudgePlayer
1172,GrudgePlayer,124,249,373,11,46,GrudgePlayer
1173,GrudgePlayer,129,269,398,6,36,GrudgePlayer
1174,GrudgePlayer,136,266,402,16,38,GrudgePlayer
1175,GrudgePlayer,120,270,390,13,41,GrudgePlayer
1176,GrudgePlayer,123,253,376,8,44,GrudgePlayer
1177,GrudgePlayer,125,285,410,9,33,GrudgePlayer
1178,GrudgePlayer,154,279,433,17,28,GrudgePlayer
1179,GrudgePlayer,151,251,402,16,38,GrudgePlayer
1180,GrudgePlayer,144,254,398,18,40,GrudgePlayer
1181,GrudgePlayer,150,275,425,12,29,GrudgePlayer
1182,GrudgePlayer,128,258,386,12,42,GrudgePlayer
1183,GrudgePlayer,128,253,381,10,43,GrudgePlayer
1184,GrudgePlayer,162,272,434,21,29,GrudgePlayer
1185,GrudgePlayer,131,281,412,8,32,GrudgePlayer
1186,GrudgePlayer,142,247,389,18,43,GrudgePlayer
1187,GrudgePlayer,124,224,348,10,54,GrudgePlayer
1188,GrudgePlayer,123,263,386,6,40,GrudgePlayer
1189,GrudgePlayer,158,278,436,23,29,GrudgePlayer
1190,GrudgePlayer,127,267,394,8,38,GrudgePlayer
1191,GrudgePlayer,117,252,369,7,46,GrudgePlayer
1192,GrudgePlayer,118,253,371,6,45,GrudgePlayer
1193,GrudgePlayer,124,274,398,12,38,GrudgePlayer
1194,GrudgePlayer,150,270,420,16,32,GrudgePlayer
1195,GrudgePlayer,108,258,366,4,46,GrudgePlayer
1196,GrudgePlayer,132,292,424,11,29,GrudgePlayer
1197,GrudgePlayer,147,252,399,16,39,GrudgePlayer
1198,GrudgePlayer,136,256,392,12,40,GrudgePlayer
1199,GrudgePlayer,118,238,356,3,49,GrudgePlayer
1200,GrudgePlayer,121,241,362,12,50,GrudgePlayer
1201,GrudgePlayer,155,295,450,16,22,GrudgePlayer
1202,GrudgePlayer,152,262,414,19,35,GrudgePlayer
1203,GrudgePlayer,114,254,368,9,47,GrudgePlayer
1204,GrudgePlayer,145,275,420,10,30,GrudgePlayer
1205,GrudgePlayer,178,293,471,28,19,GrudgePlayer
1206,GrudgePlayer,120,260,380,6,42,GrudgePlayer
1207,GrudgePlayer,141,271,412,11,33,GrudgePlayer
1208,GrudgePlayer,132,262,394,14,40,GrudgePlayer
1209,GrudgePlayer,148,258,406,17,37,GrudgePlayer
1210,GrudgePlayer,137,237,374,12,46,GrudgePlayer
1211,GrudgePlayer,123,243,366,10,48,GrudgePlayer
1212,GrudgePlayer,128,263,391,11,40,GrudgePlayer
1213,GrudgePlayer,151,266,417,19,34,GrudgePlayer
1214,GrudgePlayer,115,240,355,8,51,GrudgePlayer
1215,GrudgePlayer,143,278,421,17,32,GrudgePlayer
1216,GrudgePlayer,144,269,413,12,33,GrudgePlayer
1217,GrudgePlayer,144,254,398,15,39,GrudgePlayer
1218,GrudgePlayer,155,270,425,18,31,GrudgePlayer
1219,GrudgePlayer,154,264,418,17,33,GrudgePlayer
1220,GrudgePlayer,119,249,368,6,46,GrudgePlayer
1221,GrudgePlayer,117,252,369,10,47,GrudgePlayer
1222,GrudgePlayer,137,267,404,12,36,GrudgePlayer
1223,GrudgePlayer,132,222,354,10,52,GrudgePlayer
1224,GrudgePlayer,135,280,415,11,32,GrudgePlayer
1225,GrudgePlayer,135,265,400,8,36,GrudgePlayer
1226,GrudgePlayer,131,256,387,7,40,GrudgePlayer
1227,GrudgePlayer,114,259,373,8,45,GrudgePlayer
1228,GrudgePlayer,135,255,390,13,41,GrudgePlayer
1229,GrudgePlayer,141,271,412,14,34,GrudgePlayer
1230,GrudgePlayer,133,263,396,13,39,GrudgePlayer
1231,GrudgePlayer,159,274,433,20,29,GrudgePlayer
1232,GrudgePlayer,155,255,410,21,37,GrudgePlayer
1233,GrudgePlayer,135,270,405,7,34,GrudgePlayer
1234,GrudgePlayer,126,251,377,9,44,GrudgePlayer
1235,GrudgePlayer,152,252,404,21,39,GrudgePlayer
1236,GrudgePlayer,153,258,411,16,35,GrudgePlayer
1237,GrudgePlayer,124,259,383,3,40,GrudgePlayer
1238,GrudgePlayer,129,269,398,9,37,GrudgePlayer
1239,GrudgePlayer,130,265,395,9,38,GrudgePlayer
1240,GrudgePlayer,130,250,380,9,43,GrudgePlayer
1241,GrudgePlayer,135,255,390,10,40,GrudgePlayer
1242,GrudgePlayer,116,256,372,7,45,GrudgePlayer
1243,GrudgePlayer,125,250,375,13,46,GrudgePlayer
1244,GrudgePlayer,121,246,367,8,47,GrudgePlayer
1245,GrudgePlayer,128,268,396,7,37,GrudgePlayer
1246,GrudgePlayer,157,267,424,20,32,GrudgePlayer
1247,GrudgePlayer,138,263,401,12,37,GrudgePlayer
1248,GrudgePlayer,128,253,381,10,43,GrudgePlayer
1249,GrudgePlayer,139,254,393,10,39,GrudgePlayer
1250,GrudgePlayer,127,257,384,7,41,GrudgePlayer
1251,GrudgePlayer,142,277,419,15,32,GrudgePlayer
1252,GrudgePlayer,130,285,415,11,32,GrudgePlayer
1253,GrudgePlayer,139,279,418,8,30,GrudgePlayer
1254,GrudgePlayer,150,260,410,18,36,GrudgePlayer
1255,GrudgePlayer,132,262,394,11,39,GrudgePlayer
1256,GrudgePlayer,119,244,363,7,48,GrudgePlayer
1257,GrudgePlayer,159,284,443,15,24,GrudgePlayer
1258,GrudgePlayer,130,265,395,9,38,GrudgePlayer
1259,GrudgePlayer,137,272,409,14,35,GrudgePlayer
1260,GrudgePlayer,124,244,368,12,48,GrudgePlayer
1261,GrudgePlayer,119,269,388,11,41,GrudgePlayer
1262,GrudgePlayer,124,259,383,9,42,GrudgePlayer
1263,GrudgePlayer,166,271,437,24,29,GrudgePlayer
1264,GrudgePlayer,138,278,416,9,31,GrudgePlayer
1265,GrudgePlayer,141,266,407,12,35,GrudgePlayer
1266,GrudgePlayer,138,253,391,11,40,GrudgePlayer
1267,GrudgePlayer,160,265,425,18,31,GrudgePlayer
1268,GrudgePlayer,144,284,428,21,31,GrudgePlayer
1269,GrudgePlayer,123,268,391,8,39,GrudgePlayer
1270,GrudgePlayer,130,250,380,12,44,GrudgePlayer
1271,GrudgePlayer,134,259,393,13,40,GrudgePlayer
1272,GrudgePlayer,141,246,387,13,42,GrudgePlayer
1273,GrudgePlayer,163,273,436,20,28,GrudgePlayer
1274,GrudgePlayer,140,265,405,10,35,GrudgePlayer
1275,GrudgePlayer,139,269,408,10,34,GrudgePlayer
1276,GrudgePlayer,146,266,412,17,35,GrudgePlayer
1277,GrudgePlayer,119,239,358,8,50,GrudgePlayer
1278,GrudgePlayer,142,267,409,11,34,GrudgePlayer
1279,GrudgePlayer,128,258,386,6,40,GrudgePlayer
1280,GrudgePlayer,125,240,365,9,48,GrudgePlayer
1281,GrudgePlayer,136,266,402,10,36,GrudgePlayer
1282,GrudgePlayer,137,267,404,12,36,GrudgePlayer
1283,GrudgePlayer,137,277,414,10,32,GrudgePlayer
1284,GrudgePlayer,121,246,367,5,46,GrudgePlayer
1285,GrudgePlayer,142,277,419,12,31,GrudgePlayer
1286,GrudgePlayer,152,267,419,18,33,GrudgePlayer
1287,GrudgePlayer,106,251,357,4,49,GrudgePlayer
1288,GrudgePlayer,159,264,423,19,32,GrudgePlayer
1289,GrudgePlayer,131,256,387,7,40,GrudgePlayer
1290,GrudgePlayer,101,236,337,2,55,GrudgePlayer
1291,GrudgePlayer,161,266,427,20,31,GrudgePlayer
1292,GrudgePlayer,139,259,398,12,38,GrudgePlayer
1293,GrudgePlayer,145,275,420,10,30,GrudgePlayer
1294,GrudgePlayer,130,275,405,10,35,GrudgePlayer
1295,GrudgePlayer,130,265,395,9,38,GrudgePlayer
1296,GrudgePlayer,139,269,408,13,35,GrudgePlayer
1297,GrudgePlayer,167,282,449,21,24,GrudgePlayer
1298,GrudgePlayer,138,258,396,13,39,GrudgePlayer
1299,GrudgePlayer,138,248,386,15,43,GrudgePlayer
1300,GrudgePlayer,150,270,420,13,31,GrudgePlayer
1301,GrudgePlayer,149,279,428,15,29,GrudgePlayer
1302,GrudgePlayer,148,248,396,13,39,GrudgePlayer
1303,GrudgePlayer,142,257,399,13,38,GrudgePlayer
1304,GrudgePlayer,128,268,396,10,38,GrudgePlayer
1305,GrudgePlayer,135,265,400,14,38,GrudgePlayer
1306,GrudgePlayer,142,252,394,14,40,GrudgePlayer
1307,GrudgePlayer,139,259,398,15,39,GrudgePlayer
1308,GrudgePlayer,141,256,397,11,38,GrudgePlayer
1309,GrudgePlayer,135,255,390,13,41,GrudgePlayer
1310,GrudgePlayer,124,264,388,8,40,GrudgePlayer
1311,GrudgePlayer,114,239,353,6,51,GrudgePlayer
1312,GrudgePlayer,134,239,373,11,46,GrudgePlayer
1313,GrudgePlayer,142,277,419,15,32,GrudgePlayer
1314,GrudgePlayer,157,272,429,16,29,GrudgePlayer
1315,GrudgePlayer,149,264,413,12,33,GrudgePlayer
1316,GrudgePlayer,128,243,371,9,46,GrudgePlayer
1317,GrudgePlayer,122,252,374,6,44,GrudgePlayer
1318,GrudgePlayer,162,277,439,20,27,GrudgePlayer
1319,GrudgePlayer,115,260,375,7,44,GrudgePlayer
1320,GrudgePlayer,127,252,379,8,43,GrudgePlayer
1321,GrudgePlayer,148,273,421,14,31,GrudgePlayer
1322,GrudgePlayer,95,255,350,3,51,GrudgePlayer
1323,GrudgePlayer,141,281,422,12,30,GrudgePlayer
1324,GrudgePlayer,132,247,379,8,43,GrudgePlayer
1325,GrudgePlayer,145,265,410,12,34,GrudgePlayer
1326,GrudgePlayer,140,265,405,16,37,GrudgePlayer
1327,GrudgePlayer,146,271,417,16,33,GrudgePlayer
1328,GrudgePlayer,126,246,372,10,46,GrudgePlayer
1329,GrudgePlayer,136,256,392,12,40,GrudgePlayer
1330,GrudgePlayer,136,241,377,9,44,GrudgePlayer
1331,GrudgePlayer,130,265,395,15,40,GrudgePlayer
1332,GrudgePlayer,125,245,370,8,46,GrudgePlayer
1333,GrudgePlayer,154,264,418,20,34,GrudgePlayer
1334,GrudgePlayer,138,268,406,14,36,GrudgePlayer
1335,GrudgePlayer,119,254,373,8,45,GrudgePlayer
1336,GrudgePlayer,116,246,362,9,49,GrudgePlayer
1337,GrudgePlayer,136,266,402,13,37,GrudgePlayer
1338,GrudgePlayer,114,244,358,8,50,GrudgePlayer
1339,GrudgePlayer,128,268,396,7,37,GrudgePlayer
1340,GrudgePlayer,130,275,405,10,35,GrudgePlayer
1341,GrudgePlayer,165,250,415,26,37,GrudgePlayer
1342,GrudgePlayer,155,265,420,19,33,GrudgePlayer
1343,GrudgePlayer,126,256,382,8,42,GrudgePlayer
1344,GrudgePlayer,168,278,446,18,24,GrudgePlayer
1345,GrudgePlayer,141,261,402,13,37,GrudgePlayer
1346,GrudgePlayer,141,271,412,11,33,GrudgePlayer
1347,GrudgePlayer,157,257,414,16,34,GrudgePlayer
1348,GrudgePlayer,151,266,417,13,32,GrudgePlayer
1349,GrudgePlayer,126,261,387,10,41,GrudgePlayer
1350,GrudgePlayer,133,263,396,10,38,GrudgePlayer
1351,GrudgePlayer,172,277,449,24,25,GrudgePlayer
1352,GrudgePlayer,123,248,371,12,47,GrudgePlayer
1353,GrudgePlayer,138,278,416,9,31,GrudgePlayer
1354,GrudgePlayer,149,264,413,18,35,GrudgePlayer
1355,GrudgePlayer,134,259,393,7,38,GrudgePlayer
1356,GrudgePlayer,126,271,397,8,37,GrudgePlayer
1357,GrudgePlayer,114,234,348,4,52,GrudgePlayer
1358,GrudgePlayer,150,260,410,15,35,GrudgePlayer
1359,GrudgePlayer,144,269,413,12,33,GrudgePlayer
1360,GrudgePlayer,129,264,393,7,38,GrudgePlayer
1361,GrudgePlayer,126,261,387,7,40,GrudgePlayer
1362,GrudgePlayer,104,259,363,4,47,GrudgePlayer
1363,GrudgePlayer,150,280,430,14,28,GrudgePlayer
1364,GrudgePlayer,169,279,448,26,26,GrudgePlayer
1365,GrudgePlayer,142,252,394,17,41,GrudgePlayer
1366,GrudgePlayer,177,282,459,28,23,GrudgePlayer
1367,GrudgePlayer,151,261,412,17,35,GrudgePlayer
1368,GrudgePlayer,146,281,427,17,30,GrudgePlayer
1369,GrudgePlayer,128,263,391,11,40,GrudgePlayer
1370,GrudgePlayer,140,235,375,13,46,GrudgePlayer
1371,GrudgePlayer,131,286,417,7,30,GrudgePlayer
1372,GrudgePlayer,101,246,347,3,52,GrudgePlayer
1373,GrudgePlayer,150,260,410,18,36,GrudgePlayer
1374,GrudgePlayer,141,291,432,13,27,GrudgePlayer
1375,GrudgePlayer,138,273,411,10,33,GrudgePlayer
1376,GrudgePlayer,169,289,458,21,21,GrudgePlayer
1377,GrudgePlayer,123,268,391,5,38,GrudgePlayer
1378,GrudgePlayer,126,256,382,11,43,GrudgePlayer
1379,GrudgePlayer,136,241,377,9,44,GrudgePlayer
1380,GrudgePlayer,151,251,402,16,38,GrudgePlayer
1381,GrudgePlayer,144,259,403,14,37,GrudgePlayer
1382,GrudgePlayer,131,256,387,13,42,GrudgePlayer
1383,GrudgePlayer,127,257,384,7,41,GrudgePlayer
1384,GrudgePlayer,154,259,413,18,35,GrudgePlayer
1385,GrudgePlayer,132,262,394,5,37,GrudgePlayer
1386,GrudgePlayer,136,251,387,13,42,GrudgePlayer
1387,GrudgePlayer,126,266,392,9,39,GrudgePlayer
1388,GrudgePlayer,146,276,422,18,32,GrudgePlayer
1389,GrudgePlayer,129,264,393,10,39,GrudgePlayer
1390,GrudgePlayer,151,271,422,15,31,GrudgePlayer
1391,GrudgePlayer,150,275,425,18,31,GrudgePlayer
1392,GrudgePlayer,162,277,439,20,27,GrudgePlayer
1393,GrudgePlayer,131,241,372,10,46,GrudgePlayer
1394,GrudgePlayer,139,274,413,12,33,GrudgePlayer
1395,GrudgePlayer,127,287,414,13,33,GrudgePlayer
1396,GrudgePlayer,130,260,390,10,40,GrudgePlayer
1397,GrudgePlayer,133,248,381,10,43,GrudgePlayer
1398,GrudgePlayer,133,263,396,10,38,GrudgePlayer
1399,GrudgePlayer,127,247,374,9,45,GrudgePlayer
1400,GrudgePlayer,143,253,396,16,40,GrudgePlayer
1401,GrudgePlayer,121,241,362,9,49,GrudgePlayer
1402,GrudgePlayer,172,287,459,28,23,GrudgePlayer
1403,GrudgePlayer,155,260,415,20,35,GrudgePlayer
1404,GrudgePlayer,139,264,403,11,36,GrudgePlayer
1405,GrudgePlayer,141,281,422,12,30,GrudgePlayer
1406,GrudgePlayer,141,276,417,16,33,GrudgePlayer
1407,GrudgePlayer,153,253,406,14,36,GrudgePlayer
1408,GrudgePlayer,128,273,401,12,37,GrudgePlayer
1409,GrudgePlayer,136,271,407,9,34,GrudgePlayer
1410,GrudgePlayer,118,268,386,6,40,GrudgePlayer
1411,GrudgePlayer,121,271,392,6,38,GrudgePlayer
1412,GrudgePlayer,124,234,358,8,50,GrudgePlayer
1413,GrudgePlayer,108,258,366,4,46,GrudgePlayer
1414,GrudgePlayer,150,270,420,16,32,GrudgePlayer
1415,GrudgePlayer,135,250,385,14,43,GrudgePlayer
1416,GrudgePlayer,163,273,436,17,27,GrudgePlayer
1417,GrudgePlayer,133,263,396,13,39,GrudgePlayer
1418,GrudgePlayer,139,254,393,7,38,GrudgePlayer
1419,GrudgePlayer,119,234,353,9,52,GrudgePlayer
1420,GrudgePlayer,121,256,377,6,43,GrudgePlayer
1421,GrudgePlayer,121,261,382,8,42,GrudgePlayer
1422,GrudgePlayer,145,255,400,17,39,GrudgePlayer
1423,GrudgePlayer,111,256,367,5,46,GrudgePlayer
1424,GrudgePlayer,115,235,350,6,52,GrudgePlayer
1425,GrudgePlayer,123,268,391,8,39,GrudgePlayer
1426,GrudgePlayer,126,246,372,10,46,GrudgePlayer
1427,GrudgePlayer,139,274,413,15,34,GrudgePlayer
1428,GrudgePlayer,150,285,435,13,26,GrudgePlayer
1429,GrudgePlayer,140,270,410,15,35,GrudgePlayer
1430,GrudgePlayer,128,248,376,8,44,GrudgePlayer
1431,GrudgePlayer,141,246,387,16,43,GrudgePlayer
1432,GrudgePlayer,133,283,416,12,32,GrudgePlayer
1433,GrudgePlayer,150,270,420,13,31,GrudgePlayer
1434,GrudgePlayer,139,269,408,10,34,GrudgePlayer
1435,GrudgePlayer,146,276,422,15,31,GrudgePlayer
1436,GrudgePlayer,149,264,413,15,34,GrudgePlayer
1437,GrudgePlayer,157,282,439,20,27,GrudgePlayer
1438,GrudgePlayer,131,251,382,11,43,GrudgePlayer
1439,GrudgePlayer,148,253,401,12,37,GrudgePlayer
1440,GrudgePlayer,132,267,399,13,38,GrudgePlayer
1441,GrudgePlayer,114,259,373,8,45,GrudgePlayer
1442,GrudgePlayer,146,266,412,17,35,GrudgePlayer
1443,GrudgePlayer,136,271,407,12,35,GrudgePlayer
1444,GrudgePlayer,141,256,397,11,38,GrudgePlayer
1445,GrudgePlayer,141,266,407,12,35,GrudgePlayer
1446,GrudgePlayer,150,265,415,17,34,GrudgePlayer
1447,GrudgePlayer,157,287,444,22,26,GrudgePlayer
1448,GrudgePlayer,114,264,378,7,43,GrudgePlayer
1449,GrudgePlayer,132,267,399,7,36,GrudgePlayer
1450,GrudgePlayer,147,272,419,15,32,GrudgePlayer
1451,GrudgePlayer,122,277,399,7,36,GrudgePlayer
1452,GrudgePlayer,127,252,379,11,44,GrudgePlayer
1453,GrudgePlayer,160,260,420,19,33,GrudgePlayer
1454,GrudgePlayer,146,271,417,19,34,GrudgePlayer
1455,GrudgePlayer,146,261,407,12,35,GrudgePlayer
1456,GrudgePlayer,140,275,415,14,33,GrudgePlayer
1457,GrudgePlayer,173,273,446,27,27,GrudgePlayer
1458,GrudgePlayer,150,280,430,14,28,GrudgePlayer
1459,GrudgePlayer,136,286,422,12,30,GrudgePlayer
1460,GrudgePlayer,122,242,364,8,48,GrudgePlayer
1461,GrudgePlayer,119,264,383,9,42,GrudgePlayer
1462,GrudgePlayer,139,269,408,13,35,GrudgePlayer
1463,GrudgePlayer,130,265,395,6,37,GrudgePlayer
1464,GrudgePlayer,99,244,343,5,54,GrudgePlayer
1465,GrudgePlayer,117,257,374,9,45,GrudgePlayer
1466,GrudgePlayer,153,253,406,20,38,GrudgePlayer
1467,GrudgePlayer,150,300,450,16,22,GrudgePlayer
1468,GrudgePlayer,143,238,381,16,45,GrudgePlayer
1469,GrudgePlayer,118,253,371,6,45,GrudgePlayer
1470,GrudgePlayer,130,255,385,14,43,GrudgePlayer
1471,GrudgePlayer,145,270,415,17,34,GrudgePlayer
1472,GrudgePlayer,135,270,405,10,35,GrudgePlayer
1473,GrudgePlayer,150,240,390,19,43,GrudgePlayer
1474,GrudgePlayer,131,276,407,9,34,GrudgePlayer
1475,GrudgePlayer,129,259,388,11,41,GrudgePlayer
1476,GrudgePlayer,155,265,420,19,33,GrudgePlayer
1477,GrudgePlayer,150,280,430,20,30,GrudgePlayer
1478,GrudgePlayer,129,249,378,13,45,GrudgePlayer
1479,GrudgePlayer,139,274,413,12,33,GrudgePlayer
1480,GrudgePlayer,140,250,390,10,40,GrudgePlayer
1481,GrudgePlayer,176,281,457,23,22,GrudgePlayer
1482,GrudgePlayer,137,267,404,9,35,GrudgePlayer
1483,GrudgePlayer,138,253,391,14,41,GrudgePlayer
1484,GrudgePlayer,131,261,392,9,39,GrudgePlayer
1485,GrudgePlayer,117,282,399,7,36,GrudgePlayer
1486,GrudgePlayer,133,253,386,6,40,GrudgePlayer
1487,GrudgePlayer,183,273,456,31,25,GrudgePlayer
1488,GrudgePlayer,141,256,397,14,39,GrudgePlayer
1489,GrudgePlayer,132,257,389,12,41,GrudgePlayer
1490,GrudgePlayer,107,247,354,7,51,GrudgePlayer
1491,GrudgePlayer,132,262,394,11,39,GrudgePlayer
1492,GrudgePlayer,162,277,439,23,28,GrudgePlayer
1493,GrudgePlayer,117,272,389,6,39,GrudgePlayer
1494,GrudgePlayer,137,267,404,12,36,GrudgePlayer
1495,GrudgePlayer,124,239,363,13,50,GrudgePlayer
1496,GrudgePlayer,142,242,384,13,43,GrudgePlayer
1497,GrudgePlayer,105,240,345,4,53,GrudgePlayer
1498,GrudgePlayer,144,274,418,17,33,GrudgePlayer
1499,GrudgePlayer,140,255,395,9,38,GrudgePlayer
1500,GrudgePlayer,135,270,405,13,36,GrudgePlayer
1501,GrudgePlayer,129,249,378,10,44,GrudgePlayer
1502,GrudgePlayer,129,249,378,13,45,GrudgePlayer
1503,GrudgePlayer,135,265,400,11,37,GrudgePlayer
1504,GrudgePlayer,150,280,430,14,28,GrudgePlayer
1505,GrudgePlayer,125,265,390,10,40,GrudgePlayer
1506,GrudgePlayer,151,266,417,16,33,GrudgePlayer
1507,GrudgePlayer,126,256,382,8,42,GrudgePlayer
1508,GrudgePlayer,141,261,402,16,38,GrudgePlayer
1509,GrudgePlayer,113,263,376,11,45,GrudgePlayer
1510,GrudgePlayer,167,282,449,24,25,GrudgePlayer
1511,GrudgePlayer,129,249,378,7,43,GrudgePlayer
1512,GrudgePlayer,121,271,392,9,39,GrudgePlayer
1513,GrudgePlayer,146,266,412,14,34,GrudgePlayer
1514,GrudgePlayer,172,287,459,25,22,GrudgePlayer
1515,GrudgePlayer,148,253,401,21,40,GrudgePlayer
1516,GrudgePlayer,126,271,397,8,37,GrudgePlayer
1517,GrudgePlayer,141,276,417,13,32,GrudgePlayer
1518,GrudgePlayer,165,275,440,21,27,GrudgePlayer
1519,GrudgePlayer,133,258,391,11,40,GrudgePlayer
1520,GrudgePlayer,161,281,442,20,26,GrudgePlayer
1521,GrudgePlayer,121,261,382,5,41,GrudgePlayer
1522,GrudgePlayer,122,242,364,8,48,GrudgePlayer
1523,GrudgePlayer,141,271,412,11,33,GrudgePlayer
1524,GrudgePlayer,152,262,414,16,34,GrudgePlayer
1525,GrudgePlayer,132,262,394,17,41,GrudgePlayer
1526,GrudgePlayer,144,254,398,18,40,GrudgePlayer
1527,GrudgePlayer,114,249,363,4,47,GrudgePlayer
1528,GrudgePlayer,125,255,380,9,43,GrudgePlayer
1529,GrudgePlayer,144,264,408,13,35,GrudgePlayer
1530,GrudgePlayer,162,282,444,16,24,GrudgePlayer
1531,GrudgePlayer,141,266,407,15,36,GrudgePlayer
1532,GrudgePlayer,161,261,422,24,34,GrudgePlayer
1533,GrudgePlayer,133,248,381,10,43,GrudgePlayer
1534,GrudgePlayer,138,258,396,16,40,GrudgePlayer
1535,GrudgePlayer,114,239,353,3,50,GrudgePlayer
1536,GrudgePlayer,125,265,390,10,40,GrudgePlayer
1537,GrudgePlayer,136,246,382,11,43,GrudgePlayer
1538,GrudgePlayer,169,249,418,20,34,GrudgePlayer
1539,GrudgePlayer,120,265,385,8,41,GrudgePlayer
1540,GrudgePlayer,136,256,392,12,40,GrudgePlayer
1541,GrudgePlayer,134,259,393,10,39,GrudgePlayer
1542,GrudgePlayer,115,260,375,4,43,GrudgePlayer
1543,GrudgePlayer,124,279,403,11,36,GrudgePlayer
1544,GrudgePlayer,150,270,420,13,31,GrudgePlayer
1545,GrudgePlayer,125,270,395,12,39,GrudgePlayer
1546,GrudgePlayer,120,270,390,7,39,GrudgePlayer
1547,GrudgePlayer,153,248,401,15,38,GrudgePlayer
1548,GrudgePlayer,129,239,368,9,47,GrudgePlayer
1549,GrudgePlayer,157,272,429,16,29,GrudgePlayer
1550,GrudgePlayer,134,254,388,14,42,GrudgePlayer
1551,GrudgePlayer,123,243,366,10,48,GrudgePlayer
1552,GrudgePlayer,146,251,397,17,40,GrudgePlayer
1553,GrudgePlayer,121,241,362,6,48,GrudgePlayer
1554,GrudgePlayer,119,239,358,5,49,GrudgePlayer
1555,GrudgePlayer,147,267,414,16,34,GrudgePlayer
1556,GrudgePlayer,126,256,382,8,42,GrudgePlayer
1557,GrudgePlayer,110,245,355,5,50,GrudgePlayer
1558,GrudgePlayer,142,257,399,13,38,GrudgePlayer
1559,GrudgePlayer,126,246,372,7,45,GrudgePlayer
1560,GrudgePlayer,143,268,411,16,35,GrudgePlayer
1561,GrudgePlayer,132,252,384,10,42,GrudgePlayer
1562,GrudgePlayer,123,268,391,5,38,GrudgePlayer
1563,GrudgePlayer,138,263,401,12,37,GrudgePlayer
1564,GrudgePlayer,146,266,412,11,33,GrudgePlayer
1565,GrudgePlayer,150,265,415,17,34,GrudgePlayer
1566,GrudgePlayer,131,256,387,10,41,GrudgePlayer
1567,GrudgePlayer,127,272,399,7,36,GrudgePlayer
1568,GrudgePlayer,136,266,402,10,36,GrudgePlayer
1569,GrudgePlayer,147,267,414,13,33,GrudgePlayer
1570,GrudgePlayer,122,242,364,11,49,GrudgePlayer
1571,GrudgePlayer,140,250,390,16,42,GrudgePlayer
1572,GrudgePlayer,130,265,395,9,38,GrudgePlayer
1573,GrudgePlayer,133,253,386,12,42,GrudgePlayer
1574,GrudgePlayer,145,265,410,15,35,GrudgePlayer
1575,GrudgePlayer,121,256,377,6,43,GrudgePlayer
1576,GrudgePlayer,142,262,404,15,37,GrudgePlayer
1577,GrudgePlayer,132,257,389,9,40,GrudgePlayer
1578,GrudgePlayer,161,281,442,20,26,GrudgePlayer
1579,GrudgePlayer,126,241,367,8,47,GrudgePlayer
1580,GrudgePlayer,143,278,421,11,30,GrudgePlayer
1581,GrudgePlayer,125,255,380,9,43,GrudgePlayer
1582,GrudgePlayer,147,262,409,14,35,GrudgePlayer
1583,GrudgePlayer,136,256,392,9,39,GrudgePlayer
1584,GrudgePlayer,126,251,377,9,44,GrudgePlayer
1585,GrudgePlayer,124,254,378,13,45,GrudgePlayer
1586,GrudgePlayer,158,253,411,19,36,GrudgePlayer
1587,GrudgePlayer,154,279,433,14,27,GrudgePlayer
1588,GrudgePlayer,151,286,437,18,27,GrudgePlayer
1589,GrudgePlayer,145,245,390,16,42,GrudgePlayer
1590,GrudgePlayer,140,270,410,12,34,GrudgePlayer
1591,GrudgePlayer,118,253,371,9,46,GrudgePlayer
1592,GrudgePlayer,144,279,423,16,31,GrudgePlayer
1593,GrudgePlayer,141,246,387,16,43,GrudgePlayer
1594,GrudgePlayer,133,268,401,9,36,GrudgePlayer
1595,GrudgePlayer,151,266,417,13,32,GrudgePlayer
1596,GrudgePlayer,167,282,449,24,25,GrudgePlayer
1597,GrudgePlayer,142,247,389,18,43,GrudgePlayer
1598,GrudgePlayer,133,268,401,12,37,GrudgePlayer
1599,GrudgePlayer,130,255,385,11,42,GrudgePlayer
1600,GrudgePlayer,136,261,397,11,38,GrudgePlayer
1601,GrudgePlayer,126,256,382,11,43,GrudgePlayer
1602,GrudgePlayer,143,268,411,13,34,GrudgePlayer
1603,GrudgePlayer,137,282,419,12,31,GrudgePlayer
1604,GrudgePlayer,152,282,434,12,26,GrudgePlayer
1605,GrudgePlayer,135,265,400,11,37,GrudgePlayer
1606,GrudgePlayer,140,250,390,13,41,GrudgePlayer
1607,GrudgePlayer,148,283,431,15,28,GrudgePlayer
1608,GrudgePlayer,149,259,408,13,35,GrudgePlayer
1609,GrudgePlayer,117,262,379,5,42,GrudgePlayer
1610,GrudgePlayer,125,265,390,10,40,GrudgePlayer
1611,GrudgePlayer,174,259,433,23,30,GrudgePlayer
1612,GrudgePlayer,140,245,385,14,43,GrudgePlayer
1613,GrudgePlayer,131,271,402,16,38,GrudgePlayer
1614,GrudgePlayer,129,244,373,8,45,GrudgePlayer
1615,GrudgePlayer,151,261,412,20,36,GrudgePlayer
1616,GrudgePlayer,132,272,404,12,36,GrudgePlayer
1617,GrudgePlayer,142,267,409,11,34,GrudgePlayer
1618,GrudgePlayer,108,243,351,4,51,GrudgePlayer
1619,GrudgePlayer,151,281,432,16,28,GrudgePlayer
1620,GrudgePlayer,136,251,387,10,41,GrudgePlayer
1621,GrudgePlayer,136,251,387,13,42,GrudgePlayer
1622,GrudgePlayer,143,278,421,14,31,GrudgePlayer
1623,GrudgePlayer,143,288,431,12,27,GrudgePlayer
1624,GrudgePlayer,141,271,412,14,34,GrudgePlayer
1625,GrudgePlayer,138,258,396,13,39,GrudgePlayer
1626,GrudgePlayer,118,258,376,5,43,GrudgePlayer
1627,GrudgePlayer,144,284,428,18,30,GrudgePlayer
1628,GrudgePlayer,152,252,404,18,38,GrudgePlayer
1629,GrudgePlayer,127,267,394,5,37,GrudgePlayer
1630,GrudgePlayer,162,257,419,21,34,GrudgePlayer
1631,GrudgePlayer,170,265,435,25,30,GrudgePlayer
1632,GrudgePlayer,132,262,394,11,39,GrudgePlayer
1633,GrudgePlayer,149,274,423,13,30,GrudgePlayer
1634,GrudgePlayer,132,262,394,11,39,GrudgePlayer
1635,GrudgePlayer,141,276,417,10,31,GrudgePlayer
1636,GrudgePlayer,150,270,420,16,32,GrudgePlayer
1637,GrudgePlayer,148,288,436,17,27,GrudgePlayer
1638,GrudgePlayer,128,238,366,10,48,GrudgePlayer
1639,GrudgePlayer,136,251,387,13,42,GrudgePlayer
1640,GrudgePlayer,136,256,392,12,40,GrudgePlayer
1641,GrudgePlayer,139,254,393,10,39,GrudgePlayer
1642,GrudgePlayer,125,260,385,11,42,GrudgePlayer
1643,GrudgePlayer,131,271,402,10,36,GrudgePlayer
1644,GrudgePlayer,125,260,385,11,42,GrudgePlayer
1645,GrudgePlayer,159,279,438,16,26,GrudgePlayer
1646,GrudgePlayer,151,271,422,21,33,GrudgePlayer
1647,GrudgePlayer,138,273,411,10,33,GrudgePlayer
1648,GrudgePlayer,105,245,350,3,51,GrudgePlayer
1649,GrudgePlayer,135,275,410,12,34,GrudgePlayer
1650,GrudgePlayer,135,270,405,10,35,GrudgePlayer
1651,GrudgePlayer,132,262,394,11,39,GrudgePlayer
1652,GrudgePlayer,129,279,408,10,34,GrudgePlayer
1653,GrudgePlayer,127,237,364,14,50,GrudgePlayer
1654,GrudgePlayer,124,269,393,13,40,GrudgePlayer
1655,GrudgePlayer,134,274,408,13,35,GrudgePlayer
1656,GrudgePlayer,116,256,372,7,45,GrudgePlayer
1657,GrudgePlayer,125,265,390,10,40,GrudgePlayer
1658,GrudgePlayer,147,242,389,18,43,GrudgePlayer
1659,GrudgePlayer,128,268,396,7,37,GrudgePlayer
1660,GrudgePlayer,114,249,363,10,49,GrudgePlayer
1661,GrudgePlayer,148,273,421,17,32,GrudgePlayer
1662,GrudgePlayer,132,267,399,10,37,GrudgePlayer
1663,GrudgePlayer,119,244,363,10,49,GrudgePlayer
1664,GrudgePlayer,142,257,399,16,39,GrudgePlayer
1665,GrudgePlayer,154,264,418,17,33,GrudgePlayer
1666,GrudgePlayer,147,267,414,19,35,GrudgePlayer
1667,GrudgePlayer,124,249,373,5,44,GrudgePlayer
1668,GrudgePlayer,117,262,379,5,42,GrudgePlayer
1669,GrudgePlayer,147,262,409,14,35,GrudgePlayer
1670,GrudgePlayer,136,271,407,12,35,GrudgePlayer
1671,GrudgePlayer,137,247,384,10,42,GrudgePlayer
1672,GrudgePlayer,121,261,382,8,42,GrudgePlayer
1673,GrudgePlayer,133,273,406,11,35,GrudgePlayer
1674,GrudgePlayer,141,261,402,10,36,GrudgePlayer
1675,GrudgePlayer,141,286,427,17,30,GrudgePlayer
1676,GrudgePlayer,153,288,441,19,26,GrudgePlayer
1677,GrudgePlayer,126,251,377,6,43,GrudgePlayer
1678,GrudgePlayer,150,265,415,17,34,GrudgePlayer
1679,GrudgePlayer,161,271,432,16,28,GrudgePlayer
1680,GrudgePlayer,148,268,416,18,34,GrudgePlayer
1681,GrudgePlayer,129,234,363,10,49,GrudgePlayer
1682,GrudgePlayer,135,255,390,13,41,GrudgePlayer
1683,GrudgePlayer,122,257,379,8,43,GrudgePlayer
1684,GrudgePlayer,137,252,389,12,41,GrudgePlayer
1685,GrudgePlayer,154,274,428,12,28,GrudgePlayer
1686,GrudgePlayer,125,250,375,7,44,GrudgePlayer
1687,GrudgePlayer,154,284,438,19,27,GrudgePlayer
1688,GrudgePlayer,138,263,401,9,36,GrudgePlayer
1689,GrudgePlayer,132,262,394,8,38,GrudgePlayer
1690,GrudgePlayer,146,256,402,16,38,GrudgePlayer
1691,GrudgePlayer,143,283,426,13,29,GrudgePlayer
1692,GrudgePlayer,133,273,406,8,34,GrudgePlayer
1693,GrudgePlayer,123,268,391,8,39,GrudgePlayer
1694,GrudgePlayer,125,245,370,8,46,GrudgePlayer
1695,GrudgePlayer,120,260,380,6,42,GrudgePlayer
1696,GrudgePlayer,112,272,384,7,41,GrudgePlayer
1697,GrudgePlayer,121,256,377,6,43,GrudgePlayer
1698,GrudgePlayer,153,258,411,19,36,GrudgePlayer
1699,GrudgePlayer,149,259,408,16,36,GrudgePlayer
1700,GrudgePlayer,120,250,370,11,47,GrudgePlayer
1701,GrudgePlayer,136,236,372,13,47,GrudgePlayer
1702,GrudgePlayer,128,253,381,10,43,GrudgePlayer
1703,GrudgePlayer,139,259,398,9,37,GrudgePlayer
1704,GrudgePlayer,144,264,408,16,36,GrudgePlayer
1705,GrudgePlayer,135,230,365,12,49,GrudgePlayer
1706,GrudgePlayer,136,271,407,12,35,GrudgePlayer
1707,GrudgePlayer,141,256,397,14,39,GrudgePlayer
1708,GrudgePlayer,126,246,372,7,45,GrudgePlayer
1709,GrudgePlayer,114,264,378,7,43,GrudgePlayer
1710,GrudgePlayer,146,261,407,15,36,GrudgePlayer
1711,GrudgePlayer,111,246,357,10,51,GrudgePlayer
1712,GrudgePlayer,165,280,445,20,25,GrudgePlayer
1713,GrudgePlayer,154,269,423,16,31,GrudgePlayer
1714,GrudgePlayer,152,262,414,16,34,GrudgePlayer
1715,GrudgePlayer,128,263,391,8,39,GrudgePlayer
1716,GrudgePlayer,150,260,410,18,36,GrudgePlayer
1717,GrudgePlayer,122,262,384,10,42,GrudgePlayer
1718,GrudgePlayer,121,251,372,7,45,GrudgePlayer
1719,GrudgePlayer,118,243,361,8,49,GrudgePlayer
1720,GrudgePlayer,140,255,395,12,39,GrudgePlayer
1721,GrudgePlayer,137,252,389,12,41,GrudgePlayer
1722,GrudgePlayer,132,262,394,14,40,GrudgePlayer
1723,GrudgePlayer,144,264,408,16,36,GrudgePlayer
1724,GrudgePlayer,139,284,423,13,30,GrudgePlayer
1725,GrudgePlayer,154,264,418,20,34,GrudgePlayer
1726,GrudgePlayer,117,247,364,8,48,GrudgePlayer
1727,GrudgePlayer,154,259,413,18,35,GrudgePlayer
1728,GrudgePlayer,131,251,382,11,43,GrudgePlayer
1729,GrudgePlayer,138,268,406,14,36,GrudgePlayer
1730,GrudgePlayer,135,265,400,11,37,GrudgePlayer
1731,GrudgePlayer,134,244,378,7,43,GrudgePlayer
1732,GrudgePlayer,116,261,377,6,43,GrudgePlayer
1733,GrudgePlayer,161,281,442,23,27,GrudgePlayer
1734,GrudgePlayer,149,279,428,15,29,GrudgePlayer
1735,GrudgePlayer,139,259,398,9,37,GrudgePlayer
1736,GrudgePlayer,132,262,394,11,39,GrudgePlayer
1737,GrudgePlayer,125,260,385,11,42,GrudgePlayer
1738,GrudgePlayer,148,283,431,21,30,GrudgePlayer
1739,GrudgePlayer,147,257,404,12,36,GrudgePlayer
1740,GrudgePlayer,147,267,414,19,35,GrudgePlayer
1741,GrudgePlayer,156,256,412,23,37,GrudgePlayer
1742,GrudgePlayer,143,278,421,17,32,GrudgePlayer
1743,GrudgePlayer,151,256,407,15,36,GrudgePlayer
1744,GrudgePlayer,152,267,419,15,32,GrudgePlayer
1745,GrudgePlayer,151,266,417,19,34,GrudgePlayer
1746,GrudgePlayer,128,248,376,8,44,GrudgePlayer
1747,GrudgePlayer,154,279,433,20,29,GrudgePlayer
1748,GrudgePlayer,150,275,425,15,30,GrudgePlayer
1749,GrudgePlayer,119,254,373,8,45,GrudgePlayer
1750,GrudgePlayer,141,266,407,9,34,GrudgePlayer
1751,GrudgePlayer,128,283,411,7,32,GrudgePlayer
1752,GrudgePlayer,133,263,396,13,39,GrudgePlayer
1753,GrudgePlayer,139,259,398,12,38,GrudgePlayer
1754,GrudgePlayer,148,263,411,16,35,GrudgePlayer
1755,GrudgePlayer,145,265,410,12,34,GrudgePlayer
1756,GrudgePlayer,135,270,405,13,36,GrudgePlayer
1757,GrudgePlayer,126,231,357,10,51,GrudgePlayer
1758,GrudgePlayer,134,274,408,10,34,GrudgePlayer
1759,GrudgePlayer,133,278,411,10,33,GrudgePlayer
1760,GrudgePlayer,142,257,399,13,38,GrudgePlayer
1761,GrudgePlayer,150,270,420,16,32,GrudgePlayer
1762,GrudgePlayer,122,262,384,10,42,GrudgePlayer
1763,GrudgePlayer,126,281,407,12,35,GrudgePlayer
1764,GrudgePlayer,133,258,391,11,40,GrudgePlayer
1765,GrudgePlayer,155,275,430,17,29,GrudgePlayer
1766,GrudgePlayer,139,264,403,11,36,GrudgePlayer
1767,GrudgePlayer,125,255,380,9,43,GrudgePlayer
1768,GrudgePlayer,149,279,428,15,29,GrudgePlayer
1769,GrudgePlayer,135,255,390,13,41,GrudgePlayer
1770,GrudgePlayer,145,255,400,14,38,GrudgePlayer
1771,GrudgePlayer,145,270,415,14,33,GrudgePlayer
1772,GrudgePlayer,136,261,397,14,39,GrudgePlayer
1773,GrudgePlayer,112,252,364,8,48,GrudgePlayer
1774,GrudgePlayer,119,259,378,7,43,GrudgePlayer
1775,GrudgePlayer,120,260,380,9,43,GrudgePlayer
1776,GrudgePlayer,150,250,400,14,38,GrudgePlayer
1777,GrudgePlayer,135,275,410,6,32,GrudgePlayer
1778,GrudgePlayer,178,273,451,26,25,GrudgePlayer
1779,GrudgePlayer,154,274,428,18,30,GrudgePlayer
1780,GrudgePlayer,126,251,377,9,44,GrudgePlayer
1781,GrudgePlayer,132,252,384,10,42,GrudgePlayer
1782,GrudgePlayer,145,270,415,14,33,GrudgePlayer
1783,GrudgePlayer,145,275,420,13,31,GrudgePlayer
1784,GrudgePlayer,146,266,412,17,35,GrudgePlayer
1785,GrudgePlayer,153,258,411,19,36,GrudgePlayer
1786,GrudgePlayer,132,262,394,11,39,GrudgePlayer
1787,GrudgePlayer,164,269,433,23,30,GrudgePlayer
1788,GrudgePlayer,155,275,430,20,30,GrudgePlayer
1789,GrudgePlayer,150,260,410,21,37,GrudgePlayer
1790,GrudgePlayer,133,273,406,14,36,GrudgePlayer
1791,GrudgePlayer,153,258,411,19,36,GrudgePlayer
1792,GrudgePlayer,123,263,386,6,40,GrudgePlayer
1793,GrudgePlayer,164,269,433,20,29,GrudgePlayer
1794,GrudgePlayer,139,264,403,11,36,GrudgePlayer
1795,GrudgePlayer,140,280,420,16,32,GrudgePlayer
1796,GrudgePlayer,148,283,431,15,28,GrudgePlayer
1797,GrudgePlayer,152,262,414,16,34,GrudgePlayer
1798,GrudgePlayer,136,251,387,13,42,GrudgePlayer
1799,GrudgePlayer,122,257,379,5,42,GrudgePlayer
1800,GrudgePlayer,155,265,420,19,33,GrudgePlayer
1801,GrudgePlayer,152,277,429,16,29,GrudgePlayer
1802,GrudgePlayer,137,272,409,11,34,GrudgePlayer
1803,GrudgePlayer,131,236,367,11,48,GrudgePlayer
1804,GrudgePlayer,138,273,411,13,34,GrudgePlayer
1805,GrudgePlayer,142,262,404,12,36,GrudgePlayer
1806,GrudgePlayer,147,272,419,18,33,GrudgePlayer
1807,GrudgePlayer,159,289,448,20,24,GrudgePlayer
1808,GrudgePlayer,153,253,406,14,36,GrudgePlayer
1809,GrudgePlayer,138,248,386,12,42,GrudgePlayer
1810,GrudgePlayer,146,276,422,15,31,GrudgePlayer
1811,GrudgePlayer,145,270,415,11,32,GrudgePlayer
1812,GrudgePlayer,124,249,373,11,46,GrudgePlayer
1813,GrudgePlayer,154,274,428,18,30,GrudgePlayer
1814,GrudgePlayer,128,233,361,8,49,GrudgePlayer
1815,GrudgePlayer,124,259,383,15,44,GrudgePlayer
1816,GrudgePlayer,144,269,413,15,34,GrudgePlayer
1817,GrudgePlayer,114,244,358,8,50,GrudgePlayer
1818,GrudgePlayer,131,256,387,10,41,GrudgePlayer
1819,GrudgePlayer,143,268,411,13,34,GrudgePlayer
1820,GrudgePlayer,104,249,353,3,50,GrudgePlayer
1821,GrudgePlayer,131,266,397,8,37,GrudgePlayer
1822,GrudgePlayer,149,264,413,12,33,GrudgePlayer
1823,GrudgePlayer,131,251,382,8,42,GrudgePlayer
1824,GrudgePlayer,171,286,457,23,22,GrudgePlayer
1825,GrudgePlayer,129,234,363,7,48,GrudgePlayer
1826,GrudgePlayer,161,296,457,26,23,GrudgePlayer
1827,GrudgePlayer,140,260,400,17,39,GrudgePlayer
1828,GrudgePlayer,163,263,426,19,31,GrudgePlayer
1829,GrudgePlayer,126,261,387,10,41,GrudgePlayer
1830,GrudgePlayer,125,265,390,7,39,GrudgePlayer
1831,GrudgePlayer,150,250,400,17,39,GrudgePlayer
1832,GrudgePlayer,163,273,436,14,26,GrudgePlayer
1833,GrudgePlayer,161,266,427,20,31,GrudgePlayer
1834,GrudgePlayer,137,262,399,13,38,GrudgePlayer
1835,GrudgePlayer,147,262,409,17,36,GrudgePlayer
1836,GrudgePlayer,121,271,392,9,39,GrudgePlayer
1837,GrudgePlayer,137,252,389,12,41,GrudgePlayer
1838,GrudgePlayer,128,258,386,12,42,GrudgePlayer
1839,GrudgePlayer,145,245,390,13,41,GrudgePlayer
1840,GrudgePlayer,147,247,394,17,41,GrudgePlayer
1841,GrudgePlayer,109,249,358,2,48,GrudgePlayer
1842,GrudgePlayer,149,269,418,14,32,GrudgePlayer
1843,GrudgePlayer,151,286,437,15,26,GrudgePlayer
1844,GrudgePlayer,154,264,418,17,33,GrudgePlayer
1845,GrudgePlayer,145,275,420,19,33,GrudgePlayer
1846,GrudgePlayer,169,284,453,25,24,GrudgePlayer
1847,GrudgePlayer,130,255,385,8,41,GrudgePlayer
1848,GrudgePlayer,135,275,410,12,34,GrudgePlayer
1849,GrudgePlayer,140,275,415,17,34,GrudgePlayer
1850,GrudgePlayer,137,267,404,12,36,GrudgePlayer
1851,GrudgePlayer,146,251,397,17,40,GrudgePlayer
0,Gullible,406,141,547,47,0,Player A
1,Gullible,408,138,546,46,0,Player A
2,Gullible,402,147,549,49,0,Player A
3,Gullible,398,153,551,51,0,Player A
4,Gullible,394,159,553,53,0,Player A
5,Gullible,394,159,553,53,0,Player A
6,Gullible,410,135,545,45,0,Player A
7,Gullible,396,156,552,52,0,Player A
8,Gullible,406,141,547,47,0,Player A
9,Gullible,392,162,554,54,0,Player A
10,Gullible,378,183,561,61,0,Player A
11,Gullible,386,171,557,57,0,Player A
12,Gullible,400,150,550,50,0,Player A
13,Gullible,400,150,550,50,0,Player A
14,Gullible,392,162,554,54,0,Player A
15,Gullible,416,126,542,42,0,Player A
16,Gullible,396,156,552,52,0,Player A
17,Gullible,406,141,547,47,0,Player A
18,Gullible,396,156,552,52,0,Player A
19,Gullible,382,177,559,59,0,Player A
20,Gullible,402,147,549,49,0,Player A
21,Gullible,404,144,548,48,0,Player A
22,Gullible,406,141,547,47,0,Player A
23,Gullible,402,147,549,49,0,Player A
24,Gullible,394,159,553,53,0,Player A
25,Gullible,394,159,553,53,0,Player A
26,Gullible,408,138,546,46,0,Player A
27,Gullible,392,162,554,54,0,Player A
28,Gullible,392,162,554,54,0,Player A
29,Gullible,388,168,556,56,0,Player A
30,Gullible,386,171,557,57,0,Player A
31,Gullible,382,177,559,59,0,Player A
32,Gullible,394,159,553,53,0,Player A
33,Gullible,400,150,550,50,0,Player A
34,Gullible,402,147,549,49,0,Player A
35,Gullible,398,153,551,51,0,Player A
36,Gullible,388,168,556,56,0,Player A
37,Gullible,388,168,556,56,0,Player A
38,Gullible,414,129,543,43,0,Player A
39,Gullible,392,162,554,54,0,Player A
40,Gullible,396,156,552,52,0,Player A
41,Gullible,416,126,542,42,0,Player A
0,Sly Fox,53,288,341,0,53,Sly Fox
1,Sly Fox,48,308,356,0,48,Sly Fox
2,Sly Fox,45,320,365,0,45,Sly Fox
3,Sly Fox,52,292,344,0,52,Sly Fox
4,Sly Fox,50,300,350,0,50,Sly Fox
5,Sly Fox,45,320,365,0,45,Sly Fox
6,Sly Fox,57,272,329,0,57,Sly Fox
7,Sly Fox,49,304,353,0,49,Sly Fox
8,Sly Fox,54,284,338,0,54,Sly Fox
9,Sly Fox,52,292,344,0,52,Sly Fox
10,Sly Fox,48,308,356,0,48,Sly Fox
11,Sly Fox,53,288,341,0,53,Sly Fox
12,Sly Fox,54,284,338,0,54,Sly Fox
13,Sly Fox,44,324,368,0,44,Sly Fox
14,Sly Fox,50,300,350,0,50,Sly Fox
15,Sly Fox,58,268,326,0,58,Sly Fox
16,Sly Fox,61,256,317,0,61,Sly Fox
17,Sly Fox,47,312,359,0,47,Sly Fox
18,Sly Fox,52,292,344,0,52,Sly Fox
19,Sly Fox,54,284,338,0,54,Sly Fox
20,Sly Fox,52,292,344,0,52,Sly Fox
21,Sly Fox,45,320,365,0,45,Sly Fox
22,Sly Fox,47,312,359,0,47,Sly Fox
23,Sly Fox,55,280,335,0,55,Sly Fox
24,Sly Fox,56,276,332,0,56,Sly Fox
25,Sly Fox,50,300,350,0,50,Sly Fox
26,Sly Fox,44,324,368,0,44,Sly Fox
27,Sly Fox,47,312,359,0,47,Sly Fox
28,Sly Fox,48,308,356,0,48,Sly Fox
29,Sly Fox,51,296,347,0,51,Sly Fox
30,Sly Fox,51,296,347,0,51,Sly Fox
31,Sly Fox,44,324,368,0,44,Sly Fox
32,Sly Fox,44,324,368,0,44,Sly Fox
33,Sly Fox,48,308,356,0,48,Sly Fox
34,Sly Fox,44,324,368,0,44,Sly Fox
35,Sly Fox,53,288,341,0,53,Sly Fox
36,Sly Fox,48,308,356,0,48,Sly Fox
37,Sly Fox,45,320,365,0,45,Sly Fox
38,Sly Fox,54,284,338,0,54,Sly Fox
39,Sly Fox,44,324,368,0,44,Sly Fox
40,Sly Fox,51,296,347,0,51,Sly Fox
41,Sly Fox,49,304,353,0,49,Sly Fox
42,Sly Fox,45,320,365,0,45,Sly Fox
43,Sly Fox,57,272,329,0,57,Sly Fox
44,Sly Fox,55,280,335,0,55,Sly Fox
45,Sly Fox,46,316,362,0,46,Sly Fox
46,Sly Fox,52,292,344,0,52,Sly Fox
47,Sly Fox,45,320,365,0,45,Sly Fox
48,Sly Fox,37,352,389,0,37,Sly Fox
49,Sly Fox,49,304,353,0,49,Sly Fox
50,Sly Fox,46,316,362,0,46,Sly Fox
51,Sly Fox,50,300,350,0,50,Sly Fox
52,Sly Fox,59,264,323,0,59,Sly Fox
53,Sly Fox,49,304,353,0,49,Sly Fox
54,Sly Fox,45,320,365,0,45,Sly Fox
55,Sly Fox,43,328,371,0,43,Sly Fox
56,Sly Fox,53,288,341,0,53,Sly Fox
57,Sly Fox,50,300,350,0,50,Sly Fox
58,Sly Fox,52,292,344,0,52,Sly Fox
59,Sly Fox,51,296,347,0,51,Sly Fox
60,Sly Fox,51,296,347,0,51,Sly Fox
61,Sly Fox,35,360,395,0,35,Sly Fox
62,Sly Fox,48,308,356,0,48,Sly Fox
63,Sly Fox,39,344,383,0,39,Sly Fox
64,Sly Fox,50,300,350,0,50,Sly Fox
65,Sly Fox,46,316,362,0,46,Sly Fox
66,Sly Fox,51,296,347,0,51,Sly Fox
67,Sly Fox,46,316,362,0,46,Sly Fox
68,Sly Fox,40,340,380,0,40,Sly Fox
69,Sly Fox,50,300,350,0,50,Sly Fox
70,Sly Fox,52,292,344,0,52,Sly Fox
71,Sly Fox,50,300,350,0,50,Sly Fox
72,Sly Fox,44,324,368,0,44,Sly Fox
73,Sly Fox,53,288,341,0,53,Sly Fox
74,Sly Fox,52,292,344,0,52,Sly Fox
75,Sly Fox,50,300,350,0,50,Sly Fox
76,Sly Fox,57,272,329,0,57,Sly Fox
77,Sly Fox,53,288,341,0,53,Sly Fox
78,Sly Fox,40,340,380,0,40,Sly Fox
79,Sly Fox,56,276,332,0,56,Sly Fox
80,Sly Fox,44,324,368,0,44,Sly Fox
81,Sly Fox,49,304,353,0,49,Sly Fox
82,Sly Fox,51,296,347,0,51,Sly Fox
83,Sly Fox,46,316,362,0,46,Sly Fox
84,Sly Fox,50,300,350,0,50,Sly Fox
85,Sly Fox,44,324,368,0,44,Sly Fox
86,Sly Fox,49,304,353,0,49,Sly Fox
87,Sly Fox,45,320,365,0,45,Sly Fox
88,Sly Fox,48,308,356,0,48,Sly Fox
89,Sly Fox,39,344,383,0,39,Sly Fox
90,Sly Fox,46,316,362,0,46,Sly Fox
91,Sly Fox,48,308,356,0,48,Sly Fox
92,Sly Fox,50,300,350,0,50,Sly Fox
93,Sly Fox,51,296,347,0,51,Sly Fox
94,Sly Fox,45,320,365,0,45,Sly Fox
95,Sly Fox,48,308,356,0,48,Sly Fox
96,Sly Fox,48,308,356,0,48,Sly Fox
97,Sly Fox,43,328,371,0,43,Sly Fox
98,Sly Fox,58,268,326,0,58,Sly Fox
99,Sly Fox,46,316,362,0,46,Sly Fox
100,Sly Fox,54,284,338,0,54,Sly Fox
101,Sly Fox,53,288,341,0,53,Sly Fox
102,Sly Fox,63,248,311,0,63,Sly Fox
103,Sly Fox,53,288,341,0,53,Sly Fox
104,Sly Fox,52,292,344,0,52,Sly Fox
105,Sly Fox,41,336,377,0,41,Sly Fox
106,Sly Fox,57,272,329,0,57,Sly Fox
107,Sly Fox,40,340,380,0,40,Sly Fox
108,Sly Fox,54,284,338,0,54,Sly Fox
109,Sly Fox,44,324,368,0,44,Sly Fox
110,Sly Fox,53,288,341,0,53,Sly Fox
111,Sly Fox,55,280,335,0,55,Sly Fox
112,Sly Fox,43,328,371,0,43,Sly Fox
113,Sly Fox,49,304,353,0,49,Sly Fox
114,Sly Fox,51,296,347,0,51,Sly Fox
115,Sly Fox,44,324,368,0,44,Sly Fox
116,Sly Fox,56,276,332,0,56,Sly Fox
117,Sly Fox,50,300,350,0,50,Sly Fox
118,Sly Fox,47,312,359,0,47,Sly Fox
119,Sly Fox,42,332,374,0,42,Sly Fox
120,Sly Fox,46,316,362,0,46,Sly Fox
121,Sly Fox,50,300,350,0,50,Sly Fox
122,Sly Fox,52,292,344,0,52,Sly Fox
123,Sly Fox,48,308,356,0,48,Sly Fox
124,Sly Fox,53,288,341,0,53,Sly Fox
125,Sly Fox,52,292,344,0,52,Sly Fox
126,Sly Fox,61,256,317,0,61,Sly Fox
127,Sly Fox,52,292,344,0,52,Sly Fox
128,Sly Fox,51,296,347,0,51,Sly Fox
129,Sly Fox,47,312,359,0,47,Sly Fox
130,Sly Fox,49,304,353,0,49,Sly Fox
131,Sly Fox,52,292,344,0,52,Sly Fox
132,Sly Fox,52,292,344,0,52,Sly Fox
133,Sly Fox,49,304,353,0,49,Sly Fox
134,Sly Fox,53,288,341,0,53,Sly Fox
135,Sly Fox,56,276,332,0,56,Sly Fox
136,Sly Fox,66,236,302,0,66,Sly Fox
137,Sly Fox,54,284,338,0,54,Sly Fox
138,Sly Fox,56,276,332,0,56,Sly Fox
139,Sly Fox,50,300,350,0,50,Sly Fox
140,Sly Fox,50,300,350,0,50,Sly Fox
141,Sly Fox,49,304,353,0,49,Sly Fox
142,Sly Fox,56,276,332,0,56,Sly Fox
143,Sly Fox,50,300,350,0,50,Sly Fox
144,Sly Fox,46,316,362,0,46,Sly Fox
145,Sly Fox,45,320,365,0,45,Sly Fox
146,Sly Fox,57,272,329,0,57,Sly Fox
147,Sly Fox,49,304,353,0,49,Sly Fox
148,Sly Fox,42,332,374,0,42,Sly Fox
149,Sly Fox,54,284,338,0,54,Sly Fox
150,Sly Fox,62,252,314,0,62,Sly Fox
151,Sly Fox,52,292,344,0,52,Sly Fox
152,Sly Fox,39,344,383,0,39,Sly Fox
153,Sly Fox,46,316,362,0,46,Sly Fox
154,Sly Fox,44,324,368,0,44,Sly Fox
155,Sly Fox,56,276,332,0,56,Sly Fox
156,Sly Fox,47,312,359,0,47,Sly Fox
157,Sly Fox,57,272,329,0,57,Sly Fox
158,Sly Fox,51,296,347,0,51,Sly Fox
159,Sly Fox,53,288,341,0,53,Sly Fox
160,Sly Fox,51,296,347,0,51,Sly Fox
161,Sly Fox,52,292,344,0,52,Sly Fox
162,Sly Fox,49,304,353,0,49,Sly Fox
163,Sly Fox,61,256,317,0,61,Sly Fox
164,Sly Fox,44,324,368,0,44,Sly Fox
165,Sly Fox,56,276,332,0,56,Sly Fox
166,Sly Fox,49,304,353,0,49,Sly Fox
167,Sly Fox,50,300,350,0,50,Sly Fox
168,Sly Fox,53,288,341,0,53,Sly Fox
169,Sly Fox,49,304,353,0,49,Sly Fox
170,Sly Fox,50,300,350,0,50,Sly Fox
171,Sly Fox,59,264,323,0,59,Sly Fox
172,Sly Fox,52,292,344,0,52,Sly Fox
173,Sly Fox,56,276,332,0,56,Sly Fox
174,Sly Fox,44,324,368,0,44,Sly Fox
175,Sly Fox,48,308,356,0,48,Sly Fox
176,Sly Fox,54,284,338,0,54,Sly Fox
177,Sly Fox,49,304,353,0,49,Sly Fox
178,Sly Fox,55,280,335,0,55,Sly Fox
179,Sly Fox,51,296,347,0,51,Sly Fox
180,Sly Fox,60,260,320,0,60,Sly Fox
181,Sly Fox,52,292,344,0,52,Sly Fox
182,Sly Fox,52,292,344,0,52,Sly Fox
183,Sly Fox,43,328,371,0,43,Sly Fox
184,Sly Fox,62,252,314,0,62,Sly Fox
185,Sly Fox,41,336,377,0,41,Sly Fox
186,Sly Fox,43,328,371,0,43,Sly Fox
187,Sly Fox,49,304,353,0,49,Sly Fox
188,Sly Fox,54,284,338,0,54,Sly Fox
189,Sly Fox,52,292,344,0,52,Sly Fox
190,Sly Fox,55,280,335,0,55,Sly Fox
191,Sly Fox,44,324,368,0,44,Sly Fox
192,Sly Fox,54,284,338,0,54,Sly Fox
193,Sly Fox,44,324,368,0,44,Sly Fox
194,Sly Fox,50,300,350,0,50,Sly Fox
195,Sly Fox,47,312,359,0,47,Sly Fox
196,Sly Fox,45,320,365,0,45,Sly Fox
197,Sly Fox,52,292,344,0,52,Sly Fox
198,Sly Fox,47,312,359,0,47,Sly Fox
199,Sly Fox,47,312,359,0,47,Sly Fox
200,Sly Fox,53,288,341,0,53,Sly Fox
201,Sly Fox,50,300,350,0,50,Sly Fox
202,Sly Fox,52,292,344,0,52,Sly Fox
203,Sly Fox,60,260,320,0,60,Sly Fox
204,Sly Fox,53,288,341,0,53,Sly Fox
205,Sly Fox,53,288,341,0,53,Sly Fox
206,Sly Fox,57,272,329,0,57,Sly Fox
207,Sly Fox,55,280,335,0,55,Sly Fox
208,Sly Fox,49,304,353,0,49,Sly Fox
209,Sly Fox,45,320,365,0,45,Sly Fox
210,Sly Fox,41,336,377,0,41,Sly Fox
211,Sly Fox,46,316,362,0,46,Sly Fox
212,Sly Fox,38,348,386,0,38,Sly Fox
213,Sly Fox,48,308,356,0,48,Sly Fox
214,Sly Fox,50,300,350,0,50,Sly Fox
215,Sly Fox,58,268,326,0,58,Sly Fox
216,Sly Fox,52,292,344,0,52,Sly Fox
217,Sly Fox,47,312,359,0,47,Sly Fox
218,Sly Fox,47,312,359,0,47,Sly Fox
219,Sly Fox,50,300,350,0,50,Sly Fox
220,Sly Fox,60,260,320,0,60,Sly Fox
221,Sly Fox,50,300,350,0,50,Sly Fox
222,Sly Fox,46,316,362,0,46,Sly Fox
223,Sly Fox,43,328,371,0,43,Sly Fox
224,Sly Fox,56,276,332,0,56,Sly Fox
225,Sly Fox,44,324,368,0,44,Sly Fox
226,Sly Fox,53,288,341,0,53,Sly Fox
227,Sly Fox,53,288,341,0,53,Sly Fox
228,Sly Fox,57,272,329,0,57,Sly Fox
229,Sly Fox,50,300,350,0,50,Sly Fox
230,Sly Fox,55,280,335,0,55,Sly Fox
231,Sly Fox,54,284,338,0,54,Sly Fox
232,Sly Fox,48,308,356,0,48,Sly Fox
233,Sly Fox,43,328,371,0,43,Sly Fox
234,Sly Fox,52,292,344,0,52,Sly Fox
235,Sly Fox,56,276,332,0,56,Sly Fox
236,Sly Fox,54,284,338,0,54,Sly Fox
237,Sly Fox,59,264,323,0,59,Sly Fox
238,Sly Fox,49,304,353,0,49,Sly Fox
239,Sly Fox,58,268,326,0,58,Sly Fox
240,Sly Fox,51,296,347,0,51,Sly Fox
241,Sly Fox,49,304,353,0,49,Sly Fox
242,Sly Fox,54,284,338,0,54,Sly Fox
243,Sly Fox,51,296,347,0,51,Sly Fox
244,Sly Fox,48,308,356,0,48,Sly Fox
245,Sly Fox,42,332,374,0,42,Sly Fox
246,Sly Fox,51,296,347,0,51,Sly Fox
247,Sly Fox,47,312,359,0,47,Sly Fox
248,Sly Fox,41,336,377,0,41,Sly Fox
249,Sly Fox,53,288,341,0,53,Sly Fox
250,Sly Fox,45,320,365,0,45,Sly Fox
251,Sly Fox,53,288,341,0,53,Sly Fox
252,Sly Fox,49,304,353,0,49,Sly Fox
253,Sly Fox,51,296,347,0,51,Sly Fox
254,Sly Fox,37,352,389,0,37,Sly Fox
255,Sly Fox,46,316,362,0,46,Sly Fox
256,Sly Fox,48,308,356,0,48,Sly Fox
257,Sly Fox,52,292,344,0,52,Sly Fox
258,Sly Fox,54,284,338,0,54,Sly Fox
259,Sly Fox,49,304,353,0,49,Sly Fox
260,Sly Fox,49,304,353,0,49,Sly Fox
261,Sly Fox,53,288,341,0,53,Sly Fox
262,Sly Fox,46,316,362,0,46,Sly Fox
263,Sly Fox,49,304,353,0,49,Sly Fox
264,Sly Fox,65,240,305,0,65,Sly Fox
265,Sly Fox,55,280,335,0,55,Sly Fox
266,Sly Fox,48,308,356,0,48,Sly Fox
267,Sly Fox,42,332,374,0,42,Sly Fox
268,Sly Fox,49,304,353,0,49,Sly Fox
269,Sly Fox,51,296,347,0,51,Sly Fox
270,Sly Fox,52,292,344,0,52,Sly Fox
271,Sly Fox,49,304,353,0,49,Sly Fox
272,Sly Fox,50,300,350,0,50,Sly Fox
273,Sly Fox,54,284,338,0,54,Sly Fox
274,Sly Fox,51,296,347,0,51,Sly Fox
275,Sly Fox,45,320,365,0,45,Sly Fox
276,Sly Fox,48,308,356,0,48,Sly Fox
277,Sly Fox,51,296,347,0,51,Sly Fox
278,Sly Fox,59,264,323,0,59,Sly Fox
279,Sly Fox,64,244,308,0,64,Sly Fox
280,Sly Fox,50,300,350,0,50,Sly Fox
281,Sly Fox,59,264,323,0,59,Sly Fox
282,Sly Fox,43,328,371,0,43,Sly Fox
283,Sly Fox,44,324,368,0,44,Sly Fox
284,Sly Fox,48,308,356,0,48,Sly Fox
285,Sly Fox,46,316,362,0,46,Sly Fox
286,Sly Fox,47,312,359,0,47,Sly Fox
287,Sly Fox,51,296,347,0,51,Sly Fox
288,Sly Fox,54,284,338,0,54,Sly Fox
289,Sly Fox,58,268,326,0,58,Sly Fox
290,Sly Fox,43,328,371,0,43,Sly Fox
291,Sly Fox,51,296,347,0,51,Sly Fox
292,Sly Fox,52,292,344,0,52,Sly Fox
293,Sly Fox,43,328,371,0,43,Sly Fox
294,Sly Fox,56,276,332,0,56,Sly Fox
295,Sly Fox,50,300,350,0,50,Sly Fox
296,Sly Fox,53,288,341,0,53,Sly Fox
297,Sly Fox,44,324,368,0,44,Sly Fox
298,Sly Fox,46,316,362,0,46,Sly Fox
299,Sly Fox,48,308,356,0,48,Sly Fox
300,Sly Fox,42,332,374,0,42,Sly Fox
301,Sly Fox,46,316,362,0,46,Sly Fox
302,Sly Fox,57,272,329,0,57,Sly Fox
303,Sly Fox,54,284,338,0,54,Sly Fox
304,Sly Fox,55,280,335,0,55,Sly Fox
305,Sly Fox,52,292,344,0,52,Sly Fox
306,Sly Fox,46,316,362,0,46,Sly Fox
307,Sly Fox,57,272,329,0,57,Sly Fox
308,Sly Fox,49,304,353,0,49,Sly Fox
309,Sly Fox,46,316,362,0,46,Sly Fox
310,Sly Fox,40,340,380,0,40,Sly Fox
311,Sly Fox,49,304,353,0,49,Sly Fox
312,Sly Fox,51,296,347,0,51,Sly Fox
313,Sly Fox,55,280,335,0,55,Sly Fox
314,Sly Fox,43,328,371,0,43,Sly Fox
315,Sly Fox,55,280,335,0,55,Sly Fox
316,Sly Fox,45,320,365,0,45,Sly Fox
317,Sly Fox,49,304,353,0,49,Sly Fox
318,Sly Fox,51,296,347,0,51,Sly Fox
319,Sly Fox,48,308,356,0,48,Sly Fox
320,Sly Fox,50,300,350,0,50,Sly Fox
321,Sly Fox,48,308,356,0,48,Sly Fox
322,Sly Fox,49,304,353,0,49,Sly Fox
323,Sly Fox,59,264,323,0,59,Sly Fox
324,Sly Fox,51,296,347,0,51,Sly Fox
325,Sly Fox,46,316,362,0,46,Sly Fox
326,Sly Fox,60,260,320,0,60,Sly Fox
327,Sly Fox,45,320,365,0,45,Sly Fox
328,Sly Fox,52,292,344,0,52,Sly Fox
329,Sly Fox,49,304,353,0,49,Sly Fox
330,Sly Fox,40,340,380,0,40,Sly Fox
331,Sly Fox,60,260,320,0,60,Sly Fox
332,Sly Fox,48,308,356,0,48,Sly Fox
333,Sly Fox,46,316,362,0,46,Sly Fox
334,Sly Fox,56,276,332,0,56,Sly Fox
335,Sly Fox,49,304,353,0,49,Sly Fox
336,Sly Fox,55,280,335,0,55,Sly Fox
337,Sly Fox,50,300,350,0,50,Sly Fox
338,Sly Fox,49,304,353,0,49,Sly Fox
339,Sly Fox,54,284,338,0,54,Sly Fox
340,Sly Fox,47,312,359,0,47,Sly Fox
341,Sly Fox,48,308,356,0,48,Sly Fox
342,Sly Fox,45,320,365,0,45,Sly Fox
343,Sly Fox,46,316,362,0,46,Sly Fox
344,Sly Fox,46,316,362,0,46,Sly Fox
345,Sly Fox,43,328,371,0,43,Sly Fox
346,Sly Fox,50,300,350,0,50,Sly Fox
347,Sly Fox,46,316,362,0,46,Sly Fox
348,Sly Fox,53,288,341,0,53,Sly Fox
349,Sly Fox,52,292,344,0,52,Sly Fox
350,Sly Fox,42,332,374,0,42,Sly Fox
351,Sly Fox,45,320,365,0,45,Sly Fox
352,Sly Fox,54,284,338,0,54,Sly Fox
353,Sly Fox,52,292,344,0,52,Sly Fox
354,Sly Fox,51,296,347,0,51,Sly Fox
355,Sly Fox,51,296,347,0,51,Sly Fox
356,Sly Fox,54,284,338,0,54,Sly Fox
357,Sly Fox,60,260,320,0,60,Sly Fox
358,Sly Fox,56,276,332,0,56,Sly Fox
359,Sly Fox,49,304,353,0,49,Sly Fox
360,Sly Fox,49,304,353,0,49,Sly Fox
361,Sly Fox,53,288,341,0,53,Sly Fox
362,Sly Fox,44,324,368,0,44,Sly Fox
363,Sly Fox,56,276,332,0,56,Sly Fox
364,Sly Fox,40,340,380,0,40,Sly Fox
365,Sly Fox,48,308,356,0,48,Sly Fox
366,Sly Fox,38,348,386,0,38,Sly Fox
367,Sly Fox,43,328,371,0,43,Sly Fox
368,Sly Fox,60,260,320,0,60,Sly Fox
369,Sly Fox,54,284,338,0,54,Sly Fox
370,Sly Fox,49,304,353,0,49,Sly Fox
371,Sly Fox,52,292,344,0,52,Sly Fox
372,Sly Fox,44,324,368,0,44,Sly Fox
373,Sly Fox,53,288,341,0,53,Sly Fox
374,Sly Fox,55,280,335,0,55,Sly Fox
375,Sly Fox,56,276,332,0,56,Sly Fox
376,Sly Fox,52,292,344,0,52,Sly Fox
377,Sly Fox,37,352,389,0,37,Sly Fox
378,Sly Fox,51,296,347,0,51,Sly Fox
379,Sly Fox,47,312,359,0,47,Sly Fox
380,Sly Fox,48,308,356,0,48,Sly Fox
381,Sly Fox,41,336,377,0,41,Sly Fox
382,Sly Fox,48,308,356,0,48,Sly Fox
383,Sly Fox,50,300,350,0,50,Sly Fox
384,Sly Fox,48,308,356,0,48,Sly Fox
385,Sly Fox,51,296,347,0,51,Sly Fox
386,Sly Fox,50,300,350,0,50,Sly Fox
387,Sly Fox,53,288,341,0,53,Sly Fox
388,Sly Fox,47,312,359,0,47,Sly Fox
389,Sly Fox,51,296,347,0,51,Sly Fox
390,Sly Fox,52,292,344,0,52,Sly Fox
391,Sly Fox,48,308,356,0,48,Sly Fox
392,Sly Fox,54,284,338,0,54,Sly Fox
393,Sly Fox,51,296,347,0,51,Sly Fox
394,Sly Fox,50,300,350,0,50,Sly Fox
395,Sly Fox,46,316,362,0,46,Sly Fox
396,Sly Fox,52,292,344,0,52,Sly Fox
397,Sly Fox,47,312,359,0,47,Sly Fox
398,Sly Fox,48,308,356,0,48,Sly Fox
399,Sly Fox,49,304,353,0,49,Sly Fox
400,Sly Fox,46,316,362,0,46,Sly Fox
401,Sly Fox,59,264,323,0,59,Sly Fox
402,Sly Fox,48,308,356,0,48,Sly Fox
403,Sly Fox,55,280,335,0,55,Sly Fox
404,Sly Fox,56,276,332,0,56,Sly Fox
405,Sly Fox,58,268,326,0,58,Sly Fox
406,Sly Fox,55,280,335,0,55,Sly Fox
407,Sly Fox,47,312,359,0,47,Sly Fox
408,Sly Fox,48,308,356,0,48,Sly Fox
409,Sly Fox,53,288,341,0,53,Sly Fox
410,Sly Fox,50,300,350,0,50,Sly Fox
411,Sly Fox,50,300,350,0,50,Sly Fox
412,Sly Fox,46,316,362,0,46,Sly Fox
413,Sly Fox,46,316,362,0,46,Sly Fox
414,Sly Fox,42,332,374,0,42,Sly Fox
415,Sly Fox,54,284,338,0,54,Sly Fox
416,Sly Fox,55,280,335,0,55,Sly Fox
417,Sly Fox,50,300,350,0,50,Sly Fox
418,Sly Fox,43,328,371,0,43,Sly Fox
419,Sly Fox,56,276,332,0,56,Sly Fox
420,Sly Fox,49,304,353,0,49,Sly Fox
421,Sly Fox,53,288,341,0,53,Sly Fox
422,Sly Fox,51,296,347,0,51,Sly Fox
423,Sly Fox,47,312,359,0,47,Sly Fox
424,Sly Fox,48,308,356,0,48,Sly Fox
425,Sly Fox,62,252,314,0,62,Sly Fox
426,Sly Fox,45,320,365,0,45,Sly Fox
427,Sly Fox,51,296,347,0,51,Sly Fox
428,Sly Fox,53,288,341,0,53,Sly Fox
429,Sly Fox,54,284,338,0,54,Sly Fox
430,Sly Fox,46,316,362,0,46,Sly Fox
431,Sly Fox,57,272,329,0,57,Sly Fox
432,Sly Fox,42,332,374,0,42,Sly Fox
433,Sly Fox,53,288,341,0,53,Sly Fox
434,Sly Fox,47,312,359,0,47,Sly Fox
435,Sly Fox,50,300,350,0,50,Sly Fox
436,Sly Fox,54,284,338,0,54,Sly Fox
437,Sly Fox,51,296,347,0,51,Sly Fox
438,Sly Fox,44,324,368,0,44,Sly Fox
439,Sly Fox,59,264,323,0,59,Sly Fox
440,Sly Fox,45,320,365,0,45,Sly Fox
441,Sly Fox,53,288,341,0,53,Sly Fox
442,Sly Fox,57,272,329,0,57,Sly Fox
443,Sly Fox,44,324,368,0,44,Sly Fox
444,Sly Fox,50,300,350,0,50,Sly Fox
445,Sly Fox,49,304,353,0,49,Sly Fox
446,Sly Fox,45,320,365,0,45,Sly Fox
447,Sly Fox,53,288,341,0,53,Sly Fox
448,Sly Fox,54,284,338,0,54,Sly Fox
449,Sly Fox,53,288,341,0,53,Sly Fox
450,Sly Fox,53,288,341,0,53,Sly Fox
451,Sly Fox,60,260,320,0,60,Sly Fox
452,Sly Fox,47,312,359,0,47,Sly Fox
453,Sly Fox,55,280,335,0,55,Sly Fox
454,Sly Fox,50,300,350,0,50,Sly Fox
455,Sly Fox,49,304,353,0,49,Sly Fox
456,Sly Fox,47,312,359,0,47,Sly Fox
457,Sly Fox,50,300,350,0,50,Sly Fox
458,Sly Fox,46,316,362,0,46,Sly Fox
459,Sly Fox,48,308,356,0,48,Sly Fox
460,Sly Fox,49,304,353,0,49,Sly Fox
461,Sly Fox,48,308,356,0,48,Sly Fox
462,Sly Fox,54,284,338,0,54,Sly Fox
463,Sly Fox,51,296,347,0,51,Sly Fox
464,Sly Fox,49,304,353,0,49,Sly Fox
465,Sly Fox,56,276,332,0,56,Sly Fox
466,Sly Fox,49,304,353,0,49,Sly Fox
467,Sly Fox,48,308,356,0,48,Sly Fox
468,Sly Fox,56,276,332,0,56,Sly Fox
469,Sly Fox,54,284,338,0,54,Sly Fox
470,Sly Fox,49,304,353,0,49,Sly Fox
471,Sly Fox,42,332,374,0,42,Sly Fox
472,Sly Fox,52,292,344,0,52,Sly Fox
473,Sly Fox,51,296,347,0,51,Sly Fox
474,Sly Fox,41,336,377,0,41,Sly Fox
475,Sly Fox,38,348,386,0,38,Sly Fox
476,Sly Fox,51,296,347,0,51,Sly Fox
477,Sly Fox,53,288,341,0,53,Sly Fox
478,Sly Fox,45,320,365,0,45,Sly Fox
479,Sly Fox,39,344,383,0,39,Sly Fox
480,Sly Fox,46,316,362,0,46,Sly Fox
481,Sly Fox,53,288,341,0,53,Sly Fox
482,Sly Fox,45,320,365,0,45,Sly Fox
483,Sly Fox,53,288,341,0,53,Sly Fox
484,Sly Fox,45,320,365,0,45,Sly Fox
485,Sly Fox,52,292,344,0,52,Sly Fox
486,Sly Fox,51,296,347,0,51,Sly Fox
487,Sly Fox,53,288,341,0,53,Sly Fox
488,Sly Fox,44,324,368,0,44,Sly Fox
489,Sly Fox,57,272,329,0,57,Sly Fox
490,Sly Fox,49,304,353,0,49,Sly Fox
491,Sly Fox,50,300,350,0,50,Sly Fox
492,Sly Fox,49,304,353,0,49,Sly Fox
493,Sly Fox,59,264,323,0,59,Sly Fox
494,Sly Fox,43,328,371,0,43,Sly Fox
495,Sly Fox,43,328,371,0,43,Sly Fox
496,Sly Fox,51,296,347,0,51,Sly Fox
497,Sly Fox,46,316,362,0,46,Sly Fox
498,Sly Fox,47,312,359,0,47,Sly Fox
499,Sly Fox,50,300,350,0,50,Sly Fox
500,Sly Fox,42,332,374,0,42,Sly Fox
501,Sly Fox,47,312,359,0,47,Sly Fox
502,Sly Fox,55,280,335,0,55,Sly Fox
503,Sly Fox,56,276,332,0,56,Sly Fox
504,Sly Fox,60,260,320,0,60,Sly Fox
505,Sly Fox,49,304,353,0,49,Sly Fox
506,Sly Fox,52,292,344,0,52,Sly Fox
507,Sly Fox,49,304,353,0,49,Sly Fox
508,Sly Fox,48,308,356,0,48,Sly Fox
509,Sly Fox,49,304,353,0,49,Sly Fox
510,Sly Fox,53,288,341,0,53,Sly Fox
511,Sly Fox,49,304,353,0,49,Sly Fox
512,Sly Fox,53,288,341,0,53,Sly Fox
513,Sly Fox,44,324,368,0,44,Sly Fox
514,Sly Fox,58,268,326,0,58,Sly Fox
515,Sly Fox,52,292,344,0,52,Sly Fox
516,Sly Fox,56,276,332,0,56,Sly Fox
0,Evan,231,216,447,22,25,Player A
1,Evan,218,243,461,27,22,Evan
2,Evan,221,231,452,27,25,Evan
3,Evan,221,236,457,26,23,Evan
4,Evan,214,234,448,32,28,Evan
5,Evan,229,234,463,20,19,Evan
6,Evan,230,220,450,22,24,Player A
7,Evan,221,236,457,26,23,Evan
8,Evan,228,213,441,25,28,Player A
9,Evan,222,227,449,27,26,Evan
10,Evan,237,202,439,20,27,Player A
11,Evan,218,238,456,28,24,Evan
12,Evan,246,191,437,15,26,Player A
13,Evan,231,211,442,23,27,Player A
14,Evan,222,227,449,27,26,Evan
15,Evan,233,223,456,19,21,Player A
16,Evan,220,230,450,28,26,Evan
17,Evan,219,244,463,26,21,Evan
18,Evan,234,209,443,21,26,Player A
19,Evan,218,248,466,26,20,Evan
20,Evan,215,235,450,31,27,Evan
21,Evan,220,225,445,29,28,Evan
22,Evan,224,229,453,25,24,Evan
23,Evan,230,210,440,24,28,Player A
24,Evan,227,227,454,23,23,Tie
25,Evan,219,239,458,27,23,Evan
26,Evan,219,234,453,28,25,Evan
27,Evan,221,231,452,27,25,Evan
28,Evan,219,239,458,27,23,Evan
29,Evan,220,235,455,27,24,Evan
30,Evan,228,228,456,22,22,Tie
31,Evan,217,237,454,29,25,Evan
32,Evan,207,257,464,33,23,Evan
33,Evan,237,192,429,22,31,Player A
34,Evan,242,197,439,17,26,Player A
35,Evan,231,211,442,23,27,Player A
36,Evan,226,221,447,25,26,Player A
37,Evan,231,211,442,23,27,Player A
38,Evan,234,204,438,22,28,Player A
39,Evan,231,221,452,21,23,Player A
40,Evan,230,220,450,22,24,Player A
41,Evan,220,245,465,25,20,Evan
42,Evan,229,224,453,22,23,Player A
43,Evan,224,234,458,24,22,Evan
44,Evan,223,223,446,27,27,Tie
45,Evan,232,202,434,24,30,Player A
46,Evan,234,224,458,18,20,Player A
47,Evan,226,216,442,26,28,Player A
48,Evan,219,229,448,29,27,Evan
49,Evan,223,233,456,25,23,Evan
50,Evan,230,210,440,24,28,Player A
51,Evan,202,257,459,37,26,Evan
52,Evan,229,219,448,23,25,Player A
53,Evan,222,232,454,26,24,Evan
54,Evan,224,234,458,24,22,Evan
55,Evan,227,212,439,26,29,Player A
56,Evan,224,234,458,24,22,Evan
57,Evan,222,237,459,25,22,Evan
58,Evan,224,229,453,25,24,Evan
59,Evan,212,237,449,33,28,Evan
60,Evan,224,239,463,23,20,Evan
61,Evan,221,236,457,26,23,Evan
62,Evan,221,236,457,26,23,Evan
63,Evan,221,216,437,30,31,Player A
64,Evan,222,237,459,25,22,Evan
65,Evan,219,229,448,29,27,Evan
66,Evan,218,233,451,29,26,Evan
67,Evan,217,232,449,30,27,Evan
68,Evan,222,227,449,27,26,Evan
69,Evan,218,233,451,29,26,Evan
70,Evan,235,205,440,21,27,Player A
71,Evan,221,231,452,27,25,Evan
72,Evan,223,233,456,25,23,Evan
73,Evan,218,248,466,26,20,Evan
74,Evan,204,269,473,33,20,Evan
75,Evan,218,243,461,27,22,Evan
76,Evan,232,217,449,21,24,Player A
77,Evan,227,227,454,23,23,Tie
78,Evan,230,220,450,22,24,Player A
79,Evan,237,207,444,19,25,Player A
80,Evan,212,252,464,30,22,Evan
81,Evan,214,239,453,31,26,Evan
82,Evan,233,213,446,21,25,Player A
83,Evan,228,233,461,21,20,Evan
84,Evan,238,208,446,18,24,Player A
85,Evan,218,248,466,26,20,Evan
86,Evan,219,229,448,29,27,Evan
87,Evan,210,265,475,29,18,Evan
88,Evan,226,221,447,25,26,Player A
89,Evan,227,232,459,22,21,Evan
90,Evan,223,218,441,28,29,Player A
91,Evan,216,241,457,29,24,Evan
92,Evan,215,230,445,32,29,Evan
93,Evan,219,244,463,26,21,Evan
94,Evan,231,211,442,23,27,Player A
95,Evan,219,249,468,25,19,Evan
96,Evan,218,238,456,28,24,Evan
97,Evan,217,242,459,28,23,Evan
98,Evan,220,230,450,28,26,Evan
99,Evan,231,201,432,25,31,Player A
100,Evan,228,228,456,22,22,Tie
101,Evan,210,240,450,34,28,Evan
102,Evan,219,229,448,29,27,Evan
103,Evan,235,190,425,24,33,Player A
104,Evan,223,218,441,28,29,Player A
105,Evan,234,204,438,22,28,Player A
106,Evan,234,214,448,20,24,Player A
107,Evan,220,240,460,26,22,Evan
108,Evan,231,211,442,23,27,Player A
109,Evan,235,210,445,20,25,Player A
110,Evan,223,218,441,28,29,Player A
111,Evan,218,233,451,29,26,Evan
112,Evan,217,237,454,29,25,Evan
113,Evan,230,210,440,24,28,Player A
114,Evan,227,222,449,24,25,Player A
115,Evan,236,206,442,20,26,Player A
116,Evan,233,213,446,21,25,Player A
117,Evan,223,238,461,24,21,Evan
118,Evan,227,207,434,27,31,Player A
119,Evan,212,232,444,34,30,Evan
120,Evan,224,239,463,23,20,Evan
121,Evan,219,234,453,28,25,Evan
122,Evan,239,199,438,19,27,Player A
123,Evan,228,228,456,22,22,Tie
124,Evan,220,235,455,27,24,Evan
125,Evan,211,256,467,30,21,Evan
126,Evan,223,228,451,26,25,Evan
127,Evan,212,247,459,31,24,Evan
128,Evan,221,236,457,26,23,Evan
129,Evan,214,244,458,30,24,Evan
130,Evan,226,216,442,26,28,Player A
131,Evan,228,223,451,23,24,Player A
132,Evan,235,200,435,22,29,Player A
133,Evan,239,194,433,20,29,Player A
134,Evan,216,241,457,29,24,Evan
135,Evan,224,214,438,28,30,Player A
136,Evan,220,235,455,27,24,Evan
137,Evan,234,224,458,18,20,Player A
138,Evan,227,232,459,22,21,Evan
139,Evan,222,232,454,26,24,Evan
140,Evan,224,239,463,23,20,Evan
141,Evan,222,222,444,28,28,Tie
142,Evan,227,217,444,25,27,Player A
143,Evan,237,202,439,20,27,Player A
144,Evan,232,207,439,23,28,Player A
145,Evan,226,216,442,26,28,Player A
146,Evan,234,199,433,23,30,Player A
147,Evan,219,234,453,28,25,Evan
148,Evan,231,206,437,24,29,Player A
149,Evan,222,227,449,27,26,Evan
150,Evan,233,208,441,22,27,Player A
151,Evan,224,224,448,26,26,Tie
152,Evan,221,236,457,26,23,Evan
153,Evan,230,215,445,23,26,Player A
154,Evan,231,216,447,22,25,Player A
155,Evan,219,239,458,27,23,Evan
156,Evan,250,170,420,16,32,Player A
157,Evan,226,236,462,22,20,Evan
158,Evan,216,246,462,28,22,Evan
159,Evan,222,222,444,28,28,Tie
160,Evan,226,211,437,27,30,Player A
161,Evan,225,240,465,22,19,Evan
162,Evan,216,241,457,29,24,Evan
163,Evan,228,213,441,25,28,Player A
164,Evan,227,227,454,23,23,Tie
165,Evan,232,207,439,23,28,Player A
166,Evan,229,214,443,24,27,Player A
167,Evan,224,224,448,26,26,Tie
168,Evan,224,229,453,25,24,Evan
169,Evan,211,236,447,34,29,Evan
170,Evan,234,214,448,20,24,Player A
171,Evan,218,238,456,28,24,Evan
172,Evan,235,205,440,21,27,Player A
173,Evan,233,183,416,27,37,Player A
174,Evan,230,205,435,25,30,Player A
175,Evan,226,236,462,22,20,Evan
176,Evan,228,228,456,22,22,Tie
177,Evan,212,252,464,30,22,Evan
178,Evan,240,195,435,19,28,Player A
179,Evan,227,222,449,24,25,Player A
180,Evan,226,211,437,27,30,Player A
181,Evan,232,217,449,21,24,Player A
0,Randy,282,177,459,25,22,Player A
1,Randy,242,197,439,26,29,Player A
2,Randy,258,213,471,34,21,Player A
3,Randy,230,230,460,32,24,Tie
4,Randy,232,217,449,30,27,Player A
5,Randy,218,238,456,28,24,Randy
6,Randy,240,210,450,28,26,Player A
7,Randy,202,242,444,28,28,Randy
8,Randy,234,214,448,23,25,Player A
9,Randy,248,203,451,20,23,Player A
10,Randy,204,239,443,24,27,Randy
11,Randy,229,224,453,25,24,Player A
12,Randy,229,229,458,27,23,Tie
13,Randy,216,251,467,24,19,Randy
14,Randy,227,237,464,30,22,Randy
15,Randy,230,235,465,25,20,Randy
16,Randy,214,219,433,26,31,Randy
17,Randy,228,228,456,28,24,Tie
18,Randy,237,227,464,33,23,Player A
19,Randy,266,191,457,20,21,Player A
20,Randy,243,213,456,28,24,Player A
21,Randy,231,221,452,24,24,Player A
22,Randy,246,231,477,28,17,Player A
23,Randy,230,235,465,28,21,Randy
24,Randy,244,209,453,25,24,Player A
25,Randy,228,198,426,19,31,Player A
26,Randy,232,222,454,26,24,Player A
27,Randy,209,239,448,20,24,Randy
28,Randy,197,237,434,24,30,Randy
29,Randy,218,238,456,22,22,Randy
30,Randy,217,242,459,28,23,Randy
31,Randy,225,195,420,22,34,Player A
32,Randy,237,237,474,34,20,Tie
33,Randy,223,223,446,24,26,Tie
34,Randy,197,257,454,26,24,Randy
35,Randy,242,227,469,29,20,Player A
36,Randy,210,225,435,19,28,Randy
37,Randy,223,223,446,30,28,Tie
38,Randy,221,221,442,26,28,Tie
39,Randy,236,211,447,25,26,Player A
40,Randy,216,226,442,20,26,Randy
41,Randy,207,237,444,22,26,Randy
42,Randy,239,224,463,29,22,Player A
43,Randy,194,209,403,17,38,Randy
44,Randy,223,223,446,27,27,Tie
45,Randy,224,224,448,23,25,Tie
46,Randy,195,250,445,23,26,Randy
47,Randy,246,231,477,31,18,Player A
48,Randy,211,206,417,13,32,Player A
49,Randy,190,260,450,25,25,Randy
50,Randy,223,218,441,25,28,Player A
51,Randy,219,234,453,25,24,Randy
52,Randy,225,220,445,26,27,Player A
53,Randy,199,224,423,25,34,Randy
54,Randy,217,237,454,23,23,Randy
55,Randy,233,198,431,18,29,Player A
56,Randy,248,228,476,27,17,Player A
57,Randy,241,226,467,27,20,Player A
58,Randy,259,204,463,26,21,Player A
59,Randy,222,232,454,23,23,Randy
60,Randy,209,239,448,17,23,Randy
61,Randy,228,233,461,27,22,Randy
62,Randy,216,226,442,14,24,Randy
63,Randy,225,225,450,25,25,Tie
64,Randy,242,202,444,28,28,Player A
65,Randy,208,233,441,22,27,Randy
66,Randy,184,259,443,24,27,Randy
67,Randy,217,222,439,23,28,Randy
68,Randy,238,198,436,29,31,Player A
69,Randy,268,188,456,19,21,Player A
70,Randy,229,229,458,24,22,Tie
71,Randy,262,207,469,32,21,Player A
72,Randy,238,203,441,25,28,Player A
73,Randy,259,174,433,20,29,Player A
74,Randy,218,233,451,26,25,Randy
75,Randy,202,257,459,28,23,Randy
76,Randy,214,214,428,24,32,Tie
77,Randy,217,247,464,21,19,Randy
78,Randy,235,210,445,26,27,Player A
79,Randy,219,229,448,26,26,Randy
80,Randy,209,244,453,28,25,Randy
81,Randy,234,209,443,21,26,Player A
82,Randy,238,218,456,25,23,Player A
83,Randy,226,206,432,22,30,Player A
84,Randy,243,193,436,20,28,Player A
85,Randy,240,200,440,18,26,Player A
86,Randy,232,217,449,21,24,Player A
87,Randy,227,237,464,30,22,Randy
88,Randy,210,245,455,27,24,Randy
89,Randy,195,250,445,17,24,Randy
90,Randy,249,219,468,28,20,Player A
91,Randy,220,210,430,29,33,Player A
92,Randy,242,212,454,26,24,Player A
93,Randy,224,244,468,28,20,Randy
94,Randy,184,224,408,22,38,Randy
95,Randy,196,221,417,22,35,Randy
96,Randy,236,216,452,27,25,Player A
97,Randy,238,203,441,25,28,Player A
98,Randy,231,221,452,30,26,Player A
99,Randy,209,229,438,22,28,Randy
100,Randy,222,227,449,24,25,Randy
101,Randy,228,218,446,30,28,Player A
102,Randy,218,228,446,21,25,Randy
103,Randy,209,239,448,29,27,Randy
104,Randy,205,255,460,23,21,Randy
105,Randy,219,249,468,25,19,Randy
106,Randy,195,220,415,23,36,Randy
107,Randy,270,190,460,32,24,Player A
108,Randy,273,188,461,33,24,Player A
109,Randy,215,215,430,20,30,Tie
110,Randy,214,239,453,31,26,Randy
111,Randy,227,217,444,22,26,Player A
112,Randy,232,212,444,25,27,Player A
113,Randy,192,242,434,24,30,Randy
114,Randy,240,225,465,34,23,Player A
115,Randy,223,223,446,24,26,Tie
116,Randy,243,208,451,29,26,Player A
117,Randy,229,224,453,28,25,Player A
118,Randy,234,239,473,27,18,Randy
119,Randy,206,256,462,22,20,Randy
120,Randy,247,202,449,24,25,Player A
121,Randy,247,232,479,24,15,Player A
122,Randy,244,204,448,29,27,Player A
123,Randy,213,243,456,28,24,Randy
124,Randy,222,217,439,29,30,Player A
125,Randy,233,218,451,26,25,Player A
126,Randy,237,212,449,33,28,Player A
127,Randy,262,187,449,21,24,Player A
128,Randy,214,249,463,26,21,Randy
129,Randy,228,213,441,25,28,Player A
130,Randy,225,225,450,22,24,Tie
131,Randy,254,219,473,27,18,Player A
132,Randy,210,215,425,21,32,Randy
133,Randy,236,236,472,23,17,Tie
134,Randy,238,193,431,24,31,Player A
135,Randy,230,230,460,32,24,Tie
136,Randy,245,220,465,28,21,Player A
137,Randy,201,206,407,18,37,Randy
138,Randy,256,201,457,23,22,Player A
139,Randy,214,249,463,26,21,Randy
140,Randy,225,230,455,27,24,Randy
141,Randy,217,227,444,19,25,Randy
142,Randy,239,204,443,24,27,Player A
143,Randy,241,226,467,24,19,Player A
144,Randy,247,187,434,27,31,Player A
145,Randy,250,190,440,21,27,Player A
146,Randy,216,256,472,32,20,Randy
147,Randy,207,272,479,27,16,Randy
148,Randy,209,224,433,17,28,Randy
149,Randy,264,199,463,38,25,Player A
150,Randy,205,250,455,24,23,Randy
151,Randy,227,247,474,40,22,Randy
152,Randy,204,244,448,23,25,Randy
153,Randy,206,256,462,34,24,Randy
154,Randy,221,211,432,22,30,Player A
155,Randy,193,238,431,21,30,Randy
156,Randy,254,214,468,25,19,Player A
157,Randy,204,244,448,20,24,Randy
158,Randy,229,204,433,23,30,Player A
159,Randy,208,243,451,26,25,Randy
160,Randy,202,232,434,21,29,Randy
161,Randy,237,237,474,37,21,Tie
162,Randy,251,181,432,19,29,Player A
163,Randy,231,231,462,31,23,Tie
164,Randy,239,229,468,34,22,Player A
165,Randy,217,232,449,24,25,Randy
166,Randy,275,185,460,23,21,Player A
167,Randy,227,212,439,23,28,Player A
168,Randy,225,245,470,30,20,Randy
169,Randy,185,240,425,18,31,Randy
170,Randy,196,231,427,23,32,Randy
171,Randy,224,229,453,28,25,Randy
172,Randy,232,192,424,20,32,Player A
173,Randy,226,216,442,26,28,Player A
174,Randy,250,180,430,17,29,Player A
175,Randy,190,245,435,25,30,Randy
176,Randy,249,204,453,25,24,Player A
177,Randy,201,246,447,28,27,Randy
178,Randy,259,219,478,29,17,Player A
179,Randy,205,255,460,29,23,Randy
180,Randy,259,209,468,28,20,Player A
181,Randy,232,217,449,24,25,Player A
182,Randy,237,232,469,29,20,Player A
183,Randy,249,194,443,27,28,Player A
184,Randy,188,263,451,23,24,Randy
185,Randy,233,228,461,27,22,Player A
186,Randy,249,189,438,22,28,Player A
187,Randy,240,225,465,31,22,Player A
188,Randy,238,188,426,19,31,Player A
189,Randy,267,192,459,25,22,Player A
190,Randy,237,222,459,22,21,Player A
191,Randy,202,247,449,27,26,Randy
192,Randy,225,215,440,24,28,Player A
193,Randy,246,196,442,20,26,Player A
194,Randy,228,228,456,28,24,Tie
195,Randy,233,228,461,24,21,Player A
196,Randy,226,196,422,18,32,Player A
197,Randy,201,256,457,20,21,Randy
198,Randy,225,250,475,26,17,Randy
199,Randy,263,188,451,32,27,Player A
200,Randy,239,214,453,28,25,Player A
201,Randy,210,235,445,23,26,Randy
202,Randy,245,195,440,21,27,Player A
203,Randy,231,226,457,26,23,Player A
204,Randy,234,209,443,27,28,Player A
205,Randy,222,232,454,29,25,Randy
206,Randy,252,202,454,23,23,Player A
207,Randy,254,189,443,24,27,Player A
208,Randy,269,194,463,26,21,Player A
209,Randy,224,229,453,28,25,Randy
210,Randy,227,222,449,27,26,Player A
211,Randy,233,193,426,25,33,Player A
212,Randy,218,243,461,27,22,Randy
213,Randy,222,202,424,20,32,Player A
214,Randy,197,242,439,23,28,Randy
215,Randy,236,201,437,24,29,Player A
216,Randy,214,239,453,28,25,Randy
217,Randy,233,223,456,22,22,Player A
218,Randy,223,218,441,22,27,Player A
219,Randy,257,202,459,28,23,Player A
220,Randy,189,239,428,18,30,Randy
221,Randy,205,240,445,23,26,Randy
222,Randy,238,228,466,29,21,Player A
223,Randy,217,202,419,27,36,Player A
224,Randy,194,254,448,26,26,Randy
225,Randy,234,214,448,23,25,Player A
226,Randy,224,239,463,23,20,Randy
227,Randy,214,254,468,31,21,Randy
228,Randy,231,216,447,25,26,Player A
229,Randy,212,237,449,27,26,Randy
230,Randy,237,217,454,29,25,Player A
231,Randy,225,210,435,22,29,Player A
232,Randy,221,211,432,25,31,Player A
233,Randy,256,206,462,28,22,Player A
234,Randy,269,199,468,28,20,Player A
235,Randy,227,212,439,26,29,Player A
236,Randy,215,235,450,22,24,Randy
237,Randy,254,204,458,27,23,Player A
238,Randy,217,227,444,25,27,Randy
239,Randy,219,224,443,21,26,Randy
240,Randy,242,217,459,28,23,Player A
241,Randy,227,232,459,28,23,Randy
242,Randy,235,225,460,26,22,Player A
243,Randy,217,192,409,17,36,Player A
244,Randy,226,211,437,24,29,Player A
245,Randy,233,203,436,26,30,Player A
246,Randy,192,252,444,19,25,Randy
247,Randy,185,265,450,22,24,Randy
248,Randy,244,204,448,20,24,Player A
249,Randy,223,243,466,26,20,Randy
250,Randy,224,234,458,21,21,Randy
251,Randy,216,246,462,25,21,Randy
252,Randy,214,229,443,24,27,Randy
253,Randy,192,257,449,27,26,Randy
254,Randy,212,242,454,20,22,Randy
255,Randy,190,260,450,25,25,Randy
256,Randy,229,234,463,35,24,Randy
257,Randy,220,230,450,25,25,Randy
258,Randy,259,209,468,31,21,Player A
259,Randy,245,220,465,31,22,Player A
260,Randy,221,236,457,23,22,Randy
261,Randy,215,225,440,27,29,Randy
262,Randy,208,248,456,28,24,Randy
263,Randy,212,207,419,27,36,Player A
264,Randy,204,244,448,23,25,Randy
265,Randy,273,208,481,26,15,Player A
266,Randy,212,227,439,29,30,Randy
267,Randy,234,214,448,20,24,Player A
268,Randy,236,246,482,30,16,Randy
269,Randy,206,256,462,28,22,Randy
270,Randy,212,232,444,22,26,Randy
271,Randy,206,246,452,27,25,Randy
272,Randy,212,212,424,17,31,Tie
273,Randy,286,201,487,32,15,Player A
274,Randy,242,202,444,25,27,Player A
275,Randy,234,219,453,31,26,Player A
276,Randy,204,229,433,29,32,Randy
277,Randy,220,230,450,31,27,Randy
278,Randy,252,217,469,32,21,Player A
279,Randy,244,224,468,28,20,Player A
280,Randy,203,258,461,21,20,Randy
281,Randy,244,224,468,25,19,Player A
282,Randy,251,211,462,34,24,Player A
283,Randy,256,166,422,21,33,Player A
284,Randy,203,263,466,29,21,Randy
285,Randy,219,244,463,23,20,Randy
286,Randy,254,209,463,26,21,Player A
287,Randy,258,193,451,32,27,Player A
288,Randy,231,246,477,28,17,Randy
289,Randy,232,207,439,17,26,Player A
290,Randy,210,235,445,23,26,Randy
291,Randy,248,223,471,34,21,Player A
292,Randy,220,245,465,31,22,Randy
293,Randy,239,224,463,29,22,Player A
294,Randy,229,234,463,29,22,Randy
295,Randy,209,239,448,26,26,Randy
296,Randy,252,232,484,38,18,Player A
297,Randy,205,240,445,23,26,Randy
298,Randy,239,224,463,29,22,Player A
299,Randy,206,221,427,20,31,Randy
300,Randy,179,234,413,15,34,Randy
301,Randy,212,232,444,22,26,Randy
302,Randy,270,210,480,28,16,Player A
303,Randy,231,211,442,26,28,Player A
304,Randy,221,226,447,28,27,Randy
305,Randy,200,240,440,24,28,Randy
306,Randy,232,212,444,34,30,Player A
307,Randy,218,258,476,24,16,Randy
308,Randy,215,225,440,30,30,Randy
309,Randy,220,265,485,27,14,Randy
310,Randy,240,195,435,22,29,Player A
311,Randy,236,206,442,26,28,Player A
312,Randy,234,219,453,25,24,Player A
313,Randy,210,240,450,31,27,Randy
314,Randy,236,206,442,26,28,Player A
315,Randy,220,240,460,29,23,Randy
316,Randy,227,232,459,31,24,Randy
317,Randy,231,201,432,25,31,Player A
318,Randy,206,226,432,25,31,Randy
319,Randy,227,212,439,20,27,Player A
