Game,Opponent,PlayerA_Score,PlayerB_Score,Cumulative_Score,CCs,DDs,Winner
0,QLearningPlayer,226,241,467,33,22,QLearningPlayer
1,QLearningPlayer,261,201,462,22,20,Player A
2,QLearningPlayer,247,232,479,36,19,Player A
3,QLearningPlayer,242,237,479,27,16,Player A
4,QLearningPlayer,247,222,469,35,22,Player A
5,QLearningPlayer,252,217,469,23,18,Player A
6,QLearningPlayer,226,231,457,26,23,QLearningPlayer
7,QLearningPlayer,215,260,475,29,18,QLearningPlayer
8,QLearningPlayer,245,170,415,23,36,Player A
9,QLearningPlayer,193,253,446,24,26,QLearningPlayer
10,QLearningPlayer,236,216,452,24,24,Player A
11,QLearningPlayer,230,190,420,22,34,Player A
12,QLearningPlayer,241,221,462,31,23,Player A
13,QLearningPlayer,205,225,430,17,29,QLearningPlayer
14,QLearningPlayer,201,246,447,28,27,QLearningPlayer
15,QLearningPlayer,205,215,420,22,34,QLearningPlayer
16,QLearningPlayer,252,207,459,22,21,Player A
17,QLearningPlayer,275,190,465,22,19,Player A
18,QLearningPlayer,252,197,449,24,25,Player A
19,QLearningPlayer,193,283,476,27,17,QLearningPlayer
20,QLearningPlayer,214,259,473,30,19,QLearningPlayer
21,QLearningPlayer,192,247,439,20,27,QLearningPlayer
22,QLearningPlayer,202,277,479,30,17,QLearningPlayer
23,QLearningPlayer,205,245,450,25,25,QLearningPlayer
24,QLearningPlayer,208,248,456,28,24,QLearningPlayer
25,QLearningPlayer,194,274,468,22,18,QLearningPlayer
26,QLearningPlayer,253,203,456,25,23,Player A
27,QLearningPlayer,231,226,457,23,22,Player A
28,QLearningPlayer,171,276,447,19,24,QLearningPlayer
29,QLearningPlayer,208,228,436,23,29,QLearningPlayer
30,QLearningPlayer,237,227,464,33,23,Player A
31,QLearningPlayer,203,223,426,22,32,QLearningPlayer
32,QLearningPlayer,219,254,473,33,20,QLearningPlayer
33,QLearningPlayer,230,250,480,28,16,QLearningPlayer
34,QLearningPlayer,214,239,453,31,26,QLearningPlayer
35,QLearningPlayer,243,203,446,24,26,Player A
36,QLearningPlayer,236,231,467,21,18,Player A
37,QLearningPlayer,245,220,465,25,20,Player A
38,QLearningPlayer,217,232,449,27,26,QLearningPlayer
39,QLearningPlayer,189,229,418,17,33,QLearningPlayer
40,QLearningPlayer,203,243,446,21,25,QLearningPlayer
41,QLearningPlayer,202,257,459,28,23,QLearningPlayer
42,QLearningPlayer,213,238,451,23,24,QLearningPlayer
43,QLearningPlayer,239,214,453,25,24,Player A
44,QLearningPlayer,211,256,467,30,21,QLearningPlayer
45,QLearningPlayer,234,204,438,25,29,Player A
46,QLearningPlayer,218,243,461,27,22,QLearningPlayer
47,QLearningPlayer,227,242,469,29,20,QLearningPlayer
48,QLearningPlayer,207,227,434,18,28,QLearningPlayer
49,QLearningPlayer,205,245,450,25,25,QLearningPlayer
50,QLearningPlayer,209,219,428,21,31,QLearningPlayer
51,QLearningPlayer,228,238,466,26,20,QLearningPlayer
52,QLearningPlayer,186,241,427,26,33,QLearningPlayer
53,QLearningPlayer,208,233,441,25,28,QLearningPlayer
54,QLearningPlayer,241,216,457,29,24,Player A
55,QLearningPlayer,227,207,434,21,29,Player A
56,QLearningPlayer,234,229,463,32,23,Player A
57,QLearningPlayer,220,240,460,23,21,QLearningPlayer
58,QLearningPlayer,211,246,457,26,23,QLearningPlayer
59,QLearningPlayer,226,231,457,29,24,QLearningPlayer
60,QLearningPlayer,204,239,443,24,27,QLearningPlayer
61,QLearningPlayer,214,224,438,28,30,QLearningPlayer
62,QLearningPlayer,212,242,454,23,23,QLearningPlayer
63,QLearningPlayer,209,254,463,32,23,QLearningPlayer
64,QLearningPlayer,214,244,458,27,23,QLearningPlayer
65,QLearningPlayer,200,240,440,21,27,QLearningPlayer
66,QLearningPlayer,217,242,459,28,23,QLearningPlayer
67,QLearningPlayer,212,237,449,21,24,QLearningPlayer
68,QLearningPlayer,236,216,452,18,22,Player A
69,QLearningPlayer,274,194,468,28,20,Player A
70,QLearningPlayer,229,209,438,25,29,Player A
71,QLearningPlayer,220,225,445,20,25,QLearningPlayer
72,QLearningPlayer,238,203,441,22,27,Player A
73,QLearningPlayer,266,181,447,25,26,Player A
74,QLearningPlayer,265,185,450,25,25,Player A
75,QLearningPlayer,234,174,408,22,38,Player A
76,QLearningPlayer,217,227,444,25,27,QLearningPlayer
77,QLearningPlayer,209,234,443,24,27,QLearningPlayer
78,QLearningPlayer,219,224,443,15,24,QLearningPlayer
79,QLearningPlayer,230,220,450,31,27,Player A
80,QLearningPlayer,195,270,465,28,21,QLearningPlayer
81,QLearningPlayer,217,237,454,23,23,QLearningPlayer
82,QLearningPlayer,236,201,437,24,29,Player A
83,QLearningPlayer,216,231,447,19,24,QLearningPlayer
84,QLearningPlayer,252,227,479,30,17,Player A
85,QLearningPlayer,206,221,427,26,33,QLearningPlayer
86,QLearningPlayer,199,269,468,28,20,QLearningPlayer
87,QLearningPlayer,243,218,461,24,21,Player A
88,QLearningPlayer,199,234,433,20,29,QLearningPlayer
89,QLearningPlayer,215,240,455,30,25,QLearningPlayer
90,QLearningPlayer,234,229,463,23,20,Player A
91,QLearningPlayer,193,238,431,24,31,QLearningPlayer
92,QLearningPlayer,248,218,466,23,19,Player A
93,QLearningPlayer,214,254,468,34,22,QLearningPlayer
94,QLearningPlayer,236,226,462,28,22,Player A
95,QLearningPlayer,237,227,464,27,21,Player A
96,QLearningPlayer,228,208,436,23,29,Player A
97,QLearningPlayer,228,203,431,21,30,Player A
98,QLearningPlayer,235,225,460,32,24,Player A
99,QLearningPlayer,222,227,449,21,24,QLearningPlayer
100,QLearningPlayer,254,214,468,25,19,Player A
101,QLearningPlayer,241,206,447,25,26,Player A
102,QLearningPlayer,196,241,437,24,29,QLearningPlayer
103,QLearningPlayer,207,222,429,22,31,QLearningPlayer
104,QLearningPlayer,221,236,457,26,23,QLearningPlayer
105,QLearningPlayer,214,234,448,26,26,QLearningPlayer
106,QLearningPlayer,216,241,457,32,25,QLearningPlayer
107,QLearningPlayer,229,229,458,27,23,Tie
108,QLearningPlayer,214,244,458,27,23,QLearningPlayer
109,QLearningPlayer,204,239,443,24,27,QLearningPlayer
110,QLearningPlayer,223,238,461,24,21,QLearningPlayer
111,QLearningPlayer,235,200,435,28,31,Player A
112,QLearningPlayer,257,197,454,23,23,Player A
113,QLearningPlayer,214,229,443,27,28,QLearningPlayer
114,QLearningPlayer,235,210,445,20,25,Player A
115,QLearningPlayer,249,194,443,21,26,Player A
116,QLearningPlayer,231,206,437,18,27,Player A
117,QLearningPlayer,256,211,467,30,21,Player A
118,QLearningPlayer,217,217,434,18,28,Tie
119,QLearningPlayer,207,252,459,28,23,QLearningPlayer
120,QLearningPlayer,231,201,432,19,29,Player A
121,QLearningPlayer,249,219,468,25,19,Player A
122,QLearningPlayer,191,256,447,25,26,QLearningPlayer
123,QLearningPlayer,213,223,436,14,26,QLearningPlayer
124,QLearningPlayer,242,202,444,25,27,Player A
125,QLearningPlayer,254,204,458,24,22,Player A
126,QLearningPlayer,219,219,438,25,29,Tie
127,QLearningPlayer,191,241,432,28,32,QLearningPlayer
128,QLearningPlayer,210,275,485,33,16,QLearningPlayer
129,QLearningPlayer,201,246,447,31,28,QLearningPlayer
130,QLearningPlayer,204,234,438,19,27,QLearningPlayer
131,QLearningPlayer,213,223,436,17,27,QLearningPlayer
132,QLearningPlayer,204,229,433,20,29,QLearningPlayer
133,QLearningPlayer,179,254,433,17,28,QLearningPlayer
134,QLearningPlayer,210,255,465,22,19,QLearningPlayer
135,QLearningPlayer,261,176,437,21,28,Player A
136,QLearningPlayer,230,215,445,26,27,Player A
137,QLearningPlayer,190,245,435,22,29,QLearningPlayer
138,QLearningPlayer,228,238,466,23,19,QLearningPlayer
139,QLearningPlayer,207,237,444,31,29,QLearningPlayer
140,QLearningPlayer,250,205,455,21,22,Player A
141,QLearningPlayer,239,224,463,29,22,Player A
142,QLearningPlayer,211,221,432,19,29,QLearningPlayer
143,QLearningPlayer,204,249,453,31,26,QLearningPlayer
144,QLearningPlayer,225,215,440,21,27,Player A
145,QLearningPlayer,248,208,456,25,23,Player A
146,QLearningPlayer,256,191,447,19,24,Player A
147,QLearningPlayer,253,198,451,32,27,Player A
148,QLearningPlayer,213,248,461,27,22,QLearningPlayer
149,QLearningPlayer,222,207,429,19,30,Player A
150,QLearningPlayer,241,201,442,32,30,Player A
151,QLearningPlayer,205,235,440,24,28,QLearningPlayer
152,QLearningPlayer,208,228,436,17,27,QLearningPlayer
153,QLearningPlayer,212,232,444,28,28,QLearningPlayer
154,QLearningPlayer,229,224,453,22,23,Player A
155,QLearningPlayer,206,266,472,26,18,QLearningPlayer
156,QLearningPlayer,192,232,424,17,31,QLearningPlayer
157,QLearningPlayer,243,208,451,23,24,Player A
158,QLearningPlayer,221,231,452,24,24,QLearningPlayer
159,QLearningPlayer,228,218,446,30,28,Player A
160,QLearningPlayer,260,200,460,26,22,Player A
161,QLearningPlayer,252,212,464,21,19,Player A
162,QLearningPlayer,277,197,474,31,19,Player A
163,QLearningPlayer,264,194,458,18,20,Player A
164,QLearningPlayer,216,211,427,26,33,Player A
165,QLearningPlayer,203,223,426,19,31,QLearningPlayer
166,QLearningPlayer,268,193,461,30,23,Player A
167,QLearningPlayer,249,234,483,34,17,Player A
168,QLearningPlayer,204,244,448,26,26,QLearningPlayer
169,QLearningPlayer,228,233,461,30,23,QLearningPlayer
170,QLearningPlayer,238,228,466,32,22,Player A
171,QLearningPlayer,207,247,454,23,23,QLearningPlayer
172,QLearningPlayer,267,192,459,22,21,Player A
173,QLearningPlayer,186,236,422,24,34,QLearningPlayer
174,QLearningPlayer,259,224,483,28,15,Player A
175,QLearningPlayer,253,193,446,27,27,Player A
176,QLearningPlayer,241,201,442,23,27,Player A
177,QLearningPlayer,242,207,449,18,23,Player A
178,QLearningPlayer,229,219,448,20,24,Player A
179,QLearningPlayer,247,192,439,20,27,Player A
180,QLearningPlayer,213,223,436,17,27,QLearningPlayer
181,QLearningPlayer,252,187,439,29,30,Player A
182,QLearningPlayer,256,206,462,19,19,Player A
183,QLearningPlayer,199,229,428,24,32,QLearningPlayer
184,QLearningPlayer,233,233,466,20,18,Tie
185,QLearningPlayer,218,258,476,36,20,QLearningPlayer
186,QLearningPlayer,214,239,453,19,22,QLearningPlayer
187,QLearningPlayer,232,207,439,26,29,Player A
188,QLearningPlayer,195,235,430,23,31,QLearningPlayer
189,QLearningPlayer,246,206,452,27,25,Player A
190,QLearningPlayer,243,208,451,26,25,Player A
191,QLearningPlayer,243,228,471,34,21,Player A
192,QLearningPlayer,242,207,449,21,24,Player A
193,QLearningPlayer,227,212,439,23,28,Player A
194,QLearningPlayer,226,236,462,31,23,QLearningPlayer
195,QLearningPlayer,244,219,463,23,20,Player A
196,QLearningPlayer,232,227,459,28,23,Player A
197,QLearningPlayer,210,250,460,26,22,QLearningPlayer
198,QLearningPlayer,187,207,394,17,41,QLearningPlayer
199,QLearningPlayer,213,248,461,33,24,QLearningPlayer
200,QLearningPlayer,202,257,459,28,23,QLearningPlayer
201,QLearningPlayer,186,251,437,18,27,QLearningPlayer
202,QLearningPlayer,213,218,431,21,30,QLearningPlayer
203,QLearningPlayer,276,191,467,24,19,Player A
204,QLearningPlayer,194,224,418,23,35,QLearningPlayer
205,QLearningPlayer,253,193,446,21,25,Player A
206,QLearningPlayer,258,193,451,32,27,Player A
207,QLearningPlayer,234,214,448,14,22,Player A
208,QLearningPlayer,223,233,456,22,22,QLearningPlayer
209,QLearningPlayer,211,211,422,18,32,Tie
210,QLearningPlayer,229,234,463,23,20,QLearningPlayer
211,QLearningPlayer,225,220,445,17,24,Player A
212,QLearningPlayer,221,226,447,16,23,QLearningPlayer
213,QLearningPlayer,231,206,437,24,29,Player A
214,QLearningPlayer,223,238,461,30,23,QLearningPlayer
215,QLearningPlayer,228,203,431,27,32,Player A
216,QLearningPlayer,208,248,456,31,25,QLearningPlayer
217,QLearningPlayer,220,240,460,26,22,QLearningPlayer
218,QLearningPlayer,208,213,421,26,35,QLearningPlayer
219,QLearningPlayer,230,220,450,25,25,Player A
220,QLearningPlayer,219,214,433,23,30,Player A
221,QLearningPlayer,210,235,445,23,26,QLearningPlayer
222,QLearningPlayer,230,210,440,24,28,Player A
223,QLearningPlayer,251,191,442,29,29,Player A
224,QLearningPlayer,250,230,480,28,16,Player A
225,QLearningPlayer,233,203,436,23,29,Player A
226,QLearningPlayer,213,243,456,22,22,QLearningPlayer
227,QLearningPlayer,251,206,457,23,22,Player A
228,QLearningPlayer,190,230,420,19,33,QLearningPlayer
229,QLearningPlayer,212,227,439,20,27,QLearningPlayer
230,QLearningPlayer,221,221,442,23,27,Tie
231,QLearningPlayer,232,227,459,34,25,Player A
232,QLearningPlayer,269,194,463,23,20,Player A
233,QLearningPlayer,224,224,448,20,24,Tie
234,QLearningPlayer,249,204,453,22,23,Player A
235,QLearningPlayer,232,217,449,27,26,Player A
236,QLearningPlayer,221,221,442,26,28,Tie
237,QLearningPlayer,225,230,455,27,24,QLearningPlayer
238,QLearningPlayer,204,234,438,22,28,QLearningPlayer
239,QLearningPlayer,221,226,447,19,24,QLearningPlayer
240,QLearningPlayer,227,232,459,25,22,QLearningPlayer
241,QLearningPlayer,228,213,441,22,27,Player A
242,QLearningPlayer,217,192,409,11,34,Player A
243,QLearningPlayer,233,208,441,25,28,Player A
244,QLearningPlayer,207,252,459,28,23,QLearningPlayer
245,QLearningPlayer,220,245,465,25,20,QLearningPlayer
246,QLearningPlayer,232,222,454,29,25,Player A
247,QLearningPlayer,242,222,464,27,21,Player A
248,QLearningPlayer,210,230,440,24,28,QLearningPlayer
249,QLearningPlayer,242,227,469,23,18,Player A
250,QLearningPlayer,196,231,427,23,32,QLearningPlayer
251,QLearningPlayer,209,214,423,22,33,QLearningPlayer
252,QLearningPlayer,227,217,444,19,25,Player A
253,QLearningPlayer,225,210,435,28,31,Player A
254,QLearningPlayer,232,207,439,23,28,Player A
255,QLearningPlayer,184,249,433,23,30,QLearningPlayer
256,QLearningPlayer,223,218,441,25,28,Player A
257,QLearningPlayer,218,218,436,23,29,Tie
258,QLearningPlayer,215,235,450,22,24,QLearningPlayer
259,QLearningPlayer,219,224,443,21,26,QLearningPlayer
260,QLearningPlayer,248,213,461,27,22,Player A
261,QLearningPlayer,234,219,453,31,26,Player A
262,QLearningPlayer,233,198,431,21,30,Player A
263,QLearningPlayer,250,200,450,25,25,Player A
264,QLearningPlayer,225,250,475,26,17,QLearningPlayer
265,QLearningPlayer,203,243,446,24,26,QLearningPlayer
266,QLearningPlayer,209,199,408,19,37,Player A
267,QLearningPlayer,232,212,444,19,25,Player A
268,QLearningPlayer,227,212,439,20,27,Player A
269,QLearningPlayer,208,248,456,19,21,QLearningPlayer
270,QLearningPlayer,216,221,437,27,30,QLearningPlayer
271,QLearningPlayer,240,200,440,18,26,Player A
272,QLearningPlayer,241,206,447,19,24,Player A
273,QLearningPlayer,228,238,466,29,21,QLearningPlayer
274,QLearningPlayer,249,219,468,34,22,Player A
275,QLearningPlayer,247,217,464,27,21,Player A
276,QLearningPlayer,190,240,430,23,31,QLearningPlayer
277,QLearningPlayer,236,216,452,21,23,Player A
278,QLearningPlayer,224,229,453,28,25,QLearningPlayer
279,QLearningPlayer,220,240,460,26,22,QLearningPlayer
280,QLearningPlayer,185,255,440,30,30,QLearningPlayer
281,QLearningPlayer,210,230,440,27,29,QLearningPlayer
282,QLearningPlayer,234,229,463,29,22,Player A
283,QLearningPlayer,247,217,464,27,21,Player A
284,QLearningPlayer,267,187,454,26,24,Player A
285,QLearningPlayer,220,215,435,19,28,Player A
286,QLearningPlayer,218,223,441,25,28,QLearningPlayer
287,QLearningPlayer,236,216,452,27,25,Player A
288,QLearningPlayer,235,225,460,26,22,Player A
289,QLearningPlayer,233,228,461,30,23,Player A
290,QLearningPlayer,238,238,476,36,20,Tie
291,QLearningPlayer,211,241,452,27,25,QLearningPlayer
292,QLearningPlayer,259,184,443,30,29,Player A
293,QLearningPlayer,248,228,476,27,17,Player A
294,QLearningPlayer,227,232,459,28,23,QLearningPlayer
295,QLearningPlayer,232,232,464,30,22,Tie
296,QLearningPlayer,208,238,446,21,25,QLearningPlayer
297,QLearningPlayer,263,213,476,33,19,Player A
298,QLearningPlayer,236,246,482,33,17,QLearningPlayer
299,QLearningPlayer,266,181,447,25,26,Player A
300,QLearningPlayer,228,228,456,22,22,Tie
301,QLearningPlayer,231,231,462,28,22,Tie
302,QLearningPlayer,213,228,441,19,26,QLearningPlayer
303,QLearningPlayer,237,217,454,23,23,Player A
304,QLearningPlayer,199,229,428,18,30,QLearningPlayer
305,QLearningPlayer,209,249,458,24,22,QLearningPlayer
306,QLearningPlayer,196,251,447,25,26,QLearningPlayer
307,QLearningPlayer,236,221,457,26,23,Player A
308,QLearningPlayer,219,214,433,20,29,Player A
309,QLearningPlayer,213,253,466,29,21,QLearningPlayer
310,QLearningPlayer,252,207,459,25,22,Player A
311,QLearningPlayer,232,227,459,28,23,Player A
312,QLearningPlayer,231,241,472,26,18,QLearningPlayer
313,QLearningPlayer,243,193,436,20,28,Player A
314,QLearningPlayer,228,208,436,23,29,Player A
315,QLearningPlayer,219,224,443,21,26,QLearningPlayer
316,QLearningPlayer,200,260,460,26,22,QLearningPlayer
317,QLearningPlayer,258,218,476,33,19,Player A
318,QLearningPlayer,227,217,444,22,26,Player A
319,QLearningPlayer,215,240,455,18,21,QLearningPlayer
320,QLearningPlayer,202,232,434,15,27,QLearningPlayer
321,QLearningPlayer,218,243,461,36,25,QLearningPlayer
322,QLearningPlayer,242,197,439,29,30,Player A
323,QLearningPlayer,223,228,451,23,24,QLearningPlayer
324,QLearningPlayer,220,205,425,18,31,Player A
325,QLearningPlayer,243,228,471,34,21,Player A
326,QLearningPlayer,227,232,459,28,23,QLearningPlayer
327,QLearningPlayer,222,252,474,31,19,QLearningPlayer
328,QLearningPlayer,216,226,442,23,27,QLearningPlayer
329,QLearningPlayer,228,208,436,29,31,Player A
330,QLearningPlayer,234,209,443,27,28,Player A
331,QLearningPlayer,206,246,452,21,23,QLearningPlayer
332,QLearningPlayer,217,252,469,29,20,QLearningPlayer
333,QLearningPlayer,241,201,442,20,26,Player A
334,QLearningPlayer,243,203,446,21,25,Player A
335,QLearningPlayer,228,228,456,28,24,Tie
336,QLearningPlayer,210,265,475,29,18,QLearningPlayer
337,QLearningPlayer,204,239,443,21,26,QLearningPlayer
338,QLearningPlayer,237,192,429,28,33,Player A
339,QLearningPlayer,205,235,440,18,26,QLearningPlayer
340,QLearningPlayer,208,238,446,21,25,QLearningPlayer
341,QLearningPlayer,211,221,432,25,31,QLearningPlayer
342,QLearningPlayer,242,202,444,25,27,Player A
343,QLearningPlayer,222,217,439,20,27,Player A
344,QLearningPlayer,220,245,465,31,22,QLearningPlayer
345,QLearningPlayer,240,205,445,26,27,Player A
346,QLearningPlayer,249,214,463,23,20,Player A
347,QLearningPlayer,199,249,448,26,26,QLearningPlayer
348,QLearningPlayer,241,241,482,27,15,Tie
349,QLearningPlayer,242,207,449,21,24,Player A
350,QLearningPlayer,230,225,455,27,24,Player A
351,QLearningPlayer,223,223,446,24,26,Tie
352,QLearningPlayer,223,248,471,28,19,QLearningPlayer
353,QLearningPlayer,219,234,453,31,26,QLearningPlayer
354,QLearningPlayer,243,193,436,20,28,Player A
355,QLearningPlayer,227,207,434,27,31,Player A
356,QLearningPlayer,203,228,431,24,31,QLearningPlayer
357,QLearningPlayer,232,237,469,29,20,QLearningPlayer
358,QLearningPlayer,217,247,464,24,20,QLearningPlayer
359,QLearningPlayer,233,243,476,33,19,QLearningPlayer
360,QLearningPlayer,229,209,438,25,29,Player A
361,QLearningPlayer,236,216,452,27,25,Player A
362,QLearningPlayer,206,226,432,28,32,QLearningPlayer
363,QLearningPlayer,218,218,436,23,29,Tie
364,QLearningPlayer,202,242,444,22,26,QLearningPlayer
365,QLearningPlayer,262,182,444,25,27,Player A
366,QLearningPlayer,220,245,465,28,21,QLearningPlayer
367,QLearningPlayer,206,236,442,26,28,QLearningPlayer
368,QLearningPlayer,221,201,422,21,33,Player A
369,QLearningPlayer,222,222,444,25,27,Tie
370,QLearningPlayer,165,245,410,15,35,QLearningPlayer
371,QLearningPlayer,234,209,443,21,26,Player A
372,QLearningPlayer,221,236,457,26,23,QLearningPlayer
373,QLearningPlayer,246,211,457,23,22,Player A
374,QLearningPlayer,209,229,438,22,28,QLearningPlayer
375,QLearningPlayer,213,228,441,22,27,QLearningPlayer
376,QLearningPlayer,229,229,458,27,23,Tie
377,QLearningPlayer,236,226,462,22,20,Player A
378,QLearningPlayer,214,204,418,17,33,Player A
379,QLearningPlayer,253,203,456,25,23,Player A
380,QLearningPlayer,209,219,428,18,30,QLearningPlayer
381,QLearningPlayer,200,260,460,26,22,QLearningPlayer
382,QLearningPlayer,210,200,410,18,36,Player A
383,QLearningPlayer,228,213,441,25,28,Player A
384,QLearningPlayer,191,246,437,21,28,QLearningPlayer
385,QLearningPlayer,217,227,444,22,26,QLearningPlayer
386,QLearningPlayer,206,226,432,25,31,QLearningPlayer
387,QLearningPlayer,240,200,440,21,27,Player A
388,QLearningPlayer,245,225,470,30,20,Player A
389,QLearningPlayer,233,223,456,28,24,Player A
390,QLearningPlayer,234,209,443,18,25,Player A
391,QLearningPlayer,229,189,418,20,34,Player A
392,QLearningPlayer,233,218,451,29,26,Player A
393,QLearningPlayer,235,225,460,26,22,Player A
394,QLearningPlayer,223,243,466,29,21,QLearningPlayer
395,QLearningPlayer,255,200,455,27,24,Player A
396,QLearningPlayer,204,254,458,27,23,QLearningPlayer
397,QLearningPlayer,218,233,451,17,22,QLearningPlayer
398,QLearningPlayer,212,212,424,20,32,Tie
399,QLearningPlayer,208,213,421,20,33,QLearningPlayer
400,QLearningPlayer,229,224,453,25,24,Player A
401,QLearningPlayer,209,219,428,18,30,QLearningPlayer
402,QLearningPlayer,192,237,429,25,32,QLearningPlayer
403,QLearningPlayer,230,235,465,19,18,QLearningPlayer
404,QLearningPlayer,246,201,447,28,27,Player A
405,QLearningPlayer,256,206,462,31,23,Player A
406,QLearningPlayer,246,201,447,25,26,Player A
407,QLearningPlayer,218,243,461,30,23,QLearningPlayer
408,QLearningPlayer,191,251,442,26,28,QLearningPlayer
409,QLearningPlayer,205,250,455,24,23,QLearningPlayer
410,QLearningPlayer,209,234,443,24,27,QLearningPlayer
411,QLearningPlayer,229,214,443,30,29,Player A
412,QLearningPlayer,250,225,475,26,17,Player A
413,QLearningPlayer,241,216,457,23,22,Player A
414,QLearningPlayer,217,262,479,30,17,QLearningPlayer
415,QLearningPlayer,229,209,438,19,27,Player A
416,QLearningPlayer,232,207,439,23,28,Player A
417,QLearningPlayer,240,230,470,36,22,Player A
418,QLearningPlayer,264,199,463,29,22,Player A
419,QLearningPlayer,239,229,468,31,21,Player A
420,QLearningPlayer,201,241,442,20,26,QLearningPlayer
421,QLearningPlayer,222,212,434,24,30,Player A
422,QLearningPlayer,242,227,469,29,20,Player A
423,QLearningPlayer,193,248,441,25,28,QLearningPlayer
424,QLearningPlayer,223,193,416,30,38,Player A
425,QLearningPlayer,242,202,444,22,26,Player A
426,QLearningPlayer,206,231,437,27,30,QLearningPlayer
427,QLearningPlayer,221,206,427,17,30,Player A
428,QLearningPlayer,219,224,443,24,27,QLearningPlayer
429,QLearningPlayer,218,243,461,27,22,QLearningPlayer
430,QLearningPlayer,229,224,453,31,26,Player A
431,QLearningPlayer,229,239,468,31,21,QLearningPlayer
432,QLearningPlayer,233,208,441,31,30,Player A
433,QLearningPlayer,240,220,460,26,22,Player A
434,QLearningPlayer,222,207,429,22,31,Player A
435,QLearningPlayer,249,209,458,30,24,Player A
436,QLearningPlayer,245,185,430,20,30,Player A
437,QLearningPlayer,250,200,450,19,23,Player A
438,QLearningPlayer,210,220,430,17,29,QLearningPlayer
439,QLearningPlayer,231,216,447,22,25,Player A
440,QLearningPlayer,237,212,449,24,25,Player A
441,QLearningPlayer,245,225,470,30,20,Player A
442,QLearningPlayer,195,240,435,19,28,QLearningPlayer
443,QLearningPlayer,239,214,453,25,24,Player A
444,QLearningPlayer,203,248,451,26,25,QLearningPlayer
445,QLearningPlayer,227,237,464,30,22,QLearningPlayer
446,QLearningPlayer,192,242,434,24,30,QLearningPlayer
447,QLearningPlayer,218,238,456,19,21,QLearningPlayer
448,QLearningPlayer,223,208,431,21,30,Player A
449,QLearningPlayer,244,214,458,27,23,Player A
450,QLearningPlayer,207,232,439,17,26,QLearningPlayer
451,QLearningPlayer,236,201,437,24,29,Player A
452,QLearningPlayer,220,235,455,27,24,QLearningPlayer
453,QLearningPlayer,242,202,444,25,27,Player A
454,QLearningPlayer,214,254,468,31,21,QLearningPlayer
455,QLearningPlayer,230,225,455,27,24,Player A
456,QLearningPlayer,215,240,455,24,23,QLearningPlayer
457,QLearningPlayer,235,205,440,24,28,Player A
458,QLearningPlayer,256,221,477,31,18,Player A
459,QLearningPlayer,221,236,457,32,25,QLearningPlayer
460,QLearningPlayer,223,223,446,33,29,Tie
461,QLearningPlayer,219,234,453,28,25,QLearningPlayer
462,QLearningPlayer,248,223,471,25,18,Player A
463,QLearningPlayer,215,250,465,25,20,QLearningPlayer
464,QLearningPlayer,184,244,428,24,32,QLearningPlayer
465,QLearningPlayer,215,255,470,27,19,QLearningPlayer
466,QLearningPlayer,252,217,469,23,18,Player A
467,QLearningPlayer,190,260,450,19,23,QLearningPlayer
468,QLearningPlayer,240,210,450,25,25,Player A
469,QLearningPlayer,201,261,462,25,21,QLearningPlayer
470,QLearningPlayer,199,249,448,23,25,QLearningPlayer
471,QLearningPlayer,265,185,450,31,27,Player A
472,QLearningPlayer,209,254,463,23,20,QLearningPlayer
473,QLearningPlayer,225,205,430,23,31,Player A
474,QLearningPlayer,231,221,452,24,24,Player A
475,QLearningPlayer,220,230,450,28,26,QLearningPlayer
476,QLearningPlayer,236,176,412,11,33,Player A
477,QLearningPlayer,237,222,459,28,23,Player A
478,QLearningPlayer,221,246,467,27,20,QLearningPlayer
479,QLearningPlayer,263,193,456,25,23,Player A
480,QLearningPlayer,238,228,466,29,21,Player A
481,QLearningPlayer,227,217,444,28,28,Player A
482,QLearningPlayer,199,249,448,23,25,QLearningPlayer
483,QLearningPlayer,240,215,455,27,24,Player A
484,QLearningPlayer,216,231,447,28,27,QLearningPlayer
485,QLearningPlayer,208,233,441,22,27,QLearningPlayer
486,QLearningPlayer,193,248,441,25,28,QLearningPlayer
487,QLearningPlayer,193,223,416,18,34,QLearningPlayer
488,QLearningPlayer,205,235,440,24,28,QLearningPlayer
489,QLearningPlayer,234,239,473,36,21,QLearningPlayer
490,QLearningPlayer,217,212,429,19,30,Player A
491,QLearningPlayer,220,235,455,27,24,QLearningPlayer
492,QLearningPlayer,188,233,421,20,33,QLearningPlayer
493,QLearningPlayer,222,252,474,31,19,QLearningPlayer
494,QLearningPlayer,206,211,417,28,37,QLearningPlayer
495,QLearningPlayer,221,251,472,26,18,QLearningPlayer
496,QLearningPlayer,227,227,454,23,23,Tie
497,QLearningPlayer,225,240,465,28,21,QLearningPlayer
498,QLearningPlayer,252,227,479,30,17,Player A
499,QLearningPlayer,239,214,453,25,24,Player A
500,QLearningPlayer,216,216,432,22,30,Tie
501,QLearningPlayer,192,257,449,24,25,QLearningPlayer
502,QLearningPlayer,221,216,437,24,29,Player A
503,QLearningPlayer,251,196,447,25,26,Player A
504,QLearningPlayer,246,201,447,22,25,Player A
505,QLearningPlayer,279,189,468,28,20,Player A
506,QLearningPlayer,186,271,457,23,22,QLearningPlayer
507,QLearningPlayer,225,220,445,23,26,Player A
508,QLearningPlayer,177,277,454,26,24,QLearningPlayer
509,QLearningPlayer,227,227,454,26,24,Tie
510,QLearningPlayer,239,194,433,20,29,Player A
511,QLearningPlayer,200,235,435,22,29,QLearningPlayer
512,QLearningPlayer,228,218,446,30,28,Player A
513,QLearningPlayer,212,212,424,23,33,Tie
514,QLearningPlayer,227,222,449,27,26,Player A
515,QLearningPlayer,216,251,467,24,19,QLearningPlayer
516,QLearningPlayer,257,202,459,28,23,Player A
517,QLearningPlayer,237,202,439,23,28,Player A
518,QLearningPlayer,244,214,458,30,24,Player A
519,QLearningPlayer,218,223,441,19,26,QLearningPlayer
520,QLearningPlayer,214,234,448,26,26,QLearningPlayer
521,QLearningPlayer,214,229,443,18,25,QLearningPlayer
522,QLearningPlayer,204,234,438,22,28,QLearningPlayer
523,QLearningPlayer,233,213,446,24,26,Player A
524,QLearningPlayer,223,233,456,34,26,QLearningPlayer
525,QLearningPlayer,231,206,437,24,29,Player A
526,QLearningPlayer,208,253,461,27,22,QLearningPlayer
527,QLearningPlayer,211,266,477,28,17,QLearningPlayer
528,QLearningPlayer,238,228,466,29,21,Player A
529,QLearningPlayer,186,271,457,23,22,QLearningPlayer
530,QLearningPlayer,202,222,424,23,33,QLearningPlayer
531,QLearningPlayer,245,195,440,24,28,Player A
532,QLearningPlayer,212,222,434,24,30,QLearningPlayer
533,QLearningPlayer,217,227,444,22,26,QLearningPlayer
534,QLearningPlayer,228,213,441,19,26,Player A
535,QLearningPlayer,259,194,453,22,23,Player A
536,QLearningPlayer,213,238,451,23,24,QLearningPlayer
537,QLearningPlayer,225,210,435,19,28,Player A
538,QLearningPlayer,188,243,431,24,31,QLearningPlayer
539,QLearningPlayer,214,249,463,26,21,QLearningPlayer
540,QLearningPlayer,202,232,434,21,29,QLearningPlayer
541,QLearningPlayer,245,210,455,21,22,Player A
542,QLearningPlayer,230,205,435,28,31,Player A
543,QLearningPlayer,236,231,467,33,22,Player A
544,QLearningPlayer,249,194,443,21,26,Player A
545,QLearningPlayer,206,221,427,17,30,QLearningPlayer
546,QLearningPlayer,226,216,442,20,26,Player A
547,QLearningPlayer,205,230,435,28,31,QLearningPlayer
548,QLearningPlayer,206,226,432,22,30,QLearningPlayer
549,QLearningPlayer,257,222,479,33,18,Player A
550,QLearningPlayer,224,229,453,25,24,QLearningPlayer
551,QLearningPlayer,243,228,471,25,18,Player A
552,QLearningPlayer,221,216,437,18,27,Player A
553,QLearningPlayer,217,232,449,21,24,QLearningPlayer
554,QLearningPlayer,204,229,433,14,27,QLearningPlayer
555,QLearningPlayer,213,223,436,20,28,QLearningPlayer
556,QLearningPlayer,215,235,450,28,26,QLearningPlayer
557,QLearningPlayer,220,240,460,23,21,QLearningPlayer
558,QLearningPlayer,191,251,442,23,27,QLearningPlayer
559,QLearningPlayer,248,213,461,24,21,Player A
560,QLearningPlayer,215,240,455,21,22,QLearningPlayer
561,QLearningPlayer,229,239,468,34,22,QLearningPlayer
562,QLearningPlayer,200,235,435,22,29,QLearningPlayer
563,QLearningPlayer,223,218,441,22,27,Player A
564,QLearningPlayer,230,220,450,28,26,Player A
565,QLearningPlayer,188,253,441,22,27,QLearningPlayer
566,QLearningPlayer,230,205,435,25,30,Player A
567,QLearningPlayer,231,211,442,20,26,Player A
568,QLearningPlayer,237,207,444,28,28,Player A
569,QLearningPlayer,220,235,455,24,23,QLearningPlayer
570,QLearningPlayer,201,241,442,20,26,QLearningPlayer
571,QLearningPlayer,228,203,431,24,31,Player A
572,QLearningPlayer,214,239,453,28,25,QLearningPlayer
573,QLearningPlayer,178,268,446,21,25,QLearningPlayer
574,QLearningPlayer,230,240,470,33,21,QLearningPlayer
575,QLearningPlayer,230,230,460,26,22,Tie
576,QLearningPlayer,220,235,455,27,24,QLearningPlayer
577,QLearningPlayer,219,239,458,21,21,QLearningPlayer
578,QLearningPlayer,245,235,480,37,19,Player A
579,QLearningPlayer,248,203,451,26,25,Player A
580,QLearningPlayer,240,215,455,30,25,Player A
581,QLearningPlayer,239,209,448,29,27,Player A
582,QLearningPlayer,282,217,499,32,11,Player A
583,QLearningPlayer,228,218,446,27,27,Player A
584,QLearningPlayer,221,246,467,33,22,QLearningPlayer
585,QLearningPlayer,241,216,457,20,21,Player A
586,QLearningPlayer,232,217,449,27,26,Player A
587,QLearningPlayer,215,215,430,20,30,Tie
588,QLearningPlayer,234,199,433,14,27,Player A
589,QLearningPlayer,243,223,466,26,20,Player A
590,QLearningPlayer,255,215,470,24,18,Player A
591,QLearningPlayer,194,259,453,22,23,QLearningPlayer
592,QLearningPlayer,224,229,453,25,24,QLearningPlayer
593,QLearningPlayer,208,243,451,23,24,QLearningPlayer
594,QLearningPlayer,219,254,473,24,17,QLearningPlayer
595,QLearningPlayer,211,241,452,30,26,QLearningPlayer
596,QLearningPlayer,225,215,440,21,27,Player A
597,QLearningPlayer,219,204,423,19,32,Player A
598,QLearningPlayer,215,220,435,22,29,QLearningPlayer
599,QLearningPlayer,212,227,439,23,28,QLearningPlayer
600,QLearningPlayer,250,195,445,14,23,Player A
601,QLearningPlayer,209,234,443,30,29,QLearningPlayer
602,QLearningPlayer,248,213,461,27,22,Player A
603,QLearningPlayer,220,215,435,31,32,Player A
604,QLearningPlayer,226,236,462,25,21,QLearningPlayer
605,QLearningPlayer,222,242,464,27,21,QLearningPlayer
606,QLearningPlayer,215,240,455,21,22,QLearningPlayer
607,QLearningPlayer,252,217,469,35,22,Player A
608,QLearningPlayer,248,223,471,34,21,Player A
609,QLearningPlayer,212,232,444,28,28,QLearningPlayer
610,QLearningPlayer,239,219,458,24,22,Player A
611,QLearningPlayer,243,203,446,24,26,Player A
612,QLearningPlayer,220,235,455,24,23,QLearningPlayer
613,QLearningPlayer,249,209,458,24,22,Player A
614,QLearningPlayer,216,236,452,27,25,QLearningPlayer
615,QLearningPlayer,186,251,437,18,27,QLearningPlayer
616,QLearningPlayer,231,221,452,24,24,Player A
617,QLearningPlayer,205,245,450,25,25,QLearningPlayer
618,QLearningPlayer,212,252,464,27,21,QLearningPlayer
619,QLearningPlayer,253,223,476,24,16,Player A
620,QLearningPlayer,196,236,432,22,30,QLearningPlayer
621,QLearningPlayer,228,238,466,26,20,QLearningPlayer
622,QLearningPlayer,220,220,440,24,28,Tie
623,QLearningPlayer,228,218,446,30,28,Player A
624,QLearningPlayer,201,266,467,27,20,QLearningPlayer
625,QLearningPlayer,215,225,440,24,28,QLearningPlayer
626,QLearningPlayer,220,235,455,30,25,QLearningPlayer
627,QLearningPlayer,216,231,447,22,25,QLearningPlayer
628,QLearningPlayer,234,224,458,24,22,Player A
629,QLearningPlayer,239,229,468,28,20,Player A
630,QLearningPlayer,231,221,452,33,27,Player A
631,QLearningPlayer,250,225,475,23,16,Player A
632,QLearningPlayer,261,181,442,20,26,Player A
633,QLearningPlayer,221,211,432,19,29,Player A
634,QLearningPlayer,203,223,426,22,32,QLearningPlayer
635,QLearningPlayer,204,259,463,23,20,QLearningPlayer
636,QLearningPlayer,207,237,444,31,29,QLearningPlayer
637,QLearningPlayer,242,217,459,28,23,Player A
638,QLearningPlayer,225,240,465,28,21,QLearningPlayer
639,QLearningPlayer,224,244,468,28,20,QLearningPlayer
640,QLearningPlayer,238,223,461,27,22,Player A
641,QLearningPlayer,239,214,453,25,24,Player A
642,QLearningPlayer,247,202,449,21,24,Player A
643,QLearningPlayer,220,225,445,29,28,QLearningPlayer
644,QLearningPlayer,253,233,486,31,15,Player A
645,QLearningPlayer,216,226,442,20,26,QLearningPlayer
646,QLearningPlayer,206,231,437,21,28,QLearningPlayer
647,QLearningPlayer,237,222,459,25,22,Player A
648,QLearningPlayer,226,206,432,19,29,Player A
649,QLearningPlayer,253,208,461,27,22,Player A
650,QLearningPlayer,218,243,461,27,22,QLearningPlayer
651,QLearningPlayer,226,241,467,33,22,QLearningPlayer
652,QLearningPlayer,200,230,430,17,29,QLearningPlayer
653,QLearningPlayer,185,240,425,21,32,QLearningPlayer
654,QLearningPlayer,199,219,418,23,35,QLearningPlayer
655,QLearningPlayer,221,241,462,22,20,QLearningPlayer
656,QLearningPlayer,232,217,449,27,26,Player A
657,QLearningPlayer,222,242,464,33,23,QLearningPlayer
658,QLearningPlayer,221,226,447,25,26,QLearningPlayer
659,QLearningPlayer,267,177,444,25,27,Player A
660,QLearningPlayer,221,226,447,25,26,QLearningPlayer
661,QLearningPlayer,217,237,454,23,23,QLearningPlayer
662,QLearningPlayer,227,207,434,18,28,Player A
663,QLearningPlayer,204,239,443,27,28,QLearningPlayer
664,QLearningPlayer,221,231,452,27,25,QLearningPlayer
665,QLearningPlayer,232,207,439,23,28,Player A
666,QLearningPlayer,212,252,464,24,20,QLearningPlayer
667,QLearningPlayer,238,218,456,28,24,Player A
668,QLearningPlayer,229,239,468,31,21,QLearningPlayer
669,QLearningPlayer,235,205,440,24,28,Player A
670,QLearningPlayer,215,235,450,22,24,QLearningPlayer
671,QLearningPlayer,186,241,427,17,30,QLearningPlayer
672,QLearningPlayer,214,239,453,28,25,QLearningPlayer
673,QLearningPlayer,204,224,428,21,31,QLearningPlayer
674,QLearningPlayer,227,227,454,26,24,Tie
675,QLearningPlayer,222,202,424,23,33,Player A
676,QLearningPlayer,242,217,459,25,22,Player A
677,QLearningPlayer,228,243,471,25,18,QLearningPlayer
678,QLearningPlayer,250,220,470,27,19,Player A
679,QLearningPlayer,225,220,445,32,29,Player A
680,QLearningPlayer,227,227,454,26,24,Tie
681,QLearningPlayer,209,214,423,22,33,QLearningPlayer
682,QLearningPlayer,207,252,459,25,22,QLearningPlayer
683,QLearningPlayer,238,203,441,22,27,Player A
684,QLearningPlayer,235,195,430,20,30,Player A
685,QLearningPlayer,243,213,456,28,24,Player A
686,QLearningPlayer,213,213,426,19,31,Tie
687,QLearningPlayer,207,217,424,14,30,QLearningPlayer
688,QLearningPlayer,232,212,444,25,27,Player A
689,QLearningPlayer,169,254,423,19,32,QLearningPlayer
690,QLearningPlayer,238,208,446,27,27,Player A
691,QLearningPlayer,219,244,463,32,23,QLearningPlayer
692,QLearningPlayer,250,205,455,24,23,Player A
693,QLearningPlayer,248,198,446,27,27,Player A
694,QLearningPlayer,186,246,432,25,31,QLearningPlayer
695,QLearningPlayer,225,225,450,28,26,Tie
696,QLearningPlayer,235,225,460,26,22,Player A
697,QLearningPlayer,205,235,440,21,27,QLearningPlayer
698,QLearningPlayer,219,239,458,27,23,QLearningPlayer
699,QLearningPlayer,229,219,448,23,25,Player A
700,QLearningPlayer,231,221,452,24,24,Player A
701,QLearningPlayer,229,199,428,21,31,Player A
702,QLearningPlayer,220,225,445,29,28,QLearningPlayer
703,QLearningPlayer,224,234,458,21,21,QLearningPlayer
704,QLearningPlayer,217,237,454,20,22,QLearningPlayer
705,QLearningPlayer,242,212,454,26,24,Player A
706,QLearningPlayer,197,222,419,21,34,QLearningPlayer
707,QLearningPlayer,203,218,421,23,34,QLearningPlayer
708,QLearningPlayer,220,245,465,25,20,QLearningPlayer
709,QLearningPlayer,195,250,445,29,28,QLearningPlayer
710,QLearningPlayer,207,247,454,26,24,QLearningPlayer
711,QLearningPlayer,236,196,432,16,28,Player A
712,QLearningPlayer,243,188,431,15,28,Player A
713,QLearningPlayer,224,224,448,29,27,Tie
714,QLearningPlayer,212,247,459,22,21,QLearningPlayer
715,QLearningPlayer,254,174,428,21,31,Player A
716,QLearningPlayer,253,203,456,31,25,Player A
717,QLearningPlayer,248,198,446,27,27,Player A
718,QLearningPlayer,221,226,447,22,25,QLearningPlayer
719,QLearningPlayer,235,220,455,27,24,Player A
720,QLearningPlayer,260,205,465,25,20,Player A
721,QLearningPlayer,186,266,452,30,26,QLearningPlayer
722,QLearningPlayer,247,212,459,28,23,Player A
723,QLearningPlayer,241,221,462,34,24,Player A
724,QLearningPlayer,231,196,427,20,31,Player A
725,QLearningPlayer,226,231,457,26,23,QLearningPlayer
726,QLearningPlayer,210,235,445,20,25,QLearningPlayer
727,QLearningPlayer,245,205,450,28,26,Player A
728,QLearningPlayer,230,205,435,19,28,Player A
729,QLearningPlayer,205,235,440,24,28,QLearningPlayer
730,QLearningPlayer,211,256,467,24,19,QLearningPlayer
731,QLearningPlayer,207,222,429,25,32,QLearningPlayer
732,QLearningPlayer,232,247,479,30,17,QLearningPlayer
733,QLearningPlayer,217,227,444,28,28,QLearningPlayer
734,QLearningPlayer,210,245,455,24,23,QLearningPlayer
735,QLearningPlayer,185,250,435,25,30,QLearningPlayer
736,QLearningPlayer,236,226,462,25,21,Player A
737,QLearningPlayer,187,252,439,23,28,QLearningPlayer
738,QLearningPlayer,197,272,469,23,18,QLearningPlayer
739,QLearningPlayer,200,270,470,30,20,QLearningPlayer
740,QLearningPlayer,172,267,439,26,29,QLearningPlayer
741,QLearningPlayer,237,222,459,25,22,Player A
742,QLearningPlayer,224,234,458,27,23,QLearningPlayer
743,QLearningPlayer,260,205,465,25,20,Player A
744,QLearningPlayer,257,197,454,29,25,Player A
745,QLearningPlayer,241,216,457,29,24,Player A
746,QLearningPlayer,251,201,452,24,24,Player A
747,QLearningPlayer,160,245,405,16,37,QLearningPlayer
748,QLearningPlayer,232,227,459,31,24,Player A
749,QLearningPlayer,214,249,463,29,22,QLearningPlayer
750,QLearningPlayer,256,221,477,28,17,Player A
751,QLearningPlayer,239,204,443,27,28,Player A
752,QLearningPlayer,210,240,450,28,26,QLearningPlayer
753,QLearningPlayer,189,254,443,24,27,QLearningPlayer
754,QLearningPlayer,203,243,446,21,25,QLearningPlayer
755,QLearningPlayer,197,267,464,33,23,QLearningPlayer
756,QLearningPlayer,206,211,417,25,36,QLearningPlayer
757,QLearningPlayer,222,232,454,32,26,QLearningPlayer
758,QLearningPlayer,215,240,455,24,23,QLearningPlayer
759,QLearningPlayer,257,197,454,23,23,Player A
760,QLearningPlayer,204,234,438,22,28,QLearningPlayer
761,QLearningPlayer,249,214,463,23,20,Player A
762,QLearningPlayer,209,254,463,29,22,QLearningPlayer
763,QLearningPlayer,219,244,463,29,22,QLearningPlayer
764,QLearningPlayer,198,248,446,24,26,QLearningPlayer
765,QLearningPlayer,207,247,454,26,24,QLearningPlayer
766,QLearningPlayer,226,231,457,26,23,QLearningPlayer
767,QLearningPlayer,221,236,457,20,21,QLearningPlayer
768,QLearningPlayer,213,233,446,27,27,QLearningPlayer
769,QLearningPlayer,231,216,447,22,25,Player A
770,QLearningPlayer,214,249,463,29,22,QLearningPlayer
771,QLearningPlayer,204,224,428,18,30,QLearningPlayer
772,QLearningPlayer,225,235,460,26,22,QLearningPlayer
773,QLearningPlayer,219,264,483,25,14,QLearningPlayer
774,QLearningPlayer,205,235,440,27,29,QLearningPlayer
775,QLearningPlayer,241,221,462,28,22,Player A
776,QLearningPlayer,226,226,452,24,24,Tie
777,QLearningPlayer,221,231,452,27,25,QLearningPlayer
778,QLearningPlayer,219,234,453,28,25,QLearningPlayer
779,QLearningPlayer,216,246,462,28,22,QLearningPlayer
780,QLearningPlayer,239,209,448,23,25,Player A
781,QLearningPlayer,190,255,445,23,26,QLearningPlayer
782,QLearningPlayer,222,212,434,24,30,Player A
783,QLearningPlayer,226,221,447,25,26,Player A
784,QLearningPlayer,219,214,433,26,31,Player A
785,QLearningPlayer,223,228,451,26,25,QLearningPlayer
786,QLearningPlayer,228,233,461,21,20,QLearningPlayer
787,QLearningPlayer,205,235,440,27,29,QLearningPlayer
788,QLearningPlayer,211,246,457,23,22,QLearningPlayer
789,QLearningPlayer,219,219,438,25,29,Tie
790,QLearningPlayer,201,226,427,20,31,QLearningPlayer
791,QLearningPlayer,202,227,429,25,32,QLearningPlayer
792,QLearningPlayer,215,225,440,21,27,QLearningPlayer
793,QLearningPlayer,225,225,450,25,25,Tie
794,QLearningPlayer,211,236,447,34,29,QLearningPlayer
795,QLearningPlayer,238,208,446,15,23,Player A
796,QLearningPlayer,232,217,449,27,26,Player A
797,QLearningPlayer,213,253,466,26,20,QLearningPlayer
798,QLearningPlayer,254,194,448,23,25,Player A
799,QLearningPlayer,194,234,428,21,31,QLearningPlayer
800,QLearningPlayer,228,228,456,31,25,Tie
801,QLearningPlayer,229,229,458,30,24,Tie
802,QLearningPlayer,233,218,451,26,25,Player A
803,QLearningPlayer,217,222,439,29,30,QLearningPlayer
804,QLearningPlayer,248,193,441,25,28,Player A
805,QLearningPlayer,168,273,441,19,26,QLearningPlayer
806,QLearningPlayer,233,198,431,24,31,Player A
807,QLearningPlayer,280,200,480,31,17,Player A
808,QLearningPlayer,214,244,458,24,22,QLearningPlayer
809,QLearningPlayer,200,240,440,21,27,QLearningPlayer
810,QLearningPlayer,190,255,445,20,25,QLearningPlayer
811,QLearningPlayer,208,263,471,31,20,QLearningPlayer
812,QLearningPlayer,232,212,444,28,28,Player A
813,QLearningPlayer,228,228,456,22,22,Tie
814,QLearningPlayer,236,226,462,25,21,Player A
815,QLearningPlayer,215,235,450,28,26,QLearningPlayer
816,QLearningPlayer,217,242,459,28,23,QLearningPlayer
817,QLearningPlayer,177,252,429,19,30,QLearningPlayer
818,QLearningPlayer,240,230,470,30,20,Player A
819,QLearningPlayer,232,232,464,33,23,Tie
820,QLearningPlayer,220,240,460,26,22,QLearningPlayer
821,QLearningPlayer,229,219,448,26,26,Player A
822,QLearningPlayer,208,253,461,30,23,QLearningPlayer
823,QLearningPlayer,209,229,438,25,29,QLearningPlayer
824,QLearningPlayer,255,210,465,25,20,Player A
825,QLearningPlayer,214,234,448,29,27,QLearningPlayer
826,QLearningPlayer,264,199,463,20,19,Player A
827,QLearningPlayer,210,230,440,24,28,QLearningPlayer
828,QLearningPlayer,273,198,471,31,20,Player A
829,QLearningPlayer,242,212,454,26,24,Player A
830,QLearningPlayer,258,193,451,20,23,Player A
831,QLearningPlayer,225,240,465,25,20,QLearningPlayer
832,QLearningPlayer,264,194,458,24,22,Player A
833,QLearningPlayer,210,245,455,21,22,QLearningPlayer
834,QLearningPlayer,231,211,442,29,29,Player A
835,QLearningPlayer,215,240,455,30,25,QLearningPlayer
836,QLearningPlayer,216,231,447,31,28,QLearningPlayer
837,QLearningPlayer,226,236,462,25,21,QLearningPlayer
838,QLearningPlayer,218,233,451,29,26,QLearningPlayer
839,QLearningPlayer,207,247,454,23,23,QLearningPlayer
840,QLearningPlayer,214,234,448,29,27,QLearningPlayer
841,QLearningPlayer,192,227,419,21,34,QLearningPlayer
842,QLearningPlayer,197,252,449,21,24,QLearningPlayer
843,QLearningPlayer,263,218,481,29,16,Player A
844,QLearningPlayer,224,219,443,21,26,Player A
845,QLearningPlayer,227,237,464,36,24,QLearningPlayer
846,QLearningPlayer,208,258,466,29,21,QLearningPlayer
847,QLearningPlayer,232,247,479,30,17,QLearningPlayer
848,QLearningPlayer,241,236,477,25,16,Player A
849,QLearningPlayer,237,192,429,22,31,Player A
850,QLearningPlayer,278,183,461,30,23,Player A
851,QLearningPlayer,230,205,435,19,28,Player A
852,QLearningPlayer,208,203,411,19,36,Player A
853,QLearningPlayer,190,265,455,27,24,QLearningPlayer
854,QLearningPlayer,231,216,447,28,27,Player A
855,QLearningPlayer,240,235,475,26,17,Player A
856,QLearningPlayer,217,217,434,21,29,Tie
857,QLearningPlayer,218,248,466,23,19,QLearningPlayer
858,QLearningPlayer,223,218,441,25,28,Player A
859,QLearningPlayer,229,219,448,29,27,Player A
860,QLearningPlayer,223,218,441,25,28,Player A
861,QLearningPlayer,231,226,457,29,24,Player A
862,QLearningPlayer,235,235,470,30,20,Tie
863,QLearningPlayer,258,193,451,23,24,Player A
864,QLearningPlayer,220,240,460,23,21,QLearningPlayer
865,QLearningPlayer,218,258,476,21,15,QLearningPlayer
866,QLearningPlayer,250,210,460,29,23,Player A
867,QLearningPlayer,214,224,438,19,27,QLearningPlayer
868,QLearningPlayer,235,210,445,20,25,Player A
869,QLearningPlayer,246,201,447,31,28,Player A
870,QLearningPlayer,220,215,435,25,30,Player A
871,QLearningPlayer,207,227,434,30,32,QLearningPlayer
872,QLearningPlayer,254,204,458,30,24,Player A
873,QLearningPlayer,249,194,443,21,26,Player A
874,QLearningPlayer,233,228,461,30,23,Player A
875,QLearningPlayer,223,213,436,26,30,Player A
876,QLearningPlayer,219,249,468,28,20,QLearningPlayer
877,QLearningPlayer,223,238,461,27,22,QLearningPlayer
878,QLearningPlayer,251,201,452,24,24,Player A
879,QLearningPlayer,273,198,471,28,19,Player A
880,QLearningPlayer,195,230,425,21,32,QLearningPlayer
881,QLearningPlayer,201,231,432,25,31,QLearningPlayer
882,QLearningPlayer,199,254,453,28,25,QLearningPlayer
883,QLearningPlayer,210,245,455,24,23,QLearningPlayer
884,QLearningPlayer,227,207,434,18,28,Player A
885,QLearningPlayer,234,229,463,32,23,Player A
886,QLearningPlayer,283,198,481,26,15,Player A
887,QLearningPlayer,188,228,416,18,34,QLearningPlayer
888,QLearningPlayer,214,259,473,21,16,QLearningPlayer
889,QLearningPlayer,250,200,450,28,26,Player A
890,QLearningPlayer,193,263,456,28,24,QLearningPlayer
891,QLearningPlayer,213,228,441,25,28,QLearningPlayer
892,QLearningPlayer,227,217,444,25,27,Player A
893,QLearningPlayer,219,244,463,32,23,QLearningPlayer
894,QLearningPlayer,225,240,465,31,22,QLearningPlayer
895,QLearningPlayer,211,221,432,25,31,QLearningPlayer
896,QLearningPlayer,216,211,427,23,32,Player A
897,QLearningPlayer,213,228,441,25,28,QLearningPlayer
898,QLearningPlayer,217,262,479,24,15,QLearningPlayer
899,QLearningPlayer,227,227,454,26,24,Tie
900,QLearningPlayer,223,208,431,21,30,Player A
901,QLearningPlayer,233,218,451,23,24,Player A
902,QLearningPlayer,212,232,444,25,27,QLearningPlayer
903,QLearningPlayer,201,241,442,23,27,QLearningPlayer
904,QLearningPlayer,224,229,453,31,26,QLearningPlayer
905,QLearningPlayer,224,224,448,29,27,Tie
906,QLearningPlayer,222,252,474,31,19,QLearningPlayer
907,QLearningPlayer,187,267,454,26,24,QLearningPlayer
908,QLearningPlayer,219,224,443,27,28,QLearningPlayer
909,QLearningPlayer,231,206,437,21,28,Player A
910,QLearningPlayer,221,231,452,27,25,QLearningPlayer
911,QLearningPlayer,226,236,462,31,23,QLearningPlayer
912,QLearningPlayer,226,216,442,26,28,Player A
913,QLearningPlayer,205,230,435,19,28,QLearningPlayer
914,QLearningPlayer,204,239,443,24,27,QLearningPlayer
915,QLearningPlayer,243,208,451,20,23,Player A
916,QLearningPlayer,226,226,452,27,25,Tie
917,QLearningPlayer,226,231,457,26,23,QLearningPlayer
918,QLearningPlayer,255,195,450,25,25,Player A
919,QLearningPlayer,250,215,465,31,22,Player A
920,QLearningPlayer,215,225,440,21,27,QLearningPlayer
921,QLearningPlayer,229,234,463,26,21,QLearningPlayer
922,QLearningPlayer,209,239,448,23,25,QLearningPlayer
923,QLearningPlayer,201,261,462,22,20,QLearningPlayer
924,QLearningPlayer,225,230,455,24,23,QLearningPlayer
925,QLearningPlayer,192,242,434,27,31,QLearningPlayer
926,QLearningPlayer,256,221,477,25,16,Player A
927,QLearningPlayer,222,222,444,22,26,Tie
928,QLearningPlayer,247,232,479,27,16,Player A
929,QLearningPlayer,229,229,458,27,23,Tie
930,QLearningPlayer,203,253,456,22,22,QLearningPlayer
931,QLearningPlayer,242,202,444,28,28,Player A
932,QLearningPlayer,225,230,455,27,24,QLearningPlayer
933,QLearningPlayer,200,255,455,21,22,QLearningPlayer
934,QLearningPlayer,209,254,463,29,22,QLearningPlayer
935,QLearningPlayer,197,257,454,23,23,QLearningPlayer
936,QLearningPlayer,240,215,455,27,24,Player A
937,QLearningPlayer,227,212,439,20,27,Player A
938,QLearningPlayer,222,232,454,32,26,QLearningPlayer
939,QLearningPlayer,200,255,455,27,24,QLearningPlayer
940,QLearningPlayer,217,237,454,26,24,QLearningPlayer
941,QLearningPlayer,234,219,453,28,25,Player A
942,QLearningPlayer,232,217,449,27,26,Player A
943,QLearningPlayer,220,200,420,19,33,Player A
944,QLearningPlayer,254,214,468,25,19,Player A
945,QLearningPlayer,210,225,435,22,29,QLearningPlayer
946,QLearningPlayer,212,247,459,25,22,QLearningPlayer
947,QLearningPlayer,215,220,435,22,29,QLearningPlayer
948,QLearningPlayer,210,230,440,21,27,QLearningPlayer
949,QLearningPlayer,213,238,451,29,26,QLearningPlayer
950,QLearningPlayer,230,200,430,20,30,Player A
951,QLearningPlayer,255,195,450,31,27,Player A
952,QLearningPlayer,231,221,452,18,22,Player A
953,QLearningPlayer,254,199,453,25,24,Player A
954,QLearningPlayer,236,221,457,26,23,Player A
955,QLearningPlayer,216,241,457,29,24,QLearningPlayer
956,QLearningPlayer,204,249,453,25,24,QLearningPlayer
957,QLearningPlayer,225,210,435,22,29,Player A
958,QLearningPlayer,215,225,440,18,26,QLearningPlayer
959,QLearningPlayer,187,277,464,24,20,QLearningPlayer
960,QLearningPlayer,185,260,445,26,27,QLearningPlayer
961,QLearningPlayer,245,220,465,28,21,Player A
962,QLearningPlayer,229,209,438,22,28,Player A
963,QLearningPlayer,234,224,458,21,21,Player A
964,QLearningPlayer,216,241,457,26,23,QLearningPlayer
965,QLearningPlayer,210,235,445,23,26,QLearningPlayer
966,QLearningPlayer,205,205,410,21,37,Tie
967,QLearningPlayer,233,198,431,21,30,Player A
968,QLearningPlayer,222,222,444,22,26,Tie
969,QLearningPlayer,208,233,441,22,27,QLearningPlayer
970,QLearningPlayer,193,263,456,25,23,QLearningPlayer
971,QLearningPlayer,221,216,437,18,27,Player A
972,QLearningPlayer,244,214,458,33,25,Player A
973,QLearningPlayer,232,227,459,28,23,Player A
974,QLearningPlayer,263,188,451,26,25,Player A
975,QLearningPlayer,215,210,425,24,33,Player A
976,QLearningPlayer,234,199,433,23,30,Player A
977,QLearningPlayer,230,210,440,27,29,Player A
978,QLearningPlayer,234,199,433,17,28,Player A
979,QLearningPlayer,255,180,435,16,27,Player A
980,QLearningPlayer,238,238,476,33,19,Tie
981,QLearningPlayer,237,212,449,27,26,Player A
982,QLearningPlayer,228,223,451,23,24,Player A
983,QLearningPlayer,242,227,469,23,18,Player A
984,QLearningPlayer,218,208,426,22,32,Player A
985,QLearningPlayer,232,222,454,29,25,Player A
986,QLearningPlayer,212,222,434,24,30,QLearningPlayer
987,QLearningPlayer,190,245,435,19,28,QLearningPlayer
988,QLearningPlayer,187,262,449,24,25,QLearningPlayer
989,QLearningPlayer,232,217,449,24,25,Player A
990,QLearningPlayer,267,217,484,29,15,Player A
991,QLearningPlayer,194,234,428,18,30,QLearningPlayer
992,QLearningPlayer,208,238,446,24,26,QLearningPlayer
993,QLearningPlayer,201,256,457,20,21,QLearningPlayer
994,QLearningPlayer,232,217,449,24,25,Player A
995,QLearningPlayer,202,252,454,26,24,QLearningPlayer
996,QLearningPlayer,202,237,439,20,27,QLearningPlayer
997,QLearningPlayer,208,248,456,37,27,QLearningPlayer
998,QLearningPlayer,221,221,442,20,26,Tie
999,QLearningPlayer,209,234,443,24,27,QLearningPlayer
1000,QLearningPlayer,241,201,442,17,25,Player A
1001,QLearningPlayer,245,205,450,25,25,Player A
1002,QLearningPlayer,216,231,447,28,27,QLearningPlayer
1003,QLearningPlayer,264,194,458,27,23,Player A
1004,QLearningPlayer,203,253,456,28,24,QLearningPlayer
1005,QLearningPlayer,261,181,442,23,27,Player A
1006,QLearningPlayer,221,221,442,14,24,Tie
1007,QLearningPlayer,213,238,451,29,26,QLearningPlayer
1008,QLearningPlayer,250,215,465,28,21,Player A
1009,QLearningPlayer,208,223,431,18,29,QLearningPlayer
1010,QLearningPlayer,193,263,456,25,23,QLearningPlayer
1011,QLearningPlayer,165,280,445,26,27,QLearningPlayer
1012,QLearningPlayer,223,223,446,27,27,Tie
1013,QLearningPlayer,241,221,462,28,22,Player A
1014,QLearningPlayer,211,236,447,28,27,QLearningPlayer
1015,QLearningPlayer,209,269,478,32,18,QLearningPlayer
1016,QLearningPlayer,214,234,448,20,24,QLearningPlayer
1017,QLearningPlayer,222,237,459,25,22,QLearningPlayer
1018,QLearningPlayer,253,213,466,32,22,Player A
1019,QLearningPlayer,210,250,460,29,23,QLearningPlayer
1020,QLearningPlayer,223,213,436,20,28,Player A
1021,QLearningPlayer,206,246,452,27,25,QLearningPlayer
1022,QLearningPlayer,236,216,452,27,25,Player A
1023,QLearningPlayer,212,237,449,30,27,QLearningPlayer
1024,QLearningPlayer,200,265,465,31,22,QLearningPlayer
1025,QLearningPlayer,216,241,457,23,22,QLearningPlayer
1026,QLearningPlayer,211,236,447,25,26,QLearningPlayer
1027,QLearningPlayer,225,250,475,26,17,QLearningPlayer
1028,QLearningPlayer,229,239,468,31,21,QLearningPlayer
1029,QLearningPlayer,251,206,457,29,24,Player A
1030,QLearningPlayer,217,237,454,29,25,QLearningPlayer
1031,QLearningPlayer,220,235,455,27,24,QLearningPlayer
1032,QLearningPlayer,210,245,455,24,23,QLearningPlayer
1033,QLearningPlayer,241,196,437,21,28,Player A
1034,QLearningPlayer,231,216,447,31,28,Player A
1035,QLearningPlayer,223,243,466,29,21,QLearningPlayer
1036,QLearningPlayer,247,237,484,38,18,Player A
1037,QLearningPlayer,199,249,448,20,24,QLearningPlayer
1038,QLearningPlayer,256,211,467,30,21,Player A
1039,QLearningPlayer,224,229,453,25,24,QLearningPlayer
1040,QLearningPlayer,205,215,420,22,34,QLearningPlayer
1041,QLearningPlayer,219,234,453,25,24,QLearningPlayer
1042,QLearningPlayer,220,230,450,22,24,QLearningPlayer
1043,QLearningPlayer,231,216,447,25,26,Player A
1044,QLearningPlayer,240,230,470,30,20,Player A
1045,QLearningPlayer,232,212,444,25,27,Player A
1046,QLearningPlayer,212,247,459,34,25,QLearningPlayer
1047,QLearningPlayer,230,230,460,26,22,Tie
1048,QLearningPlayer,217,227,444,25,27,QLearningPlayer
1049,QLearningPlayer,207,232,439,20,27,QLearningPlayer
1050,QLearningPlayer,209,234,443,27,28,QLearningPlayer
1051,QLearningPlayer,272,172,444,16,24,Player A
1052,QLearningPlayer,244,209,453,25,24,Player A
1053,QLearningPlayer,250,205,455,27,24,Player A
1054,QLearningPlayer,226,226,452,18,22,Tie
1055,QLearningPlayer,223,238,461,27,22,QLearningPlayer
1056,QLearningPlayer,212,222,434,18,28,QLearningPlayer
1057,QLearningPlayer,257,207,464,24,20,Player A
1058,QLearningPlayer,199,219,418,26,36,QLearningPlayer
1059,QLearningPlayer,201,241,442,23,27,QLearningPlayer
1060,QLearningPlayer,221,221,442,23,27,Tie
1061,QLearningPlayer,220,240,460,26,22,QLearningPlayer
1062,QLearningPlayer,218,238,456,22,22,QLearningPlayer
1063,QLearningPlayer,223,208,431,21,30,Player A
1064,QLearningPlayer,235,210,445,29,28,Player A
1065,QLearningPlayer,225,220,445,26,27,Player A
1066,QLearningPlayer,230,220,450,28,26,Player A
1067,QLearningPlayer,215,235,450,25,25,QLearningPlayer
1068,QLearningPlayer,210,240,450,31,27,QLearningPlayer
1069,QLearningPlayer,205,235,440,24,28,QLearningPlayer
1070,QLearningPlayer,246,231,477,31,18,Player A
1071,QLearningPlayer,222,217,439,17,26,Player A
1072,QLearningPlayer,198,243,441,22,27,QLearningPlayer
1073,QLearningPlayer,205,220,425,27,34,QLearningPlayer
1074,QLearningPlayer,225,220,445,23,26,Player A
1075,QLearningPlayer,248,213,461,21,20,Player A
1076,QLearningPlayer,270,195,465,25,20,Player A
1077,QLearningPlayer,237,212,449,18,23,Player A
1078,QLearningPlayer,243,208,451,32,27,Player A
1079,QLearningPlayer,202,237,439,23,28,QLearningPlayer
1080,QLearningPlayer,240,215,455,27,24,Player A
1081,QLearningPlayer,211,236,447,19,24,QLearningPlayer
1082,QLearningPlayer,231,206,437,24,29,Player A
1083,QLearningPlayer,221,221,442,23,27,Tie
1084,QLearningPlayer,206,256,462,31,23,QLearningPlayer
1085,QLearningPlayer,254,194,448,26,26,Player A
1086,QLearningPlayer,201,266,467,30,21,QLearningPlayer
1087,QLearningPlayer,227,232,459,19,20,QLearningPlayer
1088,QLearningPlayer,204,249,453,25,24,QLearningPlayer
1089,QLearningPlayer,227,252,479,33,18,QLearningPlayer
1090,QLearningPlayer,237,217,454,29,25,Player A
1091,QLearningPlayer,244,204,448,23,25,Player A
1092,QLearningPlayer,215,220,435,19,28,QLearningPlayer
1093,QLearningPlayer,199,239,438,19,27,QLearningPlayer
1094,QLearningPlayer,189,239,428,15,29,QLearningPlayer
1095,QLearningPlayer,254,199,453,28,25,Player A
1096,QLearningPlayer,235,215,450,28,26,Player A
1097,QLearningPlayer,233,198,431,21,30,Player A
1098,QLearningPlayer,169,249,418,20,34,QLearningPlayer
1099,QLearningPlayer,216,216,432,19,29,Tie
1100,QLearningPlayer,221,241,462,34,24,QLearningPlayer
1101,QLearningPlayer,223,223,446,21,25,Tie
1102,QLearningPlayer,206,236,442,20,26,QLearningPlayer
1103,QLearningPlayer,220,230,450,28,26,QLearningPlayer
1104,QLearningPlayer,221,211,432,19,29,Player A
1105,QLearningPlayer,255,185,440,24,28,Player A
1106,QLearningPlayer,221,231,452,24,24,QLearningPlayer
1107,QLearningPlayer,192,242,434,21,29,QLearningPlayer
1108,QLearningPlayer,241,196,437,21,28,Player A
1109,QLearningPlayer,266,211,477,28,17,Player A
1110,QLearningPlayer,259,214,473,30,19,Player A
1111,QLearningPlayer,217,237,454,32,26,QLearningPlayer
1112,QLearningPlayer,240,205,445,17,24,Player A
1113,QLearningPlayer,214,239,453,28,25,QLearningPlayer
1114,QLearningPlayer,220,220,440,21,27,Tie
1115,QLearningPlayer,252,222,474,25,17,Player A
1116,QLearningPlayer,214,224,438,22,28,QLearningPlayer
1117,QLearningPlayer,208,243,451,35,28,QLearningPlayer
1118,QLearningPlayer,236,241,477,28,17,QLearningPlayer
1119,QLearningPlayer,207,242,449,21,24,QLearningPlayer
1120,QLearningPlayer,238,223,461,27,22,Player A
1121,QLearningPlayer,250,210,460,26,22,Player A
1122,QLearningPlayer,219,229,448,29,27,QLearningPlayer
1123,QLearningPlayer,213,223,436,23,29,QLearningPlayer
1124,QLearningPlayer,222,207,429,19,30,Player A
1125,QLearningPlayer,198,228,426,22,32,QLearningPlayer
1126,QLearningPlayer,217,222,439,32,31,QLearningPlayer
1127,QLearningPlayer,255,195,450,25,25,Player A
1128,QLearningPlayer,236,236,472,23,17,Tie
1129,QLearningPlayer,277,172,449,24,25,Player A
1130,QLearningPlayer,274,194,468,25,19,Player A
1131,QLearningPlayer,230,230,460,20,20,Tie
1132,QLearningPlayer,249,199,448,29,27,Player A
1133,QLearningPlayer,220,255,475,29,18,QLearningPlayer
1134,QLearningPlayer,213,248,461,27,22,QLearningPlayer
1135,QLearningPlayer,233,208,441,22,27,Player A
1136,QLearningPlayer,265,185,450,19,23,Player A
1137,QLearningPlayer,236,201,437,30,31,Player A
1138,QLearningPlayer,230,225,455,27,24,Player A
1139,QLearningPlayer,225,215,440,24,28,Player A
1140,QLearningPlayer,226,206,432,19,29,Player A
1141,QLearningPlayer,218,233,451,32,27,QLearningPlayer
1142,QLearningPlayer,244,204,448,26,26,Player A
1143,QLearningPlayer,241,211,452,24,24,Player A
1144,QLearningPlayer,230,230,460,29,23,Tie
1145,QLearningPlayer,221,231,452,30,26,QLearningPlayer
1146,QLearningPlayer,199,254,453,28,25,QLearningPlayer
1147,QLearningPlayer,256,206,462,31,23,Player A
1148,QLearningPlayer,212,232,444,25,27,QLearningPlayer
1149,QLearningPlayer,275,185,460,32,24,Player A
1150,QLearningPlayer,193,248,441,31,30,QLearningPlayer
1151,QLearningPlayer,238,208,446,30,28,Player A
1152,QLearningPlayer,216,226,442,32,30,QLearningPlayer
1153,QLearningPlayer,239,224,463,32,23,Player A
1154,QLearningPlayer,210,255,465,31,22,QLearningPlayer
1155,QLearningPlayer,217,257,474,25,17,QLearningPlayer
1156,QLearningPlayer,211,241,452,27,25,QLearningPlayer
1157,QLearningPlayer,220,225,445,23,26,QLearningPlayer
1158,QLearningPlayer,221,261,482,30,16,QLearningPlayer
1159,QLearningPlayer,196,251,447,22,25,QLearningPlayer
1160,QLearningPlayer,218,233,451,26,25,QLearningPlayer
1161,QLearningPlayer,256,206,462,25,21,Player A
1162,QLearningPlayer,224,224,448,29,27,Tie
1163,QLearningPlayer,260,210,470,27,19,Player A
1164,QLearningPlayer,219,224,443,24,27,QLearningPlayer
1165,QLearningPlayer,233,203,436,20,28,Player A
1166,QLearningPlayer,218,253,471,31,20,QLearningPlayer
1167,QLearningPlayer,238,223,461,24,21,Player A
1168,QLearningPlayer,193,253,446,18,24,QLearningPlayer
1169,QLearningPlayer,214,224,438,16,26,QLearningPlayer
1170,QLearningPlayer,194,254,448,17,23,QLearningPlayer
1171,QLearningPlayer,231,246,477,31,18,QLearningPlayer
1172,QLearningPlayer,257,207,464,36,24,Player A
1173,QLearningPlayer,228,243,471,31,20,QLearningPlayer
1174,QLearningPlayer,212,242,454,23,23,QLearningPlayer
1175,QLearningPlayer,210,230,440,24,28,QLearningPlayer
1176,QLearningPlayer,234,229,463,29,22,Player A
1177,QLearningPlayer,221,226,447,28,27,QLearningPlayer
1178,QLearningPlayer,191,236,427,26,33,QLearningPlayer
1179,QLearningPlayer,229,229,458,30,24,Tie
1180,QLearningPlayer,214,264,478,29,17,QLearningPlayer
1181,QLearningPlayer,225,225,450,25,25,Tie
1182,QLearningPlayer,231,206,437,27,30,Player A
1183,QLearningPlayer,257,202,459,22,21,Player A
1184,QLearningPlayer,238,213,451,26,25,Player A
1185,QLearningPlayer,218,223,441,25,28,QLearningPlayer
1186,QLearningPlayer,260,190,450,22,24,Player A
1187,QLearningPlayer,228,243,471,25,18,QLearningPlayer
1188,QLearningPlayer,261,201,462,28,22,Player A
1189,QLearningPlayer,206,251,457,23,22,QLearningPlayer
1190,QLearningPlayer,222,232,454,26,24,QLearningPlayer
1191,QLearningPlayer,214,229,443,24,27,QLearningPlayer
1192,QLearningPlayer,215,240,455,18,21,QLearningPlayer
1193,QLearningPlayer,246,211,457,26,23,Player A
1194,QLearningPlayer,246,216,462,28,22,Player A
1195,QLearningPlayer,248,203,451,32,27,Player A
1196,QLearningPlayer,185,255,440,18,26,QLearningPlayer
1197,QLearningPlayer,212,227,439,23,28,QLearningPlayer
1198,QLearningPlayer,201,261,462,34,24,QLearningPlayer
1199,QLearningPlayer,257,217,474,31,19,Player A
1200,QLearningPlayer,201,211,412,23,37,QLearningPlayer
1201,QLearningPlayer,213,243,456,22,22,QLearningPlayer
1202,QLearningPlayer,211,241,452,27,25,QLearningPlayer
1203,QLearningPlayer,223,258,481,35,18,QLearningPlayer
1204,QLearningPlayer,226,236,462,22,20,QLearningPlayer
1205,QLearningPlayer,221,216,437,21,28,Player A
1206,QLearningPlayer,258,218,476,27,17,Player A
1207,QLearningPlayer,254,199,453,28,25,Player A
1208,QLearningPlayer,238,238,476,36,20,Tie
1209,QLearningPlayer,247,207,454,32,26,Player A
1210,QLearningPlayer,261,211,472,32,20,Player A
1211,QLearningPlayer,217,232,449,21,24,QLearningPlayer
1212,QLearningPlayer,200,220,420,19,33,QLearningPlayer
1213,QLearningPlayer,220,235,455,24,23,QLearningPlayer
1214,QLearningPlayer,240,230,470,30,20,Player A
1215,QLearningPlayer,209,249,458,24,22,QLearningPlayer
1216,QLearningPlayer,235,220,455,33,26,Player A
1217,QLearningPlayer,216,251,467,30,21,QLearningPlayer
1218,QLearningPlayer,206,226,432,25,31,QLearningPlayer
1219,QLearningPlayer,242,202,444,22,26,Player A
1220,QLearningPlayer,206,236,442,26,28,QLearningPlayer
1221,QLearningPlayer,211,236,447,34,29,QLearningPlayer
1222,QLearningPlayer,204,219,423,19,32,QLearningPlayer
1223,QLearningPlayer,218,213,431,24,31,Player A
1224,QLearningPlayer,234,244,478,32,18,QLearningPlayer
1225,QLearningPlayer,247,192,439,23,28,Player A
1226,QLearningPlayer,245,215,460,32,24,Player A
1227,QLearningPlayer,207,252,459,25,22,QLearningPlayer
1228,QLearningPlayer,225,220,445,20,25,Player A
1229,QLearningPlayer,220,230,450,22,24,QLearningPlayer
1230,QLearningPlayer,213,223,436,20,28,QLearningPlayer
1231,QLearningPlayer,209,234,443,21,26,QLearningPlayer
1232,QLearningPlayer,288,183,471,31,20,Player A
1233,QLearningPlayer,224,219,443,18,25,Player A
1234,QLearningPlayer,197,257,454,23,23,QLearningPlayer
1235,QLearningPlayer,214,214,428,21,31,Tie
1236,QLearningPlayer,268,198,466,29,21,Player A
1237,QLearningPlayer,207,217,424,20,32,QLearningPlayer
1238,QLearningPlayer,213,223,436,17,27,QLearningPlayer
1239,QLearningPlayer,236,206,442,20,26,Player A
1240,QLearningPlayer,230,230,460,29,23,Tie
1241,QLearningPlayer,215,255,470,30,20,QLearningPlayer
1242,QLearningPlayer,192,247,439,17,26,QLearningPlayer
1243,QLearningPlayer,282,197,479,33,18,Player A
1244,QLearningPlayer,203,248,451,23,24,QLearningPlayer
1245,QLearningPlayer,225,225,450,22,24,Tie
1246,QLearningPlayer,241,236,477,28,17,Player A
1247,QLearningPlayer,217,222,439,32,31,QLearningPlayer
1248,QLearningPlayer,199,249,448,29,27,QLearningPlayer
1249,QLearningPlayer,191,286,477,31,18,QLearningPlayer
1250,QLearningPlayer,231,216,447,25,26,Player A
1251,QLearningPlayer,210,220,430,29,33,QLearningPlayer
1252,QLearningPlayer,209,229,438,22,28,QLearningPlayer
1253,QLearningPlayer,244,199,443,21,26,Player A
1254,QLearningPlayer,235,215,450,28,26,Player A
1255,QLearningPlayer,268,198,466,23,19,Player A
1256,QLearningPlayer,217,232,449,27,26,QLearningPlayer
1257,QLearningPlayer,208,238,446,30,28,QLearningPlayer
1258,QLearningPlayer,251,211,462,31,23,Player A
1259,QLearningPlayer,219,229,448,20,24,QLearningPlayer
1260,QLearningPlayer,262,202,464,30,22,Player A
1261,QLearningPlayer,247,217,464,36,24,Player A
1262,QLearningPlayer,252,212,464,33,23,Player A
1263,QLearningPlayer,239,214,453,25,24,Player A
1264,QLearningPlayer,241,196,437,15,26,Player A
1265,QLearningPlayer,181,256,437,21,28,QLearningPlayer
1266,QLearningPlayer,226,226,452,24,24,Tie
1267,QLearningPlayer,243,208,451,26,25,Player A
1268,QLearningPlayer,247,187,434,24,30,Player A
1269,QLearningPlayer,216,236,452,27,25,QLearningPlayer
1270,QLearningPlayer,209,249,458,33,25,QLearningPlayer
1271,QLearningPlayer,226,241,467,21,18,QLearningPlayer
1272,QLearningPlayer,203,223,426,13,29,QLearningPlayer
1273,QLearningPlayer,225,200,425,24,33,Player A
1274,QLearningPlayer,252,197,449,18,23,Player A
1275,QLearningPlayer,212,232,444,25,27,QLearningPlayer
1276,QLearningPlayer,205,260,465,28,21,QLearningPlayer
1277,QLearningPlayer,215,220,435,28,31,QLearningPlayer
1278,QLearningPlayer,228,218,446,27,27,Player A
1279,QLearningPlayer,224,194,418,17,33,Player A
1280,QLearningPlayer,205,250,455,21,22,QLearningPlayer
1281,QLearningPlayer,195,255,450,25,25,QLearningPlayer
1282,QLearningPlayer,216,236,452,24,24,QLearningPlayer
1283,QLearningPlayer,242,197,439,26,29,Player A
1284,QLearningPlayer,249,199,448,35,29,Player A
1285,QLearningPlayer,204,239,443,27,28,QLearningPlayer
1286,QLearningPlayer,190,270,460,26,22,QLearningPlayer
1287,QLearningPlayer,210,225,435,28,31,QLearningPlayer
1288,QLearningPlayer,205,225,430,17,29,QLearningPlayer
1289,QLearningPlayer,218,253,471,25,18,QLearningPlayer
1290,QLearningPlayer,251,216,467,27,20,Player A
1291,QLearningPlayer,254,209,463,26,21,Player A
1292,QLearningPlayer,214,214,428,24,32,Tie
1293,QLearningPlayer,227,207,434,24,30,Player A
1294,QLearningPlayer,239,214,453,31,26,Player A
1295,QLearningPlayer,241,221,462,28,22,Player A
1296,QLearningPlayer,241,221,462,31,23,Player A
1297,QLearningPlayer,202,247,449,27,26,QLearningPlayer
1298,QLearningPlayer,198,263,461,27,22,QLearningPlayer
1299,QLearningPlayer,224,234,458,27,23,QLearningPlayer
1300,QLearningPlayer,225,230,455,30,25,QLearningPlayer
1301,QLearningPlayer,219,229,448,29,27,QLearningPlayer
1302,QLearningPlayer,234,224,458,30,24,Player A
1303,QLearningPlayer,214,219,433,20,29,QLearningPlayer
1304,QLearningPlayer,227,232,459,28,23,QLearningPlayer
1305,QLearningPlayer,247,237,484,35,17,Player A
1306,QLearningPlayer,236,206,442,23,27,Player A
1307,QLearningPlayer,211,231,442,20,26,QLearningPlayer
1308,QLearningPlayer,202,227,429,22,31,QLearningPlayer
1309,QLearningPlayer,188,218,406,20,38,QLearningPlayer
1310,QLearningPlayer,259,214,473,33,20,Player A
1311,QLearningPlayer,232,217,449,27,26,Player A
1312,QLearningPlayer,212,242,454,29,25,QLearningPlayer
1313,QLearningPlayer,244,199,443,18,25,Player A
1314,QLearningPlayer,208,213,421,20,33,QLearningPlayer
1315,QLearningPlayer,186,251,437,24,29,QLearningPlayer
1316,QLearningPlayer,230,230,460,26,22,Tie
1317,QLearningPlayer,195,220,415,14,33,QLearningPlayer
1318,QLearningPlayer,208,253,461,30,23,QLearningPlayer
1319,QLearningPlayer,245,220,465,25,20,Player A
1320,QLearningPlayer,226,206,432,19,29,Player A
1321,QLearningPlayer,227,242,469,29,20,QLearningPlayer
1322,QLearningPlayer,248,203,451,23,24,Player A
1323,QLearningPlayer,212,227,439,26,29,QLearningPlayer
1324,QLearningPlayer,249,204,453,22,23,Player A
1325,QLearningPlayer,259,189,448,17,23,Player A
1326,QLearningPlayer,259,204,463,26,21,Player A
1327,QLearningPlayer,255,180,435,13,26,Player A
1328,QLearningPlayer,218,193,411,19,36,Player A
1329,QLearningPlayer,219,229,448,23,25,QLearningPlayer
1330,QLearningPlayer,235,225,460,20,20,Player A
1331,QLearningPlayer,247,197,444,22,26,Player A
1332,QLearningPlayer,233,208,441,28,29,Player A
1333,QLearningPlayer,198,253,451,23,24,QLearningPlayer
1334,QLearningPlayer,234,234,468,25,19,Tie
1335,QLearningPlayer,227,232,459,25,22,QLearningPlayer
1336,QLearningPlayer,243,223,466,23,19,Player A
1337,QLearningPlayer,222,202,424,20,32,Player A
1338,QLearningPlayer,239,204,443,21,26,Player A
1339,QLearningPlayer,170,265,435,22,29,QLearningPlayer
1340,QLearningPlayer,248,203,451,23,24,Player A
1341,QLearningPlayer,221,221,442,29,29,Tie
1342,QLearningPlayer,238,213,451,20,23,Player A
1343,QLearningPlayer,212,237,449,24,25,QLearningPlayer
1344,QLearningPlayer,208,218,426,22,32,QLearningPlayer
1345,QLearningPlayer,213,213,426,19,31,Tie
1346,QLearningPlayer,200,220,420,19,33,QLearningPlayer
1347,QLearningPlayer,233,218,451,23,24,Player A
1348,QLearningPlayer,262,217,479,33,18,Player A
1349,QLearningPlayer,223,213,436,26,30,Player A
1350,QLearningPlayer,231,211,442,23,27,Player A
1351,QLearningPlayer,233,213,446,30,28,Player A
1352,QLearningPlayer,208,248,456,25,23,QLearningPlayer
1353,QLearningPlayer,231,226,457,26,23,Player A
1354,QLearningPlayer,244,234,478,32,18,Player A
1355,QLearningPlayer,220,215,435,25,30,Player A
1356,QLearningPlayer,230,230,460,29,23,Tie
1357,QLearningPlayer,229,204,433,23,30,Player A
1358,QLearningPlayer,212,242,454,23,23,QLearningPlayer
1359,QLearningPlayer,247,202,449,21,24,Player A
1360,QLearningPlayer,243,218,461,27,22,Player A
1361,QLearningPlayer,224,214,438,19,27,Player A
1362,QLearningPlayer,220,220,440,27,29,Tie
1363,QLearningPlayer,207,217,424,17,31,QLearningPlayer
1364,QLearningPlayer,247,217,464,24,20,Player A
1365,QLearningPlayer,250,230,480,34,18,Player A
1366,QLearningPlayer,241,211,452,27,25,Player A
1367,QLearningPlayer,250,205,455,24,23,Player A
1368,QLearningPlayer,234,199,433,23,30,Player A
1369,QLearningPlayer,238,208,446,27,27,Player A
1370,QLearningPlayer,231,251,482,33,17,QLearningPlayer
1371,QLearningPlayer,252,202,454,26,24,Player A
1372,QLearningPlayer,225,225,450,25,25,Tie
1373,QLearningPlayer,255,180,435,25,30,Player A
1374,QLearningPlayer,196,261,457,23,22,QLearningPlayer
1375,QLearningPlayer,229,209,438,22,28,Player A
1376,QLearningPlayer,194,244,438,22,28,QLearningPlayer
1377,QLearningPlayer,240,215,455,27,24,Player A
1378,QLearningPlayer,220,220,440,24,28,Tie
1379,QLearningPlayer,200,260,460,29,23,QLearningPlayer
1380,QLearningPlayer,235,220,455,27,24,Player A
1381,QLearningPlayer,229,214,443,21,26,Player A
1382,QLearningPlayer,203,253,456,25,23,QLearningPlayer
1383,QLearningPlayer,201,251,452,30,26,QLearningPlayer
1384,QLearningPlayer,238,213,451,29,26,Player A
1385,QLearningPlayer,230,235,465,25,20,QLearningPlayer
1386,QLearningPlayer,212,232,444,25,27,QLearningPlayer
1387,QLearningPlayer,192,262,454,20,22,QLearningPlayer
1388,QLearningPlayer,233,223,456,25,23,Player A
1389,QLearningPlayer,233,188,421,17,32,Player A
1390,QLearningPlayer,202,242,444,25,27,QLearningPlayer
1391,QLearningPlayer,183,263,446,21,25,QLearningPlayer
1392,QLearningPlayer,227,237,464,24,20,QLearningPlayer
1393,QLearningPlayer,205,240,445,23,26,QLearningPlayer
1394,QLearningPlayer,221,221,442,29,29,Tie
1395,QLearningPlayer,227,237,464,36,24,QLearningPlayer
1396,QLearningPlayer,245,220,465,34,23,Player A
1397,QLearningPlayer,206,221,427,20,31,QLearningPlayer
1398,QLearningPlayer,216,251,467,21,18,QLearningPlayer
1399,QLearningPlayer,225,225,450,25,25,Tie
1400,QLearningPlayer,221,221,442,20,26,Tie
1401,QLearningPlayer,217,237,454,17,21,QLearningPlayer
1402,QLearningPlayer,223,213,436,20,28,Player A
1403,QLearningPlayer,200,240,440,24,28,QLearningPlayer
1404,QLearningPlayer,210,225,435,19,28,QLearningPlayer
1405,QLearningPlayer,219,229,448,26,26,QLearningPlayer
1406,QLearningPlayer,196,246,442,23,27,QLearningPlayer
1407,QLearningPlayer,208,238,446,27,27,QLearningPlayer
1408,QLearningPlayer,221,226,447,22,25,QLearningPlayer
1409,QLearningPlayer,232,237,469,26,19,QLearningPlayer
1410,QLearningPlayer,214,224,438,22,28,QLearningPlayer
1411,QLearningPlayer,229,209,438,19,27,Player A
1412,QLearningPlayer,236,236,472,26,18,Tie
1413,QLearningPlayer,235,215,450,31,27,Player A
1414,QLearningPlayer,254,174,428,18,30,Player A
1415,QLearningPlayer,224,229,453,22,23,QLearningPlayer
1416,QLearningPlayer,193,228,421,23,34,QLearningPlayer
1417,QLearningPlayer,247,197,444,19,25,Player A
1418,QLearningPlayer,243,188,431,33,34,Player A
1419,QLearningPlayer,221,206,427,20,31,Player A
1420,QLearningPlayer,243,218,461,30,23,Player A
1421,QLearningPlayer,222,207,429,22,31,Player A
1422,QLearningPlayer,225,220,445,29,28,Player A
1423,QLearningPlayer,218,238,456,31,25,QLearningPlayer
1424,QLearningPlayer,229,199,428,18,30,Player A
1425,QLearningPlayer,235,220,455,24,23,Player A
1426,QLearningPlayer,191,241,432,19,29,QLearningPlayer
1427,QLearningPlayer,248,193,441,22,27,Player A
1428,QLearningPlayer,210,250,460,26,22,QLearningPlayer
1429,QLearningPlayer,234,244,478,26,16,QLearningPlayer
1430,QLearningPlayer,194,254,448,20,24,QLearningPlayer
1431,QLearningPlayer,214,254,468,25,19,QLearningPlayer
1432,QLearningPlayer,236,236,472,29,19,Tie
1433,QLearningPlayer,270,190,460,26,22,Player A
1434,QLearningPlayer,224,244,468,31,21,QLearningPlayer
0,PatternLearningPlayer,298,188,486,34,16,Player A
1,PatternLearningPlayer,231,216,447,19,24,Player A
2,PatternLearningPlayer,203,203,406,17,37,Tie
3,PatternLearningPlayer,231,216,447,25,26,Player A
4,PatternLearningPlayer,264,229,493,38,15,Player A
5,PatternLearningPlayer,252,212,464,27,21,Player A
6,PatternLearningPlayer,262,212,474,28,18,Player A
7,PatternLearningPlayer,216,221,437,18,27,PatternLearningPlayer
8,PatternLearningPlayer,204,224,428,21,31,PatternLearningPlayer
9,PatternLearningPlayer,208,238,446,15,23,PatternLearningPlayer
10,PatternLearningPlayer,282,217,499,38,13,Player A
11,PatternLearningPlayer,224,239,463,26,21,PatternLearningPlayer
12,PatternLearningPlayer,229,224,453,25,24,Player A
13,PatternLearningPlayer,234,214,448,23,25,Player A
14,PatternLearningPlayer,330,195,525,43,6,Player A
15,PatternLearningPlayer,208,238,446,18,24,PatternLearningPlayer
16,PatternLearningPlayer,292,222,514,44,10,Player A
17,PatternLearningPlayer,267,217,484,35,17,Player A
18,PatternLearningPlayer,195,225,420,19,33,PatternLearningPlayer
19,PatternLearningPlayer,292,197,489,37,16,Player A
20,PatternLearningPlayer,259,219,478,32,18,Player A
21,PatternLearningPlayer,238,208,446,30,28,Player A
22,PatternLearningPlayer,211,231,442,20,26,PatternLearningPlayer
23,PatternLearningPlayer,259,219,478,29,17,Player A
24,PatternLearningPlayer,234,219,453,22,23,Player A
25,PatternLearningPlayer,269,209,478,35,19,Player A
26,PatternLearningPlayer,285,195,480,31,17,Player A
27,PatternLearningPlayer,305,205,510,40,10,Player A
28,PatternLearningPlayer,235,205,440,24,28,Player A
29,PatternLearningPlayer,221,216,437,24,29,Player A
30,PatternLearningPlayer,245,225,470,27,19,Player A
31,PatternLearningPlayer,275,205,480,31,17,Player A
32,PatternLearningPlayer,241,211,452,27,25,Player A
33,PatternLearningPlayer,263,218,481,38,19,Player A
34,PatternLearningPlayer,249,209,458,21,21,Player A
35,PatternLearningPlayer,262,212,474,31,19,Player A
36,PatternLearningPlayer,321,201,522,46,8,Player A
37,PatternLearningPlayer,255,215,470,30,20,Player A
38,PatternLearningPlayer,295,215,510,43,11,Player A
39,PatternLearningPlayer,250,190,440,24,28,Player A
40,PatternLearningPlayer,221,196,417,22,35,Player A
41,PatternLearningPlayer,296,211,507,40,11,Player A
42,PatternLearningPlayer,288,188,476,24,16,Player A
43,PatternLearningPlayer,255,245,500,45,15,Player A
44,PatternLearningPlayer,241,216,457,20,21,Player A
45,PatternLearningPlayer,249,209,458,24,22,Player A
46,PatternLearningPlayer,287,207,494,39,15,Player A
47,PatternLearningPlayer,276,191,467,30,21,Player A
48,PatternLearningPlayer,284,199,483,28,15,Player A
49,PatternLearningPlayer,269,219,488,33,15,Player A
50,PatternLearningPlayer,301,221,522,49,9,Player A
51,PatternLearningPlayer,281,226,507,37,10,Player A
52,PatternLearningPlayer,241,211,452,30,26,Player A
53,PatternLearningPlayer,278,198,476,33,19,Player A
54,PatternLearningPlayer,259,199,458,24,22,Player A
55,PatternLearningPlayer,304,194,498,37,13,Player A
56,PatternLearningPlayer,231,221,452,27,25,Player A
57,PatternLearningPlayer,284,199,483,34,17,Player A
58,PatternLearningPlayer,224,214,438,16,26,Player A
59,PatternLearningPlayer,283,193,476,30,18,Player A
60,PatternLearningPlayer,311,206,517,44,9,Player A
61,PatternLearningPlayer,191,211,402,13,37,PatternLearningPlayer
62,PatternLearningPlayer,243,233,476,27,17,Player A
63,PatternLearningPlayer,248,238,486,37,17,Player A
64,PatternLearningPlayer,278,213,491,39,16,Player A
65,PatternLearningPlayer,265,225,490,38,16,Player A
66,PatternLearningPlayer,316,201,517,41,8,Player A
67,PatternLearningPlayer,279,194,473,27,18,Player A
68,PatternLearningPlayer,236,211,447,28,27,Player A
69,PatternLearningPlayer,320,185,505,38,11,Player A
70,PatternLearningPlayer,214,234,448,23,25,PatternLearningPlayer
71,PatternLearningPlayer,325,205,530,45,5,Player A
72,PatternLearningPlayer,242,217,459,22,21,Player A
73,PatternLearningPlayer,331,201,532,53,7,Player A
74,PatternLearningPlayer,193,208,401,18,39,PatternLearningPlayer
75,PatternLearningPlayer,232,227,459,25,22,Player A
76,PatternLearningPlayer,244,214,458,24,22,Player A
77,PatternLearningPlayer,214,224,438,16,26,PatternLearningPlayer
78,PatternLearningPlayer,216,211,427,23,32,Player A
79,PatternLearningPlayer,286,186,472,35,21,Player A
80,PatternLearningPlayer,176,226,402,13,37,PatternLearningPlayer
81,PatternLearningPlayer,213,188,401,21,40,Player A
82,PatternLearningPlayer,271,206,477,34,19,Player A
83,PatternLearningPlayer,277,192,469,35,22,Player A
84,PatternLearningPlayer,242,207,449,21,24,Player A
85,PatternLearningPlayer,230,205,435,25,30,Player A
86,PatternLearningPlayer,270,215,485,33,16,Player A
87,PatternLearningPlayer,254,209,463,29,22,Player A
88,PatternLearningPlayer,263,208,471,31,20,Player A
89,PatternLearningPlayer,244,209,453,31,26,Player A
90,PatternLearningPlayer,316,206,522,52,10,Player A
91,PatternLearningPlayer,280,210,490,32,14,Player A
92,PatternLearningPlayer,211,211,422,15,31,Tie
93,PatternLearningPlayer,271,216,487,35,16,Player A
94,PatternLearningPlayer,279,209,488,36,16,Player A
95,PatternLearningPlayer,264,179,443,27,28,Player A
96,PatternLearningPlayer,353,193,546,55,3,Player A
97,PatternLearningPlayer,300,220,520,44,8,Player A
98,PatternLearningPlayer,282,207,489,34,15,Player A
99,PatternLearningPlayer,246,221,467,30,21,Player A
100,PatternLearningPlayer,255,210,465,28,21,Player A
101,PatternLearningPlayer,262,222,484,23,13,Player A
102,PatternLearningPlayer,259,219,478,26,16,Player A
103,PatternLearningPlayer,245,210,455,27,24,Player A
104,PatternLearningPlayer,210,225,435,22,29,PatternLearningPlayer
105,PatternLearningPlayer,223,218,441,16,25,Player A
106,PatternLearningPlayer,244,204,448,26,26,Player A
107,PatternLearningPlayer,277,192,469,32,21,Player A
108,PatternLearningPlayer,224,224,448,20,24,Tie
109,PatternLearningPlayer,242,222,464,24,20,Player A
110,PatternLearningPlayer,304,219,523,47,8,Player A
111,PatternLearningPlayer,311,221,532,50,6,Player A
112,PatternLearningPlayer,249,219,468,28,20,Player A
113,PatternLearningPlayer,250,200,450,25,25,Player A
114,PatternLearningPlayer,210,220,430,20,30,PatternLearningPlayer
115,PatternLearningPlayer,152,222,374,12,46,PatternLearningPlayer
116,PatternLearningPlayer,222,242,464,21,19,PatternLearningPlayer
117,PatternLearningPlayer,308,178,486,37,17,Player A
118,PatternLearningPlayer,241,216,457,26,23,Player A
119,PatternLearningPlayer,218,223,441,13,24,PatternLearningPlayer
120,PatternLearningPlayer,348,193,541,50,3,Player A
121,PatternLearningPlayer,233,193,426,25,33,Player A
122,PatternLearningPlayer,219,214,433,20,29,Player A
123,PatternLearningPlayer,300,185,485,39,18,Player A
124,PatternLearningPlayer,250,205,455,24,23,Player A
125,PatternLearningPlayer,242,217,459,22,21,Player A
126,PatternLearningPlayer,245,215,460,29,23,Player A
127,PatternLearningPlayer,238,213,451,26,25,Player A
128,PatternLearningPlayer,206,221,427,17,30,PatternLearningPlayer
129,PatternLearningPlayer,276,206,482,27,15,Player A
130,PatternLearningPlayer,316,191,507,40,11,Player A
131,PatternLearningPlayer,296,211,507,34,9,Player A
132,PatternLearningPlayer,227,212,439,17,26,Player A
133,PatternLearningPlayer,273,208,481,29,16,Player A
134,PatternLearningPlayer,245,230,475,26,17,Player A
135,PatternLearningPlayer,238,213,451,23,24,Player A
136,PatternLearningPlayer,276,221,497,39,14,Player A
137,PatternLearningPlayer,263,208,471,31,20,Player A
138,PatternLearningPlayer,279,194,473,33,20,Player A
139,PatternLearningPlayer,268,223,491,27,12,Player A
140,PatternLearningPlayer,329,209,538,47,3,Player A
141,PatternLearningPlayer,300,200,500,42,14,Player A
142,PatternLearningPlayer,272,222,494,42,16,Player A
143,PatternLearningPlayer,258,208,466,35,23,Player A
144,PatternLearningPlayer,339,189,528,49,7,Player A
145,PatternLearningPlayer,263,188,451,23,24,Player A
146,PatternLearningPlayer,292,202,494,36,14,Player A
147,PatternLearningPlayer,151,216,367,11,48,PatternLearningPlayer
148,PatternLearningPlayer,211,211,422,21,33,Tie
149,PatternLearningPlayer,193,218,411,19,36,PatternLearningPlayer
150,PatternLearningPlayer,202,242,444,25,27,PatternLearningPlayer
151,PatternLearningPlayer,259,194,453,25,24,Player A
152,PatternLearningPlayer,276,221,497,39,14,Player A
153,PatternLearningPlayer,252,187,439,20,27,Player A
154,PatternLearningPlayer,286,206,492,34,14,Player A
155,PatternLearningPlayer,274,214,488,36,16,Player A
156,PatternLearningPlayer,270,195,465,34,23,Player A
157,PatternLearningPlayer,237,237,474,25,17,Tie
158,PatternLearningPlayer,321,206,527,48,7,Player A
159,PatternLearningPlayer,240,215,455,21,22,Player A
160,PatternLearningPlayer,173,238,411,16,35,PatternLearningPlayer
161,PatternLearningPlayer,286,216,502,44,14,Player A
162,PatternLearningPlayer,297,197,494,30,12,Player A
163,PatternLearningPlayer,201,226,427,17,30,PatternLearningPlayer
164,PatternLearningPlayer,212,192,404,15,37,Player A
165,PatternLearningPlayer,250,210,460,26,22,Player A
166,PatternLearningPlayer,246,206,452,21,23,Player A
167,PatternLearningPlayer,277,197,474,31,19,Player A
168,PatternLearningPlayer,261,211,472,35,21,Player A
169,PatternLearningPlayer,194,219,413,15,34,PatternLearningPlayer
170,PatternLearningPlayer,292,202,494,42,16,Player A
171,PatternLearningPlayer,285,210,495,34,13,Player A
172,PatternLearningPlayer,230,210,440,15,25,Player A
173,PatternLearningPlayer,217,207,424,23,33,Player A
174,PatternLearningPlayer,216,226,442,20,26,PatternLearningPlayer
175,PatternLearningPlayer,258,198,456,28,24,Player A
176,PatternLearningPlayer,237,217,454,26,24,Player A
177,PatternLearningPlayer,255,210,465,25,20,Player A
178,PatternLearningPlayer,253,223,476,33,19,Player A
179,PatternLearningPlayer,228,213,441,25,28,Player A
180,PatternLearningPlayer,204,234,438,13,25,PatternLearningPlayer
181,PatternLearningPlayer,203,218,421,14,31,PatternLearningPlayer
182,PatternLearningPlayer,303,213,516,43,9,Player A
183,PatternLearningPlayer,282,197,479,36,19,Player A
184,PatternLearningPlayer,202,207,409,11,34,PatternLearningPlayer
185,PatternLearningPlayer,256,201,457,26,23,Player A
186,PatternLearningPlayer,164,214,378,10,44,PatternLearningPlayer
187,PatternLearningPlayer,213,203,416,15,33,Player A
188,PatternLearningPlayer,230,225,455,24,23,Player A
189,PatternLearningPlayer,278,193,471,34,21,Player A
190,PatternLearningPlayer,254,199,453,28,25,Player A
191,PatternLearningPlayer,347,197,544,56,4,Player A
192,PatternLearningPlayer,308,213,521,45,8,Player A
193,PatternLearningPlayer,276,206,482,33,17,Player A
194,PatternLearningPlayer,269,214,483,34,17,Player A
195,PatternLearningPlayer,212,227,439,20,27,PatternLearningPlayer
196,PatternLearningPlayer,326,206,532,47,5,Player A
197,PatternLearningPlayer,274,209,483,31,16,Player A
198,PatternLearningPlayer,309,199,508,38,10,Player A
199,PatternLearningPlayer,250,200,450,28,26,Player A
200,PatternLearningPlayer,313,198,511,41,10,Player A
201,PatternLearningPlayer,240,205,445,20,25,Player A
202,PatternLearningPlayer,233,218,451,26,25,Player A
203,PatternLearningPlayer,272,222,494,33,13,Player A
204,PatternLearningPlayer,253,218,471,34,21,Player A
205,PatternLearningPlayer,264,224,488,33,15,Player A
206,PatternLearningPlayer,266,216,482,33,17,Player A
207,PatternLearningPlayer,242,202,444,25,27,Player A
208,PatternLearningPlayer,245,210,455,24,23,Player A
209,PatternLearningPlayer,286,196,482,30,16,Player A
210,PatternLearningPlayer,307,212,519,40,7,Player A
211,PatternLearningPlayer,279,194,473,33,20,Player A
212,PatternLearningPlayer,229,209,438,25,29,Player A
213,PatternLearningPlayer,323,178,501,37,12,Player A
214,PatternLearningPlayer,299,204,503,42,13,Player A
215,PatternLearningPlayer,325,185,510,40,10,Player A
216,PatternLearningPlayer,190,225,415,17,34,PatternLearningPlayer
217,PatternLearningPlayer,301,191,492,37,15,Player A
218,PatternLearningPlayer,238,208,446,24,26,Player A
219,PatternLearningPlayer,234,209,443,21,26,Player A
220,PatternLearningPlayer,230,205,435,22,29,Player A
221,PatternLearningPlayer,279,209,488,30,14,Player A
222,PatternLearningPlayer,249,234,483,37,18,Player A
223,PatternLearningPlayer,282,202,484,32,16,Player A
224,PatternLearningPlayer,240,200,440,24,28,Player A
225,PatternLearningPlayer,190,235,425,18,31,PatternLearningPlayer
226,PatternLearningPlayer,281,211,492,43,17,Player A
227,PatternLearningPlayer,310,200,510,43,11,Player A
228,PatternLearningPlayer,276,196,472,35,21,Player A
229,PatternLearningPlayer,264,204,468,28,20,Player A
230,PatternLearningPlayer,203,198,401,15,38,Player A
231,PatternLearningPlayer,278,203,481,29,16,Player A
232,PatternLearningPlayer,256,201,457,23,22,Player A
233,PatternLearningPlayer,271,216,487,32,15,Player A
234,PatternLearningPlayer,254,209,463,23,20,Player A
235,PatternLearningPlayer,241,216,457,29,24,Player A
236,PatternLearningPlayer,267,207,474,19,15,Player A
237,PatternLearningPlayer,263,213,476,30,18,Player A
238,PatternLearningPlayer,278,188,466,26,20,Player A
239,PatternLearningPlayer,309,179,488,30,14,Player A
240,PatternLearningPlayer,284,229,513,43,10,Player A
241,PatternLearningPlayer,266,216,482,30,16,Player A
242,PatternLearningPlayer,228,208,436,26,30,Player A
243,PatternLearningPlayer,239,219,458,30,24,Player A
244,PatternLearningPlayer,261,206,467,24,19,Player A
245,PatternLearningPlayer,305,200,505,44,13,Player A
246,PatternLearningPlayer,255,225,480,34,18,Player A
247,PatternLearningPlayer,243,203,446,21,25,Player A
248,PatternLearningPlayer,243,223,466,29,21,Player A
249,PatternLearningPlayer,235,220,455,27,24,Player A
250,PatternLearningPlayer,242,237,479,33,18,Player A
251,PatternLearningPlayer,213,233,446,21,25,PatternLearningPlayer
252,PatternLearningPlayer,313,203,516,43,9,Player A
253,PatternLearningPlayer,283,218,501,40,13,Player A
254,PatternLearningPlayer,233,203,436,20,28,Player A
255,PatternLearningPlayer,271,221,492,37,15,Player A
256,PatternLearningPlayer,292,197,489,37,16,Player A
257,PatternLearningPlayer,243,203,446,27,27,Player A
258,PatternLearningPlayer,248,208,456,28,24,Player A
259,PatternLearningPlayer,252,222,474,34,20,Player A
260,PatternLearningPlayer,240,205,445,23,26,Player A
261,PatternLearningPlayer,231,216,447,25,26,Player A
262,PatternLearningPlayer,261,211,472,29,19,Player A
263,PatternLearningPlayer,274,209,483,37,18,Player A
264,PatternLearningPlayer,295,190,485,33,16,Player A
265,PatternLearningPlayer,289,199,488,39,17,Player A
266,PatternLearningPlayer,327,182,509,33,8,Player A
267,PatternLearningPlayer,264,219,483,34,17,Player A
268,PatternLearningPlayer,307,222,529,44,5,Player A
269,PatternLearningPlayer,342,167,509,39,10,Player A
270,PatternLearningPlayer,276,196,472,29,19,Player A
271,PatternLearningPlayer,218,213,431,24,31,Player A
272,PatternLearningPlayer,262,187,449,24,25,Player A
273,PatternLearningPlayer,255,195,450,25,25,Player A
274,PatternLearningPlayer,252,207,459,28,23,Player A
275,PatternLearningPlayer,302,202,504,40,12,Player A
276,PatternLearningPlayer,276,221,497,30,11,Player A
277,PatternLearningPlayer,257,197,454,32,26,Player A
278,PatternLearningPlayer,252,217,469,26,19,Player A
279,PatternLearningPlayer,218,208,426,22,32,Player A
280,PatternLearningPlayer,236,201,437,24,29,Player A
281,PatternLearningPlayer,237,182,419,18,33,Player A
282,PatternLearningPlayer,302,207,509,42,11,Player A
283,PatternLearningPlayer,289,204,493,38,15,Player A
284,PatternLearningPlayer,231,206,437,24,29,Player A
285,PatternLearningPlayer,251,211,462,22,20,Player A
286,PatternLearningPlayer,251,201,452,27,25,Player A
287,PatternLearningPlayer,261,216,477,37,20,Player A
288,PatternLearningPlayer,218,218,436,20,28,Tie
289,PatternLearningPlayer,257,217,474,28,18,Player A
290,PatternLearningPlayer,324,189,513,43,10,Player A
291,PatternLearningPlayer,221,196,417,19,34,Player A
292,PatternLearningPlayer,279,209,488,39,17,Player A
293,PatternLearningPlayer,207,207,414,16,34,Tie
294,PatternLearningPlayer,285,210,495,34,13,Player A
295,PatternLearningPlayer,278,188,466,26,20,Player A
296,PatternLearningPlayer,253,218,471,31,20,Player A
297,PatternLearningPlayer,269,194,463,29,22,Player A
298,PatternLearningPlayer,326,171,497,33,12,Player A
299,PatternLearningPlayer,289,209,498,34,12,Player A
300,PatternLearningPlayer,266,186,452,27,25,Player A
301,PatternLearningPlayer,211,231,442,20,26,PatternLearningPlayer
302,PatternLearningPlayer,241,216,457,26,23,Player A
303,PatternLearningPlayer,235,215,450,19,23,Player A
304,PatternLearningPlayer,244,209,453,28,25,Player A
305,PatternLearningPlayer,335,195,530,51,7,Player A
306,PatternLearningPlayer,213,228,441,22,27,PatternLearningPlayer
307,PatternLearningPlayer,299,184,483,34,17,Player A
308,PatternLearningPlayer,215,195,410,18,36,Player A
309,PatternLearningPlayer,251,206,457,23,22,Player A
310,PatternLearningPlayer,323,193,516,43,9,Player A
311,PatternLearningPlayer,269,214,483,34,17,Player A
312,PatternLearningPlayer,267,207,474,28,18,Player A
313,PatternLearningPlayer,202,227,429,19,30,PatternLearningPlayer
314,PatternLearningPlayer,215,210,425,21,32,Player A
315,PatternLearningPlayer,293,208,501,40,13,Player A
316,PatternLearningPlayer,217,227,444,28,28,PatternLearningPlayer
317,PatternLearningPlayer,288,203,491,39,16,Player A
318,PatternLearningPlayer,280,195,475,38,21,Player A
319,PatternLearningPlayer,251,206,457,26,23,Player A
320,PatternLearningPlayer,250,215,465,28,21,Player A
321,PatternLearningPlayer,248,213,461,27,22,Player A
322,PatternLearningPlayer,197,212,409,20,37,PatternLearningPlayer
323,PatternLearningPlayer,247,232,479,24,15,Player A
324,PatternLearningPlayer,209,234,443,21,26,PatternLearningPlayer
325,PatternLearningPlayer,274,214,488,33,15,Player A
326,PatternLearningPlayer,281,211,492,31,13,Player A
327,PatternLearningPlayer,326,186,512,39,9,Player A
328,PatternLearningPlayer,238,238,476,33,19,Tie
329,PatternLearningPlayer,251,221,472,29,19,Player A
330,PatternLearningPlayer,241,231,472,35,21,Player A
331,PatternLearningPlayer,262,207,469,29,20,Player A
332,PatternLearningPlayer,301,201,502,35,11,Player A
333,PatternLearningPlayer,341,191,532,50,6,Player A
334,PatternLearningPlayer,205,215,420,16,32,PatternLearningPlayer
335,PatternLearningPlayer,239,214,453,22,23,Player A
336,PatternLearningPlayer,286,206,492,34,14,Player A
337,PatternLearningPlayer,236,216,452,27,25,Player A
338,PatternLearningPlayer,315,195,510,40,10,Player A
339,PatternLearningPlayer,263,208,471,34,21,Player A
340,PatternLearningPlayer,266,201,467,30,21,Player A
341,PatternLearningPlayer,317,187,504,40,12,Player A
342,PatternLearningPlayer,262,202,464,30,22,Player A
343,PatternLearningPlayer,286,211,497,30,11,Player A
344,PatternLearningPlayer,287,187,474,31,19,Player A
345,PatternLearningPlayer,240,205,445,29,28,Player A
346,PatternLearningPlayer,289,214,503,45,14,Player A
347,PatternLearningPlayer,267,207,474,37,21,Player A
348,PatternLearningPlayer,219,209,428,18,30,Player A
349,PatternLearningPlayer,263,203,466,32,22,Player A
350,PatternLearningPlayer,310,205,515,39,8,Player A
351,PatternLearningPlayer,309,189,498,37,13,Player A
352,PatternLearningPlayer,293,208,501,34,11,Player A
353,PatternLearningPlayer,191,206,397,11,38,PatternLearningPlayer
354,PatternLearningPlayer,313,208,521,39,6,Player A
355,PatternLearningPlayer,263,228,491,33,14,Player A
356,PatternLearningPlayer,299,189,488,39,17,Player A
357,PatternLearningPlayer,224,214,438,19,27,Player A
358,PatternLearningPlayer,330,185,515,45,10,Player A
359,PatternLearningPlayer,276,196,472,41,23,Player A
360,PatternLearningPlayer,244,209,453,28,25,Player A
361,PatternLearningPlayer,239,229,468,28,20,Player A
362,PatternLearningPlayer,256,206,462,28,22,Player A
363,PatternLearningPlayer,265,205,470,33,21,Player A
364,PatternLearningPlayer,284,209,493,32,13,Player A
365,PatternLearningPlayer,331,186,517,35,6,Player A
366,PatternLearningPlayer,244,214,458,30,24,Player A
367,PatternLearningPlayer,298,218,516,40,8,Player A
368,PatternLearningPlayer,233,213,446,21,25,Player A
369,PatternLearningPlayer,207,202,409,11,34,Player A
370,PatternLearningPlayer,329,209,538,47,3,Player A
371,PatternLearningPlayer,220,220,440,21,27,Tie
372,PatternLearningPlayer,278,203,481,35,18,Player A
373,PatternLearningPlayer,251,201,452,18,22,Player A
374,PatternLearningPlayer,250,220,470,33,21,Player A
375,PatternLearningPlayer,255,205,460,32,24,Player A
376,PatternLearningPlayer,183,188,371,15,48,PatternLearningPlayer
377,PatternLearningPlayer,230,220,450,22,24,Player A
378,PatternLearningPlayer,277,207,484,38,18,Player A
379,PatternLearningPlayer,212,227,439,23,28,PatternLearningPlayer
380,PatternLearningPlayer,238,233,471,25,18,Player A
381,PatternLearningPlayer,337,197,534,46,4,Player A
382,PatternLearningPlayer,272,212,484,32,16,Player A
383,PatternLearningPlayer,276,191,467,33,22,Player A
384,PatternLearningPlayer,301,206,507,43,12,Player A
385,PatternLearningPlayer,278,208,486,37,17,Player A
386,PatternLearningPlayer,300,185,485,36,17,Player A
387,PatternLearningPlayer,241,216,457,29,24,Player A
388,PatternLearningPlayer,268,218,486,37,17,Player A
389,PatternLearningPlayer,233,238,471,25,18,PatternLearningPlayer
390,PatternLearningPlayer,291,206,497,33,12,Player A
391,PatternLearningPlayer,247,202,449,27,26,Player A
392,PatternLearningPlayer,306,201,507,37,10,Player A
393,PatternLearningPlayer,258,228,486,37,17,Player A
394,PatternLearningPlayer,300,210,510,37,9,Player A
395,PatternLearningPlayer,297,197,494,45,17,Player A
396,PatternLearningPlayer,220,225,445,17,24,PatternLearningPlayer
397,PatternLearningPlayer,248,203,451,23,24,Player A
398,PatternLearningPlayer,179,229,408,19,37,PatternLearningPlayer
399,PatternLearningPlayer,298,198,496,41,15,Player A
400,PatternLearningPlayer,259,209,468,40,24,Player A
401,PatternLearningPlayer,180,235,415,11,32,PatternLearningPlayer
402,PatternLearningPlayer,230,200,430,26,32,Player A
403,PatternLearningPlayer,305,210,515,42,9,Player A
404,PatternLearningPlayer,288,218,506,39,11,Player A
405,PatternLearningPlayer,253,223,476,33,19,Player A
406,PatternLearningPlayer,286,201,487,29,14,Player A
407,PatternLearningPlayer,278,223,501,37,12,Player A
408,PatternLearningPlayer,302,197,499,38,13,Player A
409,PatternLearningPlayer,239,239,478,32,18,Tie
410,PatternLearningPlayer,267,212,479,33,18,Player A
411,PatternLearningPlayer,274,199,473,33,20,Player A
412,PatternLearningPlayer,216,216,432,19,29,Tie
413,PatternLearningPlayer,285,200,485,33,16,Player A
414,PatternLearningPlayer,260,205,465,28,21,Player A
415,PatternLearningPlayer,284,219,503,45,14,Player A
416,PatternLearningPlayer,218,213,431,24,31,Player A
417,PatternLearningPlayer,233,223,456,25,23,Player A
418,PatternLearningPlayer,292,217,509,42,11,Player A
419,PatternLearningPlayer,303,203,506,39,11,Player A
420,PatternLearningPlayer,226,206,432,19,29,Player A
421,PatternLearningPlayer,284,204,488,39,17,Player A
422,PatternLearningPlayer,261,201,462,28,22,Player A
423,PatternLearningPlayer,230,215,445,20,25,Player A
424,PatternLearningPlayer,288,183,471,34,21,Player A
425,PatternLearningPlayer,274,204,478,26,16,Player A
426,PatternLearningPlayer,311,211,522,43,7,Player A
427,PatternLearningPlayer,233,208,441,25,28,Player A
428,PatternLearningPlayer,288,223,511,38,9,Player A
429,PatternLearningPlayer,193,213,406,14,36,PatternLearningPlayer
430,PatternLearningPlayer,231,211,442,20,26,Player A
431,PatternLearningPlayer,291,211,502,32,10,Player A
432,PatternLearningPlayer,231,206,437,21,28,Player A
433,PatternLearningPlayer,237,187,424,23,33,Player A
434,PatternLearningPlayer,289,194,483,34,17,Player A
435,PatternLearningPlayer,272,192,464,30,22,Player A
436,PatternLearningPlayer,304,194,498,31,11,Player A
437,PatternLearningPlayer,294,184,478,32,18,Player A
438,PatternLearningPlayer,204,209,413,15,34,PatternLearningPlayer
439,PatternLearningPlayer,306,201,507,40,11,Player A
440,PatternLearningPlayer,216,226,442,29,29,PatternLearningPlayer
441,PatternLearningPlayer,254,214,468,31,21,Player A
442,PatternLearningPlayer,237,197,434,21,29,Player A
443,PatternLearningPlayer,285,185,470,33,21,Player A
444,PatternLearningPlayer,215,220,435,19,28,PatternLearningPlayer
445,PatternLearningPlayer,259,214,473,33,20,Player A
446,PatternLearningPlayer,210,225,435,19,28,PatternLearningPlayer
447,PatternLearningPlayer,277,197,474,28,18,Player A
448,PatternLearningPlayer,270,205,475,26,17,Player A
449,PatternLearningPlayer,294,194,488,36,16,Player A
450,PatternLearningPlayer,253,228,481,35,18,Player A
451,PatternLearningPlayer,279,229,508,41,11,Player A
452,PatternLearningPlayer,224,229,453,28,25,PatternLearningPlayer
453,PatternLearningPlayer,225,215,440,30,30,Player A
454,PatternLearningPlayer,190,220,410,12,34,PatternLearningPlayer
455,PatternLearningPlayer,311,201,512,42,10,Player A
456,PatternLearningPlayer,314,199,513,37,8,Player A
457,PatternLearningPlayer,249,214,463,26,21,Player A
458,PatternLearningPlayer,275,215,490,35,15,Player A
459,PatternLearningPlayer,231,206,437,24,29,Player A
460,PatternLearningPlayer,262,207,469,32,21,Player A
461,PatternLearningPlayer,306,186,492,37,15,Player A
462,PatternLearningPlayer,261,211,472,29,19,Player A
463,PatternLearningPlayer,188,218,406,14,36,PatternLearningPlayer
464,PatternLearningPlayer,298,178,476,33,19,Player A
465,PatternLearningPlayer,253,203,456,28,24,Player A
466,PatternLearningPlayer,248,208,456,28,24,Player A
467,PatternLearningPlayer,228,208,436,17,27,Player A
468,PatternLearningPlayer,326,201,527,54,9,Player A
469,PatternLearningPlayer,249,214,463,32,23,Player A
470,PatternLearningPlayer,306,206,512,48,12,Player A
471,PatternLearningPlayer,253,233,486,31,15,Player A
472,PatternLearningPlayer,305,205,510,43,11,Player A
473,PatternLearningPlayer,238,228,466,32,22,Player A
474,PatternLearningPlayer,252,202,454,23,23,Player A
475,PatternLearningPlayer,274,199,473,30,19,Player A
476,PatternLearningPlayer,218,218,436,23,29,Tie
477,PatternLearningPlayer,242,197,439,23,28,Player A
478,PatternLearningPlayer,212,217,429,22,31,PatternLearningPlayer
479,PatternLearningPlayer,239,209,448,32,28,Player A
480,PatternLearningPlayer,313,208,521,42,7,Player A
481,PatternLearningPlayer,264,204,468,28,20,Player A
482,PatternLearningPlayer,303,193,496,35,13,Player A
483,PatternLearningPlayer,302,202,504,43,13,Player A
484,PatternLearningPlayer,185,230,415,17,34,PatternLearningPlayer
485,PatternLearningPlayer,308,193,501,34,11,Player A
486,PatternLearningPlayer,268,193,461,30,23,Player A
487,PatternLearningPlayer,280,195,475,35,20,Player A
488,PatternLearningPlayer,216,191,407,15,36,Player A
489,PatternLearningPlayer,211,216,427,23,32,PatternLearningPlayer
490,PatternLearningPlayer,297,207,504,31,9,Player A
491,PatternLearningPlayer,284,219,503,42,13,Player A
492,PatternLearningPlayer,290,210,500,39,13,Player A
493,PatternLearningPlayer,260,190,450,25,25,Player A
494,PatternLearningPlayer,256,206,462,28,22,Player A
495,PatternLearningPlayer,337,202,539,51,4,Player A
496,PatternLearningPlayer,221,196,417,16,33,Player A
497,PatternLearningPlayer,271,191,462,22,20,Player A
498,PatternLearningPlayer,308,208,516,34,6,Player A
499,PatternLearningPlayer,220,250,470,30,20,PatternLearningPlayer
500,PatternLearningPlayer,248,233,481,29,16,Player A
501,PatternLearningPlayer,244,229,473,33,20,Player A
502,PatternLearningPlayer,284,189,473,30,19,Player A
503,PatternLearningPlayer,293,193,486,40,18,Player A
504,PatternLearningPlayer,276,216,492,28,12,Player A
505,PatternLearningPlayer,270,210,480,40,20,Player A
506,PatternLearningPlayer,255,220,475,38,21,Player A
507,PatternLearningPlayer,311,206,517,47,10,Player A
508,PatternLearningPlayer,205,235,440,18,26,PatternLearningPlayer
509,PatternLearningPlayer,224,204,428,21,31,Player A
510,PatternLearningPlayer,275,220,495,34,13,Player A
511,PatternLearningPlayer,323,203,526,47,7,Player A
512,PatternLearningPlayer,230,235,465,25,20,PatternLearningPlayer
513,PatternLearningPlayer,239,199,438,34,32,Player A
514,PatternLearningPlayer,274,214,488,30,14,Player A
515,PatternLearningPlayer,276,206,482,33,17,Player A
516,PatternLearningPlayer,261,186,447,31,28,Player A
517,PatternLearningPlayer,224,214,438,19,27,Player A
518,PatternLearningPlayer,291,206,497,33,12,Player A
519,PatternLearningPlayer,210,205,415,14,33,Player A
520,PatternLearningPlayer,247,217,464,24,20,Player A
521,PatternLearningPlayer,221,216,437,18,27,Player A
522,PatternLearningPlayer,210,230,440,21,27,PatternLearningPlayer
523,PatternLearningPlayer,280,190,470,27,19,Player A
524,PatternLearningPlayer,294,194,488,36,16,Player A
525,PatternLearningPlayer,257,202,459,31,24,Player A
526,PatternLearningPlayer,264,224,488,33,15,Player A
527,PatternLearningPlayer,259,214,473,30,19,Player A
528,PatternLearningPlayer,236,181,417,22,35,Player A
529,PatternLearningPlayer,219,214,433,20,29,Player A
530,PatternLearningPlayer,239,219,458,30,24,Player A
531,PatternLearningPlayer,326,191,517,38,7,Player A
532,PatternLearningPlayer,287,192,479,30,17,Player A
533,PatternLearningPlayer,284,199,483,28,15,Player A
534,PatternLearningPlayer,232,207,439,26,29,Player A
535,PatternLearningPlayer,254,214,468,25,19,Player A
536,PatternLearningPlayer,263,223,486,34,16,Player A
537,PatternLearningPlayer,304,204,508,44,12,Player A
538,PatternLearningPlayer,269,204,473,27,18,Player A
539,PatternLearningPlayer,332,197,529,44,5,Player A
540,PatternLearningPlayer,298,203,501,43,14,Player A
541,PatternLearningPlayer,283,218,501,40,13,Player A
542,PatternLearningPlayer,205,220,425,18,31,PatternLearningPlayer
543,PatternLearningPlayer,256,206,462,31,23,Player A
544,PatternLearningPlayer,259,209,468,25,19,Player A
545,PatternLearningPlayer,211,211,422,18,32,Tie
546,PatternLearningPlayer,243,218,461,21,20,Player A
547,PatternLearningPlayer,276,201,477,37,20,Player A
548,PatternLearningPlayer,289,199,488,36,16,Player A
549,PatternLearningPlayer,245,205,450,25,25,Player A
550,PatternLearningPlayer,310,185,495,40,15,Player A
551,PatternLearningPlayer,307,192,499,47,16,Player A
552,PatternLearningPlayer,270,210,480,28,16,Player A
553,PatternLearningPlayer,277,192,469,32,21,Player A
554,PatternLearningPlayer,236,216,452,24,24,Player A
555,PatternLearningPlayer,248,233,481,38,19,Player A
556,PatternLearningPlayer,261,211,472,29,19,Player A
557,PatternLearningPlayer,275,230,505,47,14,Player A
558,PatternLearningPlayer,287,207,494,39,15,Player A
559,PatternLearningPlayer,187,242,429,16,29,PatternLearningPlayer
560,PatternLearningPlayer,255,200,455,27,24,Player A
561,PatternLearningPlayer,272,212,484,41,19,Player A
562,PatternLearningPlayer,316,196,512,45,11,Player A
563,PatternLearningPlayer,241,211,452,21,23,Player A
564,PatternLearningPlayer,285,225,510,43,11,Player A
565,PatternLearningPlayer,239,224,463,26,21,Player A
566,PatternLearningPlayer,222,202,424,20,32,Player A
567,PatternLearningPlayer,304,179,483,28,15,Player A
568,PatternLearningPlayer,289,189,478,26,16,Player A
569,PatternLearningPlayer,230,215,445,26,27,Player A
570,PatternLearningPlayer,266,226,492,28,12,Player A
571,PatternLearningPlayer,227,222,449,27,26,Player A
572,PatternLearningPlayer,232,202,434,27,31,Player A
573,PatternLearningPlayer,308,188,496,41,15,Player A
574,PatternLearningPlayer,228,228,456,19,21,Tie
575,PatternLearningPlayer,249,214,463,29,22,Player A
576,PatternLearningPlayer,311,196,507,46,13,Player A
577,PatternLearningPlayer,249,214,463,32,23,Player A
578,PatternLearningPlayer,286,201,487,38,17,Player A
579,PatternLearningPlayer,267,217,484,32,16,Player A
580,PatternLearningPlayer,209,209,418,20,34,Tie
581,PatternLearningPlayer,243,203,446,24,26,Player A
582,PatternLearningPlayer,218,193,411,22,37,Player A
583,PatternLearningPlayer,231,226,457,23,22,Player A
584,PatternLearningPlayer,289,214,503,36,11,Player A
585,PatternLearningPlayer,251,221,472,29,19,Player A
586,PatternLearningPlayer,260,220,480,34,18,Player A
587,PatternLearningPlayer,183,238,421,17,32,PatternLearningPlayer
588,PatternLearningPlayer,281,201,482,30,16,Player A
589,PatternLearningPlayer,309,194,503,39,12,Player A
590,PatternLearningPlayer,246,211,457,26,23,Player A
591,PatternLearningPlayer,143,238,381,4,41,PatternLearningPlayer
592,PatternLearningPlayer,242,187,429,22,31,Player A
593,PatternLearningPlayer,200,220,420,22,34,PatternLearningPlayer
594,PatternLearningPlayer,278,193,471,25,18,Player A
595,PatternLearningPlayer,297,197,494,36,14,Player A
596,PatternLearningPlayer,262,217,479,30,17,Player A
597,PatternLearningPlayer,267,212,479,36,19,Player A
598,PatternLearningPlayer,299,194,493,38,15,Player A
599,PatternLearningPlayer,236,211,447,28,27,Player A
600,PatternLearningPlayer,252,217,469,26,19,Player A
601,PatternLearningPlayer,257,212,469,32,21,Player A
602,PatternLearningPlayer,199,239,438,19,27,PatternLearningPlayer
603,PatternLearningPlayer,209,234,443,24,27,PatternLearningPlayer
604,PatternLearningPlayer,279,214,493,41,16,Player A
605,PatternLearningPlayer,298,203,501,40,13,Player A
606,PatternLearningPlayer,227,217,444,22,26,Player A
607,PatternLearningPlayer,259,219,478,35,19,Player A
608,PatternLearningPlayer,193,233,426,13,29,PatternLearningPlayer
609,PatternLearningPlayer,214,229,443,21,26,PatternLearningPlayer
610,PatternLearningPlayer,299,199,498,34,12,Player A
611,PatternLearningPlayer,279,209,488,30,14,Player A
612,PatternLearningPlayer,279,199,478,26,16,Player A
613,PatternLearningPlayer,234,209,443,21,26,Player A
614,PatternLearningPlayer,297,202,499,35,12,Player A
615,PatternLearningPlayer,257,207,464,30,22,Player A
616,PatternLearningPlayer,266,201,467,30,21,Player A
617,PatternLearningPlayer,304,204,508,44,12,Player A
618,PatternLearningPlayer,306,206,512,42,10,Player A
619,PatternLearningPlayer,261,211,472,26,18,Player A
620,PatternLearningPlayer,280,220,500,42,14,Player A
621,PatternLearningPlayer,207,212,419,15,32,PatternLearningPlayer
622,PatternLearningPlayer,313,198,511,44,11,Player A
623,PatternLearningPlayer,253,228,481,26,15,Player A
624,PatternLearningPlayer,289,214,503,36,11,Player A
625,PatternLearningPlayer,270,200,470,27,19,Player A
626,PatternLearningPlayer,335,205,540,49,3,Player A
627,PatternLearningPlayer,241,211,452,27,25,Player A
628,PatternLearningPlayer,318,198,516,37,7,Player A
629,PatternLearningPlayer,268,218,486,28,14,Player A
630,PatternLearningPlayer,208,223,431,18,29,PatternLearningPlayer
631,PatternLearningPlayer,272,202,474,31,19,Player A
632,PatternLearningPlayer,335,210,545,51,2,Player A
633,PatternLearningPlayer,292,202,494,36,14,Player A
634,PatternLearningPlayer,214,209,423,19,32,Player A
635,PatternLearningPlayer,301,226,527,48,7,Player A
636,PatternLearningPlayer,256,191,447,22,25,Player A
637,PatternLearningPlayer,211,211,422,12,30,Tie
638,PatternLearningPlayer,246,201,447,25,26,Player A
639,PatternLearningPlayer,285,215,500,45,15,Player A
640,PatternLearningPlayer,241,216,457,23,22,Player A
641,PatternLearningPlayer,258,203,461,30,23,Player A
642,PatternLearningPlayer,190,215,405,13,36,PatternLearningPlayer
643,PatternLearningPlayer,346,186,532,50,6,Player A
644,PatternLearningPlayer,316,206,522,46,8,Player A
645,PatternLearningPlayer,229,219,448,23,25,Player A
646,PatternLearningPlayer,262,212,474,34,20,Player A
647,PatternLearningPlayer,201,211,412,17,35,PatternLearningPlayer
648,PatternLearningPlayer,194,229,423,19,32,PatternLearningPlayer
649,PatternLearningPlayer,258,208,466,32,22,Player A
650,PatternLearningPlayer,276,211,487,29,14,Player A
651,PatternLearningPlayer,310,210,520,47,9,Player A
652,PatternLearningPlayer,298,178,476,30,18,Player A
653,PatternLearningPlayer,297,212,509,42,11,Player A
654,PatternLearningPlayer,226,221,447,25,26,Player A
655,PatternLearningPlayer,323,203,526,47,7,Player A
656,PatternLearningPlayer,254,214,468,31,21,Player A
657,PatternLearningPlayer,260,215,475,29,18,Player A
658,PatternLearningPlayer,284,204,488,36,16,Player A
659,PatternLearningPlayer,316,196,512,45,11,Player A
660,PatternLearningPlayer,256,211,467,30,21,Player A
661,PatternLearningPlayer,257,207,464,27,21,Player A
662,PatternLearningPlayer,298,198,496,44,16,Player A
663,PatternLearningPlayer,282,187,469,23,18,Player A
664,PatternLearningPlayer,241,211,452,18,22,Player A
665,PatternLearningPlayer,235,210,445,26,27,Player A
666,PatternLearningPlayer,240,220,460,26,22,Player A
667,PatternLearningPlayer,321,196,517,44,9,Player A
668,PatternLearningPlayer,222,192,414,13,33,Player A
669,PatternLearningPlayer,268,198,466,23,19,Player A
670,PatternLearningPlayer,198,243,441,22,27,PatternLearningPlayer
671,PatternLearningPlayer,209,219,428,15,29,PatternLearningPlayer
672,PatternLearningPlayer,306,211,517,50,11,Player A
673,PatternLearningPlayer,234,229,463,29,22,Player A
674,PatternLearningPlayer,308,198,506,36,10,Player A
675,PatternLearningPlayer,282,202,484,32,16,Player A
676,PatternLearningPlayer,250,230,480,28,16,Player A
677,PatternLearningPlayer,316,201,517,44,9,Player A
678,PatternLearningPlayer,254,219,473,36,21,Player A
679,PatternLearningPlayer,250,215,465,25,20,Player A
680,PatternLearningPlayer,236,211,447,25,26,Player A
681,PatternLearningPlayer,293,203,496,41,15,Player A
682,PatternLearningPlayer,292,202,494,36,14,Player A
683,PatternLearningPlayer,240,210,450,22,24,Player A
684,PatternLearningPlayer,282,217,499,35,12,Player A
685,PatternLearningPlayer,303,208,511,41,10,Player A
686,PatternLearningPlayer,286,206,492,37,15,Player A
687,PatternLearningPlayer,243,233,476,36,20,Player A
688,PatternLearningPlayer,209,204,413,18,35,Player A
689,PatternLearningPlayer,286,206,492,34,14,Player A
690,PatternLearningPlayer,360,190,550,56,2,Player A
691,PatternLearningPlayer,253,228,481,29,16,Player A
692,PatternLearningPlayer,358,188,546,52,2,Player A
693,PatternLearningPlayer,214,224,438,25,29,PatternLearningPlayer
694,PatternLearningPlayer,262,217,479,36,19,Player A
695,PatternLearningPlayer,229,219,448,26,26,Player A
696,PatternLearningPlayer,258,213,471,31,20,Player A
697,PatternLearningPlayer,249,219,468,28,20,Player A
698,PatternLearningPlayer,223,203,426,19,31,Player A
699,PatternLearningPlayer,252,207,459,28,23,Player A
700,PatternLearningPlayer,258,203,461,30,23,Player A
701,PatternLearningPlayer,312,202,514,41,9,Player A
702,PatternLearningPlayer,247,227,474,28,18,Player A
703,PatternLearningPlayer,320,200,520,44,8,Player A
704,PatternLearningPlayer,253,213,466,29,21,Player A
705,PatternLearningPlayer,245,205,450,25,25,Player A
706,PatternLearningPlayer,253,213,466,29,21,Player A
707,PatternLearningPlayer,280,200,480,28,16,Player A
708,PatternLearningPlayer,220,205,425,15,30,Player A
709,PatternLearningPlayer,214,239,453,22,23,PatternLearningPlayer
710,PatternLearningPlayer,241,221,462,25,21,Player A
711,PatternLearningPlayer,218,223,441,22,27,PatternLearningPlayer
712,PatternLearningPlayer,282,227,509,36,9,Player A
713,PatternLearningPlayer,237,237,474,31,19,Tie
714,PatternLearningPlayer,261,216,477,34,19,Player A
715,PatternLearningPlayer,297,202,499,38,13,Player A
716,PatternLearningPlayer,259,229,488,39,17,Player A
717,PatternLearningPlayer,250,205,455,27,24,Player A
718,PatternLearningPlayer,208,203,411,16,35,Player A
719,PatternLearningPlayer,269,204,473,24,17,Player A
720,PatternLearningPlayer,188,218,406,14,36,PatternLearningPlayer
721,PatternLearningPlayer,260,195,455,24,23,Player A
722,PatternLearningPlayer,205,240,445,20,25,PatternLearningPlayer
723,PatternLearningPlayer,214,224,438,25,29,PatternLearningPlayer
724,PatternLearningPlayer,257,202,459,28,23,Player A
725,PatternLearningPlayer,256,206,462,28,22,Player A
726,PatternLearningPlayer,291,206,497,33,12,Player A
727,PatternLearningPlayer,274,204,478,32,18,Player A
728,PatternLearningPlayer,245,210,455,24,23,Player A
729,PatternLearningPlayer,228,208,436,23,29,Player A
730,PatternLearningPlayer,210,240,450,19,23,PatternLearningPlayer
731,PatternLearningPlayer,329,194,523,47,8,Player A
732,PatternLearningPlayer,284,219,503,39,12,Player A
733,PatternLearningPlayer,243,188,431,21,30,Player A
734,PatternLearningPlayer,324,189,513,40,9,Player A
735,PatternLearningPlayer,259,209,468,28,20,Player A
736,PatternLearningPlayer,254,209,463,23,20,Player A
737,PatternLearningPlayer,207,232,439,17,26,PatternLearningPlayer
738,PatternLearningPlayer,189,229,418,14,32,PatternLearningPlayer
739,PatternLearningPlayer,262,232,494,36,14,Player A
740,PatternLearningPlayer,259,224,483,37,18,Player A
741,PatternLearningPlayer,306,206,512,39,9,Player A
742,PatternLearningPlayer,214,224,438,19,27,PatternLearningPlayer
743,PatternLearningPlayer,258,193,451,23,24,Player A
744,PatternLearningPlayer,223,233,456,22,22,PatternLearningPlayer
745,PatternLearningPlayer,242,197,439,20,27,Player A
746,PatternLearningPlayer,266,211,477,34,19,Player A
747,PatternLearningPlayer,232,192,424,20,32,Player A
748,PatternLearningPlayer,286,221,507,40,11,Player A
749,PatternLearningPlayer,250,220,470,42,24,Player A
750,PatternLearningPlayer,289,199,488,39,17,Player A
751,PatternLearningPlayer,239,209,448,20,24,Player A
752,PatternLearningPlayer,254,214,468,31,21,Player A
753,PatternLearningPlayer,235,210,445,23,26,Player A
754,PatternLearningPlayer,240,225,465,28,21,Player A
755,PatternLearningPlayer,269,194,463,26,21,Player A
756,PatternLearningPlayer,278,208,486,28,14,Player A
757,PatternLearningPlayer,275,195,470,27,19,Player A
758,PatternLearningPlayer,271,206,477,31,18,Player A
759,PatternLearningPlayer,230,215,445,23,26,Player A
760,PatternLearningPlayer,283,208,491,39,16,Player A
761,PatternLearningPlayer,270,215,485,36,17,Player A
762,PatternLearningPlayer,237,217,454,20,22,Player A
763,PatternLearningPlayer,231,211,442,23,27,Player A
764,PatternLearningPlayer,219,224,443,21,26,PatternLearningPlayer
765,PatternLearningPlayer,315,195,510,40,10,Player A
766,PatternLearningPlayer,262,227,489,34,15,Player A
767,PatternLearningPlayer,262,217,479,33,18,Player A
768,PatternLearningPlayer,268,198,466,35,23,Player A
769,PatternLearningPlayer,206,231,437,18,27,PatternLearningPlayer
770,PatternLearningPlayer,252,222,474,37,21,Player A
771,PatternLearningPlayer,260,215,475,32,19,Player A
772,PatternLearningPlayer,311,206,517,41,8,Player A
773,PatternLearningPlayer,235,230,465,37,24,Player A
774,PatternLearningPlayer,291,201,492,37,15,Player A
775,PatternLearningPlayer,259,214,473,27,18,Player A
776,PatternLearningPlayer,250,200,450,25,25,Player A
777,PatternLearningPlayer,231,231,462,19,19,Tie
778,PatternLearningPlayer,262,207,469,35,22,Player A
779,PatternLearningPlayer,250,210,460,29,23,Player A
780,PatternLearningPlayer,197,242,439,20,27,PatternLearningPlayer
781,PatternLearningPlayer,320,195,515,45,10,Player A
782,PatternLearningPlayer,278,213,491,39,16,Player A
783,PatternLearningPlayer,296,211,507,46,13,Player A
784,PatternLearningPlayer,209,214,423,19,32,PatternLearningPlayer
785,PatternLearningPlayer,310,200,510,34,8,Player A
786,PatternLearningPlayer,271,216,487,35,16,Player A
787,PatternLearningPlayer,239,199,438,22,28,Player A
788,PatternLearningPlayer,238,223,461,27,22,Player A
789,PatternLearningPlayer,322,197,519,40,7,Player A
790,PatternLearningPlayer,248,213,461,30,23,Player A
791,PatternLearningPlayer,265,210,475,23,16,Player A
792,PatternLearningPlayer,263,223,486,34,16,Player A
793,PatternLearningPlayer,287,197,484,29,15,Player A
794,PatternLearningPlayer,257,207,464,30,22,Player A
795,PatternLearningPlayer,253,203,456,34,26,Player A
796,PatternLearningPlayer,260,210,470,30,20,Player A
797,PatternLearningPlayer,304,194,498,37,13,Player A
798,PatternLearningPlayer,236,216,452,27,25,Player A
799,PatternLearningPlayer,226,196,422,18,32,Player A
800,PatternLearningPlayer,216,186,402,19,39,Player A
801,PatternLearningPlayer,266,216,482,27,15,Player A
802,PatternLearningPlayer,324,194,518,42,8,Player A
803,PatternLearningPlayer,309,199,508,38,10,Player A
804,PatternLearningPlayer,253,218,471,25,18,Player A
805,PatternLearningPlayer,266,206,472,32,20,Player A
806,PatternLearningPlayer,288,198,486,34,16,Player A
807,PatternLearningPlayer,215,215,430,20,30,Tie
808,PatternLearningPlayer,285,190,475,32,19,Player A
809,PatternLearningPlayer,243,208,451,26,25,Player A
810,PatternLearningPlayer,251,206,457,23,22,Player A
811,PatternLearningPlayer,337,192,529,47,6,Player A
812,PatternLearningPlayer,284,199,483,31,16,Player A
813,PatternLearningPlayer,206,231,437,21,28,PatternLearningPlayer
814,PatternLearningPlayer,236,211,447,22,25,Player A
815,PatternLearningPlayer,339,209,548,57,3,Player A
816,PatternLearningPlayer,213,223,436,20,28,PatternLearningPlayer
817,PatternLearningPlayer,297,197,494,42,16,Player A
818,PatternLearningPlayer,211,226,437,21,28,PatternLearningPlayer
819,PatternLearningPlayer,274,184,458,27,23,Player A
820,PatternLearningPlayer,259,184,443,24,27,Player A
821,PatternLearningPlayer,228,218,446,27,27,Player A
822,PatternLearningPlayer,277,202,479,36,19,Player A
823,PatternLearningPlayer,264,189,453,19,22,Player A
824,PatternLearningPlayer,261,206,467,24,19,Player A
825,PatternLearningPlayer,257,217,474,28,18,Player A
826,PatternLearningPlayer,290,190,480,31,17,Player A
827,PatternLearningPlayer,226,211,437,24,29,Player A
828,PatternLearningPlayer,274,214,488,30,14,Player A
829,PatternLearningPlayer,321,211,532,44,4,Player A
830,PatternLearningPlayer,331,196,527,45,6,Player A
831,PatternLearningPlayer,211,216,427,11,28,PatternLearningPlayer
832,PatternLearningPlayer,263,213,476,27,17,Player A
833,PatternLearningPlayer,314,214,528,49,7,Player A
834,PatternLearningPlayer,268,218,486,31,15,Player A
835,PatternLearningPlayer,324,194,518,42,8,Player A
836,PatternLearningPlayer,260,195,455,24,23,Player A
837,PatternLearningPlayer,270,225,495,37,14,Player A
838,PatternLearningPlayer,338,198,536,48,4,Player A
839,PatternLearningPlayer,294,194,488,33,15,Player A
840,PatternLearningPlayer,259,224,483,37,18,Player A
841,PatternLearningPlayer,253,198,451,23,24,Player A
842,PatternLearningPlayer,239,224,463,26,21,Player A
843,PatternLearningPlayer,241,236,477,31,18,Player A
844,PatternLearningPlayer,266,211,477,37,20,Player A
845,PatternLearningPlayer,301,206,507,43,12,Player A
846,PatternLearningPlayer,227,227,454,26,24,Tie
847,PatternLearningPlayer,301,201,502,35,11,Player A
848,PatternLearningPlayer,264,194,458,27,23,Player A
849,PatternLearningPlayer,299,204,503,39,12,Player A
850,PatternLearningPlayer,241,216,457,26,23,Player A
851,PatternLearningPlayer,241,206,447,25,26,Player A
852,PatternLearningPlayer,273,183,456,22,22,Player A
853,PatternLearningPlayer,208,223,431,27,32,PatternLearningPlayer
854,PatternLearningPlayer,272,232,504,37,11,Player A
855,PatternLearningPlayer,271,221,492,34,14,Player A
856,PatternLearningPlayer,304,194,498,40,14,Player A
857,PatternLearningPlayer,255,235,490,35,15,Player A
858,PatternLearningPlayer,235,230,465,25,20,Player A
859,PatternLearningPlayer,245,200,445,26,27,Player A
860,PatternLearningPlayer,294,214,508,41,11,Player A
861,PatternLearningPlayer,244,199,443,27,28,Player A
862,PatternLearningPlayer,278,233,511,41,10,Player A
863,PatternLearningPlayer,193,213,406,14,36,PatternLearningPlayer
864,PatternLearningPlayer,279,189,468,31,21,Player A
865,PatternLearningPlayer,262,217,479,33,18,Player A
866,PatternLearningPlayer,364,184,548,54,2,Player A
867,PatternLearningPlayer,275,185,460,26,22,Player A
868,PatternLearningPlayer,271,191,462,28,22,Player A
869,PatternLearningPlayer,314,189,503,36,11,Player A
870,PatternLearningPlayer,315,210,525,43,6,Player A
871,PatternLearningPlayer,305,215,520,44,8,Player A
872,PatternLearningPlayer,246,216,462,25,21,Player A
873,PatternLearningPlayer,272,202,474,31,19,Player A
874,PatternLearningPlayer,266,201,467,36,23,Player A
875,PatternLearningPlayer,302,192,494,39,15,Player A
876,PatternLearningPlayer,246,221,467,33,22,Player A
877,PatternLearningPlayer,256,221,477,37,20,Player A
878,PatternLearningPlayer,249,204,453,19,22,Player A
879,PatternLearningPlayer,280,215,495,40,15,Player A
880,PatternLearningPlayer,233,208,441,25,28,Player A
881,PatternLearningPlayer,302,187,489,31,14,Player A
882,PatternLearningPlayer,269,194,463,29,22,Player A
883,PatternLearningPlayer,263,203,466,23,19,Player A
884,PatternLearningPlayer,224,224,448,29,27,Tie
885,PatternLearningPlayer,328,208,536,48,4,Player A
886,PatternLearningPlayer,282,197,479,39,20,Player A
887,PatternLearningPlayer,302,197,499,32,11,Player A
888,PatternLearningPlayer,236,221,457,26,23,Player A
889,PatternLearningPlayer,247,212,459,28,23,Player A
890,PatternLearningPlayer,243,208,451,29,26,Player A
891,PatternLearningPlayer,268,208,476,30,18,Player A
892,PatternLearningPlayer,308,188,496,41,15,Player A
893,PatternLearningPlayer,235,200,435,16,27,Player A
894,PatternLearningPlayer,265,205,470,33,21,Player A
895,PatternLearningPlayer,323,203,526,41,5,Player A
896,PatternLearningPlayer,268,193,461,27,22,Player A
897,PatternLearningPlayer,248,213,461,27,22,Player A
898,PatternLearningPlayer,248,223,471,31,20,Player A
899,PatternLearningPlayer,230,215,445,23,26,Player A
900,PatternLearningPlayer,244,214,458,27,23,Player A
901,PatternLearningPlayer,223,223,446,18,24,Tie
902,PatternLearningPlayer,183,208,391,11,40,PatternLearningPlayer
903,PatternLearningPlayer,275,205,480,31,17,Player A
904,PatternLearningPlayer,248,198,446,27,27,Player A
905,PatternLearningPlayer,263,208,471,25,18,Player A
906,PatternLearningPlayer,223,203,426,19,31,Player A
907,PatternLearningPlayer,250,210,460,26,22,Player A
908,PatternLearningPlayer,202,242,444,31,29,PatternLearningPlayer
909,PatternLearningPlayer,263,208,471,37,22,Player A
910,PatternLearningPlayer,343,188,531,46,5,Player A
911,PatternLearningPlayer,273,203,476,27,17,Player A
912,PatternLearningPlayer,191,221,412,14,34,PatternLearningPlayer
913,PatternLearningPlayer,249,214,463,26,21,Player A
914,PatternLearningPlayer,289,209,498,40,14,Player A
915,PatternLearningPlayer,254,214,468,37,23,Player A
916,PatternLearningPlayer,321,186,507,37,10,Player A
917,PatternLearningPlayer,314,184,498,37,13,Player A
918,PatternLearningPlayer,297,197,494,48,18,Player A
919,PatternLearningPlayer,280,185,465,31,22,Player A
920,PatternLearningPlayer,197,222,419,15,32,PatternLearningPlayer
921,PatternLearningPlayer,260,215,475,29,18,Player A
922,PatternLearningPlayer,324,194,518,45,9,Player A
923,PatternLearningPlayer,247,217,464,24,20,Player A
924,PatternLearningPlayer,328,183,511,38,9,Player A
925,PatternLearningPlayer,328,193,521,36,5,Player A
926,PatternLearningPlayer,300,205,505,32,9,Player A
927,PatternLearningPlayer,268,218,486,34,16,Player A
928,PatternLearningPlayer,277,222,499,38,13,Player A
929,PatternLearningPlayer,306,191,497,36,13,Player A
930,PatternLearningPlayer,336,201,537,52,5,Player A
931,PatternLearningPlayer,259,219,478,26,16,Player A
932,PatternLearningPlayer,284,194,478,26,16,Player A
933,PatternLearningPlayer,268,213,481,32,17,Player A
934,PatternLearningPlayer,243,208,451,29,26,Player A
935,PatternLearningPlayer,267,197,464,33,23,Player A
936,PatternLearningPlayer,253,193,446,24,26,Player A
937,PatternLearningPlayer,262,227,489,31,14,Player A
938,PatternLearningPlayer,259,209,468,31,21,Player A
939,PatternLearningPlayer,215,220,435,22,29,PatternLearningPlayer
940,PatternLearningPlayer,263,193,456,34,26,Player A
941,PatternLearningPlayer,371,186,557,57,0,Player A
942,PatternLearningPlayer,268,198,466,32,22,Player A
943,PatternLearningPlayer,341,181,522,40,6,Player A
944,PatternLearningPlayer,202,237,439,23,28,PatternLearningPlayer
945,PatternLearningPlayer,203,223,426,16,30,PatternLearningPlayer
946,PatternLearningPlayer,206,216,422,18,32,PatternLearningPlayer
947,PatternLearningPlayer,273,208,481,29,16,Player A
948,PatternLearningPlayer,289,199,488,39,17,Player A
949,PatternLearningPlayer,261,191,452,27,25,Player A
950,PatternLearningPlayer,224,229,453,22,23,PatternLearningPlayer
951,PatternLearningPlayer,295,185,480,31,17,Player A
952,PatternLearningPlayer,244,224,468,25,19,Player A
953,PatternLearningPlayer,193,228,421,17,32,PatternLearningPlayer
954,PatternLearningPlayer,335,190,525,49,8,Player A
955,PatternLearningPlayer,319,189,508,38,10,Player A
956,PatternLearningPlayer,274,194,468,25,19,Player A
957,PatternLearningPlayer,318,213,531,49,6,Player A
958,PatternLearningPlayer,199,234,433,17,28,PatternLearningPlayer
959,PatternLearningPlayer,271,206,477,37,20,Player A
960,PatternLearningPlayer,268,208,476,27,17,Player A
961,PatternLearningPlayer,292,202,494,36,14,Player A
962,PatternLearningPlayer,221,211,432,22,30,Player A
963,PatternLearningPlayer,262,202,464,30,22,Player A
964,PatternLearningPlayer,265,215,480,31,17,Player A
965,PatternLearningPlayer,274,204,478,35,19,Player A
966,PatternLearningPlayer,220,225,445,20,25,PatternLearningPlayer
967,PatternLearningPlayer,234,214,448,23,25,Player A
968,PatternLearningPlayer,254,224,478,26,16,Player A
969,PatternLearningPlayer,263,213,476,30,18,Player A
970,PatternLearningPlayer,322,217,539,51,4,Player A
971,PatternLearningPlayer,277,197,474,28,18,Player A
972,PatternLearningPlayer,246,216,462,34,24,Player A
973,PatternLearningPlayer,216,216,432,25,31,Tie
974,PatternLearningPlayer,238,223,461,24,21,Player A
975,PatternLearningPlayer,244,214,458,27,23,Player A
976,PatternLearningPlayer,210,210,420,13,31,Tie
977,PatternLearningPlayer,244,214,458,27,23,Player A
978,PatternLearningPlayer,216,206,422,21,33,Player A
979,PatternLearningPlayer,298,208,506,39,11,Player A
980,PatternLearningPlayer,208,223,431,18,29,PatternLearningPlayer
981,PatternLearningPlayer,291,196,487,41,18,Player A
982,PatternLearningPlayer,284,204,488,36,16,Player A
983,PatternLearningPlayer,250,205,455,27,24,Player A
984,PatternLearningPlayer,231,231,462,28,22,Tie
985,PatternLearningPlayer,288,203,491,36,15,Player A
986,PatternLearningPlayer,265,205,470,36,22,Player A
987,PatternLearningPlayer,277,212,489,31,14,Player A
988,PatternLearningPlayer,285,215,500,33,11,Player A
989,PatternLearningPlayer,255,210,465,22,19,Player A
990,PatternLearningPlayer,241,211,452,24,24,Player A
991,PatternLearningPlayer,270,205,475,29,18,Player A
992,PatternLearningPlayer,230,200,430,29,33,Player A
993,PatternLearningPlayer,279,199,478,29,17,Player A
994,PatternLearningPlayer,257,212,469,35,22,Player A
995,PatternLearningPlayer,310,195,505,38,11,Player A
996,PatternLearningPlayer,230,215,445,17,24,Player A
997,PatternLearningPlayer,267,202,469,32,21,Player A
998,PatternLearningPlayer,290,215,505,41,12,Player A
999,PatternLearningPlayer,226,216,442,23,27,Player A
1000,PatternLearningPlayer,277,207,484,32,16,Player A
1001,PatternLearningPlayer,303,198,501,40,13,Player A
1002,PatternLearningPlayer,243,208,451,20,23,Player A
1003,PatternLearningPlayer,264,224,488,36,16,Player A
1004,PatternLearningPlayer,160,200,360,7,49,PatternLearningPlayer
1005,PatternLearningPlayer,245,200,445,23,26,Player A
1006,PatternLearningPlayer,233,213,446,24,26,Player A
1007,PatternLearningPlayer,244,234,478,38,20,Player A
1008,PatternLearningPlayer,262,217,479,27,16,Player A
1009,PatternLearningPlayer,245,190,435,25,30,Player A
1010,PatternLearningPlayer,311,201,512,42,10,Player A
1011,PatternLearningPlayer,204,204,408,16,36,Tie
1012,PatternLearningPlayer,251,196,447,31,28,Player A
1013,PatternLearningPlayer,278,223,501,40,13,Player A
1014,PatternLearningPlayer,308,173,481,32,17,Player A
1015,PatternLearningPlayer,305,220,525,46,7,Player A
1016,PatternLearningPlayer,286,206,492,31,13,Player A
1017,PatternLearningPlayer,300,200,500,33,11,Player A
1018,PatternLearningPlayer,301,181,482,33,17,Player A
1019,PatternLearningPlayer,289,199,488,36,16,Player A
1020,PatternLearningPlayer,231,216,447,25,26,Player A
1021,PatternLearningPlayer,228,223,451,20,23,Player A
1022,PatternLearningPlayer,302,192,494,39,15,Player A
1023,PatternLearningPlayer,274,204,478,29,17,Player A
1024,PatternLearningPlayer,278,218,496,35,13,Player A
1025,PatternLearningPlayer,261,216,477,34,19,Player A
1026,PatternLearningPlayer,181,206,387,13,42,PatternLearningPlayer
1027,PatternLearningPlayer,291,191,482,36,18,Player A
1028,PatternLearningPlayer,336,191,527,45,6,Player A
1029,PatternLearningPlayer,272,197,469,32,21,Player A
1030,PatternLearningPlayer,228,218,446,21,25,Player A
1031,PatternLearningPlayer,307,202,509,36,9,Player A
1032,PatternLearningPlayer,277,217,494,33,13,Player A
1033,PatternLearningPlayer,270,205,475,32,19,Player A
1034,PatternLearningPlayer,287,212,499,44,15,Player A
1035,PatternLearningPlayer,276,216,492,34,14,Player A
1036,PatternLearningPlayer,263,213,476,33,19,Player A
1037,PatternLearningPlayer,253,208,461,27,22,Player A
1038,PatternLearningPlayer,286,216,502,38,12,Player A
1039,PatternLearningPlayer,264,219,483,28,15,Player A
1040,PatternLearningPlayer,237,232,469,26,19,Player A
1041,PatternLearningPlayer,232,217,449,27,26,Player A
1042,PatternLearningPlayer,317,207,524,45,7,Player A
1043,PatternLearningPlayer,263,213,476,27,17,Player A
1044,PatternLearningPlayer,237,217,454,20,22,Player A
1045,PatternLearningPlayer,213,213,426,22,32,Tie
1046,PatternLearningPlayer,288,198,486,37,17,Player A
1047,PatternLearningPlayer,283,233,516,43,9,Player A
1048,PatternLearningPlayer,291,226,517,47,10,Player A
1049,PatternLearningPlayer,252,227,479,30,17,Player A
1050,PatternLearningPlayer,297,197,494,39,15,Player A
1051,PatternLearningPlayer,291,191,482,27,15,Player A
1052,PatternLearningPlayer,246,226,472,38,22,Player A
1053,PatternLearningPlayer,255,210,465,34,23,Player A
1054,PatternLearningPlayer,300,205,505,44,13,Player A
1055,PatternLearningPlayer,317,202,519,49,10,Player A
1056,PatternLearningPlayer,306,206,512,42,10,Player A
1057,PatternLearningPlayer,261,221,482,39,19,Player A
1058,PatternLearningPlayer,264,189,453,22,23,Player A
1059,PatternLearningPlayer,294,224,518,45,9,Player A
1060,PatternLearningPlayer,309,204,513,46,11,Player A
1061,PatternLearningPlayer,279,219,498,40,14,Player A
1062,PatternLearningPlayer,281,221,502,44,14,Player A
1063,PatternLearningPlayer,329,209,538,47,3,Player A
1064,PatternLearningPlayer,297,202,499,38,13,Player A
1065,PatternLearningPlayer,312,182,494,39,15,Player A
1066,PatternLearningPlayer,166,221,387,10,41,PatternLearningPlayer
1067,PatternLearningPlayer,257,212,469,32,21,Player A
1068,PatternLearningPlayer,206,221,427,23,32,PatternLearningPlayer
1069,PatternLearningPlayer,212,217,429,16,29,PatternLearningPlayer
1070,PatternLearningPlayer,276,231,507,34,9,Player A
1071,PatternLearningPlayer,293,218,511,41,10,Player A
1072,PatternLearningPlayer,279,209,488,33,15,Player A
1073,PatternLearningPlayer,204,224,428,24,32,PatternLearningPlayer
1074,PatternLearningPlayer,201,211,412,11,33,PatternLearningPlayer
1075,PatternLearningPlayer,259,209,468,25,19,Player A
1076,PatternLearningPlayer,269,194,463,26,21,Player A
1077,PatternLearningPlayer,231,201,432,22,30,Player A
1078,PatternLearningPlayer,257,202,459,25,22,Player A
1079,PatternLearningPlayer,212,232,444,25,27,PatternLearningPlayer
1080,PatternLearningPlayer,306,206,512,45,11,Player A
1081,PatternLearningPlayer,281,191,472,32,20,Player A
1082,PatternLearningPlayer,232,207,439,23,28,Player A
1083,PatternLearningPlayer,216,206,422,15,31,Player A
1084,PatternLearningPlayer,259,199,458,24,22,Player A
1085,PatternLearningPlayer,264,214,478,35,19,Player A
1086,PatternLearningPlayer,292,202,494,30,12,Player A
1087,PatternLearningPlayer,305,185,490,32,14,Player A
1088,PatternLearningPlayer,301,211,512,42,10,Player A
1089,PatternLearningPlayer,184,229,413,15,34,PatternLearningPlayer
1090,PatternLearningPlayer,235,220,455,39,28,Player A
1091,PatternLearningPlayer,287,202,489,31,14,Player A
1092,PatternLearningPlayer,277,197,474,34,20,Player A
1093,PatternLearningPlayer,249,224,473,27,18,Player A
1094,PatternLearningPlayer,168,223,391,11,40,PatternLearningPlayer
1095,PatternLearningPlayer,308,208,516,43,9,Player A
1096,PatternLearningPlayer,301,201,502,47,15,Player A
1097,PatternLearningPlayer,259,214,473,27,18,Player A
1098,PatternLearningPlayer,213,208,421,17,32,Player A
1099,PatternLearningPlayer,286,201,487,35,16,Player A
1100,PatternLearningPlayer,276,211,487,35,16,Player A
1101,PatternLearningPlayer,242,227,469,29,20,Player A
1102,PatternLearningPlayer,301,196,497,36,13,Player A
1103,PatternLearningPlayer,297,202,499,35,12,Player A
1104,PatternLearningPlayer,318,193,511,41,10,Player A
1105,PatternLearningPlayer,260,205,465,25,20,Player A
1106,PatternLearningPlayer,315,185,500,39,13,Player A
1107,PatternLearningPlayer,259,219,478,26,16,Player A
1108,PatternLearningPlayer,212,202,414,16,34,Player A
1109,PatternLearningPlayer,317,202,519,40,7,Player A
1110,PatternLearningPlayer,273,203,476,33,19,Player A
1111,PatternLearningPlayer,264,209,473,36,21,Player A
1112,PatternLearningPlayer,247,212,459,34,25,Player A
1113,PatternLearningPlayer,280,210,490,35,15,Player A
1114,PatternLearningPlayer,265,195,460,26,22,Player A
1115,PatternLearningPlayer,273,208,481,35,18,Player A
1116,PatternLearningPlayer,283,208,491,30,13,Player A
1117,PatternLearningPlayer,215,205,420,19,33,Player A
1118,PatternLearningPlayer,326,201,527,45,6,Player A
1119,PatternLearningPlayer,250,235,485,27,14,Player A
1120,PatternLearningPlayer,326,191,517,44,9,Player A
1121,PatternLearningPlayer,223,203,426,19,31,Player A
1122,PatternLearningPlayer,291,206,497,39,14,Player A
1123,PatternLearningPlayer,260,215,475,26,17,Player A
1124,PatternLearningPlayer,260,210,470,27,19,Player A
1125,PatternLearningPlayer,276,226,502,38,12,Player A
1126,PatternLearningPlayer,264,219,483,31,16,Player A
1127,PatternLearningPlayer,309,199,508,44,12,Player A
1128,PatternLearningPlayer,298,203,501,43,14,Player A
1129,PatternLearningPlayer,299,199,498,37,13,Player A
1130,PatternLearningPlayer,226,236,462,25,21,PatternLearningPlayer
1131,PatternLearningPlayer,267,217,484,35,17,Player A
1132,PatternLearningPlayer,281,191,472,35,21,Player A
1133,PatternLearningPlayer,273,218,491,30,13,Player A
1134,PatternLearningPlayer,279,209,488,36,16,Player A
1135,PatternLearningPlayer,255,200,455,30,25,Player A
1136,PatternLearningPlayer,275,215,490,44,18,Player A
1137,PatternLearningPlayer,352,192,544,50,2,Player A
1138,PatternLearningPlayer,285,185,470,33,21,Player A
1139,PatternLearningPlayer,239,189,428,18,30,Player A
1140,PatternLearningPlayer,317,212,529,50,7,Player A
1141,PatternLearningPlayer,305,195,500,39,13,Player A
1142,PatternLearningPlayer,270,210,480,34,18,Player A
1143,PatternLearningPlayer,273,213,486,37,17,Player A
1144,PatternLearningPlayer,231,226,457,29,24,Player A
1145,PatternLearningPlayer,238,203,441,22,27,Player A
1146,PatternLearningPlayer,328,193,521,39,6,Player A
1147,PatternLearningPlayer,229,209,438,19,27,Player A
1148,PatternLearningPlayer,249,219,468,34,22,Player A
1149,PatternLearningPlayer,270,220,490,32,14,Player A
1150,PatternLearningPlayer,258,218,476,30,18,Player A
1151,PatternLearningPlayer,302,202,504,40,12,Player A
1152,PatternLearningPlayer,241,206,447,19,24,Player A
1153,PatternLearningPlayer,231,201,432,25,31,Player A
1154,PatternLearningPlayer,229,199,428,12,28,Player A
1155,PatternLearningPlayer,284,219,503,36,11,Player A
1156,PatternLearningPlayer,243,228,471,25,18,Player A
1157,PatternLearningPlayer,267,202,469,29,20,Player A
1158,PatternLearningPlayer,240,195,435,19,28,Player A
1159,PatternLearningPlayer,216,236,452,27,25,PatternLearningPlayer
1160,PatternLearningPlayer,327,212,539,48,3,Player A
1161,PatternLearningPlayer,238,213,451,23,24,Player A
1162,PatternLearningPlayer,303,193,496,35,13,Player A
1163,PatternLearningPlayer,316,196,512,39,9,Player A
1164,PatternLearningPlayer,259,219,478,29,17,Player A
1165,PatternLearningPlayer,280,215,495,40,15,Player A
1166,PatternLearningPlayer,267,202,469,32,21,Player A
1167,PatternLearningPlayer,229,219,448,23,25,Player A
1168,PatternLearningPlayer,214,214,428,15,29,Tie
1169,PatternLearningPlayer,318,183,501,37,12,Player A
1170,PatternLearningPlayer,212,222,434,21,29,PatternLearningPlayer
1171,PatternLearningPlayer,336,181,517,47,10,Player A
1172,PatternLearningPlayer,329,214,543,55,4,Player A
1173,PatternLearningPlayer,274,204,478,26,16,Player A
1174,PatternLearningPlayer,289,194,483,31,16,Player A
1175,PatternLearningPlayer,324,184,508,38,10,Player A
1176,PatternLearningPlayer,286,211,497,33,12,Player A
1177,PatternLearningPlayer,254,204,458,27,23,Player A
1178,PatternLearningPlayer,203,223,426,22,32,PatternLearningPlayer
1179,PatternLearningPlayer,290,215,505,41,12,Player A
1180,PatternLearningPlayer,279,224,503,36,11,Player A
1181,PatternLearningPlayer,249,209,458,27,23,Player A
1182,PatternLearningPlayer,288,213,501,40,13,Player A
1183,PatternLearningPlayer,310,205,515,48,11,Player A
1184,PatternLearningPlayer,194,219,413,12,33,PatternLearningPlayer
1185,PatternLearningPlayer,244,224,468,28,20,Player A
1186,PatternLearningPlayer,221,216,437,21,28,Player A
1187,PatternLearningPlayer,360,195,555,55,0,Player A
1188,PatternLearningPlayer,246,196,442,23,27,Player A
1189,PatternLearningPlayer,253,213,466,26,20,Player A
1190,PatternLearningPlayer,299,199,498,37,13,Player A
1191,PatternLearningPlayer,193,223,416,12,32,PatternLearningPlayer
1192,PatternLearningPlayer,264,179,443,24,27,Player A
1193,PatternLearningPlayer,293,208,501,40,13,Player A
1194,PatternLearningPlayer,274,199,473,36,21,Player A
1195,PatternLearningPlayer,197,212,409,23,38,PatternLearningPlayer
1196,PatternLearningPlayer,286,201,487,29,14,Player A
1197,PatternLearningPlayer,255,215,470,27,19,Player A
1198,PatternLearningPlayer,277,222,499,32,11,Player A
1199,PatternLearningPlayer,317,212,529,50,7,Player A
1200,PatternLearningPlayer,257,212,469,32,21,Player A
1201,PatternLearningPlayer,296,196,492,34,14,Player A
1202,PatternLearningPlayer,269,214,483,34,17,Player A
1203,PatternLearningPlayer,253,198,451,26,25,Player A
1204,PatternLearningPlayer,317,217,534,49,5,Player A
1205,PatternLearningPlayer,286,186,472,32,20,Player A
1206,PatternLearningPlayer,285,210,495,34,13,Player A
1207,PatternLearningPlayer,231,206,437,18,27,Player A
1208,PatternLearningPlayer,249,199,448,26,26,Player A
1209,PatternLearningPlayer,243,213,456,28,24,Player A
1210,PatternLearningPlayer,231,221,452,24,24,Player A
1211,PatternLearningPlayer,275,215,490,38,16,Player A
1212,PatternLearningPlayer,222,222,444,25,27,Tie
1213,PatternLearningPlayer,185,215,400,11,37,PatternLearningPlayer
1214,PatternLearningPlayer,274,229,503,33,10,Player A
1215,PatternLearningPlayer,214,214,428,15,29,Tie
1216,PatternLearningPlayer,225,195,420,19,33,Player A
1217,PatternLearningPlayer,286,186,472,32,20,Player A
1218,PatternLearningPlayer,258,198,456,22,22,Player A
1219,PatternLearningPlayer,268,208,476,30,18,Player A
1220,PatternLearningPlayer,256,201,457,26,23,Player A
1221,PatternLearningPlayer,264,194,458,24,22,Player A
1222,PatternLearningPlayer,239,214,453,25,24,Player A
1223,PatternLearningPlayer,237,207,444,22,26,Player A
1224,PatternLearningPlayer,286,211,497,36,13,Player A
1225,PatternLearningPlayer,316,181,497,39,14,Player A
1226,PatternLearningPlayer,191,216,407,15,36,PatternLearningPlayer
1227,PatternLearningPlayer,301,206,507,43,12,Player A
1228,PatternLearningPlayer,293,213,506,39,11,Player A
1229,PatternLearningPlayer,250,220,470,24,18,Player A
1230,PatternLearningPlayer,197,237,434,12,26,PatternLearningPlayer
1231,PatternLearningPlayer,275,225,500,39,13,Player A
1232,PatternLearningPlayer,268,188,456,28,24,Player A
1233,PatternLearningPlayer,289,204,493,35,14,Player A
1234,PatternLearningPlayer,248,208,456,31,25,Player A
1235,PatternLearningPlayer,303,198,501,40,13,Player A
1236,PatternLearningPlayer,221,211,432,19,29,Player A
1237,PatternLearningPlayer,258,228,486,37,17,Player A
1238,PatternLearningPlayer,247,212,459,19,20,Player A
1239,PatternLearningPlayer,264,209,473,33,20,Player A
1240,PatternLearningPlayer,230,215,445,26,27,Player A
1241,PatternLearningPlayer,230,205,435,19,28,Player A
1242,PatternLearningPlayer,291,206,497,33,12,Player A
1243,PatternLearningPlayer,243,203,446,24,26,Player A
1244,PatternLearningPlayer,261,226,487,38,17,Player A
1245,PatternLearningPlayer,170,215,385,11,42,PatternLearningPlayer
1246,PatternLearningPlayer,160,235,395,12,39,PatternLearningPlayer
1247,PatternLearningPlayer,270,205,475,32,19,Player A
1248,PatternLearningPlayer,197,227,424,17,31,PatternLearningPlayer
1249,PatternLearningPlayer,246,211,457,23,22,Player A
1250,PatternLearningPlayer,278,213,491,42,17,Player A
1251,PatternLearningPlayer,253,208,461,30,23,Player A
1252,PatternLearningPlayer,275,210,485,33,16,Player A
1253,PatternLearningPlayer,234,214,448,29,27,Player A
1254,PatternLearningPlayer,230,225,455,27,24,Player A
1255,PatternLearningPlayer,274,214,488,39,17,Player A
1256,PatternLearningPlayer,271,226,497,36,13,Player A
1257,PatternLearningPlayer,242,207,449,24,25,Player A
1258,PatternLearningPlayer,230,210,440,24,28,Player A
1259,PatternLearningPlayer,315,205,520,44,8,Player A
1260,PatternLearningPlayer,278,193,471,31,20,Player A
1261,PatternLearningPlayer,281,216,497,33,12,Player A
1262,PatternLearningPlayer,235,220,455,27,24,Player A
1263,PatternLearningPlayer,343,208,551,54,1,Player A
1264,PatternLearningPlayer,219,219,438,16,26,Tie
1265,PatternLearningPlayer,212,247,459,28,23,PatternLearningPlayer
1266,PatternLearningPlayer,259,209,468,28,20,Player A
1267,PatternLearningPlayer,249,209,458,27,23,Player A
1268,PatternLearningPlayer,257,207,464,30,22,Player A
1269,PatternLearningPlayer,269,219,488,36,16,Player A
1270,PatternLearningPlayer,313,208,521,42,7,Player A
1271,PatternLearningPlayer,254,224,478,32,18,Player A
1272,PatternLearningPlayer,320,200,520,47,9,Player A
1273,PatternLearningPlayer,298,198,496,32,12,Player A
1274,PatternLearningPlayer,317,177,494,33,13,Player A
1275,PatternLearningPlayer,298,208,506,36,10,Player A
1276,PatternLearningPlayer,242,192,434,18,28,Player A
1277,PatternLearningPlayer,275,215,490,29,13,Player A
1278,PatternLearningPlayer,281,201,482,33,17,Player A
1279,PatternLearningPlayer,279,199,478,26,16,Player A
1280,PatternLearningPlayer,265,240,505,41,12,Player A
1281,PatternLearningPlayer,308,218,526,38,4,Player A
1282,PatternLearningPlayer,155,255,410,12,34,PatternLearningPlayer
1283,PatternLearningPlayer,313,198,511,38,9,Player A
1284,PatternLearningPlayer,233,218,451,20,23,Player A
1285,PatternLearningPlayer,330,190,520,44,8,Player A
1286,PatternLearningPlayer,186,226,412,17,35,PatternLearningPlayer
1287,PatternLearningPlayer,279,204,483,31,16,Player A
1288,PatternLearningPlayer,261,211,472,26,18,Player A
1289,PatternLearningPlayer,213,218,431,21,30,PatternLearningPlayer
1290,PatternLearningPlayer,297,182,479,36,19,Player A
1291,PatternLearningPlayer,235,200,435,25,30,Player A
1292,PatternLearningPlayer,264,209,473,33,20,Player A
1293,PatternLearningPlayer,245,220,465,25,20,Player A
1294,PatternLearningPlayer,226,216,442,23,27,Player A
1295,PatternLearningPlayer,281,211,492,37,15,Player A
1296,PatternLearningPlayer,230,215,445,23,26,Player A
1297,PatternLearningPlayer,252,222,474,25,17,Player A
1298,PatternLearningPlayer,265,225,490,35,15,Player A
1299,PatternLearningPlayer,299,204,503,39,12,Player A
1300,PatternLearningPlayer,242,227,469,29,20,Player A
1301,PatternLearningPlayer,282,197,479,36,19,Player A
1302,PatternLearningPlayer,250,230,480,37,19,Player A
1303,PatternLearningPlayer,263,208,471,34,21,Player A
1304,PatternLearningPlayer,244,209,453,25,24,Player A
1305,PatternLearningPlayer,296,191,487,29,14,Player A
1306,PatternLearningPlayer,254,194,448,23,25,Player A
1307,PatternLearningPlayer,312,182,494,33,13,Player A
1308,PatternLearningPlayer,234,199,433,23,30,Player A
1309,PatternLearningPlayer,250,220,470,24,18,Player A
1310,PatternLearningPlayer,241,211,452,30,26,Player A
1311,PatternLearningPlayer,257,192,449,33,28,Player A
1312,PatternLearningPlayer,218,213,431,15,28,Player A
1313,PatternLearningPlayer,253,223,476,33,19,Player A
1314,PatternLearningPlayer,255,200,455,24,23,Player A
1315,PatternLearningPlayer,248,228,476,24,16,Player A
1316,PatternLearningPlayer,269,219,488,30,14,Player A
1317,PatternLearningPlayer,223,208,431,30,33,Player A
1318,PatternLearningPlayer,299,194,493,35,14,Player A
1319,PatternLearningPlayer,261,226,487,32,15,Player A
1320,PatternLearningPlayer,290,210,500,39,13,Player A
1321,PatternLearningPlayer,253,208,461,24,21,Player A
1322,PatternLearningPlayer,204,219,423,22,33,PatternLearningPlayer
1323,PatternLearningPlayer,286,211,497,33,12,Player A
1324,PatternLearningPlayer,246,196,442,23,27,Player A
1325,PatternLearningPlayer,332,202,534,46,4,Player A
1326,PatternLearningPlayer,258,223,481,41,20,Player A
1327,PatternLearningPlayer,305,205,510,43,11,Player A
1328,PatternLearningPlayer,287,207,494,39,15,Player A
1329,PatternLearningPlayer,250,225,475,26,17,Player A
1330,PatternLearningPlayer,218,243,461,27,22,PatternLearningPlayer
1331,PatternLearningPlayer,315,195,510,40,10,Player A
1332,PatternLearningPlayer,283,208,491,36,15,Player A
1333,PatternLearningPlayer,267,222,489,28,13,Player A
1334,PatternLearningPlayer,243,208,451,26,25,Player A
1335,PatternLearningPlayer,292,217,509,45,12,Player A
1336,PatternLearningPlayer,278,208,486,40,18,Player A
1337,PatternLearningPlayer,251,231,482,30,16,Player A
1338,PatternLearningPlayer,296,211,507,43,12,Player A
1339,PatternLearningPlayer,236,216,452,27,25,Player A
1340,PatternLearningPlayer,308,193,501,34,11,Player A
1341,PatternLearningPlayer,232,212,444,22,26,Player A
1342,PatternLearningPlayer,281,206,487,32,15,Player A
1343,PatternLearningPlayer,251,211,462,25,21,Player A
1344,PatternLearningPlayer,286,201,487,41,18,Player A
1345,PatternLearningPlayer,238,223,461,24,21,Player A
1346,PatternLearningPlayer,232,202,434,18,28,Player A
1347,PatternLearningPlayer,257,207,464,33,23,Player A
1348,PatternLearningPlayer,323,193,516,43,9,Player A
1349,PatternLearningPlayer,303,203,506,45,13,Player A
1350,PatternLearningPlayer,214,234,448,20,24,PatternLearningPlayer
1351,PatternLearningPlayer,325,190,515,45,10,Player A
1352,PatternLearningPlayer,203,193,396,13,39,Player A
1353,PatternLearningPlayer,237,197,434,24,30,Player A
1354,PatternLearningPlayer,258,208,466,35,23,Player A
1355,PatternLearningPlayer,253,208,461,27,22,Player A
1356,PatternLearningPlayer,287,212,499,35,12,Player A
1357,PatternLearningPlayer,269,214,483,28,15,Player A
1358,PatternLearningPlayer,245,215,460,29,23,Player A
1359,PatternLearningPlayer,252,222,474,40,22,Player A
1360,PatternLearningPlayer,282,197,479,36,19,Player A
1361,PatternLearningPlayer,295,190,485,39,18,Player A
1362,PatternLearningPlayer,244,239,483,25,14,Player A
1363,PatternLearningPlayer,215,225,440,21,27,PatternLearningPlayer
1364,PatternLearningPlayer,215,230,445,23,26,PatternLearningPlayer
1365,PatternLearningPlayer,271,206,477,34,19,Player A
1366,PatternLearningPlayer,289,219,508,38,10,Player A
1367,PatternLearningPlayer,234,214,448,26,26,Player A
1368,PatternLearningPlayer,311,216,527,48,7,Player A
1369,PatternLearningPlayer,320,185,505,38,11,Player A
1370,PatternLearningPlayer,249,209,458,24,22,Player A
1371,PatternLearningPlayer,254,219,473,24,17,Player A
1372,PatternLearningPlayer,222,212,434,21,29,Player A
1373,PatternLearningPlayer,254,209,463,29,22,Player A
1374,PatternLearningPlayer,279,194,473,36,21,Player A
1375,PatternLearningPlayer,276,226,502,41,13,Player A
1376,PatternLearningPlayer,248,208,456,28,24,Player A
1377,PatternLearningPlayer,292,202,494,39,15,Player A
1378,PatternLearningPlayer,306,206,512,36,8,Player A
1379,PatternLearningPlayer,241,186,427,26,33,Player A
1380,PatternLearningPlayer,265,195,460,29,23,Player A
1381,PatternLearningPlayer,203,223,426,25,33,PatternLearningPlayer
1382,PatternLearningPlayer,298,208,506,36,10,Player A
1383,PatternLearningPlayer,300,220,520,44,8,Player A
1384,PatternLearningPlayer,263,203,466,29,21,Player A
1385,PatternLearningPlayer,249,214,463,29,22,Player A
1386,PatternLearningPlayer,273,203,476,30,18,Player A
1387,PatternLearningPlayer,248,198,446,24,26,Player A
1388,PatternLearningPlayer,283,208,491,36,15,Player A
1389,PatternLearningPlayer,226,181,407,21,38,Player A
1390,PatternLearningPlayer,228,218,446,24,26,Player A
1391,PatternLearningPlayer,209,209,418,17,33,Tie
1392,PatternLearningPlayer,297,202,499,41,14,Player A
1393,PatternLearningPlayer,291,191,482,36,18,Player A
1394,PatternLearningPlayer,318,203,521,48,9,Player A
1395,PatternLearningPlayer,240,225,465,31,22,Player A
1396,PatternLearningPlayer,281,196,477,31,18,Player A
1397,PatternLearningPlayer,317,207,524,48,8,Player A
1398,PatternLearningPlayer,257,217,474,28,18,Player A
1399,PatternLearningPlayer,303,198,501,37,12,Player A
1400,PatternLearningPlayer,234,204,438,19,27,Player A
1401,PatternLearningPlayer,307,217,524,45,7,Player A
1402,PatternLearningPlayer,315,195,510,49,13,Player A
1403,PatternLearningPlayer,287,207,494,36,14,Player A
1404,PatternLearningPlayer,289,219,508,44,12,Player A
1405,PatternLearningPlayer,313,198,511,44,11,Player A
1406,PatternLearningPlayer,356,181,537,46,3,Player A
1407,PatternLearningPlayer,297,197,494,39,15,Player A
1408,PatternLearningPlayer,295,210,505,41,12,Player A
1409,PatternLearningPlayer,260,205,465,25,20,Player A
1410,PatternLearningPlayer,249,219,468,34,22,Player A
1411,PatternLearningPlayer,317,187,504,34,10,Player A
1412,PatternLearningPlayer,267,217,484,35,17,Player A
1413,PatternLearningPlayer,284,189,473,30,19,Player A
1414,PatternLearningPlayer,240,195,435,19,28,Player A
1415,PatternLearningPlayer,187,222,409,11,34,PatternLearningPlayer
1416,PatternLearningPlayer,301,196,497,30,11,Player A
1417,PatternLearningPlayer,305,195,500,36,12,Player A
1418,PatternLearningPlayer,281,216,497,39,14,Player A
1419,PatternLearningPlayer,335,200,535,50,5,Player A
1420,PatternLearningPlayer,275,215,490,35,15,Player A
1421,PatternLearningPlayer,250,200,450,28,26,Player A
1422,PatternLearningPlayer,295,215,510,46,12,Player A
1423,PatternLearningPlayer,271,211,482,24,14,Player A
1424,PatternLearningPlayer,255,190,445,23,26,Player A
1425,PatternLearningPlayer,270,205,475,29,18,Player A
1426,PatternLearningPlayer,279,214,493,35,14,Player A
1427,PatternLearningPlayer,252,202,454,29,25,Player A
1428,PatternLearningPlayer,300,220,520,38,6,Player A
1429,PatternLearningPlayer,226,196,422,21,33,Player A
1430,PatternLearningPlayer,257,197,454,26,24,Player A
1431,PatternLearningPlayer,287,187,474,34,20,Player A
1432,PatternLearningPlayer,328,203,531,46,5,Player A
1433,PatternLearningPlayer,260,210,470,30,20,Player A
1434,PatternLearningPlayer,290,215,505,44,13,Player A
1435,PatternLearningPlayer,222,212,434,18,28,Player A
1436,PatternLearningPlayer,293,193,486,37,17,Player A
1437,PatternLearningPlayer,215,240,455,24,23,PatternLearningPlayer
1438,PatternLearningPlayer,289,189,478,38,20,Player A
1439,PatternLearningPlayer,223,208,431,21,30,Player A
1440,PatternLearningPlayer,312,192,504,37,11,Player A
1441,PatternLearningPlayer,211,216,427,20,31,PatternLearningPlayer
1442,PatternLearningPlayer,276,196,472,32,20,Player A
1443,PatternLearningPlayer,257,192,449,21,24,Player A
1444,PatternLearningPlayer,222,212,434,27,31,Player A
1445,PatternLearningPlayer,323,198,521,42,7,Player A
1446,PatternLearningPlayer,236,241,477,31,18,PatternLearningPlayer
1447,PatternLearningPlayer,257,202,459,34,25,Player A
1448,PatternLearningPlayer,247,222,469,29,20,Player A
1449,PatternLearningPlayer,197,227,424,20,32,PatternLearningPlayer
1450,PatternLearningPlayer,350,200,550,53,1,Player A
1451,PatternLearningPlayer,229,214,443,21,26,Player A
1452,PatternLearningPlayer,251,231,482,27,15,Player A
1453,PatternLearningPlayer,222,217,439,26,29,Player A
1454,PatternLearningPlayer,253,203,456,31,25,Player A
1455,PatternLearningPlayer,272,222,494,36,14,Player A
1456,PatternLearningPlayer,264,219,483,31,16,Player A
1457,PatternLearningPlayer,312,202,514,44,10,Player A
1458,PatternLearningPlayer,280,195,475,32,19,Player A
1459,PatternLearningPlayer,280,200,480,28,16,Player A
1460,PatternLearningPlayer,259,214,473,30,19,Player A
1461,PatternLearningPlayer,312,192,504,43,13,Player A
1462,PatternLearningPlayer,285,220,505,38,11,Player A
1463,PatternLearningPlayer,194,214,408,16,36,PatternLearningPlayer
1464,PatternLearningPlayer,240,220,460,32,24,Player A
1465,PatternLearningPlayer,254,224,478,35,19,Player A
1466,PatternLearningPlayer,219,209,428,21,31,Player A
1467,PatternLearningPlayer,261,206,467,33,22,Player A
1468,PatternLearningPlayer,268,188,456,28,24,Player A
1469,PatternLearningPlayer,156,226,382,8,42,PatternLearningPlayer
1470,PatternLearningPlayer,304,194,498,40,14,Player A
1471,PatternLearningPlayer,272,197,469,32,21,Player A
1472,PatternLearningPlayer,286,206,492,31,13,Player A
1473,PatternLearningPlayer,282,207,489,34,15,Player A
1474,PatternLearningPlayer,276,191,467,30,21,Player A
1475,PatternLearningPlayer,247,212,459,28,23,Player A
1476,PatternLearningPlayer,182,232,414,13,33,PatternLearningPlayer
1477,PatternLearningPlayer,258,208,466,23,19,Player A
1478,PatternLearningPlayer,221,241,462,34,24,PatternLearningPlayer
1479,PatternLearningPlayer,280,200,480,34,18,Player A
1480,PatternLearningPlayer,283,203,486,34,16,Player A
1481,PatternLearningPlayer,327,212,539,57,6,Player A
1482,PatternLearningPlayer,286,206,492,37,15,Player A
1483,PatternLearningPlayer,265,210,475,38,21,Player A
1484,PatternLearningPlayer,245,220,465,31,22,Player A
1485,PatternLearningPlayer,244,209,453,19,22,Player A
1486,PatternLearningPlayer,183,218,401,12,37,PatternLearningPlayer
1487,PatternLearningPlayer,266,206,472,32,20,Player A
1488,PatternLearningPlayer,294,214,508,44,12,Player A
1489,PatternLearningPlayer,256,226,482,33,17,Player A
1490,PatternLearningPlayer,243,203,446,33,29,Player A
1491,PatternLearningPlayer,268,208,476,27,17,Player A
1492,PatternLearningPlayer,256,226,482,30,16,Player A
1493,PatternLearningPlayer,265,195,460,32,24,Player A
1494,PatternLearningPlayer,284,199,483,34,17,Player A
1495,PatternLearningPlayer,232,202,434,24,30,Player A
1496,PatternLearningPlayer,343,193,536,54,6,Player A
1497,PatternLearningPlayer,236,211,447,22,25,Player A
1498,PatternLearningPlayer,291,211,502,32,10,Player A
1499,PatternLearningPlayer,287,197,484,35,17,Player A
1500,PatternLearningPlayer,233,213,446,21,25,Player A
1501,PatternLearningPlayer,226,221,447,25,26,Player A
1502,PatternLearningPlayer,292,197,489,37,16,Player A
1503,PatternLearningPlayer,319,199,518,45,9,Player A
1504,PatternLearningPlayer,259,209,468,28,20,Player A
1505,PatternLearningPlayer,294,204,498,43,15,Player A
1506,PatternLearningPlayer,228,208,436,26,30,Player A
1507,PatternLearningPlayer,190,205,395,12,39,PatternLearningPlayer
1508,PatternLearningPlayer,293,203,496,41,15,Player A
1509,PatternLearningPlayer,236,216,452,24,24,Player A
1510,PatternLearningPlayer,242,227,469,29,20,Player A
1511,PatternLearningPlayer,190,235,425,18,31,PatternLearningPlayer
1512,PatternLearningPlayer,309,184,493,38,15,Player A
1513,PatternLearningPlayer,275,200,475,23,16,Player A
1514,PatternLearningPlayer,293,208,501,34,11,Player A
1515,PatternLearningPlayer,286,216,502,38,12,Player A
1516,PatternLearningPlayer,291,206,497,39,14,Player A
1517,PatternLearningPlayer,253,218,471,31,20,Player A
1518,PatternLearningPlayer,286,211,497,39,14,Player A
1519,PatternLearningPlayer,275,195,470,27,19,Player A
1520,PatternLearningPlayer,264,199,463,26,21,Player A
1521,PatternLearningPlayer,254,189,443,30,29,Player A
1522,PatternLearningPlayer,294,184,478,35,19,Player A
1523,PatternLearningPlayer,282,202,484,38,18,Player A
1524,PatternLearningPlayer,278,208,486,37,17,Player A
1525,PatternLearningPlayer,223,238,461,18,19,PatternLearningPlayer
1526,PatternLearningPlayer,282,187,469,32,21,Player A
1527,PatternLearningPlayer,171,231,402,13,37,PatternLearningPlayer
1528,PatternLearningPlayer,277,192,469,29,20,Player A
1529,PatternLearningPlayer,243,208,451,23,24,Player A
1530,PatternLearningPlayer,255,205,460,26,22,Player A
1531,PatternLearningPlayer,217,212,429,19,30,Player A
1532,PatternLearningPlayer,261,221,482,36,18,Player A
1533,PatternLearningPlayer,255,230,485,36,17,Player A
1534,PatternLearningPlayer,280,220,500,39,13,Player A
1535,PatternLearningPlayer,292,192,484,35,17,Player A
1536,PatternLearningPlayer,227,222,449,24,25,Player A
1537,PatternLearningPlayer,278,188,466,26,20,Player A
1538,PatternLearningPlayer,248,218,466,32,22,Player A
1539,PatternLearningPlayer,289,199,488,30,14,Player A
1540,PatternLearningPlayer,281,211,492,37,15,Player A
1541,PatternLearningPlayer,267,217,484,38,18,Player A
1542,PatternLearningPlayer,289,204,493,29,12,Player A
1543,PatternLearningPlayer,318,198,516,43,9,Player A
1544,PatternLearningPlayer,298,178,476,36,20,Player A
1545,PatternLearningPlayer,227,217,444,25,27,Player A
1546,PatternLearningPlayer,247,187,434,24,30,Player A
1547,PatternLearningPlayer,279,219,498,34,12,Player A
1548,PatternLearningPlayer,243,203,446,27,27,Player A
1549,PatternLearningPlayer,187,207,394,11,39,PatternLearningPlayer
1550,PatternLearningPlayer,261,196,457,29,24,Player A
1551,PatternLearningPlayer,244,199,443,27,28,Player A
1552,PatternLearningPlayer,247,212,459,28,23,Player A
1553,PatternLearningPlayer,285,205,490,35,15,Player A
1554,PatternLearningPlayer,277,212,489,37,16,Player A
1555,PatternLearningPlayer,262,192,454,29,25,Player A
1556,PatternLearningPlayer,259,214,473,30,19,Player A
1557,PatternLearningPlayer,272,192,464,30,22,Player A
1558,PatternLearningPlayer,313,193,506,39,11,Player A
1559,PatternLearningPlayer,289,199,488,30,14,Player A
1560,PatternLearningPlayer,216,231,447,19,24,PatternLearningPlayer
1561,PatternLearningPlayer,267,217,484,35,17,Player A
1562,PatternLearningPlayer,188,213,401,15,38,PatternLearningPlayer
1563,PatternLearningPlayer,310,210,520,41,7,Player A
1564,PatternLearningPlayer,201,246,447,22,25,PatternLearningPlayer
1565,PatternLearningPlayer,256,216,472,29,19,Player A
1566,PatternLearningPlayer,263,193,456,31,25,Player A
1567,PatternLearningPlayer,184,234,418,14,32,PatternLearningPlayer
1568,PatternLearningPlayer,231,226,457,26,23,Player A
1569,PatternLearningPlayer,266,211,477,31,18,Player A
1570,PatternLearningPlayer,272,207,479,27,16,Player A
1571,PatternLearningPlayer,283,188,471,22,17,Player A
1572,PatternLearningPlayer,281,196,477,34,19,Player A
1573,PatternLearningPlayer,285,190,475,29,18,Player A
1574,PatternLearningPlayer,282,197,479,33,18,Player A
1575,PatternLearningPlayer,271,216,487,32,15,Player A
1576,PatternLearningPlayer,284,199,483,40,19,Player A
1577,PatternLearningPlayer,273,203,476,36,20,Player A
1578,PatternLearningPlayer,241,221,462,31,23,Player A
1579,PatternLearningPlayer,282,222,504,43,13,Player A
1580,PatternLearningPlayer,246,221,467,27,20,Player A
1581,PatternLearningPlayer,247,217,464,33,23,Player A
1582,PatternLearningPlayer,236,211,447,28,27,Player A
1583,PatternLearningPlayer,285,200,485,39,18,Player A
1584,PatternLearningPlayer,263,203,466,26,20,Player A
1585,PatternLearningPlayer,299,194,493,32,13,Player A
1586,PatternLearningPlayer,214,219,433,23,30,PatternLearningPlayer
1587,PatternLearningPlayer,255,210,465,28,21,Player A
1588,PatternLearningPlayer,265,225,490,38,16,Player A
1589,PatternLearningPlayer,227,197,424,17,31,Player A
1590,PatternLearningPlayer,273,223,496,35,13,Player A
1591,PatternLearningPlayer,262,222,484,35,17,Player A
1592,PatternLearningPlayer,253,208,461,24,21,Player A
1593,PatternLearningPlayer,243,208,451,29,26,Player A
1594,PatternLearningPlayer,275,195,470,33,21,Player A
1595,PatternLearningPlayer,236,211,447,22,25,Player A
1596,PatternLearningPlayer,277,217,494,42,16,Player A
1597,PatternLearningPlayer,281,191,472,29,19,Player A
1598,PatternLearningPlayer,232,207,439,23,28,Player A
1599,PatternLearningPlayer,220,245,465,25,20,PatternLearningPlayer
1600,PatternLearningPlayer,317,187,504,43,13,Player A
1601,PatternLearningPlayer,312,197,509,42,11,Player A
1602,PatternLearningPlayer,266,231,497,39,14,Player A
1603,PatternLearningPlayer,327,207,534,49,5,Player A
1604,PatternLearningPlayer,209,214,423,19,32,PatternLearningPlayer
1605,PatternLearningPlayer,238,198,436,17,27,Player A
1606,PatternLearningPlayer,223,203,426,16,30,Player A
1607,PatternLearningPlayer,238,208,446,27,27,Player A
1608,PatternLearningPlayer,255,220,475,29,18,Player A
1609,PatternLearningPlayer,275,200,475,26,17,Player A
1610,PatternLearningPlayer,312,197,509,42,11,Player A
1611,PatternLearningPlayer,266,211,477,34,19,Player A
1612,PatternLearningPlayer,239,214,453,19,22,Player A
1613,PatternLearningPlayer,304,214,518,39,7,Player A
1614,PatternLearningPlayer,182,217,399,10,37,PatternLearningPlayer
1615,PatternLearningPlayer,315,185,500,36,12,Player A
1616,PatternLearningPlayer,219,234,453,22,23,PatternLearningPlayer
1617,PatternLearningPlayer,308,178,486,37,17,Player A
1618,PatternLearningPlayer,327,197,524,48,8,Player A
1619,PatternLearningPlayer,228,218,446,24,26,Player A
1620,PatternLearningPlayer,239,209,448,23,25,Player A
1621,PatternLearningPlayer,284,219,503,42,13,Player A
1622,PatternLearningPlayer,278,178,456,22,22,Player A
1623,PatternLearningPlayer,308,198,506,36,10,Player A
1624,PatternLearningPlayer,268,203,471,34,21,Player A
1625,PatternLearningPlayer,251,226,477,37,20,Player A
1626,PatternLearningPlayer,201,221,422,18,32,PatternLearningPlayer
1627,PatternLearningPlayer,323,198,521,48,9,Player A
1628,PatternLearningPlayer,279,219,498,37,13,Player A
1629,PatternLearningPlayer,232,212,444,22,26,Player A
1630,PatternLearningPlayer,204,244,448,23,25,PatternLearningPlayer
1631,PatternLearningPlayer,226,196,422,21,33,Player A
1632,PatternLearningPlayer,284,204,488,39,17,Player A
1633,PatternLearningPlayer,291,196,487,32,15,Player A
1634,PatternLearningPlayer,232,197,429,25,32,Player A
1635,PatternLearningPlayer,301,211,512,39,9,Player A
1636,PatternLearningPlayer,295,190,485,33,16,Player A
1637,PatternLearningPlayer,275,210,485,33,16,Player A
1638,PatternLearningPlayer,253,208,461,27,22,Player A
1639,PatternLearningPlayer,275,210,485,30,15,Player A
1640,PatternLearningPlayer,223,223,446,30,28,Tie
1641,PatternLearningPlayer,287,182,469,32,21,Player A
1642,PatternLearningPlayer,230,215,445,20,25,Player A
1643,PatternLearningPlayer,257,202,459,28,23,Player A
1644,PatternLearningPlayer,309,199,508,41,11,Player A
1645,PatternLearningPlayer,213,223,436,26,30,PatternLearningPlayer
1646,PatternLearningPlayer,219,209,428,15,29,Player A
1647,PatternLearningPlayer,253,193,446,21,25,Player A
1648,PatternLearningPlayer,292,202,494,39,15,Player A
1649,PatternLearningPlayer,240,210,450,25,25,Player A
1650,PatternLearningPlayer,292,197,489,34,15,Player A
1651,PatternLearningPlayer,242,197,439,23,28,Player A
1652,PatternLearningPlayer,311,206,517,41,8,Player A
1653,PatternLearningPlayer,268,213,481,32,17,Player A
1654,PatternLearningPlayer,251,181,432,25,31,Player A
1655,PatternLearningPlayer,351,186,537,55,6,Player A
1656,PatternLearningPlayer,289,219,508,38,10,Player A
1657,PatternLearningPlayer,219,214,433,20,29,Player A
1658,PatternLearningPlayer,271,206,477,31,18,Player A
1659,PatternLearningPlayer,241,211,452,30,26,Player A
1660,PatternLearningPlayer,269,194,463,35,24,Player A
1661,PatternLearningPlayer,332,187,519,46,9,Player A
1662,PatternLearningPlayer,179,199,378,10,44,PatternLearningPlayer
1663,PatternLearningPlayer,290,200,490,38,16,Player A
1664,PatternLearningPlayer,241,226,467,24,19,Player A
1665,PatternLearningPlayer,243,203,446,27,27,Player A
1666,PatternLearningPlayer,256,211,467,33,22,Player A
1667,PatternLearningPlayer,224,189,413,18,35,Player A
1668,PatternLearningPlayer,196,221,417,16,33,PatternLearningPlayer
1669,PatternLearningPlayer,291,196,487,41,18,Player A
1670,PatternLearningPlayer,238,218,456,22,22,Player A
1671,PatternLearningPlayer,277,217,494,39,15,Player A
1672,PatternLearningPlayer,242,217,459,28,23,Player A
1673,PatternLearningPlayer,285,205,490,38,16,Player A
1674,PatternLearningPlayer,332,182,514,47,11,Player A
1675,PatternLearningPlayer,217,222,439,20,27,PatternLearningPlayer
1676,PatternLearningPlayer,213,218,431,21,30,PatternLearningPlayer
1677,PatternLearningPlayer,277,197,474,28,18,Player A
1678,PatternLearningPlayer,208,208,416,21,35,Tie
1679,PatternLearningPlayer,210,225,435,22,29,PatternLearningPlayer
1680,PatternLearningPlayer,273,208,481,32,17,Player A
1681,PatternLearningPlayer,276,196,472,32,20,Player A
1682,PatternLearningPlayer,233,213,446,21,25,Player A
1683,PatternLearningPlayer,305,195,500,39,13,Player A
1684,PatternLearningPlayer,234,209,443,18,25,Player A
1685,PatternLearningPlayer,299,204,503,36,11,Player A
1686,PatternLearningPlayer,242,217,459,31,24,Player A
1687,PatternLearningPlayer,199,224,423,19,32,PatternLearningPlayer
1688,PatternLearningPlayer,241,211,452,18,22,Player A
1689,PatternLearningPlayer,342,172,514,41,9,Player A
1690,PatternLearningPlayer,222,217,439,26,29,Player A
1691,PatternLearningPlayer,265,195,460,32,24,Player A
1692,PatternLearningPlayer,259,184,443,27,28,Player A
1693,PatternLearningPlayer,222,222,444,22,26,Tie
1694,PatternLearningPlayer,330,190,520,44,8,Player A
1695,PatternLearningPlayer,330,200,530,48,6,Player A
1696,PatternLearningPlayer,296,206,502,41,13,Player A
1697,PatternLearningPlayer,301,216,517,41,8,Player A
1698,PatternLearningPlayer,329,209,538,53,5,Player A
1699,PatternLearningPlayer,296,206,502,38,12,Player A
1700,PatternLearningPlayer,303,203,506,39,11,Player A
1701,PatternLearningPlayer,290,195,485,36,17,Player A
1702,PatternLearningPlayer,306,186,492,34,14,Player A
1703,PatternLearningPlayer,270,195,465,31,22,Player A
1704,PatternLearningPlayer,284,179,463,32,23,Player A
1705,PatternLearningPlayer,277,212,489,34,15,Player A
1706,PatternLearningPlayer,252,222,474,22,16,Player A
1707,PatternLearningPlayer,282,187,469,32,21,Player A
1708,PatternLearningPlayer,298,198,496,41,15,Player A
1709,PatternLearningPlayer,263,183,446,27,27,Player A
1710,PatternLearningPlayer,291,226,517,44,9,Player A
1711,PatternLearningPlayer,252,207,459,25,22,Player A
1712,PatternLearningPlayer,283,213,496,35,13,Player A
1713,PatternLearningPlayer,289,184,473,33,20,Player A
1714,PatternLearningPlayer,240,220,460,26,22,Player A
1715,PatternLearningPlayer,273,208,481,29,16,Player A
1716,PatternLearningPlayer,291,201,492,28,12,Player A
1717,PatternLearningPlayer,305,190,495,34,13,Player A
1718,PatternLearningPlayer,254,214,468,28,20,Player A
1719,PatternLearningPlayer,236,211,447,31,28,Player A
1720,PatternLearningPlayer,253,213,466,29,21,Player A
1721,PatternLearningPlayer,238,223,461,27,22,Player A
1722,PatternLearningPlayer,287,202,489,34,15,Player A
1723,PatternLearningPlayer,206,226,432,13,27,PatternLearningPlayer
1724,PatternLearningPlayer,261,221,482,30,16,Player A
1725,PatternLearningPlayer,273,213,486,40,18,Player A
1726,PatternLearningPlayer,271,196,467,30,21,Player A
1727,PatternLearningPlayer,250,225,475,32,19,Player A
1728,PatternLearningPlayer,248,228,476,27,17,Player A
1729,PatternLearningPlayer,291,216,507,43,12,Player A
1730,PatternLearningPlayer,306,216,522,46,8,Player A
1731,PatternLearningPlayer,267,207,474,31,19,Player A
1732,PatternLearningPlayer,283,213,496,35,13,Player A
1733,PatternLearningPlayer,335,190,525,43,6,Player A
1734,PatternLearningPlayer,185,220,405,13,36,PatternLearningPlayer
1735,PatternLearningPlayer,254,209,463,29,22,Player A
1736,PatternLearningPlayer,333,213,546,55,3,Player A
1737,PatternLearningPlayer,298,188,486,34,16,Player A
1738,PatternLearningPlayer,248,213,461,30,23,Player A
1739,PatternLearningPlayer,273,213,486,28,14,Player A
1740,PatternLearningPlayer,253,213,466,29,21,Player A
1741,PatternLearningPlayer,234,209,443,24,27,Player A
1742,PatternLearningPlayer,264,199,463,32,23,Player A
1743,PatternLearningPlayer,244,209,453,28,25,Player A
1744,PatternLearningPlayer,184,229,413,15,34,PatternLearningPlayer
1745,PatternLearningPlayer,289,209,498,34,12,Player A
1746,PatternLearningPlayer,297,207,504,40,12,Player A
1747,PatternLearningPlayer,286,206,492,40,16,Player A
1748,PatternLearningPlayer,310,210,520,44,8,Player A
1749,PatternLearningPlayer,226,206,432,19,29,Player A
1750,PatternLearningPlayer,267,217,484,29,15,Player A
1751,PatternLearningPlayer,280,205,485,27,14,Player A
1752,PatternLearningPlayer,260,215,475,32,19,Player A
1753,PatternLearningPlayer,290,195,485,33,16,Player A
1754,PatternLearningPlayer,299,204,503,42,13,Player A
1755,PatternLearningPlayer,259,204,463,35,24,Player A
1756,PatternLearningPlayer,221,231,452,30,26,PatternLearningPlayer
1757,PatternLearningPlayer,284,194,478,29,17,Player A
1758,PatternLearningPlayer,206,246,452,24,24,PatternLearningPlayer
1759,PatternLearningPlayer,272,222,494,36,14,Player A
1760,PatternLearningPlayer,290,215,505,38,11,Player A
1761,PatternLearningPlayer,183,233,416,15,33,PatternLearningPlayer
1762,PatternLearningPlayer,313,198,511,41,10,Player A
1763,PatternLearningPlayer,242,232,474,31,19,Player A
1764,PatternLearningPlayer,259,234,493,35,14,Player A
1765,PatternLearningPlayer,230,220,450,31,27,Player A
1766,PatternLearningPlayer,292,197,489,43,18,Player A
1767,PatternLearningPlayer,263,203,466,26,20,Player A
1768,PatternLearningPlayer,232,232,464,24,20,Tie
1769,PatternLearningPlayer,243,198,441,28,29,Player A
1770,PatternLearningPlayer,302,197,499,35,12,Player A
1771,PatternLearningPlayer,248,213,461,30,23,Player A
1772,PatternLearningPlayer,332,182,514,38,8,Player A
1773,PatternLearningPlayer,241,221,462,34,24,Player A
1774,PatternLearningPlayer,256,221,477,25,16,Player A
1775,PatternLearningPlayer,288,198,486,37,17,Player A
1776,PatternLearningPlayer,221,216,437,24,29,Player A
1777,PatternLearningPlayer,257,212,469,29,20,Player A
1778,PatternLearningPlayer,255,220,475,35,20,Player A
1779,PatternLearningPlayer,252,217,469,32,21,Player A
1780,PatternLearningPlayer,232,222,454,20,22,Player A
1781,PatternLearningPlayer,294,219,513,46,11,Player A
1782,PatternLearningPlayer,260,215,475,32,19,Player A
1783,PatternLearningPlayer,283,213,496,41,15,Player A
1784,PatternLearningPlayer,225,225,450,22,24,Tie
1785,PatternLearningPlayer,249,204,453,28,25,Player A
1786,PatternLearningPlayer,251,211,462,28,22,Player A
1787,PatternLearningPlayer,257,212,469,29,20,Player A
1788,PatternLearningPlayer,284,199,483,37,18,Player A
1789,PatternLearningPlayer,227,217,444,28,28,Player A
1790,PatternLearningPlayer,283,188,471,31,20,Player A
1791,PatternLearningPlayer,266,201,467,27,20,Player A
1792,PatternLearningPlayer,281,186,467,27,20,Player A
1793,PatternLearningPlayer,261,221,482,30,16,Player A
1794,PatternLearningPlayer,306,196,502,38,12,Player A
1795,PatternLearningPlayer,258,198,456,28,24,Player A
1796,PatternLearningPlayer,316,201,517,41,8,Player A
1797,PatternLearningPlayer,251,206,457,26,23,Player A
1798,PatternLearningPlayer,223,203,426,16,30,Player A
1799,PatternLearningPlayer,337,187,524,48,8,Player A
1800,PatternLearningPlayer,257,222,479,36,19,Player A
1801,PatternLearningPlayer,257,227,484,29,15,Player A
1802,PatternLearningPlayer,232,212,444,25,27,Player A
1803,PatternLearningPlayer,248,213,461,33,24,Player A
1804,PatternLearningPlayer,255,215,470,33,21,Player A
1805,PatternLearningPlayer,245,215,460,26,22,Player A
1806,PatternLearningPlayer,239,199,438,22,28,Player A
1807,PatternLearningPlayer,283,193,476,27,17,Player A
1808,PatternLearningPlayer,194,224,418,14,32,PatternLearningPlayer
1809,PatternLearningPlayer,215,210,425,15,30,Player A
1810,PatternLearningPlayer,278,193,471,31,20,Player A
1811,PatternLearningPlayer,255,240,495,40,15,Player A
1812,PatternLearningPlayer,276,221,497,39,14,Player A
1813,PatternLearningPlayer,203,218,421,23,34,PatternLearningPlayer
1814,PatternLearningPlayer,241,236,477,25,16,Player A
1815,PatternLearningPlayer,268,193,461,30,23,Player A
1816,PatternLearningPlayer,303,208,511,35,8,Player A
1817,PatternLearningPlayer,233,223,456,28,24,Player A
1818,PatternLearningPlayer,347,192,539,48,3,Player A
1819,PatternLearningPlayer,224,214,438,19,27,Player A
1820,PatternLearningPlayer,255,215,470,21,17,Player A
1821,PatternLearningPlayer,222,217,439,29,30,Player A
1822,PatternLearningPlayer,276,201,477,37,20,Player A
1823,PatternLearningPlayer,282,187,469,38,23,Player A
1824,PatternLearningPlayer,212,227,439,20,27,PatternLearningPlayer
1825,PatternLearningPlayer,276,206,482,36,18,Player A
1826,PatternLearningPlayer,271,211,482,33,17,Player A
1827,PatternLearningPlayer,293,203,496,35,13,Player A
1828,PatternLearningPlayer,275,200,475,29,18,Player A
1829,PatternLearningPlayer,277,202,479,30,17,Player A
1830,PatternLearningPlayer,246,206,452,21,23,Player A
1831,PatternLearningPlayer,281,196,477,34,19,Player A
1832,PatternLearningPlayer,226,221,447,25,26,Player A
1833,PatternLearningPlayer,257,202,459,31,24,Player A
1834,PatternLearningPlayer,276,201,477,31,18,Player A
1835,PatternLearningPlayer,237,222,459,25,22,Player A
1836,PatternLearningPlayer,258,198,456,28,24,Player A
1837,PatternLearningPlayer,235,210,445,26,27,Player A
1838,PatternLearningPlayer,252,232,484,29,15,Player A
1839,PatternLearningPlayer,172,217,389,12,41,PatternLearningPlayer
1840,PatternLearningPlayer,235,220,455,24,23,Player A
1841,PatternLearningPlayer,242,217,459,25,22,Player A
1842,PatternLearningPlayer,304,204,508,38,10,Player A
1843,PatternLearningPlayer,277,212,489,31,14,Player A
1844,PatternLearningPlayer,190,260,450,25,25,PatternLearningPlayer
1845,PatternLearningPlayer,304,199,503,42,13,Player A
1846,PatternLearningPlayer,242,212,454,20,22,Player A
1847,PatternLearningPlayer,245,235,480,31,17,Player A
1848,PatternLearningPlayer,340,200,540,46,2,Player A
1849,PatternLearningPlayer,296,226,522,49,9,Player A
1850,PatternLearningPlayer,186,216,402,10,36,PatternLearningPlayer
1851,PatternLearningPlayer,251,226,477,31,18,Player A
1852,PatternLearningPlayer,267,197,464,33,23,Player A
1853,PatternLearningPlayer,261,221,482,27,15,Player A
1854,PatternLearningPlayer,250,230,480,31,17,Player A
1855,PatternLearningPlayer,204,224,428,21,31,PatternLearningPlayer
1856,PatternLearningPlayer,210,210,420,19,33,Tie
1857,PatternLearningPlayer,348,193,541,47,2,Player A
1858,PatternLearningPlayer,233,218,451,23,24,Player A
1859,PatternLearningPlayer,260,205,465,34,23,Player A
1860,PatternLearningPlayer,230,220,450,25,25,Player A
1861,PatternLearningPlayer,346,171,517,44,9,Player A
1862,PatternLearningPlayer,267,217,484,32,16,Player A
1863,PatternLearningPlayer,277,212,489,31,14,Player A
1864,PatternLearningPlayer,233,213,446,24,26,Player A
1865,PatternLearningPlayer,230,230,460,23,21,Tie
1866,PatternLearningPlayer,285,205,490,29,13,Player A
1867,PatternLearningPlayer,283,188,471,31,20,Player A
1868,PatternLearningPlayer,348,198,546,55,3,Player A
1869,PatternLearningPlayer,240,225,465,25,20,Player A
1870,PatternLearningPlayer,320,190,510,46,12,Player A
1871,PatternLearningPlayer,222,222,444,22,26,Tie
1872,PatternLearningPlayer,226,221,447,28,27,Player A
1873,PatternLearningPlayer,245,220,465,28,21,Player A
1874,PatternLearningPlayer,286,191,477,34,19,Player A
1875,PatternLearningPlayer,264,214,478,26,16,Player A
1876,PatternLearningPlayer,275,220,495,37,14,Player A
1877,PatternLearningPlayer,195,230,425,12,29,PatternLearningPlayer
1878,PatternLearningPlayer,214,209,423,22,33,Player A
1879,PatternLearningPlayer,278,203,481,41,20,Player A
1880,PatternLearningPlayer,217,237,454,26,24,PatternLearningPlayer
1881,PatternLearningPlayer,226,211,437,21,28,Player A
1882,PatternLearningPlayer,321,211,532,50,6,Player A
1883,PatternLearningPlayer,280,220,500,36,12,Player A
1884,PatternLearningPlayer,307,187,494,39,15,Player A
1885,PatternLearningPlayer,235,210,445,23,26,Player A
1886,PatternLearningPlayer,289,194,483,34,17,Player A
1887,PatternLearningPlayer,297,197,494,33,13,Player A
1888,PatternLearningPlayer,259,214,473,36,21,Player A
1889,PatternLearningPlayer,267,192,459,22,21,Player A
1890,PatternLearningPlayer,251,211,462,22,20,Player A
1891,PatternLearningPlayer,270,210,480,25,15,Player A
1892,PatternLearningPlayer,262,202,464,27,21,Player A
1893,PatternLearningPlayer,270,205,475,35,20,Player A
1894,PatternLearningPlayer,166,231,397,8,37,PatternLearningPlayer
1895,PatternLearningPlayer,234,214,448,29,27,Player A
1896,PatternLearningPlayer,270,200,470,30,20,Player A
1897,PatternLearningPlayer,287,207,494,42,16,Player A
1898,PatternLearningPlayer,280,200,480,37,19,Player A
1899,PatternLearningPlayer,202,242,444,28,28,PatternLearningPlayer
1900,PatternLearningPlayer,320,205,525,43,6,Player A
1901,PatternLearningPlayer,260,205,465,31,22,Player A
1902,PatternLearningPlayer,255,220,475,29,18,Player A
1903,PatternLearningPlayer,292,202,494,42,16,Player A
1904,PatternLearningPlayer,235,200,435,19,28,Player A
1905,PatternLearningPlayer,221,201,422,24,34,Player A
1906,PatternLearningPlayer,226,221,447,22,25,Player A
1907,PatternLearningPlayer,232,202,434,24,30,Player A
1908,PatternLearningPlayer,214,204,418,17,33,Player A
1909,PatternLearningPlayer,334,189,523,44,7,Player A
1910,PatternLearningPlayer,266,216,482,30,16,Player A
1911,PatternLearningPlayer,268,218,486,37,17,Player A
1912,PatternLearningPlayer,302,197,499,32,11,Player A
1913,PatternLearningPlayer,226,221,447,25,26,Player A
1914,PatternLearningPlayer,285,195,480,31,17,Player A
1915,PatternLearningPlayer,278,218,496,29,11,Player A
1916,PatternLearningPlayer,304,224,528,46,6,Player A
1917,PatternLearningPlayer,290,215,505,44,13,Player A
1918,PatternLearningPlayer,276,196,472,29,19,Player A
1919,PatternLearningPlayer,275,220,495,37,14,Player A
1920,PatternLearningPlayer,203,228,431,24,31,PatternLearningPlayer
1921,PatternLearningPlayer,292,202,494,36,14,Player A
1922,PatternLearningPlayer,322,192,514,41,9,Player A
1923,PatternLearningPlayer,178,193,371,9,46,PatternLearningPlayer
1924,PatternLearningPlayer,242,212,454,23,23,Player A
1925,PatternLearningPlayer,250,195,445,26,27,Player A
1926,PatternLearningPlayer,263,208,471,37,22,Player A
1927,PatternLearningPlayer,244,189,433,20,29,Player A
1928,PatternLearningPlayer,154,234,388,8,40,PatternLearningPlayer
1929,PatternLearningPlayer,229,214,443,21,26,Player A
1930,PatternLearningPlayer,290,195,485,30,15,Player A
1931,PatternLearningPlayer,222,232,454,26,24,PatternLearningPlayer
1932,PatternLearningPlayer,250,230,480,40,20,Player A
1933,PatternLearningPlayer,321,196,517,47,10,Player A
1934,PatternLearningPlayer,261,221,482,33,17,Player A
1935,PatternLearningPlayer,287,222,509,36,9,Player A
1936,PatternLearningPlayer,225,200,425,21,32,Player A
1937,PatternLearningPlayer,218,203,421,17,32,Player A
1938,PatternLearningPlayer,208,223,431,18,29,PatternLearningPlayer
1939,PatternLearningPlayer,224,229,453,31,26,PatternLearningPlayer
1940,PatternLearningPlayer,267,207,474,31,19,Player A
1941,PatternLearningPlayer,239,209,448,23,25,Player A
1942,PatternLearningPlayer,289,184,473,30,19,Player A
1943,PatternLearningPlayer,249,219,468,31,21,Player A
1944,PatternLearningPlayer,284,219,503,36,11,Player A
1945,PatternLearningPlayer,274,209,483,31,16,Player A
1946,PatternLearningPlayer,156,236,392,9,39,PatternLearningPlayer
1947,PatternLearningPlayer,262,222,484,32,16,Player A
1948,PatternLearningPlayer,245,240,485,27,14,Player A
1949,PatternLearningPlayer,263,213,476,24,16,Player A
1950,PatternLearningPlayer,269,209,478,35,19,Player A
1951,PatternLearningPlayer,279,189,468,34,22,Player A
1952,PatternLearningPlayer,335,180,515,48,11,Player A
1953,PatternLearningPlayer,262,222,484,32,16,Player A
1954,PatternLearningPlayer,298,213,511,41,10,Player A
1955,PatternLearningPlayer,297,202,499,38,13,Player A
1956,PatternLearningPlayer,186,236,422,12,30,PatternLearningPlayer
1957,PatternLearningPlayer,245,200,445,26,27,Player A
1958,PatternLearningPlayer,275,195,470,36,22,Player A
1959,PatternLearningPlayer,292,197,489,40,17,Player A
1960,PatternLearningPlayer,205,230,435,16,27,PatternLearningPlayer
1961,PatternLearningPlayer,234,224,458,27,23,Player A
1962,PatternLearningPlayer,249,199,448,23,25,Player A
1963,PatternLearningPlayer,299,204,503,39,12,Player A
1964,PatternLearningPlayer,331,196,527,42,5,Player A
1965,PatternLearningPlayer,307,192,499,38,13,Player A
1966,PatternLearningPlayer,281,211,492,34,14,Player A
1967,PatternLearningPlayer,266,221,487,35,16,Player A
1968,PatternLearningPlayer,220,235,455,24,23,PatternLearningPlayer
1969,PatternLearningPlayer,327,197,524,48,8,Player A
1970,PatternLearningPlayer,250,225,475,35,20,Player A
1971,PatternLearningPlayer,237,207,444,22,26,Player A
1972,PatternLearningPlayer,235,210,445,29,28,Player A
1973,PatternLearningPlayer,223,208,431,24,31,Player A
1974,PatternLearningPlayer,310,200,510,43,11,Player A
1975,PatternLearningPlayer,278,208,486,40,18,Player A
1976,PatternLearningPlayer,269,204,473,30,19,Player A
1977,PatternLearningPlayer,284,214,498,40,14,Player A
1978,PatternLearningPlayer,230,215,445,17,24,Player A
1979,PatternLearningPlayer,286,211,497,39,14,Player A
1980,PatternLearningPlayer,325,210,535,50,5,Player A
1981,PatternLearningPlayer,273,168,441,28,29,Player A
1982,PatternLearningPlayer,228,223,451,26,25,Player A
1983,PatternLearningPlayer,202,212,414,10,32,PatternLearningPlayer
1984,PatternLearningPlayer,329,174,503,42,13,Player A
1985,PatternLearningPlayer,241,236,477,25,16,Player A
1986,PatternLearningPlayer,231,216,447,25,26,Player A
1987,PatternLearningPlayer,258,193,451,23,24,Player A
1988,PatternLearningPlayer,310,190,500,42,14,Player A
1989,PatternLearningPlayer,242,217,459,28,23,Player A
1990,PatternLearningPlayer,328,188,516,40,8,Player A
1991,PatternLearningPlayer,288,198,486,31,15,Player A
1992,PatternLearningPlayer,232,212,444,19,25,Player A
1993,PatternLearningPlayer,240,220,460,26,22,Player A
1994,PatternLearningPlayer,281,221,502,44,14,Player A
1995,PatternLearningPlayer,288,203,491,33,14,Player A
1996,PatternLearningPlayer,285,200,485,33,16,Player A
1997,PatternLearningPlayer,243,203,446,27,27,Player A
1998,PatternLearningPlayer,284,209,493,29,12,Player A
1999,PatternLearningPlayer,299,204,503,42,13,Player A
2000,PatternLearningPlayer,314,209,523,38,5,Player A
2001,PatternLearningPlayer,240,200,440,21,27,Player A
2002,PatternLearningPlayer,246,251,497,36,13,PatternLearningPlayer
2003,PatternLearningPlayer,289,204,493,35,14,Player A
2004,PatternLearningPlayer,272,197,469,32,21,Player A
2005,PatternLearningPlayer,316,191,507,40,11,Player A
2006,PatternLearningPlayer,297,212,509,36,9,Player A
2007,PatternLearningPlayer,253,203,456,25,23,Player A
2008,PatternLearningPlayer,169,209,378,10,44,PatternLearningPlayer
2009,PatternLearningPlayer,287,217,504,46,14,Player A
2010,PatternLearningPlayer,295,190,485,27,14,Player A
2011,PatternLearningPlayer,239,219,458,30,24,Player A
2012,PatternLearningPlayer,305,200,505,41,12,Player A
2013,PatternLearningPlayer,243,223,466,26,20,Player A
2014,PatternLearningPlayer,223,223,446,27,27,Tie
2015,PatternLearningPlayer,216,226,442,23,27,PatternLearningPlayer
2016,PatternLearningPlayer,217,212,429,13,28,Player A
2017,PatternLearningPlayer,279,204,483,34,17,Player A
2018,PatternLearningPlayer,256,221,477,34,19,Player A
2019,PatternLearningPlayer,199,229,428,15,29,PatternLearningPlayer
2020,PatternLearningPlayer,248,228,476,24,16,Player A
2021,PatternLearningPlayer,192,222,414,16,34,PatternLearningPlayer
2022,PatternLearningPlayer,308,203,511,35,8,Player A
2023,PatternLearningPlayer,278,223,501,37,12,Player A
2024,PatternLearningPlayer,288,208,496,44,16,Player A
2025,PatternLearningPlayer,309,194,503,42,13,Player A
2026,PatternLearningPlayer,288,208,496,35,13,Player A
2027,PatternLearningPlayer,307,217,524,42,6,Player A
2028,PatternLearningPlayer,232,217,449,27,26,Player A
2029,PatternLearningPlayer,334,204,538,47,3,Player A
2030,PatternLearningPlayer,272,192,464,33,23,Player A
2031,PatternLearningPlayer,290,200,490,38,16,Player A
2032,PatternLearningPlayer,232,217,449,21,24,Player A
2033,PatternLearningPlayer,256,181,437,24,29,Player A
2034,PatternLearningPlayer,240,210,450,25,25,Player A
2035,PatternLearningPlayer,276,201,477,34,19,Player A
2036,PatternLearningPlayer,273,198,471,34,21,Player A
2037,PatternLearningPlayer,261,206,467,27,20,Player A
2038,PatternLearningPlayer,250,205,455,24,23,Player A
2039,PatternLearningPlayer,209,224,433,20,29,PatternLearningPlayer
2040,PatternLearningPlayer,299,194,493,35,14,Player A
2041,PatternLearningPlayer,311,206,517,41,8,Player A
2042,PatternLearningPlayer,270,210,480,31,17,Player A
2043,PatternLearningPlayer,277,227,504,37,11,Player A
2044,PatternLearningPlayer,248,208,456,28,24,Player A
2045,PatternLearningPlayer,300,205,505,44,13,Player A
2046,PatternLearningPlayer,271,196,467,33,22,Player A
2047,PatternLearningPlayer,302,197,499,32,11,Player A
2048,PatternLearningPlayer,309,194,503,42,13,Player A
2049,PatternLearningPlayer,207,227,434,18,28,PatternLearningPlayer
2050,PatternLearningPlayer,209,229,438,13,25,PatternLearningPlayer
2051,PatternLearningPlayer,266,221,487,32,15,Player A
2052,PatternLearningPlayer,285,205,490,35,15,Player A
2053,PatternLearningPlayer,257,212,469,32,21,Player A
2054,PatternLearningPlayer,249,204,453,19,22,Player A
2055,PatternLearningPlayer,299,199,498,34,12,Player A
2056,PatternLearningPlayer,292,182,474,28,18,Player A
2057,PatternLearningPlayer,296,211,507,46,13,Player A
2058,PatternLearningPlayer,305,200,505,41,12,Player A
2059,PatternLearningPlayer,279,204,483,31,16,Player A
2060,PatternLearningPlayer,254,209,463,23,20,Player A
2061,PatternLearningPlayer,235,230,465,28,21,Player A
2062,PatternLearningPlayer,266,226,492,34,14,Player A
2063,PatternLearningPlayer,225,240,465,31,22,PatternLearningPlayer
2064,PatternLearningPlayer,313,198,511,47,12,Player A
2065,PatternLearningPlayer,287,212,499,32,11,Player A
2066,PatternLearningPlayer,275,205,480,31,17,Player A
2067,PatternLearningPlayer,287,172,459,25,22,Player A
2068,PatternLearningPlayer,267,217,484,26,14,Player A
2069,PatternLearningPlayer,301,186,487,32,15,Player A
2070,PatternLearningPlayer,196,216,412,14,34,PatternLearningPlayer
2071,PatternLearningPlayer,269,214,483,34,17,Player A
2072,PatternLearningPlayer,300,200,500,39,13,Player A
2073,PatternLearningPlayer,233,223,456,28,24,Player A
2074,PatternLearningPlayer,297,202,499,41,14,Player A
2075,PatternLearningPlayer,308,198,506,33,9,Player A
2076,PatternLearningPlayer,334,184,518,45,9,Player A
2077,PatternLearningPlayer,240,200,440,27,29,Player A
2078,PatternLearningPlayer,267,202,469,26,19,Player A
2079,PatternLearningPlayer,201,236,437,18,27,PatternLearningPlayer
2080,PatternLearningPlayer,255,220,475,26,17,Player A
2081,PatternLearningPlayer,218,218,436,23,29,Tie
2082,PatternLearningPlayer,311,206,517,41,8,Player A
2083,PatternLearningPlayer,198,218,416,12,32,PatternLearningPlayer
2084,PatternLearningPlayer,214,204,418,20,34,Player A
2085,PatternLearningPlayer,293,203,496,41,15,Player A
2086,PatternLearningPlayer,233,233,466,23,19,Tie
2087,PatternLearningPlayer,250,200,450,22,24,Player A
2088,PatternLearningPlayer,222,232,454,20,22,PatternLearningPlayer
2089,PatternLearningPlayer,273,198,471,31,20,Player A
2090,PatternLearningPlayer,211,241,452,24,24,PatternLearningPlayer
2091,PatternLearningPlayer,294,199,493,35,14,Player A
2092,PatternLearningPlayer,232,202,434,27,31,Player A
2093,PatternLearningPlayer,304,214,518,42,8,Player A
2094,PatternLearningPlayer,321,191,512,39,9,Player A
2095,PatternLearningPlayer,210,205,415,23,36,Player A
2096,PatternLearningPlayer,342,197,539,54,5,Player A
2097,PatternLearningPlayer,264,204,468,37,23,Player A
2098,PatternLearningPlayer,271,206,477,28,17,Player A
2099,PatternLearningPlayer,298,208,506,42,12,Player A
2100,PatternLearningPlayer,326,201,527,42,5,Player A
2101,PatternLearningPlayer,246,191,437,27,30,Player A
2102,PatternLearningPlayer,201,206,407,15,36,PatternLearningPlayer
2103,PatternLearningPlayer,261,216,477,25,16,Player A
2104,PatternLearningPlayer,275,205,480,34,18,Player A
2105,PatternLearningPlayer,299,189,488,36,16,Player A
2106,PatternLearningPlayer,254,184,438,28,30,Player A
2107,PatternLearningPlayer,313,208,521,42,7,Player A
2108,PatternLearningPlayer,294,194,488,36,16,Player A
2109,PatternLearningPlayer,305,200,505,41,12,Player A
2110,PatternLearningPlayer,288,203,491,30,13,Player A
2111,PatternLearningPlayer,286,191,477,31,18,Player A
2112,PatternLearningPlayer,293,198,491,33,14,Player A
2113,PatternLearningPlayer,260,205,465,25,20,Player A
2114,PatternLearningPlayer,174,224,398,12,38,PatternLearningPlayer
2115,PatternLearningPlayer,226,216,442,23,27,Player A
2116,PatternLearningPlayer,164,229,393,10,39,PatternLearningPlayer
2117,PatternLearningPlayer,267,207,474,34,20,Player A
2118,PatternLearningPlayer,258,223,481,32,17,Player A
2119,PatternLearningPlayer,269,179,448,26,26,Player A
2120,PatternLearningPlayer,247,237,484,32,16,Player A
2121,PatternLearningPlayer,233,203,436,20,28,Player A
2122,PatternLearningPlayer,231,201,432,16,28,Player A
2123,PatternLearningPlayer,333,198,531,55,8,Player A
2124,PatternLearningPlayer,267,207,474,31,19,Player A
2125,PatternLearningPlayer,279,194,473,42,23,Player A
2126,PatternLearningPlayer,281,201,482,30,16,Player A
2127,PatternLearningPlayer,286,196,482,30,16,Player A
2128,PatternLearningPlayer,257,207,464,27,21,Player A
2129,PatternLearningPlayer,232,207,439,23,28,Player A
2130,PatternLearningPlayer,203,223,426,22,32,PatternLearningPlayer
2131,PatternLearningPlayer,258,213,471,31,20,Player A
2132,PatternLearningPlayer,258,193,451,26,25,Player A
2133,PatternLearningPlayer,164,219,383,9,42,PatternLearningPlayer
2134,PatternLearningPlayer,264,234,498,34,12,Player A
2135,PatternLearningPlayer,259,214,473,30,19,Player A
2136,PatternLearningPlayer,287,227,514,47,11,Player A
2137,PatternLearningPlayer,240,215,455,30,25,Player A
2138,PatternLearningPlayer,294,219,513,49,12,Player A
2139,PatternLearningPlayer,306,191,497,33,12,Player A
2140,PatternLearningPlayer,306,191,497,36,13,Player A
2141,PatternLearningPlayer,249,209,458,21,21,Player A
2142,PatternLearningPlayer,304,184,488,33,15,Player A
2143,PatternLearningPlayer,279,199,478,26,16,Player A
2144,PatternLearningPlayer,295,220,515,36,7,Player A
2145,PatternLearningPlayer,296,216,512,45,11,Player A
2146,PatternLearningPlayer,303,203,506,36,10,Player A
2147,PatternLearningPlayer,271,201,472,32,20,Player A
2148,PatternLearningPlayer,285,200,485,33,16,Player A
2149,PatternLearningPlayer,251,211,462,37,25,Player A
2150,PatternLearningPlayer,265,215,480,31,17,Player A
2151,PatternLearningPlayer,317,192,509,36,9,Player A
2152,PatternLearningPlayer,232,217,449,21,24,Player A
2153,PatternLearningPlayer,342,192,534,49,5,Player A
2154,PatternLearningPlayer,259,214,473,33,20,Player A
2155,PatternLearningPlayer,315,210,525,46,7,Player A
2156,PatternLearningPlayer,274,199,473,27,18,Player A
2157,PatternLearningPlayer,282,212,494,36,14,Player A
2158,PatternLearningPlayer,260,205,465,28,21,Player A
2159,PatternLearningPlayer,291,206,497,45,16,Player A
2160,PatternLearningPlayer,301,191,492,40,16,Player A
2161,PatternLearningPlayer,288,198,486,37,17,Player A
2162,PatternLearningPlayer,243,238,481,32,17,Player A
2163,PatternLearningPlayer,208,228,436,20,28,PatternLearningPlayer
2164,PatternLearningPlayer,311,201,512,39,9,Player A
2165,PatternLearningPlayer,236,216,452,18,22,Player A
2166,PatternLearningPlayer,260,220,480,37,19,Player A
2167,PatternLearningPlayer,329,189,518,48,10,Player A
2168,PatternLearningPlayer,209,209,418,20,34,Tie
2169,PatternLearningPlayer,195,215,410,12,34,PatternLearningPlayer
2170,PatternLearningPlayer,189,209,398,9,37,PatternLearningPlayer
2171,PatternLearningPlayer,277,217,494,36,14,Player A
2172,PatternLearningPlayer,206,216,422,21,33,PatternLearningPlayer
2173,PatternLearningPlayer,204,204,408,19,37,Tie
2174,PatternLearningPlayer,167,227,394,8,38,PatternLearningPlayer
2175,PatternLearningPlayer,300,190,490,29,13,Player A
2176,PatternLearningPlayer,244,219,463,29,22,Player A
2177,PatternLearningPlayer,279,219,498,46,16,Player A
2178,PatternLearningPlayer,227,217,444,22,26,Player A
2179,PatternLearningPlayer,221,216,437,21,28,Player A
2180,PatternLearningPlayer,197,232,429,19,30,PatternLearningPlayer
2181,PatternLearningPlayer,347,202,549,52,1,Player A
2182,PatternLearningPlayer,254,189,443,24,27,Player A
2183,PatternLearningPlayer,283,218,501,37,12,Player A
2184,PatternLearningPlayer,241,216,457,20,21,Player A
2185,PatternLearningPlayer,272,187,459,31,24,Player A
2186,PatternLearningPlayer,238,198,436,23,29,Player A
2187,PatternLearningPlayer,297,192,489,43,18,Player A
2188,PatternLearningPlayer,270,200,470,27,19,Player A
2189,PatternLearningPlayer,274,219,493,32,13,Player A
2190,PatternLearningPlayer,194,219,413,15,34,PatternLearningPlayer
2191,PatternLearningPlayer,285,210,495,31,12,Player A
2192,PatternLearningPlayer,233,188,421,17,32,Player A
2193,PatternLearningPlayer,265,235,500,36,12,Player A
2194,PatternLearningPlayer,232,222,454,26,24,Player A
2195,PatternLearningPlayer,236,216,452,24,24,Player A
2196,PatternLearningPlayer,299,199,498,40,14,Player A
2197,PatternLearningPlayer,270,205,475,29,18,Player A
2198,PatternLearningPlayer,257,212,469,26,19,Player A
2199,PatternLearningPlayer,214,229,443,21,26,PatternLearningPlayer
2200,PatternLearningPlayer,226,216,442,26,28,Player A
2201,PatternLearningPlayer,228,233,461,24,21,PatternLearningPlayer
2202,PatternLearningPlayer,279,199,478,32,18,Player A
2203,PatternLearningPlayer,257,212,469,29,20,Player A
2204,PatternLearningPlayer,198,183,381,13,44,Player A
2205,PatternLearningPlayer,312,197,509,39,10,Player A
2206,PatternLearningPlayer,230,215,445,20,25,Player A
2207,PatternLearningPlayer,229,209,438,16,26,Player A
2208,PatternLearningPlayer,206,211,417,19,34,PatternLearningPlayer
2209,PatternLearningPlayer,265,220,485,33,16,Player A
2210,PatternLearningPlayer,257,202,459,25,22,Player A
2211,PatternLearningPlayer,295,190,485,33,16,Player A
2212,PatternLearningPlayer,246,221,467,24,19,Player A
2213,PatternLearningPlayer,239,209,448,20,24,Player A
2214,PatternLearningPlayer,282,217,499,35,12,Player A
2215,PatternLearningPlayer,223,218,441,22,27,Player A
2216,PatternLearningPlayer,311,201,512,48,12,Player A
2217,PatternLearningPlayer,252,222,474,25,17,Player A
2218,PatternLearningPlayer,336,176,512,42,10,Player A
2219,PatternLearningPlayer,200,210,410,15,35,PatternLearningPlayer
2220,PatternLearningPlayer,272,217,489,37,16,Player A
2221,PatternLearningPlayer,162,222,384,10,42,PatternLearningPlayer
2222,PatternLearningPlayer,251,221,472,26,18,Player A
2223,PatternLearningPlayer,297,207,504,46,14,Player A
2224,PatternLearningPlayer,252,212,464,30,22,Player A
2225,PatternLearningPlayer,193,218,411,16,35,PatternLearningPlayer
2226,PatternLearningPlayer,308,188,496,41,15,Player A
2227,PatternLearningPlayer,223,208,431,18,29,Player A
2228,PatternLearningPlayer,294,209,503,39,12,Player A
2229,PatternLearningPlayer,261,206,467,36,23,Player A
2230,PatternLearningPlayer,316,191,507,34,9,Player A
2231,PatternLearningPlayer,240,220,460,26,22,Player A
2232,PatternLearningPlayer,193,208,401,15,38,PatternLearningPlayer
2233,PatternLearningPlayer,301,186,487,32,15,Player A
2234,PatternLearningPlayer,245,210,455,30,25,Player A
2235,PatternLearningPlayer,240,210,450,22,24,Player A
2236,PatternLearningPlayer,194,224,418,17,33,PatternLearningPlayer
2237,PatternLearningPlayer,295,185,480,31,17,Player A
2238,PatternLearningPlayer,257,207,464,27,21,Player A
2239,PatternLearningPlayer,310,205,515,42,9,Player A
2240,PatternLearningPlayer,302,207,509,30,7,Player A
2241,PatternLearningPlayer,278,193,471,34,21,Player A
2242,PatternLearningPlayer,264,204,468,37,23,Player A
2243,PatternLearningPlayer,239,199,438,22,28,Player A
2244,PatternLearningPlayer,224,209,433,23,30,Player A
2245,PatternLearningPlayer,277,227,504,40,12,Player A
2246,PatternLearningPlayer,315,195,510,40,10,Player A
2247,PatternLearningPlayer,222,232,454,29,25,PatternLearningPlayer
2248,PatternLearningPlayer,204,219,423,16,31,PatternLearningPlayer
2249,PatternLearningPlayer,236,226,462,25,21,Player A
2250,PatternLearningPlayer,285,215,500,36,12,Player A
2251,PatternLearningPlayer,259,219,478,26,16,Player A
2252,PatternLearningPlayer,238,203,441,25,28,Player A
2253,PatternLearningPlayer,196,231,427,17,30,PatternLearningPlayer
2254,PatternLearningPlayer,258,198,456,28,24,Player A
2255,PatternLearningPlayer,277,197,474,31,19,Player A
2256,PatternLearningPlayer,309,199,508,44,12,Player A
2257,PatternLearningPlayer,297,207,504,28,8,Player A
2258,PatternLearningPlayer,208,228,436,17,27,PatternLearningPlayer
2259,PatternLearningPlayer,186,221,407,12,35,PatternLearningPlayer
2260,PatternLearningPlayer,257,207,464,24,20,Player A
2261,PatternLearningPlayer,263,198,461,33,24,Player A
2262,PatternLearningPlayer,248,208,456,22,22,Player A
2263,PatternLearningPlayer,264,204,468,25,19,Player A
2264,PatternLearningPlayer,227,222,449,24,25,Player A
2265,PatternLearningPlayer,318,193,511,41,10,Player A
2266,PatternLearningPlayer,261,211,472,29,19,Player A
2267,PatternLearningPlayer,285,220,505,38,11,Player A
2268,PatternLearningPlayer,258,218,476,30,18,Player A
2269,PatternLearningPlayer,259,219,478,29,17,Player A
2270,PatternLearningPlayer,236,191,427,20,31,Player A
2271,PatternLearningPlayer,246,206,452,30,26,Player A
2272,PatternLearningPlayer,198,208,406,14,36,PatternLearningPlayer
2273,PatternLearningPlayer,310,185,495,40,15,Player A
2274,PatternLearningPlayer,267,222,489,34,15,Player A
2275,PatternLearningPlayer,163,218,381,13,44,PatternLearningPlayer
2276,PatternLearningPlayer,282,202,484,35,17,Player A
2277,PatternLearningPlayer,237,202,439,23,28,Player A
2278,PatternLearningPlayer,251,216,467,30,21,Player A
2279,PatternLearningPlayer,258,218,476,33,19,Player A
2280,PatternLearningPlayer,284,189,473,33,20,Player A
2281,PatternLearningPlayer,296,206,502,41,13,Player A
2282,PatternLearningPlayer,292,202,494,39,15,Player A
2283,PatternLearningPlayer,304,209,513,40,9,Player A
2284,PatternLearningPlayer,246,211,457,29,24,Player A
2285,PatternLearningPlayer,262,222,484,35,17,Player A
2286,PatternLearningPlayer,234,219,453,28,25,Player A
2287,PatternLearningPlayer,238,213,451,23,24,Player A
2288,PatternLearningPlayer,295,195,490,35,15,Player A
2289,PatternLearningPlayer,267,197,464,27,21,Player A
2290,PatternLearningPlayer,280,215,495,34,13,Player A
2291,PatternLearningPlayer,225,225,450,25,25,Tie
2292,PatternLearningPlayer,340,185,525,46,7,Player A
2293,PatternLearningPlayer,231,206,437,18,27,Player A
2294,PatternLearningPlayer,312,187,499,38,13,Player A
2295,PatternLearningPlayer,175,200,375,10,45,PatternLearningPlayer
2296,PatternLearningPlayer,197,232,429,22,31,PatternLearningPlayer
2297,PatternLearningPlayer,249,214,463,35,24,Player A
2298,PatternLearningPlayer,281,206,487,32,15,Player A
2299,PatternLearningPlayer,185,220,405,13,36,PatternLearningPlayer
2300,PatternLearningPlayer,264,224,488,36,16,Player A
2301,PatternLearningPlayer,266,201,467,21,18,Player A
2302,PatternLearningPlayer,235,215,450,31,27,Player A
2303,PatternLearningPlayer,307,207,514,41,9,Player A
2304,PatternLearningPlayer,233,208,441,22,27,Player A
2305,PatternLearningPlayer,289,194,483,28,15,Player A
2306,PatternLearningPlayer,230,235,465,28,21,PatternLearningPlayer
2307,PatternLearningPlayer,244,224,468,25,19,Player A
2308,PatternLearningPlayer,297,217,514,44,10,Player A
2309,PatternLearningPlayer,226,206,432,19,29,Player A
2310,PatternLearningPlayer,321,186,507,37,10,Player A
2311,PatternLearningPlayer,283,198,481,35,18,Player A
2312,PatternLearningPlayer,254,229,483,31,16,Player A
2313,PatternLearningPlayer,312,202,514,38,8,Player A
2314,PatternLearningPlayer,265,230,495,31,12,Player A
2315,PatternLearningPlayer,222,222,444,16,24,Tie
2316,PatternLearningPlayer,342,207,549,58,3,Player A
2317,PatternLearningPlayer,258,208,466,26,20,Player A
2318,PatternLearningPlayer,230,225,455,21,22,Player A
2319,PatternLearningPlayer,222,247,469,29,20,PatternLearningPlayer
2320,PatternLearningPlayer,245,215,460,26,22,Player A
2321,PatternLearningPlayer,284,204,488,30,14,Player A
2322,PatternLearningPlayer,290,215,505,32,9,Player A
2323,PatternLearningPlayer,309,199,508,41,11,Player A
2324,PatternLearningPlayer,187,222,409,20,37,PatternLearningPlayer
2325,PatternLearningPlayer,282,212,494,33,13,Player A
2326,PatternLearningPlayer,297,192,489,31,14,Player A
2327,PatternLearningPlayer,244,209,453,22,23,Player A
2328,PatternLearningPlayer,218,213,431,18,29,Player A
2329,PatternLearningPlayer,306,186,492,37,15,Player A
2330,PatternLearningPlayer,233,208,441,19,26,Player A
2331,PatternLearningPlayer,251,206,457,23,22,Player A
2332,PatternLearningPlayer,203,218,421,14,31,PatternLearningPlayer
2333,PatternLearningPlayer,257,217,474,28,18,Player A
2334,PatternLearningPlayer,237,232,469,35,22,Player A
2335,PatternLearningPlayer,277,197,474,31,19,Player A
2336,PatternLearningPlayer,271,221,492,34,14,Player A
2337,PatternLearningPlayer,269,219,488,39,17,Player A
2338,PatternLearningPlayer,259,194,453,22,23,Player A
2339,PatternLearningPlayer,329,209,538,53,5,Player A
2340,PatternLearningPlayer,246,236,482,33,17,Player A
2341,PatternLearningPlayer,296,181,477,34,19,Player A
2342,PatternLearningPlayer,224,204,428,15,29,Player A
2343,PatternLearningPlayer,249,209,458,27,23,Player A
2344,PatternLearningPlayer,255,200,455,33,26,Player A
2345,PatternLearningPlayer,284,194,478,29,17,Player A
2346,PatternLearningPlayer,189,214,403,11,36,PatternLearningPlayer
2347,PatternLearningPlayer,294,199,493,35,14,Player A
2348,PatternLearningPlayer,319,219,538,53,5,Player A
2349,PatternLearningPlayer,284,204,488,39,17,Player A
2350,PatternLearningPlayer,290,205,495,40,15,Player A
2351,PatternLearningPlayer,218,218,436,23,29,Tie
2352,PatternLearningPlayer,253,193,446,21,25,Player A
2353,PatternLearningPlayer,197,212,409,14,35,PatternLearningPlayer
2354,PatternLearningPlayer,297,192,489,40,17,Player A
2355,PatternLearningPlayer,186,236,422,18,32,PatternLearningPlayer
2356,PatternLearningPlayer,296,206,502,38,12,Player A
2357,PatternLearningPlayer,317,197,514,38,8,Player A
2358,PatternLearningPlayer,298,198,496,41,15,Player A
2359,PatternLearningPlayer,278,193,471,31,20,Player A
2360,PatternLearningPlayer,317,207,524,39,5,Player A
2361,PatternLearningPlayer,254,194,448,29,27,Player A
2362,PatternLearningPlayer,199,214,413,15,34,PatternLearningPlayer
2363,PatternLearningPlayer,320,185,505,38,11,Player A
2364,PatternLearningPlayer,264,194,458,33,25,Player A
2365,PatternLearningPlayer,227,217,444,28,28,Player A
2366,PatternLearningPlayer,252,202,454,23,23,Player A
2367,PatternLearningPlayer,296,201,497,33,12,Player A
2368,PatternLearningPlayer,232,237,469,32,21,PatternLearningPlayer
2369,PatternLearningPlayer,226,216,442,20,26,Player A
2370,PatternLearningPlayer,311,191,502,38,12,Player A
2371,PatternLearningPlayer,281,216,497,33,12,Player A
2372,PatternLearningPlayer,261,216,477,31,18,Player A
2373,PatternLearningPlayer,264,204,468,28,20,Player A
2374,PatternLearningPlayer,320,190,510,46,12,Player A
2375,PatternLearningPlayer,236,226,462,28,22,Player A
2376,PatternLearningPlayer,259,229,488,27,13,Player A
2377,PatternLearningPlayer,266,196,462,28,22,Player A
2378,PatternLearningPlayer,238,208,446,21,25,Player A
2379,PatternLearningPlayer,265,205,470,33,21,Player A
2380,PatternLearningPlayer,202,222,424,20,32,PatternLearningPlayer
2381,PatternLearningPlayer,243,198,441,25,28,Player A
2382,PatternLearningPlayer,267,207,474,25,17,Player A
2383,PatternLearningPlayer,339,189,528,40,4,Player A
2384,PatternLearningPlayer,233,213,446,33,29,Player A
2385,PatternLearningPlayer,297,187,484,26,14,Player A
2386,PatternLearningPlayer,195,220,415,14,33,PatternLearningPlayer
2387,PatternLearningPlayer,238,208,446,24,26,Player A
2388,PatternLearningPlayer,212,217,429,19,30,PatternLearningPlayer
2389,PatternLearningPlayer,227,202,429,19,30,Player A
2390,PatternLearningPlayer,301,206,507,34,9,Player A
2391,PatternLearningPlayer,298,208,506,42,12,Player A
2392,PatternLearningPlayer,231,201,432,22,30,Player A
2393,PatternLearningPlayer,291,201,492,37,15,Player A
2394,PatternLearningPlayer,181,226,407,21,38,PatternLearningPlayer
2395,PatternLearningPlayer,156,251,407,9,34,PatternLearningPlayer
2396,PatternLearningPlayer,230,215,445,23,26,Player A
2397,PatternLearningPlayer,247,222,469,29,20,Player A
2398,PatternLearningPlayer,297,207,504,34,10,Player A
2399,PatternLearningPlayer,275,195,470,30,20,Player A
2400,PatternLearningPlayer,186,221,407,15,36,PatternLearningPlayer
2401,PatternLearningPlayer,197,222,419,15,32,PatternLearningPlayer
2402,PatternLearningPlayer,266,211,477,25,16,Player A
2403,PatternLearningPlayer,321,216,537,49,4,Player A
2404,PatternLearningPlayer,203,213,416,15,33,PatternLearningPlayer
2405,PatternLearningPlayer,255,210,465,25,20,Player A
2406,PatternLearningPlayer,235,210,445,26,27,Player A
2407,PatternLearningPlayer,299,199,498,34,12,Player A
2408,PatternLearningPlayer,267,222,489,28,13,Player A
2409,PatternLearningPlayer,207,222,429,16,29,PatternLearningPlayer
2410,PatternLearningPlayer,229,224,453,25,24,Player A
2411,PatternLearningPlayer,238,203,441,22,27,Player A
2412,PatternLearningPlayer,268,238,506,45,13,Player A
2413,PatternLearningPlayer,254,234,488,42,18,Player A
2414,PatternLearningPlayer,260,215,475,29,18,Player A
2415,PatternLearningPlayer,224,214,438,25,29,Player A
2416,PatternLearningPlayer,233,218,451,23,24,Player A
2417,PatternLearningPlayer,219,229,448,20,24,PatternLearningPlayer
2418,PatternLearningPlayer,269,209,478,29,17,Player A
2419,PatternLearningPlayer,271,221,492,31,13,Player A
2420,PatternLearningPlayer,330,185,515,45,10,Player A
2421,PatternLearningPlayer,208,238,446,21,25,PatternLearningPlayer
2422,PatternLearningPlayer,302,197,499,35,12,Player A
2423,PatternLearningPlayer,257,202,459,34,25,Player A
2424,PatternLearningPlayer,242,217,459,25,22,Player A
2425,PatternLearningPlayer,310,215,525,43,6,Player A
2426,PatternLearningPlayer,264,204,468,28,20,Player A
2427,PatternLearningPlayer,329,209,538,50,4,Player A
2428,PatternLearningPlayer,245,220,465,28,21,Player A
2429,PatternLearningPlayer,226,206,432,22,30,Player A
2430,PatternLearningPlayer,254,199,453,28,25,Player A
2431,PatternLearningPlayer,279,194,473,24,17,Player A
2432,PatternLearningPlayer,319,214,533,48,5,Player A
2433,PatternLearningPlayer,286,191,477,34,19,Player A
2434,PatternLearningPlayer,196,226,422,15,31,PatternLearningPlayer
2435,PatternLearningPlayer,304,204,508,41,11,Player A
2436,PatternLearningPlayer,281,196,477,34,19,Player A
2437,PatternLearningPlayer,217,217,434,24,30,Tie
2438,PatternLearningPlayer,282,207,489,40,17,Player A
2439,PatternLearningPlayer,272,202,474,31,19,Player A
2440,PatternLearningPlayer,322,187,509,36,9,Player A
2441,PatternLearningPlayer,249,219,468,28,20,Player A
2442,PatternLearningPlayer,294,194,488,39,17,Player A
2443,PatternLearningPlayer,260,210,470,33,21,Player A
2444,PatternLearningPlayer,234,214,448,23,25,Player A
2445,PatternLearningPlayer,218,223,441,22,27,PatternLearningPlayer
2446,PatternLearningPlayer,266,201,467,30,21,Player A
2447,PatternLearningPlayer,209,219,428,18,30,PatternLearningPlayer
2448,PatternLearningPlayer,314,189,503,39,12,Player A
2449,PatternLearningPlayer,299,209,508,41,11,Player A
2450,PatternLearningPlayer,239,204,443,24,27,Player A
2451,PatternLearningPlayer,246,211,457,26,23,Player A
2452,PatternLearningPlayer,241,226,467,30,21,Player A
2453,PatternLearningPlayer,257,212,469,29,20,Player A
2454,PatternLearningPlayer,226,211,437,24,29,Player A
2455,PatternLearningPlayer,285,205,490,41,17,Player A
2456,PatternLearningPlayer,253,213,466,29,21,Player A
2457,PatternLearningPlayer,298,208,506,36,10,Player A
2458,PatternLearningPlayer,249,214,463,23,20,Player A
2459,PatternLearningPlayer,239,209,448,26,26,Player A
2460,PatternLearningPlayer,248,203,451,26,25,Player A
2461,PatternLearningPlayer,286,206,492,31,13,Player A
2462,PatternLearningPlayer,311,211,522,43,7,Player A
2463,PatternLearningPlayer,282,207,489,37,16,Player A
2464,PatternLearningPlayer,253,213,466,20,18,Player A
2465,PatternLearningPlayer,231,201,432,22,30,Player A
2466,PatternLearningPlayer,255,210,465,28,21,Player A
2467,PatternLearningPlayer,309,164,473,33,20,Player A
2468,PatternLearningPlayer,268,218,486,34,16,Player A
2469,PatternLearningPlayer,313,198,511,41,10,Player A
2470,PatternLearningPlayer,242,232,474,31,19,Player A
2471,PatternLearningPlayer,250,210,460,26,22,Player A
2472,PatternLearningPlayer,270,205,475,29,18,Player A
2473,PatternLearningPlayer,255,225,480,31,17,Player A
2474,PatternLearningPlayer,310,190,500,39,13,Player A
2475,PatternLearningPlayer,280,215,495,37,14,Player A
2476,PatternLearningPlayer,211,231,442,23,27,PatternLearningPlayer
2477,PatternLearningPlayer,315,185,500,39,13,Player A
2478,PatternLearningPlayer,278,198,476,30,18,Player A
2479,PatternLearningPlayer,169,209,378,13,45,PatternLearningPlayer
2480,PatternLearningPlayer,227,227,454,17,21,Tie
2481,PatternLearningPlayer,277,197,474,31,19,Player A
2482,PatternLearningPlayer,236,206,442,20,26,Player A
2483,PatternLearningPlayer,271,216,487,32,15,Player A
2484,PatternLearningPlayer,314,199,513,37,8,Player A
2485,PatternLearningPlayer,256,216,472,32,20,Player A
2486,PatternLearningPlayer,243,223,466,29,21,Player A
2487,PatternLearningPlayer,235,215,450,25,25,Player A
2488,PatternLearningPlayer,234,214,448,26,26,Player A
2489,PatternLearningPlayer,264,224,488,33,15,Player A
2490,PatternLearningPlayer,304,184,488,36,16,Player A
2491,PatternLearningPlayer,253,193,446,24,26,Player A
2492,PatternLearningPlayer,243,213,456,22,22,Player A
2493,PatternLearningPlayer,336,191,527,42,5,Player A
2494,PatternLearningPlayer,269,214,483,40,19,Player A
2495,PatternLearningPlayer,305,195,500,39,13,Player A
2496,PatternLearningPlayer,298,183,481,35,18,Player A
2497,PatternLearningPlayer,356,191,547,53,2,Player A
2498,PatternLearningPlayer,238,213,451,29,26,Player A
2499,PatternLearningPlayer,232,227,459,31,24,Player A
2500,PatternLearningPlayer,179,214,393,16,41,PatternLearningPlayer
2501,PatternLearningPlayer,182,217,399,16,39,PatternLearningPlayer
2502,PatternLearningPlayer,244,204,448,23,25,Player A
2503,PatternLearningPlayer,271,221,492,25,11,Player A
2504,PatternLearningPlayer,338,208,546,55,3,Player A
2505,PatternLearningPlayer,186,236,422,6,28,PatternLearningPlayer
2506,PatternLearningPlayer,273,208,481,35,18,Player A
2507,PatternLearningPlayer,289,204,493,38,15,Player A
2508,PatternLearningPlayer,259,189,448,23,25,Player A
2509,PatternLearningPlayer,204,214,418,17,33,PatternLearningPlayer
2510,PatternLearningPlayer,278,228,506,36,10,Player A
2511,PatternLearningPlayer,201,211,412,14,34,PatternLearningPlayer
2512,PatternLearningPlayer,266,201,467,27,20,Player A
2513,PatternLearningPlayer,295,195,490,29,13,Player A
2514,PatternLearningPlayer,245,220,465,31,22,Player A
2515,PatternLearningPlayer,273,188,461,27,22,Player A
2516,PatternLearningPlayer,229,209,438,25,29,Player A
2517,PatternLearningPlayer,197,242,439,23,28,PatternLearningPlayer
2518,PatternLearningPlayer,305,195,500,39,13,Player A
2519,PatternLearningPlayer,265,210,475,32,19,Player A
2520,PatternLearningPlayer,265,210,475,35,20,Player A
2521,PatternLearningPlayer,258,228,486,31,15,Player A
2522,PatternLearningPlayer,198,243,441,19,26,PatternLearningPlayer
2523,PatternLearningPlayer,249,189,438,22,28,Player A
2524,PatternLearningPlayer,214,239,453,25,24,PatternLearningPlayer
2525,PatternLearningPlayer,187,217,404,12,36,PatternLearningPlayer
2526,PatternLearningPlayer,298,208,506,39,11,Player A
2527,PatternLearningPlayer,232,232,464,27,21,Tie
2528,PatternLearningPlayer,321,186,507,40,11,Player A
2529,PatternLearningPlayer,264,219,483,34,17,Player A
2530,PatternLearningPlayer,271,216,487,32,15,Player A
2531,PatternLearningPlayer,266,216,482,24,14,Player A
2532,PatternLearningPlayer,219,219,438,22,28,Tie
2533,PatternLearningPlayer,258,193,451,26,25,Player A
2534,PatternLearningPlayer,309,184,493,35,14,Player A
2535,PatternLearningPlayer,310,190,500,39,13,Player A
2536,PatternLearningPlayer,290,205,495,37,14,Player A
2537,PatternLearningPlayer,248,213,461,27,22,Player A
2538,PatternLearningPlayer,273,203,476,27,17,Player A
2539,PatternLearningPlayer,247,202,449,27,26,Player A
2540,PatternLearningPlayer,200,210,410,12,34,PatternLearningPlayer
2541,PatternLearningPlayer,286,196,482,33,17,Player A
2542,PatternLearningPlayer,296,226,522,46,8,Player A
2543,PatternLearningPlayer,263,198,461,27,22,Player A
2544,PatternLearningPlayer,256,221,477,28,17,Player A
2545,PatternLearningPlayer,287,202,489,34,15,Player A
2546,PatternLearningPlayer,262,212,474,31,19,Player A
2547,PatternLearningPlayer,320,200,520,38,6,Player A
2548,PatternLearningPlayer,217,237,454,20,22,PatternLearningPlayer
2549,PatternLearningPlayer,245,225,470,27,19,Player A
2550,PatternLearningPlayer,292,192,484,35,17,Player A
2551,PatternLearningPlayer,318,203,521,45,8,Player A
2552,PatternLearningPlayer,297,192,489,43,18,Player A
2553,PatternLearningPlayer,284,204,488,39,17,Player A
2554,PatternLearningPlayer,273,203,476,33,19,Player A
2555,PatternLearningPlayer,289,174,463,32,23,Player A
2556,PatternLearningPlayer,310,190,500,36,12,Player A
2557,PatternLearningPlayer,305,215,520,44,8,Player A
2558,PatternLearningPlayer,245,215,460,26,22,Player A
2559,PatternLearningPlayer,272,202,474,34,20,Player A
2560,PatternLearningPlayer,284,204,488,42,18,Player A
2561,PatternLearningPlayer,262,212,474,34,20,Player A
2562,PatternLearningPlayer,243,218,461,21,20,Player A
2563,PatternLearningPlayer,282,212,494,33,13,Player A
2564,PatternLearningPlayer,259,209,468,31,21,Player A
2565,PatternLearningPlayer,309,209,518,45,9,Player A
2566,PatternLearningPlayer,275,225,500,45,15,Player A
2567,PatternLearningPlayer,278,228,506,42,12,Player A
2568,PatternLearningPlayer,247,212,459,25,22,Player A
2569,PatternLearningPlayer,201,221,422,15,31,PatternLearningPlayer
2570,PatternLearningPlayer,244,204,448,23,25,Player A
2571,PatternLearningPlayer,295,185,480,37,19,Player A
2572,PatternLearningPlayer,214,224,438,22,28,PatternLearningPlayer
2573,PatternLearningPlayer,289,214,503,45,14,Player A
2574,PatternLearningPlayer,283,193,476,33,19,Player A
2575,PatternLearningPlayer,306,201,507,37,10,Player A
2576,PatternLearningPlayer,270,190,460,29,23,Player A
2577,PatternLearningPlayer,272,212,484,26,14,Player A
2578,PatternLearningPlayer,301,206,507,37,10,Player A
2579,PatternLearningPlayer,277,212,489,34,15,Player A
2580,PatternLearningPlayer,257,212,469,29,20,Player A
2581,PatternLearningPlayer,283,198,481,35,18,Player A
2582,PatternLearningPlayer,267,207,474,31,19,Player A
2583,PatternLearningPlayer,208,218,426,19,31,PatternLearningPlayer
2584,PatternLearningPlayer,247,197,444,31,29,Player A
2585,PatternLearningPlayer,276,211,487,32,15,Player A
2586,PatternLearningPlayer,237,222,459,25,22,Player A
2587,PatternLearningPlayer,305,195,500,33,11,Player A
2588,PatternLearningPlayer,325,195,520,44,8,Player A
2589,PatternLearningPlayer,301,196,497,33,12,Player A
2590,PatternLearningPlayer,229,199,428,21,31,Player A
2591,PatternLearningPlayer,315,190,505,32,9,Player A
2592,PatternLearningPlayer,269,209,478,32,18,Player A
2593,PatternLearningPlayer,303,198,501,28,9,Player A
2594,PatternLearningPlayer,293,208,501,34,11,Player A
2595,PatternLearningPlayer,247,227,474,28,18,Player A
2596,PatternLearningPlayer,215,230,445,23,26,PatternLearningPlayer
2597,PatternLearningPlayer,258,213,471,28,19,Player A
2598,PatternLearningPlayer,263,223,486,37,17,Player A
2599,PatternLearningPlayer,268,203,471,31,20,Player A
2600,PatternLearningPlayer,174,199,373,11,46,PatternLearningPlayer
2601,PatternLearningPlayer,273,193,466,26,20,Player A
2602,PatternLearningPlayer,261,206,467,33,22,Player A
2603,PatternLearningPlayer,244,199,443,24,27,Player A
2604,PatternLearningPlayer,264,214,478,35,19,Player A
2605,PatternLearningPlayer,252,222,474,25,17,Player A
2606,PatternLearningPlayer,241,211,452,24,24,Player A
2607,PatternLearningPlayer,250,220,470,30,20,Player A
2608,PatternLearningPlayer,254,214,468,31,21,Player A
2609,PatternLearningPlayer,258,218,476,30,18,Player A
2610,PatternLearningPlayer,173,218,391,8,39,PatternLearningPlayer
2611,PatternLearningPlayer,190,215,405,19,38,PatternLearningPlayer
2612,PatternLearningPlayer,288,193,481,32,17,Player A
2613,PatternLearningPlayer,183,233,416,15,33,PatternLearningPlayer
2614,PatternLearningPlayer,246,226,472,35,21,Player A
2615,PatternLearningPlayer,278,208,486,31,15,Player A
2616,PatternLearningPlayer,322,177,499,35,12,Player A
2617,PatternLearningPlayer,274,214,488,36,16,Player A
2618,PatternLearningPlayer,255,210,465,34,23,Player A
2619,PatternLearningPlayer,290,195,485,42,19,Player A
2620,PatternLearningPlayer,317,192,509,36,9,Player A
2621,PatternLearningPlayer,252,207,459,22,21,Player A
2622,PatternLearningPlayer,279,214,493,41,16,Player A
2623,PatternLearningPlayer,264,204,468,31,21,Player A
2624,PatternLearningPlayer,262,212,474,31,19,Player A
2625,PatternLearningPlayer,271,186,457,26,23,Player A
2626,PatternLearningPlayer,174,214,388,8,40,PatternLearningPlayer
2627,PatternLearningPlayer,286,216,502,38,12,Player A
2628,PatternLearningPlayer,273,193,466,26,20,Player A
2629,PatternLearningPlayer,281,236,517,44,9,Player A
2630,PatternLearningPlayer,239,214,453,22,23,Player A
2631,PatternLearningPlayer,258,223,481,38,19,Player A
2632,PatternLearningPlayer,230,230,460,29,23,Tie
2633,PatternLearningPlayer,252,202,454,23,23,Player A
2634,PatternLearningPlayer,323,203,526,41,5,Player A
2635,PatternLearningPlayer,242,222,464,30,22,Player A
2636,PatternLearningPlayer,260,220,480,34,18,Player A
2637,PatternLearningPlayer,248,203,451,26,25,Player A
2638,PatternLearningPlayer,288,203,491,33,14,Player A
2639,PatternLearningPlayer,246,211,457,26,23,Player A
2640,PatternLearningPlayer,297,207,504,43,13,Player A
2641,PatternLearningPlayer,313,183,496,38,14,Player A
2642,PatternLearningPlayer,261,196,457,26,23,Player A
2643,PatternLearningPlayer,212,232,444,19,25,PatternLearningPlayer
2644,PatternLearningPlayer,308,198,506,39,11,Player A
2645,PatternLearningPlayer,282,202,484,38,18,Player A
2646,PatternLearningPlayer,299,214,513,49,12,Player A
2647,PatternLearningPlayer,224,224,448,23,25,Tie
2648,PatternLearningPlayer,306,196,502,41,13,Player A
2649,PatternLearningPlayer,262,222,484,32,16,Player A
2650,PatternLearningPlayer,263,208,471,31,20,Player A
2651,PatternLearningPlayer,246,231,477,34,19,Player A
2652,PatternLearningPlayer,274,209,483,28,15,Player A
2653,PatternLearningPlayer,273,193,466,29,21,Player A
2654,PatternLearningPlayer,286,211,497,33,12,Player A
2655,PatternLearningPlayer,315,200,515,39,8,Player A
2656,PatternLearningPlayer,292,197,489,34,15,Player A
2657,PatternLearningPlayer,276,201,477,34,19,Player A
2658,PatternLearningPlayer,254,224,478,35,19,Player A
2659,PatternLearningPlayer,264,204,468,31,21,Player A
2660,PatternLearningPlayer,225,205,430,23,31,Player A
2661,PatternLearningPlayer,271,221,492,31,13,Player A
2662,PatternLearningPlayer,231,211,442,23,27,Player A
2663,PatternLearningPlayer,196,216,412,17,35,PatternLearningPlayer
2664,PatternLearningPlayer,229,209,438,25,29,Player A
2665,PatternLearningPlayer,242,217,459,22,21,Player A
2666,PatternLearningPlayer,329,199,528,43,5,Player A
2667,PatternLearningPlayer,187,222,409,17,36,PatternLearningPlayer
2668,PatternLearningPlayer,318,198,516,37,7,Player A
2669,PatternLearningPlayer,300,185,485,30,15,Player A
2670,PatternLearningPlayer,268,208,476,30,18,Player A
2671,PatternLearningPlayer,261,226,487,32,15,Player A
2672,PatternLearningPlayer,313,228,541,53,4,Player A
2673,PatternLearningPlayer,345,205,550,56,2,Player A
2674,PatternLearningPlayer,220,230,450,19,23,PatternLearningPlayer
2675,PatternLearningPlayer,273,208,481,35,18,Player A
2676,PatternLearningPlayer,294,189,483,37,18,Player A
2677,PatternLearningPlayer,264,204,468,28,20,Player A
2678,PatternLearningPlayer,298,208,506,39,11,Player A
2679,PatternLearningPlayer,281,211,492,34,14,Player A
2680,PatternLearningPlayer,298,188,486,37,17,Player A
2681,PatternLearningPlayer,269,209,478,35,19,Player A
2682,PatternLearningPlayer,220,210,430,14,28,Player A
2683,PatternLearningPlayer,235,200,435,19,28,Player A
2684,PatternLearningPlayer,242,202,444,25,27,Player A
2685,PatternLearningPlayer,283,203,486,34,16,Player A
2686,PatternLearningPlayer,276,201,477,34,19,Player A
2687,PatternLearningPlayer,236,221,457,23,22,Player A
2688,PatternLearningPlayer,315,180,495,40,15,Player A
2689,PatternLearningPlayer,230,220,450,28,26,Player A
2690,PatternLearningPlayer,245,215,460,23,21,Player A
2691,PatternLearningPlayer,298,223,521,45,8,Player A
2692,PatternLearningPlayer,246,221,467,21,18,Player A
2693,PatternLearningPlayer,287,207,494,36,14,Player A
2694,PatternLearningPlayer,246,226,472,35,21,Player A
2695,PatternLearningPlayer,222,227,449,18,23,PatternLearningPlayer
2696,PatternLearningPlayer,301,201,502,35,11,Player A
2697,PatternLearningPlayer,270,200,470,33,21,Player A
2698,PatternLearningPlayer,234,219,453,22,23,Player A
2699,PatternLearningPlayer,244,224,468,28,20,Player A
2700,PatternLearningPlayer,284,204,488,30,14,Player A
2701,PatternLearningPlayer,241,196,437,27,30,Player A
2702,PatternLearningPlayer,239,239,478,29,17,Tie
2703,PatternLearningPlayer,252,227,479,27,16,Player A
2704,PatternLearningPlayer,272,212,484,38,18,Player A
2705,PatternLearningPlayer,260,225,485,36,17,Player A
2706,PatternLearningPlayer,221,221,442,20,26,Tie
2707,PatternLearningPlayer,242,212,454,20,22,Player A
2708,PatternLearningPlayer,261,211,472,32,20,Player A
2709,PatternLearningPlayer,198,228,426,16,30,PatternLearningPlayer
2710,PatternLearningPlayer,277,197,474,34,20,Player A
2711,PatternLearningPlayer,310,190,500,36,12,Player A
2712,PatternLearningPlayer,240,220,460,23,21,Player A
2713,PatternLearningPlayer,256,221,477,34,19,Player A
2714,PatternLearningPlayer,271,211,482,36,18,Player A
2715,PatternLearningPlayer,252,217,469,29,20,Player A
2716,PatternLearningPlayer,195,200,395,15,40,PatternLearningPlayer
2717,PatternLearningPlayer,271,191,462,28,22,Player A
2718,PatternLearningPlayer,245,215,460,29,23,Player A
2719,PatternLearningPlayer,290,190,480,31,17,Player A
2720,PatternLearningPlayer,240,205,445,20,25,Player A
2721,PatternLearningPlayer,239,204,443,24,27,Player A
2722,PatternLearningPlayer,257,207,464,21,19,Player A
2723,PatternLearningPlayer,285,195,480,34,18,Player A
2724,PatternLearningPlayer,257,202,459,28,23,Player A
2725,PatternLearningPlayer,272,222,494,39,15,Player A
2726,PatternLearningPlayer,285,195,480,34,18,Player A
2727,PatternLearningPlayer,233,213,446,24,26,Player A
2728,PatternLearningPlayer,260,210,470,33,21,Player A
2729,PatternLearningPlayer,232,232,464,21,19,Tie
2730,PatternLearningPlayer,212,227,439,23,28,PatternLearningPlayer
2731,PatternLearningPlayer,238,218,456,22,22,Player A
2732,PatternLearningPlayer,167,242,409,11,34,PatternLearningPlayer
2733,PatternLearningPlayer,229,214,443,18,25,Player A
2734,PatternLearningPlayer,273,208,481,26,15,Player A
2735,PatternLearningPlayer,271,196,467,27,20,Player A
2736,PatternLearningPlayer,259,214,473,33,20,Player A
2737,PatternLearningPlayer,270,190,460,35,25,Player A
2738,PatternLearningPlayer,205,205,410,18,36,Tie
2739,PatternLearningPlayer,285,180,465,25,20,Player A
2740,PatternLearningPlayer,265,195,460,26,22,Player A
2741,PatternLearningPlayer,301,181,482,30,16,Player A
2742,PatternLearningPlayer,272,182,454,26,24,Player A
2743,PatternLearningPlayer,291,196,487,38,17,Player A
2744,PatternLearningPlayer,250,210,460,29,23,Player A
2745,PatternLearningPlayer,192,222,414,16,34,PatternLearningPlayer
2746,PatternLearningPlayer,286,206,492,34,14,Player A
2747,PatternLearningPlayer,269,204,473,30,19,Player A
2748,PatternLearningPlayer,271,201,472,29,19,Player A
2749,PatternLearningPlayer,198,213,411,19,36,PatternLearningPlayer
2750,PatternLearningPlayer,249,209,458,24,22,Player A
2751,PatternLearningPlayer,315,190,505,44,13,Player A
2752,PatternLearningPlayer,236,216,452,27,25,Player A
2753,PatternLearningPlayer,328,203,531,43,4,Player A
2754,PatternLearningPlayer,323,198,521,39,6,Player A
2755,PatternLearningPlayer,281,186,467,33,22,Player A
2756,PatternLearningPlayer,284,209,493,41,16,Player A
2757,PatternLearningPlayer,196,206,402,16,38,PatternLearningPlayer
2758,PatternLearningPlayer,282,207,489,28,13,Player A
0,TitForTat,233,233,466,26,20,Tie
1,TitForTat,226,221,447,31,28,Player A
2,TitForTat,242,242,484,29,15,Tie
3,TitForTat,229,234,463,26,21,TitForTat
4,TitForTat,237,237,474,34,20,Tie
5,TitForTat,224,224,448,20,24,Tie
6,TitForTat,225,220,445,29,28,Player A
7,TitForTat,247,247,494,36,14,Tie
8,TitForTat,226,226,452,27,25,Tie
9,TitForTat,222,227,449,21,24,TitForTat
10,TitForTat,223,218,441,25,28,Player A
11,TitForTat,227,227,454,32,26,Tie
12,TitForTat,222,222,444,25,27,Tie
13,TitForTat,236,236,472,32,20,Tie
14,TitForTat,212,217,429,22,31,TitForTat
15,TitForTat,218,218,436,32,32,Tie
16,TitForTat,233,228,461,27,22,Player A
17,TitForTat,219,224,443,24,27,TitForTat
18,TitForTat,232,232,464,21,19,Tie
19,TitForTat,231,226,457,17,20,Player A
20,TitForTat,216,221,437,24,29,TitForTat
21,TitForTat,212,212,424,20,32,Tie
22,TitForTat,215,210,425,24,33,Player A
23,TitForTat,221,221,442,20,26,Tie
24,TitForTat,222,227,449,21,24,TitForTat
25,TitForTat,238,233,471,28,19,Player A
26,TitForTat,222,227,449,27,26,TitForTat
27,TitForTat,234,229,463,26,21,Player A
28,TitForTat,218,218,436,23,29,Tie
29,TitForTat,226,231,457,29,24,TitForTat
30,TitForTat,235,235,470,33,21,Tie
31,TitForTat,209,204,413,24,37,Player A
32,TitForTat,200,200,400,14,38,Tie
33,TitForTat,218,223,441,25,28,TitForTat
34,TitForTat,226,221,447,28,27,Player A
35,TitForTat,218,218,436,26,30,Tie
36,TitForTat,232,237,469,26,19,TitForTat
37,TitForTat,220,215,435,16,27,Player A
38,TitForTat,217,222,439,20,27,TitForTat
39,TitForTat,242,242,484,20,12,Tie
40,TitForTat,244,244,488,36,16,Tie
41,TitForTat,230,230,460,29,23,Tie
42,TitForTat,226,221,447,25,26,Player A
43,TitForTat,220,225,445,23,26,TitForTat
44,TitForTat,220,220,440,24,28,Tie
45,TitForTat,233,233,466,35,23,Tie
46,TitForTat,223,218,441,22,27,Player A
47,TitForTat,198,198,396,16,40,Tie
48,TitForTat,230,235,465,25,20,TitForTat
49,TitForTat,230,230,460,32,24,Tie
50,TitForTat,221,221,442,23,27,Tie
51,TitForTat,238,238,476,27,17,Tie
52,TitForTat,217,217,434,21,29,Tie
53,TitForTat,232,227,459,25,22,Player A
54,TitForTat,223,228,451,26,25,TitForTat
55,TitForTat,229,229,458,30,24,Tie
56,TitForTat,226,221,447,25,26,Player A
57,TitForTat,218,218,436,26,30,Tie
58,TitForTat,214,219,433,23,30,TitForTat
59,TitForTat,227,222,449,18,23,Player A
60,TitForTat,222,227,449,30,27,TitForTat
61,TitForTat,210,210,420,19,33,Tie
62,TitForTat,239,239,478,32,18,Tie
63,TitForTat,220,220,440,24,28,Tie
64,TitForTat,233,233,466,26,20,Tie
65,TitForTat,225,225,450,25,25,Tie
66,TitForTat,232,227,459,22,21,Player A
67,TitForTat,206,206,412,20,36,Tie
68,TitForTat,220,220,440,27,29,Tie
69,TitForTat,210,215,425,18,31,TitForTat
70,TitForTat,223,218,441,19,26,Player A
71,TitForTat,212,217,429,19,30,TitForTat
72,TitForTat,223,223,446,24,26,Tie
73,TitForTat,225,225,450,25,25,Tie
74,TitForTat,225,220,445,23,26,Player A
75,TitForTat,210,215,425,18,31,TitForTat
76,TitForTat,207,207,414,22,36,Tie
77,TitForTat,238,233,471,28,19,Player A
78,TitForTat,233,233,466,26,20,Tie
79,TitForTat,233,233,466,29,21,Tie
80,TitForTat,203,208,411,19,36,TitForTat
81,TitForTat,237,232,469,26,19,Player A
82,TitForTat,229,234,463,26,21,TitForTat
83,TitForTat,221,221,442,32,30,Tie
84,TitForTat,235,230,465,31,22,Player A
85,TitForTat,223,228,451,35,28,TitForTat
86,TitForTat,228,228,456,28,24,Tie
87,TitForTat,218,213,431,21,30,Player A
88,TitForTat,218,223,441,28,29,TitForTat
89,TitForTat,232,232,464,33,23,Tie
90,TitForTat,217,212,429,19,30,Player A
91,TitForTat,196,201,397,11,38,TitForTat
92,TitForTat,226,226,452,24,24,Tie
93,TitForTat,243,243,486,34,16,Tie
94,TitForTat,221,216,437,18,27,Player A
95,TitForTat,226,226,452,27,25,Tie
96,TitForTat,232,237,469,20,17,TitForTat
97,TitForTat,228,228,456,28,24,Tie
98,TitForTat,241,241,482,33,17,Tie
99,TitForTat,229,224,453,28,25,Player A
100,TitForTat,241,246,487,38,17,TitForTat
101,TitForTat,236,236,472,26,18,Tie
102,TitForTat,231,226,457,20,21,Player A
103,TitForTat,207,207,414,16,34,Tie
104,TitForTat,227,232,459,19,20,TitForTat
105,TitForTat,226,221,447,25,26,Player A
106,TitForTat,216,221,437,27,30,TitForTat
107,TitForTat,218,218,436,23,29,Tie
108,TitForTat,226,226,452,24,24,Tie
109,TitForTat,242,237,479,30,17,Player A
110,TitForTat,236,241,477,28,17,TitForTat
111,TitForTat,230,230,460,23,21,Tie
112,TitForTat,222,222,444,22,26,Tie
113,TitForTat,221,221,442,20,26,Tie
114,TitForTat,244,244,488,33,15,Tie
115,TitForTat,226,226,452,27,25,Tie
116,TitForTat,217,217,434,30,32,Tie
117,TitForTat,211,206,417,16,33,Player A
118,TitForTat,227,227,454,23,23,Tie
119,TitForTat,211,211,422,21,33,Tie
120,TitForTat,229,234,463,26,21,TitForTat
121,TitForTat,217,212,429,13,28,Player A
122,TitForTat,221,226,447,25,26,TitForTat
123,TitForTat,233,228,461,30,23,Player A
124,TitForTat,220,220,440,27,29,Tie
125,TitForTat,215,215,430,17,29,Tie
126,TitForTat,230,230,460,23,21,Tie
127,TitForTat,226,231,457,23,22,TitForTat
128,TitForTat,228,223,451,26,25,Player A
129,TitForTat,214,219,433,14,27,TitForTat
130,TitForTat,219,214,433,29,32,Player A
131,TitForTat,221,226,447,25,26,TitForTat
132,TitForTat,229,229,458,24,22,Tie
133,TitForTat,216,216,432,25,31,Tie
134,TitForTat,225,225,450,16,22,Tie
135,TitForTat,229,229,458,33,25,Tie
136,TitForTat,239,239,478,29,17,Tie
137,TitForTat,225,225,450,28,26,Tie
138,TitForTat,229,224,453,22,23,Player A
139,TitForTat,224,224,448,20,24,Tie
140,TitForTat,223,223,446,27,27,Tie
141,TitForTat,227,232,459,34,25,TitForTat
142,TitForTat,227,227,454,29,25,Tie
143,TitForTat,226,226,452,21,23,Tie
144,TitForTat,229,229,458,24,22,Tie
145,TitForTat,234,229,463,26,21,Player A
146,TitForTat,230,235,465,34,23,TitForTat
147,TitForTat,217,212,429,22,31,Player A
148,TitForTat,209,209,418,23,35,Tie
149,TitForTat,228,233,461,27,22,TitForTat
150,TitForTat,230,225,455,18,21,Player A
151,TitForTat,234,234,468,25,19,Tie
152,TitForTat,219,224,443,24,27,TitForTat
153,TitForTat,243,243,486,43,19,Tie
154,TitForTat,227,227,454,23,23,Tie
155,TitForTat,228,223,451,32,27,Player A
156,TitForTat,215,220,435,19,28,TitForTat
157,TitForTat,220,215,435,22,29,Player A
158,TitForTat,234,234,468,31,21,Tie
159,TitForTat,209,209,418,20,34,Tie
160,TitForTat,249,254,503,33,10,TitForTat
161,TitForTat,212,212,424,17,31,Tie
162,TitForTat,221,216,437,21,28,Player A
163,TitForTat,216,221,437,21,28,TitForTat
164,TitForTat,217,217,434,27,31,Tie
165,TitForTat,230,230,460,26,22,Tie
166,TitForTat,220,215,435,25,30,Player A
167,TitForTat,217,222,439,20,27,TitForTat
168,TitForTat,228,228,456,22,22,Tie
169,TitForTat,233,228,461,27,22,Player A
170,TitForTat,229,229,458,27,23,Tie
171,TitForTat,224,229,453,31,26,TitForTat
172,TitForTat,226,226,452,33,27,Tie
173,TitForTat,224,219,443,21,26,Player A
174,TitForTat,224,224,448,23,25,Tie
175,TitForTat,215,220,435,25,30,TitForTat
176,TitForTat,223,223,446,24,26,Tie
177,TitForTat,227,227,454,26,24,Tie
178,TitForTat,224,219,443,24,27,Player A
179,TitForTat,234,239,473,30,19,TitForTat
180,TitForTat,205,200,405,13,36,Player A
181,TitForTat,234,239,473,27,18,TitForTat
182,TitForTat,226,221,447,19,24,Player A
183,TitForTat,203,203,406,20,38,Tie
184,TitForTat,222,222,444,25,27,Tie
185,TitForTat,223,228,451,26,25,TitForTat
186,TitForTat,225,220,445,23,26,Player A
187,TitForTat,221,221,442,23,27,Tie
188,TitForTat,226,231,457,26,23,TitForTat
189,TitForTat,236,236,472,23,17,Tie
190,TitForTat,208,203,411,19,36,Player A
191,TitForTat,209,209,418,17,33,Tie
192,TitForTat,214,214,428,30,34,Tie
193,TitForTat,208,208,416,18,34,Tie
194,TitForTat,203,203,406,17,37,Tie
195,TitForTat,229,229,458,30,24,Tie
196,TitForTat,223,223,446,21,25,Tie
197,TitForTat,246,246,492,34,14,Tie
198,TitForTat,232,237,469,26,19,TitForTat
199,TitForTat,228,223,451,20,23,Player A
200,TitForTat,236,241,477,37,20,TitForTat
201,TitForTat,218,218,436,17,27,Tie
202,TitForTat,236,231,467,33,22,Player A
203,TitForTat,214,219,433,23,30,TitForTat
204,TitForTat,232,227,459,28,23,Player A
205,TitForTat,219,224,443,33,30,TitForTat
206,TitForTat,234,234,468,31,21,Tie
207,TitForTat,218,213,431,24,31,Player A
208,TitForTat,214,214,428,21,31,Tie
209,TitForTat,231,231,462,19,19,Tie
210,TitForTat,225,230,455,24,23,TitForTat
211,TitForTat,235,230,465,28,21,Player A
212,TitForTat,221,221,442,17,25,Tie
213,TitForTat,220,225,445,20,25,TitForTat
214,TitForTat,234,234,468,34,22,Tie
215,TitForTat,220,220,440,27,29,Tie
216,TitForTat,201,196,397,14,39,Player A
217,TitForTat,209,214,423,13,30,TitForTat
218,TitForTat,235,230,465,28,21,Player A
219,TitForTat,236,236,472,26,18,Tie
220,TitForTat,222,227,449,21,24,TitForTat
221,TitForTat,215,215,430,26,32,Tie
222,TitForTat,217,212,429,25,32,Player A
223,TitForTat,236,241,477,34,19,TitForTat
224,TitForTat,211,211,422,18,32,Tie
225,TitForTat,228,223,451,23,24,Player A
226,TitForTat,216,221,437,21,28,TitForTat
227,TitForTat,234,229,463,32,23,Player A
228,TitForTat,253,253,506,39,11,Tie
229,TitForTat,226,231,457,26,23,TitForTat
230,TitForTat,246,241,487,35,16,Player A
231,TitForTat,212,217,429,28,33,TitForTat
232,TitForTat,234,234,468,31,21,Tie
233,TitForTat,227,227,454,26,24,Tie
234,TitForTat,213,208,421,17,32,Player A
235,TitForTat,226,226,452,21,23,Tie
236,TitForTat,215,215,430,14,28,Tie
237,TitForTat,232,232,464,30,22,Tie
238,TitForTat,191,191,382,14,44,Tie
239,TitForTat,212,212,424,23,33,Tie
240,TitForTat,226,231,457,26,23,TitForTat
241,TitForTat,220,215,435,19,28,Player A
242,TitForTat,220,225,445,23,26,TitForTat
243,TitForTat,232,227,459,28,23,Player A
244,TitForTat,230,235,465,31,22,TitForTat
245,TitForTat,240,235,475,29,18,Player A
246,TitForTat,235,235,470,33,21,Tie
247,TitForTat,213,213,426,19,31,Tie
248,TitForTat,229,229,458,21,21,Tie
249,TitForTat,239,239,478,26,16,Tie
250,TitForTat,222,222,444,25,27,Tie
251,TitForTat,206,211,417,19,34,TitForTat
252,TitForTat,229,229,458,24,22,Tie
253,TitForTat,232,232,464,30,22,Tie
254,TitForTat,241,236,477,25,16,Player A
255,TitForTat,222,227,449,21,24,TitForTat
256,TitForTat,230,230,460,29,23,Tie
257,TitForTat,252,247,499,35,12,Player A
258,TitForTat,234,234,468,40,24,Tie
259,TitForTat,233,233,466,29,21,Tie
260,TitForTat,230,230,460,26,22,Tie
261,TitForTat,228,233,461,27,22,TitForTat
262,TitForTat,199,194,393,10,39,Player A
263,TitForTat,239,239,478,35,19,Tie
264,TitForTat,227,232,459,31,24,TitForTat
265,TitForTat,223,223,446,30,28,Tie
266,TitForTat,237,232,469,32,21,Player A
267,TitForTat,234,239,473,27,18,TitForTat
268,TitForTat,231,226,457,23,22,Player A
269,TitForTat,231,236,467,24,19,TitForTat
270,TitForTat,230,225,455,30,25,Player A
271,TitForTat,215,215,430,17,29,Tie
272,TitForTat,233,238,471,31,20,TitForTat
273,TitForTat,215,215,430,26,32,Tie
274,TitForTat,237,237,474,34,20,Tie
275,TitForTat,223,223,446,21,25,Tie
276,TitForTat,209,209,418,17,33,Tie
277,TitForTat,223,223,446,27,27,Tie
278,TitForTat,224,219,443,30,29,Player A
279,TitForTat,235,235,470,27,19,Tie
280,TitForTat,223,223,446,24,26,Tie
281,TitForTat,211,216,427,20,31,TitForTat
282,TitForTat,234,229,463,29,22,Player A
283,TitForTat,227,232,459,22,21,TitForTat
284,TitForTat,225,220,445,26,27,Player A
285,TitForTat,215,215,430,17,29,Tie
286,TitForTat,220,225,445,20,25,TitForTat
287,TitForTat,229,224,453,22,23,Player A
288,TitForTat,223,228,451,23,24,TitForTat
289,TitForTat,221,216,437,18,27,Player A
290,TitForTat,212,217,429,19,30,TitForTat
291,TitForTat,225,220,445,23,26,Player A
292,TitForTat,226,226,452,24,24,Tie
293,TitForTat,222,222,444,25,27,Tie
294,TitForTat,215,220,435,19,28,TitForTat
295,TitForTat,224,219,443,27,28,Player A
296,TitForTat,216,221,437,21,28,TitForTat
297,TitForTat,236,231,467,33,22,Player A
298,TitForTat,234,239,473,33,20,TitForTat
299,TitForTat,235,235,470,24,18,Tie
300,TitForTat,216,216,432,19,29,Tie
301,TitForTat,223,223,446,24,26,Tie
302,TitForTat,226,226,452,18,22,Tie
303,TitForTat,243,238,481,32,17,Player A
304,TitForTat,192,192,384,16,44,Tie
305,TitForTat,217,222,439,26,29,TitForTat
306,TitForTat,229,229,458,27,23,Tie
307,TitForTat,238,238,476,30,18,Tie
308,TitForTat,229,224,453,28,25,Player A
309,TitForTat,234,239,473,27,18,TitForTat
310,TitForTat,219,219,438,19,27,Tie
311,TitForTat,220,220,440,24,28,Tie
312,TitForTat,211,206,417,19,34,Player A
313,TitForTat,224,229,453,28,25,TitForTat
314,TitForTat,238,238,476,33,19,Tie
315,TitForTat,224,224,448,26,26,Tie
316,TitForTat,207,202,409,14,35,Player A
317,TitForTat,220,220,440,24,28,Tie
318,TitForTat,243,248,491,33,14,TitForTat
319,TitForTat,216,211,427,20,31,Player A
320,TitForTat,230,235,465,31,22,TitForTat
321,TitForTat,225,225,450,25,25,Tie
322,TitForTat,236,236,472,26,18,Tie
323,TitForTat,230,230,460,29,23,Tie
324,TitForTat,219,219,438,22,28,Tie
325,TitForTat,246,246,492,31,13,Tie
326,TitForTat,229,224,453,34,27,Player A
327,TitForTat,230,235,465,25,20,TitForTat
328,TitForTat,233,233,466,29,21,Tie
329,TitForTat,243,243,486,31,15,Tie
330,TitForTat,206,201,407,15,36,Player A
331,TitForTat,199,204,403,17,38,TitForTat
332,TitForTat,226,221,447,25,26,Player A
333,TitForTat,228,233,461,33,24,TitForTat
334,TitForTat,234,234,468,22,18,Tie
335,TitForTat,200,195,395,21,42,Player A
336,TitForTat,209,209,418,20,34,Tie
337,TitForTat,234,234,468,34,22,Tie
338,TitForTat,206,206,412,14,34,Tie
339,TitForTat,205,205,410,18,36,Tie
340,TitForTat,223,223,446,27,27,Tie
341,TitForTat,231,231,462,34,24,Tie
342,TitForTat,226,231,457,32,25,TitForTat
343,TitForTat,219,219,438,22,28,Tie
344,TitForTat,223,223,446,21,25,Tie
345,TitForTat,228,223,451,23,24,Player A
346,TitForTat,214,219,433,23,30,TitForTat
347,TitForTat,240,240,480,37,19,Tie
348,TitForTat,219,219,438,25,29,Tie
349,TitForTat,199,194,393,16,41,Player A
350,TitForTat,231,231,462,22,20,Tie
351,TitForTat,222,222,444,28,28,Tie
352,TitForTat,232,237,469,29,20,TitForTat
353,TitForTat,227,227,454,29,25,Tie
354,TitForTat,231,231,462,28,22,Tie
355,TitForTat,213,208,421,14,31,Player A
356,TitForTat,228,228,456,25,23,Tie
357,TitForTat,215,215,430,20,30,Tie
358,TitForTat,235,240,475,29,18,TitForTat
359,TitForTat,222,217,439,20,27,Player A
360,TitForTat,219,219,438,22,28,Tie
361,TitForTat,220,220,440,24,28,Tie
362,TitForTat,218,218,436,20,28,Tie
363,TitForTat,220,220,440,24,28,Tie
364,TitForTat,228,228,456,31,25,Tie
365,TitForTat,236,236,472,32,20,Tie
366,TitForTat,229,234,463,26,21,TitForTat
367,TitForTat,233,233,466,26,20,Tie
368,TitForTat,228,228,456,31,25,Tie
369,TitForTat,215,215,430,29,33,Tie
370,TitForTat,226,226,452,27,25,Tie
371,TitForTat,229,224,453,28,25,Player A
372,TitForTat,229,234,463,32,23,TitForTat
373,TitForTat,233,228,461,30,23,Player A
374,TitForTat,235,235,470,24,18,Tie
375,TitForTat,216,216,432,22,30,Tie
376,TitForTat,214,214,428,18,30,Tie
377,TitForTat,219,224,443,24,27,TitForTat
378,TitForTat,215,215,430,20,30,Tie
379,TitForTat,238,233,471,34,21,Player A
380,TitForTat,233,233,466,26,20,Tie
381,TitForTat,209,214,423,22,33,TitForTat
382,TitForTat,244,239,483,31,16,Player A
383,TitForTat,233,233,466,23,19,Tie
384,TitForTat,215,215,430,14,28,Tie
385,TitForTat,222,227,449,21,24,TitForTat
386,TitForTat,229,224,453,31,26,Player A
387,TitForTat,218,218,436,23,29,Tie
388,TitForTat,209,209,418,17,33,Tie
389,TitForTat,212,217,429,25,32,TitForTat
390,TitForTat,230,230,460,26,22,Tie
391,TitForTat,211,211,422,21,33,Tie
392,TitForTat,224,224,448,23,25,Tie
393,TitForTat,228,228,456,22,22,Tie
394,TitForTat,218,213,431,18,29,Player A
395,TitForTat,216,216,432,22,30,Tie
396,TitForTat,216,216,432,19,29,Tie
397,TitForTat,219,219,438,22,28,Tie
398,TitForTat,206,206,412,14,34,Tie
399,TitForTat,234,234,468,25,19,Tie
400,TitForTat,223,223,446,24,26,Tie
401,TitForTat,209,214,423,25,34,TitForTat
402,TitForTat,226,226,452,18,22,Tie
403,TitForTat,232,227,459,34,25,Player A
404,TitForTat,231,236,467,33,22,TitForTat
405,TitForTat,237,232,469,29,20,Player A
406,TitForTat,219,219,438,19,27,Tie
407,TitForTat,214,219,433,20,29,TitForTat
408,TitForTat,225,220,445,23,26,Player A
409,TitForTat,226,226,452,24,24,Tie
410,TitForTat,213,213,426,16,30,Tie
411,TitForTat,242,242,484,32,16,Tie
412,TitForTat,216,221,437,21,28,TitForTat
413,TitForTat,224,219,443,21,26,Player A
414,TitForTat,228,233,461,30,23,TitForTat
415,TitForTat,218,213,431,18,29,Player A
416,TitForTat,217,222,439,26,29,TitForTat
417,TitForTat,218,218,436,17,27,Tie
418,TitForTat,225,225,450,22,24,Tie
419,TitForTat,228,223,451,23,24,Player A
420,TitForTat,226,226,452,21,23,Tie
421,TitForTat,217,217,434,24,30,Tie
422,TitForTat,221,221,442,20,26,Tie
423,TitForTat,227,232,459,25,22,TitForTat
424,TitForTat,238,233,471,28,19,Player A
425,TitForTat,228,228,456,25,23,Tie
426,TitForTat,200,205,405,19,38,TitForTat
427,TitForTat,245,245,490,32,14,Tie
428,TitForTat,231,226,457,20,21,Player A
429,TitForTat,233,233,466,23,19,Tie
430,TitForTat,218,218,436,23,29,Tie
431,TitForTat,219,219,438,19,27,Tie
432,TitForTat,224,224,448,29,27,Tie
433,TitForTat,225,230,455,27,24,TitForTat
434,TitForTat,222,217,439,23,28,Player A
435,TitForTat,218,223,441,25,28,TitForTat
436,TitForTat,237,232,469,23,18,Player A
437,TitForTat,208,213,421,14,31,TitForTat
438,TitForTat,224,224,448,20,24,Tie
439,TitForTat,242,242,484,38,18,Tie
440,TitForTat,238,238,476,27,17,Tie
441,TitForTat,223,218,441,22,27,Player A
442,TitForTat,222,227,449,24,25,TitForTat
443,TitForTat,233,228,461,27,22,Player A
444,TitForTat,242,242,484,35,17,Tie
445,TitForTat,214,219,433,23,30,TitForTat
446,TitForTat,212,212,424,26,34,Tie
447,TitForTat,224,219,443,24,27,Player A
448,TitForTat,220,225,445,26,27,TitForTat
449,TitForTat,227,227,454,20,22,Tie
450,TitForTat,204,204,408,22,38,Tie
451,TitForTat,227,227,454,26,24,Tie
452,TitForTat,241,236,477,34,19,Player A
453,TitForTat,217,222,439,20,27,TitForTat
454,TitForTat,234,234,468,34,22,Tie
455,TitForTat,221,221,442,23,27,Tie
456,TitForTat,211,211,422,21,33,Tie
457,TitForTat,208,208,416,18,34,Tie
458,TitForTat,221,216,437,21,28,Player A
459,TitForTat,225,230,455,27,24,TitForTat
460,TitForTat,233,233,466,29,21,Tie
461,TitForTat,219,219,438,19,27,Tie
462,TitForTat,228,223,451,29,26,Player A
463,TitForTat,219,219,438,19,27,Tie
464,TitForTat,205,205,410,15,35,Tie
465,TitForTat,216,221,437,27,30,TitForTat
466,TitForTat,256,251,507,40,11,Player A
467,TitForTat,208,213,421,20,33,TitForTat
468,TitForTat,238,233,471,31,20,Player A
469,TitForTat,217,222,439,17,26,TitForTat
470,TitForTat,207,202,409,20,37,Player A
471,TitForTat,196,201,397,17,40,TitForTat
472,TitForTat,233,233,466,23,19,Tie
473,TitForTat,211,206,417,19,34,Player A
474,TitForTat,215,220,435,22,29,TitForTat
475,TitForTat,245,240,485,36,17,Player A
476,TitForTat,239,244,483,34,17,TitForTat
477,TitForTat,225,225,450,28,26,Tie
478,TitForTat,225,220,445,29,28,Player A
479,TitForTat,236,241,477,31,18,TitForTat
480,TitForTat,235,230,465,25,20,Player A
481,TitForTat,218,218,436,20,28,Tie
482,TitForTat,223,223,446,24,26,Tie
483,TitForTat,223,228,451,32,27,TitForTat
484,TitForTat,233,228,461,27,22,Player A
485,TitForTat,217,217,434,18,28,Tie
486,TitForTat,228,233,461,27,22,TitForTat
487,TitForTat,233,233,466,29,21,Tie
488,TitForTat,213,208,421,20,33,Player A
489,TitForTat,242,242,484,29,15,Tie
490,TitForTat,213,213,426,28,34,Tie
491,TitForTat,238,238,476,30,18,Tie
492,TitForTat,233,233,466,26,20,Tie
493,TitForTat,220,225,445,35,30,TitForTat
494,TitForTat,235,235,470,27,19,Tie
495,TitForTat,221,221,442,23,27,Tie
496,TitForTat,224,224,448,23,25,Tie
497,TitForTat,227,222,449,21,24,Player A
498,TitForTat,229,229,458,30,24,Tie
499,TitForTat,239,239,478,23,15,Tie
500,TitForTat,217,222,439,29,30,TitForTat
501,TitForTat,233,228,461,27,22,Player A
502,TitForTat,220,220,440,21,27,Tie
503,TitForTat,222,227,449,21,24,TitForTat
504,TitForTat,236,231,467,33,22,Player A
505,TitForTat,235,235,470,27,19,Tie
506,TitForTat,221,226,447,28,27,TitForTat
507,TitForTat,246,246,492,28,12,Tie
508,TitForTat,234,229,463,23,20,Player A
509,TitForTat,220,220,440,21,27,Tie
510,TitForTat,243,243,486,31,15,Tie
511,TitForTat,220,225,445,20,25,TitForTat
512,TitForTat,232,232,464,33,23,Tie
513,TitForTat,223,218,441,22,27,Player A
514,TitForTat,204,204,408,13,35,Tie
515,TitForTat,224,229,453,28,25,TitForTat
516,TitForTat,232,227,459,25,22,Player A
517,TitForTat,215,220,435,19,28,TitForTat
518,TitForTat,214,214,428,18,30,Tie
519,TitForTat,240,240,480,34,18,Tie
520,TitForTat,215,210,425,24,33,Player A
521,TitForTat,226,226,452,24,24,Tie
522,TitForTat,227,227,454,29,25,Tie
523,TitForTat,243,243,486,43,19,Tie
524,TitForTat,233,238,471,31,20,TitForTat
525,TitForTat,230,225,455,27,24,Player A
526,TitForTat,230,230,460,23,21,Tie
527,TitForTat,212,212,424,14,30,Tie
528,TitForTat,216,221,437,21,28,TitForTat
529,TitForTat,213,213,426,22,32,Tie
530,TitForTat,230,230,460,26,22,Tie
531,TitForTat,207,202,409,17,36,Player A
532,TitForTat,224,224,448,23,25,Tie
533,TitForTat,222,227,449,33,28,TitForTat
534,TitForTat,234,229,463,26,21,Player A
535,TitForTat,223,228,451,29,26,TitForTat
536,TitForTat,207,207,414,19,35,Tie
537,TitForTat,235,230,465,25,20,Player A
538,TitForTat,221,226,447,22,25,TitForTat
539,TitForTat,221,216,437,18,27,Player A
540,TitForTat,213,213,426,19,31,Tie
541,TitForTat,226,231,457,29,24,TitForTat
542,TitForTat,249,244,493,26,11,Player A
543,TitForTat,211,216,427,17,30,TitForTat
544,TitForTat,213,213,426,16,30,Tie
545,TitForTat,229,229,458,24,22,Tie
546,TitForTat,225,225,450,28,26,Tie
547,TitForTat,229,229,458,33,25,Tie
548,TitForTat,217,212,429,22,31,Player A
549,TitForTat,238,238,476,36,20,Tie
550,TitForTat,219,224,443,18,25,TitForTat
551,TitForTat,228,223,451,23,24,Player A
552,TitForTat,226,226,452,30,26,Tie
553,TitForTat,236,241,477,34,19,TitForTat
554,TitForTat,238,233,471,34,21,Player A
555,TitForTat,213,218,431,24,31,TitForTat
556,TitForTat,233,228,461,27,22,Player A
557,TitForTat,221,221,442,29,29,Tie
558,TitForTat,220,225,445,17,24,TitForTat
559,TitForTat,225,225,450,22,24,Tie
560,TitForTat,228,223,451,26,25,Player A
561,TitForTat,222,222,444,28,28,Tie
562,TitForTat,218,223,441,22,27,TitForTat
563,TitForTat,219,214,433,20,29,Player A
564,TitForTat,220,220,440,24,28,Tie
565,TitForTat,218,223,441,19,26,TitForTat
566,TitForTat,219,219,438,19,27,Tie
567,TitForTat,232,227,459,25,22,Player A
568,TitForTat,225,230,455,21,22,TitForTat
569,TitForTat,214,209,423,19,32,Player A
570,TitForTat,212,217,429,16,29,TitForTat
571,TitForTat,228,223,451,29,26,Player A
572,TitForTat,248,248,496,35,13,Tie
573,TitForTat,213,213,426,19,31,Tie
574,TitForTat,207,212,419,24,35,TitForTat
575,TitForTat,235,230,465,22,19,Player A
576,TitForTat,237,237,474,28,18,Tie
577,TitForTat,223,228,451,26,25,TitForTat
578,TitForTat,235,230,465,31,22,Player A
579,TitForTat,205,205,410,18,36,Tie
580,TitForTat,223,223,446,21,25,Tie
581,TitForTat,219,219,438,19,27,Tie
582,TitForTat,217,217,434,24,30,Tie
583,TitForTat,209,214,423,19,32,TitForTat
584,TitForTat,243,238,481,26,15,Player A
585,TitForTat,210,215,425,21,32,TitForTat
586,TitForTat,209,204,413,12,33,Player A
587,TitForTat,221,226,447,22,25,TitForTat
588,TitForTat,229,224,453,22,23,Player A
589,TitForTat,231,231,462,28,22,Tie
590,TitForTat,234,234,468,37,23,Tie
591,TitForTat,217,222,439,17,26,TitForTat
592,TitForTat,216,211,427,23,32,Player A
593,TitForTat,229,234,463,23,20,TitForTat
594,TitForTat,243,238,481,29,16,Player A
595,TitForTat,214,214,428,24,32,Tie
596,TitForTat,230,235,465,25,20,TitForTat
597,TitForTat,225,225,450,22,24,Tie
598,TitForTat,224,219,443,21,26,Player A
599,TitForTat,215,215,430,23,31,Tie
600,TitForTat,212,212,424,23,33,Tie
601,TitForTat,217,222,439,20,27,TitForTat
602,TitForTat,235,235,470,21,17,Tie
603,TitForTat,223,223,446,24,26,Tie
604,TitForTat,223,223,446,24,26,Tie
605,TitForTat,239,234,473,27,18,Player A
606,TitForTat,225,230,455,30,25,TitForTat
607,TitForTat,225,220,445,26,27,Player A
608,TitForTat,238,243,481,26,15,TitForTat
609,TitForTat,239,239,478,29,17,Tie
610,TitForTat,210,210,420,19,33,Tie
611,TitForTat,232,227,459,28,23,Player A
612,TitForTat,224,224,448,26,26,Tie
613,TitForTat,210,215,425,18,31,TitForTat
614,TitForTat,205,205,410,15,35,Tie
615,TitForTat,225,225,450,25,25,Tie
616,TitForTat,237,232,469,29,20,Player A
617,TitForTat,233,238,471,28,19,TitForTat
618,TitForTat,231,226,457,26,23,Player A
619,TitForTat,222,222,444,28,28,Tie
620,TitForTat,214,214,428,18,30,Tie
621,TitForTat,214,219,433,23,30,TitForTat
622,TitForTat,234,234,468,22,18,Tie
623,TitForTat,231,231,462,22,20,Tie
624,TitForTat,236,231,467,33,22,Player A
625,TitForTat,232,237,469,29,20,TitForTat
626,TitForTat,222,222,444,22,26,Tie
627,TitForTat,206,206,412,17,35,Tie
628,TitForTat,231,231,462,19,19,Tie
629,TitForTat,226,221,447,22,25,Player A
630,TitForTat,212,212,424,26,34,Tie
631,TitForTat,243,243,486,28,14,Tie
632,TitForTat,214,219,433,23,30,TitForTat
633,TitForTat,228,228,456,28,24,Tie
634,TitForTat,232,232,464,30,22,Tie
635,TitForTat,233,228,461,30,23,Player A
636,TitForTat,203,203,406,17,37,Tie
637,TitForTat,220,220,440,21,27,Tie
638,TitForTat,223,223,446,24,26,Tie
639,TitForTat,224,229,453,25,24,TitForTat
640,TitForTat,216,216,432,22,30,Tie
641,TitForTat,236,236,472,29,19,Tie
642,TitForTat,217,217,434,24,30,Tie
643,TitForTat,231,231,462,31,23,Tie
644,TitForTat,232,232,464,24,20,Tie
645,TitForTat,219,219,438,25,29,Tie
646,TitForTat,237,232,469,35,22,Player A
647,TitForTat,225,225,450,28,26,Tie
648,TitForTat,227,232,459,22,21,TitForTat
649,TitForTat,236,236,472,32,20,Tie
650,TitForTat,226,226,452,30,26,Tie
651,TitForTat,216,216,432,31,33,Tie
652,TitForTat,223,223,446,21,25,Tie
653,TitForTat,237,237,474,34,20,Tie
654,TitForTat,217,212,429,19,30,Player A
655,TitForTat,229,229,458,24,22,Tie
656,TitForTat,209,214,423,19,32,TitForTat
657,TitForTat,227,222,449,24,25,Player A
658,TitForTat,218,218,436,23,29,Tie
659,TitForTat,217,217,434,24,30,Tie
660,TitForTat,224,229,453,25,24,TitForTat
661,TitForTat,211,206,417,22,35,Player A
662,TitForTat,221,221,442,26,28,Tie
663,TitForTat,224,224,448,23,25,Tie
664,TitForTat,226,231,457,29,24,TitForTat
665,TitForTat,245,240,485,30,15,Player A
666,TitForTat,211,216,427,20,31,TitForTat
667,TitForTat,238,233,471,34,21,Player A
668,TitForTat,218,218,436,20,28,Tie
669,TitForTat,233,233,466,32,22,Tie
670,TitForTat,230,235,465,22,19,TitForTat
671,TitForTat,218,218,436,29,31,Tie
672,TitForTat,252,252,504,43,13,Tie
673,TitForTat,232,227,459,25,22,Player A
674,TitForTat,220,225,445,26,27,TitForTat
675,TitForTat,224,219,443,21,26,Player A
676,TitForTat,221,221,442,26,28,Tie
677,TitForTat,222,227,449,33,28,TitForTat
678,TitForTat,229,224,453,28,25,Player A
679,TitForTat,225,230,455,27,24,TitForTat
680,TitForTat,220,220,440,24,28,Tie
681,TitForTat,221,221,442,23,27,Tie
682,TitForTat,230,225,455,27,24,Player A
683,TitForTat,227,227,454,20,22,Tie
684,TitForTat,221,226,447,22,25,TitForTat
685,TitForTat,228,228,456,28,24,Tie
686,TitForTat,222,222,444,25,27,Tie
687,TitForTat,232,227,459,28,23,Player A
688,TitForTat,226,226,452,24,24,Tie
689,TitForTat,241,246,487,38,17,TitForTat
690,TitForTat,241,241,482,36,18,Tie
691,TitForTat,213,213,426,22,32,Tie
692,TitForTat,234,234,468,25,19,Tie
693,TitForTat,227,222,449,21,24,Player A
694,TitForTat,228,233,461,24,21,TitForTat
695,TitForTat,219,214,433,23,30,Player A
696,TitForTat,231,231,462,28,22,Tie
697,TitForTat,235,235,470,21,17,Tie
698,TitForTat,234,234,468,25,19,Tie
699,TitForTat,233,238,471,28,19,TitForTat
700,TitForTat,228,228,456,28,24,Tie
701,TitForTat,224,224,448,26,26,Tie
702,TitForTat,250,250,500,42,14,Tie
703,TitForTat,210,205,415,17,34,Player A
704,TitForTat,225,225,450,22,24,Tie
705,TitForTat,213,218,431,21,30,TitForTat
706,TitForTat,249,244,493,32,13,Player A
707,TitForTat,215,215,430,23,31,Tie
708,TitForTat,229,234,463,29,22,TitForTat
709,TitForTat,232,232,464,30,22,Tie
710,TitForTat,240,235,475,26,17,Player A
711,TitForTat,224,229,453,25,24,TitForTat
712,TitForTat,224,224,448,26,26,Tie
713,TitForTat,226,226,452,33,27,Tie
714,TitForTat,226,226,452,21,23,Tie
715,TitForTat,221,216,437,27,30,Player A
716,TitForTat,230,235,465,31,22,TitForTat
717,TitForTat,242,242,484,26,14,Tie
718,TitForTat,220,220,440,27,29,Tie
719,TitForTat,217,212,429,22,31,Player A
720,TitForTat,214,219,433,14,27,TitForTat
721,TitForTat,231,231,462,31,23,Tie
722,TitForTat,231,231,462,25,21,Tie
723,TitForTat,214,209,423,22,33,Player A
724,TitForTat,255,260,515,42,9,TitForTat
725,TitForTat,241,241,482,33,17,Tie
726,TitForTat,217,212,429,16,29,Player A
727,TitForTat,227,232,459,25,22,TitForTat
728,TitForTat,226,221,447,19,24,Player A
729,TitForTat,234,239,473,30,19,TitForTat
730,TitForTat,228,223,451,26,25,Player A
731,TitForTat,227,232,459,22,21,TitForTat
732,TitForTat,234,229,463,29,22,Player A
733,TitForTat,216,221,437,24,29,TitForTat
734,TitForTat,237,232,469,29,20,Player A
735,TitForTat,230,230,460,26,22,Tie
736,TitForTat,222,227,449,27,26,TitForTat
737,TitForTat,229,229,458,33,25,Tie
738,TitForTat,202,202,404,21,39,Tie
739,TitForTat,236,236,472,29,19,Tie
740,TitForTat,242,242,484,32,16,Tie
741,TitForTat,219,219,438,22,28,Tie
742,TitForTat,222,222,444,22,26,Tie
743,TitForTat,238,238,476,36,20,Tie
744,TitForTat,216,211,427,17,30,Player A
745,TitForTat,212,217,429,25,32,TitForTat
746,TitForTat,244,239,483,34,17,Player A
747,TitForTat,219,219,438,16,26,Tie
748,TitForTat,224,229,453,28,25,TitForTat
749,TitForTat,224,224,448,26,26,Tie
750,TitForTat,215,210,425,21,32,Player A
751,TitForTat,227,227,454,26,24,Tie
752,TitForTat,225,225,450,22,24,Tie
753,TitForTat,208,208,416,21,35,Tie
754,TitForTat,242,247,489,37,16,TitForTat
755,TitForTat,216,211,427,23,32,Player A
756,TitForTat,224,224,448,26,26,Tie
757,TitForTat,234,239,473,30,19,TitForTat
758,TitForTat,213,208,421,23,34,Player A
759,TitForTat,203,208,411,13,34,TitForTat
760,TitForTat,215,210,425,24,33,Player A
761,TitForTat,223,223,446,27,27,Tie
762,TitForTat,220,220,440,15,25,Tie
763,TitForTat,230,235,465,25,20,TitForTat
764,TitForTat,229,224,453,25,24,Player A
765,TitForTat,230,235,465,34,23,TitForTat
766,TitForTat,236,231,467,27,20,Player A
767,TitForTat,223,223,446,21,25,Tie
768,TitForTat,230,235,465,22,19,TitForTat
769,TitForTat,224,224,448,29,27,Tie
770,TitForTat,244,239,483,28,15,Player A
771,TitForTat,209,209,418,23,35,Tie
772,TitForTat,233,238,471,31,20,TitForTat
773,TitForTat,233,233,466,20,18,Tie
774,TitForTat,185,185,370,14,48,Tie
775,TitForTat,214,209,423,22,33,Player A
776,TitForTat,230,230,460,20,20,Tie
777,TitForTat,203,208,411,25,38,TitForTat
778,TitForTat,233,228,461,33,24,Player A
779,TitForTat,232,237,469,29,20,TitForTat
780,TitForTat,234,234,468,31,21,Tie
781,TitForTat,211,211,422,24,34,Tie
782,TitForTat,224,219,443,24,27,Player A
783,TitForTat,222,222,444,25,27,Tie
784,TitForTat,203,203,406,17,37,Tie
785,TitForTat,218,223,441,28,29,TitForTat
786,TitForTat,223,223,446,30,28,Tie
787,TitForTat,229,229,458,27,23,Tie
788,TitForTat,220,220,440,24,28,Tie
789,TitForTat,223,218,441,22,27,Player A
790,TitForTat,213,213,426,25,33,Tie
791,TitForTat,219,224,443,24,27,TitForTat
792,TitForTat,240,235,475,35,20,Player A
793,TitForTat,229,229,458,24,22,Tie
794,TitForTat,218,218,436,14,26,Tie
795,TitForTat,227,232,459,28,23,TitForTat
796,TitForTat,203,203,406,14,36,Tie
797,TitForTat,243,238,481,29,16,Player A
798,TitForTat,222,227,449,18,23,TitForTat
799,TitForTat,227,227,454,23,23,Tie
800,TitForTat,235,230,465,34,23,Player A
801,TitForTat,212,217,429,13,28,TitForTat
802,TitForTat,229,229,458,30,24,Tie
803,TitForTat,245,245,490,35,15,Tie
804,TitForTat,226,221,447,16,23,Player A
805,TitForTat,197,197,394,17,41,Tie
806,TitForTat,207,212,419,18,33,TitForTat
807,TitForTat,219,214,433,20,29,Player A
808,TitForTat,234,234,468,28,20,Tie
809,TitForTat,232,237,469,32,21,TitForTat
810,TitForTat,212,212,424,17,31,Tie
811,TitForTat,225,225,450,25,25,Tie
812,TitForTat,221,221,442,20,26,Tie
813,TitForTat,241,236,477,28,17,Player A
814,TitForTat,216,221,437,18,27,TitForTat
815,TitForTat,223,223,446,21,25,Tie
816,TitForTat,223,223,446,24,26,Tie
817,TitForTat,220,220,440,24,28,Tie
818,TitForTat,225,220,445,20,25,Player A
819,TitForTat,221,221,442,20,26,Tie
820,TitForTat,228,233,461,21,20,TitForTat
821,TitForTat,226,226,452,21,23,Tie
822,TitForTat,213,208,421,23,34,Player A
823,TitForTat,217,222,439,17,26,TitForTat
824,TitForTat,224,224,448,23,25,Tie
825,TitForTat,215,215,430,26,32,Tie
826,TitForTat,228,223,451,23,24,Player A
827,TitForTat,235,235,470,33,21,Tie
828,TitForTat,229,229,458,30,24,Tie
829,TitForTat,215,215,430,23,31,Tie
830,TitForTat,213,213,426,19,31,Tie
831,TitForTat,216,216,432,16,28,Tie
832,TitForTat,228,233,461,24,21,TitForTat
833,TitForTat,231,231,462,25,21,Tie
834,TitForTat,233,233,466,32,22,Tie
835,TitForTat,230,230,460,32,24,Tie
836,TitForTat,231,231,462,34,24,Tie
837,TitForTat,223,218,441,19,26,Player A
838,TitForTat,236,236,472,32,20,Tie
839,TitForTat,215,215,430,26,32,Tie
840,TitForTat,227,227,454,29,25,Tie
841,TitForTat,219,219,438,28,30,Tie
842,TitForTat,223,228,451,23,24,TitForTat
843,TitForTat,214,209,423,25,34,Player A
844,TitForTat,210,215,425,18,31,TitForTat
845,TitForTat,228,223,451,23,24,Player A
846,TitForTat,239,239,478,29,17,Tie
847,TitForTat,235,240,475,26,17,TitForTat
848,TitForTat,236,236,472,32,20,Tie
849,TitForTat,221,221,442,20,26,Tie
850,TitForTat,228,228,456,31,25,Tie
851,TitForTat,244,244,488,36,16,Tie
852,TitForTat,233,228,461,30,23,Player A
853,TitForTat,222,227,449,27,26,TitForTat
854,TitForTat,222,222,444,22,26,Tie
855,TitForTat,228,228,456,28,24,Tie
856,TitForTat,233,233,466,29,21,Tie
857,TitForTat,231,226,457,32,25,Player A
858,TitForTat,232,232,464,33,23,Tie
859,TitForTat,231,231,462,25,21,Tie
860,TitForTat,230,230,460,29,23,Tie
861,TitForTat,213,213,426,19,31,Tie
862,TitForTat,244,244,488,36,16,Tie
863,TitForTat,226,231,457,29,24,TitForTat
864,TitForTat,232,227,459,28,23,Player A
865,TitForTat,234,239,473,27,18,TitForTat
866,TitForTat,221,221,442,23,27,Tie
867,TitForTat,219,214,433,20,29,Player A
868,TitForTat,223,228,451,23,24,TitForTat
869,TitForTat,230,225,455,24,23,Player A
870,TitForTat,224,224,448,26,26,Tie
871,TitForTat,235,235,470,33,21,Tie
872,TitForTat,223,228,451,26,25,TitForTat
873,TitForTat,220,220,440,21,27,Tie
874,TitForTat,231,226,457,23,22,Player A
875,TitForTat,202,207,409,17,36,TitForTat
876,TitForTat,213,208,421,20,33,Player A
877,TitForTat,238,238,476,30,18,Tie
878,TitForTat,231,236,467,24,19,TitForTat
879,TitForTat,231,226,457,26,23,Player A
880,TitForTat,209,209,418,17,33,Tie
881,TitForTat,245,245,490,41,17,Tie
882,TitForTat,220,225,445,26,27,TitForTat
883,TitForTat,223,218,441,19,26,Player A
884,TitForTat,209,214,423,25,34,TitForTat
885,TitForTat,243,243,486,31,15,Tie
886,TitForTat,223,223,446,30,28,Tie
887,TitForTat,211,211,422,15,31,Tie
888,TitForTat,224,219,443,21,26,Player A
889,TitForTat,221,221,442,23,27,Tie
890,TitForTat,230,235,465,25,20,TitForTat
891,TitForTat,229,229,458,21,21,Tie
892,TitForTat,210,210,420,16,32,Tie
893,TitForTat,227,227,454,29,25,Tie
894,TitForTat,219,219,438,19,27,Tie
895,TitForTat,234,234,468,34,22,Tie
896,TitForTat,218,218,436,20,28,Tie
897,TitForTat,215,210,425,24,33,Player A
898,TitForTat,228,228,456,28,24,Tie
899,TitForTat,239,239,478,32,18,Tie
900,TitForTat,235,235,470,21,17,Tie
901,TitForTat,223,228,451,26,25,TitForTat
902,TitForTat,235,235,470,27,19,Tie
903,TitForTat,213,208,421,23,34,Player A
904,TitForTat,230,235,465,25,20,TitForTat
905,TitForTat,229,229,458,27,23,Tie
906,TitForTat,212,212,424,17,31,Tie
907,TitForTat,218,218,436,20,28,Tie
908,TitForTat,218,218,436,26,30,Tie
909,TitForTat,229,224,453,31,26,Player A
910,TitForTat,219,224,443,21,26,TitForTat
911,TitForTat,219,214,433,20,29,Player A
912,TitForTat,231,231,462,28,22,Tie
913,TitForTat,225,225,450,28,26,Tie
914,TitForTat,219,224,443,18,25,TitForTat
915,TitForTat,210,210,420,16,32,Tie
916,TitForTat,236,236,472,26,18,Tie
917,TitForTat,233,233,466,26,20,Tie
918,TitForTat,215,215,430,20,30,Tie
919,TitForTat,224,224,448,26,26,Tie
920,TitForTat,234,229,463,29,22,Player A
921,TitForTat,239,239,478,26,16,Tie
922,TitForTat,241,241,482,30,16,Tie
923,TitForTat,220,225,445,14,23,TitForTat
924,TitForTat,215,210,425,24,33,Player A
925,TitForTat,222,227,449,21,24,TitForTat
926,TitForTat,212,207,419,21,34,Player A
927,TitForTat,230,230,460,23,21,Tie
928,TitForTat,219,224,443,24,27,TitForTat
929,TitForTat,247,247,494,36,14,Tie
930,TitForTat,240,240,480,25,15,Tie
931,TitForTat,234,234,468,22,18,Tie
932,TitForTat,229,224,453,28,25,Player A
933,TitForTat,220,225,445,26,27,TitForTat
934,TitForTat,203,203,406,17,37,Tie
935,TitForTat,226,226,452,24,24,Tie
936,TitForTat,224,219,443,24,27,Player A
937,TitForTat,221,226,447,22,25,TitForTat
938,TitForTat,233,228,461,27,22,Player A
939,TitForTat,209,209,418,20,34,Tie
940,TitForTat,234,234,468,34,22,Tie
941,TitForTat,212,212,424,17,31,Tie
942,TitForTat,228,233,461,27,22,TitForTat
943,TitForTat,229,224,453,31,26,Player A
944,TitForTat,221,226,447,31,28,TitForTat
945,TitForTat,221,216,437,21,28,Player A
946,TitForTat,224,229,453,28,25,TitForTat
947,TitForTat,237,232,469,35,22,Player A
948,TitForTat,201,201,402,16,38,Tie
949,TitForTat,237,242,479,36,19,TitForTat
950,TitForTat,235,235,470,30,20,Tie
951,TitForTat,231,231,462,31,23,Tie
952,TitForTat,238,233,471,28,19,Player A
953,TitForTat,226,226,452,27,25,Tie
954,TitForTat,226,231,457,29,24,TitForTat
955,TitForTat,211,211,422,21,33,Tie
956,TitForTat,218,213,431,18,29,Player A
957,TitForTat,238,243,481,29,16,TitForTat
958,TitForTat,241,236,477,25,16,Player A
959,TitForTat,243,243,486,37,17,Tie
960,TitForTat,233,238,471,25,18,TitForTat
961,TitForTat,231,226,457,23,22,Player A
962,TitForTat,244,249,493,38,15,TitForTat
963,TitForTat,227,222,449,24,25,Player A
964,TitForTat,243,248,491,36,15,TitForTat
965,TitForTat,217,212,429,25,32,Player A
966,TitForTat,225,225,450,25,25,Tie
967,TitForTat,226,231,457,32,25,TitForTat
968,TitForTat,224,219,443,21,26,Player A
969,TitForTat,230,230,460,26,22,Tie
970,TitForTat,246,251,497,33,12,TitForTat
971,TitForTat,216,216,432,22,30,Tie
972,TitForTat,242,242,484,26,14,Tie
973,TitForTat,249,249,498,31,11,Tie
974,TitForTat,233,228,461,24,21,Player A
975,TitForTat,228,233,461,27,22,TitForTat
976,TitForTat,248,248,496,38,14,Tie
977,TitForTat,235,230,465,25,20,Player A
978,TitForTat,217,217,434,27,31,Tie
979,TitForTat,212,217,429,19,30,TitForTat
980,TitForTat,237,237,474,31,19,Tie
981,TitForTat,219,219,438,31,31,Tie
982,TitForTat,231,231,462,25,21,Tie
983,TitForTat,223,218,441,19,26,Player A
984,TitForTat,203,208,411,19,36,TitForTat
985,TitForTat,226,221,447,25,26,Player A
986,TitForTat,214,219,433,23,30,TitForTat
987,TitForTat,224,219,443,21,26,Player A
988,TitForTat,223,228,451,23,24,TitForTat
989,TitForTat,211,211,422,15,31,Tie
990,TitForTat,235,230,465,31,22,Player A
991,TitForTat,215,215,430,20,30,Tie
992,TitForTat,214,219,433,26,31,TitForTat
993,TitForTat,231,226,457,23,22,Player A
994,TitForTat,229,234,463,29,22,TitForTat
995,TitForTat,208,203,411,16,35,Player A
996,TitForTat,217,217,434,21,29,Tie
997,TitForTat,203,203,406,17,37,Tie
998,TitForTat,216,221,437,21,28,TitForTat
999,TitForTat,244,239,483,37,18,Player A
1000,TitForTat,207,207,414,19,35,Tie
1001,TitForTat,215,220,435,22,29,TitForTat
1002,TitForTat,235,230,465,34,23,Player A
1003,TitForTat,231,231,462,25,21,Tie
1004,TitForTat,227,232,459,22,21,TitForTat
1005,TitForTat,224,224,448,29,27,Tie
1006,TitForTat,210,205,415,20,35,Player A
1007,TitForTat,227,227,454,23,23,Tie
1008,TitForTat,221,221,442,23,27,Tie
1009,TitForTat,221,221,442,20,26,Tie
1010,TitForTat,209,214,423,25,34,TitForTat
1011,TitForTat,234,229,463,23,20,Player A
1012,TitForTat,229,229,458,18,20,Tie
1013,TitForTat,230,235,465,25,20,TitForTat
1014,TitForTat,214,209,423,19,32,Player A
1015,TitForTat,223,228,451,23,24,TitForTat
1016,TitForTat,248,248,496,32,12,Tie
1017,TitForTat,209,204,413,18,35,Player A
1018,TitForTat,217,217,434,21,29,Tie
1019,TitForTat,234,234,468,28,20,Tie
1020,TitForTat,228,228,456,31,25,Tie
1021,TitForTat,208,208,416,21,35,Tie
1022,TitForTat,208,213,421,23,34,TitForTat
1023,TitForTat,237,237,474,37,21,Tie
1024,TitForTat,221,216,437,27,30,Player A
1025,TitForTat,225,225,450,25,25,Tie
1026,TitForTat,220,220,440,24,28,Tie
1027,TitForTat,220,220,440,24,28,Tie
1028,TitForTat,237,237,474,25,17,Tie
1029,TitForTat,232,232,464,27,21,Tie
1030,TitForTat,226,231,457,17,20,TitForTat
1031,TitForTat,235,230,465,19,18,Player A
1032,TitForTat,219,224,443,24,27,TitForTat
1033,TitForTat,218,213,431,21,30,Player A
1034,TitForTat,211,211,422,9,29,Tie
1035,TitForTat,204,204,408,16,36,Tie
1036,TitForTat,211,216,427,23,32,TitForTat
1037,TitForTat,214,209,423,25,34,Player A
1038,TitForTat,224,224,448,26,26,Tie
1039,TitForTat,224,229,453,28,25,TitForTat
1040,TitForTat,247,242,489,34,15,Player A
1041,TitForTat,237,242,479,27,16,TitForTat
1042,TitForTat,213,208,421,20,33,Player A
1043,TitForTat,221,226,447,28,27,TitForTat
1044,TitForTat,217,212,429,19,30,Player A
1045,TitForTat,218,218,436,20,28,Tie
1046,TitForTat,226,231,457,17,20,TitForTat
1047,TitForTat,220,215,435,25,30,Player A
1048,TitForTat,214,219,433,26,31,TitForTat
1049,TitForTat,230,230,460,26,22,Tie
1050,TitForTat,243,238,481,29,16,Player A
1051,TitForTat,203,203,406,14,36,Tie
1052,TitForTat,235,235,470,33,21,Tie
1053,TitForTat,237,237,474,31,19,Tie
1054,TitForTat,225,225,450,22,24,Tie
1055,TitForTat,234,234,468,28,20,Tie
1056,TitForTat,221,221,442,23,27,Tie
1057,TitForTat,216,216,432,22,30,Tie
1058,TitForTat,208,208,416,21,35,Tie
1059,TitForTat,216,216,432,22,30,Tie
1060,TitForTat,214,219,433,26,31,TitForTat
1061,TitForTat,215,215,430,17,29,Tie
1062,TitForTat,227,227,454,20,22,Tie
1063,TitForTat,243,243,486,31,15,Tie
1064,TitForTat,219,214,433,23,30,Player A
1065,TitForTat,219,224,443,24,27,TitForTat
1066,TitForTat,221,216,437,30,31,Player A
1067,TitForTat,206,211,417,13,32,TitForTat
1068,TitForTat,223,218,441,22,27,Player A
1069,TitForTat,229,234,463,23,20,TitForTat
1070,TitForTat,234,234,468,31,21,Tie
1071,TitForTat,233,233,466,26,20,Tie
1072,TitForTat,230,225,455,24,23,Player A
1073,TitForTat,218,218,436,26,30,Tie
1074,TitForTat,221,226,447,28,27,TitForTat
1075,TitForTat,225,220,445,26,27,Player A
1076,TitForTat,215,215,430,17,29,Tie
1077,TitForTat,233,238,471,31,20,TitForTat
1078,TitForTat,228,228,456,22,22,Tie
1079,TitForTat,222,217,439,23,28,Player A
1080,TitForTat,226,231,457,29,24,TitForTat
1081,TitForTat,250,250,500,39,13,Tie
1082,TitForTat,227,222,449,24,25,Player A
1083,TitForTat,215,215,430,26,32,Tie
1084,TitForTat,214,214,428,21,31,Tie
1085,TitForTat,224,224,448,26,26,Tie
1086,TitForTat,233,238,471,31,20,TitForTat
1087,TitForTat,217,212,429,22,31,Player A
1088,TitForTat,227,232,459,25,22,TitForTat
1089,TitForTat,227,227,454,29,25,Tie
1090,TitForTat,215,210,425,15,30,Player A
1091,TitForTat,216,216,432,22,30,Tie
1092,TitForTat,226,226,452,27,25,Tie
1093,TitForTat,222,227,449,24,25,TitForTat
1094,TitForTat,253,248,501,37,12,Player A
1095,TitForTat,227,227,454,26,24,Tie
1096,TitForTat,229,234,463,32,23,TitForTat
1097,TitForTat,223,223,446,21,25,Tie
1098,TitForTat,228,223,451,26,25,Player A
1099,TitForTat,208,208,416,21,35,Tie
1100,TitForTat,228,233,461,27,22,TitForTat
1101,TitForTat,227,222,449,24,25,Player A
1102,TitForTat,213,218,431,18,29,TitForTat
1103,TitForTat,228,223,451,32,27,Player A
1104,TitForTat,241,241,482,42,20,Tie
1105,TitForTat,203,203,406,20,38,Tie
1106,TitForTat,226,231,457,26,23,TitForTat
1107,TitForTat,224,224,448,26,26,Tie
1108,TitForTat,229,229,458,33,25,Tie
1109,TitForTat,240,235,475,32,19,Player A
1110,TitForTat,212,212,424,20,32,Tie
1111,TitForTat,219,219,438,25,29,Tie
1112,TitForTat,192,197,389,21,44,TitForTat
1113,TitForTat,213,213,426,16,30,Tie
1114,TitForTat,223,218,441,28,29,Player A
1115,TitForTat,195,195,390,16,42,Tie
1116,TitForTat,217,217,434,21,29,Tie
1117,TitForTat,218,218,436,20,28,Tie
1118,TitForTat,235,235,470,33,21,Tie
1119,TitForTat,213,218,431,21,30,TitForTat
1120,TitForTat,226,221,447,28,27,Player A
1121,TitForTat,219,224,443,27,28,TitForTat
1122,TitForTat,240,240,480,31,17,Tie
1123,TitForTat,220,215,435,22,29,Player A
1124,TitForTat,236,236,472,35,21,Tie
1125,TitForTat,224,224,448,17,23,Tie
1126,TitForTat,227,227,454,29,25,Tie
1127,TitForTat,218,218,436,26,30,Tie
1128,TitForTat,221,221,442,23,27,Tie
1129,TitForTat,234,239,473,30,19,TitForTat
1130,TitForTat,236,231,467,33,22,Player A
0,Bayesian,220,220,440,21,27,Tie
1,Bayesian,169,259,428,27,33,Bayesian
2,Bayesian,192,232,424,17,31,Bayesian
3,Bayesian,232,227,459,28,23,Player A
4,Bayesian,230,220,450,22,24,Player A
5,Bayesian,202,237,439,20,27,Bayesian
6,Bayesian,219,264,483,34,17,Bayesian
7,Bayesian,215,230,445,29,28,Bayesian
8,Bayesian,215,205,420,16,32,Player A
9,Bayesian,242,212,454,32,26,Player A
10,Bayesian,233,218,451,23,24,Player A
11,Bayesian,229,199,428,21,31,Player A
12,Bayesian,227,237,464,27,21,Bayesian
13,Bayesian,225,230,455,27,24,Bayesian
14,Bayesian,233,218,451,26,25,Player A
15,Bayesian,223,218,441,25,28,Player A
16,Bayesian,216,236,452,21,23,Bayesian
17,Bayesian,201,261,462,25,21,Bayesian
18,Bayesian,240,205,445,23,26,Player A
19,Bayesian,238,208,446,21,25,Player A
20,Bayesian,225,215,440,24,28,Player A
21,Bayesian,223,203,426,19,31,Player A
22,Bayesian,204,229,433,23,30,Bayesian
23,Bayesian,238,213,451,26,25,Player A
24,Bayesian,239,209,448,17,23,Player A
25,Bayesian,201,231,432,25,31,Bayesian
26,Bayesian,212,242,454,23,23,Bayesian
27,Bayesian,203,238,441,25,28,Bayesian
28,Bayesian,250,220,470,24,18,Player A
29,Bayesian,223,218,441,19,26,Player A
30,Bayesian,214,229,443,24,27,Bayesian
31,Bayesian,231,201,432,28,32,Player A
32,Bayesian,234,224,458,24,22,Player A
33,Bayesian,254,214,468,28,20,Player A
34,Bayesian,236,236,472,23,17,Tie
35,Bayesian,252,192,444,25,27,Player A
36,Bayesian,216,251,467,33,22,Bayesian
37,Bayesian,228,203,431,15,28,Player A
38,Bayesian,210,220,430,17,29,Bayesian
39,Bayesian,215,195,410,18,36,Player A
40,Bayesian,211,231,442,14,24,Bayesian
41,Bayesian,205,250,455,24,23,Bayesian
42,Bayesian,219,229,448,26,26,Bayesian
43,Bayesian,179,254,433,23,30,Bayesian
44,Bayesian,237,217,454,20,22,Player A
45,Bayesian,232,237,469,29,20,Bayesian
46,Bayesian,217,217,434,24,30,Tie
47,Bayesian,229,209,438,19,27,Player A
48,Bayesian,223,243,466,26,20,Bayesian
49,Bayesian,241,201,442,23,27,Player A
50,Bayesian,202,247,449,30,27,Bayesian
51,Bayesian,222,217,439,20,27,Player A
52,Bayesian,244,219,463,32,23,Player A
53,Bayesian,199,239,438,25,29,Bayesian
54,Bayesian,219,219,438,25,29,Tie
55,Bayesian,219,219,438,22,28,Tie
56,Bayesian,244,209,453,25,24,Player A
57,Bayesian,232,212,444,28,28,Player A
58,Bayesian,225,210,435,22,29,Player A
59,Bayesian,221,216,437,33,32,Player A
60,Bayesian,256,176,432,22,30,Player A
61,Bayesian,208,243,451,23,24,Bayesian
62,Bayesian,250,200,450,25,25,Player A
63,Bayesian,220,225,445,26,27,Bayesian
64,Bayesian,230,220,450,19,23,Player A
65,Bayesian,231,236,467,33,22,Bayesian
66,Bayesian,212,237,449,24,25,Bayesian
67,Bayesian,226,221,447,28,27,Player A
68,Bayesian,199,244,443,24,27,Bayesian
69,Bayesian,228,218,446,18,24,Player A
70,Bayesian,221,216,437,21,28,Player A
71,Bayesian,205,240,445,23,26,Bayesian
72,Bayesian,258,203,461,21,20,Player A
73,Bayesian,220,240,460,23,21,Bayesian
74,Bayesian,277,187,464,30,22,Player A
75,Bayesian,187,237,424,20,32,Bayesian
76,Bayesian,246,216,462,31,23,Player A
77,Bayesian,191,236,427,20,31,Bayesian
78,Bayesian,229,219,448,29,27,Player A
79,Bayesian,262,207,469,26,19,Player A
80,Bayesian,231,216,447,25,26,Player A
81,Bayesian,217,197,414,19,35,Player A
82,Bayesian,223,218,441,28,29,Player A
83,Bayesian,232,192,424,26,34,Player A
84,Bayesian,192,242,434,18,28,Bayesian
85,Bayesian,206,236,442,26,28,Bayesian
86,Bayesian,230,225,455,24,23,Player A
87,Bayesian,238,208,446,24,26,Player A
88,Bayesian,213,233,446,24,26,Bayesian
89,Bayesian,226,221,447,28,27,Player A
90,Bayesian,218,228,446,27,27,Bayesian
91,Bayesian,208,233,441,22,27,Bayesian
92,Bayesian,245,225,470,27,19,Player A
93,Bayesian,231,231,462,25,21,Tie
94,Bayesian,239,214,453,25,24,Player A
95,Bayesian,223,223,446,21,25,Tie
96,Bayesian,219,214,433,26,31,Player A
97,Bayesian,237,202,439,23,28,Player A
98,Bayesian,218,243,461,30,23,Bayesian
99,Bayesian,213,208,421,20,33,Player A
100,Bayesian,217,212,429,19,30,Player A
101,Bayesian,199,224,423,19,32,Bayesian
102,Bayesian,224,209,433,23,30,Player A
103,Bayesian,227,232,459,28,23,Bayesian
104,Bayesian,217,222,439,26,29,Bayesian
105,Bayesian,209,234,443,24,27,Bayesian
106,Bayesian,228,203,431,18,29,Player A
107,Bayesian,234,219,453,25,24,Player A
108,Bayesian,248,228,476,27,17,Player A
109,Bayesian,259,199,458,21,21,Player A
110,Bayesian,208,228,436,26,30,Bayesian
111,Bayesian,198,248,446,24,26,Bayesian
112,Bayesian,242,217,459,22,21,Player A
113,Bayesian,219,234,453,28,25,Bayesian
114,Bayesian,247,197,444,19,25,Player A
115,Bayesian,197,237,434,21,29,Bayesian
116,Bayesian,205,255,460,26,22,Bayesian
117,Bayesian,237,222,459,25,22,Player A
118,Bayesian,209,269,478,29,17,Bayesian
119,Bayesian,231,211,442,26,28,Player A
120,Bayesian,216,241,457,23,22,Bayesian
121,Bayesian,190,245,435,22,29,Bayesian
122,Bayesian,201,241,442,23,27,Bayesian
123,Bayesian,234,229,463,29,22,Player A
124,Bayesian,236,211,447,25,26,Player A
125,Bayesian,261,176,437,21,28,Player A
126,Bayesian,225,230,455,21,22,Bayesian
127,Bayesian,216,226,442,23,27,Bayesian
128,Bayesian,225,225,450,28,26,Tie
129,Bayesian,203,248,451,23,24,Bayesian
130,Bayesian,218,208,426,22,32,Player A
131,Bayesian,196,251,447,31,28,Bayesian
132,Bayesian,234,209,443,36,31,Player A
133,Bayesian,266,206,472,26,18,Player A
134,Bayesian,223,218,441,22,27,Player A
135,Bayesian,235,210,445,20,25,Player A
136,Bayesian,202,242,444,25,27,Bayesian
137,Bayesian,237,222,459,25,22,Player A
138,Bayesian,227,202,429,16,29,Player A
139,Bayesian,243,203,446,21,25,Player A
140,Bayesian,211,236,447,28,27,Bayesian
141,Bayesian,234,214,448,26,26,Player A
142,Bayesian,240,220,460,23,21,Player A
143,Bayesian,191,251,442,23,27,Bayesian
144,Bayesian,191,241,432,19,29,Bayesian
145,Bayesian,225,215,440,27,29,Player A
146,Bayesian,215,245,460,29,23,Bayesian
147,Bayesian,189,224,413,21,36,Bayesian
148,Bayesian,251,201,452,27,25,Player A
149,Bayesian,234,219,453,25,24,Player A
150,Bayesian,191,241,432,25,31,Bayesian
151,Bayesian,223,208,431,15,28,Player A
152,Bayesian,180,245,425,21,32,Bayesian
153,Bayesian,243,198,441,28,29,Player A
154,Bayesian,244,214,458,24,22,Player A
155,Bayesian,232,217,449,24,25,Player A
156,Bayesian,226,216,442,17,25,Player A
157,Bayesian,230,205,435,22,29,Player A
158,Bayesian,230,215,445,17,24,Player A
159,Bayesian,198,243,441,25,28,Bayesian
160,Bayesian,179,254,433,20,29,Bayesian
161,Bayesian,202,227,429,25,32,Bayesian
162,Bayesian,227,252,479,27,16,Bayesian
163,Bayesian,233,238,471,31,20,Bayesian
164,Bayesian,240,210,450,22,24,Player A
165,Bayesian,238,218,456,22,22,Player A
166,Bayesian,223,213,436,23,29,Player A
167,Bayesian,205,245,450,28,26,Bayesian
168,Bayesian,236,201,437,27,30,Player A
169,Bayesian,221,216,437,27,30,Player A
170,Bayesian,217,207,424,20,32,Player A
171,Bayesian,226,241,467,27,20,Bayesian
172,Bayesian,205,235,440,27,29,Bayesian
173,Bayesian,200,240,440,30,30,Bayesian
174,Bayesian,210,225,435,19,28,Bayesian
175,Bayesian,184,254,438,25,29,Bayesian
176,Bayesian,211,221,432,22,30,Bayesian
177,Bayesian,240,225,465,25,20,Player A
178,Bayesian,185,240,425,18,31,Bayesian
179,Bayesian,214,259,473,27,18,Bayesian
180,Bayesian,208,213,421,20,33,Bayesian
181,Bayesian,219,244,463,29,22,Bayesian
182,Bayesian,202,227,429,19,30,Bayesian
183,Bayesian,198,223,421,23,34,Bayesian
184,Bayesian,204,259,463,26,21,Bayesian
185,Bayesian,230,225,455,21,22,Player A
186,Bayesian,216,211,427,20,31,Player A
187,Bayesian,221,236,457,23,22,Bayesian
188,Bayesian,270,195,465,22,19,Player A
189,Bayesian,239,219,458,30,24,Player A
190,Bayesian,219,229,448,26,26,Bayesian
191,Bayesian,220,225,445,26,27,Bayesian
192,Bayesian,214,254,468,25,19,Bayesian
193,Bayesian,233,228,461,30,23,Player A
194,Bayesian,236,201,437,18,27,Player A
195,Bayesian,227,257,484,29,15,Bayesian
196,Bayesian,224,234,458,18,20,Bayesian
197,Bayesian,206,221,427,26,33,Bayesian
198,Bayesian,213,223,436,14,26,Bayesian
199,Bayesian,181,241,422,18,32,Bayesian
200,Bayesian,200,245,445,23,26,Bayesian
201,Bayesian,253,223,476,27,17,Player A
202,Bayesian,229,219,448,26,26,Player A
203,Bayesian,251,201,452,27,25,Player A
204,Bayesian,221,231,452,24,24,Bayesian
205,Bayesian,239,209,448,26,26,Player A
206,Bayesian,211,241,452,27,25,Bayesian
207,Bayesian,236,206,442,26,28,Player A
208,Bayesian,237,247,484,29,15,Bayesian
209,Bayesian,234,239,473,36,21,Bayesian
210,Bayesian,232,222,454,23,23,Player A
211,Bayesian,226,236,462,28,22,Bayesian
212,Bayesian,193,243,436,20,28,Bayesian
213,Bayesian,198,238,436,26,30,Bayesian
214,Bayesian,223,238,461,33,24,Bayesian
215,Bayesian,223,218,441,25,28,Player A
216,Bayesian,206,256,462,34,24,Bayesian
217,Bayesian,211,241,452,27,25,Bayesian
218,Bayesian,213,228,441,22,27,Bayesian
219,Bayesian,220,245,465,28,21,Bayesian
220,Bayesian,191,216,407,18,37,Bayesian
221,Bayesian,216,226,442,26,28,Bayesian
222,Bayesian,211,231,442,20,26,Bayesian
223,Bayesian,275,165,440,21,27,Player A
224,Bayesian,197,227,424,23,33,Bayesian
225,Bayesian,226,211,437,21,28,Player A
226,Bayesian,219,224,443,24,27,Bayesian
227,Bayesian,226,226,452,27,25,Tie
228,Bayesian,206,236,442,17,25,Bayesian
229,Bayesian,235,210,445,26,27,Player A
230,Bayesian,189,249,438,25,29,Bayesian
231,Bayesian,221,221,442,23,27,Tie
232,Bayesian,249,209,458,24,22,Player A
233,Bayesian,212,227,439,23,28,Bayesian
234,Bayesian,235,225,460,23,21,Player A
235,Bayesian,249,224,473,33,20,Player A
236,Bayesian,237,247,484,32,16,Bayesian
237,Bayesian,234,224,458,21,21,Player A
238,Bayesian,201,241,442,23,27,Bayesian
239,Bayesian,203,263,466,29,21,Bayesian
240,Bayesian,231,216,447,22,25,Player A
241,Bayesian,197,262,459,28,23,Bayesian
242,Bayesian,243,228,471,31,20,Player A
243,Bayesian,214,239,453,25,24,Bayesian
244,Bayesian,248,218,466,32,22,Player A
245,Bayesian,231,221,452,24,24,Player A
246,Bayesian,260,180,440,24,28,Player A
247,Bayesian,236,196,432,19,29,Player A
248,Bayesian,229,224,453,28,25,Player A
249,Bayesian,216,236,452,24,24,Bayesian
250,Bayesian,250,210,460,32,24,Player A
251,Bayesian,206,241,447,25,26,Bayesian
252,Bayesian,201,231,432,22,30,Bayesian
253,Bayesian,207,242,449,24,25,Bayesian
254,Bayesian,232,232,464,30,22,Tie
255,Bayesian,183,253,436,17,27,Bayesian
256,Bayesian,207,252,459,31,24,Bayesian
257,Bayesian,206,236,442,20,26,Bayesian
258,Bayesian,234,214,448,23,25,Player A
259,Bayesian,225,245,470,33,21,Bayesian
260,Bayesian,241,191,432,22,30,Player A
261,Bayesian,221,226,447,22,25,Bayesian
262,Bayesian,219,224,443,24,27,Bayesian
263,Bayesian,202,227,429,16,29,Bayesian
264,Bayesian,196,241,437,21,28,Bayesian
265,Bayesian,237,232,469,20,17,Player A
266,Bayesian,237,227,464,30,22,Player A
267,Bayesian,235,230,465,28,21,Player A
268,Bayesian,195,240,435,16,27,Bayesian
269,Bayesian,234,209,443,24,27,Player A
270,Bayesian,249,194,443,21,26,Player A
271,Bayesian,205,250,455,24,23,Bayesian
272,Bayesian,251,176,427,20,31,Player A
273,Bayesian,214,229,443,27,28,Bayesian
274,Bayesian,230,250,480,31,17,Bayesian
275,Bayesian,224,229,453,22,23,Bayesian
276,Bayesian,219,229,448,23,25,Bayesian
277,Bayesian,234,234,468,28,20,Tie
278,Bayesian,232,217,449,24,25,Player A
279,Bayesian,230,230,460,29,23,Tie
280,Bayesian,223,208,431,21,30,Player A
281,Bayesian,213,218,431,24,31,Bayesian
282,Bayesian,215,260,475,32,19,Bayesian
283,Bayesian,187,237,424,20,32,Bayesian
284,Bayesian,270,190,460,23,21,Player A
285,Bayesian,222,242,464,27,21,Bayesian
286,Bayesian,241,186,427,23,32,Player A
287,Bayesian,203,253,456,22,22,Bayesian
288,Bayesian,223,218,441,25,28,Player A
289,Bayesian,250,210,460,29,23,Player A
290,Bayesian,229,229,458,30,24,Tie
291,Bayesian,236,226,462,22,20,Player A
292,Bayesian,236,201,437,24,29,Player A
293,Bayesian,224,224,448,26,26,Tie
294,Bayesian,211,231,442,26,28,Bayesian
295,Bayesian,195,250,445,29,28,Bayesian
296,Bayesian,215,240,455,30,25,Bayesian
297,Bayesian,230,210,440,27,29,Player A
298,Bayesian,179,254,433,23,30,Bayesian
299,Bayesian,219,234,453,25,24,Bayesian
300,Bayesian,209,244,453,22,23,Bayesian
301,Bayesian,221,251,472,26,18,Bayesian
302,Bayesian,179,269,448,23,25,Bayesian
303,Bayesian,182,272,454,26,24,Bayesian
304,Bayesian,257,187,444,22,26,Player A
305,Bayesian,244,204,448,23,25,Player A
306,Bayesian,241,211,452,21,23,Player A
307,Bayesian,234,204,438,25,29,Player A
308,Bayesian,259,199,458,21,21,Player A
309,Bayesian,196,251,447,25,26,Bayesian
310,Bayesian,214,199,413,21,36,Player A
311,Bayesian,219,224,443,24,27,Bayesian
312,Bayesian,212,247,459,25,22,Bayesian
313,Bayesian,237,222,459,31,24,Player A
314,Bayesian,215,225,440,21,27,Bayesian
315,Bayesian,222,227,449,27,26,Bayesian
316,Bayesian,211,266,477,28,17,Bayesian
317,Bayesian,194,259,453,25,24,Bayesian
318,Bayesian,202,247,449,24,25,Bayesian
319,Bayesian,233,213,446,24,26,Player A
320,Bayesian,222,212,434,21,29,Player A
321,Bayesian,228,223,451,29,26,Player A
322,Bayesian,212,252,464,24,20,Bayesian
323,Bayesian,224,224,448,26,26,Tie
324,Bayesian,226,226,452,27,25,Tie
325,Bayesian,227,242,469,26,19,Bayesian
326,Bayesian,206,236,442,26,28,Bayesian
327,Bayesian,221,241,462,25,21,Bayesian
328,Bayesian,200,225,425,21,32,Bayesian
329,Bayesian,241,231,472,20,16,Player A
330,Bayesian,222,217,439,26,29,Player A
331,Bayesian,226,216,442,20,26,Player A
332,Bayesian,200,240,440,27,29,Bayesian
333,Bayesian,204,254,458,24,22,Bayesian
334,Bayesian,223,243,466,29,21,Bayesian
335,Bayesian,238,228,466,32,22,Player A
336,Bayesian,199,249,448,26,26,Bayesian
337,Bayesian,239,219,458,27,23,Player A
338,Bayesian,208,228,436,29,31,Bayesian
339,Bayesian,195,245,440,24,28,Bayesian
340,Bayesian,194,239,433,26,31,Bayesian
341,Bayesian,244,199,443,21,26,Player A
342,Bayesian,233,218,451,23,24,Player A
343,Bayesian,183,268,451,23,24,Bayesian
344,Bayesian,208,253,461,27,22,Bayesian
345,Bayesian,230,185,415,17,34,Player A
346,Bayesian,219,254,473,36,21,Bayesian
347,Bayesian,199,229,428,18,30,Bayesian
348,Bayesian,222,217,439,26,29,Player A
349,Bayesian,209,214,423,19,32,Bayesian
350,Bayesian,201,266,467,30,21,Bayesian
351,Bayesian,213,258,471,31,20,Bayesian
352,Bayesian,218,248,466,32,22,Bayesian
353,Bayesian,245,195,440,21,27,Player A
354,Bayesian,220,230,450,22,24,Bayesian
355,Bayesian,209,244,453,28,25,Bayesian
356,Bayesian,220,210,430,20,30,Player A
357,Bayesian,215,230,445,20,25,Bayesian
358,Bayesian,184,259,443,21,26,Bayesian
359,Bayesian,230,230,460,26,22,Tie
360,Bayesian,181,271,452,27,25,Bayesian
361,Bayesian,210,255,465,25,20,Bayesian
362,Bayesian,229,209,438,28,30,Player A
363,Bayesian,225,220,445,26,27,Player A
364,Bayesian,238,218,456,22,22,Player A
365,Bayesian,224,239,463,29,22,Bayesian
366,Bayesian,238,213,451,26,25,Player A
367,Bayesian,203,228,431,24,31,Bayesian
368,Bayesian,233,233,466,32,22,Tie
369,Bayesian,205,250,455,30,25,Bayesian
370,Bayesian,229,214,443,21,26,Player A
371,Bayesian,222,207,429,19,30,Player A
372,Bayesian,205,230,435,16,27,Bayesian
373,Bayesian,246,216,462,22,20,Player A
374,Bayesian,222,237,459,28,23,Bayesian
375,Bayesian,236,206,442,26,28,Player A
376,Bayesian,213,263,476,30,18,Bayesian
377,Bayesian,194,249,443,21,26,Bayesian
378,Bayesian,260,215,475,29,18,Player A
379,Bayesian,261,176,437,24,29,Player A
380,Bayesian,217,232,449,24,25,Bayesian
381,Bayesian,187,247,434,24,30,Bayesian
382,Bayesian,220,220,440,24,28,Tie
383,Bayesian,239,224,463,29,22,Player A
384,Bayesian,241,221,462,22,20,Player A
385,Bayesian,239,229,468,28,20,Player A
386,Bayesian,240,225,465,31,22,Player A
387,Bayesian,247,187,434,21,29,Player A
388,Bayesian,247,202,449,24,25,Player A
389,Bayesian,237,197,434,27,31,Player A
390,Bayesian,241,206,447,22,25,Player A
391,Bayesian,230,215,445,20,25,Player A
392,Bayesian,258,183,441,25,28,Player A
393,Bayesian,215,245,460,26,22,Bayesian
394,Bayesian,218,208,426,22,32,Player A
395,Bayesian,213,243,456,25,23,Bayesian
396,Bayesian,235,220,455,24,23,Player A
397,Bayesian,202,252,454,23,23,Bayesian
398,Bayesian,239,214,453,25,24,Player A
399,Bayesian,246,216,462,31,23,Player A
400,Bayesian,210,235,445,32,29,Bayesian
401,Bayesian,238,233,471,25,18,Player A
402,Bayesian,224,244,468,28,20,Bayesian
403,Bayesian,201,241,442,23,27,Bayesian
404,Bayesian,217,222,439,23,28,Bayesian
405,Bayesian,249,204,453,31,26,Player A
406,Bayesian,238,213,451,29,26,Player A
407,Bayesian,241,196,437,21,28,Player A
408,Bayesian,255,200,455,27,24,Player A
409,Bayesian,248,208,456,28,24,Player A
410,Bayesian,201,246,447,25,26,Bayesian
411,Bayesian,213,228,441,22,27,Bayesian
412,Bayesian,229,219,448,26,26,Player A
413,Bayesian,210,245,455,24,23,Bayesian
414,Bayesian,194,244,438,16,26,Bayesian
415,Bayesian,207,227,434,27,31,Bayesian
416,Bayesian,224,224,448,23,25,Tie
417,Bayesian,198,238,436,20,28,Bayesian
418,Bayesian,207,242,449,21,24,Bayesian
419,Bayesian,242,222,464,27,21,Player A
420,Bayesian,216,221,437,24,29,Bayesian
421,Bayesian,236,216,452,27,25,Player A
422,Bayesian,232,217,449,21,24,Player A
423,Bayesian,216,246,462,28,22,Bayesian
424,Bayesian,249,214,463,26,21,Player A
425,Bayesian,239,209,448,20,24,Player A
426,Bayesian,246,241,487,32,15,Player A
427,Bayesian,220,205,425,15,30,Player A
428,Bayesian,241,201,442,20,26,Player A
429,Bayesian,257,197,454,20,22,Player A
430,Bayesian,211,236,447,22,25,Bayesian
431,Bayesian,231,206,437,21,28,Player A
432,Bayesian,223,248,471,25,18,Bayesian
433,Bayesian,216,246,462,25,21,Bayesian
434,Bayesian,255,200,455,30,25,Player A
435,Bayesian,225,220,445,23,26,Player A
436,Bayesian,256,206,462,28,22,Player A
437,Bayesian,211,231,442,29,29,Bayesian
438,Bayesian,214,209,423,25,34,Player A
439,Bayesian,205,220,425,27,34,Bayesian
440,Bayesian,219,209,428,21,31,Player A
441,Bayesian,216,216,432,22,30,Tie
442,Bayesian,222,237,459,28,23,Bayesian
443,Bayesian,228,228,456,25,23,Tie
444,Bayesian,233,233,466,26,20,Tie
445,Bayesian,252,187,439,26,29,Player A
446,Bayesian,227,197,424,20,32,Player A
447,Bayesian,234,219,453,25,24,Player A
448,Bayesian,228,223,451,29,26,Player A
449,Bayesian,244,204,448,20,24,Player A
450,Bayesian,217,232,449,24,25,Bayesian
451,Bayesian,277,182,459,22,21,Player A
452,Bayesian,210,260,470,27,19,Bayesian
453,Bayesian,215,225,440,24,28,Bayesian
454,Bayesian,213,223,436,32,32,Bayesian
455,Bayesian,205,205,410,21,37,Tie
456,Bayesian,237,237,474,31,19,Tie
457,Bayesian,207,252,459,28,23,Bayesian
458,Bayesian,239,214,453,25,24,Player A
459,Bayesian,261,176,437,24,29,Player A
460,Bayesian,219,234,453,19,22,Bayesian
461,Bayesian,226,231,457,29,24,Bayesian
462,Bayesian,230,225,455,27,24,Player A
463,Bayesian,243,198,441,22,27,Player A
464,Bayesian,231,231,462,25,21,Tie
465,Bayesian,242,222,464,27,21,Player A
466,Bayesian,229,229,458,24,22,Tie
467,Bayesian,215,215,430,29,33,Tie
468,Bayesian,213,223,436,29,31,Bayesian
469,Bayesian,247,222,469,23,18,Player A
470,Bayesian,238,208,446,24,26,Player A
471,Bayesian,263,203,466,35,23,Player A
472,Bayesian,245,225,470,24,18,Player A
473,Bayesian,242,207,449,27,26,Player A
474,Bayesian,249,194,443,21,26,Player A
475,Bayesian,183,238,421,26,35,Bayesian
476,Bayesian,214,239,453,25,24,Bayesian
477,Bayesian,238,238,476,36,20,Tie
478,Bayesian,223,223,446,24,26,Tie
479,Bayesian,204,259,463,26,21,Bayesian
480,Bayesian,245,215,460,23,21,Player A
481,Bayesian,251,216,467,27,20,Player A
482,Bayesian,232,227,459,22,21,Player A
483,Bayesian,241,211,452,24,24,Player A
484,Bayesian,244,194,438,22,28,Player A
485,Bayesian,208,248,456,25,23,Bayesian
486,Bayesian,208,248,456,31,25,Bayesian
487,Bayesian,209,214,423,25,34,Bayesian
488,Bayesian,237,207,444,22,26,Player A
489,Bayesian,229,219,448,26,26,Player A
490,Bayesian,224,229,453,28,25,Bayesian
491,Bayesian,220,210,430,20,30,Player A
492,Bayesian,221,236,457,23,22,Bayesian
493,Bayesian,223,213,436,20,28,Player A
494,Bayesian,227,232,459,25,22,Bayesian
495,Bayesian,239,209,448,29,27,Player A
496,Bayesian,220,210,430,20,30,Player A
497,Bayesian,219,204,423,25,34,Player A
498,Bayesian,228,203,431,18,29,Player A
499,Bayesian,232,217,449,21,24,Player A
500,Bayesian,203,238,441,25,28,Bayesian
501,Bayesian,213,218,431,18,29,Bayesian
502,Bayesian,263,183,446,18,24,Player A
503,Bayesian,249,194,443,24,27,Player A
504,Bayesian,227,232,459,31,24,Bayesian
505,Bayesian,243,218,461,30,23,Player A
506,Bayesian,200,245,445,20,25,Bayesian
507,Bayesian,238,208,446,24,26,Player A
508,Bayesian,205,220,425,15,30,Bayesian
509,Bayesian,219,229,448,26,26,Bayesian
510,Bayesian,249,224,473,33,20,Player A
511,Bayesian,210,215,425,24,33,Bayesian
512,Bayesian,207,252,459,22,21,Bayesian
513,Bayesian,210,235,445,23,26,Bayesian
514,Bayesian,238,248,486,37,17,Bayesian
515,Bayesian,221,211,432,22,30,Player A
516,Bayesian,212,242,454,20,22,Bayesian
517,Bayesian,214,229,443,24,27,Bayesian
518,Bayesian,234,239,473,24,17,Bayesian
519,Bayesian,234,214,448,17,23,Player A
520,Bayesian,216,231,447,31,28,Bayesian
521,Bayesian,221,226,447,22,25,Bayesian
522,Bayesian,205,240,445,20,25,Bayesian
523,Bayesian,225,225,450,28,26,Tie
524,Bayesian,186,266,452,18,22,Bayesian
525,Bayesian,256,216,472,32,20,Player A
526,Bayesian,206,231,437,30,31,Bayesian
527,Bayesian,200,255,455,24,23,Bayesian
528,Bayesian,227,212,439,26,29,Player A
529,Bayesian,213,218,431,21,30,Bayesian
530,Bayesian,248,203,451,20,23,Player A
531,Bayesian,240,200,440,24,28,Player A
532,Bayesian,202,232,434,21,29,Bayesian
533,Bayesian,211,221,432,22,30,Bayesian
534,Bayesian,248,223,471,25,18,Player A
535,Bayesian,215,235,450,25,25,Bayesian
536,Bayesian,241,231,472,26,18,Player A
537,Bayesian,196,266,462,22,20,Bayesian
538,Bayesian,233,208,441,28,29,Player A
539,Bayesian,237,247,484,32,16,Bayesian
540,Bayesian,224,219,443,24,27,Player A
541,Bayesian,242,227,469,29,20,Player A
542,Bayesian,220,255,475,29,18,Bayesian
543,Bayesian,247,202,449,24,25,Player A
544,Bayesian,228,238,466,32,22,Bayesian
545,Bayesian,220,230,450,25,25,Bayesian
546,Bayesian,218,238,456,25,23,Bayesian
547,Bayesian,258,193,451,23,24,Player A
548,Bayesian,232,217,449,30,27,Player A
549,Bayesian,192,242,434,21,29,Bayesian
550,Bayesian,216,221,437,27,30,Bayesian
551,Bayesian,245,215,460,23,21,Player A
552,Bayesian,232,242,474,28,18,Bayesian
553,Bayesian,237,217,454,20,22,Player A
554,Bayesian,236,196,432,19,29,Player A
555,Bayesian,230,220,450,25,25,Player A
556,Bayesian,230,205,435,28,31,Player A
557,Bayesian,213,238,451,32,27,Bayesian
558,Bayesian,195,270,465,22,19,Bayesian
559,Bayesian,207,247,454,23,23,Bayesian
560,Bayesian,196,266,462,22,20,Bayesian
561,Bayesian,244,214,458,27,23,Player A
562,Bayesian,222,227,449,21,24,Bayesian
563,Bayesian,219,224,443,27,28,Bayesian
564,Bayesian,246,201,447,28,27,Player A
565,Bayesian,192,237,429,25,32,Bayesian
566,Bayesian,197,232,429,19,30,Bayesian
567,Bayesian,195,240,435,22,29,Bayesian
568,Bayesian,239,199,438,19,27,Player A
569,Bayesian,237,207,444,25,27,Player A
570,Bayesian,211,226,437,24,29,Bayesian
571,Bayesian,189,254,443,18,25,Bayesian
572,Bayesian,231,226,457,23,22,Player A
573,Bayesian,191,246,437,24,29,Bayesian
574,Bayesian,175,265,440,18,26,Bayesian
575,Bayesian,223,253,476,24,16,Bayesian
576,Bayesian,218,228,446,24,26,Bayesian
577,Bayesian,214,229,443,27,28,Bayesian
578,Bayesian,216,246,462,31,23,Bayesian
579,Bayesian,247,207,454,20,22,Player A
580,Bayesian,252,192,444,25,27,Player A
581,Bayesian,228,228,456,31,25,Tie
582,Bayesian,230,210,440,24,28,Player A
583,Bayesian,202,237,439,23,28,Bayesian
584,Bayesian,231,211,442,23,27,Player A
585,Bayesian,230,230,460,23,21,Tie
586,Bayesian,233,208,441,22,27,Player A
587,Bayesian,230,230,460,32,24,Tie
588,Bayesian,220,200,420,19,33,Player A
589,Bayesian,233,233,466,32,22,Tie
590,Bayesian,200,245,445,26,27,Bayesian
591,Bayesian,232,197,429,22,31,Player A
592,Bayesian,225,210,435,22,29,Player A
593,Bayesian,262,202,464,27,21,Player A
594,Bayesian,201,246,447,28,27,Bayesian
595,Bayesian,242,207,449,18,23,Player A
596,Bayesian,218,238,456,34,26,Bayesian
597,Bayesian,238,243,481,35,18,Bayesian
598,Bayesian,218,228,446,27,27,Bayesian
599,Bayesian,219,194,413,21,36,Player A
600,Bayesian,204,209,413,24,37,Bayesian
601,Bayesian,201,241,442,29,29,Bayesian
602,Bayesian,213,228,441,19,26,Bayesian
603,Bayesian,212,232,444,22,26,Bayesian
604,Bayesian,242,212,454,32,26,Player A
605,Bayesian,222,222,444,22,26,Tie
606,Bayesian,234,239,473,30,19,Bayesian
607,Bayesian,228,243,471,34,21,Bayesian
608,Bayesian,198,228,426,16,30,Bayesian
609,Bayesian,210,245,455,24,23,Bayesian
610,Bayesian,248,218,466,35,23,Player A
611,Bayesian,234,194,428,24,32,Player A
612,Bayesian,199,249,448,29,27,Bayesian
613,Bayesian,245,210,455,21,22,Player A
614,Bayesian,230,210,440,30,30,Player A
615,Bayesian,214,219,433,23,30,Bayesian
616,Bayesian,233,238,471,22,17,Bayesian
617,Bayesian,226,226,452,24,24,Tie
618,Bayesian,187,247,434,24,30,Bayesian
619,Bayesian,228,228,456,25,23,Tie
620,Bayesian,231,216,447,19,24,Player A
621,Bayesian,225,230,455,21,22,Bayesian
622,Bayesian,206,236,442,23,27,Bayesian
623,Bayesian,198,273,471,28,19,Bayesian
624,Bayesian,208,253,461,27,22,Bayesian
625,Bayesian,211,236,447,22,25,Bayesian
626,Bayesian,214,259,473,30,19,Bayesian
627,Bayesian,238,228,466,32,22,Player A
628,Bayesian,230,230,460,29,23,Tie
629,Bayesian,227,217,444,19,25,Player A
630,Bayesian,182,232,414,22,36,Bayesian
631,Bayesian,198,243,441,25,28,Bayesian
632,Bayesian,234,219,453,31,26,Player A
633,Bayesian,237,187,424,20,32,Player A
634,Bayesian,246,201,447,28,27,Player A
635,Bayesian,243,208,451,23,24,Player A
636,Bayesian,219,229,448,26,26,Bayesian
637,Bayesian,230,235,465,28,21,Bayesian
638,Bayesian,189,264,453,31,26,Bayesian
639,Bayesian,229,189,418,26,36,Player A
640,Bayesian,265,195,460,35,25,Player A
641,Bayesian,213,223,436,20,28,Bayesian
642,Bayesian,235,205,440,24,28,Player A
643,Bayesian,210,220,430,20,30,Bayesian
644,Bayesian,211,226,437,24,29,Bayesian
645,Bayesian,211,246,457,29,24,Bayesian
646,Bayesian,236,221,457,26,23,Player A
647,Bayesian,228,213,441,22,27,Player A
648,Bayesian,236,201,437,27,30,Player A
649,Bayesian,219,249,468,22,18,Bayesian
650,Bayesian,237,202,439,29,30,Player A
651,Bayesian,219,254,473,24,17,Bayesian
652,Bayesian,223,218,441,28,29,Player A
653,Bayesian,213,248,461,30,23,Bayesian
654,Bayesian,222,227,449,24,25,Bayesian
655,Bayesian,251,211,462,28,22,Player A
656,Bayesian,219,234,453,25,24,Bayesian
657,Bayesian,246,201,447,22,25,Player A
658,Bayesian,206,236,442,14,24,Bayesian
659,Bayesian,223,208,431,24,31,Player A
660,Bayesian,201,241,442,17,25,Bayesian
661,Bayesian,226,211,437,24,29,Player A
662,Bayesian,215,220,435,22,29,Bayesian
663,Bayesian,230,220,450,25,25,Player A
664,Bayesian,225,225,450,25,25,Tie
665,Bayesian,261,216,477,34,19,Player A
666,Bayesian,237,212,449,21,24,Player A
667,Bayesian,245,225,470,36,22,Player A
668,Bayesian,218,218,436,23,29,Tie
669,Bayesian,244,204,448,23,25,Player A
670,Bayesian,198,228,426,19,31,Bayesian
671,Bayesian,258,193,451,23,24,Player A
672,Bayesian,222,242,464,21,19,Bayesian
673,Bayesian,205,265,470,33,21,Bayesian
674,Bayesian,247,207,454,26,24,Player A
675,Bayesian,219,249,468,37,23,Bayesian
676,Bayesian,221,221,442,26,28,Tie
677,Bayesian,243,203,446,27,27,Player A
678,Bayesian,237,237,474,31,19,Tie
679,Bayesian,249,209,458,30,24,Player A
680,Bayesian,255,190,445,23,26,Player A
681,Bayesian,208,233,441,22,27,Bayesian
682,Bayesian,223,208,431,18,29,Player A
683,Bayesian,205,230,435,22,29,Bayesian
684,Bayesian,214,224,438,19,27,Bayesian
685,Bayesian,226,231,457,26,23,Bayesian
686,Bayesian,220,220,440,21,27,Tie
687,Bayesian,221,216,437,21,28,Player A
688,Bayesian,212,242,454,26,24,Bayesian
689,Bayesian,223,223,446,24,26,Tie
690,Bayesian,191,246,437,21,28,Bayesian
691,Bayesian,261,201,462,25,21,Player A
692,Bayesian,232,212,444,22,26,Player A
693,Bayesian,244,209,453,28,25,Player A
694,Bayesian,235,235,470,27,19,Tie
695,Bayesian,224,214,438,28,30,Player A
696,Bayesian,257,197,454,23,23,Player A
697,Bayesian,215,215,430,17,29,Tie
698,Bayesian,235,205,440,30,30,Player A
699,Bayesian,223,213,436,23,29,Player A
700,Bayesian,220,225,445,20,25,Bayesian
701,Bayesian,217,227,444,22,26,Bayesian
702,Bayesian,205,250,455,21,22,Bayesian
703,Bayesian,235,210,445,26,27,Player A
704,Bayesian,240,200,440,24,28,Player A
705,Bayesian,186,266,452,21,23,Bayesian
706,Bayesian,214,244,458,24,22,Bayesian
707,Bayesian,255,195,450,25,25,Player A
708,Bayesian,211,221,432,22,30,Bayesian
709,Bayesian,204,254,458,21,21,Bayesian
710,Bayesian,186,256,442,20,26,Bayesian
711,Bayesian,236,181,417,22,35,Player A
712,Bayesian,225,215,440,27,29,Player A
713,Bayesian,248,198,446,27,27,Player A
714,Bayesian,229,204,433,20,29,Player A
715,Bayesian,240,205,445,23,26,Player A
716,Bayesian,203,248,451,23,24,Bayesian
717,Bayesian,202,242,444,25,27,Bayesian
718,Bayesian,225,215,440,24,28,Player A
719,Bayesian,210,235,445,20,25,Bayesian
720,Bayesian,221,241,462,28,22,Bayesian
721,Bayesian,223,213,436,23,29,Player A
722,Bayesian,198,263,461,27,22,Bayesian
723,Bayesian,214,224,438,22,28,Bayesian
724,Bayesian,251,211,462,22,20,Player A
725,Bayesian,207,232,439,20,27,Bayesian
726,Bayesian,247,192,439,26,29,Player A
727,Bayesian,220,250,470,27,19,Bayesian
728,Bayesian,220,225,445,20,25,Bayesian
729,Bayesian,228,223,451,23,24,Player A
730,Bayesian,235,220,455,30,25,Player A
731,Bayesian,208,238,446,27,27,Bayesian
732,Bayesian,241,216,457,26,23,Player A
733,Bayesian,227,207,434,30,32,Player A
734,Bayesian,196,256,452,24,24,Bayesian
735,Bayesian,228,243,471,28,19,Bayesian
736,Bayesian,201,256,457,20,21,Bayesian
737,Bayesian,208,238,446,21,25,Bayesian
738,Bayesian,245,205,450,25,25,Player A
739,Bayesian,249,189,438,25,29,Player A
740,Bayesian,195,240,435,22,29,Bayesian
741,Bayesian,235,235,470,24,18,Tie
742,Bayesian,202,232,434,24,30,Bayesian
743,Bayesian,216,226,442,20,26,Bayesian
744,Bayesian,234,214,448,23,25,Player A
745,Bayesian,224,229,453,28,25,Bayesian
746,Bayesian,199,269,468,25,19,Bayesian
747,Bayesian,245,210,455,24,23,Player A
748,Bayesian,235,230,465,25,20,Player A
749,Bayesian,205,250,455,27,24,Bayesian
750,Bayesian,231,216,447,22,25,Player A
751,Bayesian,260,190,450,22,24,Player A
752,Bayesian,244,209,453,25,24,Player A
753,Bayesian,236,226,462,22,20,Player A
754,Bayesian,190,245,435,22,29,Bayesian
755,Bayesian,242,202,444,28,28,Player A
756,Bayesian,221,241,462,25,21,Bayesian
757,Bayesian,222,232,454,26,24,Bayesian
758,Bayesian,214,229,443,24,27,Bayesian
759,Bayesian,267,222,489,34,15,Player A
760,Bayesian,217,227,444,25,27,Bayesian
761,Bayesian,223,228,451,29,26,Bayesian
762,Bayesian,227,202,429,16,29,Player A
763,Bayesian,194,269,463,23,20,Bayesian
764,Bayesian,222,242,464,33,23,Bayesian
765,Bayesian,221,236,457,26,23,Bayesian
766,Bayesian,251,211,462,22,20,Player A
767,Bayesian,213,208,421,14,31,Player A
768,Bayesian,229,204,433,23,30,Player A
769,Bayesian,220,240,460,26,22,Bayesian
770,Bayesian,249,199,448,20,24,Player A
771,Bayesian,226,221,447,28,27,Player A
772,Bayesian,258,223,481,29,16,Player A
773,Bayesian,209,214,423,19,32,Bayesian
774,Bayesian,240,230,470,27,19,Player A
775,Bayesian,217,227,444,22,26,Bayesian
776,Bayesian,240,210,450,22,24,Player A
777,Bayesian,229,224,453,25,24,Player A
778,Bayesian,238,218,456,25,23,Player A
779,Bayesian,220,185,405,22,39,Player A
780,Bayesian,241,216,457,26,23,Player A
781,Bayesian,206,261,467,24,19,Bayesian
782,Bayesian,259,189,448,20,24,Player A
783,Bayesian,240,205,445,20,25,Player A
784,Bayesian,224,234,458,27,23,Bayesian
785,Bayesian,225,220,445,26,27,Player A
786,Bayesian,217,232,449,27,26,Bayesian
787,Bayesian,269,194,463,26,21,Player A
788,Bayesian,208,248,456,31,25,Bayesian
789,Bayesian,243,223,466,32,22,Player A
790,Bayesian,237,212,449,21,24,Player A
791,Bayesian,239,214,453,25,24,Player A
792,Bayesian,232,242,474,25,17,Bayesian
793,Bayesian,222,237,459,25,22,Bayesian
794,Bayesian,237,197,434,24,30,Player A
795,Bayesian,196,236,432,22,30,Bayesian
796,Bayesian,246,186,432,22,30,Player A
797,Bayesian,200,245,445,26,27,Bayesian
798,Bayesian,262,197,459,28,23,Player A
799,Bayesian,215,235,450,28,26,Bayesian
800,Bayesian,244,214,458,21,21,Player A
801,Bayesian,242,217,459,22,21,Player A
802,Bayesian,227,222,449,27,26,Player A
803,Bayesian,238,218,456,28,24,Player A
804,Bayesian,212,232,444,25,27,Bayesian
805,Bayesian,251,196,447,22,25,Player A
806,Bayesian,219,214,433,20,29,Player A
807,Bayesian,221,246,467,33,22,Bayesian
808,Bayesian,260,190,450,22,24,Player A
809,Bayesian,225,240,465,28,21,Bayesian
810,Bayesian,254,204,458,33,25,Player A
811,Bayesian,217,222,439,20,27,Bayesian
812,Bayesian,218,228,446,27,27,Bayesian
813,Bayesian,250,205,455,21,22,Player A
814,Bayesian,228,203,431,24,31,Player A
815,Bayesian,201,266,467,30,21,Bayesian
816,Bayesian,195,255,450,22,24,Bayesian
817,Bayesian,212,222,434,15,27,Bayesian
818,Bayesian,209,224,433,23,30,Bayesian
819,Bayesian,239,214,453,25,24,Player A
820,Bayesian,238,213,451,23,24,Player A
821,Bayesian,235,250,485,42,19,Bayesian
822,Bayesian,225,225,450,28,26,Tie
823,Bayesian,227,222,449,30,27,Player A
824,Bayesian,235,230,465,28,21,Player A
825,Bayesian,226,226,452,24,24,Tie
826,Bayesian,210,245,455,24,23,Bayesian
827,Bayesian,203,248,451,26,25,Bayesian
828,Bayesian,237,217,454,23,23,Player A
829,Bayesian,220,225,445,26,27,Bayesian
830,Bayesian,189,239,428,21,31,Bayesian
831,Bayesian,241,226,467,21,18,Player A
832,Bayesian,237,232,469,29,20,Player A
833,Bayesian,232,237,469,23,18,Bayesian
834,Bayesian,203,268,471,22,17,Bayesian
835,Bayesian,252,222,474,31,19,Player A
836,Bayesian,213,238,451,29,26,Bayesian
837,Bayesian,241,226,467,30,21,Player A
838,Bayesian,226,206,432,22,30,Player A
839,Bayesian,238,213,451,23,24,Player A
840,Bayesian,222,212,434,18,28,Player A
841,Bayesian,219,229,448,26,26,Bayesian
842,Bayesian,218,238,456,25,23,Bayesian
843,Bayesian,267,212,479,24,15,Player A
844,Bayesian,199,269,468,31,21,Bayesian
845,Bayesian,245,190,435,22,29,Player A
846,Bayesian,202,232,434,21,29,Bayesian
847,Bayesian,208,228,436,26,30,Bayesian
848,Bayesian,219,234,453,25,24,Bayesian
849,Bayesian,232,212,444,28,28,Player A
850,Bayesian,239,219,458,24,22,Player A
851,Bayesian,223,243,466,32,22,Bayesian
852,Bayesian,225,225,450,28,26,Tie
853,Bayesian,229,204,433,17,28,Player A
854,Bayesian,214,244,458,21,21,Bayesian
855,Bayesian,240,200,440,18,26,Player A
856,Bayesian,202,212,414,16,34,Bayesian
857,Bayesian,221,226,447,25,26,Bayesian
858,Bayesian,232,207,439,23,28,Player A
859,Bayesian,242,222,464,27,21,Player A
860,Bayesian,236,201,437,21,28,Player A
861,Bayesian,224,219,443,18,25,Player A
862,Bayesian,205,255,460,23,21,Bayesian
863,Bayesian,256,191,447,22,25,Player A
864,Bayesian,245,200,445,26,27,Player A
865,Bayesian,259,179,438,22,28,Player A
866,Bayesian,221,251,472,29,19,Bayesian
867,Bayesian,227,232,459,28,23,Bayesian
868,Bayesian,197,262,459,28,23,Bayesian
869,Bayesian,246,216,462,25,21,Player A
870,Bayesian,269,199,468,28,20,Player A
871,Bayesian,224,219,443,24,27,Player A
872,Bayesian,235,225,460,35,25,Player A
873,Bayesian,255,235,490,32,14,Player A
874,Bayesian,215,225,440,18,26,Bayesian
875,Bayesian,232,227,459,31,24,Player A
876,Bayesian,232,222,454,23,23,Player A
877,Bayesian,239,219,458,27,23,Player A
878,Bayesian,238,203,441,25,28,Player A
879,Bayesian,217,232,449,27,26,Bayesian
880,Bayesian,250,215,465,28,21,Player A
881,Bayesian,238,213,451,29,26,Player A
882,Bayesian,233,228,461,24,21,Player A
883,Bayesian,246,221,467,30,21,Player A
884,Bayesian,195,230,425,21,32,Bayesian
885,Bayesian,224,249,473,24,17,Bayesian
886,Bayesian,229,209,438,22,28,Player A
887,Bayesian,226,251,477,28,17,Bayesian
888,Bayesian,222,197,419,24,35,Player A
889,Bayesian,254,214,468,31,21,Player A
890,Bayesian,235,255,490,32,14,Bayesian
891,Bayesian,246,206,452,27,25,Player A
892,Bayesian,238,223,461,27,22,Player A
893,Bayesian,190,265,455,24,23,Bayesian
894,Bayesian,197,237,434,21,29,Bayesian
895,Bayesian,204,239,443,24,27,Bayesian
896,Bayesian,247,222,469,26,19,Player A
897,Bayesian,245,230,475,32,19,Player A
898,Bayesian,183,298,481,29,16,Bayesian
899,Bayesian,223,228,451,32,27,Bayesian
900,Bayesian,205,210,415,29,38,Bayesian
901,Bayesian,238,228,466,20,18,Player A
902,Bayesian,212,247,459,28,23,Bayesian
903,Bayesian,238,198,436,20,28,Player A
904,Bayesian,258,213,471,31,20,Player A
905,Bayesian,220,230,450,25,25,Bayesian
906,Bayesian,269,199,468,28,20,Player A
907,Bayesian,227,232,459,22,21,Bayesian
908,Bayesian,244,219,463,26,21,Player A
909,Bayesian,206,216,422,18,32,Bayesian
910,Bayesian,234,239,473,30,19,Bayesian
911,Bayesian,235,245,480,28,16,Bayesian
912,Bayesian,255,215,470,30,20,Player A
913,Bayesian,209,229,438,28,30,Bayesian
914,Bayesian,200,245,445,23,26,Bayesian
915,Bayesian,224,229,453,22,23,Bayesian
916,Bayesian,259,184,443,27,28,Player A
917,Bayesian,228,228,456,31,25,Tie
918,Bayesian,230,220,450,25,25,Player A
919,Bayesian,260,185,445,32,29,Player A
920,Bayesian,240,230,470,33,21,Player A
921,Bayesian,252,222,474,25,17,Player A
922,Bayesian,235,195,430,26,32,Player A
923,Bayesian,244,189,433,23,30,Player A
924,Bayesian,249,214,463,29,22,Player A
925,Bayesian,224,224,448,26,26,Tie
926,Bayesian,199,234,433,20,29,Bayesian
927,Bayesian,198,233,431,21,30,Bayesian
928,Bayesian,206,226,432,22,30,Bayesian
929,Bayesian,242,177,419,24,35,Player A
930,Bayesian,211,236,447,19,24,Bayesian
931,Bayesian,228,223,451,32,27,Player A
932,Bayesian,201,231,432,22,30,Bayesian
933,Bayesian,258,198,456,25,23,Player A
934,Bayesian,205,215,420,22,34,Bayesian
935,Bayesian,206,236,442,29,29,Bayesian
936,Bayesian,230,225,455,30,25,Player A
937,Bayesian,225,250,475,35,20,Bayesian
938,Bayesian,206,241,447,28,27,Bayesian
939,Bayesian,227,212,439,26,29,Player A
940,Bayesian,189,274,463,23,20,Bayesian
941,Bayesian,268,208,476,30,18,Player A
942,Bayesian,220,240,460,29,23,Bayesian
943,Bayesian,248,218,466,23,19,Player A
944,Bayesian,240,220,460,23,21,Player A
945,Bayesian,210,215,425,27,34,Bayesian
946,Bayesian,232,242,474,31,19,Bayesian
947,Bayesian,228,238,466,29,21,Bayesian
948,Bayesian,227,212,439,26,29,Player A
949,Bayesian,223,248,471,34,21,Bayesian
950,Bayesian,203,238,441,25,28,Bayesian
951,Bayesian,217,237,454,26,24,Bayesian
952,Bayesian,225,240,465,28,21,Bayesian
953,Bayesian,194,254,448,20,24,Bayesian
954,Bayesian,216,231,447,31,28,Bayesian
955,Bayesian,226,206,432,16,28,Player A
956,Bayesian,227,242,469,29,20,Bayesian
957,Bayesian,231,246,477,31,18,Bayesian
958,Bayesian,232,222,454,23,23,Player A
959,Bayesian,240,195,435,22,29,Player A
960,Bayesian,226,211,437,27,30,Player A
961,Bayesian,220,230,450,25,25,Bayesian
962,Bayesian,228,203,431,24,31,Player A
963,Bayesian,191,256,447,25,26,Bayesian
964,Bayesian,245,215,460,29,23,Player A
965,Bayesian,252,207,459,25,22,Player A
966,Bayesian,222,232,454,29,25,Bayesian
967,Bayesian,209,259,468,37,23,Bayesian
968,Bayesian,202,237,439,23,28,Bayesian
969,Bayesian,238,193,431,27,32,Player A
970,Bayesian,211,236,447,28,27,Bayesian
971,Bayesian,213,233,446,24,26,Bayesian
972,Bayesian,217,242,459,25,22,Bayesian
973,Bayesian,201,246,447,25,26,Bayesian
974,Bayesian,231,236,467,27,20,Bayesian
975,Bayesian,250,200,450,28,26,Player A
976,Bayesian,243,213,456,28,24,Player A
977,Bayesian,237,197,434,24,30,Player A
978,Bayesian,243,213,456,25,23,Player A
979,Bayesian,219,244,463,29,22,Bayesian
980,Bayesian,268,183,451,23,24,Player A
981,Bayesian,217,257,474,25,17,Bayesian
982,Bayesian,249,229,478,29,17,Player A
983,Bayesian,232,222,454,23,23,Player A
984,Bayesian,228,208,436,26,30,Player A
985,Bayesian,197,247,444,22,26,Bayesian
986,Bayesian,177,267,444,22,26,Bayesian
987,Bayesian,236,216,452,30,26,Player A
988,Bayesian,218,213,431,18,29,Player A
989,Bayesian,231,231,462,28,22,Tie
990,Bayesian,236,216,452,30,26,Player A
991,Bayesian,211,241,452,24,24,Bayesian
992,Bayesian,251,201,452,21,23,Player A
993,Bayesian,212,237,449,21,24,Bayesian
994,Bayesian,216,226,442,26,28,Bayesian
995,Bayesian,266,201,467,24,19,Player A
996,Bayesian,210,265,475,26,17,Bayesian
997,Bayesian,273,203,476,24,16,Player A
998,Bayesian,246,246,492,37,15,Tie
999,Bayesian,246,231,477,34,19,Player A
1000,Bayesian,236,211,447,19,24,Player A
1001,Bayesian,245,220,465,28,21,Player A
1002,Bayesian,219,199,418,26,36,Player A
1003,Bayesian,205,230,435,22,29,Bayesian
1004,Bayesian,221,226,447,22,25,Bayesian
1005,Bayesian,206,216,422,24,34,Bayesian
1006,Bayesian,236,216,452,27,25,Player A
1007,Bayesian,209,239,448,26,26,Bayesian
1008,Bayesian,233,213,446,21,25,Player A
1009,Bayesian,205,240,445,23,26,Bayesian
1010,Bayesian,233,223,456,25,23,Player A
1011,Bayesian,202,252,454,20,22,Bayesian
1012,Bayesian,227,227,454,26,24,Tie
1013,Bayesian,221,231,452,24,24,Bayesian
1014,Bayesian,227,242,469,32,21,Bayesian
1015,Bayesian,228,233,461,24,21,Bayesian
1016,Bayesian,243,213,456,25,23,Player A
1017,Bayesian,226,221,447,25,26,Player A
1018,Bayesian,247,227,474,31,19,Player A
1019,Bayesian,202,247,449,27,26,Bayesian
1020,Bayesian,235,200,435,22,29,Player A
1021,Bayesian,212,212,424,17,31,Tie
1022,Bayesian,213,213,426,25,33,Tie
1023,Bayesian,245,225,470,24,18,Player A
1024,Bayesian,221,236,457,23,22,Bayesian
1025,Bayesian,198,233,431,15,28,Bayesian
1026,Bayesian,202,237,439,26,29,Bayesian
1027,Bayesian,251,216,467,24,19,Player A
1028,Bayesian,183,263,446,30,28,Bayesian
1029,Bayesian,248,218,466,29,21,Player A
1030,Bayesian,228,228,456,25,23,Tie
1031,Bayesian,179,244,423,16,31,Bayesian
1032,Bayesian,244,239,483,25,14,Player A
1033,Bayesian,235,190,425,21,32,Player A
1034,Bayesian,201,226,427,20,31,Bayesian
1035,Bayesian,214,239,453,31,26,Bayesian
1036,Bayesian,218,243,461,21,20,Bayesian
1037,Bayesian,221,226,447,25,26,Bayesian
1038,Bayesian,206,241,447,22,25,Bayesian
1039,Bayesian,252,222,474,31,19,Player A
1040,Bayesian,208,238,446,27,27,Bayesian
1041,Bayesian,199,259,458,24,22,Bayesian
1042,Bayesian,230,230,460,26,22,Tie
1043,Bayesian,245,230,475,32,19,Player A
1044,Bayesian,240,240,480,31,17,Tie
1045,Bayesian,186,251,437,18,27,Bayesian
1046,Bayesian,240,225,465,34,23,Player A
1047,Bayesian,228,213,441,19,26,Player A
1048,Bayesian,249,214,463,35,24,Player A
1049,Bayesian,200,220,420,22,34,Bayesian
1050,Bayesian,210,235,445,26,27,Bayesian
1051,Bayesian,218,233,451,20,23,Bayesian
1052,Bayesian,214,239,453,37,28,Bayesian
1053,Bayesian,266,196,462,22,20,Player A
1054,Bayesian,218,233,451,26,25,Bayesian
1055,Bayesian,217,232,449,27,26,Bayesian
1056,Bayesian,221,231,452,21,23,Bayesian
1057,Bayesian,260,195,455,24,23,Player A
1058,Bayesian,209,264,473,27,18,Bayesian
1059,Bayesian,219,219,438,19,27,Tie
1060,Bayesian,206,256,462,28,22,Bayesian
1061,Bayesian,201,236,437,27,30,Bayesian
1062,Bayesian,178,263,441,19,26,Bayesian
1063,Bayesian,211,231,442,23,27,Bayesian
1064,Bayesian,224,199,423,22,33,Player A
1065,Bayesian,249,184,433,23,30,Player A
1066,Bayesian,218,228,446,21,25,Bayesian
1067,Bayesian,199,254,453,28,25,Bayesian
1068,Bayesian,217,242,459,28,23,Bayesian
1069,Bayesian,229,209,438,28,30,Player A
1070,Bayesian,237,197,434,27,31,Player A
1071,Bayesian,225,220,445,23,26,Player A
1072,Bayesian,227,227,454,26,24,Tie
1073,Bayesian,219,214,433,26,31,Player A
1074,Bayesian,216,256,472,29,19,Bayesian
1075,Bayesian,254,219,473,24,17,Player A
1076,Bayesian,239,209,448,26,26,Player A
1077,Bayesian,248,233,481,29,16,Player A
1078,Bayesian,204,249,453,28,25,Bayesian
1079,Bayesian,229,229,458,27,23,Tie
1080,Bayesian,228,258,486,31,15,Bayesian
1081,Bayesian,214,209,423,19,32,Player A
1082,Bayesian,227,222,449,24,25,Player A
1083,Bayesian,246,196,442,14,24,Player A
1084,Bayesian,229,204,433,23,30,Player A
1085,Bayesian,242,197,439,20,27,Player A
1086,Bayesian,213,243,456,25,23,Bayesian
1087,Bayesian,237,222,459,22,21,Player A
1088,Bayesian,242,207,449,24,25,Player A
1089,Bayesian,206,216,422,21,33,Bayesian
1090,Bayesian,230,220,450,28,26,Player A
1091,Bayesian,256,211,467,30,21,Player A
1092,Bayesian,239,219,458,27,23,Player A
1093,Bayesian,254,204,458,33,25,Player A
1094,Bayesian,221,211,432,25,31,Player A
1095,Bayesian,192,252,444,22,26,Bayesian
1096,Bayesian,218,218,436,32,32,Tie
1097,Bayesian,207,237,444,22,26,Bayesian
1098,Bayesian,212,222,434,30,32,Bayesian
1099,Bayesian,203,258,461,33,24,Bayesian
1100,Bayesian,237,222,459,31,24,Player A
1101,Bayesian,220,225,445,20,25,Bayesian
1102,Bayesian,238,228,466,35,23,Player A
1103,Bayesian,185,245,430,23,31,Bayesian
1104,Bayesian,200,225,425,24,33,Bayesian
1105,Bayesian,201,231,432,22,30,Bayesian
1106,Bayesian,202,237,439,29,30,Bayesian
1107,Bayesian,264,194,458,24,22,Player A
1108,Bayesian,211,226,437,24,29,Bayesian
1109,Bayesian,244,199,443,21,26,Player A
1110,Bayesian,216,231,447,25,26,Bayesian
1111,Bayesian,222,232,454,23,23,Bayesian
1112,Bayesian,215,250,465,28,21,Bayesian
1113,Bayesian,218,238,456,31,25,Bayesian
1114,Bayesian,188,248,436,17,27,Bayesian
1115,Bayesian,227,232,459,28,23,Bayesian
1116,Bayesian,235,230,465,22,19,Player A
1117,Bayesian,218,218,436,29,31,Tie
1118,Bayesian,233,198,431,24,31,Player A
1119,Bayesian,210,225,435,28,31,Bayesian
1120,Bayesian,213,203,416,18,34,Player A
1121,Bayesian,220,250,470,24,18,Bayesian
1122,Bayesian,254,209,463,32,23,Player A
1123,Bayesian,226,221,447,22,25,Player A
1124,Bayesian,239,189,428,27,33,Player A
1125,Bayesian,242,192,434,21,29,Player A
1126,Bayesian,233,223,456,25,23,Player A
1127,Bayesian,241,206,447,28,27,Player A
1128,Bayesian,199,229,428,24,32,Bayesian
1129,Bayesian,193,248,441,28,29,Bayesian
1130,Bayesian,230,210,440,27,29,Player A
1131,Bayesian,264,199,463,23,20,Player A
1132,Bayesian,218,208,426,22,32,Player A
1133,Bayesian,192,247,439,23,28,Bayesian
1134,Bayesian,228,223,451,23,24,Player A
1135,Bayesian,244,199,443,24,27,Player A
1136,Bayesian,245,215,460,23,21,Player A
1137,Bayesian,238,208,446,24,26,Player A
1138,Bayesian,211,226,437,21,28,Bayesian
1139,Bayesian,228,218,446,24,26,Player A
1140,Bayesian,199,259,458,24,22,Bayesian
1141,Bayesian,249,239,488,36,16,Player A
1142,Bayesian,214,254,468,34,22,Bayesian
1143,Bayesian,212,212,424,23,33,Tie
1144,Bayesian,205,220,425,21,32,Bayesian
1145,Bayesian,213,238,451,23,24,Bayesian
1146,Bayesian,224,234,458,33,25,Bayesian
1147,Bayesian,208,218,426,19,31,Bayesian
1148,Bayesian,223,198,421,23,34,Player A
1149,Bayesian,237,207,444,19,25,Player A
1150,Bayesian,227,222,449,24,25,Player A
1151,Bayesian,228,233,461,24,21,Bayesian
1152,Bayesian,205,235,440,21,27,Bayesian
1153,Bayesian,238,228,466,26,20,Player A
1154,Bayesian,225,220,445,23,26,Player A
1155,Bayesian,242,222,464,30,22,Player A
1156,Bayesian,214,229,443,21,26,Bayesian
1157,Bayesian,204,249,453,28,25,Bayesian
1158,Bayesian,233,218,451,23,24,Player A
1159,Bayesian,223,218,441,25,28,Player A
1160,Bayesian,231,181,412,20,36,Player A
1161,Bayesian,211,201,412,20,36,Player A
1162,Bayesian,227,247,474,31,19,Bayesian
1163,Bayesian,197,217,414,13,33,Bayesian
1164,Bayesian,242,232,474,31,19,Player A
1165,Bayesian,230,220,450,25,25,Player A
1166,Bayesian,188,238,426,19,31,Bayesian
1167,Bayesian,202,277,479,27,16,Bayesian
1168,Bayesian,231,221,452,30,26,Player A
1169,Bayesian,221,216,437,24,29,Player A
1170,Bayesian,214,234,448,20,24,Bayesian
1171,Bayesian,233,208,441,22,27,Player A
1172,Bayesian,177,262,439,26,29,Bayesian
1173,Bayesian,221,216,437,24,29,Player A
1174,Bayesian,200,240,440,18,26,Bayesian
1175,Bayesian,197,252,449,24,25,Bayesian
1176,Bayesian,205,220,425,27,34,Bayesian
1177,Bayesian,220,235,455,27,24,Bayesian
1178,Bayesian,224,214,438,19,27,Player A
1179,Bayesian,232,242,474,31,19,Bayesian
1180,Bayesian,226,221,447,28,27,Player A
1181,Bayesian,215,220,435,19,28,Bayesian
1182,Bayesian,217,212,429,25,32,Player A
1183,Bayesian,241,231,472,20,16,Player A
1184,Bayesian,254,214,468,25,19,Player A
1185,Bayesian,249,219,468,25,19,Player A
1186,Bayesian,237,237,474,28,18,Tie
1187,Bayesian,236,211,447,22,25,Player A
1188,Bayesian,230,220,450,25,25,Player A
1189,Bayesian,264,189,453,25,24,Player A
1190,Bayesian,238,203,441,25,28,Player A
1191,Bayesian,233,233,466,26,20,Tie
1192,Bayesian,221,221,442,20,26,Tie
1193,Bayesian,234,219,453,22,23,Player A
1194,Bayesian,245,220,465,31,22,Player A
1195,Bayesian,171,251,422,21,33,Bayesian
1196,Bayesian,205,230,435,16,27,Bayesian
1197,Bayesian,231,226,457,23,22,Player A
1198,Bayesian,207,232,439,26,29,Bayesian
1199,Bayesian,244,219,463,26,21,Player A
1200,Bayesian,229,229,458,30,24,Tie
1201,Bayesian,243,233,476,30,18,Player A
1202,Bayesian,233,198,431,18,29,Player A
1203,Bayesian,194,239,433,26,31,Bayesian
1204,Bayesian,233,228,461,27,22,Player A
1205,Bayesian,233,223,456,25,23,Player A
1206,Bayesian,234,224,458,27,23,Player A
1207,Bayesian,228,228,456,31,25,Tie
1208,Bayesian,261,191,452,24,24,Player A
1209,Bayesian,210,240,450,22,24,Bayesian
1210,Bayesian,227,217,444,25,27,Player A
1211,Bayesian,255,205,460,29,23,Player A
1212,Bayesian,219,234,453,28,25,Bayesian
1213,Bayesian,216,241,457,26,23,Bayesian
1214,Bayesian,251,221,472,32,20,Player A
1215,Bayesian,222,237,459,28,23,Bayesian
1216,Bayesian,199,264,463,26,21,Bayesian
1217,Bayesian,212,232,444,22,26,Bayesian
1218,Bayesian,192,242,434,18,28,Bayesian
1219,Bayesian,232,222,454,23,23,Player A
1220,Bayesian,193,243,436,20,28,Bayesian
1221,Bayesian,249,224,473,30,19,Player A
1222,Bayesian,248,208,456,25,23,Player A
1223,Bayesian,218,243,461,27,22,Bayesian
1224,Bayesian,245,220,465,31,22,Player A
1225,Bayesian,215,250,465,25,20,Bayesian
1226,Bayesian,247,177,424,23,33,Player A
1227,Bayesian,234,219,453,22,23,Player A
1228,Bayesian,211,221,432,19,29,Bayesian
1229,Bayesian,207,242,449,21,24,Bayesian
1230,Bayesian,227,222,449,24,25,Player A
1231,Bayesian,252,207,459,34,25,Player A
1232,Bayesian,219,234,453,22,23,Bayesian
1233,Bayesian,213,238,451,26,25,Bayesian
1234,Bayesian,258,193,451,26,25,Player A
1235,Bayesian,242,207,449,27,26,Player A
1236,Bayesian,218,233,451,26,25,Bayesian
1237,Bayesian,234,199,433,32,33,Player A
1238,Bayesian,234,204,438,19,27,Player A
1239,Bayesian,248,193,441,28,29,Player A
1240,Bayesian,200,245,445,23,26,Bayesian
1241,Bayesian,272,197,469,29,20,Player A
1242,Bayesian,215,210,425,21,32,Player A
1243,Bayesian,221,216,437,18,27,Player A
1244,Bayesian,235,205,440,27,29,Player A
1245,Bayesian,256,206,462,28,22,Player A
1246,Bayesian,220,225,445,23,26,Bayesian
1247,Bayesian,250,225,475,29,18,Player A
1248,Bayesian,201,226,427,26,33,Bayesian
1249,Bayesian,231,206,437,27,30,Player A
1250,Bayesian,252,192,444,25,27,Player A
1251,Bayesian,230,240,470,30,20,Bayesian
1252,Bayesian,224,214,438,22,28,Player A
1253,Bayesian,265,200,465,19,18,Player A
1254,Bayesian,195,215,410,18,36,Bayesian
1255,Bayesian,244,224,468,28,20,Player A
1256,Bayesian,207,237,444,22,26,Bayesian
1257,Bayesian,210,245,455,27,24,Bayesian
1258,Bayesian,268,183,451,23,24,Player A
1259,Bayesian,208,243,451,26,25,Bayesian
1260,Bayesian,257,187,444,22,26,Player A
1261,Bayesian,197,247,444,28,28,Bayesian
1262,Bayesian,207,237,444,25,27,Bayesian
1263,Bayesian,239,219,458,27,23,Player A
1264,Bayesian,237,202,439,20,27,Player A
1265,Bayesian,219,239,458,27,23,Bayesian
1266,Bayesian,243,213,456,28,24,Player A
1267,Bayesian,251,206,457,26,23,Player A
1268,Bayesian,222,227,449,21,24,Bayesian
1269,Bayesian,233,203,436,23,29,Player A
1270,Bayesian,227,212,439,26,29,Player A
1271,Bayesian,228,213,441,25,28,Player A
1272,Bayesian,221,226,447,28,27,Bayesian
1273,Bayesian,214,249,463,23,20,Bayesian
1274,Bayesian,214,244,458,27,23,Bayesian
1275,Bayesian,224,209,433,26,31,Player A
1276,Bayesian,235,200,435,28,31,Player A
1277,Bayesian,209,229,438,13,25,Bayesian
1278,Bayesian,214,224,438,22,28,Bayesian
1279,Bayesian,243,218,461,33,24,Player A
1280,Bayesian,199,269,468,28,20,Bayesian
1281,Bayesian,190,255,445,20,25,Bayesian
1282,Bayesian,205,265,470,24,18,Bayesian
1283,Bayesian,208,238,446,27,27,Bayesian
1284,Bayesian,230,210,440,24,28,Player A
1285,Bayesian,248,223,471,25,18,Player A
1286,Bayesian,232,242,474,25,17,Bayesian
1287,Bayesian,228,223,451,26,25,Player A
1288,Bayesian,244,224,468,25,19,Player A
1289,Bayesian,245,225,470,27,19,Player A
1290,Bayesian,204,224,428,21,31,Bayesian
1291,Bayesian,219,224,443,21,26,Bayesian
1292,Bayesian,235,220,455,27,24,Player A
1293,Bayesian,228,243,471,25,18,Bayesian
1294,Bayesian,205,250,455,27,24,Bayesian
1295,Bayesian,199,259,458,21,21,Bayesian
1296,Bayesian,239,199,438,25,29,Player A
1297,Bayesian,207,247,454,26,24,Bayesian
1298,Bayesian,266,201,467,30,21,Player A
1299,Bayesian,281,176,457,29,24,Player A
1300,Bayesian,184,259,443,24,27,Bayesian
1301,Bayesian,218,243,461,30,23,Bayesian
1302,Bayesian,225,200,425,21,32,Player A
1303,Bayesian,201,241,442,29,29,Bayesian
1304,Bayesian,197,247,444,19,25,Bayesian
1305,Bayesian,224,229,453,25,24,Bayesian
1306,Bayesian,245,205,450,25,25,Player A
1307,Bayesian,234,219,453,25,24,Player A
1308,Bayesian,233,223,456,28,24,Player A
1309,Bayesian,208,243,451,26,25,Bayesian
1310,Bayesian,218,248,466,35,23,Bayesian
1311,Bayesian,235,215,450,25,25,Player A
1312,Bayesian,198,218,416,21,35,Bayesian
1313,Bayesian,222,232,454,26,24,Bayesian
1314,Bayesian,212,237,449,18,23,Bayesian
1315,Bayesian,229,229,458,24,22,Tie
1316,Bayesian,241,211,452,12,20,Player A
1317,Bayesian,216,256,472,32,20,Bayesian
1318,Bayesian,248,238,486,34,16,Player A
1319,Bayesian,211,211,422,21,33,Tie
1320,Bayesian,231,236,467,30,21,Bayesian
1321,Bayesian,245,220,465,25,20,Player A
1322,Bayesian,216,241,457,23,22,Bayesian
1323,Bayesian,210,245,455,24,23,Bayesian
1324,Bayesian,202,237,439,23,28,Bayesian
1325,Bayesian,227,222,449,21,24,Player A
1326,Bayesian,238,208,446,21,25,Player A
1327,Bayesian,243,208,451,20,23,Player A
1328,Bayesian,222,237,459,22,21,Bayesian
1329,Bayesian,213,213,426,19,31,Tie
1330,Bayesian,207,232,439,23,28,Bayesian
1331,Bayesian,212,227,439,17,26,Bayesian
1332,Bayesian,218,218,436,23,29,Tie
1333,Bayesian,205,225,430,20,30,Bayesian
1334,Bayesian,213,238,451,23,24,Bayesian
1335,Bayesian,235,230,465,31,22,Player A
1336,Bayesian,249,224,473,27,18,Player A
1337,Bayesian,225,210,435,22,29,Player A
1338,Bayesian,233,218,451,26,25,Player A
1339,Bayesian,205,240,445,23,26,Bayesian
1340,Bayesian,238,228,466,26,20,Player A
1341,Bayesian,235,240,475,32,19,Bayesian
1342,Bayesian,218,253,471,31,20,Bayesian
1343,Bayesian,236,221,457,32,25,Player A
1344,Bayesian,252,182,434,24,30,Player A
1345,Bayesian,228,218,446,30,28,Player A
1346,Bayesian,260,220,480,28,16,Player A
0,UCBPlayer,114,274,388,11,41,UCBPlayer
1,UCBPlayer,91,266,357,7,50,UCBPlayer
2,UCBPlayer,76,281,357,4,49,UCBPlayer
3,UCBPlayer,68,278,346,2,52,UCBPlayer
4,UCBPlayer,53,303,356,0,48,UCBPlayer
5,UCBPlayer,48,333,381,1,40,UCBPlayer
6,UCBPlayer,51,336,387,1,38,UCBPlayer
7,UCBPlayer,53,303,356,0,48,UCBPlayer
8,UCBPlayer,79,249,328,2,58,UCBPlayer
9,UCBPlayer,56,291,347,0,51,UCBPlayer
10,UCBPlayer,74,269,343,2,53,UCBPlayer
11,UCBPlayer,75,285,360,4,48,UCBPlayer
12,UCBPlayer,86,271,357,7,50,UCBPlayer
13,UCBPlayer,51,331,382,2,40,UCBPlayer
14,UCBPlayer,65,290,355,2,49,UCBPlayer
15,UCBPlayer,59,279,338,0,54,UCBPlayer
16,UCBPlayer,57,302,359,0,47,UCBPlayer
17,UCBPlayer,57,287,344,0,52,UCBPlayer
18,UCBPlayer,70,290,360,4,48,UCBPlayer
19,UCBPlayer,76,291,367,5,46,UCBPlayer
20,UCBPlayer,50,315,365,0,45,UCBPlayer
21,UCBPlayer,45,335,380,0,40,UCBPlayer
22,UCBPlayer,61,306,367,2,45,UCBPlayer
23,UCBPlayer,83,273,356,6,50,UCBPlayer
24,UCBPlayer,117,267,384,13,43,UCBPlayer
25,UCBPlayer,70,270,340,2,54,UCBPlayer
26,UCBPlayer,63,288,351,1,50,UCBPlayer
27,UCBPlayer,65,270,335,0,55,UCBPlayer
28,UCBPlayer,64,284,348,1,51,UCBPlayer
29,UCBPlayer,56,311,367,2,45,UCBPlayer
30,UCBPlayer,62,282,344,0,52,UCBPlayer
31,UCBPlayer,74,269,343,2,53,UCBPlayer
32,UCBPlayer,63,263,326,0,58,UCBPlayer
33,UCBPlayer,117,272,389,15,42,UCBPlayer
34,UCBPlayer,50,315,365,0,45,UCBPlayer
35,UCBPlayer,59,279,338,0,54,UCBPlayer
36,UCBPlayer,116,241,357,10,51,UCBPlayer
37,UCBPlayer,55,305,360,1,47,UCBPlayer
38,UCBPlayer,76,281,357,4,49,UCBPlayer
39,UCBPlayer,85,280,365,6,47,UCBPlayer
40,UCBPlayer,59,279,338,0,54,UCBPlayer
41,UCBPlayer,48,323,371,0,43,UCBPlayer
42,UCBPlayer,55,295,350,0,50,UCBPlayer
43,UCBPlayer,65,270,335,0,55,UCBPlayer
44,UCBPlayer,49,319,368,0,44,UCBPlayer
45,UCBPlayer,57,287,344,0,52,UCBPlayer
46,UCBPlayer,61,271,332,0,56,UCBPlayer
47,UCBPlayer,57,287,344,0,52,UCBPlayer
48,UCBPlayer,52,317,369,1,44,UCBPlayer
49,UCBPlayer,57,307,364,2,46,UCBPlayer
50,UCBPlayer,64,274,338,0,54,UCBPlayer
51,UCBPlayer,59,279,338,0,54,UCBPlayer
52,UCBPlayer,58,283,341,0,53,UCBPlayer
53,UCBPlayer,81,306,387,10,41,UCBPlayer
54,UCBPlayer,57,287,344,0,52,UCBPlayer
55,UCBPlayer,54,299,353,0,49,UCBPlayer
56,UCBPlayer,61,296,357,1,48,UCBPlayer
57,UCBPlayer,58,318,376,2,42,UCBPlayer
58,UCBPlayer,101,276,377,9,44,UCBPlayer
59,UCBPlayer,96,266,362,9,49,UCBPlayer
60,UCBPlayer,64,274,338,0,54,UCBPlayer
61,UCBPlayer,52,307,359,0,47,UCBPlayer
62,UCBPlayer,59,279,338,0,54,UCBPlayer
63,UCBPlayer,78,288,366,4,46,UCBPlayer
64,UCBPlayer,58,283,341,0,53,UCBPlayer
65,UCBPlayer,56,316,372,1,43,UCBPlayer
66,UCBPlayer,52,307,359,0,47,UCBPlayer
67,UCBPlayer,54,324,378,1,41,UCBPlayer
68,UCBPlayer,98,243,341,6,55,UCBPlayer
69,UCBPlayer,54,299,353,0,49,UCBPlayer
70,UCBPlayer,68,278,346,2,52,UCBPlayer
71,UCBPlayer,78,273,351,4,51,UCBPlayer
72,UCBPlayer,41,351,392,0,36,UCBPlayer
73,UCBPlayer,78,288,366,4,46,UCBPlayer
74,UCBPlayer,215,220,435,28,31,UCBPlayer
75,UCBPlayer,70,295,365,3,46,UCBPlayer
76,UCBPlayer,88,258,346,5,53,UCBPlayer
77,UCBPlayer,106,276,382,14,44,UCBPlayer
78,UCBPlayer,62,297,359,0,47,UCBPlayer
79,UCBPlayer,49,319,368,0,44,UCBPlayer
80,UCBPlayer,74,254,328,2,58,UCBPlayer
81,UCBPlayer,54,299,353,0,49,UCBPlayer
82,UCBPlayer,54,299,353,0,49,UCBPlayer
83,UCBPlayer,58,283,341,0,53,UCBPlayer
84,UCBPlayer,68,303,371,3,44,UCBPlayer
85,UCBPlayer,51,311,362,0,46,UCBPlayer
86,UCBPlayer,71,291,362,3,47,UCBPlayer
87,UCBPlayer,60,300,360,1,47,UCBPlayer
88,UCBPlayer,48,333,381,1,40,UCBPlayer
89,UCBPlayer,50,325,375,1,42,UCBPlayer
90,UCBPlayer,51,321,372,1,43,UCBPlayer
91,UCBPlayer,58,308,366,1,45,UCBPlayer
92,UCBPlayer,58,293,351,1,50,UCBPlayer
93,UCBPlayer,54,314,368,0,44,UCBPlayer
94,UCBPlayer,64,294,358,2,48,UCBPlayer
95,UCBPlayer,120,270,390,16,42,UCBPlayer
96,UCBPlayer,108,268,376,11,45,UCBPlayer
97,UCBPlayer,65,310,375,4,43,UCBPlayer
98,UCBPlayer,170,255,425,18,31,UCBPlayer
99,UCBPlayer,110,280,390,13,41,UCBPlayer
100,UCBPlayer,59,324,383,3,40,UCBPlayer
101,UCBPlayer,58,298,356,0,48,UCBPlayer
102,UCBPlayer,64,269,333,1,56,UCBPlayer
103,UCBPlayer,78,288,366,4,46,UCBPlayer
104,UCBPlayer,77,267,344,3,53,UCBPlayer
105,UCBPlayer,53,303,356,0,48,UCBPlayer
106,UCBPlayer,66,316,382,5,41,UCBPlayer
107,UCBPlayer,64,284,348,1,51,UCBPlayer
108,UCBPlayer,98,283,381,10,43,UCBPlayer
109,UCBPlayer,47,327,374,0,42,UCBPlayer
110,UCBPlayer,59,279,338,0,54,UCBPlayer
111,UCBPlayer,52,307,359,0,47,UCBPlayer
112,UCBPlayer,50,315,365,0,45,UCBPlayer
113,UCBPlayer,56,291,347,0,51,UCBPlayer
114,UCBPlayer,55,320,375,1,42,UCBPlayer
115,UCBPlayer,56,291,347,0,51,UCBPlayer
116,UCBPlayer,62,317,379,2,41,UCBPlayer
117,UCBPlayer,94,269,363,7,48,UCBPlayer
118,UCBPlayer,56,291,347,0,51,UCBPlayer
119,UCBPlayer,56,291,347,0,51,UCBPlayer
120,UCBPlayer,218,183,401,21,40,Player A
121,UCBPlayer,47,327,374,0,42,UCBPlayer
122,UCBPlayer,77,277,354,4,50,UCBPlayer
123,UCBPlayer,57,287,344,0,52,UCBPlayer
124,UCBPlayer,77,272,349,2,51,UCBPlayer
125,UCBPlayer,58,283,341,0,53,UCBPlayer
126,UCBPlayer,92,252,344,6,54,UCBPlayer
127,UCBPlayer,58,283,341,0,53,UCBPlayer
128,UCBPlayer,56,291,347,0,51,UCBPlayer
129,UCBPlayer,76,306,382,8,42,UCBPlayer
130,UCBPlayer,68,268,336,1,55,UCBPlayer
131,UCBPlayer,113,263,376,8,44,UCBPlayer
132,UCBPlayer,67,297,364,2,46,UCBPlayer
133,UCBPlayer,54,299,353,0,49,UCBPlayer
134,UCBPlayer,64,284,348,1,51,UCBPlayer
135,UCBPlayer,48,323,371,0,43,UCBPlayer
136,UCBPlayer,57,287,344,0,52,UCBPlayer
137,UCBPlayer,74,279,353,3,50,UCBPlayer
138,UCBPlayer,57,287,344,0,52,UCBPlayer
139,UCBPlayer,63,308,371,3,44,UCBPlayer
140,UCBPlayer,64,274,338,0,54,UCBPlayer
141,UCBPlayer,64,314,378,4,42,UCBPlayer
142,UCBPlayer,46,331,377,0,41,UCBPlayer
143,UCBPlayer,58,293,351,1,50,UCBPlayer
144,UCBPlayer,80,260,340,2,54,UCBPlayer
145,UCBPlayer,57,297,354,1,49,UCBPlayer
146,UCBPlayer,53,328,381,1,40,UCBPlayer
147,UCBPlayer,55,305,360,1,47,UCBPlayer
148,UCBPlayer,68,298,366,4,46,UCBPlayer
149,UCBPlayer,67,272,339,1,54,UCBPlayer
150,UCBPlayer,53,303,356,0,48,UCBPlayer
151,UCBPlayer,47,327,374,0,42,UCBPlayer
152,UCBPlayer,54,284,338,0,54,UCBPlayer
153,UCBPlayer,60,275,335,0,55,UCBPlayer
154,UCBPlayer,89,264,353,6,51,UCBPlayer
155,UCBPlayer,62,292,354,1,49,UCBPlayer
156,UCBPlayer,50,315,365,0,45,UCBPlayer
157,UCBPlayer,59,279,338,0,54,UCBPlayer
158,UCBPlayer,62,302,364,2,46,UCBPlayer
159,UCBPlayer,67,292,359,3,48,UCBPlayer
160,UCBPlayer,59,304,363,1,46,UCBPlayer
161,UCBPlayer,54,299,353,0,49,UCBPlayer
162,UCBPlayer,70,290,360,4,48,UCBPlayer
163,UCBPlayer,111,261,372,13,47,UCBPlayer
164,UCBPlayer,89,259,348,4,52,UCBPlayer
165,UCBPlayer,46,331,377,0,41,UCBPlayer
166,UCBPlayer,55,295,350,0,50,UCBPlayer
167,UCBPlayer,60,320,380,3,41,UCBPlayer
168,UCBPlayer,57,287,344,0,52,UCBPlayer
169,UCBPlayer,49,319,368,0,44,UCBPlayer
170,UCBPlayer,53,303,356,0,48,UCBPlayer
171,UCBPlayer,54,299,353,0,49,UCBPlayer
172,UCBPlayer,64,304,368,3,45,UCBPlayer
173,UCBPlayer,49,319,368,0,44,UCBPlayer
174,UCBPlayer,91,286,377,9,44,UCBPlayer
175,UCBPlayer,55,295,350,0,50,UCBPlayer
176,UCBPlayer,51,311,362,0,46,UCBPlayer
177,UCBPlayer,86,266,352,5,51,UCBPlayer
178,UCBPlayer,71,296,367,5,46,UCBPlayer
179,UCBPlayer,60,290,350,0,50,UCBPlayer
180,UCBPlayer,56,291,347,0,51,UCBPlayer
181,UCBPlayer,58,303,361,2,47,UCBPlayer
182,UCBPlayer,112,282,394,11,39,UCBPlayer
183,UCBPlayer,55,295,350,0,50,UCBPlayer
184,UCBPlayer,60,275,335,0,55,UCBPlayer
185,UCBPlayer,56,316,372,1,43,UCBPlayer
186,UCBPlayer,53,303,356,0,48,UCBPlayer
187,UCBPlayer,60,300,360,1,47,UCBPlayer
188,UCBPlayer,55,295,350,0,50,UCBPlayer
189,UCBPlayer,73,238,311,0,63,UCBPlayer
190,UCBPlayer,58,283,341,0,53,UCBPlayer
191,UCBPlayer,48,323,371,0,43,UCBPlayer
192,UCBPlayer,48,323,371,0,43,UCBPlayer
193,UCBPlayer,49,329,378,1,41,UCBPlayer
194,UCBPlayer,59,294,353,0,49,UCBPlayer
195,UCBPlayer,61,281,342,1,53,UCBPlayer
196,UCBPlayer,78,273,351,4,51,UCBPlayer
197,UCBPlayer,49,319,368,0,44,UCBPlayer
198,UCBPlayer,54,299,353,0,49,UCBPlayer
199,UCBPlayer,60,275,335,0,55,UCBPlayer
200,UCBPlayer,57,297,354,1,49,UCBPlayer
201,UCBPlayer,65,280,345,1,52,UCBPlayer
202,UCBPlayer,52,302,354,1,49,UCBPlayer
203,UCBPlayer,58,308,366,1,45,UCBPlayer
204,UCBPlayer,60,275,335,0,55,UCBPlayer
205,UCBPlayer,79,259,338,3,55,UCBPlayer
206,UCBPlayer,109,269,378,13,45,UCBPlayer
207,UCBPlayer,71,296,367,5,46,UCBPlayer
208,UCBPlayer,156,251,407,15,36,UCBPlayer
209,UCBPlayer,53,303,356,0,48,UCBPlayer
210,UCBPlayer,68,268,336,1,55,UCBPlayer
211,UCBPlayer,76,261,337,2,55,UCBPlayer
212,UCBPlayer,88,258,346,5,53,UCBPlayer
213,UCBPlayer,86,281,367,5,46,UCBPlayer
214,UCBPlayer,52,307,359,0,47,UCBPlayer
215,UCBPlayer,108,258,366,10,48,UCBPlayer
216,UCBPlayer,69,254,323,0,59,UCBPlayer
217,UCBPlayer,47,327,374,0,42,UCBPlayer
218,UCBPlayer,68,268,336,1,55,UCBPlayer
219,UCBPlayer,52,307,359,0,47,UCBPlayer
220,UCBPlayer,58,283,341,0,53,UCBPlayer
221,UCBPlayer,72,252,324,1,59,UCBPlayer
222,UCBPlayer,60,335,395,6,37,UCBPlayer
223,UCBPlayer,76,271,347,3,52,UCBPlayer
224,UCBPlayer,65,270,335,0,55,UCBPlayer
225,UCBPlayer,98,283,381,7,42,UCBPlayer
226,UCBPlayer,46,331,377,0,41,UCBPlayer
227,UCBPlayer,57,287,344,0,52,UCBPlayer
228,UCBPlayer,62,267,329,0,57,UCBPlayer
229,UCBPlayer,64,284,348,1,51,UCBPlayer
230,UCBPlayer,55,325,380,3,41,UCBPlayer
231,UCBPlayer,64,314,378,4,42,UCBPlayer
232,UCBPlayer,63,288,351,1,50,UCBPlayer
233,UCBPlayer,54,299,353,0,49,UCBPlayer
234,UCBPlayer,49,319,368,0,44,UCBPlayer
235,UCBPlayer,55,295,350,0,50,UCBPlayer
236,UCBPlayer,76,271,347,3,52,UCBPlayer
237,UCBPlayer,73,283,356,3,49,UCBPlayer
238,UCBPlayer,48,333,381,1,40,UCBPlayer
239,UCBPlayer,74,309,383,6,41,UCBPlayer
240,UCBPlayer,51,311,362,0,46,UCBPlayer
241,UCBPlayer,60,275,335,0,55,UCBPlayer
242,UCBPlayer,66,276,342,1,53,UCBPlayer
243,UCBPlayer,58,283,341,0,53,UCBPlayer
244,UCBPlayer,54,309,363,1,46,UCBPlayer
245,UCBPlayer,42,347,389,0,37,UCBPlayer
246,UCBPlayer,60,315,375,1,42,UCBPlayer
247,UCBPlayer,57,287,344,0,52,UCBPlayer
248,UCBPlayer,70,290,360,4,48,UCBPlayer
249,UCBPlayer,70,285,355,5,50,UCBPlayer
250,UCBPlayer,96,251,347,3,52,UCBPlayer
251,UCBPlayer,60,295,355,2,49,UCBPlayer
252,UCBPlayer,75,270,345,4,53,UCBPlayer
253,UCBPlayer,68,288,356,3,49,UCBPlayer
254,UCBPlayer,53,318,371,0,43,UCBPlayer
255,UCBPlayer,94,254,348,7,53,UCBPlayer
256,UCBPlayer,71,291,362,3,47,UCBPlayer
257,UCBPlayer,80,285,365,6,47,UCBPlayer
258,UCBPlayer,60,300,360,1,47,UCBPlayer
259,UCBPlayer,54,299,353,0,49,UCBPlayer
260,UCBPlayer,71,256,327,1,58,UCBPlayer
261,UCBPlayer,65,290,355,2,49,UCBPlayer
262,UCBPlayer,65,280,345,1,52,UCBPlayer
263,UCBPlayer,68,288,356,3,49,UCBPlayer
264,UCBPlayer,67,282,349,2,51,UCBPlayer
265,UCBPlayer,53,303,356,0,48,UCBPlayer
266,UCBPlayer,57,322,379,2,41,UCBPlayer
267,UCBPlayer,57,287,344,0,52,UCBPlayer
268,UCBPlayer,61,271,332,0,56,UCBPlayer
269,UCBPlayer,59,279,338,0,54,UCBPlayer
270,UCBPlayer,73,273,346,2,52,UCBPlayer
271,UCBPlayer,58,283,341,0,53,UCBPlayer
272,UCBPlayer,59,304,363,1,46,UCBPlayer
273,UCBPlayer,46,331,377,0,41,UCBPlayer
274,UCBPlayer,58,283,341,0,53,UCBPlayer
275,UCBPlayer,61,306,367,2,45,UCBPlayer
276,UCBPlayer,44,339,383,0,39,UCBPlayer
277,UCBPlayer,83,293,376,5,43,UCBPlayer
278,UCBPlayer,51,311,362,0,46,UCBPlayer
279,UCBPlayer,53,303,356,0,48,UCBPlayer
280,UCBPlayer,78,288,366,4,46,UCBPlayer
281,UCBPlayer,67,302,369,4,45,UCBPlayer
282,UCBPlayer,64,299,363,4,47,UCBPlayer
283,UCBPlayer,69,289,358,2,48,UCBPlayer
284,UCBPlayer,55,305,360,1,47,UCBPlayer
285,UCBPlayer,74,269,343,2,53,UCBPlayer
286,UCBPlayer,57,287,344,0,52,UCBPlayer
287,UCBPlayer,48,323,371,0,43,UCBPlayer
288,UCBPlayer,58,283,341,0,53,UCBPlayer
289,UCBPlayer,67,272,339,1,54,UCBPlayer
290,UCBPlayer,61,306,367,2,45,UCBPlayer
291,UCBPlayer,83,248,331,2,57,UCBPlayer
292,UCBPlayer,55,315,370,2,44,UCBPlayer
293,UCBPlayer,75,265,340,2,54,UCBPlayer
294,UCBPlayer,55,305,360,1,47,UCBPlayer
295,UCBPlayer,67,292,359,3,48,UCBPlayer
296,UCBPlayer,47,327,374,0,42,UCBPlayer
297,UCBPlayer,67,292,359,3,48,UCBPlayer
298,UCBPlayer,77,292,369,4,45,UCBPlayer
299,UCBPlayer,61,271,332,0,56,UCBPlayer
300,UCBPlayer,52,307,359,0,47,UCBPlayer
301,UCBPlayer,60,290,350,0,50,UCBPlayer
302,UCBPlayer,58,278,336,1,55,UCBPlayer
303,UCBPlayer,64,309,373,2,43,UCBPlayer
304,UCBPlayer,64,269,333,1,56,UCBPlayer
305,UCBPlayer,54,324,378,1,41,UCBPlayer
306,UCBPlayer,83,293,376,5,43,UCBPlayer
307,UCBPlayer,61,271,332,0,56,UCBPlayer
308,UCBPlayer,62,282,344,0,52,UCBPlayer
309,UCBPlayer,72,287,359,3,48,UCBPlayer
310,UCBPlayer,53,303,356,0,48,UCBPlayer
311,UCBPlayer,74,279,353,3,50,UCBPlayer
312,UCBPlayer,95,285,380,9,43,UCBPlayer
313,UCBPlayer,66,296,362,3,47,UCBPlayer
314,UCBPlayer,50,315,365,0,45,UCBPlayer
315,UCBPlayer,66,276,342,1,53,UCBPlayer
316,UCBPlayer,69,299,368,3,45,UCBPlayer
317,UCBPlayer,62,312,374,3,43,UCBPlayer
318,UCBPlayer,57,327,384,1,39,UCBPlayer
319,UCBPlayer,54,299,353,0,49,UCBPlayer
320,UCBPlayer,53,303,356,0,48,UCBPlayer
321,UCBPlayer,60,290,350,0,50,UCBPlayer
322,UCBPlayer,64,284,348,1,51,UCBPlayer
323,UCBPlayer,43,343,386,0,38,UCBPlayer
324,UCBPlayer,64,294,358,2,48,UCBPlayer
325,UCBPlayer,49,329,378,1,41,UCBPlayer
326,UCBPlayer,55,295,350,0,50,UCBPlayer
327,UCBPlayer,49,319,368,0,44,UCBPlayer
328,UCBPlayer,50,315,365,0,45,UCBPlayer
329,UCBPlayer,82,277,359,6,49,UCBPlayer
330,UCBPlayer,52,307,359,0,47,UCBPlayer
331,UCBPlayer,52,342,394,2,36,UCBPlayer
332,UCBPlayer,68,283,351,1,50,UCBPlayer
333,UCBPlayer,54,299,353,0,49,UCBPlayer
334,UCBPlayer,72,302,374,6,44,UCBPlayer
335,UCBPlayer,77,277,354,4,50,UCBPlayer
336,UCBPlayer,48,323,371,0,43,UCBPlayer
337,UCBPlayer,50,315,365,0,45,UCBPlayer
338,UCBPlayer,121,266,387,16,43,UCBPlayer
339,UCBPlayer,48,323,371,0,43,UCBPlayer
340,UCBPlayer,168,233,401,21,40,UCBPlayer
341,UCBPlayer,86,256,342,4,54,UCBPlayer
342,UCBPlayer,61,306,367,2,45,UCBPlayer
343,UCBPlayer,51,311,362,0,46,UCBPlayer
344,UCBPlayer,72,262,334,2,56,UCBPlayer
345,UCBPlayer,53,343,396,4,36,UCBPlayer
346,UCBPlayer,67,312,379,5,42,UCBPlayer
347,UCBPlayer,56,321,377,3,42,UCBPlayer
348,UCBPlayer,88,258,346,5,53,UCBPlayer
349,UCBPlayer,81,321,402,10,36,UCBPlayer
350,UCBPlayer,97,272,369,7,46,UCBPlayer
351,UCBPlayer,55,295,350,0,50,UCBPlayer
352,UCBPlayer,70,260,330,1,57,UCBPlayer
353,UCBPlayer,62,287,349,2,51,UCBPlayer
354,UCBPlayer,58,318,376,2,42,UCBPlayer
355,UCBPlayer,62,277,339,1,54,UCBPlayer
356,UCBPlayer,64,284,348,1,51,UCBPlayer
357,UCBPlayer,64,309,373,2,43,UCBPlayer
358,UCBPlayer,63,318,381,4,41,UCBPlayer
359,UCBPlayer,56,326,382,2,40,UCBPlayer
360,UCBPlayer,49,319,368,0,44,UCBPlayer
361,UCBPlayer,89,309,398,9,37,UCBPlayer
362,UCBPlayer,57,287,344,0,52,UCBPlayer
363,UCBPlayer,55,295,350,0,50,UCBPlayer
364,UCBPlayer,50,315,365,0,45,UCBPlayer
365,UCBPlayer,48,323,371,0,43,UCBPlayer
366,UCBPlayer,55,295,350,0,50,UCBPlayer
367,UCBPlayer,53,303,356,0,48,UCBPlayer
368,UCBPlayer,80,265,345,4,53,UCBPlayer
369,UCBPlayer,59,314,373,2,43,UCBPlayer
370,UCBPlayer,56,291,347,0,51,UCBPlayer
371,UCBPlayer,64,284,348,1,51,UCBPlayer
372,UCBPlayer,61,311,372,1,43,UCBPlayer
373,UCBPlayer,49,319,368,0,44,UCBPlayer
374,UCBPlayer,58,318,376,2,42,UCBPlayer
375,UCBPlayer,55,305,360,1,47,UCBPlayer
376,UCBPlayer,68,278,346,2,52,UCBPlayer
377,UCBPlayer,74,269,343,2,53,UCBPlayer
378,UCBPlayer,69,294,363,4,47,UCBPlayer
379,UCBPlayer,186,226,412,26,38,UCBPlayer
380,UCBPlayer,53,303,356,0,48,UCBPlayer
381,UCBPlayer,51,311,362,0,46,UCBPlayer
382,UCBPlayer,66,296,362,3,47,UCBPlayer
383,UCBPlayer,57,287,344,0,52,UCBPlayer
384,UCBPlayer,56,291,347,0,51,UCBPlayer
385,UCBPlayer,63,308,371,3,44,UCBPlayer
386,UCBPlayer,67,282,349,2,51,UCBPlayer
387,UCBPlayer,50,315,365,0,45,UCBPlayer
388,UCBPlayer,54,299,353,0,49,UCBPlayer
389,UCBPlayer,56,326,382,2,40,UCBPlayer
390,UCBPlayer,51,321,372,1,43,UCBPlayer
391,UCBPlayer,57,302,359,0,47,UCBPlayer
392,UCBPlayer,65,305,370,2,44,UCBPlayer
393,UCBPlayer,58,283,341,0,53,UCBPlayer
394,UCBPlayer,83,288,371,6,45,UCBPlayer
395,UCBPlayer,60,275,335,0,55,UCBPlayer
396,UCBPlayer,60,275,335,0,55,UCBPlayer
397,UCBPlayer,69,254,323,0,59,UCBPlayer
398,UCBPlayer,62,287,349,2,51,UCBPlayer
399,UCBPlayer,63,298,361,2,47,UCBPlayer
400,UCBPlayer,63,273,336,1,55,UCBPlayer
401,UCBPlayer,68,348,416,9,31,UCBPlayer
402,UCBPlayer,77,267,344,3,53,UCBPlayer
403,UCBPlayer,58,303,361,2,47,UCBPlayer
404,UCBPlayer,73,303,376,5,43,UCBPlayer
405,UCBPlayer,58,288,346,2,52,UCBPlayer
406,UCBPlayer,85,290,375,7,44,UCBPlayer
407,UCBPlayer,44,324,368,0,44,UCBPlayer
408,UCBPlayer,63,288,351,1,50,UCBPlayer
409,UCBPlayer,59,324,383,3,40,UCBPlayer
410,UCBPlayer,60,300,360,1,47,UCBPlayer
411,UCBPlayer,66,301,367,2,45,UCBPlayer
412,UCBPlayer,54,299,353,0,49,UCBPlayer
413,UCBPlayer,48,323,371,0,43,UCBPlayer
414,UCBPlayer,105,260,365,12,49,UCBPlayer
415,UCBPlayer,56,291,347,0,51,UCBPlayer
416,UCBPlayer,60,310,370,2,44,UCBPlayer
417,UCBPlayer,118,253,371,9,46,UCBPlayer
418,UCBPlayer,58,283,341,0,53,UCBPlayer
419,UCBPlayer,48,323,371,0,43,UCBPlayer
420,UCBPlayer,75,285,360,4,48,UCBPlayer
421,UCBPlayer,53,303,356,0,48,UCBPlayer
422,UCBPlayer,53,303,356,0,48,UCBPlayer
423,UCBPlayer,72,287,359,3,48,UCBPlayer
424,UCBPlayer,66,286,352,2,50,UCBPlayer
425,UCBPlayer,65,265,330,1,57,UCBPlayer
426,UCBPlayer,76,281,357,4,49,UCBPlayer
427,UCBPlayer,50,325,375,1,42,UCBPlayer
428,UCBPlayer,54,314,368,0,44,UCBPlayer
429,UCBPlayer,70,300,370,5,45,UCBPlayer
430,UCBPlayer,52,332,384,1,39,UCBPlayer
431,UCBPlayer,59,314,373,2,43,UCBPlayer
432,UCBPlayer,55,305,360,1,47,UCBPlayer
433,UCBPlayer,77,277,354,4,50,UCBPlayer
434,UCBPlayer,58,283,341,0,53,UCBPlayer
435,UCBPlayer,54,299,353,0,49,UCBPlayer
436,UCBPlayer,60,300,360,1,47,UCBPlayer
437,UCBPlayer,59,279,338,0,54,UCBPlayer
438,UCBPlayer,58,313,371,3,44,UCBPlayer
439,UCBPlayer,65,280,345,1,52,UCBPlayer
440,UCBPlayer,82,277,359,6,49,UCBPlayer
441,UCBPlayer,54,319,373,2,43,UCBPlayer
442,UCBPlayer,97,287,384,10,42,UCBPlayer
443,UCBPlayer,49,319,368,0,44,UCBPlayer
444,UCBPlayer,100,265,365,6,47,UCBPlayer
445,UCBPlayer,53,303,356,0,48,UCBPlayer
446,UCBPlayer,70,300,370,5,45,UCBPlayer
447,UCBPlayer,70,275,345,1,52,UCBPlayer
448,UCBPlayer,49,319,368,0,44,UCBPlayer
449,UCBPlayer,86,296,382,8,42,UCBPlayer
450,UCBPlayer,47,327,374,0,42,UCBPlayer
451,UCBPlayer,61,296,357,1,48,UCBPlayer
452,UCBPlayer,58,283,341,0,53,UCBPlayer
453,UCBPlayer,56,321,377,3,42,UCBPlayer
454,UCBPlayer,72,257,329,0,57,UCBPlayer
455,UCBPlayer,73,238,311,0,63,UCBPlayer
456,UCBPlayer,57,287,344,0,52,UCBPlayer
457,UCBPlayer,56,291,347,0,51,UCBPlayer
458,UCBPlayer,51,296,347,0,51,UCBPlayer
459,UCBPlayer,49,319,368,0,44,UCBPlayer
460,UCBPlayer,55,295,350,0,50,UCBPlayer
461,UCBPlayer,65,310,375,4,43,UCBPlayer
462,UCBPlayer,61,316,377,3,42,UCBPlayer
463,UCBPlayer,44,339,383,0,39,UCBPlayer
464,UCBPlayer,63,298,361,2,47,UCBPlayer
465,UCBPlayer,62,292,354,1,49,UCBPlayer
466,UCBPlayer,64,314,378,4,42,UCBPlayer
467,UCBPlayer,63,298,361,2,47,UCBPlayer
468,UCBPlayer,43,343,386,0,38,UCBPlayer
469,UCBPlayer,55,295,350,0,50,UCBPlayer
470,UCBPlayer,63,313,376,2,42,UCBPlayer
471,UCBPlayer,54,299,353,0,49,UCBPlayer
472,UCBPlayer,55,295,350,0,50,UCBPlayer
473,UCBPlayer,68,258,326,0,58,UCBPlayer
474,UCBPlayer,54,299,353,0,49,UCBPlayer
475,UCBPlayer,47,327,374,0,42,UCBPlayer
476,UCBPlayer,51,321,372,1,43,UCBPlayer
477,UCBPlayer,57,312,369,1,44,UCBPlayer
478,UCBPlayer,56,291,347,0,51,UCBPlayer
479,UCBPlayer,48,323,371,0,43,UCBPlayer
480,UCBPlayer,50,315,365,0,45,UCBPlayer
481,UCBPlayer,53,313,366,1,45,UCBPlayer
482,UCBPlayer,59,304,363,1,46,UCBPlayer
483,UCBPlayer,48,323,371,0,43,UCBPlayer
484,UCBPlayer,53,333,386,3,39,UCBPlayer
485,UCBPlayer,55,310,365,0,45,UCBPlayer
486,UCBPlayer,56,321,377,3,42,UCBPlayer
487,UCBPlayer,52,322,374,0,42,UCBPlayer
488,UCBPlayer,59,319,378,4,42,UCBPlayer
489,UCBPlayer,59,294,353,0,49,UCBPlayer
490,UCBPlayer,76,261,337,5,56,UCBPlayer
491,UCBPlayer,45,345,390,1,37,UCBPlayer
492,UCBPlayer,57,312,369,1,44,UCBPlayer
493,UCBPlayer,67,277,344,3,53,UCBPlayer
494,UCBPlayer,72,337,409,5,32,UCBPlayer
495,UCBPlayer,49,319,368,0,44,UCBPlayer
496,UCBPlayer,53,303,356,0,48,UCBPlayer
497,UCBPlayer,54,299,353,0,49,UCBPlayer
498,UCBPlayer,57,287,344,0,52,UCBPlayer
499,UCBPlayer,52,307,359,0,47,UCBPlayer
500,UCBPlayer,86,261,347,6,53,UCBPlayer
501,UCBPlayer,64,274,338,0,54,UCBPlayer
502,UCBPlayer,53,303,356,0,48,UCBPlayer
503,UCBPlayer,51,311,362,0,46,UCBPlayer
504,UCBPlayer,64,284,348,4,52,UCBPlayer
505,UCBPlayer,98,258,356,6,50,UCBPlayer
506,UCBPlayer,77,302,379,5,42,UCBPlayer
507,UCBPlayer,44,339,383,0,39,UCBPlayer
508,UCBPlayer,82,257,339,4,55,UCBPlayer
509,UCBPlayer,67,257,324,1,59,UCBPlayer
510,UCBPlayer,55,320,375,1,42,UCBPlayer
511,UCBPlayer,86,281,367,8,47,UCBPlayer
512,UCBPlayer,48,323,371,0,43,UCBPlayer
513,UCBPlayer,54,299,353,0,49,UCBPlayer
514,UCBPlayer,68,278,346,2,52,UCBPlayer
515,UCBPlayer,50,315,365,0,45,UCBPlayer
516,UCBPlayer,67,297,364,2,46,UCBPlayer
517,UCBPlayer,54,299,353,0,49,UCBPlayer
518,UCBPlayer,63,263,326,0,58,UCBPlayer
519,UCBPlayer,75,290,365,3,46,UCBPlayer
520,UCBPlayer,56,291,347,0,51,UCBPlayer
521,UCBPlayer,116,241,357,10,51,UCBPlayer
522,UCBPlayer,68,278,346,2,52,UCBPlayer
523,UCBPlayer,57,287,344,0,52,UCBPlayer
524,UCBPlayer,49,329,378,1,41,UCBPlayer
525,UCBPlayer,71,291,362,3,47,UCBPlayer
526,UCBPlayer,74,279,353,3,50,UCBPlayer
527,UCBPlayer,56,291,347,0,51,UCBPlayer
528,UCBPlayer,71,256,327,1,58,UCBPlayer
529,UCBPlayer,174,229,403,20,39,UCBPlayer
530,UCBPlayer,50,315,365,0,45,UCBPlayer
531,UCBPlayer,66,276,342,1,53,UCBPlayer
532,UCBPlayer,74,274,348,4,52,UCBPlayer
533,UCBPlayer,55,295,350,0,50,UCBPlayer
534,UCBPlayer,55,295,350,0,50,UCBPlayer
535,UCBPlayer,49,319,368,0,44,UCBPlayer
536,UCBPlayer,50,325,375,1,42,UCBPlayer
537,UCBPlayer,91,311,402,13,37,UCBPlayer
538,UCBPlayer,52,317,369,1,44,UCBPlayer
539,UCBPlayer,54,314,368,0,44,UCBPlayer
540,UCBPlayer,56,291,347,0,51,UCBPlayer
541,UCBPlayer,56,291,347,0,51,UCBPlayer
542,UCBPlayer,56,291,347,0,51,UCBPlayer
543,UCBPlayer,55,315,370,2,44,UCBPlayer
544,UCBPlayer,83,263,346,5,53,UCBPlayer
545,UCBPlayer,79,309,388,5,39,UCBPlayer
546,UCBPlayer,49,329,378,1,41,UCBPlayer
547,UCBPlayer,56,316,372,1,43,UCBPlayer
548,UCBPlayer,77,272,349,2,51,UCBPlayer
549,UCBPlayer,61,281,342,1,53,UCBPlayer
550,UCBPlayer,64,289,353,0,49,UCBPlayer
551,UCBPlayer,53,313,366,1,45,UCBPlayer
552,UCBPlayer,44,349,393,1,36,UCBPlayer
553,UCBPlayer,82,292,374,9,45,UCBPlayer
554,UCBPlayer,78,288,366,4,46,UCBPlayer
555,UCBPlayer,63,278,341,0,53,UCBPlayer
556,UCBPlayer,49,319,368,0,44,UCBPlayer
557,UCBPlayer,63,298,361,2,47,UCBPlayer
558,UCBPlayer,52,322,374,0,42,UCBPlayer
559,UCBPlayer,52,307,359,0,47,UCBPlayer
560,UCBPlayer,55,280,335,0,55,UCBPlayer
561,UCBPlayer,54,299,353,0,49,UCBPlayer
562,UCBPlayer,60,320,380,3,41,UCBPlayer
563,UCBPlayer,47,327,374,0,42,UCBPlayer
564,UCBPlayer,60,310,370,2,44,UCBPlayer
565,UCBPlayer,71,296,367,2,45,UCBPlayer
566,UCBPlayer,51,311,362,0,46,UCBPlayer
567,UCBPlayer,147,247,394,17,41,UCBPlayer
568,UCBPlayer,53,303,356,0,48,UCBPlayer
569,UCBPlayer,92,277,369,7,46,UCBPlayer
570,UCBPlayer,60,275,335,0,55,UCBPlayer
571,UCBPlayer,84,289,373,8,45,UCBPlayer
572,UCBPlayer,63,298,361,2,47,UCBPlayer
573,UCBPlayer,59,294,353,0,49,UCBPlayer
574,UCBPlayer,55,320,375,1,42,UCBPlayer
575,UCBPlayer,69,254,323,0,59,UCBPlayer
576,UCBPlayer,62,302,364,2,46,UCBPlayer
577,UCBPlayer,70,270,340,2,54,UCBPlayer
578,UCBPlayer,91,256,347,6,53,UCBPlayer
579,UCBPlayer,51,311,362,0,46,UCBPlayer
580,UCBPlayer,59,314,373,2,43,UCBPlayer
581,UCBPlayer,77,297,374,6,44,UCBPlayer
582,UCBPlayer,52,337,389,3,38,UCBPlayer
583,UCBPlayer,57,312,369,1,44,UCBPlayer
584,UCBPlayer,63,298,361,2,47,UCBPlayer
585,UCBPlayer,84,299,383,9,42,UCBPlayer
586,UCBPlayer,61,286,347,0,51,UCBPlayer
587,UCBPlayer,108,273,381,10,43,UCBPlayer
588,UCBPlayer,58,293,351,1,50,UCBPlayer
589,UCBPlayer,80,285,365,6,47,UCBPlayer
590,UCBPlayer,68,258,326,0,58,UCBPlayer
591,UCBPlayer,56,291,347,0,51,UCBPlayer
592,UCBPlayer,55,295,350,0,50,UCBPlayer
593,UCBPlayer,53,303,356,0,48,UCBPlayer
594,UCBPlayer,54,309,363,1,46,UCBPlayer
595,UCBPlayer,57,302,359,0,47,UCBPlayer
596,UCBPlayer,61,296,357,1,48,UCBPlayer
597,UCBPlayer,54,299,353,0,49,UCBPlayer
598,UCBPlayer,57,312,369,1,44,UCBPlayer
599,UCBPlayer,67,282,349,2,51,UCBPlayer
600,UCBPlayer,66,276,342,1,53,UCBPlayer
601,UCBPlayer,48,333,381,1,40,UCBPlayer
602,UCBPlayer,103,258,361,8,49,UCBPlayer
603,UCBPlayer,95,245,340,5,55,UCBPlayer
604,UCBPlayer,85,260,345,4,53,UCBPlayer
605,UCBPlayer,87,222,309,1,64,UCBPlayer
606,UCBPlayer,52,307,359,0,47,UCBPlayer
607,UCBPlayer,47,332,379,2,41,UCBPlayer
608,UCBPlayer,68,288,356,3,49,UCBPlayer
609,UCBPlayer,67,297,364,2,46,UCBPlayer
610,UCBPlayer,70,260,330,1,57,UCBPlayer
611,UCBPlayer,51,296,347,0,51,UCBPlayer
612,UCBPlayer,47,347,394,2,36,UCBPlayer
613,UCBPlayer,64,294,358,2,48,UCBPlayer
614,UCBPlayer,82,257,339,4,55,UCBPlayer
615,UCBPlayer,62,302,364,2,46,UCBPlayer
616,UCBPlayer,52,307,359,0,47,UCBPlayer
617,UCBPlayer,52,307,359,0,47,UCBPlayer
618,UCBPlayer,66,286,352,2,50,UCBPlayer
619,UCBPlayer,63,298,361,2,47,UCBPlayer
620,UCBPlayer,63,318,381,4,41,UCBPlayer
621,UCBPlayer,59,279,338,0,54,UCBPlayer
622,UCBPlayer,51,311,362,0,46,UCBPlayer
623,UCBPlayer,46,331,377,0,41,UCBPlayer
624,UCBPlayer,51,311,362,0,46,UCBPlayer
625,UCBPlayer,61,296,357,1,48,UCBPlayer
626,UCBPlayer,47,327,374,0,42,UCBPlayer
627,UCBPlayer,57,287,344,0,52,UCBPlayer
628,UCBPlayer,57,312,369,1,44,UCBPlayer
629,UCBPlayer,44,339,383,0,39,UCBPlayer
630,UCBPlayer,43,343,386,0,38,UCBPlayer
631,UCBPlayer,61,271,332,0,56,UCBPlayer
632,UCBPlayer,59,334,393,4,37,UCBPlayer
633,UCBPlayer,66,276,342,1,53,UCBPlayer
634,UCBPlayer,63,298,361,2,47,UCBPlayer
635,UCBPlayer,48,323,371,0,43,UCBPlayer
636,UCBPlayer,70,280,350,3,51,UCBPlayer
637,UCBPlayer,128,258,386,15,43,UCBPlayer
638,UCBPlayer,55,295,350,0,50,UCBPlayer
639,UCBPlayer,56,291,347,0,51,UCBPlayer
640,UCBPlayer,59,279,338,0,54,UCBPlayer
641,UCBPlayer,86,281,367,5,46,UCBPlayer
642,UCBPlayer,59,279,338,0,54,UCBPlayer
643,UCBPlayer,55,295,350,0,50,UCBPlayer
644,UCBPlayer,46,331,377,0,41,UCBPlayer
645,UCBPlayer,54,299,353,0,49,UCBPlayer
646,UCBPlayer,57,287,344,0,52,UCBPlayer
647,UCBPlayer,98,253,351,7,52,UCBPlayer
648,UCBPlayer,56,291,347,0,51,UCBPlayer
649,UCBPlayer,54,299,353,0,49,UCBPlayer
650,UCBPlayer,55,295,350,0,50,UCBPlayer
651,UCBPlayer,52,327,379,2,41,UCBPlayer
652,UCBPlayer,65,280,345,1,52,UCBPlayer
653,UCBPlayer,43,343,386,0,38,UCBPlayer
654,UCBPlayer,61,291,352,2,50,UCBPlayer
655,UCBPlayer,72,277,349,2,51,UCBPlayer
656,UCBPlayer,70,270,340,2,54,UCBPlayer
657,UCBPlayer,49,329,378,1,41,UCBPlayer
658,UCBPlayer,64,294,358,2,48,UCBPlayer
659,UCBPlayer,56,311,367,2,45,UCBPlayer
660,UCBPlayer,64,289,353,3,50,UCBPlayer
661,UCBPlayer,61,321,382,2,40,UCBPlayer
662,UCBPlayer,51,296,347,0,51,UCBPlayer
663,UCBPlayer,59,294,353,0,49,UCBPlayer
664,UCBPlayer,58,308,366,1,45,UCBPlayer
665,UCBPlayer,62,292,354,1,49,UCBPlayer
666,UCBPlayer,69,264,333,1,56,UCBPlayer
667,UCBPlayer,73,263,336,1,55,UCBPlayer
668,UCBPlayer,48,333,381,1,40,UCBPlayer
669,UCBPlayer,133,263,396,13,39,UCBPlayer
670,UCBPlayer,52,307,359,0,47,UCBPlayer
671,UCBPlayer,51,311,362,0,46,UCBPlayer
672,UCBPlayer,49,319,368,0,44,UCBPlayer
673,UCBPlayer,61,271,332,0,56,UCBPlayer
674,UCBPlayer,87,257,344,3,53,UCBPlayer
675,UCBPlayer,75,265,340,2,54,UCBPlayer
676,UCBPlayer,54,299,353,0,49,UCBPlayer
677,UCBPlayer,49,319,368,0,44,UCBPlayer
678,UCBPlayer,52,307,359,0,47,UCBPlayer
679,UCBPlayer,53,303,356,0,48,UCBPlayer
680,UCBPlayer,70,250,320,0,60,UCBPlayer
681,UCBPlayer,65,295,360,1,47,UCBPlayer
682,UCBPlayer,60,275,335,0,55,UCBPlayer
683,UCBPlayer,82,262,344,3,53,UCBPlayer
684,UCBPlayer,60,275,335,0,55,UCBPlayer
685,UCBPlayer,54,299,353,0,49,UCBPlayer
686,UCBPlayer,58,283,341,0,53,UCBPlayer
687,UCBPlayer,62,297,359,3,48,UCBPlayer
688,UCBPlayer,68,278,346,2,52,UCBPlayer
689,UCBPlayer,67,287,354,1,49,UCBPlayer
690,UCBPlayer,47,327,374,0,42,UCBPlayer
691,UCBPlayer,58,283,341,0,53,UCBPlayer
692,UCBPlayer,53,303,356,0,48,UCBPlayer
693,UCBPlayer,51,321,372,1,43,UCBPlayer
694,UCBPlayer,100,235,335,6,57,UCBPlayer
695,UCBPlayer,54,299,353,0,49,UCBPlayer
696,UCBPlayer,54,319,373,2,43,UCBPlayer
697,UCBPlayer,72,287,359,3,48,UCBPlayer
698,UCBPlayer,60,275,335,0,55,UCBPlayer
699,UCBPlayer,81,281,362,6,48,UCBPlayer
700,UCBPlayer,58,298,356,0,48,UCBPlayer
701,UCBPlayer,133,253,386,15,43,UCBPlayer
702,UCBPlayer,58,283,341,0,53,UCBPlayer
703,UCBPlayer,42,347,389,0,37,UCBPlayer
704,UCBPlayer,89,284,373,11,46,UCBPlayer
705,UCBPlayer,64,299,363,1,46,UCBPlayer
706,UCBPlayer,81,276,357,4,49,UCBPlayer
707,UCBPlayer,59,279,338,0,54,UCBPlayer
708,UCBPlayer,60,325,385,5,40,UCBPlayer
709,UCBPlayer,70,295,365,3,46,UCBPlayer
710,UCBPlayer,49,319,368,0,44,UCBPlayer
711,UCBPlayer,52,312,364,2,46,UCBPlayer
712,UCBPlayer,66,286,352,2,50,UCBPlayer
713,UCBPlayer,51,326,377,0,41,UCBPlayer
714,UCBPlayer,68,303,371,3,44,UCBPlayer
715,UCBPlayer,50,315,365,0,45,UCBPlayer
716,UCBPlayer,60,300,360,1,47,UCBPlayer
717,UCBPlayer,56,291,347,0,51,UCBPlayer
718,UCBPlayer,65,270,335,0,55,UCBPlayer
719,UCBPlayer,68,258,326,0,58,UCBPlayer
720,UCBPlayer,69,254,323,0,59,UCBPlayer
721,UCBPlayer,55,295,350,0,50,UCBPlayer
722,UCBPlayer,71,276,347,3,52,UCBPlayer
723,UCBPlayer,44,349,393,1,36,UCBPlayer
724,UCBPlayer,53,303,356,0,48,UCBPlayer
725,UCBPlayer,53,303,356,0,48,UCBPlayer
726,UCBPlayer,57,287,344,0,52,UCBPlayer
727,UCBPlayer,119,274,393,10,39,UCBPlayer
728,UCBPlayer,49,319,368,0,44,UCBPlayer
729,UCBPlayer,68,308,376,5,43,UCBPlayer
730,UCBPlayer,54,319,373,2,43,UCBPlayer
731,UCBPlayer,80,285,365,3,46,UCBPlayer
732,UCBPlayer,50,315,365,0,45,UCBPlayer
733,UCBPlayer,63,263,326,0,58,UCBPlayer
734,UCBPlayer,99,259,358,8,50,UCBPlayer
735,UCBPlayer,138,213,351,10,53,UCBPlayer
736,UCBPlayer,53,303,356,0,48,UCBPlayer
737,UCBPlayer,75,255,330,1,57,UCBPlayer
738,UCBPlayer,70,270,340,2,54,UCBPlayer
739,UCBPlayer,48,333,381,1,40,UCBPlayer
740,UCBPlayer,51,311,362,0,46,UCBPlayer
741,UCBPlayer,54,299,353,0,49,UCBPlayer
742,UCBPlayer,58,283,341,0,53,UCBPlayer
743,UCBPlayer,42,347,389,0,37,UCBPlayer
744,UCBPlayer,79,254,333,1,56,UCBPlayer
745,UCBPlayer,92,262,354,4,50,UCBPlayer
746,UCBPlayer,58,283,341,0,53,UCBPlayer
747,UCBPlayer,54,309,363,1,46,UCBPlayer
748,UCBPlayer,66,311,377,3,42,UCBPlayer
749,UCBPlayer,47,327,374,0,42,UCBPlayer
750,UCBPlayer,47,327,374,0,42,UCBPlayer
751,UCBPlayer,52,307,359,0,47,UCBPlayer
752,UCBPlayer,59,279,338,0,54,UCBPlayer
753,UCBPlayer,54,299,353,0,49,UCBPlayer
754,UCBPlayer,65,300,365,3,46,UCBPlayer
755,UCBPlayer,91,276,367,8,47,UCBPlayer
756,UCBPlayer,52,307,359,0,47,UCBPlayer
757,UCBPlayer,62,297,359,3,48,UCBPlayer
758,UCBPlayer,61,306,367,2,45,UCBPlayer
759,UCBPlayer,52,327,379,2,41,UCBPlayer
760,UCBPlayer,57,302,359,0,47,UCBPlayer
761,UCBPlayer,57,297,354,1,49,UCBPlayer
762,UCBPlayer,59,294,353,0,49,UCBPlayer
763,UCBPlayer,49,319,368,0,44,UCBPlayer
764,UCBPlayer,53,288,341,0,53,UCBPlayer
765,UCBPlayer,57,287,344,0,52,UCBPlayer
766,UCBPlayer,58,283,341,0,53,UCBPlayer
767,UCBPlayer,109,274,383,12,43,UCBPlayer
768,UCBPlayer,86,301,387,7,40,UCBPlayer
769,UCBPlayer,89,259,348,4,52,UCBPlayer
770,UCBPlayer,66,276,342,1,53,UCBPlayer
771,UCBPlayer,59,279,338,0,54,UCBPlayer
772,UCBPlayer,60,290,350,0,50,UCBPlayer
773,UCBPlayer,47,327,374,0,42,UCBPlayer
774,UCBPlayer,71,301,372,4,44,UCBPlayer
775,UCBPlayer,65,280,345,1,52,UCBPlayer
776,UCBPlayer,85,275,360,4,48,UCBPlayer
777,UCBPlayer,56,291,347,0,51,UCBPlayer
778,UCBPlayer,83,268,351,4,51,UCBPlayer
779,UCBPlayer,72,267,339,1,54,UCBPlayer
780,UCBPlayer,62,302,364,2,46,UCBPlayer
781,UCBPlayer,61,271,332,0,56,UCBPlayer
782,UCBPlayer,57,287,344,0,52,UCBPlayer
783,UCBPlayer,72,292,364,5,47,UCBPlayer
784,UCBPlayer,82,252,334,2,56,UCBPlayer
785,UCBPlayer,99,264,363,7,48,UCBPlayer
786,UCBPlayer,68,303,371,3,44,UCBPlayer
787,UCBPlayer,56,291,347,0,51,UCBPlayer
788,UCBPlayer,78,268,346,2,52,UCBPlayer
789,UCBPlayer,52,307,359,0,47,UCBPlayer
790,UCBPlayer,115,275,390,10,40,UCBPlayer
791,UCBPlayer,61,281,342,1,53,UCBPlayer
792,UCBPlayer,58,298,356,0,48,UCBPlayer
793,UCBPlayer,52,307,359,0,47,UCBPlayer
794,UCBPlayer,94,309,403,11,36,UCBPlayer
795,UCBPlayer,69,284,353,3,50,UCBPlayer
796,UCBPlayer,81,241,322,2,60,UCBPlayer
797,UCBPlayer,56,291,347,0,51,UCBPlayer
798,UCBPlayer,69,279,348,4,52,UCBPlayer
799,UCBPlayer,79,264,343,2,53,UCBPlayer
800,UCBPlayer,106,246,352,8,52,UCBPlayer
801,UCBPlayer,71,291,362,3,47,UCBPlayer
802,UCBPlayer,53,303,356,0,48,UCBPlayer
803,UCBPlayer,51,311,362,0,46,UCBPlayer
804,UCBPlayer,96,271,367,8,47,UCBPlayer
805,UCBPlayer,54,309,363,1,46,UCBPlayer
806,UCBPlayer,69,294,363,4,47,UCBPlayer
807,UCBPlayer,70,300,370,5,45,UCBPlayer
808,UCBPlayer,61,301,362,0,46,UCBPlayer
809,UCBPlayer,64,259,323,0,59,UCBPlayer
810,UCBPlayer,49,319,368,0,44,UCBPlayer
811,UCBPlayer,66,276,342,1,53,UCBPlayer
812,UCBPlayer,68,278,346,2,52,UCBPlayer
813,UCBPlayer,58,303,361,2,47,UCBPlayer
814,UCBPlayer,74,274,348,1,51,UCBPlayer
815,UCBPlayer,51,296,347,0,51,UCBPlayer
816,UCBPlayer,65,295,360,1,47,UCBPlayer
817,UCBPlayer,94,269,363,7,48,UCBPlayer
818,UCBPlayer,59,279,338,0,54,UCBPlayer
819,UCBPlayer,60,275,335,0,55,UCBPlayer
820,UCBPlayer,132,252,384,13,43,UCBPlayer
821,UCBPlayer,55,295,350,0,50,UCBPlayer
822,UCBPlayer,59,279,338,0,54,UCBPlayer
823,UCBPlayer,64,294,358,2,48,UCBPlayer
824,UCBPlayer,55,295,350,0,50,UCBPlayer
825,UCBPlayer,52,307,359,0,47,UCBPlayer
826,UCBPlayer,57,312,369,1,44,UCBPlayer
827,UCBPlayer,75,265,340,2,54,UCBPlayer
828,UCBPlayer,52,307,359,0,47,UCBPlayer
829,UCBPlayer,68,258,326,0,58,UCBPlayer
830,UCBPlayer,51,311,362,0,46,UCBPlayer
831,UCBPlayer,63,278,341,0,53,UCBPlayer
832,UCBPlayer,63,288,351,1,50,UCBPlayer
833,UCBPlayer,59,299,358,2,48,UCBPlayer
834,UCBPlayer,66,311,377,3,42,UCBPlayer
835,UCBPlayer,49,319,368,0,44,UCBPlayer
836,UCBPlayer,55,295,350,0,50,UCBPlayer
837,UCBPlayer,54,299,353,0,49,UCBPlayer
838,UCBPlayer,54,299,353,0,49,UCBPlayer
839,UCBPlayer,78,288,366,4,46,UCBPlayer
840,UCBPlayer,56,291,347,0,51,UCBPlayer
841,UCBPlayer,43,343,386,0,38,UCBPlayer
842,UCBPlayer,68,268,336,1,55,UCBPlayer
843,UCBPlayer,58,318,376,2,42,UCBPlayer
844,UCBPlayer,88,293,381,7,42,UCBPlayer
845,UCBPlayer,89,274,363,10,49,UCBPlayer
846,UCBPlayer,60,310,370,2,44,UCBPlayer
847,UCBPlayer,61,306,367,2,45,UCBPlayer
848,UCBPlayer,69,304,373,2,43,UCBPlayer
849,UCBPlayer,50,315,365,0,45,UCBPlayer
850,UCBPlayer,49,319,368,0,44,UCBPlayer
851,UCBPlayer,64,294,358,2,48,UCBPlayer
852,UCBPlayer,65,280,345,1,52,UCBPlayer
853,UCBPlayer,52,307,359,0,47,UCBPlayer
854,UCBPlayer,57,287,344,0,52,UCBPlayer
855,UCBPlayer,69,254,323,0,59,UCBPlayer
856,UCBPlayer,63,293,356,3,49,UCBPlayer
857,UCBPlayer,83,293,376,8,44,UCBPlayer
858,UCBPlayer,64,289,353,3,50,UCBPlayer
859,UCBPlayer,116,276,392,18,42,UCBPlayer
860,UCBPlayer,84,264,348,4,52,UCBPlayer
861,UCBPlayer,64,274,338,0,54,UCBPlayer
862,UCBPlayer,62,267,329,0,57,UCBPlayer
863,UCBPlayer,66,266,332,0,56,UCBPlayer
864,UCBPlayer,50,315,365,0,45,UCBPlayer
865,UCBPlayer,75,265,340,2,54,UCBPlayer
866,UCBPlayer,48,308,356,0,48,UCBPlayer
867,UCBPlayer,92,287,379,8,43,UCBPlayer
868,UCBPlayer,82,257,339,4,55,UCBPlayer
869,UCBPlayer,62,292,354,1,49,UCBPlayer
870,UCBPlayer,47,327,374,0,42,UCBPlayer
871,UCBPlayer,65,300,365,3,46,UCBPlayer
872,UCBPlayer,70,300,370,5,45,UCBPlayer
873,UCBPlayer,123,278,401,18,39,UCBPlayer
874,UCBPlayer,89,304,393,7,38,UCBPlayer
875,UCBPlayer,52,307,359,0,47,UCBPlayer
876,UCBPlayer,65,280,345,1,52,UCBPlayer
877,UCBPlayer,79,269,348,4,52,UCBPlayer
878,UCBPlayer,52,307,359,0,47,UCBPlayer
879,UCBPlayer,54,329,383,3,40,UCBPlayer
880,UCBPlayer,64,299,363,1,46,UCBPlayer
881,UCBPlayer,65,255,320,0,60,UCBPlayer
882,UCBPlayer,61,306,367,2,45,UCBPlayer
883,UCBPlayer,61,271,332,0,56,UCBPlayer
884,UCBPlayer,64,284,348,1,51,UCBPlayer
885,UCBPlayer,53,333,386,3,39,UCBPlayer
886,UCBPlayer,71,281,352,2,50,UCBPlayer
887,UCBPlayer,50,315,365,0,45,UCBPlayer
888,UCBPlayer,58,308,366,1,45,UCBPlayer
889,UCBPlayer,57,287,344,0,52,UCBPlayer
890,UCBPlayer,54,319,373,2,43,UCBPlayer
891,UCBPlayer,53,318,371,0,43,UCBPlayer
892,UCBPlayer,49,319,368,0,44,UCBPlayer
893,UCBPlayer,60,320,380,3,41,UCBPlayer
894,UCBPlayer,51,311,362,0,46,UCBPlayer
895,UCBPlayer,61,296,357,1,48,UCBPlayer
896,UCBPlayer,58,323,381,4,41,UCBPlayer
897,UCBPlayer,60,290,350,0,50,UCBPlayer
898,UCBPlayer,87,272,359,6,49,UCBPlayer
899,UCBPlayer,46,341,387,1,38,UCBPlayer
900,UCBPlayer,65,280,345,1,52,UCBPlayer
901,UCBPlayer,41,351,392,0,36,UCBPlayer
902,UCBPlayer,98,273,371,6,45,UCBPlayer
903,UCBPlayer,74,274,348,4,52,UCBPlayer
904,UCBPlayer,52,307,359,0,47,UCBPlayer
905,UCBPlayer,63,278,341,0,53,UCBPlayer
906,UCBPlayer,59,279,338,0,54,UCBPlayer
907,UCBPlayer,79,279,358,5,49,UCBPlayer
908,UCBPlayer,59,279,338,0,54,UCBPlayer
909,UCBPlayer,68,293,361,2,47,UCBPlayer
910,UCBPlayer,80,270,350,6,52,UCBPlayer
911,UCBPlayer,76,266,342,1,53,UCBPlayer
912,UCBPlayer,48,323,371,0,43,UCBPlayer
913,UCBPlayer,64,304,368,6,46,UCBPlayer
914,UCBPlayer,83,293,376,5,43,UCBPlayer
915,UCBPlayer,54,324,378,1,41,UCBPlayer
916,UCBPlayer,88,273,361,5,48,UCBPlayer
917,UCBPlayer,55,280,335,0,55,UCBPlayer
918,UCBPlayer,44,339,383,0,39,UCBPlayer
919,UCBPlayer,67,282,349,2,51,UCBPlayer
920,UCBPlayer,76,301,377,6,43,UCBPlayer
921,UCBPlayer,53,303,356,0,48,UCBPlayer
922,UCBPlayer,65,290,355,2,49,UCBPlayer
923,UCBPlayer,74,289,363,4,47,UCBPlayer
924,UCBPlayer,57,287,344,0,52,UCBPlayer
925,UCBPlayer,74,259,333,1,56,UCBPlayer
926,UCBPlayer,55,295,350,0,50,UCBPlayer
927,UCBPlayer,64,274,338,0,54,UCBPlayer
928,UCBPlayer,57,322,379,2,41,UCBPlayer
929,UCBPlayer,68,293,361,2,47,UCBPlayer
930,UCBPlayer,79,299,378,7,43,UCBPlayer
931,UCBPlayer,58,283,341,0,53,UCBPlayer
932,UCBPlayer,65,280,345,1,52,UCBPlayer
933,UCBPlayer,63,288,351,1,50,UCBPlayer
934,UCBPlayer,61,316,377,3,42,UCBPlayer
935,UCBPlayer,55,295,350,0,50,UCBPlayer
936,UCBPlayer,69,289,358,2,48,UCBPlayer
937,UCBPlayer,69,299,368,3,45,UCBPlayer
938,UCBPlayer,74,279,353,3,50,UCBPlayer
939,UCBPlayer,45,345,390,1,37,UCBPlayer
940,UCBPlayer,58,298,356,0,48,UCBPlayer
941,UCBPlayer,52,307,359,0,47,UCBPlayer
942,UCBPlayer,57,287,344,0,52,UCBPlayer
943,UCBPlayer,69,294,363,4,47,UCBPlayer
944,UCBPlayer,61,306,367,2,45,UCBPlayer
945,UCBPlayer,89,259,348,4,52,UCBPlayer
946,UCBPlayer,56,291,347,0,51,UCBPlayer
947,UCBPlayer,114,284,398,15,39,UCBPlayer
948,UCBPlayer,59,279,338,0,54,UCBPlayer
949,UCBPlayer,52,307,359,0,47,UCBPlayer
950,UCBPlayer,54,299,353,0,49,UCBPlayer
951,UCBPlayer,74,299,373,5,44,UCBPlayer
952,UCBPlayer,88,263,351,7,52,UCBPlayer
953,UCBPlayer,58,298,356,0,48,UCBPlayer
954,UCBPlayer,65,310,375,4,43,UCBPlayer
955,UCBPlayer,62,292,354,1,49,UCBPlayer
956,UCBPlayer,52,307,359,0,47,UCBPlayer
957,UCBPlayer,64,259,323,0,59,UCBPlayer
958,UCBPlayer,100,250,350,6,52,UCBPlayer
959,UCBPlayer,51,311,362,0,46,UCBPlayer
960,UCBPlayer,57,307,364,2,46,UCBPlayer
961,UCBPlayer,62,322,384,4,40,UCBPlayer
962,UCBPlayer,60,290,350,0,50,UCBPlayer
963,UCBPlayer,77,282,359,3,48,UCBPlayer
964,UCBPlayer,67,247,314,0,62,UCBPlayer
965,UCBPlayer,87,252,339,4,55,UCBPlayer
966,UCBPlayer,50,320,370,2,44,UCBPlayer
967,UCBPlayer,66,301,367,2,45,UCBPlayer
968,UCBPlayer,65,265,330,1,57,UCBPlayer
969,UCBPlayer,68,328,396,7,37,UCBPlayer
970,UCBPlayer,58,283,341,0,53,UCBPlayer
971,UCBPlayer,58,318,376,2,42,UCBPlayer
972,UCBPlayer,102,272,374,12,46,UCBPlayer
973,UCBPlayer,56,291,347,0,51,UCBPlayer
974,UCBPlayer,52,307,359,0,47,UCBPlayer
975,UCBPlayer,55,295,350,0,50,UCBPlayer
976,UCBPlayer,59,279,338,0,54,UCBPlayer
977,UCBPlayer,100,245,345,7,54,UCBPlayer
978,UCBPlayer,62,312,374,3,43,UCBPlayer
979,UCBPlayer,65,290,355,2,49,UCBPlayer
980,UCBPlayer,57,287,344,0,52,UCBPlayer
981,UCBPlayer,40,355,395,0,35,UCBPlayer
982,UCBPlayer,78,263,341,3,54,UCBPlayer
983,UCBPlayer,58,283,341,0,53,UCBPlayer
984,UCBPlayer,63,278,341,0,53,UCBPlayer
985,UCBPlayer,68,268,336,1,55,UCBPlayer
986,UCBPlayer,74,314,388,5,39,UCBPlayer
987,UCBPlayer,76,296,372,4,44,UCBPlayer
988,UCBPlayer,57,287,344,0,52,UCBPlayer
989,UCBPlayer,59,304,363,1,46,UCBPlayer
990,UCBPlayer,73,268,341,3,54,UCBPlayer
991,UCBPlayer,57,287,344,0,52,UCBPlayer
992,UCBPlayer,50,315,365,0,45,UCBPlayer
993,UCBPlayer,57,287,344,0,52,UCBPlayer
994,UCBPlayer,74,274,348,1,51,UCBPlayer
995,UCBPlayer,52,307,359,0,47,UCBPlayer
996,UCBPlayer,53,313,366,1,45,UCBPlayer
997,UCBPlayer,64,284,348,1,51,UCBPlayer
998,UCBPlayer,86,296,382,8,42,UCBPlayer
999,UCBPlayer,83,293,376,8,44,UCBPlayer
1000,UCBPlayer,46,331,377,0,41,UCBPlayer
1001,UCBPlayer,55,305,360,1,47,UCBPlayer
1002,UCBPlayer,80,295,375,7,44,UCBPlayer
1003,UCBPlayer,72,277,349,2,51,UCBPlayer
1004,UCBPlayer,60,310,370,2,44,UCBPlayer
1005,UCBPlayer,69,264,333,1,56,UCBPlayer
1006,UCBPlayer,50,330,380,3,41,UCBPlayer
1007,UCBPlayer,78,258,336,1,55,UCBPlayer
1008,UCBPlayer,62,317,379,2,41,UCBPlayer
1009,UCBPlayer,62,277,339,1,54,UCBPlayer
1010,UCBPlayer,55,320,375,1,42,UCBPlayer
1011,UCBPlayer,54,299,353,0,49,UCBPlayer
1012,UCBPlayer,56,291,347,0,51,UCBPlayer
1013,UCBPlayer,71,281,352,5,51,UCBPlayer
1014,UCBPlayer,71,271,342,1,53,UCBPlayer
1015,UCBPlayer,67,262,329,0,57,UCBPlayer
1016,UCBPlayer,50,325,375,1,42,UCBPlayer
1017,UCBPlayer,65,280,345,1,52,UCBPlayer
1018,UCBPlayer,63,273,336,1,55,UCBPlayer
1019,UCBPlayer,81,286,367,5,46,UCBPlayer
1020,UCBPlayer,76,281,357,4,49,UCBPlayer
1021,UCBPlayer,106,251,357,10,51,UCBPlayer
1022,UCBPlayer,67,272,339,1,54,UCBPlayer
1023,UCBPlayer,66,266,332,0,56,UCBPlayer
1024,UCBPlayer,119,274,393,13,40,UCBPlayer
1025,UCBPlayer,80,295,375,7,44,UCBPlayer
1026,UCBPlayer,56,326,382,2,40,UCBPlayer
1027,UCBPlayer,58,283,341,0,53,UCBPlayer
1028,UCBPlayer,67,262,329,0,57,UCBPlayer
1029,UCBPlayer,58,283,341,0,53,UCBPlayer
1030,UCBPlayer,65,280,345,1,52,UCBPlayer
1031,UCBPlayer,52,307,359,0,47,UCBPlayer
1032,UCBPlayer,63,308,371,3,44,UCBPlayer
1033,UCBPlayer,82,267,349,5,52,UCBPlayer
1034,UCBPlayer,46,341,387,1,38,UCBPlayer
1035,UCBPlayer,58,298,356,0,48,UCBPlayer
1036,UCBPlayer,48,323,371,0,43,UCBPlayer
1037,UCBPlayer,51,311,362,0,46,UCBPlayer
1038,UCBPlayer,94,274,368,9,47,UCBPlayer
1039,UCBPlayer,70,285,355,2,49,UCBPlayer
1040,UCBPlayer,55,295,350,0,50,UCBPlayer
1041,UCBPlayer,86,246,332,3,57,UCBPlayer
1042,UCBPlayer,134,234,368,15,49,UCBPlayer
1043,UCBPlayer,78,288,366,7,47,UCBPlayer
1044,UCBPlayer,77,272,349,2,51,UCBPlayer
1045,UCBPlayer,49,319,368,0,44,UCBPlayer
1046,UCBPlayer,103,283,386,9,41,UCBPlayer
1047,UCBPlayer,59,279,338,0,54,UCBPlayer
1048,UCBPlayer,62,307,369,1,44,UCBPlayer
1049,UCBPlayer,57,287,344,0,52,UCBPlayer
1050,UCBPlayer,78,278,356,6,50,UCBPlayer
1051,UCBPlayer,48,323,371,0,43,UCBPlayer
1052,UCBPlayer,54,309,363,1,46,UCBPlayer
1053,UCBPlayer,62,302,364,2,46,UCBPlayer
1054,UCBPlayer,62,292,354,1,49,UCBPlayer
1055,UCBPlayer,65,280,345,1,52,UCBPlayer
1056,UCBPlayer,56,291,347,0,51,UCBPlayer
1057,UCBPlayer,77,287,364,5,47,UCBPlayer
1058,UCBPlayer,64,329,393,4,37,UCBPlayer
1059,UCBPlayer,44,339,383,0,39,UCBPlayer
1060,UCBPlayer,57,287,344,0,52,UCBPlayer
1061,UCBPlayer,52,307,359,0,47,UCBPlayer
1062,UCBPlayer,63,273,336,1,55,UCBPlayer
1063,UCBPlayer,65,280,345,1,52,UCBPlayer
1064,UCBPlayer,81,311,392,6,38,UCBPlayer
1065,UCBPlayer,62,287,349,2,51,UCBPlayer
1066,UCBPlayer,53,318,371,0,43,UCBPlayer
1067,UCBPlayer,58,283,341,0,53,UCBPlayer
1068,UCBPlayer,53,313,366,1,45,UCBPlayer
1069,UCBPlayer,96,291,387,10,41,UCBPlayer
1070,UCBPlayer,44,324,368,0,44,UCBPlayer
1071,UCBPlayer,66,266,332,0,56,UCBPlayer
1072,UCBPlayer,89,269,358,5,49,UCBPlayer
1073,UCBPlayer,63,308,371,3,44,UCBPlayer
1074,UCBPlayer,56,291,347,0,51,UCBPlayer
1075,UCBPlayer,104,264,368,9,47,UCBPlayer
1076,UCBPlayer,54,299,353,0,49,UCBPlayer
1077,UCBPlayer,68,288,356,3,49,UCBPlayer
1078,UCBPlayer,57,287,344,0,52,UCBPlayer
1079,UCBPlayer,104,324,428,12,28,UCBPlayer
1080,UCBPlayer,56,291,347,0,51,UCBPlayer
1081,UCBPlayer,62,267,329,0,57,UCBPlayer
1082,UCBPlayer,60,290,350,0,50,UCBPlayer
1083,UCBPlayer,45,335,380,0,40,UCBPlayer
1084,UCBPlayer,68,318,386,6,40,UCBPlayer
1085,UCBPlayer,54,299,353,0,49,UCBPlayer
1086,UCBPlayer,53,303,356,0,48,UCBPlayer
1087,UCBPlayer,64,304,368,3,45,UCBPlayer
1088,UCBPlayer,59,279,338,0,54,UCBPlayer
1089,UCBPlayer,68,293,361,2,47,UCBPlayer
1090,UCBPlayer,50,325,375,1,42,UCBPlayer
1091,UCBPlayer,98,293,391,8,39,UCBPlayer
1092,UCBPlayer,50,325,375,1,42,UCBPlayer
1093,UCBPlayer,62,292,354,1,49,UCBPlayer
1094,UCBPlayer,57,322,379,2,41,UCBPlayer
1095,UCBPlayer,59,324,383,3,40,UCBPlayer
1096,UCBPlayer,54,299,353,0,49,UCBPlayer
1097,UCBPlayer,54,309,363,1,46,UCBPlayer
1098,UCBPlayer,87,282,369,4,45,UCBPlayer
1099,UCBPlayer,55,320,375,1,42,UCBPlayer
1100,UCBPlayer,88,268,356,6,50,UCBPlayer
1101,UCBPlayer,54,299,353,0,49,UCBPlayer
1102,UCBPlayer,52,307,359,0,47,UCBPlayer
1103,UCBPlayer,129,249,378,13,45,UCBPlayer
1104,UCBPlayer,52,307,359,0,47,UCBPlayer
1105,UCBPlayer,46,331,377,0,41,UCBPlayer
1106,UCBPlayer,56,291,347,0,51,UCBPlayer
1107,UCBPlayer,78,288,366,4,46,UCBPlayer
1108,UCBPlayer,58,293,351,1,50,UCBPlayer
1109,UCBPlayer,71,296,367,5,46,UCBPlayer
1110,UCBPlayer,126,256,382,14,44,UCBPlayer
1111,UCBPlayer,77,292,369,4,45,UCBPlayer
1112,UCBPlayer,48,323,371,0,43,UCBPlayer
1113,UCBPlayer,88,273,361,8,49,UCBPlayer
1114,UCBPlayer,61,296,357,1,48,UCBPlayer
1115,UCBPlayer,61,271,332,0,56,UCBPlayer
1116,UCBPlayer,49,319,368,0,44,UCBPlayer
1117,UCBPlayer,54,299,353,0,49,UCBPlayer
1118,UCBPlayer,61,271,332,0,56,UCBPlayer
1119,UCBPlayer,57,292,349,2,51,UCBPlayer
1120,UCBPlayer,71,286,357,1,48,UCBPlayer
1121,UCBPlayer,47,312,359,0,47,UCBPlayer
1122,UCBPlayer,67,262,329,0,57,UCBPlayer
1123,UCBPlayer,69,289,358,2,48,UCBPlayer
1124,UCBPlayer,52,307,359,0,47,UCBPlayer
1125,UCBPlayer,52,307,359,0,47,UCBPlayer
1126,UCBPlayer,60,275,335,0,55,UCBPlayer
1127,UCBPlayer,64,324,388,5,39,UCBPlayer
1128,UCBPlayer,60,300,360,1,47,UCBPlayer
1129,UCBPlayer,57,287,344,0,52,UCBPlayer
1130,UCBPlayer,66,286,352,2,50,UCBPlayer
1131,UCBPlayer,65,270,335,0,55,UCBPlayer
1132,UCBPlayer,62,267,329,0,57,UCBPlayer
1133,UCBPlayer,88,273,361,8,49,UCBPlayer
1134,UCBPlayer,49,319,368,0,44,UCBPlayer
1135,UCBPlayer,60,320,380,3,41,UCBPlayer
1136,UCBPlayer,47,327,374,0,42,UCBPlayer
1137,UCBPlayer,53,303,356,0,48,UCBPlayer
1138,UCBPlayer,50,315,365,0,45,UCBPlayer
1139,UCBPlayer,63,308,371,3,44,UCBPlayer
1140,UCBPlayer,82,272,354,4,50,UCBPlayer
1141,UCBPlayer,50,315,365,0,45,UCBPlayer
1142,UCBPlayer,65,300,365,3,46,UCBPlayer
1143,UCBPlayer,63,298,361,2,47,UCBPlayer
1144,UCBPlayer,64,259,323,0,59,UCBPlayer
1145,UCBPlayer,63,298,361,2,47,UCBPlayer
1146,UCBPlayer,53,303,356,0,48,UCBPlayer
1147,UCBPlayer,56,291,347,0,51,UCBPlayer
1148,UCBPlayer,73,283,356,3,49,UCBPlayer
1149,UCBPlayer,71,266,337,2,55,UCBPlayer
1150,UCBPlayer,63,288,351,1,50,UCBPlayer
1151,UCBPlayer,56,316,372,1,43,UCBPlayer
1152,UCBPlayer,78,278,356,6,50,UCBPlayer
1153,UCBPlayer,79,264,343,2,53,UCBPlayer
1154,UCBPlayer,50,315,365,0,45,UCBPlayer
1155,UCBPlayer,52,307,359,0,47,UCBPlayer
1156,UCBPlayer,74,284,358,5,49,UCBPlayer
1157,UCBPlayer,60,290,350,0,50,UCBPlayer
1158,UCBPlayer,68,283,351,1,50,UCBPlayer
1159,UCBPlayer,61,271,332,0,56,UCBPlayer
1160,UCBPlayer,68,278,346,2,52,UCBPlayer
1161,UCBPlayer,49,329,378,1,41,UCBPlayer
1162,UCBPlayer,57,302,359,0,47,UCBPlayer
1163,UCBPlayer,58,283,341,0,53,UCBPlayer
1164,UCBPlayer,86,306,392,9,39,UCBPlayer
1165,UCBPlayer,131,266,397,17,40,UCBPlayer
1166,UCBPlayer,99,239,338,6,56,UCBPlayer
1167,UCBPlayer,124,284,408,10,34,UCBPlayer
1168,UCBPlayer,57,302,359,0,47,UCBPlayer
1169,UCBPlayer,57,287,344,0,52,UCBPlayer
1170,UCBPlayer,51,316,367,2,45,UCBPlayer
1171,UCBPlayer,72,267,339,1,54,UCBPlayer
1172,UCBPlayer,68,298,366,4,46,UCBPlayer
1173,UCBPlayer,71,311,382,5,41,UCBPlayer
1174,UCBPlayer,63,318,381,4,41,UCBPlayer
1175,UCBPlayer,56,291,347,0,51,UCBPlayer
1176,UCBPlayer,67,282,349,2,51,UCBPlayer
1177,UCBPlayer,64,304,368,3,45,UCBPlayer
1178,UCBPlayer,77,277,354,4,50,UCBPlayer
1179,UCBPlayer,60,275,335,0,55,UCBPlayer
1180,UCBPlayer,87,262,349,5,52,UCBPlayer
1181,UCBPlayer,72,242,314,0,62,UCBPlayer
1182,UCBPlayer,41,351,392,0,36,UCBPlayer
1183,UCBPlayer,84,299,383,9,42,UCBPlayer
1184,UCBPlayer,70,295,365,3,46,UCBPlayer
1185,UCBPlayer,56,291,347,0,51,UCBPlayer
1186,UCBPlayer,69,294,363,4,47,UCBPlayer
1187,UCBPlayer,61,306,367,2,45,UCBPlayer
1188,UCBPlayer,67,302,369,4,45,UCBPlayer
1189,UCBPlayer,56,291,347,0,51,UCBPlayer
1190,UCBPlayer,71,291,362,3,47,UCBPlayer
1191,UCBPlayer,55,295,350,0,50,UCBPlayer
1192,UCBPlayer,66,286,352,2,50,UCBPlayer
1193,UCBPlayer,76,281,357,4,49,UCBPlayer
1194,UCBPlayer,50,325,375,1,42,UCBPlayer
1195,UCBPlayer,76,271,347,3,52,UCBPlayer
1196,UCBPlayer,76,261,337,2,55,UCBPlayer
1197,UCBPlayer,57,287,344,0,52,UCBPlayer
1198,UCBPlayer,77,247,324,1,59,UCBPlayer
1199,UCBPlayer,69,254,323,0,59,UCBPlayer
1200,UCBPlayer,52,307,359,0,47,UCBPlayer
1201,UCBPlayer,66,286,352,2,50,UCBPlayer
1202,UCBPlayer,72,262,334,2,56,UCBPlayer
1203,UCBPlayer,92,297,389,9,40,UCBPlayer
1204,UCBPlayer,94,274,368,9,47,UCBPlayer
1205,UCBPlayer,48,323,371,0,43,UCBPlayer
1206,UCBPlayer,52,332,384,1,39,UCBPlayer
1207,UCBPlayer,66,276,342,1,53,UCBPlayer
1208,UCBPlayer,52,307,359,0,47,UCBPlayer
1209,UCBPlayer,59,299,358,2,48,UCBPlayer
1210,UCBPlayer,66,311,377,3,42,UCBPlayer
1211,UCBPlayer,50,315,365,0,45,UCBPlayer
1212,UCBPlayer,55,315,370,2,44,UCBPlayer
1213,UCBPlayer,73,283,356,3,49,UCBPlayer
1214,UCBPlayer,56,291,347,0,51,UCBPlayer
1215,UCBPlayer,82,302,384,10,42,UCBPlayer
1216,UCBPlayer,95,275,370,8,46,UCBPlayer
1217,UCBPlayer,62,312,374,3,43,UCBPlayer
1218,UCBPlayer,80,265,345,4,53,UCBPlayer
1219,UCBPlayer,76,296,372,7,45,UCBPlayer
1220,UCBPlayer,91,296,387,7,40,UCBPlayer
1221,UCBPlayer,57,292,349,2,51,UCBPlayer
1222,UCBPlayer,111,231,342,7,55,UCBPlayer
1223,UCBPlayer,52,322,374,0,42,UCBPlayer
1224,UCBPlayer,61,271,332,0,56,UCBPlayer
1225,UCBPlayer,52,307,359,0,47,UCBPlayer
1226,UCBPlayer,86,266,352,5,51,UCBPlayer
1227,UCBPlayer,76,291,367,5,46,UCBPlayer
1228,UCBPlayer,47,327,374,0,42,UCBPlayer
1229,UCBPlayer,48,323,371,0,43,UCBPlayer
1230,UCBPlayer,52,307,359,0,47,UCBPlayer
1231,UCBPlayer,53,303,356,0,48,UCBPlayer
1232,UCBPlayer,53,303,356,0,48,UCBPlayer
1233,UCBPlayer,49,319,368,0,44,UCBPlayer
1234,UCBPlayer,44,339,383,0,39,UCBPlayer
1235,UCBPlayer,59,304,363,1,46,UCBPlayer
1236,UCBPlayer,60,275,335,0,55,UCBPlayer
1237,UCBPlayer,57,302,359,0,47,UCBPlayer
1238,UCBPlayer,74,274,348,4,52,UCBPlayer
1239,UCBPlayer,68,303,371,3,44,UCBPlayer
1240,UCBPlayer,52,307,359,0,47,UCBPlayer
1241,UCBPlayer,60,320,380,3,41,UCBPlayer
1242,UCBPlayer,76,266,342,4,54,UCBPlayer
1243,UCBPlayer,69,294,363,4,47,UCBPlayer
1244,UCBPlayer,51,321,372,1,43,UCBPlayer
1245,UCBPlayer,57,302,359,0,47,UCBPlayer
1246,UCBPlayer,67,272,339,1,54,UCBPlayer
1247,UCBPlayer,58,298,356,0,48,UCBPlayer
1248,UCBPlayer,59,279,338,0,54,UCBPlayer
1249,UCBPlayer,57,312,369,1,44,UCBPlayer
1250,UCBPlayer,64,309,373,2,43,UCBPlayer
1251,UCBPlayer,63,263,326,0,58,UCBPlayer
1252,UCBPlayer,77,257,334,2,56,UCBPlayer
1253,UCBPlayer,48,333,381,1,40,UCBPlayer
1254,UCBPlayer,73,278,351,1,50,UCBPlayer
1255,UCBPlayer,51,311,362,0,46,UCBPlayer
1256,UCBPlayer,51,311,362,0,46,UCBPlayer
1257,UCBPlayer,58,283,341,0,53,UCBPlayer
1258,UCBPlayer,57,287,344,0,52,UCBPlayer
1259,UCBPlayer,82,282,364,5,47,UCBPlayer
1260,UCBPlayer,68,278,346,2,52,UCBPlayer
1261,UCBPlayer,54,329,383,3,40,UCBPlayer
1262,UCBPlayer,61,286,347,0,51,UCBPlayer
1263,UCBPlayer,66,276,342,1,53,UCBPlayer
1264,UCBPlayer,52,307,359,0,47,UCBPlayer
1265,UCBPlayer,54,299,353,0,49,UCBPlayer
1266,UCBPlayer,58,303,361,2,47,UCBPlayer
1267,UCBPlayer,59,294,353,0,49,UCBPlayer
1268,UCBPlayer,68,273,341,3,54,UCBPlayer
1269,UCBPlayer,52,322,374,0,42,UCBPlayer
1270,UCBPlayer,67,262,329,0,57,UCBPlayer
1271,UCBPlayer,50,315,365,0,45,UCBPlayer
1272,UCBPlayer,48,318,366,1,45,UCBPlayer
1273,UCBPlayer,56,316,372,1,43,UCBPlayer
1274,UCBPlayer,130,260,390,13,41,UCBPlayer
1275,UCBPlayer,50,315,365,0,45,UCBPlayer
1276,UCBPlayer,65,290,355,2,49,UCBPlayer
1277,UCBPlayer,52,307,359,0,47,UCBPlayer
1278,UCBPlayer,100,255,355,8,51,UCBPlayer
1279,UCBPlayer,58,283,341,0,53,UCBPlayer
1280,UCBPlayer,45,335,380,0,40,UCBPlayer
1281,UCBPlayer,52,307,359,0,47,UCBPlayer
1282,UCBPlayer,63,318,381,4,41,UCBPlayer
1283,UCBPlayer,84,244,328,2,58,UCBPlayer
1284,UCBPlayer,67,272,339,1,54,UCBPlayer
1285,UCBPlayer,73,273,346,2,52,UCBPlayer
1286,UCBPlayer,56,291,347,0,51,UCBPlayer
1287,UCBPlayer,72,287,359,3,48,UCBPlayer
1288,UCBPlayer,71,281,352,2,50,UCBPlayer
1289,UCBPlayer,58,283,341,0,53,UCBPlayer
1290,UCBPlayer,51,311,362,0,46,UCBPlayer
1291,UCBPlayer,61,326,387,4,39,UCBPlayer
1292,UCBPlayer,51,311,362,0,46,UCBPlayer
1293,UCBPlayer,53,313,366,1,45,UCBPlayer
1294,UCBPlayer,74,299,373,5,44,UCBPlayer
1295,UCBPlayer,78,293,371,3,44,UCBPlayer
1296,UCBPlayer,57,287,344,0,52,UCBPlayer
1297,UCBPlayer,64,319,383,6,41,UCBPlayer
1298,UCBPlayer,78,313,391,5,38,UCBPlayer
1299,UCBPlayer,59,279,338,0,54,UCBPlayer
1300,UCBPlayer,70,280,350,3,51,UCBPlayer
1301,UCBPlayer,64,304,368,3,45,UCBPlayer
1302,UCBPlayer,53,318,371,0,43,UCBPlayer
1303,UCBPlayer,56,291,347,0,51,UCBPlayer
1304,UCBPlayer,46,331,377,0,41,UCBPlayer
1305,UCBPlayer,53,313,366,1,45,UCBPlayer
1306,UCBPlayer,87,272,359,6,49,UCBPlayer
1307,UCBPlayer,74,304,378,7,43,UCBPlayer
1308,UCBPlayer,51,311,362,0,46,UCBPlayer
1309,UCBPlayer,69,264,333,1,56,UCBPlayer
1310,UCBPlayer,59,279,338,0,54,UCBPlayer
1311,UCBPlayer,92,257,349,5,52,UCBPlayer
1312,UCBPlayer,50,315,365,0,45,UCBPlayer
1313,UCBPlayer,60,300,360,1,47,UCBPlayer
1314,UCBPlayer,44,349,393,1,36,UCBPlayer
1315,UCBPlayer,75,265,340,2,54,UCBPlayer
1316,UCBPlayer,79,289,368,9,47,UCBPlayer
1317,UCBPlayer,65,315,380,3,41,UCBPlayer
1318,UCBPlayer,46,331,377,0,41,UCBPlayer
1319,UCBPlayer,43,343,386,0,38,UCBPlayer
1320,UCBPlayer,63,303,366,4,46,UCBPlayer
1321,UCBPlayer,104,259,363,7,48,UCBPlayer
1322,UCBPlayer,56,291,347,0,51,UCBPlayer
1323,UCBPlayer,54,314,368,0,44,UCBPlayer
1324,UCBPlayer,54,299,353,0,49,UCBPlayer
1325,UCBPlayer,52,292,344,0,52,UCBPlayer
1326,UCBPlayer,58,308,366,1,45,UCBPlayer
1327,UCBPlayer,69,254,323,0,59,UCBPlayer
1328,UCBPlayer,53,303,356,0,48,UCBPlayer
1329,UCBPlayer,54,299,353,0,49,UCBPlayer
1330,UCBPlayer,51,311,362,0,46,UCBPlayer
1331,UCBPlayer,53,303,356,0,48,UCBPlayer
1332,UCBPlayer,70,300,370,2,44,UCBPlayer
1333,UCBPlayer,110,310,420,13,31,UCBPlayer
1334,UCBPlayer,109,274,383,9,42,UCBPlayer
1335,UCBPlayer,61,271,332,0,56,UCBPlayer
1336,UCBPlayer,75,265,340,2,54,UCBPlayer
1337,UCBPlayer,69,299,368,3,45,UCBPlayer
1338,UCBPlayer,162,257,419,21,34,UCBPlayer
1339,UCBPlayer,59,314,373,2,43,UCBPlayer
1340,UCBPlayer,53,303,356,0,48,UCBPlayer
1341,UCBPlayer,98,253,351,7,52,UCBPlayer
1342,UCBPlayer,57,287,344,0,52,UCBPlayer
1343,UCBPlayer,68,268,336,1,55,UCBPlayer
1344,UCBPlayer,53,303,356,0,48,UCBPlayer
1345,UCBPlayer,55,295,350,0,50,UCBPlayer
1346,UCBPlayer,53,303,356,0,48,UCBPlayer
1347,UCBPlayer,55,320,375,1,42,UCBPlayer
1348,UCBPlayer,51,311,362,0,46,UCBPlayer
1349,UCBPlayer,62,267,329,0,57,UCBPlayer
1350,UCBPlayer,63,273,336,1,55,UCBPlayer
1351,UCBPlayer,49,339,388,2,38,UCBPlayer
1352,UCBPlayer,77,277,354,4,50,UCBPlayer
1353,UCBPlayer,56,291,347,0,51,UCBPlayer
1354,UCBPlayer,68,278,346,2,52,UCBPlayer
1355,UCBPlayer,64,274,338,0,54,UCBPlayer
1356,UCBPlayer,52,307,359,0,47,UCBPlayer
1357,UCBPlayer,60,290,350,0,50,UCBPlayer
1358,UCBPlayer,75,305,380,6,42,UCBPlayer
1359,UCBPlayer,63,313,376,5,43,UCBPlayer
1360,UCBPlayer,89,274,363,7,48,UCBPlayer
1361,UCBPlayer,63,288,351,1,50,UCBPlayer
1362,UCBPlayer,68,273,341,3,54,UCBPlayer
1363,UCBPlayer,56,306,362,0,46,UCBPlayer
1364,UCBPlayer,58,283,341,0,53,UCBPlayer
1365,UCBPlayer,81,291,372,4,44,UCBPlayer
1366,UCBPlayer,55,325,380,3,41,UCBPlayer
1367,UCBPlayer,72,297,369,4,45,UCBPlayer
1368,UCBPlayer,63,278,341,0,53,UCBPlayer
1369,UCBPlayer,55,295,350,0,50,UCBPlayer
1370,UCBPlayer,54,319,373,2,43,UCBPlayer
1371,UCBPlayer,57,312,369,1,44,UCBPlayer
1372,UCBPlayer,73,293,366,4,46,UCBPlayer
1373,UCBPlayer,54,299,353,0,49,UCBPlayer
1374,UCBPlayer,59,289,348,1,51,UCBPlayer
1375,UCBPlayer,53,348,401,3,34,UCBPlayer
1376,UCBPlayer,72,277,349,2,51,UCBPlayer
1377,UCBPlayer,51,311,362,0,46,UCBPlayer
1378,UCBPlayer,55,295,350,0,50,UCBPlayer
1379,UCBPlayer,51,311,362,0,46,UCBPlayer
1380,UCBPlayer,59,279,338,0,54,UCBPlayer
1381,UCBPlayer,53,303,356,0,48,UCBPlayer
1382,UCBPlayer,54,299,353,0,49,UCBPlayer
1383,UCBPlayer,85,280,365,6,47,UCBPlayer
1384,UCBPlayer,91,291,382,8,42,UCBPlayer
1385,UCBPlayer,46,331,377,0,41,UCBPlayer
1386,UCBPlayer,59,279,338,0,54,UCBPlayer
1387,UCBPlayer,58,298,356,0,48,UCBPlayer
1388,UCBPlayer,53,303,356,0,48,UCBPlayer
1389,UCBPlayer,57,287,344,0,52,UCBPlayer
1390,UCBPlayer,46,331,377,0,41,UCBPlayer
1391,UCBPlayer,67,282,349,2,51,UCBPlayer
1392,UCBPlayer,67,272,339,1,54,UCBPlayer
1393,UCBPlayer,62,267,329,0,57,UCBPlayer
1394,UCBPlayer,62,282,344,0,52,UCBPlayer
1395,UCBPlayer,79,304,383,6,41,UCBPlayer
1396,UCBPlayer,56,291,347,0,51,UCBPlayer
1397,UCBPlayer,101,256,357,7,50,UCBPlayer
1398,UCBPlayer,79,294,373,8,45,UCBPlayer
1399,UCBPlayer,53,303,356,0,48,UCBPlayer
1400,UCBPlayer,50,325,375,1,42,UCBPlayer
1401,UCBPlayer,53,303,356,0,48,UCBPlayer
1402,UCBPlayer,66,276,342,1,53,UCBPlayer
1403,UCBPlayer,55,295,350,0,50,UCBPlayer
1404,UCBPlayer,108,253,361,11,50,UCBPlayer
1405,UCBPlayer,41,351,392,0,36,UCBPlayer
1406,UCBPlayer,63,298,361,2,47,UCBPlayer
1407,UCBPlayer,70,300,370,2,44,UCBPlayer
1408,UCBPlayer,71,286,357,4,49,UCBPlayer
1409,UCBPlayer,87,272,359,6,49,UCBPlayer
1410,UCBPlayer,61,296,357,1,48,UCBPlayer
1411,UCBPlayer,56,291,347,0,51,UCBPlayer
1412,UCBPlayer,66,296,362,3,47,UCBPlayer
1413,UCBPlayer,52,307,359,0,47,UCBPlayer
1414,UCBPlayer,52,307,359,0,47,UCBPlayer
1415,UCBPlayer,75,275,350,3,51,UCBPlayer
1416,UCBPlayer,71,256,327,1,58,UCBPlayer
1417,UCBPlayer,53,313,366,1,45,UCBPlayer
1418,UCBPlayer,67,272,339,1,54,UCBPlayer
1419,UCBPlayer,75,295,370,5,45,UCBPlayer
1420,UCBPlayer,76,291,367,8,47,UCBPlayer
1421,UCBPlayer,75,280,355,2,49,UCBPlayer
1422,UCBPlayer,51,311,362,0,46,UCBPlayer
1423,UCBPlayer,55,295,350,0,50,UCBPlayer
1424,UCBPlayer,66,276,342,1,53,UCBPlayer
1425,UCBPlayer,53,303,356,0,48,UCBPlayer
1426,UCBPlayer,53,303,356,0,48,UCBPlayer
1427,UCBPlayer,47,312,359,0,47,UCBPlayer
1428,UCBPlayer,70,260,330,1,57,UCBPlayer
1429,UCBPlayer,51,311,362,0,46,UCBPlayer
1430,UCBPlayer,60,320,380,3,41,UCBPlayer
1431,UCBPlayer,64,304,368,3,45,UCBPlayer
1432,UCBPlayer,79,289,368,6,46,UCBPlayer
1433,UCBPlayer,58,308,366,1,45,UCBPlayer
1434,UCBPlayer,57,287,344,0,52,UCBPlayer
1435,UCBPlayer,70,285,355,2,49,UCBPlayer
1436,UCBPlayer,55,295,350,0,50,UCBPlayer
1437,UCBPlayer,54,299,353,0,49,UCBPlayer
1438,UCBPlayer,68,268,336,1,55,UCBPlayer
1439,UCBPlayer,55,295,350,0,50,UCBPlayer
1440,UCBPlayer,60,310,370,2,44,UCBPlayer
1441,UCBPlayer,58,313,371,3,44,UCBPlayer
1442,UCBPlayer,86,266,352,5,51,UCBPlayer
1443,UCBPlayer,48,323,371,0,43,UCBPlayer
1444,UCBPlayer,67,272,339,1,54,UCBPlayer
1445,UCBPlayer,50,315,365,0,45,UCBPlayer
1446,UCBPlayer,163,233,396,22,42,UCBPlayer
1447,UCBPlayer,47,327,374,0,42,UCBPlayer
0,JointPQPlayer,294,204,498,34,12,Player A
1,JointPQPlayer,304,164,468,25,19,Player A
2,JointPQPlayer,293,193,486,31,15,Player A
3,JointPQPlayer,150,240,390,13,41,JointPQPlayer
4,JointPQPlayer,294,179,473,30,19,Player A
5,JointPQPlayer,296,196,492,28,12,Player A
6,JointPQPlayer,302,192,494,39,15,Player A
7,JointPQPlayer,270,215,485,36,17,Player A
8,JointPQPlayer,273,223,496,35,13,Player A
9,JointPQPlayer,262,217,479,36,19,Player A
10,JointPQPlayer,241,216,457,32,25,Player A
11,JointPQPlayer,276,226,502,41,13,Player A
12,JointPQPlayer,164,234,398,12,38,JointPQPlayer
13,JointPQPlayer,290,200,490,35,15,Player A
14,JointPQPlayer,294,199,493,35,14,Player A
15,JointPQPlayer,329,164,493,32,13,Player A
16,JointPQPlayer,319,179,498,40,14,Player A
17,JointPQPlayer,297,192,489,28,13,Player A
18,JointPQPlayer,283,188,471,31,20,Player A
19,JointPQPlayer,295,195,490,32,14,Player A
20,JointPQPlayer,309,174,483,28,15,Player A
21,JointPQPlayer,276,211,487,38,17,Player A
22,JointPQPlayer,261,181,442,23,27,Player A
23,JointPQPlayer,296,201,497,36,13,Player A
24,JointPQPlayer,159,264,423,19,32,JointPQPlayer
25,JointPQPlayer,268,213,481,38,19,Player A
26,JointPQPlayer,283,183,466,29,21,Player A
27,JointPQPlayer,242,242,484,35,17,Tie
28,JointPQPlayer,165,270,435,13,26,JointPQPlayer
29,JointPQPlayer,263,243,506,45,13,Player A
30,JointPQPlayer,279,194,473,39,22,Player A
31,JointPQPlayer,272,187,459,28,23,Player A
32,JointPQPlayer,239,224,463,29,22,Player A
33,JointPQPlayer,282,187,469,26,19,Player A
34,JointPQPlayer,310,165,475,35,20,Player A
35,JointPQPlayer,276,201,477,34,19,Player A
36,JointPQPlayer,291,171,462,28,22,Player A
37,JointPQPlayer,316,181,497,39,14,Player A
38,JointPQPlayer,289,214,503,33,10,Player A
39,JointPQPlayer,312,177,489,34,15,Player A
40,JointPQPlayer,299,194,493,32,13,Player A
41,JointPQPlayer,161,256,417,16,33,JointPQPlayer
42,JointPQPlayer,132,252,384,13,43,JointPQPlayer
43,JointPQPlayer,168,238,406,17,37,JointPQPlayer
44,JointPQPlayer,293,213,506,45,13,Player A
45,JointPQPlayer,290,195,485,36,17,Player A
46,JointPQPlayer,282,217,499,38,13,Player A
47,JointPQPlayer,281,211,492,40,16,Player A
48,JointPQPlayer,312,172,484,32,16,Player A
49,JointPQPlayer,296,186,482,33,17,Player A
50,JointPQPlayer,332,167,499,35,12,Player A
51,JointPQPlayer,255,200,455,33,26,Player A
52,JointPQPlayer,168,268,436,17,27,JointPQPlayer
53,JointPQPlayer,302,202,504,34,10,Player A
54,JointPQPlayer,307,177,484,35,17,Player A
55,JointPQPlayer,302,192,494,33,13,Player A
56,JointPQPlayer,313,203,516,37,7,Player A
57,JointPQPlayer,297,182,479,30,17,Player A
58,JointPQPlayer,321,156,477,25,16,Player A
59,JointPQPlayer,300,190,490,32,14,Player A
60,JointPQPlayer,306,186,492,34,14,Player A
61,JointPQPlayer,286,206,492,37,15,Player A
62,JointPQPlayer,279,199,478,29,17,Player A
63,JointPQPlayer,300,190,490,32,14,Player A
64,JointPQPlayer,288,223,511,38,9,Player A
65,JointPQPlayer,293,188,481,35,18,Player A
66,JointPQPlayer,140,235,375,13,46,JointPQPlayer
67,JointPQPlayer,279,169,448,26,26,Player A
68,JointPQPlayer,241,206,447,19,24,Player A
69,JointPQPlayer,301,181,482,33,17,Player A
70,JointPQPlayer,286,196,482,36,18,Player A
71,JointPQPlayer,267,202,469,32,21,Player A
72,JointPQPlayer,311,171,482,27,15,Player A
73,JointPQPlayer,159,244,403,11,36,JointPQPlayer
74,JointPQPlayer,309,194,503,45,14,Player A
75,JointPQPlayer,249,214,463,35,24,Player A
76,JointPQPlayer,277,202,479,33,18,Player A
77,JointPQPlayer,286,201,487,38,17,Player A
78,JointPQPlayer,271,201,472,32,20,Player A
79,JointPQPlayer,139,269,408,13,35,JointPQPlayer
80,JointPQPlayer,175,230,405,13,36,JointPQPlayer
81,JointPQPlayer,277,197,474,40,22,Player A
82,JointPQPlayer,250,220,470,27,19,Player A
83,JointPQPlayer,290,195,485,33,16,Player A
84,JointPQPlayer,299,204,503,45,14,Player A
85,JointPQPlayer,296,181,477,31,18,Player A
86,JointPQPlayer,305,185,490,35,15,Player A
87,JointPQPlayer,270,205,475,26,17,Player A
88,JointPQPlayer,290,210,500,39,13,Player A
89,JointPQPlayer,291,191,482,33,17,Player A
90,JointPQPlayer,283,213,496,41,15,Player A
91,JointPQPlayer,307,182,489,31,14,Player A
92,JointPQPlayer,222,217,439,29,30,Player A
93,JointPQPlayer,293,213,506,39,11,Player A
94,JointPQPlayer,292,192,484,35,17,Player A
95,JointPQPlayer,241,226,467,21,18,Player A
96,JointPQPlayer,290,200,490,29,13,Player A
97,JointPQPlayer,279,199,478,29,17,Player A
98,JointPQPlayer,153,238,391,17,42,JointPQPlayer
99,JointPQPlayer,318,168,486,34,16,Player A
100,JointPQPlayer,313,173,486,34,16,Player A
101,JointPQPlayer,274,199,473,33,20,Player A
102,JointPQPlayer,298,193,491,42,17,Player A
103,JointPQPlayer,266,201,467,27,20,Player A
104,JointPQPlayer,302,162,464,36,24,Player A
105,JointPQPlayer,288,203,491,33,14,Player A
106,JointPQPlayer,160,270,430,14,28,JointPQPlayer
107,JointPQPlayer,269,204,473,33,20,Player A
108,JointPQPlayer,268,223,491,33,14,Player A
109,JointPQPlayer,286,186,472,32,20,Player A
110,JointPQPlayer,269,214,483,40,19,Player A
111,JointPQPlayer,138,263,401,15,38,JointPQPlayer
112,JointPQPlayer,239,224,463,23,20,Player A
113,JointPQPlayer,260,210,470,33,21,Player A
114,JointPQPlayer,276,226,502,38,12,Player A
115,JointPQPlayer,320,165,485,27,14,Player A
116,JointPQPlayer,310,190,500,33,11,Player A
117,JointPQPlayer,272,217,489,37,16,Player A
118,JointPQPlayer,310,175,485,33,16,Player A
119,JointPQPlayer,279,199,478,29,17,Player A
120,JointPQPlayer,283,203,486,37,17,Player A
121,JointPQPlayer,176,256,432,22,30,JointPQPlayer
122,JointPQPlayer,289,204,493,38,15,Player A
123,JointPQPlayer,288,203,491,33,14,Player A
124,JointPQPlayer,157,257,414,16,34,JointPQPlayer
125,JointPQPlayer,263,243,506,33,9,Player A
126,JointPQPlayer,312,192,504,43,13,Player A
127,JointPQPlayer,302,177,479,33,18,Player A
128,JointPQPlayer,326,181,507,37,10,Player A
129,JointPQPlayer,297,197,494,36,14,Player A
130,JointPQPlayer,287,202,489,40,17,Player A
131,JointPQPlayer,328,168,496,35,13,Player A
132,JointPQPlayer,308,183,491,36,15,Player A
133,JointPQPlayer,293,188,481,29,16,Player A
134,JointPQPlayer,285,220,505,41,12,Player A
135,JointPQPlayer,285,195,480,34,18,Player A
136,JointPQPlayer,337,157,494,33,13,Player A
137,JointPQPlayer,283,198,481,32,17,Player A
138,JointPQPlayer,289,214,503,33,10,Player A
139,JointPQPlayer,246,221,467,33,22,Player A
140,JointPQPlayer,296,176,472,32,20,Player A
141,JointPQPlayer,151,246,397,11,38,JointPQPlayer
142,JointPQPlayer,279,204,483,34,17,Player A
143,JointPQPlayer,222,227,449,18,23,JointPQPlayer
144,JointPQPlayer,313,173,486,31,15,Player A
145,JointPQPlayer,142,282,424,17,31,JointPQPlayer
146,JointPQPlayer,281,206,487,38,17,Player A
147,JointPQPlayer,140,265,405,16,37,JointPQPlayer
148,JointPQPlayer,315,160,475,29,18,Player A
149,JointPQPlayer,287,197,484,35,17,Player A
150,JointPQPlayer,309,179,488,42,18,Player A
151,JointPQPlayer,288,188,476,36,20,Player A
152,JointPQPlayer,271,221,492,37,15,Player A
153,JointPQPlayer,313,198,511,38,9,Player A
154,JointPQPlayer,297,192,489,34,15,Player A
155,JointPQPlayer,162,262,424,17,31,JointPQPlayer
156,JointPQPlayer,178,258,436,17,27,JointPQPlayer
157,JointPQPlayer,315,155,470,21,17,Player A
158,JointPQPlayer,284,209,493,41,16,Player A
159,JointPQPlayer,312,182,494,39,15,Player A
160,JointPQPlayer,347,147,494,36,14,Player A
161,JointPQPlayer,264,199,463,29,22,Player A
162,JointPQPlayer,246,226,472,26,18,Player A
163,JointPQPlayer,127,307,434,18,28,JointPQPlayer
164,JointPQPlayer,132,287,419,12,31,JointPQPlayer
165,JointPQPlayer,245,210,455,30,25,Player A
166,JointPQPlayer,152,272,424,20,32,JointPQPlayer
167,JointPQPlayer,281,216,497,45,16,Player A
168,JointPQPlayer,217,232,449,18,23,JointPQPlayer
169,JointPQPlayer,133,263,396,10,38,JointPQPlayer
170,JointPQPlayer,325,180,505,38,11,Player A
171,JointPQPlayer,307,187,494,39,15,Player A
172,JointPQPlayer,133,298,431,15,28,JointPQPlayer
173,JointPQPlayer,260,235,495,37,14,Player A
174,JointPQPlayer,247,202,449,27,26,Player A
175,JointPQPlayer,255,235,490,44,18,Player A
176,JointPQPlayer,151,271,422,18,32,JointPQPlayer
177,JointPQPlayer,165,240,405,13,36,JointPQPlayer
178,JointPQPlayer,311,191,502,38,12,Player A
179,JointPQPlayer,282,217,499,38,13,Player A
180,JointPQPlayer,189,244,433,23,30,JointPQPlayer
181,JointPQPlayer,173,243,416,18,34,JointPQPlayer
182,JointPQPlayer,154,269,423,19,32,JointPQPlayer
183,JointPQPlayer,293,183,476,24,16,Player A
184,JointPQPlayer,175,245,420,16,32,JointPQPlayer
185,JointPQPlayer,294,179,473,33,20,Player A
186,JointPQPlayer,131,266,397,11,38,JointPQPlayer
187,JointPQPlayer,265,230,495,37,14,Player A
188,JointPQPlayer,112,287,399,13,38,JointPQPlayer
189,JointPQPlayer,310,165,475,29,18,Player A
190,JointPQPlayer,280,190,470,27,19,Player A
191,JointPQPlayer,257,212,469,29,20,Player A
192,JointPQPlayer,142,272,414,13,33,JointPQPlayer
193,JointPQPlayer,305,205,510,40,10,Player A
194,JointPQPlayer,159,239,398,15,39,JointPQPlayer
195,JointPQPlayer,126,301,427,17,30,JointPQPlayer
196,JointPQPlayer,294,199,493,35,14,Player A
197,JointPQPlayer,339,164,503,33,10,Player A
198,JointPQPlayer,285,190,475,26,17,Player A
199,JointPQPlayer,288,183,471,31,20,Player A
200,JointPQPlayer,332,172,504,31,9,Player A
201,JointPQPlayer,283,213,496,44,16,Player A
202,JointPQPlayer,155,265,420,13,31,JointPQPlayer
203,JointPQPlayer,277,222,499,44,15,Player A
204,JointPQPlayer,293,198,491,39,16,Player A
205,JointPQPlayer,323,168,491,39,16,Player A
206,JointPQPlayer,309,184,493,38,15,Player A
207,JointPQPlayer,252,222,474,34,20,Player A
208,JointPQPlayer,284,199,483,37,18,Player A
209,JointPQPlayer,294,189,483,31,16,Player A
210,JointPQPlayer,276,191,467,27,20,Player A
211,JointPQPlayer,279,204,483,40,19,Player A
212,JointPQPlayer,288,183,471,31,20,Player A
213,JointPQPlayer,303,183,486,49,21,Player A
214,JointPQPlayer,309,169,478,32,18,Player A
215,JointPQPlayer,292,192,484,35,17,Player A
216,JointPQPlayer,303,183,486,34,16,Player A
217,JointPQPlayer,170,260,430,17,29,JointPQPlayer
218,JointPQPlayer,184,244,428,18,30,JointPQPlayer
219,JointPQPlayer,303,188,491,30,13,Player A
220,JointPQPlayer,218,243,461,30,23,JointPQPlayer
221,JointPQPlayer,194,244,438,16,26,JointPQPlayer
222,JointPQPlayer,175,250,425,15,30,JointPQPlayer
223,JointPQPlayer,324,174,498,40,14,Player A
224,JointPQPlayer,305,210,515,42,9,Player A
225,JointPQPlayer,285,200,485,33,16,Player A
226,JointPQPlayer,332,157,489,31,14,Player A
227,JointPQPlayer,308,193,501,40,13,Player A
228,JointPQPlayer,276,221,497,42,15,Player A
229,JointPQPlayer,251,226,477,34,19,Player A
230,JointPQPlayer,276,206,482,30,16,Player A
231,JointPQPlayer,322,167,489,34,15,Player A
232,JointPQPlayer,325,175,500,36,12,Player A
233,JointPQPlayer,245,205,450,25,25,Player A
234,JointPQPlayer,301,166,467,30,21,Player A
235,JointPQPlayer,309,194,503,33,10,Player A
236,JointPQPlayer,299,189,488,36,16,Player A
237,JointPQPlayer,261,181,442,23,27,Player A
238,JointPQPlayer,281,216,497,39,14,Player A
239,JointPQPlayer,227,227,454,26,24,Tie
240,JointPQPlayer,291,206,497,36,13,Player A
241,JointPQPlayer,318,188,506,42,12,Player A
242,JointPQPlayer,283,183,466,29,21,Player A
243,JointPQPlayer,288,188,476,33,19,Player A
244,JointPQPlayer,286,201,487,32,15,Player A
245,JointPQPlayer,296,201,497,36,13,Player A
246,JointPQPlayer,300,185,485,33,16,Player A
247,JointPQPlayer,299,194,493,35,14,Player A
248,JointPQPlayer,138,223,361,14,51,JointPQPlayer
249,JointPQPlayer,298,213,511,47,12,Player A
250,JointPQPlayer,300,195,495,34,13,Player A
251,JointPQPlayer,158,253,411,19,36,JointPQPlayer
252,JointPQPlayer,265,205,470,33,21,Player A
253,JointPQPlayer,288,183,471,28,19,Player A
254,JointPQPlayer,301,186,487,32,15,Player A
255,JointPQPlayer,314,164,478,38,20,Player A
256,JointPQPlayer,294,204,498,37,13,Player A
257,JointPQPlayer,299,194,493,35,14,Player A
258,JointPQPlayer,301,176,477,37,20,Player A
259,JointPQPlayer,282,197,479,39,20,Player A
260,JointPQPlayer,148,258,406,14,36,JointPQPlayer
261,JointPQPlayer,280,230,510,37,9,Player A
262,JointPQPlayer,152,242,394,11,39,JointPQPlayer
263,JointPQPlayer,338,168,506,39,11,Player A
264,JointPQPlayer,124,299,423,16,31,JointPQPlayer
265,JointPQPlayer,134,284,418,8,30,JointPQPlayer
266,JointPQPlayer,302,187,489,31,14,Player A
267,JointPQPlayer,293,208,501,37,12,Player A
268,JointPQPlayer,282,207,489,34,15,Player A
269,JointPQPlayer,282,197,479,42,21,Player A
270,JointPQPlayer,295,180,475,29,18,Player A
271,JointPQPlayer,292,187,479,30,17,Player A
272,JointPQPlayer,137,262,399,13,38,JointPQPlayer
273,JointPQPlayer,294,194,488,30,14,Player A
274,JointPQPlayer,290,185,475,35,20,Player A
275,JointPQPlayer,306,211,517,38,7,Player A
276,JointPQPlayer,301,196,497,36,13,Player A
277,JointPQPlayer,297,192,489,40,17,Player A
278,JointPQPlayer,302,187,489,31,14,Player A
279,JointPQPlayer,170,225,395,12,39,JointPQPlayer
280,JointPQPlayer,239,229,468,31,21,Player A
281,JointPQPlayer,300,175,475,35,20,Player A
282,JointPQPlayer,281,231,512,45,11,Player A
283,JointPQPlayer,127,297,424,17,31,JointPQPlayer
284,JointPQPlayer,322,172,494,39,15,Player A
285,JointPQPlayer,277,197,474,34,20,Player A
286,JointPQPlayer,310,185,495,34,13,Player A
287,JointPQPlayer,291,201,492,37,15,Player A
288,JointPQPlayer,290,205,495,34,13,Player A
289,JointPQPlayer,161,266,427,14,29,JointPQPlayer
290,JointPQPlayer,271,226,497,39,14,Player A
291,JointPQPlayer,300,205,505,44,13,Player A
292,JointPQPlayer,165,225,390,10,40,JointPQPlayer
293,JointPQPlayer,293,193,486,37,17,Player A
294,JointPQPlayer,313,168,481,29,16,Player A
295,JointPQPlayer,257,197,454,23,23,Player A
296,JointPQPlayer,301,186,487,35,16,Player A
297,JointPQPlayer,289,184,473,30,19,Player A
298,JointPQPlayer,342,167,509,36,9,Player A
299,JointPQPlayer,261,221,482,30,16,Player A
300,JointPQPlayer,305,195,500,39,13,Player A
301,JointPQPlayer,163,258,421,20,33,JointPQPlayer
302,JointPQPlayer,288,223,511,38,9,Player A
303,JointPQPlayer,307,202,509,39,10,Player A
304,JointPQPlayer,307,177,484,29,15,Player A
305,JointPQPlayer,309,189,498,34,12,Player A
306,JointPQPlayer,167,232,399,13,38,JointPQPlayer
307,JointPQPlayer,132,287,419,18,33,JointPQPlayer
308,JointPQPlayer,151,271,422,21,33,JointPQPlayer
309,JointPQPlayer,284,204,488,33,15,Player A
310,JointPQPlayer,333,168,501,31,10,Player A
311,JointPQPlayer,175,250,425,12,29,JointPQPlayer
312,JointPQPlayer,276,211,487,35,16,Player A
313,JointPQPlayer,311,191,502,41,13,Player A
314,JointPQPlayer,180,220,400,11,37,JointPQPlayer
315,JointPQPlayer,280,195,475,35,20,Player A
316,JointPQPlayer,296,196,492,34,14,Player A
317,JointPQPlayer,304,184,488,36,16,Player A
318,JointPQPlayer,146,276,422,12,30,JointPQPlayer
319,JointPQPlayer,305,190,495,40,15,Player A
320,JointPQPlayer,163,273,436,20,28,JointPQPlayer
321,JointPQPlayer,139,269,408,13,35,JointPQPlayer
322,JointPQPlayer,298,178,476,30,18,Player A
323,JointPQPlayer,150,265,415,17,34,JointPQPlayer
324,JointPQPlayer,249,229,478,35,19,Player A
325,JointPQPlayer,133,298,431,12,27,JointPQPlayer
326,JointPQPlayer,253,223,476,39,21,Player A
327,JointPQPlayer,276,211,487,35,16,Player A
328,JointPQPlayer,141,246,387,16,43,JointPQPlayer
329,JointPQPlayer,164,254,418,17,33,JointPQPlayer
330,JointPQPlayer,255,210,465,25,20,Player A
331,JointPQPlayer,259,204,463,29,22,Player A
332,JointPQPlayer,192,227,419,18,33,JointPQPlayer
333,JointPQPlayer,278,198,476,27,17,Player A
334,JointPQPlayer,273,208,481,38,19,Player A
335,JointPQPlayer,156,246,402,19,39,JointPQPlayer
336,JointPQPlayer,262,227,489,37,16,Player A
337,JointPQPlayer,160,245,405,13,36,JointPQPlayer
338,JointPQPlayer,295,190,485,36,17,Player A
339,JointPQPlayer,148,263,411,16,35,JointPQPlayer
340,JointPQPlayer,291,181,472,29,19,Player A
341,JointPQPlayer,172,222,394,11,39,JointPQPlayer
342,JointPQPlayer,284,204,488,33,15,Player A
343,JointPQPlayer,305,170,475,29,18,Player A
344,JointPQPlayer,284,194,478,32,18,Player A
345,JointPQPlayer,181,251,432,25,31,JointPQPlayer
346,JointPQPlayer,308,173,481,29,16,Player A
347,JointPQPlayer,324,184,508,32,8,Player A
348,JointPQPlayer,166,261,427,14,29,JointPQPlayer
349,JointPQPlayer,239,214,453,25,24,Player A
350,JointPQPlayer,291,176,467,30,21,Player A
351,JointPQPlayer,292,202,494,39,15,Player A
352,JointPQPlayer,310,200,510,40,10,Player A
353,JointPQPlayer,265,185,450,25,25,Player A
354,JointPQPlayer,244,239,483,31,16,Player A
355,JointPQPlayer,235,260,495,40,15,JointPQPlayer
356,JointPQPlayer,155,250,405,13,36,JointPQPlayer
357,JointPQPlayer,285,200,485,30,15,Player A
358,JointPQPlayer,267,212,479,42,21,Player A
359,JointPQPlayer,172,262,434,18,28,JointPQPlayer
360,JointPQPlayer,281,206,487,35,16,Player A
361,JointPQPlayer,285,205,490,41,17,Player A
362,JointPQPlayer,288,198,486,31,15,Player A
363,JointPQPlayer,276,201,477,31,18,Player A
364,JointPQPlayer,283,208,491,36,15,Player A
365,JointPQPlayer,291,211,502,35,11,Player A
366,JointPQPlayer,117,297,414,13,33,JointPQPlayer
367,JointPQPlayer,255,225,480,28,16,Player A
368,JointPQPlayer,269,199,468,31,21,Player A
369,JointPQPlayer,279,199,478,38,20,Player A
370,JointPQPlayer,116,276,392,12,40,JointPQPlayer
371,JointPQPlayer,198,273,471,37,22,JointPQPlayer
372,JointPQPlayer,258,218,476,33,19,Player A
373,JointPQPlayer,243,228,471,28,19,Player A
374,JointPQPlayer,254,229,483,31,16,Player A
375,JointPQPlayer,314,179,493,29,12,Player A
376,JointPQPlayer,283,208,491,39,16,Player A
377,JointPQPlayer,323,178,501,37,12,Player A
378,JointPQPlayer,322,162,484,32,16,Player A
379,JointPQPlayer,157,252,409,11,34,JointPQPlayer
380,JointPQPlayer,333,173,506,39,11,Player A
381,JointPQPlayer,288,213,501,37,12,Player A
382,JointPQPlayer,150,260,410,12,34,JointPQPlayer
383,JointPQPlayer,314,174,488,42,18,Player A
384,JointPQPlayer,274,219,493,38,15,Player A
385,JointPQPlayer,277,182,459,25,22,Player A
386,JointPQPlayer,248,233,481,35,18,Player A
387,JointPQPlayer,299,179,478,32,18,Player A
388,JointPQPlayer,308,193,501,40,13,Player A
389,JointPQPlayer,295,190,485,30,15,Player A
390,JointPQPlayer,314,194,508,38,10,Player A
391,JointPQPlayer,313,173,486,31,15,Player A
392,JointPQPlayer,165,260,425,18,31,JointPQPlayer
393,JointPQPlayer,265,230,495,37,14,Player A
394,JointPQPlayer,289,209,498,40,14,Player A
395,JointPQPlayer,158,248,406,14,36,JointPQPlayer
396,JointPQPlayer,268,213,481,38,19,Player A
397,JointPQPlayer,263,198,461,33,24,Player A
398,JointPQPlayer,277,177,454,26,24,Player A
399,JointPQPlayer,298,203,501,37,12,Player A
400,JointPQPlayer,130,290,420,16,32,JointPQPlayer
401,JointPQPlayer,136,271,407,18,37,JointPQPlayer
402,JointPQPlayer,158,243,401,18,39,JointPQPlayer
403,JointPQPlayer,272,237,509,48,13,Player A
404,JointPQPlayer,132,272,404,9,35,JointPQPlayer
405,JointPQPlayer,134,264,398,12,38,JointPQPlayer
406,JointPQPlayer,300,195,495,34,13,Player A
407,JointPQPlayer,158,248,406,11,35,JointPQPlayer
408,JointPQPlayer,316,186,502,44,14,Player A
409,JointPQPlayer,321,171,492,31,13,Player A
410,JointPQPlayer,270,190,460,32,24,Player A
411,JointPQPlayer,253,193,446,33,29,Player A
412,JointPQPlayer,290,215,505,47,14,Player A
413,JointPQPlayer,273,193,466,32,22,Player A
414,JointPQPlayer,303,193,496,38,14,Player A
415,JointPQPlayer,299,184,483,34,17,Player A
416,JointPQPlayer,119,254,373,8,45,JointPQPlayer
417,JointPQPlayer,273,213,486,28,14,Player A
418,JointPQPlayer,332,152,484,35,17,Player A
419,JointPQPlayer,288,203,491,33,14,Player A
420,JointPQPlayer,318,183,501,43,14,Player A
421,JointPQPlayer,292,202,494,39,15,Player A
422,JointPQPlayer,139,269,408,16,36,JointPQPlayer
423,JointPQPlayer,157,227,384,13,43,JointPQPlayer
424,JointPQPlayer,279,214,493,35,14,Player A
425,JointPQPlayer,311,186,497,36,13,Player A
426,JointPQPlayer,348,143,491,30,13,Player A
427,JointPQPlayer,259,209,468,34,22,Player A
428,JointPQPlayer,143,288,431,12,27,JointPQPlayer
429,JointPQPlayer,283,218,501,37,12,Player A
430,JointPQPlayer,275,220,495,34,13,Player A
431,JointPQPlayer,145,260,405,10,35,JointPQPlayer
432,JointPQPlayer,271,211,482,27,15,Player A
433,JointPQPlayer,297,207,504,40,12,Player A
434,JointPQPlayer,268,203,471,37,22,Player A
435,JointPQPlayer,297,192,489,40,17,Player A
436,JointPQPlayer,129,264,393,13,40,JointPQPlayer
437,JointPQPlayer,300,190,490,41,17,Player A
438,JointPQPlayer,298,208,506,48,14,Player A
439,JointPQPlayer,151,251,402,16,38,JointPQPlayer
440,JointPQPlayer,138,248,386,12,42,JointPQPlayer
441,JointPQPlayer,151,231,382,8,42,JointPQPlayer
442,JointPQPlayer,330,165,495,34,13,Player A
443,JointPQPlayer,309,179,488,39,17,Player A
444,JointPQPlayer,283,208,491,30,13,Player A
445,JointPQPlayer,126,281,407,12,35,JointPQPlayer
446,JointPQPlayer,302,207,509,39,10,Player A
447,JointPQPlayer,286,196,482,36,18,Player A
448,JointPQPlayer,298,193,491,36,15,Player A
449,JointPQPlayer,304,164,468,31,21,Player A
450,JointPQPlayer,264,214,478,35,19,Player A
451,JointPQPlayer,328,143,471,28,19,Player A
452,JointPQPlayer,263,213,476,27,17,Player A
453,JointPQPlayer,289,189,478,26,16,Player A
454,JointPQPlayer,235,215,450,22,24,Player A
455,JointPQPlayer,293,188,481,35,18,Player A
456,JointPQPlayer,272,232,504,37,11,Player A
457,JointPQPlayer,287,207,494,36,14,Player A
458,JointPQPlayer,142,287,429,16,29,JointPQPlayer
459,JointPQPlayer,303,193,496,29,11,Player A
460,JointPQPlayer,267,202,469,29,20,Player A
461,JointPQPlayer,299,179,478,41,21,Player A
462,JointPQPlayer,267,212,479,21,14,Player A
463,JointPQPlayer,285,225,510,40,10,Player A
464,JointPQPlayer,160,240,400,14,38,JointPQPlayer
465,JointPQPlayer,309,184,493,29,12,Player A
466,JointPQPlayer,287,192,479,27,16,Player A
467,JointPQPlayer,166,241,407,12,35,JointPQPlayer
468,JointPQPlayer,115,270,385,5,40,JointPQPlayer
469,JointPQPlayer,262,222,484,32,16,Player A
470,JointPQPlayer,284,199,483,28,15,Player A
471,JointPQPlayer,305,205,510,43,11,Player A
472,JointPQPlayer,291,211,502,41,13,Player A
473,JointPQPlayer,294,184,478,32,18,Player A
474,JointPQPlayer,272,207,479,33,18,Player A
475,JointPQPlayer,271,221,492,31,13,Player A
476,JointPQPlayer,314,194,508,41,11,Player A
477,JointPQPlayer,273,198,471,31,20,Player A
478,JointPQPlayer,291,171,462,31,23,Player A
479,JointPQPlayer,272,197,469,32,21,Player A
480,JointPQPlayer,158,248,406,11,35,JointPQPlayer
481,JointPQPlayer,293,203,496,41,15,Player A
482,JointPQPlayer,280,195,475,26,17,Player A
483,JointPQPlayer,324,174,498,37,13,Player A
484,JointPQPlayer,285,205,490,41,17,Player A
485,JointPQPlayer,176,231,407,15,36,JointPQPlayer
486,JointPQPlayer,292,177,469,26,19,Player A
487,JointPQPlayer,305,170,475,38,21,Player A
488,JointPQPlayer,247,217,464,27,21,Player A
489,JointPQPlayer,253,203,456,31,25,Player A
490,JointPQPlayer,136,286,422,12,30,JointPQPlayer
491,JointPQPlayer,182,242,424,14,30,JointPQPlayer
492,JointPQPlayer,241,236,477,31,18,Player A
493,JointPQPlayer,288,198,486,28,14,Player A
494,JointPQPlayer,242,232,474,31,19,Player A
495,JointPQPlayer,301,196,497,30,11,Player A
496,JointPQPlayer,197,257,454,26,24,JointPQPlayer
497,JointPQPlayer,168,238,406,14,36,JointPQPlayer
498,JointPQPlayer,165,270,435,22,29,JointPQPlayer
499,JointPQPlayer,310,200,510,34,8,Player A
500,JointPQPlayer,290,225,515,45,10,Player A
501,JointPQPlayer,327,172,499,35,12,Player A
502,JointPQPlayer,322,172,494,27,11,Player A
503,JointPQPlayer,139,254,393,16,41,JointPQPlayer
504,JointPQPlayer,300,185,485,30,15,Player A
505,JointPQPlayer,138,243,381,13,44,JointPQPlayer
506,JointPQPlayer,288,208,496,35,13,Player A
507,JointPQPlayer,200,245,445,26,27,JointPQPlayer
508,JointPQPlayer,254,224,478,32,18,Player A
509,JointPQPlayer,310,180,490,35,15,Player A
510,JointPQPlayer,163,248,411,16,35,JointPQPlayer
511,JointPQPlayer,243,248,491,42,17,JointPQPlayer
512,JointPQPlayer,248,233,481,35,18,Player A
513,JointPQPlayer,293,193,486,31,15,Player A
514,JointPQPlayer,308,183,491,30,13,Player A
515,JointPQPlayer,152,252,404,9,35,JointPQPlayer
516,JointPQPlayer,291,201,492,31,13,Player A
517,JointPQPlayer,319,184,503,36,11,Player A
518,JointPQPlayer,298,193,491,33,14,Player A
519,JointPQPlayer,284,204,488,36,16,Player A
520,JointPQPlayer,283,193,476,39,21,Player A
521,JointPQPlayer,332,157,489,31,14,Player A
522,JointPQPlayer,156,256,412,14,34,JointPQPlayer
523,JointPQPlayer,301,181,482,33,17,Player A
524,JointPQPlayer,293,203,496,38,14,Player A
525,JointPQPlayer,301,181,482,36,18,Player A
526,JointPQPlayer,311,196,507,40,11,Player A
527,JointPQPlayer,277,217,494,30,12,Player A
528,JointPQPlayer,319,189,508,38,10,Player A
529,JointPQPlayer,131,261,392,12,40,JointPQPlayer
530,JointPQPlayer,299,184,483,34,17,Player A
531,JointPQPlayer,222,237,459,25,22,JointPQPlayer
532,JointPQPlayer,113,268,381,10,43,JointPQPlayer
533,JointPQPlayer,299,179,478,26,16,Player A
534,JointPQPlayer,251,231,482,33,17,Player A
535,JointPQPlayer,273,208,481,35,18,Player A
536,JointPQPlayer,126,291,417,13,32,JointPQPlayer
537,JointPQPlayer,277,212,489,31,14,Player A
538,JointPQPlayer,287,202,489,31,14,Player A
539,JointPQPlayer,311,171,482,33,17,Player A
540,JointPQPlayer,108,258,366,13,49,JointPQPlayer
541,JointPQPlayer,274,224,498,34,12,Player A
542,JointPQPlayer,294,189,483,31,16,Player A
543,JointPQPlayer,283,203,486,37,17,Player A
544,JointPQPlayer,287,192,479,36,19,Player A
545,JointPQPlayer,135,265,400,17,39,JointPQPlayer
546,JointPQPlayer,305,185,490,35,15,Player A
547,JointPQPlayer,257,217,474,34,20,Player A
548,JointPQPlayer,274,204,478,29,17,Player A
549,JointPQPlayer,297,182,479,30,17,Player A
550,JointPQPlayer,297,192,489,37,16,Player A
551,JointPQPlayer,311,181,492,34,14,Player A
552,JointPQPlayer,300,185,485,33,16,Player A
553,JointPQPlayer,168,258,426,22,32,JointPQPlayer
554,JointPQPlayer,255,210,465,28,21,Player A
555,JointPQPlayer,285,195,480,37,19,Player A
556,JointPQPlayer,329,174,503,30,9,Player A
557,JointPQPlayer,185,245,430,23,31,JointPQPlayer
558,JointPQPlayer,285,220,505,38,11,Player A
559,JointPQPlayer,289,199,488,27,13,Player A
560,JointPQPlayer,301,181,482,33,17,Player A
561,JointPQPlayer,160,235,395,15,40,JointPQPlayer
562,JointPQPlayer,262,192,454,23,23,Player A
563,JointPQPlayer,155,270,425,18,31,JointPQPlayer
564,JointPQPlayer,167,247,414,19,35,JointPQPlayer
565,JointPQPlayer,286,201,487,38,17,Player A
566,JointPQPlayer,222,222,444,25,27,Tie
567,JointPQPlayer,321,186,507,34,9,Player A
568,JointPQPlayer,264,219,483,40,19,Player A
569,JointPQPlayer,330,185,515,36,7,Player A
570,JointPQPlayer,228,223,451,26,25,Player A
571,JointPQPlayer,256,221,477,34,19,Player A
572,JointPQPlayer,265,220,485,30,15,Player A
573,JointPQPlayer,248,253,501,37,12,JointPQPlayer
574,JointPQPlayer,309,189,498,40,14,Player A
575,JointPQPlayer,274,214,488,39,17,Player A
576,JointPQPlayer,156,251,407,12,35,JointPQPlayer
577,JointPQPlayer,258,223,481,35,18,Player A
578,JointPQPlayer,304,189,493,38,15,Player A
579,JointPQPlayer,140,290,430,20,30,JointPQPlayer
580,JointPQPlayer,296,206,502,38,12,Player A
581,JointPQPlayer,270,210,480,43,21,Player A
582,JointPQPlayer,323,198,521,39,6,Player A
583,JointPQPlayer,279,224,503,36,11,Player A
584,JointPQPlayer,329,144,473,21,16,Player A
585,JointPQPlayer,262,217,479,33,18,Player A
586,JointPQPlayer,301,186,487,32,15,Player A
587,JointPQPlayer,216,226,442,23,27,JointPQPlayer
588,JointPQPlayer,296,206,502,35,11,Player A
589,JointPQPlayer,307,177,484,35,17,Player A
590,JointPQPlayer,331,146,477,25,16,Player A
591,JointPQPlayer,274,164,438,22,28,Player A
592,JointPQPlayer,303,163,466,20,18,Player A
593,JointPQPlayer,142,292,434,12,26,JointPQPlayer
594,JointPQPlayer,198,253,451,26,25,JointPQPlayer
595,JointPQPlayer,203,243,446,24,26,JointPQPlayer
596,JointPQPlayer,320,180,500,39,13,Player A
597,JointPQPlayer,141,276,417,16,33,JointPQPlayer
598,JointPQPlayer,302,177,479,33,18,Player A
599,JointPQPlayer,251,216,467,30,21,Player A
600,JointPQPlayer,277,222,499,44,15,Player A
601,JointPQPlayer,276,226,502,38,12,Player A
602,JointPQPlayer,260,190,450,25,25,Player A
603,JointPQPlayer,142,282,424,14,30,JointPQPlayer
604,JointPQPlayer,266,196,462,31,23,Player A
605,JointPQPlayer,290,180,470,36,22,Player A
606,JointPQPlayer,267,212,479,33,18,Player A
607,JointPQPlayer,307,177,484,38,18,Player A
608,JointPQPlayer,297,202,499,35,12,Player A
609,JointPQPlayer,314,184,498,31,11,Player A
610,JointPQPlayer,301,186,487,35,16,Player A
611,JointPQPlayer,137,252,389,12,41,JointPQPlayer
612,JointPQPlayer,316,196,512,39,9,Player A
613,JointPQPlayer,263,228,491,36,15,Player A
614,JointPQPlayer,141,216,357,7,50,JointPQPlayer
615,JointPQPlayer,283,228,511,44,11,Player A
616,JointPQPlayer,256,206,462,31,23,Player A
617,JointPQPlayer,329,179,508,35,9,Player A
618,JointPQPlayer,283,198,481,32,17,Player A
619,JointPQPlayer,157,247,404,18,38,JointPQPlayer
620,JointPQPlayer,121,256,377,15,46,JointPQPlayer
621,JointPQPlayer,282,177,459,25,22,Player A
622,JointPQPlayer,129,279,408,16,36,JointPQPlayer
623,JointPQPlayer,146,251,397,14,39,JointPQPlayer
624,JointPQPlayer,261,236,497,39,14,Player A
625,JointPQPlayer,335,165,500,36,12,Player A
626,JointPQPlayer,283,208,491,33,14,Player A
627,JointPQPlayer,314,169,483,31,16,Player A
628,JointPQPlayer,272,197,469,29,20,Player A
629,JointPQPlayer,298,183,481,32,17,Player A
630,JointPQPlayer,298,198,496,41,15,Player A
631,JointPQPlayer,331,176,507,40,11,Player A
632,JointPQPlayer,154,274,428,12,28,JointPQPlayer
633,JointPQPlayer,257,232,489,37,16,Player A
634,JointPQPlayer,281,176,457,29,24,Player A
635,JointPQPlayer,312,167,479,30,17,Player A
636,JointPQPlayer,300,165,465,34,23,Player A
637,JointPQPlayer,156,266,422,18,32,JointPQPlayer
638,JointPQPlayer,315,205,520,44,8,Player A
639,JointPQPlayer,173,248,421,17,32,JointPQPlayer
640,JointPQPlayer,278,223,501,34,11,Player A
641,JointPQPlayer,296,186,482,30,16,Player A
642,JointPQPlayer,288,208,496,35,13,Player A
643,JointPQPlayer,273,213,486,34,16,Player A
644,JointPQPlayer,347,152,499,32,11,Player A
645,JointPQPlayer,126,281,407,15,36,JointPQPlayer
646,JointPQPlayer,175,235,410,12,34,JointPQPlayer
647,JointPQPlayer,289,199,488,33,15,Player A
648,JointPQPlayer,124,289,413,21,36,JointPQPlayer
649,JointPQPlayer,310,195,505,41,12,Player A
650,JointPQPlayer,266,216,482,36,18,Player A
651,JointPQPlayer,264,239,503,33,10,Player A
652,JointPQPlayer,320,180,500,39,13,Player A
653,JointPQPlayer,118,293,411,16,35,JointPQPlayer
654,JointPQPlayer,296,191,487,38,17,Player A
655,JointPQPlayer,241,226,467,27,20,Player A
656,JointPQPlayer,276,216,492,31,13,Player A
657,JointPQPlayer,120,290,410,18,36,JointPQPlayer
658,JointPQPlayer,168,228,396,16,40,JointPQPlayer
659,JointPQPlayer,276,216,492,34,14,Player A
660,JointPQPlayer,258,203,461,30,23,Player A
661,JointPQPlayer,273,193,466,29,21,Player A
662,JointPQPlayer,290,210,500,42,14,Player A
663,JointPQPlayer,308,183,491,33,14,Player A
664,JointPQPlayer,262,212,474,31,19,Player A
665,JointPQPlayer,285,205,490,29,13,Player A
666,JointPQPlayer,125,300,425,15,30,JointPQPlayer
667,JointPQPlayer,282,202,484,29,15,Player A
668,JointPQPlayer,296,186,482,33,17,Player A
669,JointPQPlayer,292,192,484,32,16,Player A
670,JointPQPlayer,305,195,500,36,12,Player A
671,JointPQPlayer,274,219,493,38,15,Player A
672,JointPQPlayer,314,184,498,40,14,Player A
673,JointPQPlayer,294,194,488,30,14,Player A
674,JointPQPlayer,275,195,470,30,20,Player A
675,JointPQPlayer,260,220,480,31,17,Player A
676,JointPQPlayer,302,182,484,29,15,Player A
677,JointPQPlayer,312,177,489,34,15,Player A
678,JointPQPlayer,258,233,491,36,15,Player A
679,JointPQPlayer,304,189,493,35,14,Player A
680,JointPQPlayer,300,190,490,38,16,Player A
681,JointPQPlayer,265,215,480,34,18,Player A
682,JointPQPlayer,260,220,480,40,20,Player A
683,JointPQPlayer,279,219,498,34,12,Player A
684,JointPQPlayer,293,188,481,32,17,Player A
685,JointPQPlayer,306,166,472,23,17,Player A
686,JointPQPlayer,299,174,473,27,18,Player A
687,JointPQPlayer,332,192,524,48,8,Player A
688,JointPQPlayer,326,181,507,43,12,Player A
689,JointPQPlayer,275,200,475,32,19,Player A
690,JointPQPlayer,129,254,383,12,43,JointPQPlayer
691,JointPQPlayer,256,196,452,36,28,Player A
692,JointPQPlayer,171,271,442,17,25,JointPQPlayer
693,JointPQPlayer,298,173,471,31,20,Player A
694,JointPQPlayer,315,175,490,29,13,Player A
695,JointPQPlayer,315,190,505,35,10,Player A
696,JointPQPlayer,282,202,484,38,18,Player A
697,JointPQPlayer,125,270,395,15,40,JointPQPlayer
698,JointPQPlayer,307,187,494,36,14,Player A
699,JointPQPlayer,314,184,498,34,12,Player A
700,JointPQPlayer,150,260,410,18,36,JointPQPlayer
701,JointPQPlayer,288,193,481,32,17,Player A
702,JointPQPlayer,312,172,484,35,17,Player A
703,JointPQPlayer,301,226,527,54,9,Player A
704,JointPQPlayer,313,148,461,27,22,Player A
705,JointPQPlayer,283,198,481,44,21,Player A
706,JointPQPlayer,355,150,505,32,9,Player A
707,JointPQPlayer,263,223,486,40,18,Player A
708,JointPQPlayer,173,258,431,21,30,JointPQPlayer
709,JointPQPlayer,296,201,497,36,13,Player A
710,JointPQPlayer,318,183,501,34,11,Player A
711,JointPQPlayer,256,206,462,28,22,Player A
712,JointPQPlayer,293,213,506,36,10,Player A
713,JointPQPlayer,323,158,481,32,17,Player A
714,JointPQPlayer,307,172,479,36,19,Player A
715,JointPQPlayer,288,193,481,32,17,Player A
716,JointPQPlayer,270,215,485,36,17,Player A
717,JointPQPlayer,138,268,406,14,36,JointPQPlayer
718,JointPQPlayer,274,214,488,36,16,Player A
719,JointPQPlayer,319,184,503,36,11,Player A
720,JointPQPlayer,291,176,467,36,23,Player A
721,JointPQPlayer,150,255,405,13,36,JointPQPlayer
722,JointPQPlayer,317,177,494,30,12,Player A
723,JointPQPlayer,303,193,496,35,13,Player A
724,JointPQPlayer,177,257,434,18,28,JointPQPlayer
725,JointPQPlayer,281,211,492,37,15,Player A
726,JointPQPlayer,324,169,493,35,14,Player A
727,JointPQPlayer,153,263,416,12,32,JointPQPlayer
728,JointPQPlayer,305,190,495,34,13,Player A
729,JointPQPlayer,311,196,507,40,11,Player A
730,JointPQPlayer,248,218,466,32,22,Player A
731,JointPQPlayer,302,192,494,33,13,Player A
732,JointPQPlayer,198,243,441,25,28,JointPQPlayer
733,JointPQPlayer,148,268,416,15,33,JointPQPlayer
734,JointPQPlayer,155,245,400,14,38,JointPQPlayer
735,JointPQPlayer,150,245,395,12,39,JointPQPlayer
736,JointPQPlayer,136,281,417,16,33,JointPQPlayer
737,JointPQPlayer,259,204,463,23,20,Player A
738,JointPQPlayer,116,261,377,15,46,JointPQPlayer
739,JointPQPlayer,263,223,486,28,14,Player A
740,JointPQPlayer,306,176,482,36,18,Player A
741,JointPQPlayer,131,271,402,13,37,JointPQPlayer
742,JointPQPlayer,304,179,483,28,15,Player A
743,JointPQPlayer,275,195,470,24,18,Player A
744,JointPQPlayer,263,198,461,33,24,Player A
745,JointPQPlayer,292,197,489,34,15,Player A
746,JointPQPlayer,322,172,494,33,13,Player A
747,JointPQPlayer,288,198,486,37,17,Player A
748,JointPQPlayer,146,271,417,16,33,JointPQPlayer
749,JointPQPlayer,271,216,487,41,18,Player A
750,JointPQPlayer,321,171,492,34,14,Player A
751,JointPQPlayer,268,213,481,32,17,Player A
752,JointPQPlayer,157,242,399,13,38,JointPQPlayer
753,JointPQPlayer,293,203,496,38,14,Player A
754,JointPQPlayer,322,182,504,43,13,Player A
755,JointPQPlayer,255,230,485,39,18,Player A
756,JointPQPlayer,274,214,488,36,16,Player A
757,JointPQPlayer,306,186,492,34,14,Player A
758,JointPQPlayer,264,214,478,32,18,Player A
759,JointPQPlayer,259,254,513,43,10,Player A
760,JointPQPlayer,314,174,488,27,13,Player A
761,JointPQPlayer,329,169,498,34,12,Player A
762,JointPQPlayer,173,273,446,24,26,JointPQPlayer
763,JointPQPlayer,148,278,426,19,31,JointPQPlayer
764,JointPQPlayer,257,222,479,36,19,Player A
765,JointPQPlayer,292,182,474,31,19,Player A
766,JointPQPlayer,290,195,485,33,16,Player A
767,JointPQPlayer,277,202,479,33,18,Player A
768,JointPQPlayer,181,241,422,15,31,JointPQPlayer
769,JointPQPlayer,316,161,477,25,16,Player A
770,JointPQPlayer,274,189,463,26,21,Player A
771,JointPQPlayer,295,210,505,32,9,Player A
772,JointPQPlayer,312,172,484,29,15,Player A
773,JointPQPlayer,286,196,482,33,17,Player A
774,JointPQPlayer,285,180,465,31,22,Player A
775,JointPQPlayer,122,272,394,8,38,JointPQPlayer
776,JointPQPlayer,167,237,404,9,35,JointPQPlayer
777,JointPQPlayer,167,252,419,12,31,JointPQPlayer
778,JointPQPlayer,333,153,486,25,13,Player A
779,JointPQPlayer,220,230,450,19,23,JointPQPlayer
780,JointPQPlayer,170,220,390,10,40,JointPQPlayer
781,JointPQPlayer,271,226,497,33,12,Player A
782,JointPQPlayer,213,233,446,24,26,JointPQPlayer
783,JointPQPlayer,223,228,451,23,24,JointPQPlayer
784,JointPQPlayer,251,236,487,38,17,Player A
785,JointPQPlayer,290,200,490,44,18,Player A
786,JointPQPlayer,301,196,497,39,14,Player A
787,JointPQPlayer,298,208,506,33,9,Player A
788,JointPQPlayer,317,162,479,30,17,Player A
789,JointPQPlayer,170,255,425,18,31,JointPQPlayer
790,JointPQPlayer,274,219,493,41,16,Player A
791,JointPQPlayer,295,185,480,31,17,Player A
792,JointPQPlayer,307,182,489,40,17,Player A
793,JointPQPlayer,142,272,414,13,33,JointPQPlayer
794,JointPQPlayer,256,221,477,31,18,Player A
795,JointPQPlayer,247,222,469,29,20,Player A
796,JointPQPlayer,315,185,500,36,12,Player A
797,JointPQPlayer,272,222,494,30,12,Player A
798,JointPQPlayer,150,260,410,12,34,JointPQPlayer
799,JointPQPlayer,224,224,448,26,26,Tie
800,JointPQPlayer,315,180,495,31,12,Player A
801,JointPQPlayer,300,200,500,39,13,Player A
802,JointPQPlayer,333,178,511,35,8,Player A
803,JointPQPlayer,273,198,471,34,21,Player A
804,JointPQPlayer,266,211,477,31,18,Player A
805,JointPQPlayer,306,191,497,33,12,Player A
806,JointPQPlayer,202,242,444,25,27,JointPQPlayer
807,JointPQPlayer,309,149,458,24,22,Player A
808,JointPQPlayer,297,187,484,41,19,Player A
809,JointPQPlayer,297,192,489,40,17,Player A
810,JointPQPlayer,148,233,381,10,43,JointPQPlayer
811,JointPQPlayer,274,189,463,32,23,Player A
812,JointPQPlayer,310,190,500,39,13,Player A
813,JointPQPlayer,323,163,486,28,14,Player A
814,JointPQPlayer,144,254,398,15,39,JointPQPlayer
815,JointPQPlayer,298,163,461,30,23,Player A
816,JointPQPlayer,311,171,482,30,16,Player A
817,JointPQPlayer,239,199,438,22,28,Player A
818,JointPQPlayer,305,190,495,31,12,Player A
819,JointPQPlayer,284,189,473,27,18,Player A
820,JointPQPlayer,315,175,490,35,15,Player A
821,JointPQPlayer,262,202,464,24,20,Player A
822,JointPQPlayer,295,185,480,34,18,Player A
823,JointPQPlayer,266,226,492,34,14,Player A
824,JointPQPlayer,319,179,498,31,11,Player A
825,JointPQPlayer,270,160,430,20,30,Player A
826,JointPQPlayer,244,244,488,33,15,Tie
827,JointPQPlayer,290,205,495,37,14,Player A
828,JointPQPlayer,289,214,503,39,12,Player A
829,JointPQPlayer,273,213,486,37,17,Player A
830,JointPQPlayer,141,271,412,14,34,JointPQPlayer
831,JointPQPlayer,331,171,502,38,12,Player A
832,JointPQPlayer,312,177,489,34,15,Player A
833,JointPQPlayer,284,204,488,33,15,Player A
834,JointPQPlayer,296,186,482,33,17,Player A
835,JointPQPlayer,277,207,484,38,18,Player A
836,JointPQPlayer,256,221,477,25,16,Player A
837,JointPQPlayer,298,198,496,38,14,Player A
838,JointPQPlayer,203,233,436,17,27,JointPQPlayer
839,JointPQPlayer,306,206,512,42,10,Player A
840,JointPQPlayer,143,268,411,16,35,JointPQPlayer
841,JointPQPlayer,287,202,489,40,17,Player A
842,JointPQPlayer,275,205,480,28,16,Player A
843,JointPQPlayer,268,213,481,35,18,Player A
844,JointPQPlayer,268,213,481,35,18,Player A
845,JointPQPlayer,285,185,470,36,22,Player A
846,JointPQPlayer,152,277,429,19,30,JointPQPlayer
847,JointPQPlayer,264,209,473,36,21,Player A
848,JointPQPlayer,307,192,499,44,15,Player A
849,JointPQPlayer,298,188,486,40,18,Player A
850,JointPQPlayer,301,196,497,36,13,Player A
851,JointPQPlayer,292,187,479,36,19,Player A
852,JointPQPlayer,273,228,501,43,14,Player A
853,JointPQPlayer,297,202,499,35,12,Player A
854,JointPQPlayer,291,186,477,28,17,Player A
855,JointPQPlayer,261,196,457,32,25,Player A
856,JointPQPlayer,314,189,503,42,13,Player A
857,JointPQPlayer,203,238,441,28,29,JointPQPlayer
858,JointPQPlayer,294,194,488,36,16,Player A
859,JointPQPlayer,299,199,498,46,16,Player A
860,JointPQPlayer,166,246,412,14,34,JointPQPlayer
861,JointPQPlayer,297,177,474,37,21,Player A
862,JointPQPlayer,303,203,506,42,12,Player A
863,JointPQPlayer,281,196,477,43,22,Player A
864,JointPQPlayer,268,218,486,31,15,Player A
865,JointPQPlayer,290,225,515,39,8,Player A
866,JointPQPlayer,287,207,494,36,14,Player A
867,JointPQPlayer,233,233,466,29,21,Tie
868,JointPQPlayer,298,183,481,35,18,Player A
869,JointPQPlayer,310,180,490,38,16,Player A
870,JointPQPlayer,150,255,405,13,36,JointPQPlayer
871,JointPQPlayer,283,218,501,43,14,Player A
872,JointPQPlayer,287,192,479,36,19,Player A
873,JointPQPlayer,258,223,481,38,19,Player A
874,JointPQPlayer,309,184,493,32,13,Player A
875,JointPQPlayer,319,189,508,35,9,Player A
876,JointPQPlayer,277,212,489,31,14,Player A
877,JointPQPlayer,294,184,478,29,17,Player A
878,JointPQPlayer,221,256,477,31,18,JointPQPlayer
879,JointPQPlayer,258,213,471,31,20,Player A
880,JointPQPlayer,292,187,479,36,19,Player A
881,JointPQPlayer,326,186,512,36,8,Player A
882,JointPQPlayer,267,212,479,30,17,Player A
883,JointPQPlayer,246,211,457,29,24,Player A
884,JointPQPlayer,327,167,494,33,13,Player A
885,JointPQPlayer,173,268,441,19,26,JointPQPlayer
886,JointPQPlayer,263,233,496,41,15,Player A
887,JointPQPlayer,280,185,465,28,21,Player A
888,JointPQPlayer,309,184,493,41,16,Player A
889,JointPQPlayer,265,230,495,37,14,Player A
890,JointPQPlayer,295,210,505,32,9,Player A
891,JointPQPlayer,276,206,482,36,18,Player A
892,JointPQPlayer,321,181,502,32,10,Player A
893,JointPQPlayer,247,217,464,30,22,Player A
894,JointPQPlayer,325,205,530,45,5,Player A
895,JointPQPlayer,279,214,493,32,13,Player A
896,JointPQPlayer,158,228,386,15,43,JointPQPlayer
897,JointPQPlayer,320,175,495,34,13,Player A
898,JointPQPlayer,207,262,469,29,20,JointPQPlayer
899,JointPQPlayer,281,196,477,34,19,Player A
900,JointPQPlayer,258,208,466,35,23,Player A
901,JointPQPlayer,154,249,403,14,37,JointPQPlayer
902,JointPQPlayer,151,236,387,16,43,JointPQPlayer
903,JointPQPlayer,314,194,508,41,11,Player A
904,JointPQPlayer,310,180,490,29,13,Player A
905,JointPQPlayer,292,202,494,39,15,Player A
906,JointPQPlayer,242,237,479,33,18,Player A
907,JointPQPlayer,312,182,494,36,14,Player A
908,JointPQPlayer,313,158,471,28,19,Player A
909,JointPQPlayer,285,210,495,37,14,Player A
910,JointPQPlayer,258,223,481,41,20,Player A
911,JointPQPlayer,333,173,506,30,8,Player A
912,JointPQPlayer,287,187,474,25,17,Player A
913,JointPQPlayer,305,180,485,27,14,Player A
914,JointPQPlayer,267,232,499,35,12,Player A
915,JointPQPlayer,292,172,464,27,21,Player A
916,JointPQPlayer,149,259,408,13,35,JointPQPlayer
917,JointPQPlayer,324,189,513,31,6,Player A
918,JointPQPlayer,160,240,400,17,39,JointPQPlayer
919,JointPQPlayer,217,247,464,21,19,JointPQPlayer
920,JointPQPlayer,262,222,484,35,17,Player A
921,JointPQPlayer,160,240,400,8,36,JointPQPlayer
922,JointPQPlayer,267,202,469,35,22,Player A
923,JointPQPlayer,248,233,481,35,18,Player A
924,JointPQPlayer,142,247,389,9,40,JointPQPlayer
925,JointPQPlayer,269,219,488,36,16,Player A
926,JointPQPlayer,187,227,414,22,36,JointPQPlayer
927,JointPQPlayer,157,257,414,19,35,JointPQPlayer
928,JointPQPlayer,308,203,511,38,9,Player A
929,JointPQPlayer,188,253,441,22,27,JointPQPlayer
930,JointPQPlayer,260,210,470,33,21,Player A
931,JointPQPlayer,242,217,459,31,24,Player A
932,JointPQPlayer,257,197,454,32,26,Player A
933,JointPQPlayer,322,162,484,26,14,Player A
934,JointPQPlayer,317,207,524,48,8,Player A
935,JointPQPlayer,288,198,486,31,15,Player A
936,JointPQPlayer,185,240,425,18,31,JointPQPlayer
937,JointPQPlayer,152,247,399,16,39,JointPQPlayer
938,JointPQPlayer,139,259,398,12,38,JointPQPlayer
939,JointPQPlayer,290,195,485,36,17,Player A
940,JointPQPlayer,271,191,462,28,22,Player A
941,JointPQPlayer,330,180,510,37,9,Player A
942,JointPQPlayer,301,191,492,34,14,Player A
943,JointPQPlayer,267,217,484,32,16,Player A
944,JointPQPlayer,262,202,464,27,21,Player A
945,JointPQPlayer,303,188,491,36,15,Player A
946,JointPQPlayer,306,206,512,45,11,Player A
947,JointPQPlayer,282,227,509,39,10,Player A
948,JointPQPlayer,244,219,463,26,21,Player A
949,JointPQPlayer,293,213,506,39,11,Player A
950,JointPQPlayer,310,190,500,36,12,Player A
951,JointPQPlayer,270,190,460,26,22,Player A
952,JointPQPlayer,151,261,412,14,34,JointPQPlayer
953,JointPQPlayer,173,258,431,15,28,JointPQPlayer
954,JointPQPlayer,254,229,483,37,18,Player A
955,JointPQPlayer,301,181,482,33,17,Player A
956,JointPQPlayer,320,180,500,39,13,Player A
957,JointPQPlayer,122,262,384,13,43,JointPQPlayer
958,JointPQPlayer,262,202,464,27,21,Player A
959,JointPQPlayer,270,215,485,36,17,Player A
960,JointPQPlayer,224,194,418,23,35,Player A
961,JointPQPlayer,164,249,413,15,34,JointPQPlayer
962,JointPQPlayer,259,194,453,31,26,Player A
963,JointPQPlayer,293,193,486,37,17,Player A
964,JointPQPlayer,258,203,461,30,23,Player A
965,JointPQPlayer,301,186,487,38,17,Player A
966,JointPQPlayer,230,215,445,20,25,Player A
967,JointPQPlayer,316,181,497,33,12,Player A
968,JointPQPlayer,172,242,414,19,35,JointPQPlayer
969,JointPQPlayer,138,263,401,9,36,JointPQPlayer
970,JointPQPlayer,268,193,461,27,22,Player A
971,JointPQPlayer,313,188,501,31,10,Player A
972,JointPQPlayer,307,157,464,24,20,Player A
973,JointPQPlayer,288,193,481,32,17,Player A
974,JointPQPlayer,283,218,501,37,12,Player A
975,JointPQPlayer,149,259,408,19,37,JointPQPlayer
976,JointPQPlayer,290,215,505,47,14,Player A
977,JointPQPlayer,323,173,496,38,14,Player A
978,JointPQPlayer,171,241,412,11,33,JointPQPlayer
979,JointPQPlayer,298,173,471,28,19,Player A
980,JointPQPlayer,263,218,481,38,19,Player A
981,JointPQPlayer,184,224,408,22,38,JointPQPlayer
982,JointPQPlayer,266,211,477,40,21,Player A
983,JointPQPlayer,287,217,504,31,9,Player A
984,JointPQPlayer,281,181,462,28,22,Player A
985,JointPQPlayer,290,180,470,30,20,Player A
986,JointPQPlayer,309,169,478,32,18,Player A
987,JointPQPlayer,152,247,399,16,39,JointPQPlayer
988,JointPQPlayer,264,209,473,39,22,Player A
989,JointPQPlayer,324,169,493,38,15,Player A
990,JointPQPlayer,298,193,491,30,13,Player A
991,JointPQPlayer,279,209,488,33,15,Player A
992,JointPQPlayer,150,260,410,12,34,JointPQPlayer
993,JointPQPlayer,290,170,460,29,23,Player A
994,JointPQPlayer,287,197,484,26,14,Player A
995,JointPQPlayer,270,230,500,45,15,Player A
996,JointPQPlayer,258,223,481,32,17,Player A
997,JointPQPlayer,268,208,476,36,20,Player A
998,JointPQPlayer,289,164,453,28,25,Player A
999,JointPQPlayer,268,213,481,38,19,Player A
1000,JointPQPlayer,309,179,488,36,16,Player A
1001,JointPQPlayer,322,182,504,37,11,Player A
1002,JointPQPlayer,299,184,483,34,17,Player A
1003,JointPQPlayer,274,199,473,24,17,Player A
1004,JointPQPlayer,277,212,489,37,16,Player A
1005,JointPQPlayer,288,198,486,34,16,Player A
1006,JointPQPlayer,289,209,498,37,13,Player A
1007,JointPQPlayer,335,190,525,40,5,Player A
1008,JointPQPlayer,303,198,501,37,12,Player A
1009,JointPQPlayer,266,221,487,35,16,Player A
1010,JointPQPlayer,264,194,458,27,23,Player A
1011,JointPQPlayer,285,210,495,31,12,Player A
1012,JointPQPlayer,309,174,483,34,17,Player A
1013,JointPQPlayer,292,202,494,36,14,Player A
1014,JointPQPlayer,313,188,501,43,14,Player A
1015,JointPQPlayer,138,233,371,9,46,JointPQPlayer
1016,JointPQPlayer,317,187,504,37,11,Player A
1017,JointPQPlayer,321,196,517,44,9,Player A
1018,JointPQPlayer,309,189,498,34,12,Player A
1019,JointPQPlayer,188,248,436,17,27,JointPQPlayer
1020,JointPQPlayer,307,177,484,35,17,Player A
1021,JointPQPlayer,138,278,416,15,33,JointPQPlayer
1022,JointPQPlayer,260,215,475,35,20,Player A
1023,JointPQPlayer,315,195,510,37,9,Player A
1024,JointPQPlayer,243,233,476,30,18,Player A
1025,JointPQPlayer,294,204,498,40,14,Player A
1026,JointPQPlayer,238,213,451,26,25,Player A
1027,JointPQPlayer,145,235,380,9,43,JointPQPlayer
1028,JointPQPlayer,326,156,482,30,16,Player A
1029,JointPQPlayer,141,286,427,17,30,JointPQPlayer
1030,JointPQPlayer,243,228,471,25,18,Player A
1031,JointPQPlayer,314,179,493,32,13,Player A
1032,JointPQPlayer,252,237,489,40,17,Player A
1033,JointPQPlayer,182,237,419,15,32,JointPQPlayer
1034,JointPQPlayer,309,174,483,34,17,Player A
1035,JointPQPlayer,286,181,467,27,20,Player A
1036,JointPQPlayer,305,185,490,32,14,Player A
1037,JointPQPlayer,283,213,496,35,13,Player A
1038,JointPQPlayer,287,207,494,39,15,Player A
1039,JointPQPlayer,307,187,494,33,13,Player A
1040,JointPQPlayer,290,200,490,38,16,Player A
1041,JointPQPlayer,315,175,490,35,15,Player A
1042,JointPQPlayer,298,203,501,40,13,Player A
1043,JointPQPlayer,268,218,486,31,15,Player A
1044,JointPQPlayer,288,188,476,33,19,Player A
1045,JointPQPlayer,283,203,486,40,18,Player A
1046,JointPQPlayer,207,222,429,16,29,JointPQPlayer
1047,JointPQPlayer,276,201,477,31,18,Player A
1048,JointPQPlayer,284,199,483,37,18,Player A
1049,JointPQPlayer,290,200,490,35,15,Player A
1050,JointPQPlayer,288,208,496,44,16,Player A
1051,JointPQPlayer,296,191,487,32,15,Player A
1052,JointPQPlayer,314,184,498,37,13,Player A
1053,JointPQPlayer,279,214,493,44,17,Player A
1054,JointPQPlayer,269,204,473,33,20,Player A
1055,JointPQPlayer,293,203,496,41,15,Player A
1056,JointPQPlayer,178,238,416,21,35,JointPQPlayer
1057,JointPQPlayer,290,190,480,34,18,Player A
1058,JointPQPlayer,280,205,485,30,15,Player A
1059,JointPQPlayer,228,273,501,37,12,JointPQPlayer
1060,JointPQPlayer,275,205,480,31,17,Player A
1061,JointPQPlayer,328,183,511,38,9,Player A
1062,JointPQPlayer,312,192,504,43,13,Player A
1063,JointPQPlayer,293,178,471,22,17,Player A
1064,JointPQPlayer,278,198,476,33,19,Player A
1065,JointPQPlayer,285,210,495,40,15,Player A
1066,JointPQPlayer,318,173,491,33,14,Player A
1067,JointPQPlayer,143,268,411,13,34,JointPQPlayer
1068,JointPQPlayer,148,243,391,11,40,JointPQPlayer
1069,JointPQPlayer,146,271,417,10,31,JointPQPlayer
1070,JointPQPlayer,191,241,432,25,31,JointPQPlayer
1071,JointPQPlayer,273,203,476,36,20,Player A
1072,JointPQPlayer,152,222,374,9,45,JointPQPlayer
1073,JointPQPlayer,173,233,406,11,35,JointPQPlayer
1074,JointPQPlayer,292,202,494,33,13,Player A
1075,JointPQPlayer,275,195,470,33,21,Player A
1076,JointPQPlayer,139,244,383,15,44,JointPQPlayer
1077,JointPQPlayer,302,187,489,37,16,Player A
1078,JointPQPlayer,297,187,484,35,17,Player A
1079,JointPQPlayer,310,190,500,39,13,Player A
1080,JointPQPlayer,285,185,470,33,21,Player A
1081,JointPQPlayer,275,210,485,39,18,Player A
1082,JointPQPlayer,301,166,467,33,22,Player A
1083,JointPQPlayer,309,169,478,29,17,Player A
1084,JointPQPlayer,316,176,492,37,15,Player A
1085,JointPQPlayer,283,183,466,29,21,Player A
1086,JointPQPlayer,160,245,405,16,37,JointPQPlayer
1087,JointPQPlayer,197,242,439,23,28,JointPQPlayer
1088,JointPQPlayer,275,205,480,31,17,Player A
1089,JointPQPlayer,225,210,435,19,28,Player A
1090,JointPQPlayer,159,249,408,19,37,JointPQPlayer
1091,JointPQPlayer,252,182,434,24,30,Player A
1092,JointPQPlayer,219,194,413,15,34,Player A
1093,JointPQPlayer,310,185,495,43,16,Player A
1094,JointPQPlayer,290,205,495,40,15,Player A
1095,JointPQPlayer,262,232,494,36,14,Player A
1096,JointPQPlayer,310,180,490,29,13,Player A
1097,JointPQPlayer,156,241,397,14,39,JointPQPlayer
1098,JointPQPlayer,313,178,491,33,14,Player A
1099,JointPQPlayer,309,194,503,36,11,Player A
1100,JointPQPlayer,279,204,483,31,16,Player A
1101,JointPQPlayer,310,190,500,36,12,Player A
1102,JointPQPlayer,172,247,419,21,34,JointPQPlayer
1103,JointPQPlayer,290,215,505,41,12,Player A
1104,JointPQPlayer,324,169,493,35,14,Player A
1105,JointPQPlayer,278,218,496,38,14,Player A
1106,JointPQPlayer,267,197,464,30,22,Player A
1107,JointPQPlayer,257,202,459,25,22,Player A
1108,JointPQPlayer,194,269,463,26,21,JointPQPlayer
1109,JointPQPlayer,279,194,473,24,17,Player A
1110,JointPQPlayer,310,180,490,35,15,Player A
1111,JointPQPlayer,293,198,491,39,16,Player A
1112,JointPQPlayer,315,190,505,41,12,Player A
1113,JointPQPlayer,164,274,438,19,27,JointPQPlayer
1114,JointPQPlayer,230,205,435,22,29,Player A
1115,JointPQPlayer,294,184,478,35,19,Player A
1116,JointPQPlayer,281,186,467,30,21,Player A
1117,JointPQPlayer,266,226,492,37,15,Player A
1118,JointPQPlayer,291,201,492,34,14,Player A
1119,JointPQPlayer,160,255,415,17,34,JointPQPlayer
1120,JointPQPlayer,248,213,461,33,24,Player A
1121,JointPQPlayer,274,204,478,29,17,Player A
1122,JointPQPlayer,306,176,482,36,18,Player A
1123,JointPQPlayer,275,200,475,38,21,Player A
1124,JointPQPlayer,274,219,493,32,13,Player A
1125,JointPQPlayer,149,274,423,10,29,JointPQPlayer
1126,JointPQPlayer,291,191,482,27,15,Player A
1127,JointPQPlayer,129,269,398,12,38,JointPQPlayer
1128,JointPQPlayer,297,162,459,28,23,Player A
1129,JointPQPlayer,293,208,501,40,13,Player A
1130,JointPQPlayer,261,221,482,39,19,Player A
1131,JointPQPlayer,300,185,485,33,16,Player A
1132,JointPQPlayer,225,230,455,18,21,JointPQPlayer
1133,JointPQPlayer,287,207,494,30,12,Player A
1134,JointPQPlayer,278,208,486,40,18,Player A
1135,JointPQPlayer,293,183,476,36,20,Player A
1136,JointPQPlayer,298,168,466,26,20,Player A
1137,JointPQPlayer,269,219,488,36,16,Player A
1138,JointPQPlayer,164,239,403,17,38,JointPQPlayer
1139,JointPQPlayer,177,252,429,19,30,JointPQPlayer
1140,JointPQPlayer,121,271,392,15,41,JointPQPlayer
1141,JointPQPlayer,208,248,456,31,25,JointPQPlayer
1142,JointPQPlayer,277,172,449,21,24,Player A
1143,JointPQPlayer,260,220,480,31,17,Player A
1144,JointPQPlayer,272,212,484,32,16,Player A
1145,JointPQPlayer,136,251,387,13,42,JointPQPlayer
1146,JointPQPlayer,155,260,415,23,36,JointPQPlayer
1147,JointPQPlayer,245,220,465,28,21,Player A
1148,JointPQPlayer,330,185,515,42,9,Player A
1149,JointPQPlayer,312,192,504,43,13,Player A
1150,JointPQPlayer,297,177,474,25,17,Player A
1151,JointPQPlayer,288,193,481,35,18,Player A
1152,JointPQPlayer,295,195,490,32,14,Player A
1153,JointPQPlayer,299,194,493,38,15,Player A
1154,JointPQPlayer,295,195,490,35,15,Player A
1155,JointPQPlayer,310,175,485,33,16,Player A
1156,JointPQPlayer,278,203,481,35,18,Player A
1157,JointPQPlayer,312,187,499,41,14,Player A
1158,JointPQPlayer,276,236,512,39,9,Player A
1159,JointPQPlayer,295,165,460,29,23,Player A
1160,JointPQPlayer,299,174,473,27,18,Player A
1161,JointPQPlayer,248,198,446,27,27,Player A
1162,JointPQPlayer,304,194,498,40,14,Player A
1163,JointPQPlayer,327,167,494,33,13,Player A
1164,JointPQPlayer,142,227,369,7,46,JointPQPlayer
1165,JointPQPlayer,294,189,483,34,17,Player A
1166,JointPQPlayer,305,200,505,41,12,Player A
1167,JointPQPlayer,155,250,405,10,35,JointPQPlayer
1168,JointPQPlayer,155,245,400,17,39,JointPQPlayer
1169,JointPQPlayer,276,201,477,25,16,Player A
1170,JointPQPlayer,293,203,496,38,14,Player A
1171,JointPQPlayer,315,180,495,40,15,Player A
1172,JointPQPlayer,257,207,464,30,22,Player A
1173,JointPQPlayer,298,218,516,37,7,Player A
1174,JointPQPlayer,264,229,493,32,13,Player A
1175,JointPQPlayer,299,189,488,30,14,Player A
1176,JointPQPlayer,290,190,480,34,18,Player A
1177,JointPQPlayer,171,251,422,18,32,JointPQPlayer
1178,JointPQPlayer,307,192,499,38,13,Player A
1179,JointPQPlayer,270,175,445,29,28,Player A
1180,JointPQPlayer,284,199,483,34,17,Player A
1181,JointPQPlayer,156,251,407,18,37,JointPQPlayer
1182,JointPQPlayer,287,187,474,28,18,Player A
1183,JointPQPlayer,302,212,514,38,8,Player A
1184,JointPQPlayer,259,209,468,31,21,Player A
1185,JointPQPlayer,320,165,485,30,15,Player A
1186,JointPQPlayer,301,196,497,33,12,Player A
1187,JointPQPlayer,307,182,489,28,13,Player A
1188,JointPQPlayer,272,212,484,38,18,Player A
1189,JointPQPlayer,297,202,499,38,13,Player A
1190,JointPQPlayer,329,179,508,41,11,Player A
1191,JointPQPlayer,283,173,456,25,23,Player A
1192,JointPQPlayer,294,209,503,42,13,Player A
1193,JointPQPlayer,286,196,482,36,18,Player A
1194,JointPQPlayer,300,200,500,42,14,Player A
1195,JointPQPlayer,112,287,399,13,38,JointPQPlayer
1196,JointPQPlayer,276,191,467,39,24,Player A
1197,JointPQPlayer,315,160,475,32,19,Player A
1198,JointPQPlayer,242,212,454,29,25,Player A
1199,JointPQPlayer,272,217,489,34,15,Player A
1200,JointPQPlayer,147,262,409,17,36,JointPQPlayer
1201,JointPQPlayer,202,242,444,16,24,JointPQPlayer
1202,JointPQPlayer,115,270,385,8,41,JointPQPlayer
1203,JointPQPlayer,294,194,488,39,17,Player A
1204,JointPQPlayer,162,242,404,18,38,JointPQPlayer
1205,JointPQPlayer,156,276,432,16,28,JointPQPlayer
1206,JointPQPlayer,302,187,489,34,15,Player A
1207,JointPQPlayer,340,160,500,33,11,Player A
1208,JointPQPlayer,158,243,401,15,38,JointPQPlayer
1209,JointPQPlayer,148,263,411,13,34,JointPQPlayer
1210,JointPQPlayer,284,184,468,34,22,Player A
1211,JointPQPlayer,285,200,485,30,15,Player A
1212,JointPQPlayer,163,258,421,11,30,JointPQPlayer
1213,JointPQPlayer,279,214,493,41,16,Player A
1214,JointPQPlayer,286,201,487,35,16,Player A
1215,JointPQPlayer,257,232,489,46,19,Player A
1216,JointPQPlayer,337,162,499,41,14,Player A
1217,JointPQPlayer,207,207,414,16,34,Tie
1218,JointPQPlayer,282,207,489,37,16,Player A
1219,JointPQPlayer,271,211,482,33,17,Player A
1220,JointPQPlayer,291,191,482,33,17,Player A
1221,JointPQPlayer,313,183,496,41,15,Player A
1222,JointPQPlayer,279,199,478,32,18,Player A
1223,JointPQPlayer,327,172,499,35,12,Player A
1224,JointPQPlayer,272,187,459,31,24,Player A
1225,JointPQPlayer,276,211,487,35,16,Player A
1226,JointPQPlayer,270,200,470,27,19,Player A
1227,JointPQPlayer,296,196,492,34,14,Player A
1228,JointPQPlayer,307,182,489,37,16,Player A
1229,JointPQPlayer,158,223,381,10,43,JointPQPlayer
1230,JointPQPlayer,276,201,477,28,17,Player A
1231,JointPQPlayer,294,179,473,33,20,Player A
1232,JointPQPlayer,157,247,404,15,37,JointPQPlayer
1233,JointPQPlayer,267,197,464,33,23,Player A
1234,JointPQPlayer,192,272,464,27,21,JointPQPlayer
1235,JointPQPlayer,285,225,510,43,11,Player A
1236,JointPQPlayer,258,203,461,24,21,Player A
1237,JointPQPlayer,299,214,513,37,8,Player A
1238,JointPQPlayer,303,198,501,34,11,Player A
1239,JointPQPlayer,253,218,471,31,20,Player A
1240,JointPQPlayer,311,181,492,37,15,Player A
1241,JointPQPlayer,282,192,474,37,21,Player A
1242,JointPQPlayer,153,263,416,15,33,JointPQPlayer
1243,JointPQPlayer,301,201,502,32,10,Player A
1244,JointPQPlayer,139,274,413,15,34,JointPQPlayer
1245,JointPQPlayer,298,168,466,35,23,Player A
1246,JointPQPlayer,245,200,445,20,25,Player A
1247,JointPQPlayer,179,229,408,16,36,JointPQPlayer
1248,JointPQPlayer,273,213,486,28,14,Player A
1249,JointPQPlayer,288,203,491,33,14,Player A
1250,JointPQPlayer,296,221,517,41,8,Player A
1251,JointPQPlayer,231,216,447,31,28,Player A
1252,JointPQPlayer,254,199,453,25,24,Player A
1253,JointPQPlayer,256,226,482,33,17,Player A
1254,JointPQPlayer,297,187,484,35,17,Player A
1255,JointPQPlayer,172,227,399,10,37,JointPQPlayer
1256,JointPQPlayer,159,259,418,14,32,JointPQPlayer
1257,JointPQPlayer,239,224,463,35,24,Player A
1258,JointPQPlayer,319,189,508,38,10,Player A
1259,JointPQPlayer,178,248,426,16,30,JointPQPlayer
1260,JointPQPlayer,296,176,472,29,19,Player A
1261,JointPQPlayer,188,228,416,15,33,JointPQPlayer
1262,JointPQPlayer,300,185,485,30,15,Player A
1263,JointPQPlayer,270,205,475,35,20,Player A
1264,JointPQPlayer,323,173,496,35,13,Player A
1265,JointPQPlayer,296,191,487,35,16,Player A
1266,JointPQPlayer,305,190,495,40,15,Player A
1267,JointPQPlayer,265,200,465,28,21,Player A
1268,JointPQPlayer,290,200,490,35,15,Player A
1269,JointPQPlayer,126,281,407,12,35,JointPQPlayer
1270,JointPQPlayer,302,182,484,35,17,Player A
1271,JointPQPlayer,295,185,480,31,17,Player A
1272,JointPQPlayer,268,218,486,37,17,Player A
1273,JointPQPlayer,273,213,486,43,19,Player A
1274,JointPQPlayer,284,214,498,43,15,Player A
1275,JointPQPlayer,296,191,487,32,15,Player A
1276,JointPQPlayer,155,240,395,18,41,JointPQPlayer
1277,JointPQPlayer,305,175,480,34,18,Player A
1278,JointPQPlayer,315,170,485,30,15,Player A
1279,JointPQPlayer,266,221,487,35,16,Player A
1280,JointPQPlayer,264,199,463,35,24,Player A
1281,JointPQPlayer,308,188,496,32,12,Player A
1282,JointPQPlayer,264,209,473,36,21,Player A
1283,JointPQPlayer,211,236,447,19,24,JointPQPlayer
1284,JointPQPlayer,300,180,480,34,18,Player A
1285,JointPQPlayer,279,214,493,41,16,Player A
1286,JointPQPlayer,280,200,480,34,18,Player A
1287,JointPQPlayer,313,188,501,40,13,Player A
1288,JointPQPlayer,276,221,497,30,11,Player A
1289,JointPQPlayer,285,210,495,37,14,Player A
1290,JointPQPlayer,299,169,468,31,21,Player A
1291,JointPQPlayer,133,278,411,13,34,JointPQPlayer
1292,JointPQPlayer,276,196,472,32,20,Player A
1293,JointPQPlayer,267,207,474,31,19,Player A
1294,JointPQPlayer,282,222,504,37,11,Player A
1295,JointPQPlayer,277,192,469,32,21,Player A
1296,JointPQPlayer,293,198,491,36,15,Player A
1297,JointPQPlayer,292,187,479,39,20,Player A
1298,JointPQPlayer,289,184,473,33,20,Player A
1299,JointPQPlayer,275,225,500,36,12,Player A
1300,JointPQPlayer,156,271,427,14,29,JointPQPlayer
1301,JointPQPlayer,267,182,449,33,28,Player A
1302,JointPQPlayer,151,241,392,18,42,JointPQPlayer
1303,JointPQPlayer,256,206,462,37,25,Player A
1304,JointPQPlayer,270,200,470,27,19,Player A
1305,JointPQPlayer,295,205,500,39,13,Player A
1306,JointPQPlayer,300,185,485,36,17,Player A
1307,JointPQPlayer,269,199,468,31,21,Player A
1308,JointPQPlayer,168,238,406,17,37,JointPQPlayer
1309,JointPQPlayer,300,200,500,36,12,Player A
1310,JointPQPlayer,308,193,501,34,11,Player A
1311,JointPQPlayer,273,193,466,29,21,Player A
1312,JointPQPlayer,304,194,498,37,13,Player A
1313,JointPQPlayer,143,263,406,17,37,JointPQPlayer
1314,JointPQPlayer,270,215,485,33,16,Player A
1315,JointPQPlayer,146,281,427,20,31,JointPQPlayer
1316,JointPQPlayer,122,257,379,5,42,JointPQPlayer
1317,JointPQPlayer,262,207,469,35,22,Player A
1318,JointPQPlayer,287,212,499,35,12,Player A
1319,JointPQPlayer,298,203,501,40,13,Player A
1320,JointPQPlayer,264,209,473,30,19,Player A
1321,JointPQPlayer,301,171,472,26,18,Player A
1322,JointPQPlayer,307,142,449,27,26,Player A
1323,JointPQPlayer,329,184,513,40,9,Player A
1324,JointPQPlayer,276,211,487,38,17,Player A
1325,JointPQPlayer,137,277,414,16,34,JointPQPlayer
1326,JointPQPlayer,301,196,497,36,13,Player A
1327,JointPQPlayer,146,226,372,10,46,JointPQPlayer
1328,JointPQPlayer,273,208,481,35,18,Player A
1329,JointPQPlayer,238,223,461,30,23,Player A
1330,JointPQPlayer,300,215,515,42,9,Player A
1331,JointPQPlayer,311,191,502,38,12,Player A
1332,JointPQPlayer,131,256,387,10,41,JointPQPlayer
1333,JointPQPlayer,266,201,467,36,23,Player A
1334,JointPQPlayer,310,200,510,40,10,Player A
1335,JointPQPlayer,297,187,484,32,16,Player A
1336,JointPQPlayer,311,176,487,35,16,Player A
1337,JointPQPlayer,315,165,480,31,17,Player A
1338,JointPQPlayer,292,187,479,39,20,Player A
1339,JointPQPlayer,273,203,476,33,19,Player A
1340,JointPQPlayer,291,191,482,45,21,Player A
1341,JointPQPlayer,142,252,394,11,39,JointPQPlayer
1342,JointPQPlayer,305,185,490,32,14,Player A
1343,JointPQPlayer,252,217,469,29,20,Player A
1344,JointPQPlayer,274,199,473,27,18,Player A
1345,JointPQPlayer,318,183,501,37,12,Player A
1346,JointPQPlayer,292,192,484,29,15,Player A
1347,JointPQPlayer,262,232,494,45,17,Player A
1348,JointPQPlayer,297,192,489,31,14,Player A
1349,JointPQPlayer,336,171,507,37,10,Player A
1350,JointPQPlayer,238,218,456,25,23,Player A
1351,JointPQPlayer,324,169,493,32,13,Player A
1352,JointPQPlayer,334,189,523,44,7,Player A
1353,JointPQPlayer,141,281,422,12,30,JointPQPlayer
1354,JointPQPlayer,287,187,474,34,20,Player A
1355,JointPQPlayer,261,236,497,36,13,Player A
1356,JointPQPlayer,270,225,495,40,15,Player A
1357,JointPQPlayer,302,177,479,33,18,Player A
1358,JointPQPlayer,222,212,434,24,30,Player A
1359,JointPQPlayer,307,187,494,30,12,Player A
1360,JointPQPlayer,292,212,504,49,15,Player A
1361,JointPQPlayer,297,182,479,33,18,Player A
1362,JointPQPlayer,292,207,499,44,15,Player A
1363,JointPQPlayer,304,184,488,39,17,Player A
1364,JointPQPlayer,291,176,467,30,21,Player A
1365,JointPQPlayer,284,199,483,40,19,Player A
1366,JointPQPlayer,277,227,504,43,13,Player A
1367,JointPQPlayer,239,234,473,27,18,Player A
1368,JointPQPlayer,295,170,465,34,23,Player A
1369,JointPQPlayer,276,181,457,29,24,Player A
1370,JointPQPlayer,280,205,485,33,16,Player A
1371,JointPQPlayer,274,199,473,33,20,Player A
1372,JointPQPlayer,298,188,486,34,16,Player A
1373,JointPQPlayer,243,218,461,30,23,Player A
1374,JointPQPlayer,310,180,490,35,15,Player A
1375,JointPQPlayer,316,171,487,26,13,Player A
1376,JointPQPlayer,138,288,426,13,29,JointPQPlayer
1377,JointPQPlayer,215,230,445,29,28,JointPQPlayer
1378,JointPQPlayer,313,193,506,42,12,Player A
1379,JointPQPlayer,140,250,390,13,41,JointPQPlayer
1380,JointPQPlayer,245,220,465,34,23,Player A
1381,JointPQPlayer,290,220,510,37,9,Player A
1382,JointPQPlayer,297,182,479,30,17,Player A
1383,JointPQPlayer,146,246,392,12,40,JointPQPlayer
1384,JointPQPlayer,306,201,507,37,10,Player A
1385,JointPQPlayer,128,303,431,15,28,JointPQPlayer
1386,JointPQPlayer,159,244,403,8,35,JointPQPlayer
1387,JointPQPlayer,152,237,389,9,40,JointPQPlayer
1388,JointPQPlayer,308,188,496,38,14,Player A
1389,JointPQPlayer,258,223,481,35,18,Player A
1390,JointPQPlayer,144,299,443,21,26,JointPQPlayer
1391,JointPQPlayer,322,187,509,39,10,Player A
1392,JointPQPlayer,230,215,445,26,27,Player A
1393,JointPQPlayer,261,231,492,40,16,Player A
1394,JointPQPlayer,140,270,410,15,35,JointPQPlayer
1395,JointPQPlayer,123,283,406,8,34,JointPQPlayer
1396,JointPQPlayer,160,225,385,8,41,JointPQPlayer
1397,JointPQPlayer,298,183,481,35,18,Player A
1398,JointPQPlayer,205,235,440,24,28,JointPQPlayer
1399,JointPQPlayer,246,231,477,34,19,Player A
1400,JointPQPlayer,258,223,481,44,21,Player A
1401,JointPQPlayer,302,187,489,28,13,Player A
1402,JointPQPlayer,302,192,494,33,13,Player A
1403,JointPQPlayer,279,204,483,31,16,Player A
1404,JointPQPlayer,292,187,479,30,17,Player A
1405,JointPQPlayer,180,230,410,21,37,JointPQPlayer
1406,JointPQPlayer,270,195,465,28,21,Player A
1407,JointPQPlayer,281,201,482,30,16,Player A
1408,JointPQPlayer,280,200,480,31,17,Player A
1409,JointPQPlayer,276,221,497,39,14,Player A
1410,JointPQPlayer,284,229,513,43,10,Player A
1411,JointPQPlayer,304,174,478,35,19,Player A
1412,JointPQPlayer,138,263,401,12,37,JointPQPlayer
1413,JointPQPlayer,279,214,493,35,14,Player A
1414,JointPQPlayer,223,223,446,21,25,Tie
1415,JointPQPlayer,296,206,502,38,12,Player A
1416,JointPQPlayer,255,235,490,35,15,Player A
1417,JointPQPlayer,150,255,405,16,37,JointPQPlayer
1418,JointPQPlayer,315,190,505,29,8,Player A
1419,JointPQPlayer,262,227,489,34,15,Player A
1420,JointPQPlayer,308,178,486,40,18,Player A
1421,JointPQPlayer,288,208,496,38,14,Player A
1422,JointPQPlayer,304,189,493,35,14,Player A
1423,JointPQPlayer,137,267,404,12,36,JointPQPlayer
1424,JointPQPlayer,303,193,496,35,13,Player A
1425,JointPQPlayer,309,184,493,29,12,Player A
1426,JointPQPlayer,274,214,488,39,17,Player A
1427,JointPQPlayer,139,259,398,6,36,JointPQPlayer
1428,JointPQPlayer,214,229,443,24,27,JointPQPlayer
1429,JointPQPlayer,267,197,464,27,21,Player A
1430,JointPQPlayer,280,185,465,28,21,Player A
1431,JointPQPlayer,234,204,438,19,27,Player A
1432,JointPQPlayer,260,205,465,31,22,Player A
1433,JointPQPlayer,310,185,495,34,13,Player A
1434,JointPQPlayer,247,227,474,37,21,Player A
1435,JointPQPlayer,291,216,507,43,12,Player A
1436,JointPQPlayer,282,202,484,38,18,Player A
1437,JointPQPlayer,262,202,464,24,20,Player A
1438,JointPQPlayer,299,189,488,30,14,Player A
1439,JointPQPlayer,230,185,415,20,35,Player A
1440,JointPQPlayer,148,283,431,18,29,JointPQPlayer
1441,JointPQPlayer,291,206,497,39,14,Player A
1442,JointPQPlayer,139,269,408,16,36,JointPQPlayer
1443,JointPQPlayer,143,243,386,15,43,JointPQPlayer
1444,JointPQPlayer,220,240,460,26,22,JointPQPlayer
1445,JointPQPlayer,315,180,495,31,12,Player A
1446,JointPQPlayer,242,212,454,29,25,Player A
1447,JointPQPlayer,223,228,451,20,23,JointPQPlayer
1448,JointPQPlayer,127,287,414,10,32,JointPQPlayer
1449,JointPQPlayer,170,250,420,22,34,JointPQPlayer
1450,JointPQPlayer,318,188,506,33,9,Player A
1451,JointPQPlayer,184,229,413,18,35,JointPQPlayer
1452,JointPQPlayer,246,226,472,29,19,Player A
1453,JointPQPlayer,269,209,478,35,19,Player A
1454,JointPQPlayer,158,273,431,18,29,JointPQPlayer
1455,JointPQPlayer,268,218,486,37,17,Player A
1456,JointPQPlayer,275,215,490,35,15,Player A
1457,JointPQPlayer,276,201,477,37,20,Player A
1458,JointPQPlayer,281,221,502,41,13,Player A
1459,JointPQPlayer,287,207,494,33,13,Player A
1460,JointPQPlayer,300,205,505,38,11,Player A
1461,JointPQPlayer,288,208,496,41,15,Player A
1462,JointPQPlayer,295,175,470,30,20,Player A
1463,JointPQPlayer,284,209,493,38,15,Player A
1464,JointPQPlayer,239,214,453,28,25,Player A
1465,JointPQPlayer,320,160,480,34,18,Player A
1466,JointPQPlayer,262,207,469,32,21,Player A
1467,JointPQPlayer,299,219,518,39,7,Player A
1468,JointPQPlayer,302,207,509,39,10,Player A
1469,JointPQPlayer,125,280,405,13,36,JointPQPlayer
1470,JointPQPlayer,161,256,417,13,32,JointPQPlayer
1471,JointPQPlayer,251,231,482,27,15,Player A
1472,JointPQPlayer,296,216,512,39,9,Player A
1473,JointPQPlayer,278,203,481,32,17,Player A
1474,JointPQPlayer,319,164,483,34,17,Player A
1475,JointPQPlayer,303,183,486,34,16,Player A
1476,JointPQPlayer,281,211,492,34,14,Player A
1477,JointPQPlayer,288,203,491,30,13,Player A
1478,JointPQPlayer,275,210,485,30,15,Player A
1479,JointPQPlayer,321,171,492,37,15,Player A
1480,JointPQPlayer,331,161,492,34,14,Player A
1481,JointPQPlayer,257,237,494,39,15,Player A
1482,JointPQPlayer,288,203,491,36,15,Player A
1483,JointPQPlayer,157,252,409,14,35,JointPQPlayer
1484,JointPQPlayer,292,197,489,40,17,Player A
1485,JointPQPlayer,180,240,420,19,33,JointPQPlayer
1486,JointPQPlayer,280,195,475,35,20,Player A
1487,JointPQPlayer,276,191,467,33,22,Player A
1488,JointPQPlayer,149,264,413,18,35,JointPQPlayer
1489,JointPQPlayer,268,193,461,36,25,Player A
1490,JointPQPlayer,295,205,500,30,10,Player A
1491,JointPQPlayer,309,179,488,33,15,Player A
1492,JointPQPlayer,322,172,494,36,14,Player A
1493,JointPQPlayer,278,213,491,36,15,Player A
1494,JointPQPlayer,272,202,474,28,18,Player A
1495,JointPQPlayer,154,274,428,18,30,JointPQPlayer
1496,JointPQPlayer,165,265,430,20,30,JointPQPlayer
1497,JointPQPlayer,323,173,496,38,14,Player A
1498,JointPQPlayer,261,236,497,33,12,Player A
1499,JointPQPlayer,188,223,411,19,36,JointPQPlayer
1500,JointPQPlayer,313,178,491,33,14,Player A
1501,JointPQPlayer,314,174,488,33,15,Player A
1502,JointPQPlayer,293,208,501,28,9,Player A
1503,JointPQPlayer,310,180,490,32,14,Player A
1504,JointPQPlayer,282,202,484,35,17,Player A
1505,JointPQPlayer,143,243,386,12,42,JointPQPlayer
1506,JointPQPlayer,161,236,397,14,39,JointPQPlayer
1507,JointPQPlayer,311,186,497,30,11,Player A
1508,JointPQPlayer,215,250,465,25,20,JointPQPlayer
1509,JointPQPlayer,310,195,505,41,12,Player A
1510,JointPQPlayer,162,257,419,18,33,JointPQPlayer
1511,JointPQPlayer,299,204,503,42,13,Player A
1512,JointPQPlayer,309,194,503,36,11,Player A
1513,JointPQPlayer,316,181,497,42,15,Player A
1514,JointPQPlayer,335,170,505,32,9,Player A
1515,JointPQPlayer,149,244,393,13,40,JointPQPlayer
1516,JointPQPlayer,282,212,494,33,13,Player A
1517,JointPQPlayer,301,196,497,39,14,Player A
1518,JointPQPlayer,254,224,478,32,18,Player A
1519,JointPQPlayer,151,246,397,17,40,JointPQPlayer
1520,JointPQPlayer,306,191,497,36,13,Player A
1521,JointPQPlayer,180,230,410,12,34,JointPQPlayer
1522,JointPQPlayer,301,211,512,42,10,Player A
1523,JointPQPlayer,247,217,464,27,21,Player A
1524,JointPQPlayer,205,245,450,22,24,JointPQPlayer
1525,JointPQPlayer,308,178,486,31,15,Player A
1526,JointPQPlayer,278,213,491,39,16,Player A
1527,JointPQPlayer,270,215,485,39,18,Player A
1528,JointPQPlayer,302,177,479,36,19,Player A
1529,JointPQPlayer,279,199,478,35,19,Player A
1530,JointPQPlayer,294,224,518,42,8,Player A
1531,JointPQPlayer,177,267,444,25,27,JointPQPlayer
1532,JointPQPlayer,213,203,416,15,33,Player A
1533,JointPQPlayer,169,234,403,14,37,JointPQPlayer
1534,JointPQPlayer,177,242,419,15,32,JointPQPlayer
1535,JointPQPlayer,150,235,385,11,42,JointPQPlayer
1536,JointPQPlayer,266,186,452,30,26,Player A
1537,JointPQPlayer,278,208,486,34,16,Player A
1538,JointPQPlayer,282,217,499,38,13,Player A
1539,JointPQPlayer,161,281,442,20,26,JointPQPlayer
1540,JointPQPlayer,153,243,396,10,38,JointPQPlayer
1541,JointPQPlayer,217,227,444,28,28,JointPQPlayer
1542,JointPQPlayer,152,272,424,17,31,JointPQPlayer
1543,JointPQPlayer,300,185,485,33,16,Player A
1544,JointPQPlayer,272,207,479,33,18,Player A
1545,JointPQPlayer,164,264,428,18,30,JointPQPlayer
1546,JointPQPlayer,150,260,410,15,35,JointPQPlayer
1547,JointPQPlayer,319,154,473,30,19,Player A
1548,JointPQPlayer,269,189,458,24,22,Player A
1549,JointPQPlayer,315,200,515,39,8,Player A
1550,JointPQPlayer,195,220,415,23,36,JointPQPlayer
1551,JointPQPlayer,243,233,476,27,17,Player A
1552,JointPQPlayer,159,219,378,16,46,JointPQPlayer
1553,JointPQPlayer,303,188,491,33,14,Player A
1554,JointPQPlayer,305,195,500,33,11,Player A
1555,JointPQPlayer,262,197,459,28,23,Player A
1556,JointPQPlayer,314,189,503,36,11,Player A
1557,JointPQPlayer,222,262,484,32,16,JointPQPlayer
1558,JointPQPlayer,275,205,480,31,17,Player A
1559,JointPQPlayer,320,200,520,41,7,Player A
1560,JointPQPlayer,136,256,392,18,42,JointPQPlayer
1561,JointPQPlayer,301,191,492,31,13,Player A
1562,JointPQPlayer,130,230,360,10,50,JointPQPlayer
1563,JointPQPlayer,119,294,413,12,33,JointPQPlayer
1564,JointPQPlayer,300,195,495,46,17,Player A
1565,JointPQPlayer,306,196,502,35,11,Player A
1566,JointPQPlayer,142,272,414,13,33,JointPQPlayer
1567,JointPQPlayer,306,191,497,39,14,Player A
1568,JointPQPlayer,153,238,391,11,40,JointPQPlayer
1569,JointPQPlayer,138,283,421,14,31,JointPQPlayer
1570,JointPQPlayer,319,184,503,42,13,Player A
1571,JointPQPlayer,285,190,475,29,18,Player A
1572,JointPQPlayer,297,177,474,34,20,Player A
1573,JointPQPlayer,290,190,480,28,16,Player A
1574,JointPQPlayer,289,209,498,43,15,Player A
1575,JointPQPlayer,287,207,494,42,16,Player A
1576,JointPQPlayer,136,306,442,17,25,JointPQPlayer
1577,JointPQPlayer,265,230,495,34,13,Player A
1578,JointPQPlayer,305,170,475,35,20,Player A
1579,JointPQPlayer,167,247,414,13,33,JointPQPlayer
1580,JointPQPlayer,287,187,474,28,18,Player A
1581,JointPQPlayer,306,201,507,40,11,Player A
1582,JointPQPlayer,297,192,489,34,15,Player A
1583,JointPQPlayer,304,184,488,39,17,Player A
1584,JointPQPlayer,252,232,484,38,18,Player A
1585,JointPQPlayer,285,185,470,27,19,Player A
1586,JointPQPlayer,150,270,420,13,31,JointPQPlayer
1587,JointPQPlayer,304,194,498,34,12,Player A
1588,JointPQPlayer,289,174,463,23,20,Player A
1589,JointPQPlayer,304,204,508,38,10,Player A
1590,JointPQPlayer,299,194,493,41,16,Player A
1591,JointPQPlayer,284,189,473,27,18,Player A
1592,JointPQPlayer,131,276,407,12,35,JointPQPlayer
1593,JointPQPlayer,295,210,505,38,11,Player A
1594,JointPQPlayer,293,188,481,35,18,Player A
1595,JointPQPlayer,308,193,501,40,13,Player A
1596,JointPQPlayer,286,186,472,26,18,Player A
1597,JointPQPlayer,229,224,453,28,25,Player A
1598,JointPQPlayer,302,177,479,33,18,Player A
1599,JointPQPlayer,277,192,469,29,20,Player A
1600,JointPQPlayer,273,223,496,44,16,Player A
1601,JointPQPlayer,301,171,472,32,20,Player A
1602,JointPQPlayer,258,223,481,29,16,Player A
1603,JointPQPlayer,291,186,477,31,18,Player A
1604,JointPQPlayer,150,280,430,17,29,JointPQPlayer
1605,JointPQPlayer,248,228,476,33,19,Player A
1606,JointPQPlayer,120,295,415,14,33,JointPQPlayer
1607,JointPQPlayer,152,287,439,14,25,JointPQPlayer
1608,JointPQPlayer,144,254,398,12,38,JointPQPlayer
1609,JointPQPlayer,222,212,434,21,29,Player A
1610,JointPQPlayer,290,175,465,31,22,Player A
1611,JointPQPlayer,248,228,476,33,19,Player A
1612,JointPQPlayer,266,196,462,31,23,Player A
1613,JointPQPlayer,290,215,505,41,12,Player A
1614,JointPQPlayer,125,290,415,11,32,JointPQPlayer
1615,JointPQPlayer,240,240,480,31,17,Tie
1616,JointPQPlayer,128,273,401,12,37,JointPQPlayer
1617,JointPQPlayer,283,198,481,29,16,Player A
1618,JointPQPlayer,152,277,429,13,28,JointPQPlayer
1619,JointPQPlayer,315,185,500,36,12,Player A
1620,JointPQPlayer,302,187,489,31,14,Player A
1621,JointPQPlayer,299,189,488,30,14,Player A
1622,JointPQPlayer,172,257,429,19,30,JointPQPlayer
1623,JointPQPlayer,281,221,502,41,13,Player A
1624,JointPQPlayer,305,200,505,41,12,Player A
1625,JointPQPlayer,187,227,414,16,34,JointPQPlayer
1626,JointPQPlayer,301,201,502,38,12,Player A
1627,JointPQPlayer,290,205,495,40,15,Player A
1628,JointPQPlayer,286,176,462,31,23,Player A
1629,JointPQPlayer,303,183,486,37,17,Player A
1630,JointPQPlayer,213,253,466,23,19,JointPQPlayer
1631,JointPQPlayer,302,197,499,38,13,Player A
1632,JointPQPlayer,295,190,485,30,15,Player A
1633,JointPQPlayer,300,170,470,27,19,Player A
1634,JointPQPlayer,312,197,509,30,7,Player A
1635,JointPQPlayer,172,222,394,17,41,JointPQPlayer
1636,JointPQPlayer,305,210,515,39,8,Player A
1637,JointPQPlayer,281,201,482,30,16,Player A
1638,JointPQPlayer,288,188,476,30,18,Player A
1639,JointPQPlayer,318,178,496,35,13,Player A
1640,JointPQPlayer,289,194,483,37,18,Player A
1641,JointPQPlayer,326,161,487,32,15,Player A
1642,JointPQPlayer,315,185,500,33,11,Player A
1643,JointPQPlayer,318,173,491,33,14,Player A
1644,JointPQPlayer,160,290,450,22,24,JointPQPlayer
1645,JointPQPlayer,296,196,492,31,13,Player A
1646,JointPQPlayer,323,178,501,34,11,Player A
1647,JointPQPlayer,272,212,484,38,18,Player A
1648,JointPQPlayer,267,212,479,36,19,Player A
1649,JointPQPlayer,271,206,477,31,18,Player A
1650,JointPQPlayer,259,204,463,35,24,Player A
1651,JointPQPlayer,310,195,505,38,11,Player A
1652,JointPQPlayer,160,275,435,22,29,JointPQPlayer
1653,JointPQPlayer,148,258,406,14,36,JointPQPlayer
1654,JointPQPlayer,274,219,493,41,16,Player A
1655,JointPQPlayer,330,170,500,30,10,Player A
1656,JointPQPlayer,159,234,393,13,40,JointPQPlayer
1657,JointPQPlayer,291,221,512,39,9,Player A
1658,JointPQPlayer,281,221,502,38,12,Player A
1659,JointPQPlayer,293,213,506,39,11,Player A
1660,JointPQPlayer,289,194,483,34,17,Player A
1661,JointPQPlayer,133,263,396,10,38,JointPQPlayer
1662,JointPQPlayer,294,174,468,34,22,Player A
1663,JointPQPlayer,168,248,416,18,34,JointPQPlayer
1664,JointPQPlayer,304,179,483,34,17,Player A
1665,JointPQPlayer,279,224,503,39,12,Player A
1666,JointPQPlayer,277,197,474,34,20,Player A
1667,JointPQPlayer,178,223,401,15,38,JointPQPlayer
1668,JointPQPlayer,293,208,501,46,15,Player A
1669,JointPQPlayer,274,199,473,33,20,Player A
1670,JointPQPlayer,257,217,474,34,20,Player A
1671,JointPQPlayer,287,212,499,44,15,Player A
1672,JointPQPlayer,245,210,455,27,24,Player A
1673,JointPQPlayer,247,222,469,26,19,Player A
1674,JointPQPlayer,283,193,476,30,18,Player A
1675,JointPQPlayer,283,198,481,32,17,Player A
1676,JointPQPlayer,265,190,455,27,24,Player A
1677,JointPQPlayer,261,226,487,41,18,Player A
1678,JointPQPlayer,270,210,480,34,18,Player A
1679,JointPQPlayer,285,200,485,33,16,Player A
1680,JointPQPlayer,311,196,507,43,12,Player A
1681,JointPQPlayer,275,210,485,27,14,Player A
1682,JointPQPlayer,293,213,506,36,10,Player A
1683,JointPQPlayer,275,200,475,38,21,Player A
1684,JointPQPlayer,294,184,478,29,17,Player A
1685,JointPQPlayer,300,175,475,35,20,Player A
1686,JointPQPlayer,309,189,498,34,12,Player A
1687,JointPQPlayer,302,192,494,27,11,Player A
1688,JointPQPlayer,298,193,491,30,13,Player A
1689,JointPQPlayer,295,200,495,34,13,Player A
1690,JointPQPlayer,292,192,484,29,15,Player A
1691,JointPQPlayer,304,174,478,29,17,Player A
1692,JointPQPlayer,303,198,501,34,11,Player A
1693,JointPQPlayer,324,184,508,35,9,Player A
1694,JointPQPlayer,302,172,474,28,18,Player A
1695,JointPQPlayer,300,190,490,35,15,Player A
1696,JointPQPlayer,313,193,506,36,10,Player A
1697,JointPQPlayer,334,154,488,33,15,Player A
1698,JointPQPlayer,142,262,404,15,37,JointPQPlayer
1699,JointPQPlayer,256,236,492,37,15,Player A
1700,JointPQPlayer,299,199,498,40,14,Player A
1701,JointPQPlayer,151,226,377,9,44,JointPQPlayer
1702,JointPQPlayer,150,265,415,14,33,JointPQPlayer
1703,JointPQPlayer,242,212,454,23,23,Player A
1704,JointPQPlayer,276,201,477,28,17,Player A
1705,JointPQPlayer,314,174,488,30,14,Player A
1706,JointPQPlayer,296,201,497,39,14,Player A
1707,JointPQPlayer,145,270,415,17,34,JointPQPlayer
1708,JointPQPlayer,294,204,498,34,12,Player A
1709,JointPQPlayer,274,204,478,29,17,Player A
1710,JointPQPlayer,137,252,389,9,40,JointPQPlayer
1711,JointPQPlayer,251,251,502,44,14,Tie
1712,JointPQPlayer,253,238,491,39,16,Player A
1713,JointPQPlayer,190,235,425,12,29,JointPQPlayer
1714,JointPQPlayer,271,196,467,27,20,Player A
1715,JointPQPlayer,308,168,476,30,18,Player A
1716,JointPQPlayer,277,207,484,32,16,Player A
1717,JointPQPlayer,273,208,481,32,17,Player A
1718,JointPQPlayer,265,205,470,27,19,Player A
1719,JointPQPlayer,289,204,493,35,14,Player A
1720,JointPQPlayer,216,236,452,21,23,JointPQPlayer
1721,JointPQPlayer,288,198,486,34,16,Player A
1722,JointPQPlayer,310,190,500,36,12,Player A
1723,JointPQPlayer,300,195,495,37,14,Player A
1724,JointPQPlayer,298,203,501,37,12,Player A
1725,JointPQPlayer,276,211,487,38,17,Player A
1726,JointPQPlayer,228,238,466,35,23,JointPQPlayer
1727,JointPQPlayer,254,219,473,33,20,Player A
1728,JointPQPlayer,164,249,413,15,34,JointPQPlayer
1729,JointPQPlayer,277,177,454,29,25,Player A
1730,JointPQPlayer,329,159,488,33,15,Player A
1731,JointPQPlayer,308,193,501,40,13,Player A
1732,JointPQPlayer,233,243,476,30,18,JointPQPlayer
1733,JointPQPlayer,287,197,484,32,16,Player A
1734,JointPQPlayer,211,226,437,15,26,JointPQPlayer
1735,JointPQPlayer,179,259,438,16,26,JointPQPlayer
1736,JointPQPlayer,150,280,430,17,29,JointPQPlayer
1737,JointPQPlayer,305,185,490,35,15,Player A
1738,JointPQPlayer,324,194,518,39,7,Player A
1739,JointPQPlayer,316,186,502,44,14,Player A
1740,JointPQPlayer,296,211,507,37,10,Player A
1741,JointPQPlayer,164,234,398,15,39,JointPQPlayer
1742,JointPQPlayer,316,171,487,29,14,Player A
1743,JointPQPlayer,290,190,480,31,17,Player A
1744,JointPQPlayer,294,189,483,31,16,Player A
1745,JointPQPlayer,284,184,468,28,20,Player A
1746,JointPQPlayer,146,286,432,16,28,JointPQPlayer
1747,JointPQPlayer,291,216,507,46,13,Player A
1748,JointPQPlayer,306,176,482,42,20,Player A
1749,JointPQPlayer,311,191,502,38,12,Player A
1750,JointPQPlayer,306,171,477,31,18,Player A
1751,JointPQPlayer,251,206,457,29,24,Player A
1752,JointPQPlayer,312,192,504,40,12,Player A
1753,JointPQPlayer,299,214,513,40,9,Player A
1754,JointPQPlayer,307,167,474,34,20,Player A
1755,JointPQPlayer,193,243,436,17,27,JointPQPlayer
1756,JointPQPlayer,250,235,485,27,14,Player A
1757,JointPQPlayer,172,252,424,20,32,JointPQPlayer
1758,JointPQPlayer,296,186,482,30,16,Player A
1759,JointPQPlayer,130,300,430,14,28,JointPQPlayer
1760,JointPQPlayer,142,252,394,14,40,JointPQPlayer
1761,JointPQPlayer,303,183,486,40,18,Player A
1762,JointPQPlayer,304,174,478,35,19,Player A
1763,JointPQPlayer,316,166,482,33,17,Player A
1764,JointPQPlayer,296,206,502,38,12,Player A
1765,JointPQPlayer,285,205,490,38,16,Player A
1766,JointPQPlayer,314,179,493,38,15,Player A
1767,JointPQPlayer,317,182,499,41,14,Player A
1768,JointPQPlayer,292,192,484,35,17,Player A
1769,JointPQPlayer,157,252,409,11,34,JointPQPlayer
1770,JointPQPlayer,174,244,418,14,32,JointPQPlayer
1771,JointPQPlayer,173,243,416,12,32,JointPQPlayer
1772,JointPQPlayer,300,210,510,40,10,Player A
1773,JointPQPlayer,230,215,445,20,25,Player A
1774,JointPQPlayer,157,262,419,18,33,JointPQPlayer
1775,JointPQPlayer,156,256,412,20,36,JointPQPlayer
1776,JointPQPlayer,313,198,511,41,10,Player A
1777,JointPQPlayer,292,212,504,31,9,Player A
1778,JointPQPlayer,335,170,505,32,9,Player A
1779,JointPQPlayer,298,198,496,35,13,Player A
1780,JointPQPlayer,277,222,499,38,13,Player A
1781,JointPQPlayer,148,273,421,14,31,JointPQPlayer
1782,JointPQPlayer,295,175,470,33,21,Player A
1783,JointPQPlayer,292,182,474,31,19,Player A
1784,JointPQPlayer,255,210,465,31,22,Player A
1785,JointPQPlayer,289,214,503,39,12,Player A
1786,JointPQPlayer,165,235,400,14,38,JointPQPlayer
1787,JointPQPlayer,306,166,472,32,20,Player A
1788,JointPQPlayer,122,272,394,11,39,JointPQPlayer
1789,JointPQPlayer,277,192,469,26,19,Player A
1790,JointPQPlayer,325,155,480,34,18,Player A
1791,JointPQPlayer,305,210,515,39,8,Player A
1792,JointPQPlayer,185,215,400,14,38,JointPQPlayer
1793,JointPQPlayer,259,204,463,29,22,Player A
1794,JointPQPlayer,283,213,496,38,14,Player A
1795,JointPQPlayer,307,167,474,34,20,Player A
1796,JointPQPlayer,154,269,423,19,32,JointPQPlayer
1797,JointPQPlayer,245,235,480,31,17,Player A
1798,JointPQPlayer,147,277,424,17,31,JointPQPlayer
1799,JointPQPlayer,308,188,496,32,12,Player A
1800,JointPQPlayer,253,228,481,38,19,Player A
1801,JointPQPlayer,332,182,514,44,10,Player A
1802,JointPQPlayer,282,187,469,35,22,Player A
1803,JointPQPlayer,280,210,490,35,15,Player A
1804,JointPQPlayer,267,187,454,26,24,Player A
1805,JointPQPlayer,268,193,461,27,22,Player A
1806,JointPQPlayer,279,204,483,37,18,Player A
1807,JointPQPlayer,218,248,466,29,21,JointPQPlayer
1808,JointPQPlayer,273,213,486,40,18,Player A
1809,JointPQPlayer,326,166,492,25,11,Player A
1810,JointPQPlayer,302,167,469,26,19,Player A
1811,JointPQPlayer,284,169,453,28,25,Player A
1812,JointPQPlayer,282,187,469,29,20,Player A
1813,JointPQPlayer,162,242,404,9,35,JointPQPlayer
1814,JointPQPlayer,294,179,473,30,19,Player A
1815,JointPQPlayer,298,178,476,27,17,Player A
1816,JointPQPlayer,336,171,507,37,10,Player A
1817,JointPQPlayer,282,187,469,35,22,Player A
1818,JointPQPlayer,275,190,465,31,22,Player A
1819,JointPQPlayer,282,192,474,34,20,Player A
1820,JointPQPlayer,311,201,512,45,11,Player A
1821,JointPQPlayer,261,216,477,43,22,Player A
1822,JointPQPlayer,281,206,487,35,16,Player A
1823,JointPQPlayer,296,186,482,36,18,Player A
1824,JointPQPlayer,295,195,490,35,15,Player A
1825,JointPQPlayer,126,296,422,12,30,JointPQPlayer
1826,JointPQPlayer,150,260,410,12,34,JointPQPlayer
1827,JointPQPlayer,226,221,447,25,26,Player A
1828,JointPQPlayer,272,202,474,34,20,Player A
1829,JointPQPlayer,296,206,502,38,12,Player A
1830,JointPQPlayer,276,216,492,40,16,Player A
1831,JointPQPlayer,230,235,465,34,23,JointPQPlayer
1832,JointPQPlayer,299,199,498,37,13,Player A
1833,JointPQPlayer,284,214,498,40,14,Player A
1834,JointPQPlayer,291,191,482,33,17,Player A
1835,JointPQPlayer,196,216,412,23,37,JointPQPlayer
1836,JointPQPlayer,307,187,494,36,14,Player A
1837,JointPQPlayer,286,196,482,33,17,Player A
1838,JointPQPlayer,274,204,478,32,18,Player A
1839,JointPQPlayer,322,187,509,36,9,Player A
1840,JointPQPlayer,280,225,505,35,10,Player A
1841,JointPQPlayer,276,206,482,42,20,Player A
1842,JointPQPlayer,296,191,487,38,17,Player A
1843,JointPQPlayer,257,217,474,34,20,Player A
1844,JointPQPlayer,311,171,482,36,18,Player A
1845,JointPQPlayer,142,252,394,17,41,JointPQPlayer
1846,JointPQPlayer,291,181,472,32,20,Player A
1847,JointPQPlayer,281,196,477,31,18,Player A
1848,JointPQPlayer,291,206,497,42,15,Player A
1849,JointPQPlayer,280,200,480,34,18,Player A
1850,JointPQPlayer,289,194,483,34,17,Player A
1851,JointPQPlayer,324,184,508,38,10,Player A
1852,JointPQPlayer,269,224,493,32,13,Player A
1853,JointPQPlayer,134,284,418,14,32,JointPQPlayer
1854,JointPQPlayer,298,193,491,33,14,Player A
1855,JointPQPlayer,170,270,440,21,27,JointPQPlayer
1856,JointPQPlayer,285,200,485,36,17,Player A
1857,JointPQPlayer,301,181,482,33,17,Player A
1858,JointPQPlayer,140,270,410,15,35,JointPQPlayer
1859,JointPQPlayer,278,178,456,31,25,Player A
1860,JointPQPlayer,175,225,400,14,38,JointPQPlayer
1861,JointPQPlayer,279,184,463,23,20,Player A
1862,JointPQPlayer,281,201,482,33,17,Player A
1863,JointPQPlayer,221,236,457,26,23,JointPQPlayer
1864,JointPQPlayer,137,257,394,17,41,JointPQPlayer
1865,JointPQPlayer,280,175,455,27,24,Player A
1866,JointPQPlayer,257,227,484,29,15,Player A
1867,JointPQPlayer,302,197,499,29,10,Player A
1868,JointPQPlayer,163,233,396,13,39,JointPQPlayer
1869,JointPQPlayer,286,206,492,31,13,Player A
1870,JointPQPlayer,287,187,474,28,18,Player A
1871,JointPQPlayer,287,187,474,25,17,Player A
1872,JointPQPlayer,262,187,449,30,27,Player A
1873,JointPQPlayer,316,191,507,46,13,Player A
1874,JointPQPlayer,158,263,421,14,31,JointPQPlayer
1875,JointPQPlayer,306,181,487,38,17,Player A
1876,JointPQPlayer,288,203,491,36,15,Player A
1877,JointPQPlayer,272,197,469,32,21,Player A
1878,JointPQPlayer,235,225,460,29,23,Player A
1879,JointPQPlayer,293,178,471,22,17,Player A
1880,JointPQPlayer,151,251,402,10,36,JointPQPlayer
1881,JointPQPlayer,162,212,374,15,47,JointPQPlayer
1882,JointPQPlayer,307,177,484,29,15,Player A
1883,JointPQPlayer,276,181,457,26,23,Player A
1884,JointPQPlayer,274,214,488,33,15,Player A
1885,JointPQPlayer,304,179,483,28,15,Player A
1886,JointPQPlayer,274,219,493,35,14,Player A
1887,JointPQPlayer,327,182,509,39,10,Player A
1888,JointPQPlayer,284,229,513,40,9,Player A
1889,JointPQPlayer,241,236,477,34,19,Player A
1890,JointPQPlayer,261,236,497,36,13,Player A
1891,JointPQPlayer,144,259,403,17,38,JointPQPlayer
1892,JointPQPlayer,170,240,410,15,35,JointPQPlayer
1893,JointPQPlayer,147,267,414,16,34,JointPQPlayer
1894,JointPQPlayer,239,264,503,36,11,JointPQPlayer
1895,JointPQPlayer,272,212,484,32,16,Player A
1896,JointPQPlayer,277,212,489,37,16,Player A
1897,JointPQPlayer,263,228,491,33,14,Player A
1898,JointPQPlayer,127,267,394,11,39,JointPQPlayer
1899,JointPQPlayer,279,184,463,32,23,Player A
1900,JointPQPlayer,250,205,455,24,23,Player A
1901,JointPQPlayer,289,184,473,33,20,Player A
1902,JointPQPlayer,171,246,417,16,33,JointPQPlayer
1903,JointPQPlayer,261,221,482,36,18,Player A
1904,JointPQPlayer,314,164,478,32,18,Player A
1905,JointPQPlayer,327,162,489,37,16,Player A
1906,JointPQPlayer,328,158,486,28,14,Player A
1907,JointPQPlayer,280,190,470,24,18,Player A
1908,JointPQPlayer,294,204,498,37,13,Player A
1909,JointPQPlayer,137,297,434,18,28,JointPQPlayer
1910,JointPQPlayer,305,195,500,42,14,Player A
1911,JointPQPlayer,310,195,505,29,8,Player A
1912,JointPQPlayer,309,179,488,33,15,Player A
1913,JointPQPlayer,321,191,512,42,10,Player A
1914,JointPQPlayer,325,175,500,36,12,Player A
1915,JointPQPlayer,138,263,401,12,37,JointPQPlayer
1916,JointPQPlayer,298,178,476,30,18,Player A
1917,JointPQPlayer,294,174,468,31,21,Player A
1918,JointPQPlayer,315,180,495,40,15,Player A
1919,JointPQPlayer,155,275,430,17,29,JointPQPlayer
1920,JointPQPlayer,298,198,496,41,15,Player A
1921,JointPQPlayer,279,209,488,36,16,Player A
1922,JointPQPlayer,268,218,486,31,15,Player A
1923,JointPQPlayer,144,269,413,15,34,JointPQPlayer
1924,JointPQPlayer,144,254,398,18,40,JointPQPlayer
1925,JointPQPlayer,253,208,461,27,22,Player A
1926,JointPQPlayer,282,207,489,28,13,Player A
1927,JointPQPlayer,258,208,466,35,23,Player A
1928,JointPQPlayer,297,192,489,40,17,Player A
1929,JointPQPlayer,311,181,492,40,16,Player A
1930,JointPQPlayer,291,211,502,35,11,Player A
1931,JointPQPlayer,246,226,472,32,20,Player A
1932,JointPQPlayer,267,232,499,32,11,Player A
1933,JointPQPlayer,292,212,504,37,11,Player A
1934,JointPQPlayer,293,203,496,35,13,Player A
1935,JointPQPlayer,288,193,481,35,18,Player A
1936,JointPQPlayer,152,272,424,14,30,JointPQPlayer
1937,JointPQPlayer,281,211,492,34,14,Player A
1938,JointPQPlayer,306,181,487,29,14,Player A
1939,JointPQPlayer,304,169,473,24,17,Player A
1940,JointPQPlayer,300,180,480,40,20,Player A
1941,JointPQPlayer,312,187,499,44,15,Player A
1942,JointPQPlayer,184,234,418,23,35,JointPQPlayer
1943,JointPQPlayer,333,168,501,31,10,Player A
1944,JointPQPlayer,270,220,490,29,13,Player A
1945,JointPQPlayer,273,198,471,34,21,Player A
1946,JointPQPlayer,301,171,472,32,20,Player A
1947,JointPQPlayer,161,261,422,18,32,JointPQPlayer
1948,JointPQPlayer,260,195,455,27,24,Player A
1949,JointPQPlayer,294,194,488,30,14,Player A
1950,JointPQPlayer,313,163,476,27,17,Player A
1951,JointPQPlayer,277,207,484,32,16,Player A
1952,JointPQPlayer,289,209,498,40,14,Player A
1953,JointPQPlayer,251,211,462,19,19,Player A
1954,JointPQPlayer,256,191,447,25,26,Player A
1955,JointPQPlayer,312,177,489,34,15,Player A
1956,JointPQPlayer,289,214,503,36,11,Player A
1957,JointPQPlayer,279,199,478,35,19,Player A
1958,JointPQPlayer,233,203,436,23,29,Player A
1959,JointPQPlayer,161,281,442,17,25,JointPQPlayer
1960,JointPQPlayer,262,207,469,29,20,Player A
1961,JointPQPlayer,315,200,515,42,9,Player A
1962,JointPQPlayer,325,165,490,32,14,Player A
1963,JointPQPlayer,312,147,459,19,20,Player A
1964,JointPQPlayer,250,245,495,34,13,Player A
1965,JointPQPlayer,142,247,389,15,42,JointPQPlayer
1966,JointPQPlayer,283,218,501,43,14,Player A
1967,JointPQPlayer,283,208,491,33,14,Player A
1968,JointPQPlayer,291,206,497,42,15,Player A
1969,JointPQPlayer,209,269,478,32,18,JointPQPlayer
1970,JointPQPlayer,241,241,482,30,16,Tie
1971,JointPQPlayer,315,175,490,32,14,Player A
1972,JointPQPlayer,267,212,479,33,18,Player A
1973,JointPQPlayer,294,209,503,33,10,Player A
1974,JointPQPlayer,189,249,438,25,29,JointPQPlayer
1975,JointPQPlayer,140,260,400,17,39,JointPQPlayer
1976,JointPQPlayer,144,239,383,12,43,JointPQPlayer
1977,JointPQPlayer,257,217,474,37,21,Player A
1978,JointPQPlayer,295,195,490,32,14,Player A
1979,JointPQPlayer,261,201,462,34,24,Player A
1980,JointPQPlayer,155,290,445,23,26,JointPQPlayer
1981,JointPQPlayer,285,210,495,34,13,Player A
1982,JointPQPlayer,269,194,463,29,22,Player A
1983,JointPQPlayer,273,223,496,35,13,Player A
1984,JointPQPlayer,265,215,480,31,17,Player A
1985,JointPQPlayer,250,210,460,35,25,Player A
1986,JointPQPlayer,309,174,483,28,15,Player A
1987,JointPQPlayer,307,187,494,33,13,Player A
1988,JointPQPlayer,278,208,486,34,16,Player A
1989,JointPQPlayer,298,208,506,39,11,Player A
1990,JointPQPlayer,181,211,392,12,40,JointPQPlayer
1991,JointPQPlayer,263,198,461,30,23,Player A
1992,JointPQPlayer,293,208,501,43,14,Player A
1993,JointPQPlayer,267,222,489,40,17,Player A
1994,JointPQPlayer,323,183,506,39,11,Player A
1995,JointPQPlayer,153,243,396,19,41,JointPQPlayer
1996,JointPQPlayer,259,209,468,28,20,Player A
1997,JointPQPlayer,288,198,486,34,16,Player A
1998,JointPQPlayer,164,274,438,13,25,JointPQPlayer
1999,JointPQPlayer,295,195,490,32,14,Player A
2000,JointPQPlayer,151,231,382,8,42,JointPQPlayer
2001,JointPQPlayer,276,211,487,41,18,Player A
2002,JointPQPlayer,245,210,455,24,23,Player A
2003,JointPQPlayer,305,205,510,40,10,Player A
2004,JointPQPlayer,291,196,487,38,17,Player A
2005,JointPQPlayer,154,259,413,18,35,JointPQPlayer
2006,JointPQPlayer,302,197,499,38,13,Player A
2007,JointPQPlayer,296,201,497,39,14,Player A
2008,JointPQPlayer,308,173,481,35,18,Player A
2009,JointPQPlayer,268,248,516,43,9,Player A
2010,JointPQPlayer,322,167,489,37,16,Player A
2011,JointPQPlayer,262,217,479,39,20,Player A
2012,JointPQPlayer,277,227,504,40,12,Player A
2013,JointPQPlayer,134,279,413,15,34,JointPQPlayer
2014,JointPQPlayer,275,195,470,36,22,Player A
2015,JointPQPlayer,279,199,478,32,18,Player A
2016,JointPQPlayer,154,274,428,18,30,JointPQPlayer
2017,JointPQPlayer,296,216,512,45,11,Player A
2018,JointPQPlayer,251,216,467,24,19,Player A
2019,JointPQPlayer,316,171,487,35,16,Player A
2020,JointPQPlayer,153,258,411,19,36,JointPQPlayer
2021,JointPQPlayer,127,287,414,10,32,JointPQPlayer
2022,JointPQPlayer,301,211,512,39,9,Player A
2023,JointPQPlayer,159,259,418,11,31,JointPQPlayer
2024,JointPQPlayer,292,197,489,31,14,Player A
2025,JointPQPlayer,309,164,473,24,17,Player A
2026,JointPQPlayer,152,282,434,21,29,JointPQPlayer
2027,JointPQPlayer,306,186,492,31,13,Player A
2028,JointPQPlayer,301,181,482,30,16,Player A
2029,JointPQPlayer,177,222,399,13,38,JointPQPlayer
2030,JointPQPlayer,302,192,494,33,13,Player A
2031,JointPQPlayer,295,180,475,29,18,Player A
2032,JointPQPlayer,313,183,496,38,14,Player A
2033,JointPQPlayer,276,206,482,36,18,Player A
2034,JointPQPlayer,254,229,483,31,16,Player A
2035,JointPQPlayer,269,194,463,23,20,Player A
2036,JointPQPlayer,305,200,505,41,12,Player A
2037,JointPQPlayer,287,212,499,35,12,Player A
2038,JointPQPlayer,303,173,476,27,17,Player A
2039,JointPQPlayer,287,202,489,40,17,Player A
2040,JointPQPlayer,321,176,497,36,13,Player A
2041,JointPQPlayer,274,204,478,32,18,Player A
2042,JointPQPlayer,303,203,506,39,11,Player A
2043,JointPQPlayer,277,212,489,28,13,Player A
2044,JointPQPlayer,310,190,500,36,12,Player A
2045,JointPQPlayer,271,211,482,27,15,Player A
2046,JointPQPlayer,315,185,500,33,11,Player A
2047,JointPQPlayer,160,265,425,18,31,JointPQPlayer
2048,JointPQPlayer,300,190,490,38,16,Player A
2049,JointPQPlayer,152,262,414,19,35,JointPQPlayer
2050,JointPQPlayer,326,146,472,20,16,Player A
2051,JointPQPlayer,307,192,499,35,12,Player A
2052,JointPQPlayer,221,211,432,25,31,Player A
2053,JointPQPlayer,302,192,494,39,15,Player A
2054,JointPQPlayer,137,262,399,16,39,JointPQPlayer
2055,JointPQPlayer,294,184,478,32,18,Player A
2056,JointPQPlayer,123,288,411,13,34,JointPQPlayer
2057,JointPQPlayer,269,234,503,39,12,Player A
2058,JointPQPlayer,284,204,488,30,14,Player A
2059,JointPQPlayer,268,233,501,40,13,Player A
2060,JointPQPlayer,303,183,486,37,17,Player A
2061,JointPQPlayer,138,248,386,15,43,JointPQPlayer
2062,JointPQPlayer,322,172,494,33,13,Player A
2063,JointPQPlayer,272,232,504,37,11,Player A
2064,JointPQPlayer,289,179,468,25,19,Player A
2065,JointPQPlayer,264,194,458,30,24,Player A
2066,JointPQPlayer,260,205,465,34,23,Player A
2067,JointPQPlayer,141,286,427,8,27,JointPQPlayer
2068,JointPQPlayer,281,191,472,26,18,Player A
2069,JointPQPlayer,293,203,496,35,13,Player A
2070,JointPQPlayer,158,233,391,11,40,JointPQPlayer
2071,JointPQPlayer,166,261,427,17,30,JointPQPlayer
2072,JointPQPlayer,310,190,500,42,14,Player A
2073,JointPQPlayer,147,277,424,20,32,JointPQPlayer
2074,JointPQPlayer,144,264,408,13,35,JointPQPlayer
2075,JointPQPlayer,321,176,497,33,12,Player A
2076,JointPQPlayer,267,227,494,36,14,Player A
2077,JointPQPlayer,306,166,472,32,20,Player A
2078,JointPQPlayer,270,220,490,41,17,Player A
2079,JointPQPlayer,314,174,488,30,14,Player A
2080,JointPQPlayer,316,171,487,32,15,Player A
2081,JointPQPlayer,148,303,451,23,24,JointPQPlayer
2082,JointPQPlayer,283,183,466,29,21,Player A
2083,JointPQPlayer,245,220,465,40,25,Player A
2084,JointPQPlayer,302,172,474,34,20,Player A
2085,JointPQPlayer,276,176,452,24,24,Player A
2086,JointPQPlayer,128,283,411,13,34,JointPQPlayer
2087,JointPQPlayer,314,199,513,40,9,Player A
2088,JointPQPlayer,257,177,434,21,29,Player A
2089,JointPQPlayer,280,210,490,41,17,Player A
2090,JointPQPlayer,152,257,409,11,34,JointPQPlayer
2091,JointPQPlayer,250,200,450,31,27,Player A
2092,JointPQPlayer,276,206,482,33,17,Player A
2093,JointPQPlayer,301,171,472,26,18,Player A
2094,JointPQPlayer,311,191,502,41,13,Player A
2095,JointPQPlayer,258,228,486,37,17,Player A
2096,JointPQPlayer,288,208,496,32,12,Player A
2097,JointPQPlayer,321,176,497,30,11,Player A
2098,JointPQPlayer,295,195,490,38,16,Player A
2099,JointPQPlayer,279,219,498,37,13,Player A
2100,JointPQPlayer,171,261,432,13,27,JointPQPlayer
2101,JointPQPlayer,278,208,486,34,16,Player A
2102,JointPQPlayer,313,193,506,42,12,Player A
2103,JointPQPlayer,317,207,524,45,7,Player A
2104,JointPQPlayer,299,204,503,36,11,Player A
2105,JointPQPlayer,279,209,488,42,18,Player A
2106,JointPQPlayer,307,207,514,41,9,Player A
2107,JointPQPlayer,267,212,479,30,17,Player A
2108,JointPQPlayer,304,189,493,38,15,Player A
2109,JointPQPlayer,304,209,513,46,11,Player A
2110,JointPQPlayer,287,202,489,34,15,Player A
2111,JointPQPlayer,250,205,455,27,24,Player A
2112,JointPQPlayer,261,201,462,34,24,Player A
2113,JointPQPlayer,299,179,478,29,17,Player A
2114,JointPQPlayer,208,243,451,20,23,JointPQPlayer
2115,JointPQPlayer,314,189,503,45,14,Player A
2116,JointPQPlayer,156,251,407,15,36,JointPQPlayer
2117,JointPQPlayer,322,182,504,37,11,Player A
2118,JointPQPlayer,314,189,503,36,11,Player A
2119,JointPQPlayer,144,274,418,11,31,JointPQPlayer
2120,JointPQPlayer,145,280,425,18,31,JointPQPlayer
2121,JointPQPlayer,306,176,482,33,17,Player A
2122,JointPQPlayer,209,254,463,26,21,JointPQPlayer
2123,JointPQPlayer,305,190,495,37,14,Player A
2124,JointPQPlayer,145,260,405,13,36,JointPQPlayer
2125,JointPQPlayer,144,249,393,13,40,JointPQPlayer
2126,JointPQPlayer,153,248,401,18,39,JointPQPlayer
2127,JointPQPlayer,297,207,504,37,11,Player A
2128,JointPQPlayer,311,191,502,41,13,Player A
2129,JointPQPlayer,281,201,482,36,18,Player A
2130,JointPQPlayer,320,175,495,31,12,Player A
2131,JointPQPlayer,284,179,463,26,21,Player A
2132,JointPQPlayer,298,178,476,30,18,Player A
2133,JointPQPlayer,298,193,491,36,15,Player A
2134,JointPQPlayer,311,176,487,35,16,Player A
2135,JointPQPlayer,281,216,497,39,14,Player A
2136,JointPQPlayer,287,192,479,33,18,Player A
2137,JointPQPlayer,274,194,468,31,21,Player A
2138,JointPQPlayer,301,186,487,32,15,Player A
2139,JointPQPlayer,328,178,506,39,11,Player A
2140,JointPQPlayer,257,207,464,33,23,Player A
2141,JointPQPlayer,278,183,461,27,22,Player A
2142,JointPQPlayer,160,265,425,21,32,JointPQPlayer
2143,JointPQPlayer,305,185,490,38,16,Player A
2144,JointPQPlayer,284,199,483,34,17,Player A
2145,JointPQPlayer,323,168,491,33,14,Player A
2146,JointPQPlayer,304,179,483,28,15,Player A
2147,JointPQPlayer,280,220,500,39,13,Player A
2148,JointPQPlayer,296,201,497,36,13,Player A
2149,JointPQPlayer,283,203,486,37,17,Player A
2150,JointPQPlayer,194,239,433,26,31,JointPQPlayer
2151,JointPQPlayer,307,177,484,35,17,Player A
2152,JointPQPlayer,281,216,497,36,13,Player A
2153,JointPQPlayer,324,169,493,32,13,Player A
2154,JointPQPlayer,259,204,463,23,20,Player A
2155,JointPQPlayer,258,203,461,30,23,Player A
2156,JointPQPlayer,325,200,525,43,6,Player A
2157,JointPQPlayer,212,237,449,24,25,JointPQPlayer
2158,JointPQPlayer,305,190,495,34,13,Player A
2159,JointPQPlayer,334,164,498,31,11,Player A
2160,JointPQPlayer,293,203,496,38,14,Player A
2161,JointPQPlayer,285,195,480,34,18,Player A
2162,JointPQPlayer,245,220,465,37,24,Player A
2163,JointPQPlayer,286,211,497,39,14,Player A
2164,JointPQPlayer,269,219,488,36,16,Player A
2165,JointPQPlayer,296,201,497,39,14,Player A
2166,JointPQPlayer,271,211,482,36,18,Player A
2167,JointPQPlayer,310,175,485,30,15,Player A
2168,JointPQPlayer,277,197,474,34,20,Player A
2169,JointPQPlayer,297,187,484,35,17,Player A
2170,JointPQPlayer,299,179,478,38,20,Player A
2171,JointPQPlayer,266,216,482,33,17,Player A
2172,JointPQPlayer,311,191,502,32,10,Player A
2173,JointPQPlayer,297,202,499,38,13,Player A
2174,JointPQPlayer,259,194,453,28,25,Player A
2175,JointPQPlayer,213,213,426,16,30,Tie
2176,JointPQPlayer,295,170,465,34,23,Player A
2177,JointPQPlayer,292,187,479,36,19,Player A
2178,JointPQPlayer,301,196,497,39,14,Player A
2179,JointPQPlayer,261,216,477,40,21,Player A
2180,JointPQPlayer,315,160,475,29,18,Player A
2181,JointPQPlayer,309,199,508,38,10,Player A
2182,JointPQPlayer,301,176,477,34,19,Player A
2183,JointPQPlayer,323,178,501,37,12,Player A
2184,JointPQPlayer,301,206,507,37,10,Player A
2185,JointPQPlayer,213,203,416,12,32,Player A
2186,JointPQPlayer,290,200,490,32,14,Player A
2187,JointPQPlayer,133,248,381,10,43,JointPQPlayer
2188,JointPQPlayer,286,216,502,38,12,Player A
2189,JointPQPlayer,303,193,496,38,14,Player A
2190,JointPQPlayer,138,288,426,16,30,JointPQPlayer
2191,JointPQPlayer,299,204,503,36,11,Player A
2192,JointPQPlayer,320,155,475,26,17,Player A
2193,JointPQPlayer,312,172,484,26,14,Player A
2194,JointPQPlayer,324,169,493,38,15,Player A
2195,JointPQPlayer,216,246,462,34,24,JointPQPlayer
2196,JointPQPlayer,271,181,452,24,24,Player A
2197,JointPQPlayer,264,214,478,32,18,Player A
2198,JointPQPlayer,166,281,447,19,24,JointPQPlayer
2199,JointPQPlayer,270,215,485,33,16,Player A
2200,JointPQPlayer,316,191,507,40,11,Player A
2201,JointPQPlayer,302,182,484,35,17,Player A
2202,JointPQPlayer,323,173,496,35,13,Player A
2203,JointPQPlayer,335,150,485,27,14,Player A
2204,JointPQPlayer,285,180,465,28,21,Player A
2205,JointPQPlayer,271,201,472,38,22,Player A
2206,JointPQPlayer,129,269,398,12,38,JointPQPlayer
2207,JointPQPlayer,259,214,473,33,20,Player A
2208,JointPQPlayer,309,179,488,33,15,Player A
2209,JointPQPlayer,259,224,483,25,14,Player A
2210,JointPQPlayer,138,268,406,14,36,JointPQPlayer
2211,JointPQPlayer,289,214,503,45,14,Player A
2212,JointPQPlayer,281,216,497,39,14,Player A
2213,JointPQPlayer,167,232,399,16,39,JointPQPlayer
2214,JointPQPlayer,270,190,460,26,22,Player A
2215,JointPQPlayer,292,212,504,34,10,Player A
2216,JointPQPlayer,316,176,492,34,14,Player A
2217,JointPQPlayer,293,223,516,40,8,Player A
2218,JointPQPlayer,266,226,492,37,15,Player A
2219,JointPQPlayer,264,219,483,31,16,Player A
2220,JointPQPlayer,283,193,476,39,21,Player A
2221,JointPQPlayer,275,215,490,32,14,Player A
2222,JointPQPlayer,200,245,445,26,27,JointPQPlayer
2223,JointPQPlayer,329,164,493,35,14,Player A
2224,JointPQPlayer,317,182,499,38,13,Player A
2225,JointPQPlayer,282,192,474,34,20,Player A
2226,JointPQPlayer,307,177,484,29,15,Player A
2227,JointPQPlayer,287,207,494,36,14,Player A
2228,JointPQPlayer,277,192,469,29,20,Player A
2229,JointPQPlayer,280,215,495,34,13,Player A
2230,JointPQPlayer,290,205,495,40,15,Player A
2231,JointPQPlayer,202,242,444,19,25,JointPQPlayer
2232,JointPQPlayer,267,197,464,21,19,Player A
2233,JointPQPlayer,159,254,413,18,35,JointPQPlayer
2234,JointPQPlayer,277,222,499,41,14,Player A
2235,JointPQPlayer,265,205,470,33,21,Player A
2236,JointPQPlayer,272,212,484,32,16,Player A
2237,JointPQPlayer,313,153,466,29,21,Player A
2238,JointPQPlayer,299,179,478,35,19,Player A
2239,JointPQPlayer,144,254,398,12,38,JointPQPlayer
2240,JointPQPlayer,273,223,496,47,17,Player A
2241,JointPQPlayer,317,177,494,27,11,Player A
2242,JointPQPlayer,210,220,430,23,31,JointPQPlayer
2243,JointPQPlayer,314,179,493,38,15,Player A
2244,JointPQPlayer,265,220,485,27,14,Player A
2245,JointPQPlayer,287,207,494,36,14,Player A
2246,JointPQPlayer,274,174,448,26,26,Player A
2247,JointPQPlayer,125,255,380,12,44,JointPQPlayer
2248,JointPQPlayer,294,189,483,28,15,Player A
2249,JointPQPlayer,312,172,484,32,16,Player A
2250,JointPQPlayer,294,214,508,29,7,Player A
2251,JointPQPlayer,240,210,450,28,26,Player A
2252,JointPQPlayer,301,176,477,25,16,Player A
2253,JointPQPlayer,236,206,442,20,26,Player A
2254,JointPQPlayer,303,188,491,36,15,Player A
2255,JointPQPlayer,250,205,455,30,25,Player A
2256,JointPQPlayer,267,212,479,30,17,Player A
2257,JointPQPlayer,144,254,398,12,38,JointPQPlayer
2258,JointPQPlayer,282,192,474,34,20,Player A
2259,JointPQPlayer,283,193,476,33,19,Player A
2260,JointPQPlayer,276,186,462,34,24,Player A
2261,JointPQPlayer,294,224,518,36,6,Player A
2262,JointPQPlayer,263,208,471,34,21,Player A
2263,JointPQPlayer,214,229,443,27,28,JointPQPlayer
2264,JointPQPlayer,162,257,419,18,33,JointPQPlayer
2265,JointPQPlayer,283,203,486,34,16,Player A
2266,JointPQPlayer,127,252,379,8,43,JointPQPlayer
2267,JointPQPlayer,291,226,517,41,8,Player A
2268,JointPQPlayer,127,307,434,15,27,JointPQPlayer
2269,JointPQPlayer,298,188,486,34,16,Player A
2270,JointPQPlayer,125,290,415,17,34,JointPQPlayer
2271,JointPQPlayer,282,197,479,33,18,Player A
2272,JointPQPlayer,275,200,475,32,19,Player A
2273,JointPQPlayer,258,223,481,32,17,Player A
2274,JointPQPlayer,299,184,483,34,17,Player A
2275,JointPQPlayer,284,209,493,32,13,Player A
2276,JointPQPlayer,272,207,479,27,16,Player A
2277,JointPQPlayer,279,209,488,33,15,Player A
2278,JointPQPlayer,280,225,505,44,13,Player A
2279,JointPQPlayer,236,201,437,24,29,Player A
2280,JointPQPlayer,261,221,482,33,17,Player A
2281,JointPQPlayer,266,196,462,25,21,Player A
2282,JointPQPlayer,317,187,504,37,11,Player A
2283,JointPQPlayer,305,185,490,38,16,Player A
2284,JointPQPlayer,225,240,465,22,19,JointPQPlayer
2285,JointPQPlayer,304,179,483,31,16,Player A
2286,JointPQPlayer,137,267,404,12,36,JointPQPlayer
2287,JointPQPlayer,306,191,497,30,11,Player A
2288,JointPQPlayer,286,226,512,39,9,Player A
2289,JointPQPlayer,307,197,504,40,12,Player A
2290,JointPQPlayer,276,216,492,37,15,Player A
2291,JointPQPlayer,271,226,497,42,15,Player A
2292,JointPQPlayer,323,163,486,31,15,Player A
2293,JointPQPlayer,160,245,405,13,36,JointPQPlayer
2294,JointPQPlayer,181,231,412,17,35,JointPQPlayer
2295,JointPQPlayer,331,166,497,36,13,Player A
2296,JointPQPlayer,251,221,472,29,19,Player A
2297,JointPQPlayer,159,239,398,12,38,JointPQPlayer
2298,JointPQPlayer,137,262,399,10,37,JointPQPlayer
2299,JointPQPlayer,316,166,482,36,18,Player A
2300,JointPQPlayer,293,183,476,33,19,Player A
2301,JointPQPlayer,161,246,407,18,37,JointPQPlayer
2302,JointPQPlayer,282,227,509,48,13,Player A
2303,JointPQPlayer,146,246,392,9,39,JointPQPlayer
2304,JointPQPlayer,309,204,513,40,9,Player A
2305,JointPQPlayer,306,171,477,31,18,Player A
2306,JointPQPlayer,310,185,495,40,15,Player A
2307,JointPQPlayer,284,194,478,35,19,Player A
2308,JointPQPlayer,285,225,510,40,10,Player A
2309,JointPQPlayer,325,160,485,30,15,Player A
2310,JointPQPlayer,257,207,464,24,20,Player A
2311,JointPQPlayer,265,230,495,37,14,Player A
2312,JointPQPlayer,276,236,512,42,10,Player A
2313,JointPQPlayer,269,224,493,38,15,Player A
2314,JointPQPlayer,178,248,426,16,30,JointPQPlayer
2315,JointPQPlayer,318,208,526,47,7,Player A
2316,JointPQPlayer,274,204,478,32,18,Player A
2317,JointPQPlayer,302,182,484,41,19,Player A
2318,JointPQPlayer,306,156,462,25,21,Player A
2319,JointPQPlayer,313,178,491,33,14,Player A
2320,JointPQPlayer,204,254,458,30,24,JointPQPlayer
2321,JointPQPlayer,285,215,500,42,14,Player A
2322,JointPQPlayer,214,254,468,28,20,JointPQPlayer
2323,JointPQPlayer,325,180,505,35,10,Player A
2324,JointPQPlayer,246,211,457,32,25,Player A
2325,JointPQPlayer,265,190,455,27,24,Player A
2326,JointPQPlayer,260,225,485,30,15,Player A
2327,JointPQPlayer,173,233,406,14,36,JointPQPlayer
2328,JointPQPlayer,141,296,437,15,26,JointPQPlayer
2329,JointPQPlayer,157,212,369,10,47,JointPQPlayer
2330,JointPQPlayer,205,205,410,15,35,Tie
2331,JointPQPlayer,265,230,495,34,13,Player A
2332,JointPQPlayer,293,193,486,28,14,Player A
2333,JointPQPlayer,288,198,486,31,15,Player A
2334,JointPQPlayer,289,194,483,34,17,Player A
2335,JointPQPlayer,263,198,461,27,22,Player A
2336,JointPQPlayer,111,281,392,9,39,JointPQPlayer
2337,JointPQPlayer,280,185,465,31,22,Player A
2338,JointPQPlayer,299,179,478,29,17,Player A
2339,JointPQPlayer,297,187,484,35,17,Player A
2340,JointPQPlayer,301,196,497,39,14,Player A
2341,JointPQPlayer,317,177,494,30,12,Player A
2342,JointPQPlayer,286,186,472,26,18,Player A
2343,JointPQPlayer,119,289,408,13,35,JointPQPlayer
2344,JointPQPlayer,283,193,476,33,19,Player A
2345,JointPQPlayer,313,198,511,35,8,Player A
2346,JointPQPlayer,130,265,395,9,38,JointPQPlayer
2347,JointPQPlayer,297,207,504,43,13,Player A
2348,JointPQPlayer,262,227,489,34,15,Player A
2349,JointPQPlayer,261,216,477,31,18,Player A
2350,JointPQPlayer,266,211,477,43,22,Player A
2351,JointPQPlayer,280,205,485,36,17,Player A
2352,JointPQPlayer,315,200,515,42,9,Player A
2353,JointPQPlayer,313,198,511,35,8,Player A
2354,JointPQPlayer,308,193,501,37,12,Player A
2355,JointPQPlayer,269,189,458,27,23,Player A
2356,JointPQPlayer,272,217,489,40,17,Player A
2357,JointPQPlayer,307,172,479,30,17,Player A
2358,JointPQPlayer,299,209,508,44,12,Player A
2359,JointPQPlayer,284,174,458,33,25,Player A
2360,JointPQPlayer,264,194,458,33,25,Player A
2361,JointPQPlayer,289,189,478,35,19,Player A
2362,JointPQPlayer,265,180,445,29,28,Player A
2363,JointPQPlayer,112,277,389,9,40,JointPQPlayer
2364,JointPQPlayer,264,229,493,38,15,Player A
2365,JointPQPlayer,279,204,483,34,17,Player A
2366,JointPQPlayer,316,201,517,38,7,Player A
2367,JointPQPlayer,288,188,476,33,19,Player A
2368,JointPQPlayer,133,268,401,15,38,JointPQPlayer
2369,JointPQPlayer,304,174,478,29,17,Player A
2370,JointPQPlayer,155,275,430,17,29,JointPQPlayer
2371,JointPQPlayer,326,161,487,32,15,Player A
2372,JointPQPlayer,284,194,478,35,19,Player A
2373,JointPQPlayer,240,225,465,31,22,Player A
2374,JointPQPlayer,258,198,456,28,24,Player A
2375,JointPQPlayer,302,202,504,31,9,Player A
2376,JointPQPlayer,246,216,462,34,24,Player A
2377,JointPQPlayer,295,195,490,32,14,Player A
2378,JointPQPlayer,293,208,501,37,12,Player A
2379,JointPQPlayer,142,282,424,11,29,JointPQPlayer
2380,JointPQPlayer,303,203,506,36,10,Player A
2381,JointPQPlayer,162,227,389,9,40,JointPQPlayer
2382,JointPQPlayer,291,191,482,36,18,Player A
2383,JointPQPlayer,256,211,467,33,22,Player A
2384,JointPQPlayer,321,181,502,38,12,Player A
2385,JointPQPlayer,294,184,478,26,16,Player A
2386,JointPQPlayer,257,197,454,23,23,Player A
2387,JointPQPlayer,284,209,493,35,14,Player A
2388,JointPQPlayer,237,232,469,26,19,Player A
2389,JointPQPlayer,291,196,487,29,14,Player A
2390,JointPQPlayer,272,217,489,31,14,Player A
2391,JointPQPlayer,314,159,473,27,18,Player A
2392,JointPQPlayer,287,212,499,38,13,Player A
2393,JointPQPlayer,321,176,497,39,14,Player A
2394,JointPQPlayer,292,187,479,42,21,Player A
2395,JointPQPlayer,273,213,486,34,16,Player A
2396,JointPQPlayer,215,235,450,19,23,JointPQPlayer
2397,JointPQPlayer,299,189,488,36,16,Player A
2398,JointPQPlayer,302,172,474,31,19,Player A
2399,JointPQPlayer,275,175,450,31,27,Player A
2400,JointPQPlayer,273,213,486,31,15,Player A
2401,JointPQPlayer,274,214,488,36,16,Player A
2402,JointPQPlayer,278,208,486,31,15,Player A
2403,JointPQPlayer,302,177,479,33,18,Player A
2404,JointPQPlayer,324,169,493,35,14,Player A
2405,JointPQPlayer,279,189,468,31,21,Player A
2406,JointPQPlayer,254,229,483,31,16,Player A
2407,JointPQPlayer,310,170,480,34,18,Player A
2408,JointPQPlayer,239,219,458,24,22,Player A
2409,JointPQPlayer,302,187,489,34,15,Player A
2410,JointPQPlayer,281,201,482,36,18,Player A
2411,JointPQPlayer,295,225,520,44,8,Player A
2412,JointPQPlayer,293,203,496,38,14,Player A
2413,JointPQPlayer,190,265,455,18,21,JointPQPlayer
2414,JointPQPlayer,274,204,478,29,17,Player A
2415,JointPQPlayer,291,171,462,31,23,Player A
2416,JointPQPlayer,211,216,427,23,32,JointPQPlayer
2417,JointPQPlayer,299,199,498,37,13,Player A
2418,JointPQPlayer,256,191,447,31,28,Player A
2419,JointPQPlayer,297,167,464,30,22,Player A
2420,JointPQPlayer,313,178,491,36,15,Player A
2421,JointPQPlayer,147,242,389,9,40,JointPQPlayer
2422,JointPQPlayer,282,212,494,36,14,Player A
2423,JointPQPlayer,299,199,498,34,12,Player A
2424,JointPQPlayer,288,208,496,35,13,Player A
2425,JointPQPlayer,268,213,481,38,19,Player A
2426,JointPQPlayer,301,186,487,38,17,Player A
2427,JointPQPlayer,324,194,518,42,8,Player A
2428,JointPQPlayer,279,214,493,32,13,Player A
2429,JointPQPlayer,209,229,438,31,31,JointPQPlayer
2430,JointPQPlayer,263,213,476,30,18,Player A
2431,JointPQPlayer,134,249,383,12,43,JointPQPlayer
2432,JointPQPlayer,311,201,512,45,11,Player A
2433,JointPQPlayer,313,208,521,42,7,Player A
2434,JointPQPlayer,284,179,463,29,22,Player A
2435,JointPQPlayer,277,227,504,37,11,Player A
2436,JointPQPlayer,277,212,489,31,14,Player A
2437,JointPQPlayer,146,266,412,14,34,JointPQPlayer
2438,JointPQPlayer,133,283,416,21,35,JointPQPlayer
2439,JointPQPlayer,315,160,475,26,17,Player A
2440,JointPQPlayer,294,174,468,25,19,Player A
2441,JointPQPlayer,279,214,493,35,14,Player A
2442,JointPQPlayer,310,175,485,30,15,Player A
2443,JointPQPlayer,314,184,498,40,14,Player A
2444,JointPQPlayer,312,192,504,37,11,Player A
2445,JointPQPlayer,319,169,488,36,16,Player A
2446,JointPQPlayer,260,220,480,34,18,Player A
2447,JointPQPlayer,314,184,498,31,11,Player A
2448,JointPQPlayer,293,213,506,39,11,Player A
2449,JointPQPlayer,302,182,484,38,18,Player A
2450,JointPQPlayer,230,225,455,27,24,Player A
2451,JointPQPlayer,277,192,469,32,21,Player A
2452,JointPQPlayer,284,169,453,28,25,Player A
2453,JointPQPlayer,307,187,494,27,11,Player A
2454,JointPQPlayer,197,227,424,20,32,JointPQPlayer
2455,JointPQPlayer,304,194,498,34,12,Player A
2456,JointPQPlayer,275,200,475,32,19,Player A
2457,JointPQPlayer,146,246,392,12,40,JointPQPlayer
2458,JointPQPlayer,316,186,502,29,9,Player A
2459,JointPQPlayer,114,289,403,14,37,JointPQPlayer
2460,JointPQPlayer,252,202,454,32,26,Player A
2461,JointPQPlayer,165,270,435,16,27,JointPQPlayer
2462,JointPQPlayer,256,201,457,29,24,Player A
2463,JointPQPlayer,247,227,474,28,18,Player A
2464,JointPQPlayer,324,184,508,32,8,Player A
2465,JointPQPlayer,306,191,497,42,15,Player A
2466,JointPQPlayer,293,203,496,47,17,Player A
2467,JointPQPlayer,291,181,472,32,20,Player A
2468,JointPQPlayer,297,207,504,40,12,Player A
2469,JointPQPlayer,139,259,398,9,37,JointPQPlayer
2470,JointPQPlayer,296,176,472,32,20,Player A
2471,JointPQPlayer,282,212,494,33,13,Player A
2472,JointPQPlayer,317,172,489,34,15,Player A
2473,JointPQPlayer,300,185,485,36,17,Player A
2474,JointPQPlayer,265,225,490,35,15,Player A
2475,JointPQPlayer,314,189,503,36,11,Player A
2476,JointPQPlayer,138,273,411,13,34,JointPQPlayer
2477,JointPQPlayer,297,187,484,35,17,Player A
2478,JointPQPlayer,317,162,479,27,16,Player A
2479,JointPQPlayer,291,186,477,37,20,Player A
2480,JointPQPlayer,253,203,456,25,23,Player A
2481,JointPQPlayer,132,242,374,9,45,JointPQPlayer
2482,JointPQPlayer,139,259,398,12,38,JointPQPlayer
2483,JointPQPlayer,232,212,444,25,27,Player A
2484,JointPQPlayer,274,184,458,30,24,Player A
2485,JointPQPlayer,282,212,494,45,17,Player A
2486,JointPQPlayer,241,211,452,18,22,Player A
2487,JointPQPlayer,286,216,502,38,12,Player A
2488,JointPQPlayer,301,191,492,37,15,Player A
2489,JointPQPlayer,296,206,502,32,10,Player A
2490,JointPQPlayer,301,181,482,27,15,Player A
2491,JointPQPlayer,290,200,490,32,14,Player A
2492,JointPQPlayer,279,199,478,32,18,Player A
2493,JointPQPlayer,294,204,498,37,13,Player A
2494,JointPQPlayer,285,200,485,30,15,Player A
2495,JointPQPlayer,257,227,484,32,16,Player A
2496,JointPQPlayer,317,177,494,36,14,Player A
2497,JointPQPlayer,136,261,397,11,38,JointPQPlayer
2498,JointPQPlayer,258,223,481,41,20,Player A
2499,JointPQPlayer,296,181,477,40,21,Player A
2500,JointPQPlayer,149,249,398,15,39,JointPQPlayer
2501,JointPQPlayer,259,224,483,31,16,Player A
2502,JointPQPlayer,286,191,477,34,19,Player A
2503,JointPQPlayer,260,210,470,24,18,Player A
2504,JointPQPlayer,283,173,456,28,24,Player A
2505,JointPQPlayer,268,208,476,33,19,Player A
2506,JointPQPlayer,298,183,481,32,17,Player A
2507,JointPQPlayer,328,183,511,41,10,Player A
2508,JointPQPlayer,149,279,428,12,28,JointPQPlayer
2509,JointPQPlayer,176,246,422,21,33,JointPQPlayer
2510,JointPQPlayer,177,222,399,16,39,JointPQPlayer
2511,JointPQPlayer,279,184,463,35,24,Player A
2512,JointPQPlayer,253,173,426,28,34,Player A
2513,JointPQPlayer,277,192,469,35,22,Player A
2514,JointPQPlayer,152,272,424,17,31,JointPQPlayer
2515,JointPQPlayer,293,218,511,38,9,Player A
2516,JointPQPlayer,288,198,486,28,14,Player A
2517,JointPQPlayer,117,277,394,14,40,JointPQPlayer
2518,JointPQPlayer,142,267,409,23,38,JointPQPlayer
2519,JointPQPlayer,297,167,464,33,23,Player A
2520,JointPQPlayer,270,220,490,41,17,Player A
2521,JointPQPlayer,256,236,492,34,14,Player A
2522,JointPQPlayer,280,210,490,32,14,Player A
2523,JointPQPlayer,167,237,404,18,38,JointPQPlayer
2524,JointPQPlayer,143,243,386,12,42,JointPQPlayer
2525,JointPQPlayer,286,196,482,27,15,Player A
2526,JointPQPlayer,278,203,481,32,17,Player A
2527,JointPQPlayer,309,164,473,33,20,Player A
2528,JointPQPlayer,248,213,461,30,23,Player A
2529,JointPQPlayer,146,261,407,15,36,JointPQPlayer
2530,JointPQPlayer,287,187,474,34,20,Player A
2531,JointPQPlayer,295,195,490,41,17,Player A
2532,JointPQPlayer,266,201,467,33,22,Player A
2533,JointPQPlayer,174,244,418,14,32,JointPQPlayer
2534,JointPQPlayer,287,217,504,40,12,Player A
2535,JointPQPlayer,135,280,415,14,33,JointPQPlayer
2536,JointPQPlayer,257,207,464,33,23,Player A
2537,JointPQPlayer,280,200,480,34,18,Player A
2538,JointPQPlayer,241,236,477,34,19,Player A
2539,JointPQPlayer,291,211,502,35,11,Player A
2540,JointPQPlayer,264,209,473,27,18,Player A
2541,JointPQPlayer,169,254,423,16,31,JointPQPlayer
2542,JointPQPlayer,278,188,466,35,23,Player A
2543,JointPQPlayer,257,227,484,32,16,Player A
2544,JointPQPlayer,254,219,473,33,20,Player A
2545,JointPQPlayer,282,187,469,32,21,Player A
2546,JointPQPlayer,285,180,465,31,22,Player A
2547,JointPQPlayer,292,217,509,39,10,Player A
2548,JointPQPlayer,228,218,446,21,25,Player A
2549,JointPQPlayer,288,208,496,29,11,Player A
2550,JointPQPlayer,251,211,462,31,23,Player A
2551,JointPQPlayer,302,192,494,33,13,Player A
2552,JointPQPlayer,153,238,391,14,41,JointPQPlayer
2553,JointPQPlayer,271,191,462,37,25,Player A
2554,JointPQPlayer,130,260,390,13,41,JointPQPlayer
2555,JointPQPlayer,305,210,515,42,9,Player A
2556,JointPQPlayer,309,169,478,32,18,Player A
2557,JointPQPlayer,164,264,428,18,30,JointPQPlayer
2558,JointPQPlayer,309,194,503,42,13,Player A
2559,JointPQPlayer,173,253,426,13,29,JointPQPlayer
2560,JointPQPlayer,289,174,463,23,20,Player A
2561,JointPQPlayer,284,199,483,43,20,Player A
2562,JointPQPlayer,287,212,499,41,14,Player A
2563,JointPQPlayer,273,218,491,36,15,Player A
2564,JointPQPlayer,236,231,467,36,23,Player A
2565,JointPQPlayer,249,224,473,36,21,Player A
2566,JointPQPlayer,226,226,452,21,23,Tie
2567,JointPQPlayer,245,215,460,26,22,Player A
2568,JointPQPlayer,315,175,490,32,14,Player A
2569,JointPQPlayer,149,259,408,19,37,JointPQPlayer
2570,JointPQPlayer,312,192,504,43,13,Player A
2571,JointPQPlayer,315,175,490,35,15,Player A
2572,JointPQPlayer,322,187,509,33,8,Player A
2573,JointPQPlayer,236,201,437,24,29,Player A
2574,JointPQPlayer,290,215,505,44,13,Player A
2575,JointPQPlayer,326,176,502,38,12,Player A
2576,JointPQPlayer,265,215,480,31,17,Player A
2577,JointPQPlayer,282,182,464,27,21,Player A
2578,JointPQPlayer,118,258,376,8,44,JointPQPlayer
2579,JointPQPlayer,325,175,500,36,12,Player A
2580,JointPQPlayer,273,213,486,43,19,Player A
2581,JointPQPlayer,298,188,486,34,16,Player A
2582,JointPQPlayer,301,191,492,37,15,Player A
2583,JointPQPlayer,285,210,495,40,15,Player A
2584,JointPQPlayer,324,179,503,39,12,Player A
2585,JointPQPlayer,236,251,487,38,17,JointPQPlayer
2586,JointPQPlayer,236,241,477,28,17,JointPQPlayer
2587,JointPQPlayer,138,253,391,11,40,JointPQPlayer
2588,JointPQPlayer,282,207,489,34,15,Player A
2589,JointPQPlayer,272,197,469,32,21,Player A
2590,JointPQPlayer,294,214,508,38,10,Player A
2591,JointPQPlayer,258,233,491,39,16,Player A
2592,JointPQPlayer,274,179,453,28,25,Player A
2593,JointPQPlayer,306,151,457,32,25,Player A
2594,JointPQPlayer,169,229,398,12,38,JointPQPlayer
2595,JointPQPlayer,326,166,492,34,14,Player A
2596,JointPQPlayer,288,213,501,37,12,Player A
2597,JointPQPlayer,139,254,393,7,38,JointPQPlayer
2598,JointPQPlayer,268,213,481,29,16,Player A
2599,JointPQPlayer,294,169,463,32,23,Player A
2600,JointPQPlayer,189,259,448,20,24,JointPQPlayer
2601,JointPQPlayer,271,206,477,28,17,Player A
2602,JointPQPlayer,305,170,475,38,21,Player A
2603,JointPQPlayer,307,197,504,37,11,Player A
2604,JointPQPlayer,289,184,473,27,18,Player A
2605,JointPQPlayer,310,180,490,38,16,Player A
2606,JointPQPlayer,276,201,477,37,20,Player A
2607,JointPQPlayer,248,213,461,27,22,Player A
2608,JointPQPlayer,251,231,482,36,18,Player A
2609,JointPQPlayer,269,209,478,35,19,Player A
2610,JointPQPlayer,200,255,455,27,24,JointPQPlayer
2611,JointPQPlayer,278,208,486,34,16,Player A
2612,JointPQPlayer,287,202,489,31,14,Player A
2613,JointPQPlayer,137,272,409,17,36,JointPQPlayer
2614,JointPQPlayer,276,201,477,37,20,Player A
2615,JointPQPlayer,247,222,469,32,21,Player A
2616,JointPQPlayer,161,261,422,21,33,JointPQPlayer
2617,JointPQPlayer,134,264,398,9,37,JointPQPlayer
2618,JointPQPlayer,255,200,455,36,27,Player A
2619,JointPQPlayer,308,183,491,39,16,Player A
2620,JointPQPlayer,276,211,487,32,15,Player A
2621,JointPQPlayer,249,219,468,34,22,Player A
2622,JointPQPlayer,157,262,419,18,33,JointPQPlayer
2623,JointPQPlayer,296,166,462,31,23,Player A
2624,JointPQPlayer,298,178,476,33,19,Player A
2625,JointPQPlayer,297,202,499,41,14,Player A
2626,JointPQPlayer,219,214,433,26,31,Player A
2627,JointPQPlayer,308,178,486,31,15,Player A
2628,JointPQPlayer,300,185,485,36,17,Player A
2629,JointPQPlayer,307,187,494,33,13,Player A
2630,JointPQPlayer,267,207,474,28,18,Player A
2631,JointPQPlayer,253,208,461,33,24,Player A
2632,JointPQPlayer,154,269,423,16,31,JointPQPlayer
2633,JointPQPlayer,285,215,500,42,14,Player A
2634,JointPQPlayer,277,222,499,38,13,Player A
2635,JointPQPlayer,269,204,473,36,21,Player A
2636,JointPQPlayer,279,219,498,34,12,Player A
2637,JointPQPlayer,283,208,491,33,14,Player A
2638,JointPQPlayer,294,169,463,26,21,Player A
2639,JointPQPlayer,341,161,502,35,11,Player A
2640,JointPQPlayer,210,250,460,26,22,JointPQPlayer
2641,JointPQPlayer,300,185,485,30,15,Player A
2642,JointPQPlayer,307,187,494,36,14,Player A
2643,JointPQPlayer,283,198,481,29,16,Player A
2644,JointPQPlayer,138,258,396,7,37,JointPQPlayer
2645,JointPQPlayer,182,242,424,14,30,JointPQPlayer
2646,JointPQPlayer,302,187,489,37,16,Player A
2647,JointPQPlayer,228,233,461,33,24,JointPQPlayer
2648,JointPQPlayer,293,218,511,38,9,Player A
2649,JointPQPlayer,287,192,479,36,19,Player A
2650,JointPQPlayer,262,222,484,32,16,Player A
2651,JointPQPlayer,243,218,461,33,24,Player A
2652,JointPQPlayer,322,167,489,31,14,Player A
2653,JointPQPlayer,140,260,400,14,38,JointPQPlayer
2654,JointPQPlayer,263,223,486,40,18,Player A
2655,JointPQPlayer,130,270,400,11,37,JointPQPlayer
2656,JointPQPlayer,283,203,486,31,15,Player A
2657,JointPQPlayer,258,208,466,26,20,Player A
2658,JointPQPlayer,305,195,500,36,12,Player A
2659,JointPQPlayer,281,191,472,41,23,Player A
2660,JointPQPlayer,284,204,488,30,14,Player A
2661,JointPQPlayer,294,199,493,38,15,Player A
2662,JointPQPlayer,263,188,451,23,24,Player A
2663,JointPQPlayer,168,248,416,15,33,JointPQPlayer
2664,JointPQPlayer,307,187,494,36,14,Player A
2665,JointPQPlayer,276,201,477,37,20,Player A
2666,JointPQPlayer,283,213,496,35,13,Player A
2667,JointPQPlayer,147,252,399,10,37,JointPQPlayer
2668,JointPQPlayer,154,254,408,10,34,JointPQPlayer
2669,JointPQPlayer,281,206,487,32,15,Player A
2670,JointPQPlayer,301,196,497,36,13,Player A
2671,JointPQPlayer,300,200,500,39,13,Player A
2672,JointPQPlayer,287,202,489,37,16,Player A
2673,JointPQPlayer,344,164,508,35,9,Player A
2674,JointPQPlayer,319,164,483,34,17,Player A
2675,JointPQPlayer,306,181,487,32,15,Player A
2676,JointPQPlayer,296,196,492,34,14,Player A
2677,JointPQPlayer,273,188,461,30,23,Player A
2678,JointPQPlayer,267,212,479,33,18,Player A
2679,JointPQPlayer,172,227,399,16,39,JointPQPlayer
2680,JointPQPlayer,248,213,461,27,22,Player A
2681,JointPQPlayer,207,217,424,20,32,JointPQPlayer
2682,JointPQPlayer,306,191,497,30,11,Player A
2683,JointPQPlayer,304,199,503,33,10,Player A
2684,JointPQPlayer,326,166,492,31,13,Player A
2685,JointPQPlayer,134,264,398,12,38,JointPQPlayer
2686,JointPQPlayer,179,239,418,20,34,JointPQPlayer
2687,JointPQPlayer,292,197,489,34,15,Player A
2688,JointPQPlayer,181,236,417,16,33,JointPQPlayer
2689,JointPQPlayer,326,186,512,45,11,Player A
2690,JointPQPlayer,289,189,478,26,16,Player A
2691,JointPQPlayer,260,220,480,37,19,Player A
2692,JointPQPlayer,304,184,488,33,15,Player A
2693,JointPQPlayer,328,173,501,43,14,Player A
2694,JointPQPlayer,312,187,499,38,13,Player A
2695,JointPQPlayer,286,186,472,29,19,Player A
2696,JointPQPlayer,290,185,475,32,19,Player A
2697,JointPQPlayer,150,250,400,14,38,JointPQPlayer
2698,JointPQPlayer,304,214,518,48,10,Player A
2699,JointPQPlayer,273,228,501,40,13,Player A
2700,JointPQPlayer,263,228,491,33,14,Player A
2701,JointPQPlayer,283,203,486,37,17,Player A
2702,JointPQPlayer,289,174,463,32,23,Player A
2703,JointPQPlayer,287,187,474,25,17,Player A
2704,JointPQPlayer,313,153,466,32,22,Player A
2705,JointPQPlayer,274,204,478,35,19,Player A
2706,JointPQPlayer,327,177,504,40,12,Player A
2707,JointPQPlayer,282,192,474,31,19,Player A
2708,JointPQPlayer,302,182,484,35,17,Player A
2709,JointPQPlayer,269,209,478,35,19,Player A
2710,JointPQPlayer,321,176,497,33,12,Player A
2711,JointPQPlayer,285,190,475,32,19,Player A
2712,JointPQPlayer,294,199,493,35,14,Player A
2713,JointPQPlayer,285,210,495,40,15,Player A
2714,JointPQPlayer,291,196,487,35,16,Player A
2715,JointPQPlayer,138,243,381,10,43,JointPQPlayer
2716,JointPQPlayer,277,207,484,32,16,Player A
2717,JointPQPlayer,257,187,444,28,28,Player A
2718,JointPQPlayer,266,231,497,42,15,Player A
2719,JointPQPlayer,245,205,450,25,25,Player A
2720,JointPQPlayer,172,262,434,18,28,JointPQPlayer
2721,JointPQPlayer,285,190,475,29,18,Player A
2722,JointPQPlayer,277,212,489,37,16,Player A
2723,JointPQPlayer,273,228,501,37,12,Player A
2724,JointPQPlayer,256,236,492,28,12,Player A
2725,JointPQPlayer,299,174,473,30,19,Player A
2726,JointPQPlayer,145,260,405,13,36,JointPQPlayer
2727,JointPQPlayer,308,183,491,33,14,Player A
2728,JointPQPlayer,292,187,479,33,18,Player A
2729,JointPQPlayer,267,222,489,40,17,Player A
2730,JointPQPlayer,301,206,507,34,9,Player A
2731,JointPQPlayer,282,202,484,38,18,Player A
2732,JointPQPlayer,228,228,456,28,24,Tie
2733,JointPQPlayer,303,193,496,41,15,Player A
2734,JointPQPlayer,310,180,490,29,13,Player A
2735,JointPQPlayer,111,286,397,11,38,JointPQPlayer
2736,JointPQPlayer,155,235,390,13,41,JointPQPlayer
2737,JointPQPlayer,287,192,479,27,16,Player A
2738,JointPQPlayer,274,224,498,37,13,Player A
2739,JointPQPlayer,305,195,500,33,11,Player A
2740,JointPQPlayer,276,221,497,33,12,Player A
2741,JointPQPlayer,279,174,453,25,24,Player A
2742,JointPQPlayer,308,188,496,38,14,Player A
2743,JointPQPlayer,235,235,470,24,18,Tie
2744,JointPQPlayer,272,207,479,33,18,Player A
2745,JointPQPlayer,289,204,493,41,16,Player A
2746,JointPQPlayer,315,155,470,33,21,Player A
2747,JointPQPlayer,297,187,484,26,14,Player A
2748,JointPQPlayer,290,185,475,38,21,Player A
2749,JointPQPlayer,148,268,416,15,33,JointPQPlayer
2750,JointPQPlayer,164,244,408,10,34,JointPQPlayer
2751,JointPQPlayer,275,220,495,40,15,Player A
2752,JointPQPlayer,271,216,487,35,16,Player A
2753,JointPQPlayer,287,197,484,29,15,Player A
2754,JointPQPlayer,283,203,486,37,17,Player A
2755,JointPQPlayer,134,249,383,12,43,JointPQPlayer
2756,JointPQPlayer,303,183,486,34,16,Player A
2757,JointPQPlayer,290,195,485,30,15,Player A
2758,JointPQPlayer,116,316,432,7,25,JointPQPlayer
2759,JointPQPlayer,188,243,431,21,30,JointPQPlayer
2760,JointPQPlayer,313,193,506,42,12,Player A
2761,JointPQPlayer,334,144,478,26,16,Player A
2762,JointPQPlayer,281,221,502,41,13,Player A
2763,JointPQPlayer,313,203,516,40,8,Player A
2764,JointPQPlayer,145,265,410,9,33,JointPQPlayer
2765,JointPQPlayer,302,207,509,33,8,Player A
2766,JointPQPlayer,324,164,488,33,15,Player A
2767,JointPQPlayer,325,180,505,35,10,Player A
2768,JointPQPlayer,110,295,405,10,35,JointPQPlayer
2769,JointPQPlayer,159,279,438,19,27,JointPQPlayer
2770,JointPQPlayer,297,192,489,34,15,Player A
2771,JointPQPlayer,170,245,415,17,34,JointPQPlayer
2772,JointPQPlayer,299,189,488,36,16,Player A
2773,JointPQPlayer,299,199,498,34,12,Player A
2774,JointPQPlayer,246,216,462,25,21,Player A
2775,JointPQPlayer,306,171,477,28,17,Player A
2776,JointPQPlayer,281,216,497,36,13,Player A
2777,JointPQPlayer,289,194,483,31,16,Player A
2778,JointPQPlayer,302,197,499,32,11,Player A
2779,JointPQPlayer,316,186,502,38,12,Player A
2780,JointPQPlayer,147,282,429,19,30,JointPQPlayer
2781,JointPQPlayer,131,261,392,12,40,JointPQPlayer
2782,JointPQPlayer,319,169,488,30,14,Player A
2783,JointPQPlayer,253,213,466,26,20,Player A
2784,JointPQPlayer,142,237,379,11,44,JointPQPlayer
2785,JointPQPlayer,286,176,462,28,22,Player A
2786,JointPQPlayer,131,246,377,12,45,JointPQPlayer
2787,JointPQPlayer,304,179,483,31,16,Player A
2788,JointPQPlayer,312,177,489,37,16,Player A
2789,JointPQPlayer,285,200,485,42,19,Player A
2790,JointPQPlayer,228,228,456,25,23,Tie
2791,JointPQPlayer,307,192,499,35,12,Player A
2792,JointPQPlayer,333,173,506,39,11,Player A
2793,JointPQPlayer,294,204,498,43,15,Player A
2794,JointPQPlayer,307,182,489,34,15,Player A
2795,JointPQPlayer,250,205,455,30,25,Player A
2796,JointPQPlayer,278,198,476,39,21,Player A
2797,JointPQPlayer,322,162,484,32,16,Player A
2798,JointPQPlayer,264,214,478,38,20,Player A
2799,JointPQPlayer,289,219,508,41,11,Player A
2800,JointPQPlayer,328,168,496,29,11,Player A
2801,JointPQPlayer,294,209,503,36,11,Player A
2802,JointPQPlayer,292,207,499,35,12,Player A
2803,JointPQPlayer,274,189,463,26,21,Player A
2804,JointPQPlayer,211,231,442,20,26,JointPQPlayer
2805,JointPQPlayer,265,210,475,32,19,Player A
2806,JointPQPlayer,294,179,473,27,18,Player A
2807,JointPQPlayer,141,261,402,13,37,JointPQPlayer
2808,JointPQPlayer,154,239,393,13,40,JointPQPlayer
2809,JointPQPlayer,318,178,496,29,11,Player A
2810,JointPQPlayer,290,195,485,30,15,Player A
2811,JointPQPlayer,303,198,501,43,14,Player A
2812,JointPQPlayer,266,211,477,31,18,Player A
2813,JointPQPlayer,272,222,494,42,16,Player A
2814,JointPQPlayer,301,181,482,30,16,Player A
2815,JointPQPlayer,146,251,397,14,39,JointPQPlayer
2816,JointPQPlayer,261,196,457,29,24,Player A
2817,JointPQPlayer,262,222,484,29,15,Player A
2818,JointPQPlayer,239,254,493,41,16,JointPQPlayer
2819,JointPQPlayer,300,210,510,40,10,Player A
2820,JointPQPlayer,212,247,459,28,23,JointPQPlayer
2821,JointPQPlayer,286,211,497,39,14,Player A
2822,JointPQPlayer,322,182,504,31,9,Player A
2823,JointPQPlayer,320,190,510,34,8,Player A
2824,JointPQPlayer,265,215,480,37,19,Player A
2825,JointPQPlayer,186,246,432,16,28,JointPQPlayer
2826,JointPQPlayer,308,163,471,25,18,Player A
2827,JointPQPlayer,138,273,411,13,34,JointPQPlayer
2828,JointPQPlayer,271,201,472,29,19,Player A
2829,JointPQPlayer,288,193,481,35,18,Player A
2830,JointPQPlayer,298,203,501,43,14,Player A
2831,JointPQPlayer,253,228,481,32,17,Player A
2832,JointPQPlayer,287,212,499,44,15,Player A
2833,JointPQPlayer,281,201,482,30,16,Player A
2834,JointPQPlayer,304,189,493,35,14,Player A
2835,JointPQPlayer,151,231,382,14,44,JointPQPlayer
2836,JointPQPlayer,282,192,474,34,20,Player A
2837,JointPQPlayer,228,263,491,30,13,JointPQPlayer
2838,JointPQPlayer,270,180,450,28,26,Player A
2839,JointPQPlayer,292,182,474,34,20,Player A
2840,JointPQPlayer,259,219,478,38,20,Player A
2841,JointPQPlayer,293,178,471,34,21,Player A
2842,JointPQPlayer,231,221,452,24,24,Player A
2843,JointPQPlayer,249,239,488,36,16,Player A
2844,JointPQPlayer,279,209,488,36,16,Player A
2845,JointPQPlayer,286,176,462,25,21,Player A
2846,JointPQPlayer,274,189,463,29,22,Player A
2847,JointPQPlayer,300,195,495,37,14,Player A
2848,JointPQPlayer,301,186,487,32,15,Player A
2849,JointPQPlayer,266,216,482,33,17,Player A
2850,JointPQPlayer,261,216,477,31,18,Player A
2851,JointPQPlayer,306,181,487,26,13,Player A
2852,JointPQPlayer,300,185,485,36,17,Player A
2853,JointPQPlayer,248,228,476,39,21,Player A
2854,JointPQPlayer,293,198,491,39,16,Player A
2855,JointPQPlayer,129,269,398,9,37,JointPQPlayer
2856,JointPQPlayer,310,175,485,42,19,Player A
2857,JointPQPlayer,137,257,394,8,38,JointPQPlayer
2858,JointPQPlayer,311,166,477,34,19,Player A
2859,JointPQPlayer,317,182,499,29,10,Player A
2860,JointPQPlayer,316,166,482,27,15,Player A
2861,JointPQPlayer,306,151,457,23,22,Player A
2862,JointPQPlayer,274,189,463,29,22,Player A
2863,JointPQPlayer,130,280,410,15,35,JointPQPlayer
2864,JointPQPlayer,311,171,482,30,16,Player A
2865,JointPQPlayer,200,245,445,26,27,JointPQPlayer
2866,JointPQPlayer,135,270,405,13,36,JointPQPlayer
2867,JointPQPlayer,239,229,468,22,18,Player A
2868,JointPQPlayer,277,192,469,35,22,Player A
2869,JointPQPlayer,319,174,493,32,13,Player A
2870,JointPQPlayer,286,186,472,35,21,Player A
2871,JointPQPlayer,292,192,484,35,17,Player A
2872,JointPQPlayer,262,202,464,30,22,Player A
2873,JointPQPlayer,312,177,489,31,14,Player A
2874,JointPQPlayer,159,259,418,14,32,JointPQPlayer
2875,JointPQPlayer,277,227,504,40,12,Player A
2876,JointPQPlayer,302,192,494,36,14,Player A
2877,JointPQPlayer,145,245,390,10,40,JointPQPlayer
2878,JointPQPlayer,314,169,483,34,17,Player A
2879,JointPQPlayer,264,199,463,26,21,Player A
2880,JointPQPlayer,260,215,475,35,20,Player A
2881,JointPQPlayer,145,255,400,14,38,JointPQPlayer
2882,JointPQPlayer,285,210,495,34,13,Player A
2883,JointPQPlayer,303,178,481,35,18,Player A
2884,JointPQPlayer,279,209,488,33,15,Player A
2885,JointPQPlayer,276,211,487,38,17,Player A
2886,JointPQPlayer,303,203,506,42,12,Player A
2887,JointPQPlayer,289,194,483,40,19,Player A
2888,JointPQPlayer,138,283,421,14,31,JointPQPlayer
2889,JointPQPlayer,303,183,486,34,16,Player A
2890,JointPQPlayer,236,246,482,27,15,JointPQPlayer
2891,JointPQPlayer,281,186,467,24,19,Player A
2892,JointPQPlayer,172,222,394,17,41,JointPQPlayer
2893,JointPQPlayer,310,185,495,31,12,Player A
2894,JointPQPlayer,133,268,401,12,37,JointPQPlayer
2895,JointPQPlayer,284,204,488,36,16,Player A
2896,JointPQPlayer,133,278,411,10,33,JointPQPlayer
2897,JointPQPlayer,292,202,494,39,15,Player A
2898,JointPQPlayer,275,210,485,33,16,Player A
2899,JointPQPlayer,313,183,496,32,12,Player A
2900,JointPQPlayer,274,179,453,25,24,Player A
2901,JointPQPlayer,297,182,479,39,20,Player A
2902,JointPQPlayer,309,184,493,35,14,Player A
2903,JointPQPlayer,289,189,478,35,19,Player A
2904,JointPQPlayer,146,246,392,12,40,JointPQPlayer
2905,JointPQPlayer,284,209,493,41,16,Player A
2906,JointPQPlayer,284,199,483,28,15,Player A
2907,JointPQPlayer,322,177,499,41,14,Player A
2908,JointPQPlayer,304,204,508,44,12,Player A
2909,JointPQPlayer,286,216,502,38,12,Player A
2910,JointPQPlayer,292,182,474,31,19,Player A
2911,JointPQPlayer,310,190,500,39,13,Player A
2912,JointPQPlayer,281,191,472,38,22,Player A
2913,JointPQPlayer,167,262,429,25,32,JointPQPlayer
2914,JointPQPlayer,143,258,401,18,39,JointPQPlayer
2915,JointPQPlayer,327,152,479,27,16,Player A
2916,JointPQPlayer,308,188,496,32,12,Player A
2917,JointPQPlayer,102,292,394,11,39,JointPQPlayer
2918,JointPQPlayer,294,209,503,42,13,Player A
2919,JointPQPlayer,274,219,493,35,14,Player A
2920,JointPQPlayer,151,251,402,13,37,JointPQPlayer
2921,JointPQPlayer,274,229,503,42,13,Player A
2922,JointPQPlayer,299,189,488,33,15,Player A
2923,JointPQPlayer,275,230,505,38,11,Player A
2924,JointPQPlayer,247,227,474,37,21,Player A
2925,JointPQPlayer,306,206,512,45,11,Player A
2926,JointPQPlayer,278,203,481,32,17,Player A
2927,JointPQPlayer,280,185,465,34,23,Player A
2928,JointPQPlayer,296,176,472,29,19,Player A
2929,JointPQPlayer,302,192,494,36,14,Player A
2930,JointPQPlayer,128,258,386,12,42,JointPQPlayer
2931,JointPQPlayer,283,218,501,43,14,Player A
2932,JointPQPlayer,147,272,419,12,31,JointPQPlayer
2933,JointPQPlayer,154,264,418,20,34,JointPQPlayer
2934,JointPQPlayer,253,223,476,36,20,Player A
2935,JointPQPlayer,156,266,422,15,31,JointPQPlayer
2936,JointPQPlayer,248,228,476,33,19,Player A
2937,JointPQPlayer,304,174,478,38,20,Player A
2938,JointPQPlayer,298,178,476,30,18,Player A
2939,JointPQPlayer,251,201,452,21,23,Player A
2940,JointPQPlayer,294,184,478,23,15,Player A
2941,JointPQPlayer,129,244,373,11,46,JointPQPlayer
2942,JointPQPlayer,309,199,508,44,12,Player A
2943,JointPQPlayer,191,201,392,12,40,JointPQPlayer
2944,JointPQPlayer,295,200,495,31,12,Player A
2945,JointPQPlayer,287,182,469,32,21,Player A
2946,JointPQPlayer,309,169,478,23,15,Player A
2947,JointPQPlayer,258,188,446,27,27,Player A
2948,JointPQPlayer,278,203,481,35,18,Player A
2949,JointPQPlayer,276,211,487,35,16,Player A
2950,JointPQPlayer,278,233,511,29,6,Player A
2951,JointPQPlayer,325,180,505,35,10,Player A
2952,JointPQPlayer,306,156,462,28,22,Player A
2953,JointPQPlayer,294,194,488,33,15,Player A
2954,JointPQPlayer,284,214,498,37,13,Player A
2955,JointPQPlayer,265,200,465,37,24,Player A
2956,JointPQPlayer,268,213,481,41,20,Player A
2957,JointPQPlayer,139,244,383,15,44,JointPQPlayer
2958,JointPQPlayer,313,173,486,34,16,Player A
2959,JointPQPlayer,137,262,399,13,38,JointPQPlayer
2960,JointPQPlayer,266,231,497,39,14,Player A
2961,JointPQPlayer,280,220,500,36,12,Player A
2962,JointPQPlayer,306,196,502,38,12,Player A
2963,JointPQPlayer,261,196,457,35,26,Player A
2964,JointPQPlayer,307,187,494,33,13,Player A
2965,JointPQPlayer,270,205,475,35,20,Player A
2966,JointPQPlayer,294,189,483,34,17,Player A
2967,JointPQPlayer,262,232,494,39,15,Player A
2968,JointPQPlayer,280,200,480,37,19,Player A
2969,JointPQPlayer,284,214,498,43,15,Player A
2970,JointPQPlayer,287,182,469,32,21,Player A
2971,JointPQPlayer,270,210,480,25,15,Player A
2972,JointPQPlayer,102,287,389,9,40,JointPQPlayer
2973,JointPQPlayer,141,276,417,13,32,JointPQPlayer
2974,JointPQPlayer,202,237,439,17,26,JointPQPlayer
2975,JointPQPlayer,297,177,474,31,19,Player A
2976,JointPQPlayer,156,256,412,17,35,JointPQPlayer
2977,JointPQPlayer,320,180,500,33,11,Player A
2978,JointPQPlayer,244,229,473,36,21,Player A
2979,JointPQPlayer,284,219,503,39,12,Player A
2980,JointPQPlayer,312,192,504,31,9,Player A
2981,JointPQPlayer,283,188,471,31,20,Player A
2982,JointPQPlayer,312,177,489,34,15,Player A
2983,JointPQPlayer,277,202,479,33,18,Player A
2984,JointPQPlayer,284,199,483,31,16,Player A
2985,JointPQPlayer,178,263,441,28,29,JointPQPlayer
2986,JointPQPlayer,289,189,478,29,17,Player A
2987,JointPQPlayer,236,246,482,36,18,JointPQPlayer
2988,JointPQPlayer,266,221,487,44,19,Player A
2989,JointPQPlayer,265,230,495,37,14,Player A
2990,JointPQPlayer,281,221,502,41,13,Player A
2991,JointPQPlayer,282,207,489,46,19,Player A
2992,JointPQPlayer,152,262,414,13,33,JointPQPlayer
2993,JointPQPlayer,265,225,490,32,14,Player A
2994,JointPQPlayer,294,224,518,42,8,Player A
2995,JointPQPlayer,169,244,413,18,35,JointPQPlayer
2996,JointPQPlayer,320,195,515,42,9,Player A
2997,JointPQPlayer,275,175,450,25,25,Player A
2998,JointPQPlayer,129,259,388,14,42,JointPQPlayer
2999,JointPQPlayer,265,215,480,37,19,Player A
3000,JointPQPlayer,295,205,500,36,12,Player A
3001,JointPQPlayer,243,233,476,30,18,Player A
3002,JointPQPlayer,139,269,408,13,35,JointPQPlayer
3003,JointPQPlayer,273,183,456,25,23,Player A
3004,JointPQPlayer,293,178,471,28,19,Player A
3005,JointPQPlayer,277,192,469,32,21,Player A
3006,JointPQPlayer,155,275,430,17,29,JointPQPlayer
3007,JointPQPlayer,255,230,485,36,17,Player A
3008,JointPQPlayer,232,232,464,27,21,Tie
3009,JointPQPlayer,301,181,482,30,16,Player A
3010,JointPQPlayer,143,278,421,14,31,JointPQPlayer
3011,JointPQPlayer,174,224,398,12,38,JointPQPlayer
3012,JointPQPlayer,284,184,468,34,22,Player A
3013,JointPQPlayer,308,203,511,44,11,Player A
3014,JointPQPlayer,321,171,492,25,11,Player A
3015,JointPQPlayer,248,198,446,21,25,Player A
3016,JointPQPlayer,308,183,491,33,14,Player A
3017,JointPQPlayer,298,213,511,47,12,Player A
3018,JointPQPlayer,281,206,487,35,16,Player A
3019,JointPQPlayer,304,179,483,34,17,Player A
3020,JointPQPlayer,342,167,509,39,10,Player A
3021,JointPQPlayer,276,206,482,33,17,Player A
3022,JointPQPlayer,138,253,391,5,38,JointPQPlayer
3023,JointPQPlayer,302,177,479,33,18,Player A
3024,JointPQPlayer,286,196,482,30,16,Player A
3025,JointPQPlayer,262,232,494,36,14,Player A
3026,JointPQPlayer,281,211,492,34,14,Player A
3027,JointPQPlayer,162,297,459,25,22,JointPQPlayer
3028,JointPQPlayer,248,233,481,38,19,Player A
3029,JointPQPlayer,298,203,501,40,13,Player A
3030,JointPQPlayer,280,195,475,38,21,Player A
3031,JointPQPlayer,291,186,477,31,18,Player A
3032,JointPQPlayer,252,217,469,32,21,Player A
3033,JointPQPlayer,150,255,405,10,35,JointPQPlayer
3034,JointPQPlayer,137,262,399,13,38,JointPQPlayer
3035,JointPQPlayer,265,225,490,38,16,Player A
3036,JointPQPlayer,285,210,495,40,15,Player A
3037,JointPQPlayer,283,198,481,35,18,Player A
3038,JointPQPlayer,272,217,489,34,15,Player A
3039,JointPQPlayer,143,263,406,14,36,JointPQPlayer
3040,JointPQPlayer,150,280,430,20,30,JointPQPlayer
3041,JointPQPlayer,165,230,395,15,40,JointPQPlayer
3042,JointPQPlayer,124,289,413,12,33,JointPQPlayer
3043,JointPQPlayer,171,231,402,13,37,JointPQPlayer
3044,JointPQPlayer,277,197,474,28,18,Player A
3045,JointPQPlayer,323,178,501,37,12,Player A
3046,JointPQPlayer,260,200,460,41,27,Player A
3047,JointPQPlayer,316,166,482,36,18,Player A
3048,JointPQPlayer,305,170,475,35,20,Player A
3049,JointPQPlayer,168,238,406,17,37,JointPQPlayer
3050,JointPQPlayer,138,258,396,13,39,JointPQPlayer
3051,JointPQPlayer,285,160,445,26,27,Player A
3052,JointPQPlayer,208,238,446,27,27,JointPQPlayer
3053,JointPQPlayer,293,178,471,22,17,Player A
3054,JointPQPlayer,242,217,459,34,25,Player A
3055,JointPQPlayer,298,208,506,39,11,Player A
3056,JointPQPlayer,311,151,462,19,19,Player A
3057,JointPQPlayer,131,236,367,8,47,JointPQPlayer
3058,JointPQPlayer,288,193,481,35,18,Player A
3059,JointPQPlayer,262,192,454,26,24,Player A
3060,JointPQPlayer,293,188,481,29,16,Player A
3061,JointPQPlayer,142,257,399,13,38,JointPQPlayer
3062,JointPQPlayer,311,171,482,42,20,Player A
3063,JointPQPlayer,158,263,421,17,32,JointPQPlayer
3064,JointPQPlayer,288,193,481,32,17,Player A
3065,JointPQPlayer,301,191,492,34,14,Player A
3066,JointPQPlayer,231,241,472,35,21,JointPQPlayer
3067,JointPQPlayer,150,260,410,12,34,JointPQPlayer
3068,JointPQPlayer,165,270,435,19,28,JointPQPlayer
3069,JointPQPlayer,293,198,491,39,16,Player A
3070,JointPQPlayer,308,183,491,36,15,Player A
3071,JointPQPlayer,314,199,513,43,10,Player A
3072,JointPQPlayer,274,169,443,30,29,Player A
3073,JointPQPlayer,298,198,496,32,12,Player A
3074,JointPQPlayer,300,190,490,35,15,Player A
3075,JointPQPlayer,143,253,396,13,39,JointPQPlayer
3076,JointPQPlayer,161,221,382,11,43,JointPQPlayer
3077,JointPQPlayer,139,244,383,9,42,JointPQPlayer
3078,JointPQPlayer,334,159,493,32,13,Player A
3079,JointPQPlayer,303,198,501,43,14,Player A
3080,JointPQPlayer,300,185,485,33,16,Player A
3081,JointPQPlayer,282,187,469,32,21,Player A
3082,JointPQPlayer,305,195,500,36,12,Player A
3083,JointPQPlayer,330,160,490,35,15,Player A
3084,JointPQPlayer,175,235,410,24,38,JointPQPlayer
3085,JointPQPlayer,285,200,485,39,18,Player A
3086,JointPQPlayer,316,181,497,33,12,Player A
3087,JointPQPlayer,303,198,501,40,13,Player A
3088,JointPQPlayer,282,182,464,24,20,Player A
3089,JointPQPlayer,302,177,479,30,17,Player A
3090,JointPQPlayer,158,268,426,13,29,JointPQPlayer
3091,JointPQPlayer,305,180,485,39,18,Player A
3092,JointPQPlayer,315,185,500,39,13,Player A
3093,JointPQPlayer,273,223,496,35,13,Player A
3094,JointPQPlayer,279,204,483,34,17,Player A
3095,JointPQPlayer,290,195,485,36,17,Player A
3096,JointPQPlayer,286,186,472,35,21,Player A
3097,JointPQPlayer,206,246,452,30,26,JointPQPlayer
3098,JointPQPlayer,310,190,500,39,13,Player A
3099,JointPQPlayer,239,234,473,30,19,Player A
3100,JointPQPlayer,294,199,493,32,13,Player A
3101,JointPQPlayer,163,223,386,12,42,JointPQPlayer
3102,JointPQPlayer,307,182,489,28,13,Player A
3103,JointPQPlayer,299,189,488,33,15,Player A
3104,JointPQPlayer,271,201,472,26,18,Player A
3105,JointPQPlayer,299,179,478,35,19,Player A
3106,JointPQPlayer,270,215,485,33,16,Player A
3107,JointPQPlayer,312,192,504,37,11,Player A
3108,JointPQPlayer,313,178,491,36,15,Player A
3109,JointPQPlayer,309,189,498,43,15,Player A
3110,JointPQPlayer,150,260,410,9,33,JointPQPlayer
3111,JointPQPlayer,268,198,466,32,22,Player A
3112,JointPQPlayer,277,182,459,31,24,Player A
3113,JointPQPlayer,285,190,475,29,18,Player A
3114,JointPQPlayer,304,199,503,42,13,Player A
3115,JointPQPlayer,308,193,501,34,11,Player A
3116,JointPQPlayer,283,203,486,28,14,Player A
3117,JointPQPlayer,273,208,481,35,18,Player A
3118,JointPQPlayer,287,217,504,37,11,Player A
3119,JointPQPlayer,293,198,491,36,15,Player A
3120,JointPQPlayer,283,193,476,30,18,Player A
3121,JointPQPlayer,179,254,433,20,29,JointPQPlayer
3122,JointPQPlayer,284,214,498,40,14,Player A
3123,JointPQPlayer,286,206,492,34,14,Player A
3124,JointPQPlayer,298,198,496,35,13,Player A
3125,JointPQPlayer,280,210,490,32,14,Player A
3126,JointPQPlayer,267,232,499,41,14,Player A
3127,JointPQPlayer,297,192,489,34,15,Player A
3128,JointPQPlayer,269,199,468,34,22,Player A
3129,JointPQPlayer,264,214,478,35,19,Player A
3130,JointPQPlayer,224,224,448,29,27,Tie
3131,JointPQPlayer,276,191,467,30,21,Player A
3132,JointPQPlayer,278,213,491,30,13,Player A
3133,JointPQPlayer,240,220,460,26,22,Player A
3134,JointPQPlayer,124,284,408,16,36,JointPQPlayer
3135,JointPQPlayer,278,183,461,24,21,Player A
3136,JointPQPlayer,319,204,523,44,7,Player A
3137,JointPQPlayer,249,199,448,23,25,Player A
3138,JointPQPlayer,287,212,499,38,13,Player A
3139,JointPQPlayer,152,262,414,13,33,JointPQPlayer
3140,JointPQPlayer,170,225,395,24,43,JointPQPlayer
3141,JointPQPlayer,248,243,491,39,16,Player A
3142,JointPQPlayer,286,211,497,42,15,Player A
3143,JointPQPlayer,184,244,428,15,29,JointPQPlayer
3144,JointPQPlayer,307,172,479,36,19,Player A
3145,JointPQPlayer,209,239,448,26,26,JointPQPlayer
3146,JointPQPlayer,286,206,492,34,14,Player A
3147,JointPQPlayer,296,196,492,37,15,Player A
3148,JointPQPlayer,316,186,502,35,11,Player A
3149,JointPQPlayer,253,233,486,34,16,Player A
3150,JointPQPlayer,153,288,441,22,27,JointPQPlayer
3151,JointPQPlayer,171,201,372,10,46,JointPQPlayer
3152,JointPQPlayer,295,195,490,38,16,Player A
3153,JointPQPlayer,273,218,491,33,14,Player A
3154,JointPQPlayer,278,228,506,45,13,Player A
3155,JointPQPlayer,317,172,489,37,16,Player A
3156,JointPQPlayer,297,177,474,28,18,Player A
3157,JointPQPlayer,301,176,477,31,18,Player A
3158,JointPQPlayer,294,184,478,32,18,Player A
3159,JointPQPlayer,301,196,497,36,13,Player A
3160,JointPQPlayer,286,206,492,43,17,Player A
3161,JointPQPlayer,296,166,462,28,22,Player A
3162,JointPQPlayer,245,240,485,33,16,Player A
3163,JointPQPlayer,164,249,413,18,35,JointPQPlayer
3164,JointPQPlayer,282,202,484,29,15,Player A
3165,JointPQPlayer,299,199,498,37,13,Player A
3166,JointPQPlayer,304,199,503,42,13,Player A
3167,JointPQPlayer,291,211,502,41,13,Player A
3168,JointPQPlayer,310,160,470,30,20,Player A
3169,JointPQPlayer,304,189,493,38,15,Player A
3170,JointPQPlayer,136,261,397,14,39,JointPQPlayer
3171,JointPQPlayer,281,206,487,38,17,Player A
3172,JointPQPlayer,281,191,472,32,20,Player A
3173,JointPQPlayer,311,156,467,27,20,Player A
3174,JointPQPlayer,300,195,495,37,14,Player A
3175,JointPQPlayer,165,255,420,22,34,JointPQPlayer
3176,JointPQPlayer,310,180,490,32,14,Player A
3177,JointPQPlayer,153,238,391,14,41,JointPQPlayer
3178,JointPQPlayer,305,185,490,41,17,Player A
3179,JointPQPlayer,246,211,457,32,25,Player A
3180,JointPQPlayer,139,279,418,8,30,JointPQPlayer
3181,JointPQPlayer,295,210,505,47,14,Player A
3182,JointPQPlayer,166,241,407,15,36,JointPQPlayer
3183,JointPQPlayer,274,214,488,33,15,Player A
3184,JointPQPlayer,275,190,465,25,20,Player A
3185,JointPQPlayer,296,196,492,34,14,Player A
3186,JointPQPlayer,290,190,480,37,19,Player A
3187,JointPQPlayer,263,218,481,26,15,Player A
3188,JointPQPlayer,287,212,499,38,13,Player A
3189,JointPQPlayer,279,199,478,35,19,Player A
3190,JointPQPlayer,303,203,506,36,10,Player A
3191,JointPQPlayer,319,169,488,33,15,Player A
3192,JointPQPlayer,254,214,468,28,20,Player A
3193,JointPQPlayer,293,188,481,32,17,Player A
3194,JointPQPlayer,292,192,484,38,18,Player A
3195,JointPQPlayer,271,196,467,30,21,Player A
3196,JointPQPlayer,154,249,403,17,38,JointPQPlayer
3197,JointPQPlayer,295,210,505,41,12,Player A
3198,JointPQPlayer,311,196,507,37,10,Player A
3199,JointPQPlayer,115,285,400,14,38,JointPQPlayer
3200,JointPQPlayer,304,179,483,37,18,Player A
3201,JointPQPlayer,275,210,485,33,16,Player A
3202,JointPQPlayer,150,245,395,12,39,JointPQPlayer
3203,JointPQPlayer,289,209,498,37,13,Player A
3204,JointPQPlayer,307,192,499,44,15,Player A
3205,JointPQPlayer,331,161,492,31,13,Player A
3206,JointPQPlayer,268,233,501,40,13,Player A
3207,JointPQPlayer,284,204,488,39,17,Player A
3208,JointPQPlayer,295,195,490,41,17,Player A
3209,JointPQPlayer,289,219,508,44,12,Player A
3210,JointPQPlayer,255,205,460,29,23,Player A
3211,JointPQPlayer,305,190,495,43,16,Player A
3212,JointPQPlayer,135,275,410,18,36,JointPQPlayer
3213,JointPQPlayer,145,260,405,16,37,JointPQPlayer
3214,JointPQPlayer,284,189,473,33,20,Player A
3215,JointPQPlayer,270,210,480,34,18,Player A
3216,JointPQPlayer,264,209,473,30,19,Player A
3217,JointPQPlayer,307,187,494,39,15,Player A
3218,JointPQPlayer,289,184,473,30,19,Player A
3219,JointPQPlayer,214,234,448,29,27,JointPQPlayer
3220,JointPQPlayer,287,197,484,38,18,Player A
3221,JointPQPlayer,290,200,490,35,15,Player A
3222,JointPQPlayer,260,200,460,26,22,Player A
3223,JointPQPlayer,159,244,403,11,36,JointPQPlayer
3224,JointPQPlayer,304,189,493,41,16,Player A
3225,JointPQPlayer,329,194,523,35,4,Player A
3226,JointPQPlayer,330,175,505,38,11,Player A
3227,JointPQPlayer,223,203,426,22,32,Player A
3228,JointPQPlayer,267,207,474,34,20,Player A
3229,JointPQPlayer,261,211,472,29,19,Player A
3230,JointPQPlayer,284,219,503,39,12,Player A
3231,JointPQPlayer,301,196,497,33,12,Player A
3232,JointPQPlayer,314,184,498,34,12,Player A
3233,JointPQPlayer,154,239,393,13,40,JointPQPlayer
3234,JointPQPlayer,320,175,495,37,14,Player A
3235,JointPQPlayer,273,208,481,32,17,Player A
3236,JointPQPlayer,255,225,480,34,18,Player A
3237,JointPQPlayer,172,247,419,12,31,JointPQPlayer
3238,JointPQPlayer,240,240,480,37,19,Tie
3239,JointPQPlayer,282,222,504,37,11,Player A
3240,JointPQPlayer,134,269,403,11,36,JointPQPlayer
3241,JointPQPlayer,260,225,485,36,17,Player A
3242,JointPQPlayer,340,125,465,25,20,Player A
3243,JointPQPlayer,277,202,479,30,17,Player A
3244,JointPQPlayer,299,169,468,28,20,Player A
3245,JointPQPlayer,171,241,412,17,35,JointPQPlayer
3246,JointPQPlayer,228,238,466,26,20,JointPQPlayer
3247,JointPQPlayer,149,269,418,8,30,JointPQPlayer
3248,JointPQPlayer,272,182,454,32,26,Player A
3249,JointPQPlayer,276,196,472,38,22,Player A
3250,JointPQPlayer,289,199,488,33,15,Player A
3251,JointPQPlayer,306,191,497,30,11,Player A
3252,JointPQPlayer,265,215,480,34,18,Player A
3253,JointPQPlayer,253,213,466,23,19,Player A
3254,JointPQPlayer,284,199,483,31,16,Player A
3255,JointPQPlayer,304,219,523,41,6,Player A
3256,JointPQPlayer,286,206,492,40,16,Player A
3257,JointPQPlayer,249,224,473,30,19,Player A
3258,JointPQPlayer,256,226,482,36,18,Player A
3259,JointPQPlayer,148,253,401,12,37,JointPQPlayer
3260,JointPQPlayer,268,218,486,37,17,Player A
3261,JointPQPlayer,139,244,383,15,44,JointPQPlayer
3262,JointPQPlayer,150,280,430,14,28,JointPQPlayer
3263,JointPQPlayer,298,178,476,33,19,Player A
3264,JointPQPlayer,224,229,453,22,23,JointPQPlayer
3265,JointPQPlayer,293,188,481,32,17,Player A
3266,JointPQPlayer,303,183,486,28,14,Player A
3267,JointPQPlayer,138,258,396,16,40,JointPQPlayer
3268,JointPQPlayer,258,213,471,31,20,Player A
3269,JointPQPlayer,327,197,524,45,7,Player A
3270,JointPQPlayer,147,262,409,17,36,JointPQPlayer
3271,JointPQPlayer,277,202,479,30,17,Player A
3272,JointPQPlayer,150,275,425,18,31,JointPQPlayer
3273,JointPQPlayer,289,199,488,39,17,Player A
3274,JointPQPlayer,303,148,451,26,25,Player A
3275,JointPQPlayer,305,185,490,35,15,Player A
3276,JointPQPlayer,295,195,490,41,17,Player A
3277,JointPQPlayer,260,210,470,30,20,Player A
3278,JointPQPlayer,296,201,497,36,13,Player A
3279,JointPQPlayer,268,218,486,31,15,Player A
3280,JointPQPlayer,289,219,508,38,10,Player A
3281,JointPQPlayer,148,243,391,14,41,JointPQPlayer
3282,JointPQPlayer,293,173,466,32,22,Player A
3283,JointPQPlayer,311,186,497,42,15,Player A
3284,JointPQPlayer,287,197,484,35,17,Player A
3285,JointPQPlayer,305,185,490,35,15,Player A
3286,JointPQPlayer,150,255,405,13,36,JointPQPlayer
3287,JointPQPlayer,300,200,500,33,11,Player A
3288,JointPQPlayer,138,263,401,12,37,JointPQPlayer
3289,JointPQPlayer,307,177,484,38,18,Player A
3290,JointPQPlayer,285,195,480,37,19,Player A
3291,JointPQPlayer,299,194,493,38,15,Player A
3292,JointPQPlayer,271,221,492,37,15,Player A
3293,JointPQPlayer,303,163,466,29,21,Player A
3294,JointPQPlayer,147,272,419,15,32,JointPQPlayer
3295,JointPQPlayer,271,231,502,44,14,Player A
3296,JointPQPlayer,320,175,495,34,13,Player A
3297,JointPQPlayer,326,171,497,36,13,Player A
3298,JointPQPlayer,252,212,464,27,21,Player A
3299,JointPQPlayer,246,191,437,21,28,Player A
3300,JointPQPlayer,238,228,466,29,21,Player A
3301,JointPQPlayer,134,269,403,14,37,JointPQPlayer
3302,JointPQPlayer,265,190,455,30,25,Player A
3303,JointPQPlayer,298,188,486,40,18,Player A
3304,JointPQPlayer,274,214,488,33,15,Player A
3305,JointPQPlayer,321,201,522,49,9,Player A
3306,JointPQPlayer,308,198,506,36,10,Player A
3307,JointPQPlayer,192,217,409,17,36,JointPQPlayer
3308,JointPQPlayer,265,215,480,40,20,Player A
3309,JointPQPlayer,294,199,493,35,14,Player A
3310,JointPQPlayer,270,210,480,34,18,Player A
3311,JointPQPlayer,221,236,457,29,24,JointPQPlayer
3312,JointPQPlayer,314,174,488,30,14,Player A
3313,JointPQPlayer,129,269,398,12,38,JointPQPlayer
3314,JointPQPlayer,269,214,483,34,17,Player A
3315,JointPQPlayer,304,189,493,32,13,Player A
3316,JointPQPlayer,316,191,507,40,11,Player A
3317,JointPQPlayer,133,273,406,14,36,JointPQPlayer
3318,JointPQPlayer,224,249,473,27,18,JointPQPlayer
3319,JointPQPlayer,300,180,480,34,18,Player A
3320,JointPQPlayer,301,191,492,34,14,Player A
3321,JointPQPlayer,329,164,493,29,12,Player A
3322,JointPQPlayer,309,189,498,37,13,Player A
3323,JointPQPlayer,170,240,410,15,35,JointPQPlayer
3324,JointPQPlayer,293,183,476,27,17,Player A
3325,JointPQPlayer,121,271,392,12,40,JointPQPlayer
3326,JointPQPlayer,302,187,489,34,15,Player A
3327,JointPQPlayer,260,195,455,30,25,Player A
3328,JointPQPlayer,281,201,482,39,19,Player A
3329,JointPQPlayer,301,186,487,32,15,Player A
3330,JointPQPlayer,291,196,487,35,16,Player A
3331,JointPQPlayer,293,193,486,31,15,Player A
3332,JointPQPlayer,140,260,400,17,39,JointPQPlayer
3333,JointPQPlayer,306,171,477,28,17,Player A
3334,JointPQPlayer,270,180,450,22,24,Player A
3335,JointPQPlayer,287,192,479,30,17,Player A
3336,JointPQPlayer,148,253,401,15,38,JointPQPlayer
3337,JointPQPlayer,172,237,409,17,36,JointPQPlayer
3338,JointPQPlayer,285,165,450,25,25,Player A
3339,JointPQPlayer,273,203,476,36,20,Player A
3340,JointPQPlayer,322,152,474,28,18,Player A
3341,JointPQPlayer,279,194,473,30,19,Player A
3342,JointPQPlayer,266,221,487,35,16,Player A
3343,JointPQPlayer,146,276,422,15,31,JointPQPlayer
3344,JointPQPlayer,281,191,472,32,20,Player A
3345,JointPQPlayer,163,223,386,9,41,JointPQPlayer
3346,JointPQPlayer,289,199,488,39,17,Player A
3347,JointPQPlayer,254,224,478,38,20,Player A
3348,JointPQPlayer,280,210,490,32,14,Player A
3349,JointPQPlayer,141,286,427,14,29,JointPQPlayer
3350,JointPQPlayer,304,194,498,37,13,Player A
3351,JointPQPlayer,316,181,497,36,13,Player A
3352,JointPQPlayer,235,180,415,23,36,Player A
3353,JointPQPlayer,294,209,503,39,12,Player A
3354,JointPQPlayer,281,201,482,33,17,Player A
3355,JointPQPlayer,301,191,492,37,15,Player A
3356,JointPQPlayer,290,210,500,36,12,Player A
3357,JointPQPlayer,296,211,507,40,11,Player A
3358,JointPQPlayer,308,178,486,31,15,Player A
3359,JointPQPlayer,278,218,496,35,13,Player A
3360,JointPQPlayer,216,256,472,23,17,JointPQPlayer
3361,JointPQPlayer,302,197,499,41,14,Player A
3362,JointPQPlayer,151,276,427,17,30,JointPQPlayer
3363,JointPQPlayer,137,282,419,15,32,JointPQPlayer
3364,JointPQPlayer,326,161,487,35,16,Player A
3365,JointPQPlayer,151,256,407,12,35,JointPQPlayer
3366,JointPQPlayer,308,193,501,37,12,Player A
3367,JointPQPlayer,271,201,472,29,19,Player A
3368,JointPQPlayer,277,232,509,39,10,Player A
3369,JointPQPlayer,138,288,426,16,30,JointPQPlayer
3370,JointPQPlayer,262,227,489,34,15,Player A
3371,JointPQPlayer,285,205,490,32,14,Player A
3372,JointPQPlayer,274,209,483,34,17,Player A
3373,JointPQPlayer,285,205,490,35,15,Player A
3374,JointPQPlayer,148,233,381,13,44,JointPQPlayer
3375,JointPQPlayer,295,205,500,36,12,Player A
3376,JointPQPlayer,166,246,412,17,35,JointPQPlayer
3377,JointPQPlayer,261,206,467,36,23,Player A
3378,JointPQPlayer,264,234,498,34,12,Player A
3379,JointPQPlayer,311,181,492,31,13,Player A
3380,JointPQPlayer,224,209,433,23,30,Player A
3381,JointPQPlayer,322,162,484,32,16,Player A
3382,JointPQPlayer,138,238,376,17,47,JointPQPlayer
3383,JointPQPlayer,276,206,482,27,15,Player A
3384,JointPQPlayer,306,186,492,31,13,Player A
3385,JointPQPlayer,267,227,494,30,12,Player A
3386,JointPQPlayer,196,226,422,15,31,JointPQPlayer
3387,JointPQPlayer,296,161,457,32,25,Player A
3388,JointPQPlayer,184,234,418,17,33,JointPQPlayer
3389,JointPQPlayer,285,195,480,28,16,Player A
3390,JointPQPlayer,297,207,504,37,11,Player A
3391,JointPQPlayer,286,196,482,33,17,Player A
3392,JointPQPlayer,254,164,418,23,35,Player A
3393,JointPQPlayer,262,207,469,38,23,Player A
3394,JointPQPlayer,332,147,479,30,17,Player A
3395,JointPQPlayer,231,231,462,25,21,Tie
3396,JointPQPlayer,286,211,497,36,13,Player A
3397,JointPQPlayer,255,230,485,27,14,Player A
3398,JointPQPlayer,303,188,491,30,13,Player A
3399,JointPQPlayer,302,192,494,39,15,Player A
3400,JointPQPlayer,292,197,489,37,16,Player A
3401,JointPQPlayer,285,205,490,32,14,Player A
3402,JointPQPlayer,291,186,477,28,17,Player A
3403,JointPQPlayer,280,180,460,26,22,Player A
3404,JointPQPlayer,279,199,478,29,17,Player A
3405,JointPQPlayer,307,187,494,30,12,Player A
3406,JointPQPlayer,148,268,416,18,34,JointPQPlayer
3407,JointPQPlayer,286,201,487,32,15,Player A
3408,JointPQPlayer,284,194,478,35,19,Player A
3409,JointPQPlayer,289,209,498,37,13,Player A
3410,JointPQPlayer,308,178,486,34,16,Player A
3411,JointPQPlayer,282,212,494,39,15,Player A
3412,JointPQPlayer,287,217,504,34,10,Player A
3413,JointPQPlayer,151,251,402,13,37,JointPQPlayer
3414,JointPQPlayer,170,255,425,15,30,JointPQPlayer
3415,JointPQPlayer,302,197,499,41,14,Player A
3416,JointPQPlayer,267,222,489,34,15,Player A
3417,JointPQPlayer,289,204,493,35,14,Player A
3418,JointPQPlayer,267,227,494,36,14,Player A
3419,JointPQPlayer,153,223,376,11,45,JointPQPlayer
3420,JointPQPlayer,249,234,483,34,17,Player A
3421,JointPQPlayer,272,207,479,30,17,Player A
3422,JointPQPlayer,297,187,484,32,16,Player A
3423,JointPQPlayer,338,168,506,36,10,Player A
3424,JointPQPlayer,284,214,498,34,12,Player A
3425,JointPQPlayer,277,197,474,28,18,Player A
3426,JointPQPlayer,307,182,489,31,14,Player A
3427,JointPQPlayer,323,173,496,35,13,Player A
3428,JointPQPlayer,165,220,385,17,44,JointPQPlayer
3429,JointPQPlayer,315,185,500,39,13,Player A
3430,JointPQPlayer,244,219,463,29,22,Player A
3431,JointPQPlayer,310,185,495,40,15,Player A
3432,JointPQPlayer,296,196,492,37,15,Player A
3433,JointPQPlayer,161,276,437,12,25,JointPQPlayer
3434,JointPQPlayer,164,244,408,19,37,JointPQPlayer
3435,JointPQPlayer,237,227,464,30,22,Player A
3436,JointPQPlayer,278,193,471,31,20,Player A
3437,JointPQPlayer,130,285,415,11,32,JointPQPlayer
3438,JointPQPlayer,264,224,488,39,17,Player A
3439,JointPQPlayer,305,170,475,32,19,Player A
3440,JointPQPlayer,271,231,502,35,11,Player A
3441,JointPQPlayer,180,265,445,20,25,JointPQPlayer
3442,JointPQPlayer,298,178,476,33,19,Player A
3443,JointPQPlayer,127,292,419,15,32,JointPQPlayer
3444,JointPQPlayer,304,199,503,33,10,Player A
3445,JointPQPlayer,129,279,408,16,36,JointPQPlayer
3446,JointPQPlayer,127,277,404,15,37,JointPQPlayer
3447,JointPQPlayer,313,178,491,33,14,Player A
3448,JointPQPlayer,268,223,491,30,13,Player A
3449,JointPQPlayer,288,213,501,37,12,Player A
3450,JointPQPlayer,167,257,424,14,30,JointPQPlayer
3451,JointPQPlayer,283,183,466,29,21,Player A
3452,JointPQPlayer,306,211,517,44,9,Player A
3453,JointPQPlayer,310,175,485,36,17,Player A
3454,JointPQPlayer,130,260,390,10,40,JointPQPlayer
3455,JointPQPlayer,301,186,487,32,15,Player A
3456,JointPQPlayer,275,215,490,41,17,Player A
3457,JointPQPlayer,297,177,474,34,20,Player A
3458,JointPQPlayer,271,196,467,33,22,Player A
3459,JointPQPlayer,285,190,475,38,21,Player A
3460,JointPQPlayer,272,222,494,36,14,Player A
3461,JointPQPlayer,249,234,483,37,18,Player A
3462,JointPQPlayer,257,212,469,23,18,Player A
3463,JointPQPlayer,249,219,468,28,20,Player A
3464,JointPQPlayer,295,170,465,28,21,Player A
3465,JointPQPlayer,260,210,470,18,16,Player A
3466,JointPQPlayer,287,197,484,38,18,Player A
3467,JointPQPlayer,158,248,406,11,35,JointPQPlayer
3468,JointPQPlayer,152,252,404,9,35,JointPQPlayer
3469,JointPQPlayer,298,188,486,31,15,Player A
3470,JointPQPlayer,279,214,493,44,17,Player A
3471,JointPQPlayer,141,276,417,13,32,JointPQPlayer
3472,JointPQPlayer,319,169,488,36,16,Player A
3473,JointPQPlayer,270,195,465,28,21,Player A
3474,JointPQPlayer,292,172,464,27,21,Player A
3475,JointPQPlayer,302,177,479,33,18,Player A
3476,JointPQPlayer,238,213,451,23,24,Player A
3477,JointPQPlayer,161,246,407,15,36,JointPQPlayer
3478,JointPQPlayer,178,238,416,18,34,JointPQPlayer
3479,JointPQPlayer,282,202,484,35,17,Player A
3480,JointPQPlayer,268,228,496,35,13,Player A
3481,JointPQPlayer,308,183,491,33,14,Player A
3482,JointPQPlayer,299,189,488,30,14,Player A
3483,JointPQPlayer,221,226,447,28,27,JointPQPlayer
3484,JointPQPlayer,274,224,498,37,13,Player A
3485,JointPQPlayer,286,201,487,35,16,Player A
3486,JointPQPlayer,298,193,491,39,16,Player A
3487,JointPQPlayer,319,164,483,34,17,Player A
3488,JointPQPlayer,144,294,438,22,28,JointPQPlayer
3489,JointPQPlayer,224,244,468,25,19,JointPQPlayer
3490,JointPQPlayer,268,228,496,41,15,Player A
3491,JointPQPlayer,272,202,474,28,18,Player A
3492,JointPQPlayer,120,305,425,15,30,JointPQPlayer
3493,JointPQPlayer,296,186,482,30,16,Player A
3494,JointPQPlayer,324,194,518,45,9,Player A
3495,JointPQPlayer,325,170,495,34,13,Player A
3496,JointPQPlayer,308,183,491,36,15,Player A
3497,JointPQPlayer,261,216,477,37,20,Player A
3498,JointPQPlayer,266,201,467,27,20,Player A
3499,JointPQPlayer,290,210,500,42,14,Player A
3500,JointPQPlayer,273,233,506,39,11,Player A
3501,JointPQPlayer,278,198,476,33,19,Player A
3502,JointPQPlayer,298,188,486,28,14,Player A
3503,JointPQPlayer,319,179,498,37,13,Player A
3504,JointPQPlayer,272,222,494,36,14,Player A
3505,JointPQPlayer,293,198,491,33,14,Player A
3506,JointPQPlayer,136,296,432,25,31,JointPQPlayer
3507,JointPQPlayer,292,192,484,32,16,Player A
3508,JointPQPlayer,261,231,492,34,14,Player A
3509,JointPQPlayer,238,233,471,28,19,Player A
3510,JointPQPlayer,163,263,426,16,30,JointPQPlayer
3511,JointPQPlayer,273,198,471,28,19,Player A
3512,JointPQPlayer,300,175,475,26,17,Player A
3513,JointPQPlayer,287,207,494,33,13,Player A
3514,JointPQPlayer,268,213,481,29,16,Player A
3515,JointPQPlayer,292,212,504,46,14,Player A
3516,JointPQPlayer,279,204,483,31,16,Player A
3517,JointPQPlayer,299,174,473,30,19,Player A
3518,JointPQPlayer,290,170,460,26,22,Player A
3519,JointPQPlayer,277,212,489,28,13,Player A
3520,JointPQPlayer,300,180,480,31,17,Player A
3521,JointPQPlayer,279,219,498,43,15,Player A
3522,JointPQPlayer,299,199,498,40,14,Player A
3523,JointPQPlayer,267,207,474,31,19,Player A
3524,JointPQPlayer,293,183,476,30,18,Player A
3525,JointPQPlayer,309,189,498,37,13,Player A
3526,JointPQPlayer,167,237,404,24,40,JointPQPlayer
3527,JointPQPlayer,282,207,489,40,17,Player A
3528,JointPQPlayer,291,201,492,34,14,Player A
3529,JointPQPlayer,273,233,506,39,11,Player A
3530,JointPQPlayer,260,220,480,34,18,Player A
3531,JointPQPlayer,143,273,416,12,32,JointPQPlayer
3532,JointPQPlayer,270,205,475,35,20,Player A
3533,JointPQPlayer,302,192,494,33,13,Player A
3534,JointPQPlayer,273,208,481,41,20,Player A
3535,JointPQPlayer,277,182,459,31,24,Player A
3536,JointPQPlayer,125,265,390,7,39,JointPQPlayer
3537,JointPQPlayer,269,224,493,32,13,Player A
3538,JointPQPlayer,300,170,470,27,19,Player A
3539,JointPQPlayer,256,226,482,39,19,Player A
3540,JointPQPlayer,303,198,501,37,12,Player A
3541,JointPQPlayer,166,276,442,17,25,JointPQPlayer
3542,JointPQPlayer,247,217,464,30,22,Player A
3543,JointPQPlayer,286,211,497,39,14,Player A
3544,JointPQPlayer,218,253,471,31,20,JointPQPlayer
3545,JointPQPlayer,143,253,396,13,39,JointPQPlayer
3546,JointPQPlayer,276,201,477,31,18,Player A
3547,JointPQPlayer,278,213,491,33,14,Player A
3548,JointPQPlayer,170,230,400,14,38,JointPQPlayer
3549,JointPQPlayer,144,239,383,12,43,JointPQPlayer
3550,JointPQPlayer,279,194,473,33,20,Player A
3551,JointPQPlayer,309,179,488,27,13,Player A
3552,JointPQPlayer,291,191,482,39,19,Player A
3553,JointPQPlayer,256,206,462,34,24,Player A
3554,JointPQPlayer,268,198,466,29,21,Player A
3555,JointPQPlayer,140,255,395,15,40,JointPQPlayer
3556,JointPQPlayer,308,188,496,26,10,Player A
3557,JointPQPlayer,241,236,477,28,17,Player A
3558,JointPQPlayer,283,203,486,37,17,Player A
3559,JointPQPlayer,313,178,491,36,15,Player A
3560,JointPQPlayer,160,260,420,10,30,JointPQPlayer
3561,JointPQPlayer,292,197,489,31,14,Player A
3562,JointPQPlayer,213,228,441,22,27,JointPQPlayer
3563,JointPQPlayer,298,218,516,43,9,Player A
3564,JointPQPlayer,158,253,411,16,35,JointPQPlayer
3565,JointPQPlayer,300,200,500,36,12,Player A
3566,JointPQPlayer,260,210,470,33,21,Player A
3567,JointPQPlayer,310,175,485,27,14,Player A
3568,JointPQPlayer,194,229,423,19,32,JointPQPlayer
3569,JointPQPlayer,298,193,491,33,14,Player A
3570,JointPQPlayer,285,195,480,40,20,Player A
3571,JointPQPlayer,153,268,421,11,30,JointPQPlayer
3572,JointPQPlayer,308,173,481,35,18,Player A
3573,JointPQPlayer,144,239,383,6,41,JointPQPlayer
3574,JointPQPlayer,300,175,475,35,20,Player A
3575,JointPQPlayer,183,258,441,22,27,JointPQPlayer
3576,JointPQPlayer,297,192,489,31,14,Player A
3577,JointPQPlayer,160,260,420,16,32,JointPQPlayer
3578,JointPQPlayer,291,206,497,36,13,Player A
3579,JointPQPlayer,288,188,476,33,19,Player A
3580,JointPQPlayer,287,202,489,37,16,Player A
3581,JointPQPlayer,280,200,480,34,18,Player A
3582,JointPQPlayer,157,252,409,20,37,JointPQPlayer
3583,JointPQPlayer,273,203,476,30,18,Player A
3584,JointPQPlayer,245,215,460,29,23,Player A
3585,JointPQPlayer,296,171,467,30,21,Player A
3586,JointPQPlayer,313,203,516,46,10,Player A
3587,JointPQPlayer,312,192,504,40,12,Player A
3588,JointPQPlayer,157,237,394,11,39,JointPQPlayer
3589,JointPQPlayer,245,200,445,26,27,Player A
3590,JointPQPlayer,224,219,443,27,28,Player A
3591,JointPQPlayer,168,248,416,18,34,JointPQPlayer
3592,JointPQPlayer,306,181,487,32,15,Player A
3593,JointPQPlayer,141,241,382,14,44,JointPQPlayer
3594,JointPQPlayer,277,227,504,40,12,Player A
3595,JointPQPlayer,272,202,474,28,18,Player A
3596,JointPQPlayer,303,198,501,37,12,Player A
3597,JointPQPlayer,268,228,496,38,14,Player A
3598,JointPQPlayer,290,185,475,29,18,Player A
3599,JointPQPlayer,283,213,496,38,14,Player A
3600,JointPQPlayer,134,244,378,13,45,JointPQPlayer
3601,JointPQPlayer,175,255,430,20,30,JointPQPlayer
3602,JointPQPlayer,298,178,476,24,16,Player A
3603,JointPQPlayer,291,211,502,41,13,Player A
3604,JointPQPlayer,314,189,503,39,12,Player A
3605,JointPQPlayer,142,237,379,14,45,JointPQPlayer
3606,JointPQPlayer,288,173,461,30,23,Player A
3607,JointPQPlayer,241,216,457,26,23,Player A
3608,JointPQPlayer,297,197,494,42,16,Player A
3609,JointPQPlayer,254,209,463,29,22,Player A
3610,JointPQPlayer,236,216,452,24,24,Player A
3611,JointPQPlayer,290,215,505,38,11,Player A
3612,JointPQPlayer,264,209,473,33,20,Player A
3613,JointPQPlayer,285,200,485,33,16,Player A
3614,JointPQPlayer,281,196,477,34,19,Player A
3615,JointPQPlayer,225,235,460,23,21,JointPQPlayer
3616,JointPQPlayer,317,152,469,29,20,Player A
3617,JointPQPlayer,333,143,476,27,17,Player A
3618,JointPQPlayer,324,159,483,31,16,Player A
3619,JointPQPlayer,117,292,409,14,35,JointPQPlayer
3620,JointPQPlayer,286,216,502,38,12,Player A
3621,JointPQPlayer,151,256,407,12,35,JointPQPlayer
3622,JointPQPlayer,157,247,404,15,37,JointPQPlayer
3623,JointPQPlayer,297,182,479,27,16,Player A
3624,JointPQPlayer,136,261,397,17,40,JointPQPlayer
3625,JointPQPlayer,141,271,412,17,35,JointPQPlayer
3626,JointPQPlayer,250,215,465,25,20,Player A
3627,JointPQPlayer,323,198,521,45,8,Player A
3628,JointPQPlayer,284,209,493,35,14,Player A
3629,JointPQPlayer,131,276,407,12,35,JointPQPlayer
3630,JointPQPlayer,318,163,481,32,17,Player A
3631,JointPQPlayer,150,260,410,15,35,JointPQPlayer
3632,JointPQPlayer,311,216,527,42,5,Player A
3633,JointPQPlayer,130,280,410,12,34,JointPQPlayer
3634,JointPQPlayer,153,268,421,11,30,JointPQPlayer
3635,JointPQPlayer,302,182,484,32,16,Player A
3636,JointPQPlayer,271,236,507,43,12,Player A
3637,JointPQPlayer,170,270,440,21,27,JointPQPlayer
3638,JointPQPlayer,289,194,483,37,18,Player A
3639,JointPQPlayer,291,201,492,43,17,Player A
3640,JointPQPlayer,310,175,485,24,13,Player A
3641,JointPQPlayer,260,210,470,33,21,Player A
3642,JointPQPlayer,302,202,504,37,11,Player A
3643,JointPQPlayer,306,206,512,48,12,Player A
3644,JointPQPlayer,300,175,475,32,19,Player A
3645,JointPQPlayer,133,293,426,16,30,JointPQPlayer
3646,JointPQPlayer,145,230,375,7,44,JointPQPlayer
3647,JointPQPlayer,160,270,430,14,28,JointPQPlayer
3648,JointPQPlayer,149,249,398,12,38,JointPQPlayer
3649,JointPQPlayer,286,186,472,32,20,Player A
3650,JointPQPlayer,314,184,498,37,13,Player A
3651,JointPQPlayer,298,198,496,44,16,Player A
3652,JointPQPlayer,310,190,500,45,15,Player A
3653,JointPQPlayer,256,211,467,27,20,Player A
3654,JointPQPlayer,305,210,515,45,10,Player A
3655,JointPQPlayer,160,245,405,16,37,JointPQPlayer
3656,JointPQPlayer,212,232,444,25,27,JointPQPlayer
3657,JointPQPlayer,274,214,488,36,16,Player A
3658,JointPQPlayer,289,184,473,30,19,Player A
3659,JointPQPlayer,277,207,484,35,17,Player A
3660,JointPQPlayer,161,286,447,19,24,JointPQPlayer
3661,JointPQPlayer,311,186,497,36,13,Player A
3662,JointPQPlayer,302,197,499,41,14,Player A
3663,JointPQPlayer,269,209,478,29,17,Player A
3664,JointPQPlayer,282,192,474,31,19,Player A
3665,JointPQPlayer,278,198,476,30,18,Player A
3666,JointPQPlayer,323,183,506,36,10,Player A
3667,JointPQPlayer,291,201,492,37,15,Player A
3668,JointPQPlayer,253,218,471,31,20,Player A
3669,JointPQPlayer,300,185,485,33,16,Player A
3670,JointPQPlayer,319,179,498,37,13,Player A
3671,JointPQPlayer,270,200,470,33,21,Player A
3672,JointPQPlayer,318,188,506,39,11,Player A
3673,JointPQPlayer,152,237,389,12,41,JointPQPlayer
3674,JointPQPlayer,133,268,401,15,38,JointPQPlayer
3675,JointPQPlayer,162,282,444,13,23,JointPQPlayer
3676,JointPQPlayer,215,245,460,32,24,JointPQPlayer
3677,JointPQPlayer,283,213,496,38,14,Player A
3678,JointPQPlayer,319,184,503,36,11,Player A
3679,JointPQPlayer,291,201,492,40,16,Player A
3680,JointPQPlayer,283,193,476,30,18,Player A
3681,JointPQPlayer,312,182,494,36,14,Player A
3682,JointPQPlayer,179,224,403,11,36,JointPQPlayer
3683,JointPQPlayer,263,208,471,31,20,Player A
3684,JointPQPlayer,297,217,514,44,10,Player A
3685,JointPQPlayer,306,176,482,24,14,Player A
3686,JointPQPlayer,274,194,468,25,19,Player A
3687,JointPQPlayer,307,187,494,36,14,Player A
3688,JointPQPlayer,247,222,469,32,21,Player A
3689,JointPQPlayer,295,165,460,23,21,Player A
3690,JointPQPlayer,158,263,421,23,34,JointPQPlayer
3691,JointPQPlayer,305,185,490,32,14,Player A
3692,JointPQPlayer,298,198,496,32,12,Player A
3693,JointPQPlayer,261,196,457,26,23,Player A
3694,JointPQPlayer,327,157,484,29,15,Player A
3695,JointPQPlayer,280,200,480,34,18,Player A
3696,JointPQPlayer,128,263,391,11,40,JointPQPlayer
3697,JointPQPlayer,256,216,472,26,18,Player A
3698,JointPQPlayer,306,181,487,38,17,Player A
3699,JointPQPlayer,238,213,451,26,25,Player A
3700,JointPQPlayer,144,244,388,11,41,JointPQPlayer
3701,JointPQPlayer,157,232,389,9,40,JointPQPlayer
3702,JointPQPlayer,261,241,502,38,12,Player A
3703,JointPQPlayer,314,189,503,36,11,Player A
3704,JointPQPlayer,275,225,500,36,12,Player A
3705,JointPQPlayer,308,178,486,40,18,Player A
3706,JointPQPlayer,278,168,446,24,26,Player A
3707,JointPQPlayer,287,192,479,36,19,Player A
3708,JointPQPlayer,292,212,504,43,13,Player A
3709,JointPQPlayer,290,185,475,29,18,Player A
3710,JointPQPlayer,250,250,500,36,12,Tie
3711,JointPQPlayer,157,267,424,11,29,JointPQPlayer
3712,JointPQPlayer,281,206,487,35,16,Player A
3713,JointPQPlayer,317,202,519,43,8,Player A
3714,JointPQPlayer,296,191,487,32,15,Player A
3715,JointPQPlayer,281,196,477,34,19,Player A
3716,JointPQPlayer,263,213,476,33,19,Player A
3717,JointPQPlayer,291,191,482,33,17,Player A
3718,JointPQPlayer,295,175,470,30,20,Player A
3719,JointPQPlayer,283,193,476,33,19,Player A
3720,JointPQPlayer,163,248,411,13,34,JointPQPlayer
3721,JointPQPlayer,133,258,391,14,41,JointPQPlayer
3722,JointPQPlayer,322,162,484,32,16,Player A
3723,JointPQPlayer,255,225,480,31,17,Player A
3724,JointPQPlayer,293,193,486,34,16,Player A
3725,JointPQPlayer,124,289,413,12,33,JointPQPlayer
3726,JointPQPlayer,203,223,426,22,32,JointPQPlayer
3727,JointPQPlayer,293,223,516,43,9,Player A
3728,JointPQPlayer,311,216,527,45,6,Player A
3729,JointPQPlayer,282,187,469,32,21,Player A
3730,JointPQPlayer,163,243,406,14,36,JointPQPlayer
3731,JointPQPlayer,280,215,495,43,16,Player A
3732,JointPQPlayer,279,219,498,40,14,Player A
3733,JointPQPlayer,271,206,477,34,19,Player A
3734,JointPQPlayer,282,192,474,31,19,Player A
3735,JointPQPlayer,226,201,427,14,29,Player A
3736,JointPQPlayer,315,205,520,41,7,Player A
3737,JointPQPlayer,297,177,474,25,17,Player A
3738,JointPQPlayer,134,264,398,15,39,JointPQPlayer
3739,JointPQPlayer,139,269,408,16,36,JointPQPlayer
3740,JointPQPlayer,145,250,395,12,39,JointPQPlayer
3741,JointPQPlayer,306,181,487,35,16,Player A
3742,JointPQPlayer,265,205,470,30,20,Player A
3743,JointPQPlayer,269,189,458,30,24,Player A
3744,JointPQPlayer,306,191,497,39,14,Player A
3745,JointPQPlayer,286,181,467,24,19,Player A
3746,JointPQPlayer,238,223,461,30,23,Player A
3747,JointPQPlayer,294,214,508,41,11,Player A
3748,JointPQPlayer,307,197,504,40,12,Player A
3749,JointPQPlayer,277,217,494,33,13,Player A
3750,JointPQPlayer,255,205,460,23,21,Player A
3751,JointPQPlayer,309,194,503,39,12,Player A
3752,JointPQPlayer,120,285,405,16,37,JointPQPlayer
3753,JointPQPlayer,275,210,485,33,16,Player A
3754,JointPQPlayer,293,193,486,31,15,Player A
3755,JointPQPlayer,302,207,509,36,9,Player A
3756,JointPQPlayer,280,200,480,37,19,Player A
3757,JointPQPlayer,292,202,494,42,16,Player A
3758,JointPQPlayer,262,202,464,27,21,Player A
3759,JointPQPlayer,292,197,489,34,15,Player A
3760,JointPQPlayer,312,172,484,32,16,Player A
3761,JointPQPlayer,302,202,504,37,11,Player A
3762,JointPQPlayer,193,238,431,9,26,JointPQPlayer
3763,JointPQPlayer,283,203,486,31,15,Player A
3764,JointPQPlayer,282,197,479,30,17,Player A
3765,JointPQPlayer,285,220,505,32,9,Player A
3766,JointPQPlayer,309,174,483,40,19,Player A
3767,JointPQPlayer,314,174,488,30,14,Player A
3768,JointPQPlayer,291,216,507,37,10,Player A
3769,JointPQPlayer,283,208,491,27,12,Player A
3770,JointPQPlayer,140,255,395,15,40,JointPQPlayer
3771,JointPQPlayer,156,236,392,15,41,JointPQPlayer
3772,JointPQPlayer,322,182,504,40,12,Player A
3773,JointPQPlayer,185,255,440,21,27,JointPQPlayer
3774,JointPQPlayer,292,177,469,32,21,Player A
3775,JointPQPlayer,286,186,472,29,19,Player A
3776,JointPQPlayer,255,205,460,35,25,Player A
3777,JointPQPlayer,301,186,487,29,14,Player A
3778,JointPQPlayer,291,186,477,31,18,Player A
3779,JointPQPlayer,274,204,478,35,19,Player A
3780,JointPQPlayer,294,184,478,29,17,Player A
3781,JointPQPlayer,309,184,493,29,12,Player A
3782,JointPQPlayer,317,192,509,39,10,Player A
3783,JointPQPlayer,139,244,383,12,43,JointPQPlayer
3784,JointPQPlayer,308,178,486,31,15,Player A
3785,JointPQPlayer,296,196,492,28,12,Player A
3786,JointPQPlayer,274,214,488,33,15,Player A
3787,JointPQPlayer,276,186,462,31,23,Player A
3788,JointPQPlayer,302,182,484,32,16,Player A
3789,JointPQPlayer,313,188,501,37,12,Player A
3790,JointPQPlayer,134,264,398,12,38,JointPQPlayer
3791,JointPQPlayer,238,218,456,28,24,Player A
3792,JointPQPlayer,208,268,476,30,18,JointPQPlayer
3793,JointPQPlayer,197,232,429,25,32,JointPQPlayer
3794,JointPQPlayer,290,210,500,39,13,Player A
3795,JointPQPlayer,226,231,457,29,24,JointPQPlayer
3796,JointPQPlayer,289,214,503,33,10,Player A
3797,JointPQPlayer,266,231,497,39,14,Player A
3798,JointPQPlayer,289,179,468,25,19,Player A
3799,JointPQPlayer,129,264,393,13,40,JointPQPlayer
3800,JointPQPlayer,293,193,486,34,16,Player A
3801,JointPQPlayer,292,187,479,36,19,Player A
3802,JointPQPlayer,287,192,479,33,18,Player A
3803,JointPQPlayer,270,210,480,31,17,Player A
3804,JointPQPlayer,282,207,489,37,16,Player A
3805,JointPQPlayer,319,164,483,34,17,Player A
3806,JointPQPlayer,267,212,479,39,20,Player A
3807,JointPQPlayer,305,185,490,38,16,Player A
3808,JointPQPlayer,135,265,400,14,38,JointPQPlayer
3809,JointPQPlayer,261,211,472,29,19,Player A
3810,JointPQPlayer,290,185,475,26,17,Player A
3811,JointPQPlayer,127,302,429,19,30,JointPQPlayer
3812,JointPQPlayer,312,182,494,33,13,Player A
3813,JointPQPlayer,166,246,412,20,36,JointPQPlayer
3814,JointPQPlayer,148,253,401,15,38,JointPQPlayer
3815,JointPQPlayer,126,276,402,10,36,JointPQPlayer
3816,JointPQPlayer,299,209,508,41,11,Player A
3817,JointPQPlayer,321,191,512,45,11,Player A
3818,JointPQPlayer,255,235,490,35,15,Player A
3819,JointPQPlayer,138,283,421,20,33,JointPQPlayer
3820,JointPQPlayer,271,226,497,45,16,Player A
3821,JointPQPlayer,147,297,444,19,25,JointPQPlayer
3822,JointPQPlayer,278,218,496,44,16,Player A
3823,JointPQPlayer,292,187,479,30,17,Player A
3824,JointPQPlayer,186,256,442,20,26,JointPQPlayer
3825,JointPQPlayer,304,179,483,28,15,Player A
3826,JointPQPlayer,263,208,471,31,20,Player A
3827,JointPQPlayer,276,196,472,23,17,Player A
3828,JointPQPlayer,298,208,506,39,11,Player A
3829,JointPQPlayer,207,237,444,25,27,JointPQPlayer
3830,JointPQPlayer,150,245,395,15,40,JointPQPlayer
3831,JointPQPlayer,144,259,403,11,36,JointPQPlayer
3832,JointPQPlayer,298,188,486,37,17,Player A
3833,JointPQPlayer,203,238,441,25,28,JointPQPlayer
3834,JointPQPlayer,135,270,405,10,35,JointPQPlayer
3835,JointPQPlayer,158,243,401,18,39,JointPQPlayer
3836,JointPQPlayer,301,201,502,44,14,Player A
3837,JointPQPlayer,299,204,503,42,13,Player A
3838,JointPQPlayer,202,237,439,20,27,JointPQPlayer
3839,JointPQPlayer,286,206,492,37,15,Player A
3840,JointPQPlayer,285,195,480,31,17,Player A
3841,JointPQPlayer,154,239,393,16,41,JointPQPlayer
3842,JointPQPlayer,317,192,509,42,11,Player A
3843,JointPQPlayer,295,225,520,44,8,Player A
3844,JointPQPlayer,161,281,442,26,28,JointPQPlayer
3845,JointPQPlayer,312,187,499,35,12,Player A
3846,JointPQPlayer,250,225,475,23,16,Player A
3847,JointPQPlayer,166,266,432,19,29,JointPQPlayer
3848,JointPQPlayer,146,271,417,16,33,JointPQPlayer
3849,JointPQPlayer,279,224,503,42,13,Player A
3850,JointPQPlayer,257,197,454,26,24,Player A
3851,JointPQPlayer,139,259,398,9,37,JointPQPlayer
3852,JointPQPlayer,267,197,464,33,23,Player A
3853,JointPQPlayer,136,261,397,11,38,JointPQPlayer
3854,JointPQPlayer,302,212,514,41,9,Player A
3855,JointPQPlayer,155,250,405,16,37,JointPQPlayer
3856,JointPQPlayer,146,251,397,17,40,JointPQPlayer
3857,JointPQPlayer,303,173,476,36,20,Player A
3858,JointPQPlayer,302,177,479,30,17,Player A
3859,JointPQPlayer,285,195,480,31,17,Player A
3860,JointPQPlayer,244,249,493,35,14,JointPQPlayer
3861,JointPQPlayer,292,192,484,32,16,Player A
3862,JointPQPlayer,300,170,470,30,20,Player A
3863,JointPQPlayer,305,195,500,39,13,Player A
3864,JointPQPlayer,321,181,502,38,12,Player A
3865,JointPQPlayer,288,188,476,27,17,Player A
3866,JointPQPlayer,259,229,488,36,16,Player A
3867,JointPQPlayer,262,197,459,22,21,Player A
3868,JointPQPlayer,275,220,495,34,13,Player A
3869,JointPQPlayer,324,179,503,39,12,Player A
3870,JointPQPlayer,309,184,493,32,13,Player A
3871,JointPQPlayer,313,203,516,31,5,Player A
3872,JointPQPlayer,310,190,500,33,11,Player A
3873,JointPQPlayer,307,192,499,35,12,Player A
3874,JointPQPlayer,291,181,472,32,20,Player A
3875,JointPQPlayer,284,214,498,43,15,Player A
3876,JointPQPlayer,262,197,459,31,24,Player A
3877,JointPQPlayer,297,177,474,34,20,Player A
3878,JointPQPlayer,276,226,502,41,13,Player A
3879,JointPQPlayer,306,181,487,35,16,Player A
3880,JointPQPlayer,297,197,494,33,13,Player A
3881,JointPQPlayer,257,207,464,30,22,Player A
3882,JointPQPlayer,140,250,390,13,41,JointPQPlayer
3883,JointPQPlayer,298,183,481,29,16,Player A
3884,JointPQPlayer,150,240,390,13,41,JointPQPlayer
3885,JointPQPlayer,300,195,495,34,13,Player A
3886,JointPQPlayer,296,196,492,34,14,Player A
3887,JointPQPlayer,261,236,497,39,14,Player A
3888,JointPQPlayer,154,234,388,14,42,JointPQPlayer
3889,JointPQPlayer,320,165,485,33,16,Player A
3890,JointPQPlayer,304,194,498,40,14,Player A
3891,JointPQPlayer,256,226,482,39,19,Player A
3892,JointPQPlayer,281,216,497,36,13,Player A
3893,JointPQPlayer,272,207,479,27,16,Player A
3894,JointPQPlayer,297,187,484,32,16,Player A
0,revTitforTat,176,281,457,23,22,revTitforTat
1,revTitforTat,195,255,450,25,25,revTitforTat
2,revTitforTat,227,227,454,23,23,Tie
3,revTitforTat,182,277,459,19,20,revTitforTat
4,revTitforTat,223,233,456,22,22,revTitforTat
5,revTitforTat,248,203,451,26,25,Player A
6,revTitforTat,215,235,450,25,25,revTitforTat
7,revTitforTat,215,230,445,26,27,revTitforTat
8,revTitforTat,229,219,448,26,26,Player A
9,revTitforTat,224,229,453,25,24,revTitforTat
10,revTitforTat,235,210,445,26,27,Player A
11,revTitforTat,216,231,447,28,27,revTitforTat
12,revTitforTat,214,234,448,26,26,revTitforTat
13,revTitforTat,241,206,447,25,26,Player A
14,revTitforTat,171,281,452,24,24,revTitforTat
15,revTitforTat,196,261,457,23,22,revTitforTat
16,revTitforTat,229,224,453,22,23,Player A
17,revTitforTat,230,225,455,24,23,Player A
18,revTitforTat,237,217,454,23,23,Player A
19,revTitforTat,235,210,445,26,27,Player A
20,revTitforTat,267,182,449,27,26,Player A
21,revTitforTat,249,204,453,22,23,Player A
22,revTitforTat,240,200,440,30,30,Player A
23,revTitforTat,214,239,453,25,24,revTitforTat
24,revTitforTat,208,238,446,27,27,revTitforTat
25,revTitforTat,214,234,448,26,26,revTitforTat
26,revTitforTat,257,187,444,28,28,Player A
27,revTitforTat,249,209,458,21,21,Player A
28,revTitforTat,217,237,454,23,23,revTitforTat
29,revTitforTat,185,270,455,21,22,revTitforTat
30,revTitforTat,219,234,453,25,24,revTitforTat
31,revTitforTat,247,207,454,23,23,Player A
32,revTitforTat,257,192,449,24,25,Player A
33,revTitforTat,225,225,450,25,25,Tie
34,revTitforTat,230,225,455,24,23,Player A
35,revTitforTat,238,213,451,23,24,Player A
36,revTitforTat,262,197,459,22,21,Player A
37,revTitforTat,270,180,450,25,25,Player A
38,revTitforTat,234,219,453,22,23,Player A
39,revTitforTat,258,193,451,26,25,Player A
40,revTitforTat,219,239,458,21,21,revTitforTat
41,revTitforTat,245,205,450,25,25,Player A
42,revTitforTat,247,207,454,23,23,Player A
43,revTitforTat,226,221,447,25,26,Player A
44,revTitforTat,241,206,447,28,27,Player A
45,revTitforTat,232,217,449,24,25,Player A
46,revTitforTat,226,211,437,33,32,Player A
47,revTitforTat,220,225,445,26,27,revTitforTat
48,revTitforTat,235,215,450,25,25,Player A
49,revTitforTat,222,232,454,23,23,revTitforTat
50,revTitforTat,247,202,449,27,26,Player A
51,revTitforTat,252,207,459,19,20,Player A
52,revTitforTat,239,214,453,25,24,Player A
53,revTitforTat,199,249,448,26,26,revTitforTat
54,revTitforTat,177,272,449,24,25,revTitforTat
55,revTitforTat,253,198,451,26,25,Player A
56,revTitforTat,235,215,450,25,25,Player A
57,revTitforTat,232,212,444,28,28,Player A
58,revTitforTat,253,198,451,23,24,Player A
59,revTitforTat,209,239,448,26,26,revTitforTat
60,revTitforTat,227,222,449,27,26,Player A
61,revTitforTat,224,224,448,26,26,Tie
62,revTitforTat,200,245,445,26,27,revTitforTat
63,revTitforTat,236,221,457,23,22,Player A
64,revTitforTat,212,232,444,28,28,revTitforTat
65,revTitforTat,220,235,455,21,22,revTitforTat
66,revTitforTat,201,246,447,28,27,revTitforTat
67,revTitforTat,248,208,456,22,22,Player A
68,revTitforTat,254,199,453,22,23,Player A
69,revTitforTat,231,216,447,28,27,Player A
70,revTitforTat,209,244,453,22,23,revTitforTat
71,revTitforTat,211,231,442,29,29,revTitforTat
0,PatternPlayer,231,211,442,23,27,Player A
1,PatternPlayer,209,259,468,31,21,PatternPlayer
2,PatternPlayer,224,219,443,27,28,Player A
3,PatternPlayer,227,212,439,26,29,Player A
4,PatternPlayer,229,219,448,23,25,Player A
5,PatternPlayer,223,223,446,27,27,Tie
6,PatternPlayer,212,237,449,33,28,PatternPlayer
7,PatternPlayer,225,225,450,25,25,Tie
8,PatternPlayer,222,227,449,27,26,PatternPlayer
9,PatternPlayer,217,247,464,27,21,PatternPlayer
10,PatternPlayer,233,203,436,23,29,Player A
11,PatternPlayer,226,221,447,25,26,Player A
12,PatternPlayer,227,237,464,21,19,PatternPlayer
13,PatternPlayer,213,248,461,30,23,PatternPlayer
14,PatternPlayer,218,228,446,30,28,PatternPlayer
15,PatternPlayer,229,219,448,23,25,Player A
16,PatternPlayer,228,208,436,26,30,Player A
17,PatternPlayer,224,229,453,25,24,PatternPlayer
18,PatternPlayer,231,216,447,22,25,Player A
19,PatternPlayer,220,230,450,28,26,PatternPlayer
20,PatternPlayer,228,208,436,26,30,Player A
21,PatternPlayer,230,215,445,23,26,Player A
22,PatternPlayer,233,218,451,20,23,Player A
23,PatternPlayer,215,245,460,29,23,PatternPlayer
24,PatternPlayer,218,233,451,29,26,PatternPlayer
25,PatternPlayer,221,231,452,27,25,PatternPlayer
26,PatternPlayer,235,210,445,20,25,Player A
27,PatternPlayer,216,241,457,29,24,PatternPlayer
28,PatternPlayer,214,244,458,30,24,PatternPlayer
29,PatternPlayer,215,250,465,28,21,PatternPlayer
30,PatternPlayer,229,209,438,25,29,Player A
31,PatternPlayer,211,246,457,32,25,PatternPlayer
32,PatternPlayer,236,211,447,19,24,Player A
33,PatternPlayer,236,226,462,16,18,Player A
34,PatternPlayer,241,181,422,21,33,Player A
35,PatternPlayer,229,214,443,24,27,Player A
36,PatternPlayer,245,180,425,18,31,Player A
37,PatternPlayer,219,229,448,29,27,PatternPlayer
38,PatternPlayer,224,229,453,25,24,PatternPlayer
39,PatternPlayer,219,234,453,28,25,PatternPlayer
40,PatternPlayer,227,207,434,27,31,Player A
41,PatternPlayer,225,225,450,25,25,Tie
42,PatternPlayer,224,239,463,23,20,PatternPlayer
43,PatternPlayer,223,238,461,24,21,PatternPlayer
44,PatternPlayer,221,231,452,27,25,PatternPlayer
45,PatternPlayer,237,197,434,21,29,Player A
46,PatternPlayer,232,202,434,24,30,Player A
47,PatternPlayer,231,206,437,24,29,Player A
48,PatternPlayer,231,211,442,23,27,Player A
49,PatternPlayer,219,234,453,28,25,PatternPlayer
50,PatternPlayer,233,203,436,23,29,Player A
51,PatternPlayer,229,219,448,23,25,Player A
52,PatternPlayer,209,249,458,33,25,PatternPlayer
53,PatternPlayer,213,253,466,29,21,PatternPlayer
54,PatternPlayer,233,218,451,20,23,Player A
55,PatternPlayer,224,229,453,25,24,PatternPlayer
56,PatternPlayer,223,228,451,26,25,PatternPlayer
57,PatternPlayer,222,242,464,24,20,PatternPlayer
58,PatternPlayer,222,232,454,26,24,PatternPlayer
59,PatternPlayer,237,212,449,18,23,Player A
60,PatternPlayer,232,222,454,20,22,Player A
61,PatternPlayer,221,231,452,27,25,PatternPlayer
62,PatternPlayer,233,208,441,22,27,Player A
63,PatternPlayer,211,241,452,33,27,PatternPlayer
64,PatternPlayer,238,203,441,19,26,Player A
65,PatternPlayer,225,230,455,24,23,PatternPlayer
66,PatternPlayer,233,208,441,22,27,Player A
67,PatternPlayer,210,260,470,30,20,PatternPlayer
68,PatternPlayer,220,225,445,29,28,PatternPlayer
69,PatternPlayer,234,224,458,18,20,Player A
70,PatternPlayer,227,212,439,26,29,Player A
71,PatternPlayer,216,246,462,28,22,PatternPlayer
72,PatternPlayer,228,213,441,25,28,Player A
73,PatternPlayer,239,179,418,23,35,Player A
74,PatternPlayer,215,250,465,28,21,PatternPlayer
75,PatternPlayer,224,214,438,28,30,Player A
76,PatternPlayer,223,228,451,26,25,PatternPlayer
77,PatternPlayer,224,229,453,25,24,PatternPlayer
78,PatternPlayer,227,212,439,26,29,Player A
79,PatternPlayer,220,235,455,27,24,PatternPlayer
80,PatternPlayer,235,205,440,21,27,Player A
81,PatternPlayer,214,249,463,29,22,PatternPlayer
82,PatternPlayer,217,242,459,28,23,PatternPlayer
83,PatternPlayer,227,232,459,22,21,PatternPlayer
84,PatternPlayer,234,214,448,20,24,Player A
85,PatternPlayer,225,215,440,27,29,Player A
86,PatternPlayer,220,235,455,27,24,PatternPlayer
87,PatternPlayer,226,221,447,25,26,Player A
88,PatternPlayer,225,220,445,26,27,Player A
89,PatternPlayer,236,196,432,22,30,Player A
90,PatternPlayer,231,211,442,23,27,Player A
91,PatternPlayer,236,201,437,21,28,Player A
92,PatternPlayer,218,243,461,27,22,PatternPlayer
93,PatternPlayer,224,244,468,22,18,PatternPlayer
94,PatternPlayer,228,213,441,25,28,Player A
95,PatternPlayer,228,218,446,24,26,Player A
96,PatternPlayer,216,251,467,27,20,PatternPlayer
97,PatternPlayer,223,233,456,25,23,PatternPlayer
98,PatternPlayer,220,240,460,26,22,PatternPlayer
99,PatternPlayer,220,230,450,28,26,PatternPlayer
100,PatternPlayer,221,236,457,26,23,PatternPlayer
101,PatternPlayer,225,230,455,24,23,PatternPlayer
102,PatternPlayer,211,251,462,31,23,PatternPlayer
103,PatternPlayer,204,264,468,34,22,PatternPlayer
104,PatternPlayer,226,226,452,24,24,Tie
105,PatternPlayer,211,241,452,33,27,PatternPlayer
106,PatternPlayer,212,257,469,29,20,PatternPlayer
107,PatternPlayer,212,242,454,32,26,PatternPlayer
108,PatternPlayer,246,181,427,17,30,Player A
109,PatternPlayer,226,226,452,24,24,Tie
110,PatternPlayer,235,210,445,20,25,Player A
111,PatternPlayer,219,239,458,27,23,PatternPlayer
112,PatternPlayer,211,241,452,33,27,PatternPlayer
113,PatternPlayer,244,189,433,17,28,Player A
114,PatternPlayer,212,252,464,30,22,PatternPlayer
115,PatternPlayer,229,224,453,22,23,Player A
116,PatternPlayer,226,236,462,22,20,PatternPlayer
117,PatternPlayer,218,248,466,26,20,PatternPlayer
118,PatternPlayer,228,213,441,25,28,Player A
119,PatternPlayer,223,228,451,26,25,PatternPlayer
120,PatternPlayer,221,236,457,26,23,PatternPlayer
121,PatternPlayer,226,211,437,27,30,Player A
122,PatternPlayer,224,229,453,25,24,PatternPlayer
123,PatternPlayer,218,248,466,26,20,PatternPlayer
124,PatternPlayer,222,232,454,26,24,PatternPlayer
125,PatternPlayer,216,236,452,30,26,PatternPlayer
126,PatternPlayer,230,215,445,23,26,Player A
127,PatternPlayer,219,244,463,26,21,PatternPlayer
128,PatternPlayer,221,231,452,27,25,PatternPlayer
129,PatternPlayer,216,231,447,31,28,PatternPlayer
130,PatternPlayer,233,218,451,20,23,Player A
131,PatternPlayer,223,228,451,26,25,PatternPlayer
132,PatternPlayer,218,248,466,26,20,PatternPlayer
133,PatternPlayer,227,212,439,26,29,Player A
134,PatternPlayer,224,234,458,24,22,PatternPlayer
135,PatternPlayer,231,226,457,20,21,Player A
136,PatternPlayer,223,223,446,27,27,Tie
137,PatternPlayer,221,236,457,26,23,PatternPlayer
138,PatternPlayer,227,217,444,25,27,Player A
139,PatternPlayer,235,205,440,21,27,Player A
140,PatternPlayer,225,225,450,25,25,Tie
141,PatternPlayer,214,244,458,30,24,PatternPlayer
142,PatternPlayer,226,216,442,26,28,Player A
143,PatternPlayer,212,262,474,28,18,PatternPlayer
144,PatternPlayer,226,216,442,26,28,Player A
145,PatternPlayer,225,240,465,22,19,PatternPlayer
146,PatternPlayer,221,221,442,29,29,Tie
147,PatternPlayer,220,240,460,26,22,PatternPlayer
148,PatternPlayer,227,222,449,24,25,Player A
149,PatternPlayer,228,223,451,23,24,Player A
150,PatternPlayer,231,226,457,20,21,Player A
151,PatternPlayer,227,217,444,25,27,Player A
152,PatternPlayer,236,206,442,20,26,Player A
153,PatternPlayer,228,218,446,24,26,Player A
154,PatternPlayer,223,223,446,27,27,Tie
155,PatternPlayer,233,218,451,20,23,Player A
156,PatternPlayer,225,215,440,27,29,Player A
157,PatternPlayer,227,217,444,25,27,Player A
158,PatternPlayer,230,220,450,22,24,Player A
159,PatternPlayer,240,195,435,19,28,Player A
160,PatternPlayer,229,214,443,24,27,Player A
161,PatternPlayer,237,207,444,19,25,Player A
162,PatternPlayer,230,225,455,21,22,Player A
163,PatternPlayer,232,197,429,25,32,Player A
164,PatternPlayer,232,202,434,24,30,Player A
165,PatternPlayer,204,274,478,32,18,PatternPlayer
166,PatternPlayer,222,217,439,29,30,Player A
167,PatternPlayer,231,221,452,21,23,Player A
168,PatternPlayer,223,218,441,28,29,Player A
169,PatternPlayer,218,238,456,28,24,PatternPlayer
170,PatternPlayer,223,228,451,26,25,PatternPlayer
171,PatternPlayer,218,233,451,29,26,PatternPlayer
172,PatternPlayer,236,191,427,23,32,Player A
173,PatternPlayer,234,209,443,21,26,Player A
174,PatternPlayer,231,211,442,23,27,Player A
175,PatternPlayer,219,239,458,27,23,PatternPlayer
176,PatternPlayer,231,216,447,22,25,Player A
177,PatternPlayer,225,220,445,26,27,Player A
178,PatternPlayer,230,220,450,22,24,Player A
179,PatternPlayer,224,214,438,28,30,Player A
180,PatternPlayer,222,237,459,25,22,PatternPlayer
181,PatternPlayer,224,239,463,23,20,PatternPlayer
182,PatternPlayer,220,240,460,26,22,PatternPlayer
183,PatternPlayer,217,242,459,28,23,PatternPlayer
184,PatternPlayer,232,217,449,21,24,Player A
185,PatternPlayer,236,196,432,22,30,Player A
186,PatternPlayer,225,210,435,28,31,Player A
187,PatternPlayer,229,224,453,22,23,Player A
188,PatternPlayer,233,208,441,22,27,Player A
189,PatternPlayer,221,236,457,26,23,PatternPlayer
190,PatternPlayer,219,249,468,25,19,PatternPlayer
191,PatternPlayer,220,230,450,28,26,PatternPlayer
192,PatternPlayer,224,219,443,27,28,Player A
193,PatternPlayer,231,221,452,21,23,Player A
194,PatternPlayer,228,228,456,22,22,Tie
195,PatternPlayer,233,223,456,19,21,Player A
196,PatternPlayer,228,218,446,24,26,Player A
197,PatternPlayer,217,252,469,26,19,PatternPlayer
198,PatternPlayer,232,227,459,19,20,Player A
199,PatternPlayer,227,212,439,26,29,Player A
200,PatternPlayer,224,234,458,24,22,PatternPlayer
201,PatternPlayer,222,222,444,28,28,Tie
202,PatternPlayer,227,222,449,24,25,Player A
203,PatternPlayer,222,242,464,24,20,PatternPlayer
204,PatternPlayer,230,200,430,26,32,Player A
205,PatternPlayer,227,232,459,22,21,PatternPlayer
206,PatternPlayer,220,235,455,27,24,PatternPlayer
207,PatternPlayer,217,232,449,30,27,PatternPlayer
208,PatternPlayer,226,226,452,24,24,Tie
209,PatternPlayer,223,223,446,27,27,Tie
210,PatternPlayer,224,239,463,23,20,PatternPlayer
211,PatternPlayer,230,215,445,23,26,Player A
212,PatternPlayer,225,220,445,26,27,Player A
213,PatternPlayer,229,209,438,25,29,Player A
214,PatternPlayer,218,253,471,25,18,PatternPlayer
215,PatternPlayer,228,223,451,23,24,Player A
216,PatternPlayer,213,243,456,31,25,PatternPlayer
217,PatternPlayer,229,224,453,22,23,Player A
218,PatternPlayer,226,231,457,23,22,PatternPlayer
219,PatternPlayer,206,271,477,31,18,PatternPlayer
220,PatternPlayer,229,229,458,21,21,Tie
221,PatternPlayer,228,223,451,23,24,Player A
222,PatternPlayer,225,215,440,27,29,Player A
223,PatternPlayer,219,234,453,28,25,PatternPlayer
224,PatternPlayer,227,222,449,24,25,Player A
225,PatternPlayer,226,231,457,23,22,PatternPlayer
226,PatternPlayer,227,222,449,24,25,Player A
227,PatternPlayer,224,229,453,25,24,PatternPlayer
228,PatternPlayer,219,244,463,26,21,PatternPlayer
229,PatternPlayer,226,226,452,24,24,Tie
230,PatternPlayer,216,241,457,29,24,PatternPlayer
231,PatternPlayer,229,209,438,25,29,Player A
232,PatternPlayer,232,212,444,22,26,Player A
233,PatternPlayer,225,225,450,25,25,Tie
234,PatternPlayer,234,214,448,20,24,Player A
235,PatternPlayer,217,242,459,28,23,PatternPlayer
236,PatternPlayer,218,233,451,29,26,PatternPlayer
237,PatternPlayer,238,188,426,22,32,Player A
238,PatternPlayer,227,227,454,23,23,Tie
239,PatternPlayer,222,242,464,24,20,PatternPlayer
240,PatternPlayer,221,231,452,27,25,PatternPlayer
241,PatternPlayer,240,180,420,22,34,Player A
242,PatternPlayer,221,216,437,30,31,Player A
243,PatternPlayer,235,195,430,23,31,Player A
244,PatternPlayer,235,200,435,22,29,Player A
245,PatternPlayer,221,231,452,27,25,PatternPlayer
246,PatternPlayer,224,239,463,23,20,PatternPlayer
247,PatternPlayer,215,250,465,28,21,PatternPlayer
248,PatternPlayer,242,202,444,16,24,Player A
249,PatternPlayer,240,185,425,21,32,Player A
250,PatternPlayer,227,222,449,24,25,Player A
251,PatternPlayer,231,211,442,23,27,Player A
252,PatternPlayer,223,243,466,23,19,PatternPlayer
253,PatternPlayer,226,236,462,22,20,PatternPlayer
254,PatternPlayer,217,247,464,27,21,PatternPlayer
255,PatternPlayer,222,242,464,24,20,PatternPlayer
256,PatternPlayer,233,218,451,20,23,Player A
257,PatternPlayer,208,253,461,33,24,PatternPlayer
258,PatternPlayer,230,215,445,23,26,Player A
259,PatternPlayer,219,239,458,27,23,PatternPlayer
260,PatternPlayer,229,224,453,22,23,Player A
261,PatternPlayer,218,238,456,28,24,PatternPlayer
262,PatternPlayer,237,202,439,20,27,Player A
263,PatternPlayer,239,179,418,23,35,Player A
264,PatternPlayer,229,214,443,24,27,Player A
265,PatternPlayer,219,239,458,27,23,PatternPlayer
266,PatternPlayer,208,253,461,33,24,PatternPlayer
267,PatternPlayer,225,225,450,25,25,Tie
268,PatternPlayer,235,195,430,23,31,Player A
269,PatternPlayer,222,217,439,29,30,Player A
270,PatternPlayer,229,204,433,26,31,Player A
271,PatternPlayer,220,245,465,25,20,PatternPlayer
272,PatternPlayer,231,221,452,21,23,Player A
273,PatternPlayer,216,246,462,28,22,PatternPlayer
274,PatternPlayer,230,215,445,23,26,Player A
275,PatternPlayer,225,235,460,23,21,PatternPlayer
276,PatternPlayer,224,219,443,27,28,Player A
277,PatternPlayer,216,236,452,30,26,PatternPlayer
278,PatternPlayer,213,248,461,30,23,PatternPlayer
279,PatternPlayer,216,246,462,28,22,PatternPlayer
280,PatternPlayer,228,223,451,23,24,Player A
281,PatternPlayer,215,245,460,29,23,PatternPlayer
282,PatternPlayer,233,213,446,21,25,Player A
283,PatternPlayer,222,232,454,26,24,PatternPlayer
284,PatternPlayer,219,229,448,29,27,PatternPlayer
285,PatternPlayer,237,197,434,21,29,Player A
286,PatternPlayer,234,204,438,22,28,Player A
287,PatternPlayer,230,220,450,22,24,Player A
288,PatternPlayer,222,222,444,28,28,Tie
289,PatternPlayer,223,238,461,24,21,PatternPlayer
290,PatternPlayer,229,219,448,23,25,Player A
291,PatternPlayer,219,234,453,28,25,PatternPlayer
292,PatternPlayer,219,229,448,29,27,PatternPlayer
293,PatternPlayer,231,221,452,21,23,Player A
294,PatternPlayer,222,237,459,25,22,PatternPlayer
295,PatternPlayer,228,218,446,24,26,Player A
296,PatternPlayer,224,219,443,27,28,Player A
297,PatternPlayer,238,188,426,22,32,Player A
298,PatternPlayer,223,238,461,24,21,PatternPlayer
299,PatternPlayer,216,236,452,30,26,PatternPlayer
300,PatternPlayer,232,232,464,18,18,Tie
301,PatternPlayer,235,205,440,21,27,Player A
302,PatternPlayer,236,201,437,21,28,Player A
303,PatternPlayer,223,223,446,27,27,Tie
304,PatternPlayer,219,239,458,27,23,PatternPlayer
305,PatternPlayer,233,213,446,21,25,Player A
306,PatternPlayer,205,255,460,35,25,PatternPlayer
307,PatternPlayer,221,246,467,24,19,PatternPlayer
308,PatternPlayer,228,218,446,24,26,Player A
309,PatternPlayer,226,221,447,25,26,Player A
310,PatternPlayer,230,225,455,21,22,Player A
311,PatternPlayer,225,225,450,25,25,Tie
312,PatternPlayer,218,233,451,29,26,PatternPlayer
313,PatternPlayer,220,240,460,26,22,PatternPlayer
314,PatternPlayer,227,212,439,26,29,Player A
315,PatternPlayer,228,213,441,25,28,Player A
316,PatternPlayer,219,244,463,26,21,PatternPlayer
317,PatternPlayer,240,190,430,20,30,Player A
318,PatternPlayer,235,205,440,21,27,Player A
319,PatternPlayer,225,225,450,25,25,Tie
320,PatternPlayer,213,253,466,29,21,PatternPlayer
321,PatternPlayer,240,185,425,21,32,Player A
322,PatternPlayer,221,236,457,26,23,PatternPlayer
323,PatternPlayer,220,240,460,26,22,PatternPlayer
324,PatternPlayer,219,229,448,29,27,PatternPlayer
325,PatternPlayer,224,224,448,26,26,Tie
326,PatternPlayer,227,217,444,25,27,Player A
327,PatternPlayer,219,244,463,26,21,PatternPlayer
328,PatternPlayer,232,207,439,23,28,Player A
329,PatternPlayer,229,209,438,25,29,Player A
330,PatternPlayer,214,254,468,28,20,PatternPlayer
331,PatternPlayer,223,248,471,22,17,PatternPlayer
0,GrudgePlayer,156,266,422,21,33,GrudgePlayer
1,GrudgePlayer,126,236,362,12,50,GrudgePlayer
2,GrudgePlayer,118,258,376,8,44,GrudgePlayer
3,GrudgePlayer,148,268,416,18,34,GrudgePlayer
4,GrudgePlayer,156,286,442,23,27,GrudgePlayer
5,GrudgePlayer,117,252,369,7,46,GrudgePlayer
6,GrudgePlayer,142,262,404,15,37,GrudgePlayer
7,GrudgePlayer,129,264,393,13,40,GrudgePlayer
8,GrudgePlayer,156,276,432,19,29,GrudgePlayer
9,GrudgePlayer,137,267,404,12,36,GrudgePlayer
10,GrudgePlayer,127,272,399,10,37,GrudgePlayer
11,GrudgePlayer,143,273,416,12,32,GrudgePlayer
12,GrudgePlayer,138,248,386,15,43,GrudgePlayer
13,GrudgePlayer,123,253,376,2,42,GrudgePlayer
14,GrudgePlayer,164,279,443,21,26,GrudgePlayer
15,GrudgePlayer,140,265,405,10,35,GrudgePlayer
16,GrudgePlayer,125,255,380,9,43,GrudgePlayer
17,GrudgePlayer,146,266,412,11,33,GrudgePlayer
18,GrudgePlayer,162,277,439,26,29,GrudgePlayer
19,GrudgePlayer,135,275,410,12,34,GrudgePlayer
20,GrudgePlayer,146,271,417,13,32,GrudgePlayer
21,GrudgePlayer,120,255,375,7,44,GrudgePlayer
22,GrudgePlayer,156,271,427,17,30,GrudgePlayer
23,GrudgePlayer,141,261,402,10,36,GrudgePlayer
24,GrudgePlayer,142,282,424,14,30,GrudgePlayer
25,GrudgePlayer,138,263,401,15,38,GrudgePlayer
26,GrudgePlayer,149,274,423,13,30,GrudgePlayer
27,GrudgePlayer,115,240,355,5,50,GrudgePlayer
28,GrudgePlayer,139,264,403,11,36,GrudgePlayer
29,GrudgePlayer,130,265,395,12,39,GrudgePlayer
30,GrudgePlayer,124,254,378,10,44,GrudgePlayer
31,GrudgePlayer,141,256,397,14,39,GrudgePlayer
32,GrudgePlayer,127,267,394,8,38,GrudgePlayer
33,GrudgePlayer,128,243,371,9,46,GrudgePlayer
34,GrudgePlayer,131,266,397,11,38,GrudgePlayer
35,GrudgePlayer,132,272,404,12,36,GrudgePlayer
36,GrudgePlayer,159,264,423,16,31,GrudgePlayer
37,GrudgePlayer,135,240,375,13,46,GrudgePlayer
38,GrudgePlayer,141,266,407,12,35,GrudgePlayer
39,GrudgePlayer,164,274,438,19,27,GrudgePlayer
40,GrudgePlayer,115,270,385,5,40,GrudgePlayer
41,GrudgePlayer,113,238,351,4,51,GrudgePlayer
42,GrudgePlayer,130,260,390,10,40,GrudgePlayer
43,GrudgePlayer,127,247,374,9,45,GrudgePlayer
44,GrudgePlayer,151,271,422,21,33,GrudgePlayer
45,GrudgePlayer,141,236,377,15,46,GrudgePlayer
46,GrudgePlayer,138,263,401,15,38,GrudgePlayer
47,GrudgePlayer,159,264,423,19,32,GrudgePlayer
48,GrudgePlayer,122,262,384,10,42,GrudgePlayer
49,GrudgePlayer,127,262,389,9,40,GrudgePlayer
50,GrudgePlayer,143,273,416,12,32,GrudgePlayer
51,GrudgePlayer,135,270,405,10,35,GrudgePlayer
52,GrudgePlayer,124,254,378,10,44,GrudgePlayer
53,GrudgePlayer,144,259,403,14,37,GrudgePlayer
54,GrudgePlayer,130,265,395,9,38,GrudgePlayer
55,GrudgePlayer,116,256,372,10,46,GrudgePlayer
56,GrudgePlayer,155,265,420,19,33,GrudgePlayer
57,GrudgePlayer,140,265,405,10,35,GrudgePlayer
58,GrudgePlayer,129,274,403,8,35,GrudgePlayer
59,GrudgePlayer,129,269,398,9,37,GrudgePlayer
60,GrudgePlayer,145,275,420,16,32,GrudgePlayer
61,GrudgePlayer,125,240,365,9,48,GrudgePlayer
62,GrudgePlayer,135,260,395,9,38,GrudgePlayer
63,GrudgePlayer,131,261,392,9,39,GrudgePlayer
64,GrudgePlayer,164,284,448,23,25,GrudgePlayer
65,GrudgePlayer,160,255,415,20,35,GrudgePlayer
66,GrudgePlayer,132,272,404,12,36,GrudgePlayer
67,GrudgePlayer,141,291,432,10,26,GrudgePlayer
68,GrudgePlayer,118,243,361,8,49,GrudgePlayer
69,GrudgePlayer,122,252,374,6,44,GrudgePlayer
70,GrudgePlayer,142,257,399,16,39,GrudgePlayer
71,GrudgePlayer,149,274,423,19,32,GrudgePlayer
72,GrudgePlayer,149,259,408,16,36,GrudgePlayer
73,GrudgePlayer,139,264,403,11,36,GrudgePlayer
74,GrudgePlayer,110,245,355,5,50,GrudgePlayer
75,GrudgePlayer,136,256,392,9,39,GrudgePlayer
76,GrudgePlayer,144,269,413,15,34,GrudgePlayer
77,GrudgePlayer,160,255,415,20,35,GrudgePlayer
78,GrudgePlayer,130,255,385,11,42,GrudgePlayer
79,GrudgePlayer,136,251,387,13,42,GrudgePlayer
80,GrudgePlayer,134,259,393,13,40,GrudgePlayer
81,GrudgePlayer,121,261,382,8,42,GrudgePlayer
82,GrudgePlayer,121,251,372,4,44,GrudgePlayer
83,GrudgePlayer,134,269,403,11,36,GrudgePlayer
84,GrudgePlayer,155,275,430,14,28,GrudgePlayer
85,GrudgePlayer,170,270,440,24,28,GrudgePlayer
86,GrudgePlayer,123,238,361,8,49,GrudgePlayer
87,GrudgePlayer,147,267,414,13,33,GrudgePlayer
88,GrudgePlayer,137,272,409,11,34,GrudgePlayer
89,GrudgePlayer,131,276,407,12,35,GrudgePlayer
90,GrudgePlayer,142,262,404,18,38,GrudgePlayer
91,GrudgePlayer,151,266,417,19,34,GrudgePlayer
92,GrudgePlayer,160,280,440,15,25,GrudgePlayer
93,GrudgePlayer,134,254,388,11,41,GrudgePlayer
94,GrudgePlayer,111,256,367,8,47,GrudgePlayer
95,GrudgePlayer,155,270,425,15,30,GrudgePlayer
96,GrudgePlayer,118,238,356,6,50,GrudgePlayer
97,GrudgePlayer,154,264,418,20,34,GrudgePlayer
98,GrudgePlayer,129,249,378,10,44,GrudgePlayer
99,GrudgePlayer,126,256,382,11,43,GrudgePlayer
100,GrudgePlayer,170,280,450,22,24,GrudgePlayer
101,GrudgePlayer,142,282,424,20,32,GrudgePlayer
102,GrudgePlayer,155,280,435,13,26,GrudgePlayer
103,GrudgePlayer,133,248,381,16,45,GrudgePlayer
104,GrudgePlayer,145,255,400,17,39,GrudgePlayer
105,GrudgePlayer,123,243,366,7,47,GrudgePlayer
106,GrudgePlayer,119,249,368,6,46,GrudgePlayer
107,GrudgePlayer,112,257,369,4,45,GrudgePlayer
108,GrudgePlayer,109,249,358,5,49,GrudgePlayer
109,GrudgePlayer,148,263,411,16,35,GrudgePlayer
110,GrudgePlayer,118,253,371,6,45,GrudgePlayer
111,GrudgePlayer,125,245,370,11,47,GrudgePlayer
112,GrudgePlayer,120,260,380,9,43,GrudgePlayer
113,GrudgePlayer,134,264,398,12,38,GrudgePlayer
114,GrudgePlayer,145,265,410,12,34,GrudgePlayer
115,GrudgePlayer,129,244,373,14,47,GrudgePlayer
116,GrudgePlayer,155,280,435,19,28,GrudgePlayer
117,GrudgePlayer,118,258,376,5,43,GrudgePlayer
118,GrudgePlayer,127,262,389,9,40,GrudgePlayer
119,GrudgePlayer,142,267,409,14,35,GrudgePlayer
120,GrudgePlayer,122,257,379,8,43,GrudgePlayer
121,GrudgePlayer,158,258,416,18,34,GrudgePlayer
122,GrudgePlayer,152,282,434,18,28,GrudgePlayer
123,GrudgePlayer,142,257,399,13,38,GrudgePlayer
124,GrudgePlayer,137,262,399,13,38,GrudgePlayer
125,GrudgePlayer,153,263,416,21,35,GrudgePlayer
126,GrudgePlayer,137,272,409,8,33,GrudgePlayer
127,GrudgePlayer,134,239,373,11,46,GrudgePlayer
128,GrudgePlayer,135,270,405,16,37,GrudgePlayer
129,GrudgePlayer,143,268,411,16,35,GrudgePlayer
130,GrudgePlayer,156,291,447,19,24,GrudgePlayer
131,GrudgePlayer,125,255,380,12,44,GrudgePlayer
132,GrudgePlayer,143,253,396,16,40,GrudgePlayer
133,GrudgePlayer,128,273,401,9,36,GrudgePlayer
134,GrudgePlayer,150,265,415,17,34,GrudgePlayer
135,GrudgePlayer,151,256,407,15,36,GrudgePlayer
136,GrudgePlayer,121,256,377,9,44,GrudgePlayer
137,GrudgePlayer,148,278,426,16,30,GrudgePlayer
138,GrudgePlayer,137,272,409,17,36,GrudgePlayer
139,GrudgePlayer,118,253,371,9,46,GrudgePlayer
140,GrudgePlayer,140,265,405,10,35,GrudgePlayer
141,GrudgePlayer,157,292,449,18,23,GrudgePlayer
142,GrudgePlayer,143,253,396,10,38,GrudgePlayer
143,GrudgePlayer,163,273,436,23,29,GrudgePlayer
144,GrudgePlayer,144,259,403,11,36,GrudgePlayer
145,GrudgePlayer,150,280,430,17,29,GrudgePlayer
146,GrudgePlayer,133,258,391,11,40,GrudgePlayer
147,GrudgePlayer,121,236,357,7,50,GrudgePlayer
148,GrudgePlayer,136,271,407,9,34,GrudgePlayer
149,GrudgePlayer,139,244,383,12,43,GrudgePlayer
150,GrudgePlayer,147,282,429,13,28,GrudgePlayer
151,GrudgePlayer,125,255,380,9,43,GrudgePlayer
152,GrudgePlayer,150,275,425,15,30,GrudgePlayer
153,GrudgePlayer,161,276,437,21,28,GrudgePlayer
154,GrudgePlayer,127,262,389,6,39,GrudgePlayer
155,GrudgePlayer,133,258,391,17,42,GrudgePlayer
156,GrudgePlayer,159,259,418,20,34,GrudgePlayer
157,GrudgePlayer,136,256,392,9,39,GrudgePlayer
158,GrudgePlayer,131,271,402,7,35,GrudgePlayer
159,GrudgePlayer,145,265,410,15,35,GrudgePlayer
160,GrudgePlayer,143,258,401,15,38,GrudgePlayer
161,GrudgePlayer,152,282,434,18,28,GrudgePlayer
162,GrudgePlayer,145,250,395,15,40,GrudgePlayer
163,GrudgePlayer,108,238,346,5,53,GrudgePlayer
164,GrudgePlayer,146,271,417,16,33,GrudgePlayer
165,GrudgePlayer,137,252,389,15,42,GrudgePlayer
166,GrudgePlayer,128,263,391,14,41,GrudgePlayer
167,GrudgePlayer,160,270,430,17,29,GrudgePlayer
168,GrudgePlayer,127,272,399,10,37,GrudgePlayer
169,GrudgePlayer,109,229,338,6,56,GrudgePlayer
170,GrudgePlayer,134,269,403,11,36,GrudgePlayer
171,GrudgePlayer,113,248,361,5,48,GrudgePlayer
172,GrudgePlayer,126,251,377,9,44,GrudgePlayer
173,GrudgePlayer,134,274,408,10,34,GrudgePlayer
174,GrudgePlayer,131,266,397,11,38,GrudgePlayer
175,GrudgePlayer,139,264,403,14,37,GrudgePlayer
176,GrudgePlayer,163,273,436,23,29,GrudgePlayer
177,GrudgePlayer,135,260,395,15,40,GrudgePlayer
178,GrudgePlayer,157,262,419,21,34,GrudgePlayer
179,GrudgePlayer,152,272,424,17,31,GrudgePlayer
180,GrudgePlayer,114,254,368,6,46,GrudgePlayer
181,GrudgePlayer,122,252,374,9,45,GrudgePlayer
182,GrudgePlayer,117,252,369,7,46,GrudgePlayer
183,GrudgePlayer,138,263,401,18,39,GrudgePlayer
184,GrudgePlayer,126,256,382,8,42,GrudgePlayer
185,GrudgePlayer,124,249,373,5,44,GrudgePlayer
186,GrudgePlayer,141,261,402,13,37,GrudgePlayer
187,GrudgePlayer,125,265,390,10,40,GrudgePlayer
188,GrudgePlayer,159,279,438,25,29,GrudgePlayer
189,GrudgePlayer,125,245,370,8,46,GrudgePlayer
190,GrudgePlayer,141,271,412,14,34,GrudgePlayer
191,GrudgePlayer,154,264,418,20,34,GrudgePlayer
192,GrudgePlayer,127,257,384,10,42,GrudgePlayer
193,GrudgePlayer,124,264,388,5,39,GrudgePlayer
194,GrudgePlayer,135,260,395,12,39,GrudgePlayer
195,GrudgePlayer,129,249,378,10,44,GrudgePlayer
196,GrudgePlayer,141,271,412,11,33,GrudgePlayer
197,GrudgePlayer,135,280,415,14,33,GrudgePlayer
198,GrudgePlayer,128,258,386,9,41,GrudgePlayer
199,GrudgePlayer,143,273,416,15,33,GrudgePlayer
200,GrudgePlayer,143,293,436,14,26,GrudgePlayer
201,GrudgePlayer,154,264,418,20,34,GrudgePlayer
202,GrudgePlayer,123,273,396,13,39,GrudgePlayer
203,GrudgePlayer,135,260,395,12,39,GrudgePlayer
204,GrudgePlayer,139,279,418,14,32,GrudgePlayer
205,GrudgePlayer,141,266,407,12,35,GrudgePlayer
206,GrudgePlayer,158,278,436,14,26,GrudgePlayer
207,GrudgePlayer,138,268,406,11,35,GrudgePlayer
208,GrudgePlayer,148,248,396,16,40,GrudgePlayer
209,GrudgePlayer,121,266,387,7,40,GrudgePlayer
210,GrudgePlayer,122,252,374,9,45,GrudgePlayer
211,GrudgePlayer,159,279,438,16,26,GrudgePlayer
212,GrudgePlayer,121,276,397,11,38,GrudgePlayer
213,GrudgePlayer,164,284,448,20,24,GrudgePlayer
214,GrudgePlayer,133,253,386,12,42,GrudgePlayer
215,GrudgePlayer,146,256,402,13,37,GrudgePlayer
216,GrudgePlayer,159,264,423,19,32,GrudgePlayer
217,GrudgePlayer,139,284,423,16,31,GrudgePlayer
218,GrudgePlayer,115,255,370,5,45,GrudgePlayer
219,GrudgePlayer,175,260,435,28,31,GrudgePlayer
220,GrudgePlayer,135,260,395,15,40,GrudgePlayer
221,GrudgePlayer,163,268,431,21,30,GrudgePlayer
222,GrudgePlayer,119,249,368,6,46,GrudgePlayer
223,GrudgePlayer,153,273,426,16,30,GrudgePlayer
224,GrudgePlayer,125,270,395,9,38,GrudgePlayer
225,GrudgePlayer,132,252,384,10,42,GrudgePlayer
226,GrudgePlayer,138,253,391,11,40,GrudgePlayer
227,GrudgePlayer,117,247,364,8,48,GrudgePlayer
228,GrudgePlayer,147,287,434,15,27,GrudgePlayer
229,GrudgePlayer,145,270,415,17,34,GrudgePlayer
230,GrudgePlayer,134,269,403,11,36,GrudgePlayer
231,GrudgePlayer,165,280,445,20,25,GrudgePlayer
232,GrudgePlayer,135,265,400,8,36,GrudgePlayer
233,GrudgePlayer,139,279,418,14,32,GrudgePlayer
234,GrudgePlayer,131,266,397,11,38,GrudgePlayer
235,GrudgePlayer,148,253,401,12,37,GrudgePlayer
236,GrudgePlayer,116,276,392,6,38,GrudgePlayer
237,GrudgePlayer,139,259,398,15,39,GrudgePlayer
238,GrudgePlayer,155,275,430,20,30,GrudgePlayer
239,GrudgePlayer,142,272,414,16,34,GrudgePlayer
240,GrudgePlayer,142,272,414,16,34,GrudgePlayer
241,GrudgePlayer,132,272,404,6,34,GrudgePlayer
242,GrudgePlayer,147,282,429,16,29,GrudgePlayer
243,GrudgePlayer,142,242,384,13,43,GrudgePlayer
244,GrudgePlayer,149,274,423,16,31,GrudgePlayer
245,GrudgePlayer,135,265,400,11,37,GrudgePlayer
246,GrudgePlayer,127,272,399,10,37,GrudgePlayer
247,GrudgePlayer,121,261,382,8,42,GrudgePlayer
248,GrudgePlayer,122,242,364,11,49,GrudgePlayer
249,GrudgePlayer,137,272,409,14,35,GrudgePlayer
250,GrudgePlayer,146,286,432,16,28,GrudgePlayer
251,GrudgePlayer,121,251,372,7,45,GrudgePlayer
252,GrudgePlayer,135,260,395,12,39,GrudgePlayer
253,GrudgePlayer,127,257,384,10,42,GrudgePlayer
254,GrudgePlayer,142,247,389,12,41,GrudgePlayer
255,GrudgePlayer,118,253,371,6,45,GrudgePlayer
256,GrudgePlayer,116,251,367,5,46,GrudgePlayer
257,GrudgePlayer,147,272,419,18,33,GrudgePlayer
258,GrudgePlayer,135,255,390,10,40,GrudgePlayer
259,GrudgePlayer,131,261,392,12,40,GrudgePlayer
260,GrudgePlayer,177,277,454,23,23,GrudgePlayer
261,GrudgePlayer,128,253,381,10,43,GrudgePlayer
262,GrudgePlayer,145,270,415,14,33,GrudgePlayer
263,GrudgePlayer,132,242,374,12,46,GrudgePlayer
264,GrudgePlayer,148,273,421,14,31,GrudgePlayer
265,GrudgePlayer,111,241,352,8,52,GrudgePlayer
266,GrudgePlayer,150,250,400,17,39,GrudgePlayer
267,GrudgePlayer,126,241,367,8,47,GrudgePlayer
268,GrudgePlayer,116,241,357,10,51,GrudgePlayer
269,GrudgePlayer,136,261,397,5,36,GrudgePlayer
270,GrudgePlayer,106,256,362,3,47,GrudgePlayer
271,GrudgePlayer,156,256,412,17,35,GrudgePlayer
272,GrudgePlayer,137,262,399,13,38,GrudgePlayer
273,GrudgePlayer,140,270,410,15,35,GrudgePlayer
274,GrudgePlayer,123,268,391,5,38,GrudgePlayer
275,GrudgePlayer,176,271,447,25,26,GrudgePlayer
276,GrudgePlayer,115,265,380,9,43,GrudgePlayer
277,GrudgePlayer,128,253,381,10,43,GrudgePlayer
278,GrudgePlayer,118,253,371,6,45,GrudgePlayer
279,GrudgePlayer,151,256,407,18,37,GrudgePlayer
280,GrudgePlayer,156,261,417,19,34,GrudgePlayer
281,GrudgePlayer,114,244,358,5,49,GrudgePlayer
282,GrudgePlayer,157,272,429,19,30,GrudgePlayer
283,GrudgePlayer,128,278,406,8,34,GrudgePlayer
284,GrudgePlayer,128,263,391,2,37,GrudgePlayer
285,GrudgePlayer,124,264,388,5,39,GrudgePlayer
286,GrudgePlayer,153,278,431,18,29,GrudgePlayer
287,GrudgePlayer,116,231,347,9,54,GrudgePlayer
288,GrudgePlayer,166,256,422,21,33,GrudgePlayer
289,GrudgePlayer,117,247,364,5,47,GrudgePlayer
290,GrudgePlayer,151,281,432,16,28,GrudgePlayer
291,GrudgePlayer,118,253,371,9,46,GrudgePlayer
292,GrudgePlayer,147,267,414,16,34,GrudgePlayer
293,GrudgePlayer,139,259,398,9,37,GrudgePlayer
294,GrudgePlayer,153,263,416,21,35,GrudgePlayer
295,GrudgePlayer,122,257,379,8,43,GrudgePlayer
296,GrudgePlayer,142,267,409,11,34,GrudgePlayer
297,GrudgePlayer,147,267,414,13,33,GrudgePlayer
298,GrudgePlayer,151,271,422,18,32,GrudgePlayer
299,GrudgePlayer,146,281,427,17,30,GrudgePlayer
300,GrudgePlayer,121,251,372,7,45,GrudgePlayer
301,GrudgePlayer,132,247,379,11,44,GrudgePlayer
302,GrudgePlayer,119,229,348,10,54,GrudgePlayer
303,GrudgePlayer,101,246,347,6,53,GrudgePlayer
304,GrudgePlayer,122,252,374,9,45,GrudgePlayer
305,GrudgePlayer,143,268,411,10,33,GrudgePlayer
306,GrudgePlayer,140,260,400,11,37,GrudgePlayer
307,GrudgePlayer,150,265,415,14,33,GrudgePlayer
308,GrudgePlayer,145,265,410,18,36,GrudgePlayer
309,GrudgePlayer,148,273,421,20,33,GrudgePlayer
310,GrudgePlayer,169,269,438,25,29,GrudgePlayer
311,GrudgePlayer,130,275,405,13,36,GrudgePlayer
312,GrudgePlayer,140,260,400,14,38,GrudgePlayer
313,GrudgePlayer,127,247,374,12,46,GrudgePlayer
314,GrudgePlayer,154,279,433,20,29,GrudgePlayer
315,GrudgePlayer,126,256,382,8,42,GrudgePlayer
316,GrudgePlayer,151,271,422,18,32,GrudgePlayer
317,GrudgePlayer,163,288,451,23,24,GrudgePlayer
318,GrudgePlayer,144,274,418,11,31,GrudgePlayer
319,GrudgePlayer,131,261,392,9,39,GrudgePlayer
320,GrudgePlayer,145,270,415,17,34,GrudgePlayer
321,GrudgePlayer,118,248,366,7,47,GrudgePlayer
322,GrudgePlayer,121,266,387,10,41,GrudgePlayer
323,GrudgePlayer,132,257,389,9,40,GrudgePlayer
324,GrudgePlayer,130,245,375,10,45,GrudgePlayer
325,GrudgePlayer,114,259,373,5,44,GrudgePlayer
326,GrudgePlayer,157,282,439,17,26,GrudgePlayer
327,GrudgePlayer,134,249,383,9,42,GrudgePlayer
328,GrudgePlayer,143,273,416,12,32,GrudgePlayer
329,GrudgePlayer,120,260,380,12,44,GrudgePlayer
330,GrudgePlayer,134,264,398,9,37,GrudgePlayer
331,GrudgePlayer,146,266,412,14,34,GrudgePlayer
332,GrudgePlayer,152,262,414,19,35,GrudgePlayer
333,GrudgePlayer,138,268,406,17,37,GrudgePlayer
334,GrudgePlayer,131,266,397,11,38,GrudgePlayer
335,GrudgePlayer,158,258,416,18,34,GrudgePlayer
336,GrudgePlayer,128,253,381,16,45,GrudgePlayer
337,GrudgePlayer,148,268,416,15,33,GrudgePlayer
338,GrudgePlayer,150,280,430,17,29,GrudgePlayer
339,GrudgePlayer,145,255,400,11,37,GrudgePlayer
340,GrudgePlayer,116,256,372,7,45,GrudgePlayer
341,GrudgePlayer,137,277,414,10,32,GrudgePlayer
342,GrudgePlayer,136,276,412,8,32,GrudgePlayer
343,GrudgePlayer,138,263,401,12,37,GrudgePlayer
344,GrudgePlayer,145,290,435,16,27,GrudgePlayer
345,GrudgePlayer,148,253,401,12,37,GrudgePlayer
346,GrudgePlayer,138,258,396,16,40,GrudgePlayer
347,GrudgePlayer,134,254,388,14,42,GrudgePlayer
348,GrudgePlayer,121,236,357,4,49,GrudgePlayer
349,GrudgePlayer,140,285,425,15,30,GrudgePlayer
350,GrudgePlayer,130,280,410,9,33,GrudgePlayer
351,GrudgePlayer,121,256,377,9,44,GrudgePlayer
352,GrudgePlayer,142,257,399,16,39,GrudgePlayer
353,GrudgePlayer,136,261,397,8,37,GrudgePlayer
354,GrudgePlayer,139,274,413,12,33,GrudgePlayer
355,GrudgePlayer,141,261,402,16,38,GrudgePlayer
356,GrudgePlayer,135,245,380,12,44,GrudgePlayer
357,GrudgePlayer,153,268,421,14,31,GrudgePlayer
358,GrudgePlayer,147,282,429,13,28,GrudgePlayer
359,GrudgePlayer,133,238,371,12,47,GrudgePlayer
360,GrudgePlayer,127,252,379,8,43,GrudgePlayer
361,GrudgePlayer,132,262,394,8,38,GrudgePlayer
362,GrudgePlayer,139,279,418,11,31,GrudgePlayer
363,GrudgePlayer,133,248,381,10,43,GrudgePlayer
364,GrudgePlayer,131,266,397,11,38,GrudgePlayer
365,GrudgePlayer,154,264,418,20,34,GrudgePlayer
366,GrudgePlayer,136,256,392,9,39,GrudgePlayer
367,GrudgePlayer,151,261,412,20,36,GrudgePlayer
368,GrudgePlayer,131,266,397,11,38,GrudgePlayer
369,GrudgePlayer,123,238,361,11,50,GrudgePlayer
370,GrudgePlayer,167,267,434,18,28,GrudgePlayer
371,GrudgePlayer,124,269,393,10,39,GrudgePlayer
372,GrudgePlayer,136,236,372,13,47,GrudgePlayer
373,GrudgePlayer,128,258,386,6,40,GrudgePlayer
374,GrudgePlayer,136,261,397,8,37,GrudgePlayer
375,GrudgePlayer,141,271,412,11,33,GrudgePlayer
376,GrudgePlayer,160,265,425,21,32,GrudgePlayer
377,GrudgePlayer,135,270,405,10,35,GrudgePlayer
378,GrudgePlayer,140,260,400,14,38,GrudgePlayer
379,GrudgePlayer,123,238,361,8,49,GrudgePlayer
380,GrudgePlayer,140,265,405,10,35,GrudgePlayer
381,GrudgePlayer,143,263,406,14,36,GrudgePlayer
382,GrudgePlayer,114,264,378,7,43,GrudgePlayer
383,GrudgePlayer,134,264,398,9,37,GrudgePlayer
384,GrudgePlayer,149,269,418,14,32,GrudgePlayer
385,GrudgePlayer,138,248,386,9,41,GrudgePlayer
386,GrudgePlayer,125,265,390,10,40,GrudgePlayer
387,GrudgePlayer,138,283,421,11,30,GrudgePlayer
388,GrudgePlayer,123,268,391,5,38,GrudgePlayer
389,GrudgePlayer,139,279,418,17,33,GrudgePlayer
390,GrudgePlayer,123,253,376,5,43,GrudgePlayer
391,GrudgePlayer,143,268,411,13,34,GrudgePlayer
392,GrudgePlayer,142,267,409,17,36,GrudgePlayer
393,GrudgePlayer,118,248,366,7,47,GrudgePlayer
394,GrudgePlayer,156,276,432,19,29,GrudgePlayer
395,GrudgePlayer,141,261,402,13,37,GrudgePlayer
396,GrudgePlayer,129,254,383,9,42,GrudgePlayer
397,GrudgePlayer,152,267,419,15,32,GrudgePlayer
398,GrudgePlayer,153,278,431,15,28,GrudgePlayer
399,GrudgePlayer,168,273,441,19,26,GrudgePlayer
400,GrudgePlayer,104,264,368,3,45,GrudgePlayer
401,GrudgePlayer,120,255,375,10,45,GrudgePlayer
402,GrudgePlayer,136,256,392,9,39,GrudgePlayer
403,GrudgePlayer,130,265,395,12,39,GrudgePlayer
404,GrudgePlayer,136,256,392,12,40,GrudgePlayer
405,GrudgePlayer,139,244,383,12,43,GrudgePlayer
406,GrudgePlayer,135,240,375,10,45,GrudgePlayer
407,GrudgePlayer,174,279,453,28,25,GrudgePlayer
408,GrudgePlayer,126,261,387,16,43,GrudgePlayer
409,GrudgePlayer,141,256,397,14,39,GrudgePlayer
410,GrudgePlayer,130,250,380,9,43,GrudgePlayer
411,GrudgePlayer,129,254,383,6,41,GrudgePlayer
412,GrudgePlayer,128,253,381,7,42,GrudgePlayer
413,GrudgePlayer,120,245,365,3,46,GrudgePlayer
414,GrudgePlayer,119,264,383,9,42,GrudgePlayer
415,GrudgePlayer,145,265,410,15,35,GrudgePlayer
416,GrudgePlayer,106,261,367,5,46,GrudgePlayer
417,GrudgePlayer,123,258,381,7,42,GrudgePlayer
418,GrudgePlayer,110,260,370,5,45,GrudgePlayer
419,GrudgePlayer,142,272,414,16,34,GrudgePlayer
420,GrudgePlayer,120,250,370,5,45,GrudgePlayer
421,GrudgePlayer,126,251,377,9,44,GrudgePlayer
422,GrudgePlayer,112,277,389,3,38,GrudgePlayer
423,GrudgePlayer,135,265,400,11,37,GrudgePlayer
424,GrudgePlayer,137,262,399,13,38,GrudgePlayer
425,GrudgePlayer,131,256,387,10,41,GrudgePlayer
426,GrudgePlayer,145,260,405,13,36,GrudgePlayer
427,GrudgePlayer,137,262,399,16,39,GrudgePlayer
428,GrudgePlayer,146,266,412,17,35,GrudgePlayer
429,GrudgePlayer,172,282,454,26,24,GrudgePlayer
430,GrudgePlayer,129,239,368,9,47,GrudgePlayer
431,GrudgePlayer,142,262,404,15,37,GrudgePlayer
432,GrudgePlayer,130,265,395,9,38,GrudgePlayer
433,GrudgePlayer,127,237,364,11,49,GrudgePlayer
434,GrudgePlayer,126,241,367,5,46,GrudgePlayer
435,GrudgePlayer,147,262,409,11,34,GrudgePlayer
436,GrudgePlayer,112,267,379,8,43,GrudgePlayer
437,GrudgePlayer,145,240,385,14,43,GrudgePlayer
438,GrudgePlayer,122,252,374,9,45,GrudgePlayer
439,GrudgePlayer,151,261,412,14,34,GrudgePlayer
440,GrudgePlayer,125,270,395,9,38,GrudgePlayer
441,GrudgePlayer,146,271,417,16,33,GrudgePlayer
442,GrudgePlayer,129,269,398,9,37,GrudgePlayer
443,GrudgePlayer,133,258,391,8,39,GrudgePlayer
444,GrudgePlayer,140,265,405,16,37,GrudgePlayer
445,GrudgePlayer,129,269,398,9,37,GrudgePlayer
446,GrudgePlayer,158,273,431,15,28,GrudgePlayer
447,GrudgePlayer,145,270,415,20,35,GrudgePlayer
448,GrudgePlayer,146,261,407,12,35,GrudgePlayer
449,GrudgePlayer,134,269,403,8,35,GrudgePlayer
450,GrudgePlayer,128,273,401,9,36,GrudgePlayer
451,GrudgePlayer,130,260,390,10,40,GrudgePlayer
452,GrudgePlayer,126,261,387,10,41,GrudgePlayer
453,GrudgePlayer,138,258,396,13,39,GrudgePlayer
454,GrudgePlayer,142,247,389,15,42,GrudgePlayer
455,GrudgePlayer,120,255,375,7,44,GrudgePlayer
456,GrudgePlayer,149,279,428,18,30,GrudgePlayer
457,GrudgePlayer,143,253,396,16,40,GrudgePlayer
458,GrudgePlayer,116,251,367,5,46,GrudgePlayer
459,GrudgePlayer,135,270,405,13,36,GrudgePlayer
460,GrudgePlayer,112,262,374,9,45,GrudgePlayer
461,GrudgePlayer,114,234,348,10,54,GrudgePlayer
462,GrudgePlayer,128,248,376,8,44,GrudgePlayer
463,GrudgePlayer,95,230,325,2,59,GrudgePlayer
464,GrudgePlayer,123,258,381,10,43,GrudgePlayer
465,GrudgePlayer,161,246,407,24,39,GrudgePlayer
466,GrudgePlayer,128,258,386,9,41,GrudgePlayer
467,GrudgePlayer,161,286,447,25,26,GrudgePlayer
468,GrudgePlayer,165,270,435,22,29,GrudgePlayer
469,GrudgePlayer,134,239,373,8,45,GrudgePlayer
470,GrudgePlayer,124,269,393,10,39,GrudgePlayer
471,GrudgePlayer,116,256,372,4,44,GrudgePlayer
472,GrudgePlayer,132,267,399,13,38,GrudgePlayer
473,GrudgePlayer,121,256,377,9,44,GrudgePlayer
474,GrudgePlayer,124,264,388,5,39,GrudgePlayer
475,GrudgePlayer,141,261,402,13,37,GrudgePlayer
476,GrudgePlayer,116,236,352,8,52,GrudgePlayer
477,GrudgePlayer,116,261,377,6,43,GrudgePlayer
478,GrudgePlayer,108,268,376,5,43,GrudgePlayer
479,GrudgePlayer,132,277,409,11,34,GrudgePlayer
480,GrudgePlayer,142,277,419,15,32,GrudgePlayer
481,GrudgePlayer,119,234,353,6,51,GrudgePlayer
482,GrudgePlayer,122,262,384,10,42,GrudgePlayer
483,GrudgePlayer,123,263,386,12,42,GrudgePlayer
484,GrudgePlayer,138,263,401,9,36,GrudgePlayer
485,GrudgePlayer,163,283,446,18,24,GrudgePlayer
486,GrudgePlayer,165,285,450,22,24,GrudgePlayer
487,GrudgePlayer,126,231,357,10,51,GrudgePlayer
488,GrudgePlayer,130,245,375,7,44,GrudgePlayer
489,GrudgePlayer,163,278,441,19,26,GrudgePlayer
490,GrudgePlayer,145,265,410,15,35,GrudgePlayer
491,GrudgePlayer,140,280,420,16,32,GrudgePlayer
492,GrudgePlayer,132,252,384,10,42,GrudgePlayer
493,GrudgePlayer,146,261,407,18,37,GrudgePlayer
494,GrudgePlayer,154,264,418,17,33,GrudgePlayer
495,GrudgePlayer,107,227,334,5,57,GrudgePlayer
496,GrudgePlayer,139,269,408,13,35,GrudgePlayer
497,GrudgePlayer,149,274,423,16,31,GrudgePlayer
498,GrudgePlayer,133,248,381,13,44,GrudgePlayer
499,GrudgePlayer,135,260,395,9,38,GrudgePlayer
500,GrudgePlayer,124,249,373,5,44,GrudgePlayer
501,GrudgePlayer,128,278,406,8,34,GrudgePlayer
502,GrudgePlayer,118,258,376,5,43,GrudgePlayer
503,GrudgePlayer,116,251,367,5,46,GrudgePlayer
504,GrudgePlayer,137,262,399,7,36,GrudgePlayer
505,GrudgePlayer,152,267,419,15,32,GrudgePlayer
506,GrudgePlayer,140,265,405,10,35,GrudgePlayer
507,GrudgePlayer,164,274,438,22,28,GrudgePlayer
508,GrudgePlayer,151,276,427,14,29,GrudgePlayer
509,GrudgePlayer,121,241,362,6,48,GrudgePlayer
510,GrudgePlayer,128,278,406,8,34,GrudgePlayer
511,GrudgePlayer,156,276,432,16,28,GrudgePlayer
512,GrudgePlayer,132,267,399,13,38,GrudgePlayer
513,GrudgePlayer,130,240,370,5,45,GrudgePlayer
514,GrudgePlayer,163,278,441,22,27,GrudgePlayer
515,GrudgePlayer,137,257,394,14,40,GrudgePlayer
516,GrudgePlayer,118,238,356,9,51,GrudgePlayer
517,GrudgePlayer,142,252,394,14,40,GrudgePlayer
518,GrudgePlayer,146,266,412,14,34,GrudgePlayer
519,GrudgePlayer,118,258,376,8,44,GrudgePlayer
520,GrudgePlayer,113,228,341,6,55,GrudgePlayer
521,GrudgePlayer,142,257,399,13,38,GrudgePlayer
522,GrudgePlayer,132,257,389,12,41,GrudgePlayer
523,GrudgePlayer,168,283,451,23,24,GrudgePlayer
524,GrudgePlayer,143,268,411,13,34,GrudgePlayer
525,GrudgePlayer,150,260,410,18,36,GrudgePlayer
526,GrudgePlayer,136,266,402,10,36,GrudgePlayer
527,GrudgePlayer,132,247,379,11,44,GrudgePlayer
528,GrudgePlayer,139,259,398,15,39,GrudgePlayer
529,GrudgePlayer,139,264,403,14,37,GrudgePlayer
530,GrudgePlayer,137,262,399,19,40,GrudgePlayer
531,GrudgePlayer,176,286,462,28,22,GrudgePlayer
532,GrudgePlayer,147,272,419,15,32,GrudgePlayer
533,GrudgePlayer,113,253,366,4,46,GrudgePlayer
534,GrudgePlayer,125,245,370,11,47,GrudgePlayer
535,GrudgePlayer,137,272,409,11,34,GrudgePlayer
536,GrudgePlayer,173,283,456,25,23,GrudgePlayer
537,GrudgePlayer,130,270,400,14,38,GrudgePlayer
538,GrudgePlayer,130,255,385,11,42,GrudgePlayer
539,GrudgePlayer,137,257,394,17,41,GrudgePlayer
540,GrudgePlayer,149,264,413,18,35,GrudgePlayer
541,GrudgePlayer,154,259,413,24,37,GrudgePlayer
542,GrudgePlayer,143,253,396,10,38,GrudgePlayer
543,GrudgePlayer,138,258,396,10,38,GrudgePlayer
544,GrudgePlayer,131,266,397,11,38,GrudgePlayer
545,GrudgePlayer,144,264,408,13,35,GrudgePlayer
546,GrudgePlayer,128,248,376,11,45,GrudgePlayer
547,GrudgePlayer,144,269,413,12,33,GrudgePlayer
548,GrudgePlayer,155,265,420,19,33,GrudgePlayer
549,GrudgePlayer,133,273,406,5,33,GrudgePlayer
550,GrudgePlayer,132,237,369,13,48,GrudgePlayer
551,GrudgePlayer,143,278,421,14,31,GrudgePlayer
552,GrudgePlayer,120,235,355,5,50,GrudgePlayer
553,GrudgePlayer,111,241,352,5,51,GrudgePlayer
554,GrudgePlayer,137,277,414,13,33,GrudgePlayer
555,GrudgePlayer,125,255,380,6,42,GrudgePlayer
556,GrudgePlayer,124,249,373,5,44,GrudgePlayer
557,GrudgePlayer,131,246,377,9,44,GrudgePlayer
558,GrudgePlayer,160,270,430,17,29,GrudgePlayer
559,GrudgePlayer,149,274,423,16,31,GrudgePlayer
560,GrudgePlayer,149,269,418,20,34,GrudgePlayer
561,GrudgePlayer,138,268,406,14,36,GrudgePlayer
562,GrudgePlayer,139,269,408,13,35,GrudgePlayer
563,GrudgePlayer,143,263,406,17,37,GrudgePlayer
564,GrudgePlayer,136,266,402,13,37,GrudgePlayer
565,GrudgePlayer,116,246,362,6,48,GrudgePlayer
566,GrudgePlayer,158,283,441,19,26,GrudgePlayer
567,GrudgePlayer,131,241,372,10,46,GrudgePlayer
568,GrudgePlayer,127,267,394,8,38,GrudgePlayer
569,GrudgePlayer,159,264,423,19,32,GrudgePlayer
570,GrudgePlayer,142,257,399,16,39,GrudgePlayer
571,GrudgePlayer,137,267,404,12,36,GrudgePlayer
572,GrudgePlayer,135,270,405,10,35,GrudgePlayer
573,GrudgePlayer,126,256,382,8,42,GrudgePlayer
574,GrudgePlayer,154,274,428,21,31,GrudgePlayer
575,GrudgePlayer,131,256,387,10,41,GrudgePlayer
576,GrudgePlayer,123,268,391,11,40,GrudgePlayer
577,GrudgePlayer,115,250,365,6,47,GrudgePlayer
578,GrudgePlayer,140,280,420,16,32,GrudgePlayer
579,GrudgePlayer,130,260,390,13,41,GrudgePlayer
580,GrudgePlayer,131,256,387,10,41,GrudgePlayer
581,GrudgePlayer,120,260,380,9,43,GrudgePlayer
582,GrudgePlayer,109,264,373,5,44,GrudgePlayer
583,GrudgePlayer,137,272,409,14,35,GrudgePlayer
584,GrudgePlayer,152,252,404,15,37,GrudgePlayer
585,GrudgePlayer,156,266,422,18,32,GrudgePlayer
586,GrudgePlayer,138,268,406,11,35,GrudgePlayer
587,GrudgePlayer,129,249,378,13,45,GrudgePlayer
588,GrudgePlayer,136,241,377,12,45,GrudgePlayer
589,GrudgePlayer,139,274,413,18,35,GrudgePlayer
590,GrudgePlayer,147,272,419,21,34,GrudgePlayer
591,GrudgePlayer,134,254,388,11,41,GrudgePlayer
592,GrudgePlayer,152,252,404,15,37,GrudgePlayer
593,GrudgePlayer,127,267,394,5,37,GrudgePlayer
594,GrudgePlayer,126,251,377,9,44,GrudgePlayer
595,GrudgePlayer,124,244,368,9,47,GrudgePlayer
596,GrudgePlayer,127,247,374,9,45,GrudgePlayer
597,GrudgePlayer,133,258,391,11,40,GrudgePlayer
598,GrudgePlayer,154,279,433,17,28,GrudgePlayer
599,GrudgePlayer,152,277,429,19,30,GrudgePlayer
600,GrudgePlayer,126,246,372,7,45,GrudgePlayer
601,GrudgePlayer,127,252,379,8,43,GrudgePlayer
602,GrudgePlayer,155,255,410,21,37,GrudgePlayer
603,GrudgePlayer,159,274,433,20,29,GrudgePlayer
604,GrudgePlayer,125,250,375,7,44,GrudgePlayer
605,GrudgePlayer,138,263,401,15,38,GrudgePlayer
606,GrudgePlayer,131,261,392,9,39,GrudgePlayer
607,GrudgePlayer,147,272,419,15,32,GrudgePlayer
608,GrudgePlayer,166,276,442,17,25,GrudgePlayer
609,GrudgePlayer,140,260,400,11,37,GrudgePlayer
610,GrudgePlayer,126,261,387,7,40,GrudgePlayer
611,GrudgePlayer,125,255,380,9,43,GrudgePlayer
612,GrudgePlayer,139,254,393,13,40,GrudgePlayer
613,GrudgePlayer,125,265,390,10,40,GrudgePlayer
614,GrudgePlayer,147,272,419,15,32,GrudgePlayer
615,GrudgePlayer,145,265,410,15,35,GrudgePlayer
616,GrudgePlayer,135,250,385,11,42,GrudgePlayer
617,GrudgePlayer,155,265,420,19,33,GrudgePlayer
618,GrudgePlayer,148,248,396,16,40,GrudgePlayer
619,GrudgePlayer,133,273,406,11,35,GrudgePlayer
620,GrudgePlayer,133,253,386,15,43,GrudgePlayer
621,GrudgePlayer,141,286,427,14,29,GrudgePlayer
622,GrudgePlayer,170,270,440,21,27,GrudgePlayer
623,GrudgePlayer,121,266,387,10,41,GrudgePlayer
624,GrudgePlayer,152,267,419,18,33,GrudgePlayer
625,GrudgePlayer,144,279,423,16,31,GrudgePlayer
626,GrudgePlayer,161,281,442,17,25,GrudgePlayer
627,GrudgePlayer,136,266,402,10,36,GrudgePlayer
628,GrudgePlayer,134,259,393,7,38,GrudgePlayer
629,GrudgePlayer,130,265,395,9,38,GrudgePlayer
630,GrudgePlayer,130,265,395,9,38,GrudgePlayer
631,GrudgePlayer,137,277,414,10,32,GrudgePlayer
632,GrudgePlayer,149,259,408,13,35,GrudgePlayer
633,GrudgePlayer,117,237,354,7,51,GrudgePlayer
634,GrudgePlayer,130,255,385,11,42,GrudgePlayer
635,GrudgePlayer,121,256,377,9,44,GrudgePlayer
636,GrudgePlayer,109,239,348,4,52,GrudgePlayer
637,GrudgePlayer,144,274,418,14,32,GrudgePlayer
638,GrudgePlayer,137,262,399,10,37,GrudgePlayer
639,GrudgePlayer,159,274,433,23,30,GrudgePlayer
640,GrudgePlayer,132,272,404,12,36,GrudgePlayer
641,GrudgePlayer,142,242,384,19,45,GrudgePlayer
642,GrudgePlayer,134,279,413,9,32,GrudgePlayer
643,GrudgePlayer,142,257,399,16,39,GrudgePlayer
644,GrudgePlayer,123,243,366,4,46,GrudgePlayer
645,GrudgePlayer,133,248,381,7,42,GrudgePlayer
646,GrudgePlayer,153,268,421,20,33,GrudgePlayer
647,GrudgePlayer,145,280,425,12,29,GrudgePlayer
648,GrudgePlayer,135,270,405,16,37,GrudgePlayer
649,GrudgePlayer,118,248,366,7,47,GrudgePlayer
650,GrudgePlayer,139,259,398,12,38,GrudgePlayer
651,GrudgePlayer,148,263,411,16,35,GrudgePlayer
652,GrudgePlayer,146,251,397,14,39,GrudgePlayer
653,GrudgePlayer,135,260,395,12,39,GrudgePlayer
654,GrudgePlayer,140,285,425,18,31,GrudgePlayer
655,GrudgePlayer,136,266,402,10,36,GrudgePlayer
656,GrudgePlayer,146,261,407,12,35,GrudgePlayer
657,GrudgePlayer,138,258,396,13,39,GrudgePlayer
658,GrudgePlayer,152,277,429,16,29,GrudgePlayer
659,GrudgePlayer,145,250,395,15,40,GrudgePlayer
660,GrudgePlayer,131,251,382,11,43,GrudgePlayer
661,GrudgePlayer,152,272,424,14,30,GrudgePlayer
662,GrudgePlayer,141,271,412,14,34,GrudgePlayer
663,GrudgePlayer,138,288,426,13,29,GrudgePlayer
664,GrudgePlayer,107,247,354,4,50,GrudgePlayer
665,GrudgePlayer,129,254,383,9,42,GrudgePlayer
666,GrudgePlayer,155,270,425,18,31,GrudgePlayer
667,GrudgePlayer,133,258,391,11,40,GrudgePlayer
668,GrudgePlayer,136,241,377,15,46,GrudgePlayer
669,GrudgePlayer,133,258,391,11,40,GrudgePlayer
670,GrudgePlayer,146,246,392,18,42,GrudgePlayer
671,GrudgePlayer,152,267,419,18,33,GrudgePlayer
672,GrudgePlayer,125,260,385,8,41,GrudgePlayer
673,GrudgePlayer,142,267,409,11,34,GrudgePlayer
674,GrudgePlayer,141,261,402,10,36,GrudgePlayer
675,GrudgePlayer,125,255,380,12,44,GrudgePlayer
676,GrudgePlayer,137,257,394,8,38,GrudgePlayer
677,GrudgePlayer,140,275,415,14,33,GrudgePlayer
678,GrudgePlayer,115,240,355,2,49,GrudgePlayer
679,GrudgePlayer,160,270,430,23,31,GrudgePlayer
680,GrudgePlayer,136,266,402,10,36,GrudgePlayer
681,GrudgePlayer,160,270,430,17,29,GrudgePlayer
682,GrudgePlayer,146,261,407,12,35,GrudgePlayer
683,GrudgePlayer,125,250,375,10,45,GrudgePlayer
684,GrudgePlayer,151,256,407,15,36,GrudgePlayer
685,GrudgePlayer,135,265,400,14,38,GrudgePlayer
686,GrudgePlayer,151,291,442,17,25,GrudgePlayer
687,GrudgePlayer,155,275,430,17,29,GrudgePlayer
688,GrudgePlayer,131,256,387,10,41,GrudgePlayer
689,GrudgePlayer,148,278,426,16,30,GrudgePlayer
690,GrudgePlayer,133,263,396,16,40,GrudgePlayer
691,GrudgePlayer,132,252,384,10,42,GrudgePlayer
692,GrudgePlayer,153,268,421,17,32,GrudgePlayer
693,GrudgePlayer,141,261,402,13,37,GrudgePlayer
694,GrudgePlayer,121,251,372,7,45,GrudgePlayer
695,GrudgePlayer,130,270,400,11,37,GrudgePlayer
696,GrudgePlayer,138,248,386,12,42,GrudgePlayer
697,GrudgePlayer,137,262,399,13,38,GrudgePlayer
698,GrudgePlayer,138,248,386,15,43,GrudgePlayer
699,GrudgePlayer,124,254,378,7,43,GrudgePlayer
700,GrudgePlayer,135,245,380,15,45,GrudgePlayer
701,GrudgePlayer,129,259,388,8,40,GrudgePlayer
702,GrudgePlayer,134,249,383,9,42,GrudgePlayer
703,GrudgePlayer,140,270,410,12,34,GrudgePlayer
704,GrudgePlayer,133,248,381,13,44,GrudgePlayer
705,GrudgePlayer,149,264,413,18,35,GrudgePlayer
706,GrudgePlayer,112,232,344,3,53,GrudgePlayer
707,GrudgePlayer,165,265,430,23,31,GrudgePlayer
708,GrudgePlayer,129,254,383,12,43,GrudgePlayer
709,GrudgePlayer,149,274,423,19,32,GrudgePlayer
710,GrudgePlayer,147,277,424,14,30,GrudgePlayer
711,GrudgePlayer,143,268,411,13,34,GrudgePlayer
712,GrudgePlayer,142,262,404,12,36,GrudgePlayer
713,GrudgePlayer,116,251,367,5,46,GrudgePlayer
714,GrudgePlayer,115,255,370,8,46,GrudgePlayer
715,GrudgePlayer,136,271,407,12,35,GrudgePlayer
716,GrudgePlayer,137,267,404,12,36,GrudgePlayer
717,GrudgePlayer,140,270,410,12,34,GrudgePlayer
718,GrudgePlayer,169,269,438,25,29,GrudgePlayer
719,GrudgePlayer,157,272,429,22,31,GrudgePlayer
720,GrudgePlayer,120,250,370,8,46,GrudgePlayer
721,GrudgePlayer,110,255,365,6,47,GrudgePlayer
722,GrudgePlayer,129,264,393,10,39,GrudgePlayer
723,GrudgePlayer,137,287,424,5,27,GrudgePlayer
724,GrudgePlayer,124,264,388,5,39,GrudgePlayer
725,GrudgePlayer,108,243,351,4,51,GrudgePlayer
726,GrudgePlayer,128,268,396,13,39,GrudgePlayer
727,GrudgePlayer,157,272,429,19,30,GrudgePlayer
728,GrudgePlayer,146,281,427,17,30,GrudgePlayer
729,GrudgePlayer,135,240,375,10,45,GrudgePlayer
730,GrudgePlayer,102,242,344,3,53,GrudgePlayer
731,GrudgePlayer,124,244,368,12,48,GrudgePlayer
732,GrudgePlayer,136,276,412,8,32,GrudgePlayer
733,GrudgePlayer,121,256,377,6,43,GrudgePlayer
734,GrudgePlayer,146,281,427,17,30,GrudgePlayer
735,GrudgePlayer,128,258,386,9,41,GrudgePlayer
736,GrudgePlayer,146,271,417,13,32,GrudgePlayer
737,GrudgePlayer,162,272,434,18,28,GrudgePlayer
738,GrudgePlayer,147,262,409,17,36,GrudgePlayer
739,GrudgePlayer,125,225,350,9,53,GrudgePlayer
740,GrudgePlayer,127,242,369,10,47,GrudgePlayer
741,GrudgePlayer,145,260,405,16,37,GrudgePlayer
742,GrudgePlayer,155,260,415,20,35,GrudgePlayer
743,GrudgePlayer,123,258,381,10,43,GrudgePlayer
744,GrudgePlayer,163,278,441,19,26,GrudgePlayer
745,GrudgePlayer,148,268,416,15,33,GrudgePlayer
746,GrudgePlayer,133,263,396,10,38,GrudgePlayer
747,GrudgePlayer,143,263,406,20,38,GrudgePlayer
748,GrudgePlayer,128,258,386,9,41,GrudgePlayer
749,GrudgePlayer,122,252,374,9,45,GrudgePlayer
750,GrudgePlayer,133,268,401,9,36,GrudgePlayer
751,GrudgePlayer,151,266,417,16,33,GrudgePlayer
752,GrudgePlayer,126,266,392,6,38,GrudgePlayer
753,GrudgePlayer,133,258,391,11,40,GrudgePlayer
754,GrudgePlayer,146,276,422,12,30,GrudgePlayer
755,GrudgePlayer,122,257,379,8,43,GrudgePlayer
756,GrudgePlayer,153,263,416,15,33,GrudgePlayer
757,GrudgePlayer,138,263,401,15,38,GrudgePlayer
758,GrudgePlayer,129,264,393,10,39,GrudgePlayer
759,GrudgePlayer,128,243,371,9,46,GrudgePlayer
760,GrudgePlayer,126,246,372,10,46,GrudgePlayer
761,GrudgePlayer,128,263,391,11,40,GrudgePlayer
762,GrudgePlayer,138,263,401,12,37,GrudgePlayer
763,GrudgePlayer,149,269,418,20,34,GrudgePlayer
764,GrudgePlayer,145,265,410,15,35,GrudgePlayer
765,GrudgePlayer,115,255,370,5,45,GrudgePlayer
766,GrudgePlayer,110,250,360,7,49,GrudgePlayer
767,GrudgePlayer,139,284,423,16,31,GrudgePlayer
768,GrudgePlayer,148,273,421,14,31,GrudgePlayer
769,GrudgePlayer,145,255,400,17,39,GrudgePlayer
770,GrudgePlayer,145,270,415,17,34,GrudgePlayer
771,GrudgePlayer,134,279,413,9,32,GrudgePlayer
772,GrudgePlayer,133,253,386,12,42,GrudgePlayer
773,GrudgePlayer,157,267,424,17,31,GrudgePlayer
774,GrudgePlayer,125,250,375,10,45,GrudgePlayer
775,GrudgePlayer,121,266,387,7,40,GrudgePlayer
776,GrudgePlayer,137,262,399,13,38,GrudgePlayer
777,GrudgePlayer,134,254,388,17,43,GrudgePlayer
778,GrudgePlayer,117,272,389,6,39,GrudgePlayer
779,GrudgePlayer,114,254,368,6,46,GrudgePlayer
780,GrudgePlayer,135,260,395,9,38,GrudgePlayer
781,GrudgePlayer,148,278,426,16,30,GrudgePlayer
782,GrudgePlayer,137,277,414,7,31,GrudgePlayer
783,GrudgePlayer,154,259,413,18,35,GrudgePlayer
784,GrudgePlayer,124,264,388,8,40,GrudgePlayer
785,GrudgePlayer,145,260,405,10,35,GrudgePlayer
786,GrudgePlayer,129,254,383,9,42,GrudgePlayer
787,GrudgePlayer,137,257,394,14,40,GrudgePlayer
788,GrudgePlayer,133,273,406,14,36,GrudgePlayer
789,GrudgePlayer,116,251,367,5,46,GrudgePlayer
790,GrudgePlayer,148,258,406,14,36,GrudgePlayer
791,GrudgePlayer,166,281,447,22,25,GrudgePlayer
792,GrudgePlayer,137,262,399,13,38,GrudgePlayer
793,GrudgePlayer,122,247,369,10,47,GrudgePlayer
794,GrudgePlayer,142,247,389,18,43,GrudgePlayer
795,GrudgePlayer,131,276,407,12,35,GrudgePlayer
796,GrudgePlayer,131,271,402,10,36,GrudgePlayer
797,GrudgePlayer,151,266,417,19,34,GrudgePlayer
798,GrudgePlayer,118,268,386,9,41,GrudgePlayer
799,GrudgePlayer,114,254,368,9,47,GrudgePlayer
800,GrudgePlayer,147,272,419,15,32,GrudgePlayer
801,GrudgePlayer,141,256,397,14,39,GrudgePlayer
802,GrudgePlayer,127,257,384,10,42,GrudgePlayer
803,GrudgePlayer,117,252,369,4,45,GrudgePlayer
804,GrudgePlayer,126,236,362,9,49,GrudgePlayer
805,GrudgePlayer,155,290,445,23,26,GrudgePlayer
806,GrudgePlayer,131,256,387,13,42,GrudgePlayer
807,GrudgePlayer,121,251,372,7,45,GrudgePlayer
808,GrudgePlayer,142,267,409,14,35,GrudgePlayer
809,GrudgePlayer,123,253,376,8,44,GrudgePlayer
810,GrudgePlayer,146,261,407,15,36,GrudgePlayer
811,GrudgePlayer,107,257,364,5,47,GrudgePlayer
812,GrudgePlayer,150,285,435,13,26,GrudgePlayer
813,GrudgePlayer,143,288,431,12,27,GrudgePlayer
814,GrudgePlayer,127,257,384,10,42,GrudgePlayer
815,GrudgePlayer,132,257,389,6,39,GrudgePlayer
816,GrudgePlayer,131,281,412,11,33,GrudgePlayer
817,GrudgePlayer,153,268,421,20,33,GrudgePlayer
818,GrudgePlayer,148,273,421,8,29,GrudgePlayer
819,GrudgePlayer,140,265,405,10,35,GrudgePlayer
820,GrudgePlayer,133,268,401,6,35,GrudgePlayer
821,GrudgePlayer,133,258,391,8,39,GrudgePlayer
822,GrudgePlayer,174,274,448,23,25,GrudgePlayer
823,GrudgePlayer,133,253,386,9,41,GrudgePlayer
824,GrudgePlayer,118,253,371,9,46,GrudgePlayer
825,GrudgePlayer,140,270,410,15,35,GrudgePlayer
826,GrudgePlayer,150,275,425,15,30,GrudgePlayer
827,GrudgePlayer,127,242,369,7,46,GrudgePlayer
828,GrudgePlayer,119,274,393,7,38,GrudgePlayer
829,GrudgePlayer,147,262,409,14,35,GrudgePlayer
830,GrudgePlayer,147,277,424,20,32,GrudgePlayer
831,GrudgePlayer,129,264,393,13,40,GrudgePlayer
832,GrudgePlayer,134,269,403,14,37,GrudgePlayer
833,GrudgePlayer,136,246,382,14,44,GrudgePlayer
834,GrudgePlayer,114,259,373,5,44,GrudgePlayer
835,GrudgePlayer,124,264,388,8,40,GrudgePlayer
836,GrudgePlayer,120,270,390,7,39,GrudgePlayer
837,GrudgePlayer,120,245,365,9,48,GrudgePlayer
838,GrudgePlayer,137,267,404,12,36,GrudgePlayer
839,GrudgePlayer,160,250,410,21,37,GrudgePlayer
840,GrudgePlayer,144,274,418,14,32,GrudgePlayer
841,GrudgePlayer,167,277,444,25,27,GrudgePlayer
842,GrudgePlayer,117,237,354,7,51,GrudgePlayer
843,GrudgePlayer,153,268,421,20,33,GrudgePlayer
844,GrudgePlayer,141,251,392,15,41,GrudgePlayer
845,GrudgePlayer,141,261,402,10,36,GrudgePlayer
846,GrudgePlayer,162,272,434,21,29,GrudgePlayer
847,GrudgePlayer,144,269,413,15,34,GrudgePlayer
848,GrudgePlayer,134,274,408,10,34,GrudgePlayer
849,GrudgePlayer,122,262,384,7,41,GrudgePlayer
850,GrudgePlayer,138,248,386,9,41,GrudgePlayer
851,GrudgePlayer,140,275,415,11,32,GrudgePlayer
852,GrudgePlayer,123,258,381,10,43,GrudgePlayer
853,GrudgePlayer,120,255,375,4,43,GrudgePlayer
854,GrudgePlayer,163,263,426,22,32,GrudgePlayer
855,GrudgePlayer,142,272,414,13,33,GrudgePlayer
856,GrudgePlayer,120,270,390,10,40,GrudgePlayer
857,GrudgePlayer,123,248,371,6,45,GrudgePlayer
858,GrudgePlayer,124,264,388,8,40,GrudgePlayer
859,GrudgePlayer,123,243,366,4,46,GrudgePlayer
860,GrudgePlayer,137,282,419,6,29,GrudgePlayer
861,GrudgePlayer,104,249,353,6,51,GrudgePlayer
862,GrudgePlayer,104,254,358,5,49,GrudgePlayer
863,GrudgePlayer,168,283,451,20,23,GrudgePlayer
864,GrudgePlayer,118,253,371,6,45,GrudgePlayer
865,GrudgePlayer,160,275,435,16,27,GrudgePlayer
866,GrudgePlayer,122,232,354,7,51,GrudgePlayer
867,GrudgePlayer,141,271,412,14,34,GrudgePlayer
868,GrudgePlayer,129,239,368,9,47,GrudgePlayer
869,GrudgePlayer,143,268,411,13,34,GrudgePlayer
870,GrudgePlayer,124,244,368,6,46,GrudgePlayer
871,GrudgePlayer,145,285,430,11,27,GrudgePlayer
872,GrudgePlayer,136,251,387,13,42,GrudgePlayer
873,GrudgePlayer,157,282,439,23,28,GrudgePlayer
874,GrudgePlayer,150,275,425,15,30,GrudgePlayer
875,GrudgePlayer,150,275,425,18,31,GrudgePlayer
876,GrudgePlayer,150,270,420,16,32,GrudgePlayer
877,GrudgePlayer,144,269,413,18,35,GrudgePlayer
878,GrudgePlayer,151,281,432,13,27,GrudgePlayer
879,GrudgePlayer,127,262,389,12,41,GrudgePlayer
880,GrudgePlayer,134,259,393,7,38,GrudgePlayer
881,GrudgePlayer,134,289,423,10,29,GrudgePlayer
882,GrudgePlayer,151,276,427,14,29,GrudgePlayer
883,GrudgePlayer,139,254,393,13,40,GrudgePlayer
884,GrudgePlayer,136,266,402,4,34,GrudgePlayer
885,GrudgePlayer,123,258,381,7,42,GrudgePlayer
886,GrudgePlayer,111,251,362,3,47,GrudgePlayer
887,GrudgePlayer,118,268,386,6,40,GrudgePlayer
888,GrudgePlayer,111,241,352,5,51,GrudgePlayer
889,GrudgePlayer,150,270,420,16,32,GrudgePlayer
890,GrudgePlayer,161,281,442,20,26,GrudgePlayer
891,GrudgePlayer,130,265,395,12,39,GrudgePlayer
892,GrudgePlayer,120,245,365,6,47,GrudgePlayer
893,GrudgePlayer,140,260,400,17,39,GrudgePlayer
894,GrudgePlayer,147,262,409,11,34,GrudgePlayer
895,GrudgePlayer,149,259,408,19,37,GrudgePlayer
896,GrudgePlayer,113,248,361,5,48,GrudgePlayer
897,GrudgePlayer,134,289,423,10,29,GrudgePlayer
898,GrudgePlayer,148,253,401,15,38,GrudgePlayer
899,GrudgePlayer,137,277,414,13,33,GrudgePlayer
900,GrudgePlayer,143,248,391,17,42,GrudgePlayer
901,GrudgePlayer,151,261,412,20,36,GrudgePlayer
902,GrudgePlayer,151,266,417,16,33,GrudgePlayer
903,GrudgePlayer,123,263,386,9,41,GrudgePlayer
904,GrudgePlayer,163,288,451,20,23,GrudgePlayer
905,GrudgePlayer,159,264,423,22,33,GrudgePlayer
906,GrudgePlayer,153,283,436,20,28,GrudgePlayer
907,GrudgePlayer,137,252,389,12,41,GrudgePlayer
908,GrudgePlayer,141,281,422,12,30,GrudgePlayer
909,GrudgePlayer,118,248,366,7,47,GrudgePlayer
910,GrudgePlayer,160,280,440,18,26,GrudgePlayer
911,GrudgePlayer,119,234,353,6,51,GrudgePlayer
912,GrudgePlayer,129,239,368,9,47,GrudgePlayer
913,GrudgePlayer,140,265,405,16,37,GrudgePlayer
914,GrudgePlayer,140,285,425,15,30,GrudgePlayer
915,GrudgePlayer,169,269,438,19,27,GrudgePlayer
916,GrudgePlayer,130,270,400,11,37,GrudgePlayer
917,GrudgePlayer,129,269,398,9,37,GrudgePlayer
918,GrudgePlayer,124,264,388,5,39,GrudgePlayer
919,GrudgePlayer,145,240,385,17,44,GrudgePlayer
920,GrudgePlayer,140,260,400,8,36,GrudgePlayer
921,GrudgePlayer,138,273,411,10,33,GrudgePlayer
922,GrudgePlayer,140,260,400,17,39,GrudgePlayer
923,GrudgePlayer,140,270,410,15,35,GrudgePlayer
924,GrudgePlayer,144,269,413,12,33,GrudgePlayer
925,GrudgePlayer,133,258,391,11,40,GrudgePlayer
926,GrudgePlayer,146,256,402,16,38,GrudgePlayer
927,GrudgePlayer,138,263,401,15,38,GrudgePlayer
928,GrudgePlayer,146,246,392,18,42,GrudgePlayer
929,GrudgePlayer,140,265,405,10,35,GrudgePlayer
930,GrudgePlayer,169,284,453,22,23,GrudgePlayer
931,GrudgePlayer,157,272,429,16,29,GrudgePlayer
932,GrudgePlayer,143,268,411,13,34,GrudgePlayer
933,GrudgePlayer,115,240,355,5,50,GrudgePlayer
934,GrudgePlayer,109,259,368,6,46,GrudgePlayer
935,GrudgePlayer,134,274,408,13,35,GrudgePlayer
936,GrudgePlayer,156,271,427,14,29,GrudgePlayer
937,GrudgePlayer,134,249,383,9,42,GrudgePlayer
938,GrudgePlayer,146,291,437,12,25,GrudgePlayer
939,GrudgePlayer,121,261,382,8,42,GrudgePlayer
940,GrudgePlayer,128,268,396,4,36,GrudgePlayer
941,GrudgePlayer,132,257,389,12,41,GrudgePlayer
942,GrudgePlayer,145,255,400,14,38,GrudgePlayer
943,GrudgePlayer,158,273,431,21,30,GrudgePlayer
944,GrudgePlayer,137,252,389,9,40,GrudgePlayer
945,GrudgePlayer,133,258,391,14,41,GrudgePlayer
946,GrudgePlayer,130,250,380,9,43,GrudgePlayer
947,GrudgePlayer,130,255,385,11,42,GrudgePlayer
948,GrudgePlayer,142,257,399,10,37,GrudgePlayer
949,GrudgePlayer,132,277,409,8,33,GrudgePlayer
950,GrudgePlayer,158,278,436,23,29,GrudgePlayer
951,GrudgePlayer,134,279,413,12,33,GrudgePlayer
952,GrudgePlayer,121,241,362,6,48,GrudgePlayer
953,GrudgePlayer,129,259,388,11,41,GrudgePlayer
954,GrudgePlayer,130,255,385,8,41,GrudgePlayer
955,GrudgePlayer,129,259,388,8,40,GrudgePlayer
956,GrudgePlayer,129,259,388,11,41,GrudgePlayer
957,GrudgePlayer,124,259,383,12,43,GrudgePlayer
958,GrudgePlayer,127,257,384,10,42,GrudgePlayer
959,GrudgePlayer,142,262,404,15,37,GrudgePlayer
960,GrudgePlayer,136,241,377,12,45,GrudgePlayer
961,GrudgePlayer,128,243,371,9,46,GrudgePlayer
962,GrudgePlayer,140,260,400,14,38,GrudgePlayer
963,GrudgePlayer,146,256,402,13,37,GrudgePlayer
964,GrudgePlayer,132,277,409,11,34,GrudgePlayer
965,GrudgePlayer,146,256,402,19,39,GrudgePlayer
966,GrudgePlayer,148,248,396,13,39,GrudgePlayer
967,GrudgePlayer,144,274,418,14,32,GrudgePlayer
968,GrudgePlayer,131,256,387,13,42,GrudgePlayer
969,GrudgePlayer,138,248,386,15,43,GrudgePlayer
970,GrudgePlayer,125,265,390,7,39,GrudgePlayer
971,GrudgePlayer,130,260,390,13,41,GrudgePlayer
972,GrudgePlayer,116,251,367,5,46,GrudgePlayer
973,GrudgePlayer,155,250,405,19,38,GrudgePlayer
974,GrudgePlayer,150,260,410,15,35,GrudgePlayer
975,GrudgePlayer,155,255,410,21,37,GrudgePlayer
976,GrudgePlayer,128,268,396,10,38,GrudgePlayer
977,GrudgePlayer,100,260,360,1,47,GrudgePlayer
978,GrudgePlayer,141,281,422,15,31,GrudgePlayer
979,GrudgePlayer,126,256,382,5,41,GrudgePlayer
980,GrudgePlayer,146,261,407,15,36,GrudgePlayer
981,GrudgePlayer,136,266,402,13,37,GrudgePlayer
982,GrudgePlayer,123,273,396,10,38,GrudgePlayer
983,GrudgePlayer,139,264,403,14,37,GrudgePlayer
984,GrudgePlayer,126,271,397,8,37,GrudgePlayer
985,GrudgePlayer,158,273,431,21,30,GrudgePlayer
986,GrudgePlayer,126,241,367,11,48,GrudgePlayer
987,GrudgePlayer,141,251,392,15,41,GrudgePlayer
988,GrudgePlayer,139,269,408,10,34,GrudgePlayer
989,GrudgePlayer,132,257,389,15,42,GrudgePlayer
990,GrudgePlayer,121,256,377,9,44,GrudgePlayer
991,GrudgePlayer,152,252,404,18,38,GrudgePlayer
992,GrudgePlayer,137,272,409,11,34,GrudgePlayer
993,GrudgePlayer,131,281,412,11,33,GrudgePlayer
994,GrudgePlayer,115,230,345,4,53,GrudgePlayer
995,GrudgePlayer,118,268,386,6,40,GrudgePlayer
996,GrudgePlayer,150,255,405,16,37,GrudgePlayer
997,GrudgePlayer,143,268,411,10,33,GrudgePlayer
998,GrudgePlayer,129,254,383,12,43,GrudgePlayer
999,GrudgePlayer,140,265,405,7,34,GrudgePlayer
1000,GrudgePlayer,136,271,407,12,35,GrudgePlayer
1001,GrudgePlayer,164,274,438,22,28,GrudgePlayer
1002,GrudgePlayer,133,263,396,13,39,GrudgePlayer
1003,GrudgePlayer,124,269,393,4,37,GrudgePlayer
1004,GrudgePlayer,136,241,377,9,44,GrudgePlayer
1005,GrudgePlayer,137,262,399,10,37,GrudgePlayer
1006,GrudgePlayer,137,252,389,9,40,GrudgePlayer
1007,GrudgePlayer,127,262,389,9,40,GrudgePlayer
1008,GrudgePlayer,127,247,374,9,45,GrudgePlayer
1009,GrudgePlayer,126,251,377,12,45,GrudgePlayer
1010,GrudgePlayer,123,263,386,9,41,GrudgePlayer
1011,GrudgePlayer,143,268,411,10,33,GrudgePlayer
1012,GrudgePlayer,136,266,402,13,37,GrudgePlayer
1013,GrudgePlayer,148,248,396,16,40,GrudgePlayer
1014,GrudgePlayer,137,247,384,10,42,GrudgePlayer
1015,GrudgePlayer,133,253,386,12,42,GrudgePlayer
1016,GrudgePlayer,159,269,428,18,30,GrudgePlayer
1017,GrudgePlayer,137,277,414,13,33,GrudgePlayer
1018,GrudgePlayer,143,273,416,15,33,GrudgePlayer
1019,GrudgePlayer,136,271,407,9,34,GrudgePlayer
1020,GrudgePlayer,104,229,333,4,57,GrudgePlayer
1021,GrudgePlayer,118,258,376,8,44,GrudgePlayer
1022,GrudgePlayer,127,267,394,11,39,GrudgePlayer
1023,GrudgePlayer,147,262,409,17,36,GrudgePlayer
1024,GrudgePlayer,124,244,368,6,46,GrudgePlayer
1025,GrudgePlayer,132,287,419,9,30,GrudgePlayer
1026,GrudgePlayer,154,259,413,18,35,GrudgePlayer
1027,GrudgePlayer,164,294,458,27,23,GrudgePlayer
1028,GrudgePlayer,106,271,377,3,42,GrudgePlayer
1029,GrudgePlayer,125,250,375,10,45,GrudgePlayer
1030,GrudgePlayer,126,251,377,6,43,GrudgePlayer
1031,GrudgePlayer,130,260,390,13,41,GrudgePlayer
1032,GrudgePlayer,137,262,399,13,38,GrudgePlayer
1033,GrudgePlayer,138,278,416,12,32,GrudgePlayer
1034,GrudgePlayer,141,286,427,17,30,GrudgePlayer
1035,GrudgePlayer,154,264,418,20,34,GrudgePlayer
1036,GrudgePlayer,127,242,369,7,46,GrudgePlayer
1037,GrudgePlayer,116,246,362,9,49,GrudgePlayer
1038,GrudgePlayer,130,265,395,9,38,GrudgePlayer
1039,GrudgePlayer,135,260,395,9,38,GrudgePlayer
1040,GrudgePlayer,152,272,424,17,31,GrudgePlayer
1041,GrudgePlayer,121,246,367,8,47,GrudgePlayer
1042,GrudgePlayer,133,273,406,11,35,GrudgePlayer
1043,GrudgePlayer,117,227,344,9,55,GrudgePlayer
1044,GrudgePlayer,128,263,391,8,39,GrudgePlayer
1045,GrudgePlayer,142,267,409,14,35,GrudgePlayer
1046,GrudgePlayer,151,271,422,15,31,GrudgePlayer
1047,GrudgePlayer,138,273,411,10,33,GrudgePlayer
1048,GrudgePlayer,140,270,410,9,33,GrudgePlayer
1049,GrudgePlayer,135,250,385,14,43,GrudgePlayer
1050,GrudgePlayer,124,264,388,11,41,GrudgePlayer
1051,GrudgePlayer,155,275,430,20,30,GrudgePlayer
1052,GrudgePlayer,145,250,395,12,39,GrudgePlayer
1053,GrudgePlayer,147,257,404,15,37,GrudgePlayer
1054,GrudgePlayer,115,245,360,4,48,GrudgePlayer
1055,GrudgePlayer,130,250,380,9,43,GrudgePlayer
1056,GrudgePlayer,115,240,355,5,50,GrudgePlayer
1057,GrudgePlayer,147,267,414,16,34,GrudgePlayer
1058,GrudgePlayer,144,274,418,14,32,GrudgePlayer
1059,GrudgePlayer,145,255,400,14,38,GrudgePlayer
1060,GrudgePlayer,134,264,398,6,36,GrudgePlayer
1061,GrudgePlayer,149,264,413,15,34,GrudgePlayer
1062,GrudgePlayer,125,265,390,10,40,GrudgePlayer
1063,GrudgePlayer,129,274,403,8,35,GrudgePlayer
1064,GrudgePlayer,145,275,420,16,32,GrudgePlayer
1065,GrudgePlayer,158,273,431,18,29,GrudgePlayer
1066,GrudgePlayer,157,252,409,17,36,GrudgePlayer
1067,GrudgePlayer,144,254,398,18,40,GrudgePlayer
1068,GrudgePlayer,119,239,358,8,50,GrudgePlayer
1069,GrudgePlayer,127,247,374,9,45,GrudgePlayer
1070,GrudgePlayer,147,282,429,13,28,GrudgePlayer
1071,GrudgePlayer,127,262,389,9,40,GrudgePlayer
1072,GrudgePlayer,142,252,394,17,41,GrudgePlayer
1073,GrudgePlayer,162,287,449,18,23,GrudgePlayer
1074,GrudgePlayer,148,268,416,15,33,GrudgePlayer
1075,GrudgePlayer,128,263,391,8,39,GrudgePlayer
1076,GrudgePlayer,141,261,402,13,37,GrudgePlayer
1077,GrudgePlayer,149,269,418,17,33,GrudgePlayer
1078,GrudgePlayer,134,259,393,10,39,GrudgePlayer
1079,GrudgePlayer,155,265,420,16,32,GrudgePlayer
1080,GrudgePlayer,136,261,397,14,39,GrudgePlayer
1081,GrudgePlayer,126,251,377,12,45,GrudgePlayer
1082,GrudgePlayer,151,261,412,20,36,GrudgePlayer
1083,GrudgePlayer,146,281,427,17,30,GrudgePlayer
1084,GrudgePlayer,157,262,419,21,34,GrudgePlayer
1085,GrudgePlayer,146,276,422,18,32,GrudgePlayer
1086,GrudgePlayer,135,275,410,12,34,GrudgePlayer
1087,GrudgePlayer,128,228,356,9,51,GrudgePlayer
1088,GrudgePlayer,113,213,326,6,60,GrudgePlayer
1089,GrudgePlayer,151,271,422,15,31,GrudgePlayer
1090,GrudgePlayer,126,246,372,7,45,GrudgePlayer
1091,GrudgePlayer,119,244,363,7,48,GrudgePlayer
1092,GrudgePlayer,135,255,390,13,41,GrudgePlayer
1093,GrudgePlayer,135,275,410,9,33,GrudgePlayer
1094,GrudgePlayer,136,271,407,12,35,GrudgePlayer
1095,GrudgePlayer,127,252,379,11,44,GrudgePlayer
1096,GrudgePlayer,120,240,360,7,49,GrudgePlayer
1097,GrudgePlayer,151,276,427,20,31,GrudgePlayer
1098,GrudgePlayer,134,269,403,17,38,GrudgePlayer
1099,GrudgePlayer,162,262,424,23,33,GrudgePlayer
1100,GrudgePlayer,159,284,443,21,26,GrudgePlayer
1101,GrudgePlayer,137,257,394,11,39,GrudgePlayer
1102,GrudgePlayer,108,253,361,5,48,GrudgePlayer
1103,GrudgePlayer,138,263,401,15,38,GrudgePlayer
1104,GrudgePlayer,103,248,351,4,51,GrudgePlayer
1105,GrudgePlayer,118,263,381,7,42,GrudgePlayer
1106,GrudgePlayer,160,270,430,23,31,GrudgePlayer
1107,GrudgePlayer,155,270,425,12,29,GrudgePlayer
1108,GrudgePlayer,132,257,389,9,40,GrudgePlayer
1109,GrudgePlayer,147,257,404,15,37,GrudgePlayer
1110,GrudgePlayer,129,279,408,10,34,GrudgePlayer
1111,GrudgePlayer,121,276,397,8,37,GrudgePlayer
1112,GrudgePlayer,142,252,394,11,39,GrudgePlayer
1113,GrudgePlayer,123,233,356,12,52,GrudgePlayer
1114,GrudgePlayer,143,263,406,14,36,GrudgePlayer
1115,GrudgePlayer,139,264,403,14,37,GrudgePlayer
1116,GrudgePlayer,132,272,404,15,37,GrudgePlayer
1117,GrudgePlayer,136,266,402,13,37,GrudgePlayer
1118,GrudgePlayer,142,272,414,13,33,GrudgePlayer
1119,GrudgePlayer,150,265,415,14,33,GrudgePlayer
1120,GrudgePlayer,126,271,397,8,37,GrudgePlayer
1121,GrudgePlayer,147,267,414,16,34,GrudgePlayer
1122,GrudgePlayer,124,249,373,8,45,GrudgePlayer
1123,GrudgePlayer,112,247,359,3,48,GrudgePlayer
1124,GrudgePlayer,142,267,409,14,35,GrudgePlayer
1125,GrudgePlayer,123,238,361,11,50,GrudgePlayer
1126,GrudgePlayer,149,269,418,17,33,GrudgePlayer
1127,GrudgePlayer,150,275,425,15,30,GrudgePlayer
1128,GrudgePlayer,126,271,397,11,38,GrudgePlayer
1129,GrudgePlayer,162,282,444,22,26,GrudgePlayer
1130,GrudgePlayer,141,251,392,9,39,GrudgePlayer
1131,GrudgePlayer,127,257,384,7,41,GrudgePlayer
1132,GrudgePlayer,146,271,417,16,33,GrudgePlayer
1133,GrudgePlayer,137,272,409,8,33,GrudgePlayer
1134,GrudgePlayer,158,268,426,13,29,GrudgePlayer
1135,GrudgePlayer,140,255,395,12,39,GrudgePlayer
1136,GrudgePlayer,145,275,420,19,33,GrudgePlayer
1137,GrudgePlayer,146,286,432,13,27,GrudgePlayer
1138,GrudgePlayer,149,274,423,19,32,GrudgePlayer
1139,GrudgePlayer,159,279,438,19,27,GrudgePlayer
1140,GrudgePlayer,128,253,381,13,44,GrudgePlayer
1141,GrudgePlayer,136,261,397,8,37,GrudgePlayer
1142,GrudgePlayer,127,267,394,8,38,GrudgePlayer
1143,GrudgePlayer,122,267,389,9,40,GrudgePlayer
1144,GrudgePlayer,145,265,410,15,35,GrudgePlayer
1145,GrudgePlayer,119,244,363,7,48,GrudgePlayer
1146,GrudgePlayer,141,271,412,14,34,GrudgePlayer
1147,GrudgePlayer,133,253,386,12,42,GrudgePlayer
1148,GrudgePlayer,115,250,365,3,46,GrudgePlayer
1149,GrudgePlayer,152,272,424,14,30,GrudgePlayer
1150,GrudgePlayer,115,240,355,11,52,GrudgePlayer
1151,GrudgePlayer,179,274,453,31,26,GrudgePlayer
1152,GrudgePlayer,153,258,411,19,36,GrudgePlayer
1153,GrudgePlayer,137,272,409,11,34,GrudgePlayer
1154,GrudgePlayer,149,284,433,14,27,GrudgePlayer
1155,GrudgePlayer,147,272,419,18,33,GrudgePlayer
1156,GrudgePlayer,113,238,351,1,50,GrudgePlayer
1157,GrudgePlayer,146,281,427,17,30,GrudgePlayer
1158,GrudgePlayer,147,257,404,18,38,GrudgePlayer
1159,GrudgePlayer,137,262,399,13,38,GrudgePlayer
1160,GrudgePlayer,122,252,374,6,44,GrudgePlayer
1161,GrudgePlayer,154,279,433,14,27,GrudgePlayer
1162,GrudgePlayer,153,248,401,18,39,GrudgePlayer
1163,GrudgePlayer,133,233,366,10,48,GrudgePlayer
1164,GrudgePlayer,141,256,397,17,40,GrudgePlayer
1165,GrudgePlayer,151,266,417,13,32,GrudgePlayer
1166,GrudgePlayer,157,272,429,22,31,GrudgePlayer
1167,GrudgePlayer,136,246,382,14,44,GrudgePlayer
1168,GrudgePlayer,155,280,435,19,28,GrudgePlayer
1169,GrudgePlayer,139,269,408,10,34,GrudgePlayer
1170,GrudgePlayer,143,243,386,15,43,GrudgePlayer
1171,GrudgePlayer,132,272,404,9,35,GrudgePlayer
1172,GrudgePlayer,119,234,353,9,52,GrudgePlayer
1173,GrudgePlayer,133,263,396,13,39,GrudgePlayer
1174,GrudgePlayer,151,266,417,19,34,GrudgePlayer
1175,GrudgePlayer,129,274,403,8,35,GrudgePlayer
1176,GrudgePlayer,145,280,425,15,30,GrudgePlayer
1177,GrudgePlayer,141,266,407,15,36,GrudgePlayer
1178,GrudgePlayer,150,280,430,17,29,GrudgePlayer
1179,GrudgePlayer,158,273,431,18,29,GrudgePlayer
1180,GrudgePlayer,126,246,372,10,46,GrudgePlayer
1181,GrudgePlayer,136,266,402,13,37,GrudgePlayer
1182,GrudgePlayer,136,276,412,8,32,GrudgePlayer
1183,GrudgePlayer,162,282,444,19,25,GrudgePlayer
1184,GrudgePlayer,145,280,425,12,29,GrudgePlayer
1185,GrudgePlayer,160,285,445,20,25,GrudgePlayer
1186,GrudgePlayer,139,259,398,15,39,GrudgePlayer
1187,GrudgePlayer,135,240,375,10,45,GrudgePlayer
1188,GrudgePlayer,122,247,369,4,45,GrudgePlayer
1189,GrudgePlayer,131,271,402,13,37,GrudgePlayer
1190,GrudgePlayer,135,255,390,13,41,GrudgePlayer
1191,GrudgePlayer,159,259,418,20,34,GrudgePlayer
1192,GrudgePlayer,143,263,406,14,36,GrudgePlayer
1193,GrudgePlayer,143,263,406,17,37,GrudgePlayer
1194,GrudgePlayer,148,253,401,18,39,GrudgePlayer
1195,GrudgePlayer,148,273,421,14,31,GrudgePlayer
1196,GrudgePlayer,119,254,373,5,44,GrudgePlayer
1197,GrudgePlayer,114,264,378,7,43,GrudgePlayer
1198,GrudgePlayer,141,271,412,11,33,GrudgePlayer
1199,GrudgePlayer,143,253,396,13,39,GrudgePlayer
1200,GrudgePlayer,136,261,397,5,36,GrudgePlayer
1201,GrudgePlayer,105,245,350,3,51,GrudgePlayer
1202,GrudgePlayer,150,265,415,17,34,GrudgePlayer
1203,GrudgePlayer,125,245,370,5,45,GrudgePlayer
1204,GrudgePlayer,155,265,420,19,33,GrudgePlayer
1205,GrudgePlayer,143,283,426,13,29,GrudgePlayer
1206,GrudgePlayer,140,250,390,13,41,GrudgePlayer
1207,GrudgePlayer,144,269,413,12,33,GrudgePlayer
1208,GrudgePlayer,129,259,388,8,40,GrudgePlayer
1209,GrudgePlayer,133,258,391,8,39,GrudgePlayer
1210,GrudgePlayer,114,254,368,3,45,GrudgePlayer
1211,GrudgePlayer,152,282,434,15,27,GrudgePlayer
1212,GrudgePlayer,117,217,334,8,58,GrudgePlayer
1213,GrudgePlayer,151,276,427,14,29,GrudgePlayer
1214,GrudgePlayer,140,235,375,13,46,GrudgePlayer
1215,GrudgePlayer,150,295,445,17,24,GrudgePlayer
1216,GrudgePlayer,145,255,400,14,38,GrudgePlayer
1217,GrudgePlayer,125,270,395,9,38,GrudgePlayer
1218,GrudgePlayer,128,258,386,9,41,GrudgePlayer
1219,GrudgePlayer,142,272,414,13,33,GrudgePlayer
1220,GrudgePlayer,130,275,405,10,35,GrudgePlayer
1221,GrudgePlayer,161,271,432,19,29,GrudgePlayer
1222,GrudgePlayer,126,256,382,14,44,GrudgePlayer
1223,GrudgePlayer,159,284,443,15,24,GrudgePlayer
1224,GrudgePlayer,124,249,373,8,45,GrudgePlayer
1225,GrudgePlayer,142,267,409,14,35,GrudgePlayer
1226,GrudgePlayer,135,260,395,12,39,GrudgePlayer
1227,GrudgePlayer,117,242,359,9,50,GrudgePlayer
1228,GrudgePlayer,137,252,389,15,42,GrudgePlayer
1229,GrudgePlayer,158,273,431,24,31,GrudgePlayer
1230,GrudgePlayer,141,261,402,13,37,GrudgePlayer
1231,GrudgePlayer,128,253,381,7,42,GrudgePlayer
1232,GrudgePlayer,125,260,385,11,42,GrudgePlayer
1233,GrudgePlayer,151,261,412,17,35,GrudgePlayer
1234,GrudgePlayer,140,270,410,12,34,GrudgePlayer
1235,GrudgePlayer,161,276,437,18,27,GrudgePlayer
1236,GrudgePlayer,131,241,372,10,46,GrudgePlayer
1237,GrudgePlayer,123,258,381,7,42,GrudgePlayer
1238,GrudgePlayer,144,274,418,11,31,GrudgePlayer
1239,GrudgePlayer,158,253,411,19,36,GrudgePlayer
1240,GrudgePlayer,135,265,400,11,37,GrudgePlayer
1241,GrudgePlayer,103,243,346,2,52,GrudgePlayer
1242,GrudgePlayer,126,251,377,12,45,GrudgePlayer
1243,GrudgePlayer,135,260,395,12,39,GrudgePlayer
1244,GrudgePlayer,160,265,425,21,32,GrudgePlayer
1245,GrudgePlayer,117,272,389,6,39,GrudgePlayer
1246,GrudgePlayer,144,254,398,15,39,GrudgePlayer
1247,GrudgePlayer,131,261,392,6,38,GrudgePlayer
1248,GrudgePlayer,142,277,419,15,32,GrudgePlayer
1249,GrudgePlayer,150,270,420,13,31,GrudgePlayer
1250,GrudgePlayer,162,277,439,14,25,GrudgePlayer
1251,GrudgePlayer,117,247,364,11,49,GrudgePlayer
1252,GrudgePlayer,120,275,395,6,37,GrudgePlayer
1253,GrudgePlayer,152,272,424,17,31,GrudgePlayer
1254,GrudgePlayer,141,286,427,14,29,GrudgePlayer
1255,GrudgePlayer,128,263,391,11,40,GrudgePlayer
1256,GrudgePlayer,109,254,363,7,48,GrudgePlayer
1257,GrudgePlayer,125,280,405,7,34,GrudgePlayer
1258,GrudgePlayer,150,275,425,15,30,GrudgePlayer
1259,GrudgePlayer,120,245,365,6,47,GrudgePlayer
1260,GrudgePlayer,147,267,414,16,34,GrudgePlayer
1261,GrudgePlayer,136,261,397,14,39,GrudgePlayer
1262,GrudgePlayer,154,254,408,19,37,GrudgePlayer
1263,GrudgePlayer,104,259,363,4,47,GrudgePlayer
1264,GrudgePlayer,137,262,399,13,38,GrudgePlayer
1265,GrudgePlayer,131,271,402,10,36,GrudgePlayer
1266,GrudgePlayer,141,261,402,16,38,GrudgePlayer
1267,GrudgePlayer,134,249,383,12,43,GrudgePlayer
1268,GrudgePlayer,137,267,404,9,35,GrudgePlayer
1269,GrudgePlayer,106,251,357,7,50,GrudgePlayer
1270,GrudgePlayer,120,250,370,5,45,GrudgePlayer
1271,GrudgePlayer,133,263,396,13,39,GrudgePlayer
1272,GrudgePlayer,127,257,384,7,41,GrudgePlayer
1273,GrudgePlayer,127,262,389,6,39,GrudgePlayer
1274,GrudgePlayer,138,268,406,14,36,GrudgePlayer
1275,GrudgePlayer,116,246,362,9,49,GrudgePlayer
1276,GrudgePlayer,146,246,392,15,41,GrudgePlayer
1277,GrudgePlayer,133,283,416,9,31,GrudgePlayer
1278,GrudgePlayer,138,268,406,11,35,GrudgePlayer
1279,GrudgePlayer,136,266,402,13,37,GrudgePlayer
1280,GrudgePlayer,143,278,421,14,31,GrudgePlayer
1281,GrudgePlayer,159,269,428,18,30,GrudgePlayer
1282,GrudgePlayer,130,250,380,9,43,GrudgePlayer
1283,GrudgePlayer,149,269,418,17,33,GrudgePlayer
1284,GrudgePlayer,130,260,390,10,40,GrudgePlayer
1285,GrudgePlayer,119,254,373,5,44,GrudgePlayer
1286,GrudgePlayer,116,246,362,6,48,GrudgePlayer
1287,GrudgePlayer,154,264,418,20,34,GrudgePlayer
1288,GrudgePlayer,141,271,412,11,33,GrudgePlayer
1289,GrudgePlayer,142,257,399,13,38,GrudgePlayer
1290,GrudgePlayer,134,264,398,12,38,GrudgePlayer
1291,GrudgePlayer,150,285,435,16,27,GrudgePlayer
1292,GrudgePlayer,154,274,428,18,30,GrudgePlayer
1293,GrudgePlayer,140,250,390,10,40,GrudgePlayer
1294,GrudgePlayer,148,273,421,17,32,GrudgePlayer
1295,GrudgePlayer,151,281,432,13,27,GrudgePlayer
1296,GrudgePlayer,154,254,408,19,37,GrudgePlayer
1297,GrudgePlayer,145,270,415,17,34,GrudgePlayer
1298,GrudgePlayer,136,271,407,9,34,GrudgePlayer
1299,GrudgePlayer,149,269,418,17,33,GrudgePlayer
1300,GrudgePlayer,106,246,352,2,50,GrudgePlayer
1301,GrudgePlayer,147,267,414,13,33,GrudgePlayer
1302,GrudgePlayer,148,258,406,20,38,GrudgePlayer
1303,GrudgePlayer,137,277,414,13,33,GrudgePlayer
1304,GrudgePlayer,131,261,392,9,39,GrudgePlayer
1305,GrudgePlayer,131,276,407,12,35,GrudgePlayer
1306,GrudgePlayer,122,257,379,8,43,GrudgePlayer
1307,GrudgePlayer,130,255,385,11,42,GrudgePlayer
1308,GrudgePlayer,132,257,389,15,42,GrudgePlayer
1309,GrudgePlayer,143,258,401,15,38,GrudgePlayer
1310,GrudgePlayer,124,239,363,7,48,GrudgePlayer
1311,GrudgePlayer,130,255,385,14,43,GrudgePlayer
1312,GrudgePlayer,121,246,367,8,47,GrudgePlayer
1313,GrudgePlayer,117,257,374,6,44,GrudgePlayer
1314,GrudgePlayer,133,263,396,10,38,GrudgePlayer
1315,GrudgePlayer,163,268,431,27,32,GrudgePlayer
1316,GrudgePlayer,124,244,368,12,48,GrudgePlayer
1317,GrudgePlayer,170,285,455,24,23,GrudgePlayer
1318,GrudgePlayer,149,264,413,15,34,GrudgePlayer
1319,GrudgePlayer,155,280,435,19,28,GrudgePlayer
1320,GrudgePlayer,134,264,398,12,38,GrudgePlayer
1321,GrudgePlayer,135,270,405,16,37,GrudgePlayer
1322,GrudgePlayer,129,244,373,8,45,GrudgePlayer
1323,GrudgePlayer,151,271,422,15,31,GrudgePlayer
1324,GrudgePlayer,131,256,387,13,42,GrudgePlayer
1325,GrudgePlayer,124,274,398,9,37,GrudgePlayer
1326,GrudgePlayer,127,262,389,9,40,GrudgePlayer
1327,GrudgePlayer,122,252,374,9,45,GrudgePlayer
1328,GrudgePlayer,137,242,379,11,44,GrudgePlayer
1329,GrudgePlayer,130,250,380,6,42,GrudgePlayer
1330,GrudgePlayer,138,273,411,10,33,GrudgePlayer
1331,GrudgePlayer,152,272,424,14,30,GrudgePlayer
1332,GrudgePlayer,151,276,427,17,30,GrudgePlayer
1333,GrudgePlayer,156,276,432,19,29,GrudgePlayer
1334,GrudgePlayer,129,254,383,15,44,GrudgePlayer
1335,GrudgePlayer,137,242,379,11,44,GrudgePlayer
1336,GrudgePlayer,134,274,408,13,35,GrudgePlayer
1337,GrudgePlayer,151,296,447,16,23,GrudgePlayer
1338,GrudgePlayer,111,261,372,7,45,GrudgePlayer
1339,GrudgePlayer,152,272,424,14,30,GrudgePlayer
1340,GrudgePlayer,135,255,390,13,41,GrudgePlayer
1341,GrudgePlayer,121,251,372,7,45,GrudgePlayer
1342,GrudgePlayer,123,263,386,9,41,GrudgePlayer
1343,GrudgePlayer,135,275,410,15,35,GrudgePlayer
1344,GrudgePlayer,138,258,396,7,37,GrudgePlayer
1345,GrudgePlayer,100,230,330,1,57,GrudgePlayer
1346,GrudgePlayer,130,260,390,13,41,GrudgePlayer
1347,GrudgePlayer,159,279,438,19,27,GrudgePlayer
1348,GrudgePlayer,157,277,434,15,27,GrudgePlayer
1349,GrudgePlayer,125,240,365,6,47,GrudgePlayer
1350,GrudgePlayer,158,288,446,18,24,GrudgePlayer
1351,GrudgePlayer,127,237,364,11,49,GrudgePlayer
1352,GrudgePlayer,133,263,396,10,38,GrudgePlayer
1353,GrudgePlayer,152,262,414,19,35,GrudgePlayer
1354,GrudgePlayer,144,249,393,16,41,GrudgePlayer
1355,GrudgePlayer,128,253,381,13,44,GrudgePlayer
1356,GrudgePlayer,144,264,408,13,35,GrudgePlayer
1357,GrudgePlayer,156,261,417,25,36,GrudgePlayer
1358,GrudgePlayer,146,261,407,15,36,GrudgePlayer
1359,GrudgePlayer,136,251,387,13,42,GrudgePlayer
1360,GrudgePlayer,128,278,406,11,35,GrudgePlayer
1361,GrudgePlayer,155,255,410,15,35,GrudgePlayer
1362,GrudgePlayer,155,270,425,21,32,GrudgePlayer
1363,GrudgePlayer,120,255,375,7,44,GrudgePlayer
1364,GrudgePlayer,136,251,387,13,42,GrudgePlayer
1365,GrudgePlayer,141,276,417,13,32,GrudgePlayer
1366,GrudgePlayer,137,252,389,15,42,GrudgePlayer
1367,GrudgePlayer,137,257,394,11,39,GrudgePlayer
1368,GrudgePlayer,136,261,397,11,38,GrudgePlayer
1369,GrudgePlayer,144,269,413,9,32,GrudgePlayer
1370,GrudgePlayer,119,239,358,8,50,GrudgePlayer
1371,GrudgePlayer,135,255,390,16,42,GrudgePlayer
1372,GrudgePlayer,135,260,395,15,40,GrudgePlayer
1373,GrudgePlayer,148,263,411,19,36,GrudgePlayer
1374,GrudgePlayer,136,271,407,9,34,GrudgePlayer
1375,GrudgePlayer,145,250,395,15,40,GrudgePlayer
1376,GrudgePlayer,135,265,400,11,37,GrudgePlayer
1377,GrudgePlayer,153,263,416,18,34,GrudgePlayer
1378,GrudgePlayer,137,242,379,14,45,GrudgePlayer
1379,GrudgePlayer,147,262,409,11,34,GrudgePlayer
1380,GrudgePlayer,142,282,424,14,30,GrudgePlayer
1381,GrudgePlayer,150,265,415,20,35,GrudgePlayer
1382,GrudgePlayer,152,277,429,10,27,GrudgePlayer
1383,GrudgePlayer,146,266,412,14,34,GrudgePlayer
1384,GrudgePlayer,139,274,413,15,34,GrudgePlayer
1385,GrudgePlayer,141,276,417,13,32,GrudgePlayer
1386,GrudgePlayer,147,257,404,18,38,GrudgePlayer
1387,GrudgePlayer,130,260,390,13,41,GrudgePlayer
1388,GrudgePlayer,125,250,375,10,45,GrudgePlayer
1389,GrudgePlayer,128,253,381,4,41,GrudgePlayer
1390,GrudgePlayer,114,229,343,5,54,GrudgePlayer
1391,GrudgePlayer,156,281,437,18,27,GrudgePlayer
1392,GrudgePlayer,136,251,387,13,42,GrudgePlayer
1393,GrudgePlayer,140,265,405,16,37,GrudgePlayer
1394,GrudgePlayer,163,283,446,24,26,GrudgePlayer
1395,GrudgePlayer,124,244,368,6,46,GrudgePlayer
1396,GrudgePlayer,121,231,352,11,53,GrudgePlayer
1397,GrudgePlayer,119,259,378,10,44,GrudgePlayer
1398,GrudgePlayer,127,262,389,6,39,GrudgePlayer
1399,GrudgePlayer,134,254,388,11,41,GrudgePlayer
1400,GrudgePlayer,119,259,378,10,44,GrudgePlayer
1401,GrudgePlayer,135,285,420,10,30,GrudgePlayer
1402,GrudgePlayer,107,247,354,7,51,GrudgePlayer
1403,GrudgePlayer,147,272,419,15,32,GrudgePlayer
1404,GrudgePlayer,135,265,400,11,37,GrudgePlayer
1405,GrudgePlayer,150,265,415,17,34,GrudgePlayer
1406,GrudgePlayer,132,242,374,12,46,GrudgePlayer
1407,GrudgePlayer,112,237,349,5,52,GrudgePlayer
1408,GrudgePlayer,130,265,395,9,38,GrudgePlayer
1409,GrudgePlayer,154,239,393,13,40,GrudgePlayer
1410,GrudgePlayer,150,270,420,16,32,GrudgePlayer
1411,GrudgePlayer,146,276,422,12,30,GrudgePlayer
1412,GrudgePlayer,117,267,384,7,41,GrudgePlayer
1413,GrudgePlayer,129,249,378,13,45,GrudgePlayer
1414,GrudgePlayer,131,241,372,10,46,GrudgePlayer
1415,GrudgePlayer,149,269,418,17,33,GrudgePlayer
1416,GrudgePlayer,139,269,408,10,34,GrudgePlayer
1417,GrudgePlayer,142,262,404,12,36,GrudgePlayer
1418,GrudgePlayer,150,270,420,16,32,GrudgePlayer
1419,GrudgePlayer,127,242,369,10,47,GrudgePlayer
1420,GrudgePlayer,140,265,405,13,36,GrudgePlayer
1421,GrudgePlayer,122,237,359,3,48,GrudgePlayer
1422,GrudgePlayer,121,256,377,9,44,GrudgePlayer
1423,GrudgePlayer,133,268,401,6,35,GrudgePlayer
1424,GrudgePlayer,131,236,367,14,49,GrudgePlayer
1425,GrudgePlayer,145,260,405,13,36,GrudgePlayer
1426,GrudgePlayer,128,278,406,5,33,GrudgePlayer
1427,GrudgePlayer,135,250,385,11,42,GrudgePlayer
1428,GrudgePlayer,133,263,396,13,39,GrudgePlayer
1429,GrudgePlayer,143,268,411,16,35,GrudgePlayer
1430,GrudgePlayer,137,237,374,12,46,GrudgePlayer
1431,GrudgePlayer,158,278,436,20,28,GrudgePlayer
1432,GrudgePlayer,152,277,429,22,31,GrudgePlayer
1433,GrudgePlayer,151,276,427,20,31,GrudgePlayer
1434,GrudgePlayer,149,279,428,18,30,GrudgePlayer
1435,GrudgePlayer,112,262,374,3,43,GrudgePlayer
1436,GrudgePlayer,165,255,420,22,34,GrudgePlayer
1437,GrudgePlayer,111,261,372,7,45,GrudgePlayer
1438,GrudgePlayer,169,279,448,20,24,GrudgePlayer
1439,GrudgePlayer,162,277,439,23,28,GrudgePlayer
1440,GrudgePlayer,126,251,377,6,43,GrudgePlayer
1441,GrudgePlayer,113,253,366,4,46,GrudgePlayer
1442,GrudgePlayer,117,247,364,2,46,GrudgePlayer
1443,GrudgePlayer,139,279,418,11,31,GrudgePlayer
1444,GrudgePlayer,140,265,405,10,35,GrudgePlayer
1445,GrudgePlayer,151,271,422,12,30,GrudgePlayer
1446,GrudgePlayer,140,260,400,11,37,GrudgePlayer
1447,GrudgePlayer,140,240,380,9,43,GrudgePlayer
1448,GrudgePlayer,148,253,401,15,38,GrudgePlayer
1449,GrudgePlayer,130,255,385,5,40,GrudgePlayer
1450,GrudgePlayer,140,245,385,11,42,GrudgePlayer
1451,GrudgePlayer,148,273,421,17,32,GrudgePlayer
1452,GrudgePlayer,140,270,410,21,37,GrudgePlayer
1453,GrudgePlayer,141,266,407,12,35,GrudgePlayer
1454,GrudgePlayer,137,272,409,14,35,GrudgePlayer
1455,GrudgePlayer,126,256,382,8,42,GrudgePlayer
1456,GrudgePlayer,142,257,399,13,38,GrudgePlayer
1457,GrudgePlayer,133,258,391,11,40,GrudgePlayer
1458,GrudgePlayer,133,268,401,9,36,GrudgePlayer
1459,GrudgePlayer,132,267,399,10,37,GrudgePlayer
1460,GrudgePlayer,141,256,397,8,37,GrudgePlayer
1461,GrudgePlayer,112,227,339,4,55,GrudgePlayer
1462,GrudgePlayer,130,250,380,9,43,GrudgePlayer
1463,GrudgePlayer,140,255,395,9,38,GrudgePlayer
1464,GrudgePlayer,115,250,365,9,48,GrudgePlayer
1465,GrudgePlayer,129,249,378,10,44,GrudgePlayer
1466,GrudgePlayer,150,275,425,18,31,GrudgePlayer
1467,GrudgePlayer,157,257,414,19,35,GrudgePlayer
1468,GrudgePlayer,149,264,413,18,35,GrudgePlayer
1469,GrudgePlayer,140,260,400,11,37,GrudgePlayer
1470,GrudgePlayer,124,279,403,8,35,GrudgePlayer
1471,GrudgePlayer,140,265,405,10,35,GrudgePlayer
1472,GrudgePlayer,129,254,383,6,41,GrudgePlayer
1473,GrudgePlayer,133,278,411,10,33,GrudgePlayer
1474,GrudgePlayer,129,269,398,6,36,GrudgePlayer
1475,GrudgePlayer,95,235,330,4,58,GrudgePlayer
1476,GrudgePlayer,130,250,380,9,43,GrudgePlayer
1477,GrudgePlayer,154,274,428,18,30,GrudgePlayer
1478,GrudgePlayer,181,296,477,28,17,GrudgePlayer
1479,GrudgePlayer,148,273,421,14,31,GrudgePlayer
1480,GrudgePlayer,114,249,363,7,48,GrudgePlayer
1481,GrudgePlayer,127,262,389,12,41,GrudgePlayer
1482,GrudgePlayer,135,255,390,13,41,GrudgePlayer
1483,GrudgePlayer,128,238,366,7,47,GrudgePlayer
1484,GrudgePlayer,115,245,360,10,50,GrudgePlayer
1485,GrudgePlayer,149,274,423,13,30,GrudgePlayer
1486,GrudgePlayer,129,249,378,10,44,GrudgePlayer
1487,GrudgePlayer,153,273,426,19,31,GrudgePlayer
1488,GrudgePlayer,133,258,391,11,40,GrudgePlayer
1489,GrudgePlayer,149,279,428,12,28,GrudgePlayer
1490,GrudgePlayer,130,245,375,7,44,GrudgePlayer
1491,GrudgePlayer,116,251,367,5,46,GrudgePlayer
1492,GrudgePlayer,149,254,403,17,38,GrudgePlayer
1493,GrudgePlayer,152,262,414,16,34,GrudgePlayer
1494,GrudgePlayer,132,262,394,11,39,GrudgePlayer
1495,GrudgePlayer,163,288,451,17,22,GrudgePlayer
1496,GrudgePlayer,145,260,405,16,37,GrudgePlayer
1497,GrudgePlayer,109,249,358,5,49,GrudgePlayer
1498,GrudgePlayer,135,255,390,7,39,GrudgePlayer
1499,GrudgePlayer,127,267,394,8,38,GrudgePlayer
1500,GrudgePlayer,135,255,390,10,40,GrudgePlayer
1501,GrudgePlayer,126,266,392,9,39,GrudgePlayer
1502,GrudgePlayer,151,266,417,13,32,GrudgePlayer
1503,GrudgePlayer,126,251,377,12,45,GrudgePlayer
1504,GrudgePlayer,133,283,416,15,33,GrudgePlayer
1505,GrudgePlayer,166,271,437,15,26,GrudgePlayer
1506,GrudgePlayer,152,277,429,19,30,GrudgePlayer
1507,GrudgePlayer,136,266,402,10,36,GrudgePlayer
1508,GrudgePlayer,145,270,415,17,34,GrudgePlayer
1509,GrudgePlayer,143,273,416,15,33,GrudgePlayer
1510,GrudgePlayer,134,239,373,11,46,GrudgePlayer
1511,GrudgePlayer,146,266,412,17,35,GrudgePlayer
1512,GrudgePlayer,142,252,394,11,39,GrudgePlayer
1513,GrudgePlayer,132,267,399,7,36,GrudgePlayer
1514,GrudgePlayer,149,269,418,17,33,GrudgePlayer
1515,GrudgePlayer,131,246,377,12,45,GrudgePlayer
1516,GrudgePlayer,154,259,413,18,35,GrudgePlayer
1517,GrudgePlayer,144,279,423,13,30,GrudgePlayer
1518,GrudgePlayer,132,242,374,12,46,GrudgePlayer
1519,GrudgePlayer,128,273,401,9,36,GrudgePlayer
1520,GrudgePlayer,134,264,398,15,39,GrudgePlayer
1521,GrudgePlayer,147,267,414,13,33,GrudgePlayer
1522,GrudgePlayer,140,265,405,10,35,GrudgePlayer
1523,GrudgePlayer,155,275,430,14,28,GrudgePlayer
1524,GrudgePlayer,120,245,365,9,48,GrudgePlayer
1525,GrudgePlayer,136,261,397,8,37,GrudgePlayer
1526,GrudgePlayer,152,287,439,14,25,GrudgePlayer
1527,GrudgePlayer,128,258,386,6,40,GrudgePlayer
1528,GrudgePlayer,157,267,424,17,31,GrudgePlayer
1529,GrudgePlayer,120,255,375,7,44,GrudgePlayer
1530,GrudgePlayer,111,256,367,5,46,GrudgePlayer
1531,GrudgePlayer,137,257,394,14,40,GrudgePlayer
1532,GrudgePlayer,146,271,417,13,32,GrudgePlayer
1533,GrudgePlayer,137,277,414,10,32,GrudgePlayer
1534,GrudgePlayer,145,245,390,13,41,GrudgePlayer
1535,GrudgePlayer,121,241,362,6,48,GrudgePlayer
1536,GrudgePlayer,134,269,403,11,36,GrudgePlayer
1537,GrudgePlayer,149,259,408,19,37,GrudgePlayer
1538,GrudgePlayer,135,265,400,8,36,GrudgePlayer
1539,GrudgePlayer,133,248,381,10,43,GrudgePlayer
1540,GrudgePlayer,126,276,402,10,36,GrudgePlayer
1541,GrudgePlayer,134,264,398,12,38,GrudgePlayer
1542,GrudgePlayer,139,259,398,12,38,GrudgePlayer
1543,GrudgePlayer,130,245,375,13,46,GrudgePlayer
1544,GrudgePlayer,135,255,390,13,41,GrudgePlayer
1545,GrudgePlayer,130,260,390,10,40,GrudgePlayer
1546,GrudgePlayer,138,253,391,11,40,GrudgePlayer
1547,GrudgePlayer,131,281,412,8,32,GrudgePlayer
1548,GrudgePlayer,147,257,404,18,38,GrudgePlayer
1549,GrudgePlayer,127,252,379,8,43,GrudgePlayer
1550,GrudgePlayer,133,263,396,10,38,GrudgePlayer
1551,GrudgePlayer,143,278,421,14,31,GrudgePlayer
1552,GrudgePlayer,131,256,387,10,41,GrudgePlayer
1553,GrudgePlayer,149,254,403,14,37,GrudgePlayer
1554,GrudgePlayer,119,264,383,3,40,GrudgePlayer
1555,GrudgePlayer,143,253,396,16,40,GrudgePlayer
1556,GrudgePlayer,123,248,371,9,46,GrudgePlayer
1557,GrudgePlayer,121,231,352,8,52,GrudgePlayer
1558,GrudgePlayer,146,256,402,19,39,GrudgePlayer
1559,GrudgePlayer,118,268,386,6,40,GrudgePlayer
1560,GrudgePlayer,146,266,412,17,35,GrudgePlayer
1561,GrudgePlayer,145,270,415,11,32,GrudgePlayer
1562,GrudgePlayer,139,279,418,14,32,GrudgePlayer
1563,GrudgePlayer,148,263,411,16,35,GrudgePlayer
1564,GrudgePlayer,132,257,389,9,40,GrudgePlayer
1565,GrudgePlayer,135,260,395,9,38,GrudgePlayer
1566,GrudgePlayer,141,271,412,14,34,GrudgePlayer
1567,GrudgePlayer,133,268,401,15,38,GrudgePlayer
1568,GrudgePlayer,132,257,389,9,40,GrudgePlayer
1569,GrudgePlayer,151,261,412,20,36,GrudgePlayer
1570,GrudgePlayer,123,243,366,10,48,GrudgePlayer
1571,GrudgePlayer,139,249,388,11,41,GrudgePlayer
1572,GrudgePlayer,134,259,393,10,39,GrudgePlayer
1573,GrudgePlayer,139,279,418,11,31,GrudgePlayer
1574,GrudgePlayer,121,256,377,6,43,GrudgePlayer
1575,GrudgePlayer,143,248,391,11,40,GrudgePlayer
1576,GrudgePlayer,172,282,454,23,23,GrudgePlayer
1577,GrudgePlayer,106,241,347,3,52,GrudgePlayer
1578,GrudgePlayer,149,259,408,19,37,GrudgePlayer
1579,GrudgePlayer,127,272,399,10,37,GrudgePlayer
1580,GrudgePlayer,127,257,384,7,41,GrudgePlayer
1581,GrudgePlayer,133,238,371,12,47,GrudgePlayer
1582,GrudgePlayer,130,260,390,7,39,GrudgePlayer
1583,GrudgePlayer,118,238,356,6,50,GrudgePlayer
1584,GrudgePlayer,152,262,414,16,34,GrudgePlayer
1585,GrudgePlayer,140,250,390,13,41,GrudgePlayer
1586,GrudgePlayer,148,288,436,14,26,GrudgePlayer
1587,GrudgePlayer,153,278,431,15,28,GrudgePlayer
1588,GrudgePlayer,134,269,403,11,36,GrudgePlayer
1589,GrudgePlayer,138,248,386,9,41,GrudgePlayer
1590,GrudgePlayer,118,253,371,6,45,GrudgePlayer
1591,GrudgePlayer,152,272,424,23,33,GrudgePlayer
1592,GrudgePlayer,136,266,402,10,36,GrudgePlayer
1593,GrudgePlayer,112,257,369,10,47,GrudgePlayer
1594,GrudgePlayer,157,262,419,18,33,GrudgePlayer
1595,GrudgePlayer,159,264,423,16,31,GrudgePlayer
1596,GrudgePlayer,125,265,390,10,40,GrudgePlayer
1597,GrudgePlayer,141,271,412,11,33,GrudgePlayer
1598,GrudgePlayer,145,270,415,14,33,GrudgePlayer
1599,GrudgePlayer,124,274,398,12,38,GrudgePlayer
1600,GrudgePlayer,135,260,395,12,39,GrudgePlayer
1601,GrudgePlayer,136,266,402,10,36,GrudgePlayer
1602,GrudgePlayer,122,257,379,8,43,GrudgePlayer
1603,GrudgePlayer,138,258,396,16,40,GrudgePlayer
1604,GrudgePlayer,136,256,392,15,41,GrudgePlayer
1605,GrudgePlayer,132,262,394,14,40,GrudgePlayer
1606,GrudgePlayer,134,259,393,13,40,GrudgePlayer
1607,GrudgePlayer,118,258,376,8,44,GrudgePlayer
1608,GrudgePlayer,159,269,428,18,30,GrudgePlayer
1609,GrudgePlayer,136,261,397,8,37,GrudgePlayer
1610,GrudgePlayer,132,257,389,12,41,GrudgePlayer
1611,GrudgePlayer,129,254,383,6,41,GrudgePlayer
1612,GrudgePlayer,137,237,374,12,46,GrudgePlayer
1613,GrudgePlayer,136,266,402,13,37,GrudgePlayer
1614,GrudgePlayer,136,266,402,10,36,GrudgePlayer
1615,GrudgePlayer,130,265,395,6,37,GrudgePlayer
1616,GrudgePlayer,135,265,400,11,37,GrudgePlayer
1617,GrudgePlayer,130,255,385,8,41,GrudgePlayer
1618,GrudgePlayer,137,277,414,13,33,GrudgePlayer
1619,GrudgePlayer,152,287,439,14,25,GrudgePlayer
1620,GrudgePlayer,131,271,402,10,36,GrudgePlayer
1621,GrudgePlayer,152,287,439,14,25,GrudgePlayer
1622,GrudgePlayer,150,255,405,16,37,GrudgePlayer
1623,GrudgePlayer,137,237,374,15,47,GrudgePlayer
1624,GrudgePlayer,158,278,436,17,27,GrudgePlayer
1625,GrudgePlayer,148,258,406,14,36,GrudgePlayer
1626,GrudgePlayer,131,251,382,11,43,GrudgePlayer
1627,GrudgePlayer,147,277,424,14,30,GrudgePlayer
1628,GrudgePlayer,137,252,389,9,40,GrudgePlayer
1629,GrudgePlayer,130,260,390,13,41,GrudgePlayer
1630,GrudgePlayer,104,224,328,5,59,GrudgePlayer
1631,GrudgePlayer,129,264,393,13,40,GrudgePlayer
1632,GrudgePlayer,110,255,365,3,46,GrudgePlayer
1633,GrudgePlayer,143,238,381,16,45,GrudgePlayer
1634,GrudgePlayer,146,286,432,13,27,GrudgePlayer
1635,GrudgePlayer,135,275,410,12,34,GrudgePlayer
1636,GrudgePlayer,142,262,404,15,37,GrudgePlayer
1637,GrudgePlayer,149,259,408,13,35,GrudgePlayer
1638,GrudgePlayer,138,283,421,11,30,GrudgePlayer
1639,GrudgePlayer,139,269,408,16,36,GrudgePlayer
1640,GrudgePlayer,134,279,413,12,33,GrudgePlayer
1641,GrudgePlayer,172,262,434,21,29,GrudgePlayer
1642,GrudgePlayer,107,262,369,4,45,GrudgePlayer
1643,GrudgePlayer,110,240,350,6,52,GrudgePlayer
1644,GrudgePlayer,134,264,398,15,39,GrudgePlayer
1645,GrudgePlayer,152,267,419,18,33,GrudgePlayer
1646,GrudgePlayer,128,238,366,7,47,GrudgePlayer
1647,GrudgePlayer,159,279,438,25,29,GrudgePlayer
1648,GrudgePlayer,127,267,394,8,38,GrudgePlayer
1649,GrudgePlayer,132,267,399,13,38,GrudgePlayer
1650,GrudgePlayer,135,270,405,10,35,GrudgePlayer
1651,GrudgePlayer,137,257,394,8,38,GrudgePlayer
1652,GrudgePlayer,144,289,433,14,27,GrudgePlayer
1653,GrudgePlayer,161,241,402,22,40,GrudgePlayer
1654,GrudgePlayer,133,248,381,16,45,GrudgePlayer
1655,GrudgePlayer,147,282,429,16,29,GrudgePlayer
1656,GrudgePlayer,159,279,438,19,27,GrudgePlayer
1657,GrudgePlayer,123,263,386,12,42,GrudgePlayer
1658,GrudgePlayer,162,257,419,24,35,GrudgePlayer
1659,GrudgePlayer,118,273,391,5,38,GrudgePlayer
1660,GrudgePlayer,170,280,450,22,24,GrudgePlayer
1661,GrudgePlayer,114,254,368,3,45,GrudgePlayer
1662,GrudgePlayer,128,268,396,13,39,GrudgePlayer
1663,GrudgePlayer,143,273,416,15,33,GrudgePlayer
1664,GrudgePlayer,165,270,435,19,28,GrudgePlayer
1665,GrudgePlayer,176,301,477,25,16,GrudgePlayer
1666,GrudgePlayer,140,275,415,11,32,GrudgePlayer
1667,GrudgePlayer,145,275,420,13,31,GrudgePlayer
1668,GrudgePlayer,150,270,420,19,33,GrudgePlayer
1669,GrudgePlayer,132,257,389,12,41,GrudgePlayer
1670,GrudgePlayer,141,261,402,16,38,GrudgePlayer
1671,GrudgePlayer,132,257,389,12,41,GrudgePlayer
1672,GrudgePlayer,130,250,380,9,43,GrudgePlayer
1673,GrudgePlayer,143,268,411,13,34,GrudgePlayer
1674,GrudgePlayer,146,276,422,12,30,GrudgePlayer
1675,GrudgePlayer,122,267,389,6,39,GrudgePlayer
1676,GrudgePlayer,131,241,372,10,46,GrudgePlayer
1677,GrudgePlayer,152,272,424,23,33,GrudgePlayer
1678,GrudgePlayer,112,237,349,5,52,GrudgePlayer
1679,GrudgePlayer,128,253,381,7,42,GrudgePlayer
1680,GrudgePlayer,138,263,401,15,38,GrudgePlayer
1681,GrudgePlayer,145,255,400,17,39,GrudgePlayer
1682,GrudgePlayer,151,276,427,17,30,GrudgePlayer
1683,GrudgePlayer,155,285,440,18,26,GrudgePlayer
1684,GrudgePlayer,130,235,365,9,48,GrudgePlayer
1685,GrudgePlayer,149,259,408,16,36,GrudgePlayer
1686,GrudgePlayer,162,282,444,22,26,GrudgePlayer
1687,GrudgePlayer,161,291,452,21,23,GrudgePlayer
1688,GrudgePlayer,159,284,443,15,24,GrudgePlayer
1689,GrudgePlayer,126,271,397,8,37,GrudgePlayer
1690,GrudgePlayer,120,270,390,7,39,GrudgePlayer
1691,GrudgePlayer,152,257,409,14,35,GrudgePlayer
1692,GrudgePlayer,140,260,400,14,38,GrudgePlayer
1693,GrudgePlayer,134,259,393,13,40,GrudgePlayer
1694,GrudgePlayer,123,263,386,9,41,GrudgePlayer
1695,GrudgePlayer,142,267,409,17,36,GrudgePlayer
1696,GrudgePlayer,135,250,385,11,42,GrudgePlayer
1697,GrudgePlayer,149,279,428,18,30,GrudgePlayer
1698,GrudgePlayer,144,269,413,15,34,GrudgePlayer
1699,GrudgePlayer,150,270,420,16,32,GrudgePlayer
1700,GrudgePlayer,130,245,375,10,45,GrudgePlayer
1701,GrudgePlayer,124,259,383,6,41,GrudgePlayer
1702,GrudgePlayer,147,247,394,14,40,GrudgePlayer
1703,GrudgePlayer,133,258,391,11,40,GrudgePlayer
1704,GrudgePlayer,121,241,362,9,49,GrudgePlayer
1705,GrudgePlayer,111,251,362,9,49,GrudgePlayer
1706,GrudgePlayer,118,253,371,6,45,GrudgePlayer
1707,GrudgePlayer,137,237,374,15,47,GrudgePlayer
1708,GrudgePlayer,154,279,433,20,29,GrudgePlayer
1709,GrudgePlayer,132,277,409,11,34,GrudgePlayer
1710,GrudgePlayer,163,248,411,19,36,GrudgePlayer
1711,GrudgePlayer,117,267,384,7,41,GrudgePlayer
1712,GrudgePlayer,117,222,339,7,56,GrudgePlayer
1713,GrudgePlayer,137,272,409,11,34,GrudgePlayer
1714,GrudgePlayer,134,249,383,15,44,GrudgePlayer
1715,GrudgePlayer,119,239,358,8,50,GrudgePlayer
1716,GrudgePlayer,144,274,418,11,31,GrudgePlayer
1717,GrudgePlayer,124,259,383,12,43,GrudgePlayer
1718,GrudgePlayer,125,260,385,11,42,GrudgePlayer
1719,GrudgePlayer,133,288,421,11,30,GrudgePlayer
1720,GrudgePlayer,110,230,340,5,55,GrudgePlayer
1721,GrudgePlayer,135,280,415,11,32,GrudgePlayer
1722,GrudgePlayer,150,265,415,14,33,GrudgePlayer
1723,GrudgePlayer,168,288,456,22,22,GrudgePlayer
1724,GrudgePlayer,151,281,432,13,27,GrudgePlayer
1725,GrudgePlayer,132,272,404,12,36,GrudgePlayer
1726,GrudgePlayer,143,258,401,15,38,GrudgePlayer
1727,GrudgePlayer,140,270,410,12,34,GrudgePlayer
1728,GrudgePlayer,139,269,408,10,34,GrudgePlayer
1729,GrudgePlayer,124,239,363,10,49,GrudgePlayer
1730,GrudgePlayer,138,278,416,9,31,GrudgePlayer
1731,GrudgePlayer,154,274,428,15,29,GrudgePlayer
1732,GrudgePlayer,130,270,400,14,38,GrudgePlayer
1733,GrudgePlayer,137,257,394,14,40,GrudgePlayer
1734,GrudgePlayer,133,273,406,11,35,GrudgePlayer
1735,GrudgePlayer,125,250,375,7,44,GrudgePlayer
1736,GrudgePlayer,133,238,371,15,48,GrudgePlayer
1737,GrudgePlayer,127,262,389,6,39,GrudgePlayer
1738,GrudgePlayer,134,259,393,13,40,GrudgePlayer
1739,GrudgePlayer,136,261,397,11,38,GrudgePlayer
1740,GrudgePlayer,171,271,442,23,27,GrudgePlayer
1741,GrudgePlayer,104,264,368,3,45,GrudgePlayer
1742,GrudgePlayer,166,286,452,21,23,GrudgePlayer
1743,GrudgePlayer,163,283,446,18,24,GrudgePlayer
1744,GrudgePlayer,166,296,462,22,20,GrudgePlayer
1745,GrudgePlayer,129,254,383,15,44,GrudgePlayer
1746,GrudgePlayer,130,260,390,13,41,GrudgePlayer
1747,GrudgePlayer,129,274,403,11,36,GrudgePlayer
1748,GrudgePlayer,139,249,388,11,41,GrudgePlayer
1749,GrudgePlayer,151,276,427,17,30,GrudgePlayer
1750,GrudgePlayer,141,261,402,10,36,GrudgePlayer
1751,GrudgePlayer,143,243,386,9,41,GrudgePlayer
1752,GrudgePlayer,133,258,391,14,41,GrudgePlayer
1753,GrudgePlayer,142,272,414,13,33,GrudgePlayer
1754,GrudgePlayer,112,237,349,2,51,GrudgePlayer
1755,GrudgePlayer,151,251,402,16,38,GrudgePlayer
1756,GrudgePlayer,156,276,432,16,28,GrudgePlayer
1757,GrudgePlayer,149,264,413,15,34,GrudgePlayer
1758,GrudgePlayer,151,286,437,18,27,GrudgePlayer
1759,GrudgePlayer,107,237,344,3,53,GrudgePlayer
1760,GrudgePlayer,143,268,411,10,33,GrudgePlayer
1761,GrudgePlayer,157,282,439,17,26,GrudgePlayer
1762,GrudgePlayer,151,276,427,17,30,GrudgePlayer
1763,GrudgePlayer,180,280,460,29,23,GrudgePlayer
1764,GrudgePlayer,147,262,409,17,36,GrudgePlayer
1765,GrudgePlayer,139,284,423,10,29,GrudgePlayer
1766,GrudgePlayer,137,257,394,11,39,GrudgePlayer
1767,GrudgePlayer,144,264,408,10,34,GrudgePlayer
1768,GrudgePlayer,116,256,372,10,46,GrudgePlayer
1769,GrudgePlayer,153,268,421,17,32,GrudgePlayer
1770,GrudgePlayer,151,276,427,20,31,GrudgePlayer
1771,GrudgePlayer,159,274,433,20,29,GrudgePlayer
1772,GrudgePlayer,149,284,433,20,29,GrudgePlayer
1773,GrudgePlayer,120,240,360,7,49,GrudgePlayer
1774,GrudgePlayer,138,253,391,8,39,GrudgePlayer
1775,GrudgePlayer,104,254,358,5,49,GrudgePlayer
1776,GrudgePlayer,141,266,407,15,36,GrudgePlayer
1777,GrudgePlayer,134,249,383,15,44,GrudgePlayer
1778,GrudgePlayer,144,274,418,17,33,GrudgePlayer
1779,GrudgePlayer,135,265,400,11,37,GrudgePlayer
1780,GrudgePlayer,129,244,373,11,46,GrudgePlayer
1781,GrudgePlayer,127,282,409,8,33,GrudgePlayer
1782,GrudgePlayer,134,254,388,11,41,GrudgePlayer
1783,GrudgePlayer,133,268,401,9,36,GrudgePlayer
1784,GrudgePlayer,104,254,358,5,49,GrudgePlayer
1785,GrudgePlayer,160,280,440,24,28,GrudgePlayer
1786,GrudgePlayer,173,288,461,27,22,GrudgePlayer
1787,GrudgePlayer,132,247,379,11,44,GrudgePlayer
1788,GrudgePlayer,148,253,401,18,39,GrudgePlayer
1789,GrudgePlayer,141,256,397,14,39,GrudgePlayer
1790,GrudgePlayer,124,269,393,10,39,GrudgePlayer
1791,GrudgePlayer,150,255,405,19,38,GrudgePlayer
1792,GrudgePlayer,141,251,392,18,42,GrudgePlayer
1793,GrudgePlayer,114,269,383,6,41,GrudgePlayer
1794,GrudgePlayer,127,247,374,9,45,GrudgePlayer
1795,GrudgePlayer,138,263,401,12,37,GrudgePlayer
1796,GrudgePlayer,125,270,395,3,36,GrudgePlayer
1797,GrudgePlayer,137,257,394,14,40,GrudgePlayer
1798,GrudgePlayer,149,264,413,15,34,GrudgePlayer
1799,GrudgePlayer,126,291,417,10,31,GrudgePlayer
1800,GrudgePlayer,134,259,393,10,39,GrudgePlayer
1801,GrudgePlayer,137,257,394,14,40,GrudgePlayer
1802,GrudgePlayer,137,257,394,8,38,GrudgePlayer
1803,GrudgePlayer,115,245,360,7,49,GrudgePlayer
1804,GrudgePlayer,126,236,362,12,50,GrudgePlayer
1805,GrudgePlayer,125,255,380,9,43,GrudgePlayer
1806,GrudgePlayer,140,250,390,13,41,GrudgePlayer
1807,GrudgePlayer,150,290,440,15,25,GrudgePlayer
1808,GrudgePlayer,148,273,421,11,30,GrudgePlayer
1809,GrudgePlayer,135,250,385,8,41,GrudgePlayer
1810,GrudgePlayer,137,247,384,13,43,GrudgePlayer
1811,GrudgePlayer,156,276,432,19,29,GrudgePlayer
1812,GrudgePlayer,148,243,391,17,42,GrudgePlayer
1813,GrudgePlayer,126,241,367,8,47,GrudgePlayer
1814,GrudgePlayer,129,259,388,8,40,GrudgePlayer
1815,GrudgePlayer,120,265,385,8,41,GrudgePlayer
1816,GrudgePlayer,113,238,351,7,52,GrudgePlayer
1817,GrudgePlayer,133,263,396,13,39,GrudgePlayer
1818,GrudgePlayer,110,260,370,2,44,GrudgePlayer
1819,GrudgePlayer,111,246,357,4,49,GrudgePlayer
1820,GrudgePlayer,140,250,390,10,40,GrudgePlayer
1821,GrudgePlayer,132,282,414,10,32,GrudgePlayer
1822,GrudgePlayer,149,269,418,17,33,GrudgePlayer
1823,GrudgePlayer,141,281,422,12,30,GrudgePlayer
1824,GrudgePlayer,143,248,391,14,41,GrudgePlayer
1825,GrudgePlayer,133,268,401,3,34,GrudgePlayer
1826,GrudgePlayer,113,268,381,4,41,GrudgePlayer
1827,GrudgePlayer,118,253,371,9,46,GrudgePlayer
1828,GrudgePlayer,135,260,395,12,39,GrudgePlayer
1829,GrudgePlayer,155,270,425,18,31,GrudgePlayer
1830,GrudgePlayer,149,274,423,16,31,GrudgePlayer
1831,GrudgePlayer,110,235,345,4,53,GrudgePlayer
1832,GrudgePlayer,130,260,390,10,40,GrudgePlayer
1833,GrudgePlayer,133,248,381,13,44,GrudgePlayer
1834,GrudgePlayer,137,267,404,12,36,GrudgePlayer
1835,GrudgePlayer,101,256,357,7,50,GrudgePlayer
1836,GrudgePlayer,138,258,396,16,40,GrudgePlayer
1837,GrudgePlayer,139,259,398,15,39,GrudgePlayer
1838,GrudgePlayer,162,297,459,22,21,GrudgePlayer
1839,GrudgePlayer,148,263,411,13,34,GrudgePlayer
1840,GrudgePlayer,154,259,413,18,35,GrudgePlayer
1841,GrudgePlayer,128,258,386,9,41,GrudgePlayer
1842,GrudgePlayer,137,252,389,9,40,GrudgePlayer
1843,GrudgePlayer,141,251,392,15,41,GrudgePlayer
1844,GrudgePlayer,123,273,396,10,38,GrudgePlayer
1845,GrudgePlayer,138,268,406,14,36,GrudgePlayer
1846,GrudgePlayer,134,279,413,12,33,GrudgePlayer
1847,GrudgePlayer,167,287,454,20,22,GrudgePlayer
1848,GrudgePlayer,150,270,420,13,31,GrudgePlayer
1849,GrudgePlayer,141,266,407,12,35,GrudgePlayer
1850,GrudgePlayer,147,272,419,15,32,GrudgePlayer
1851,GrudgePlayer,134,254,388,8,40,GrudgePlayer
1852,GrudgePlayer,114,269,383,9,42,GrudgePlayer
1853,GrudgePlayer,130,240,370,8,46,GrudgePlayer
1854,GrudgePlayer,140,235,375,16,47,GrudgePlayer
1855,GrudgePlayer,150,275,425,15,30,GrudgePlayer
1856,GrudgePlayer,153,263,416,15,33,GrudgePlayer
1857,GrudgePlayer,136,276,412,11,33,GrudgePlayer
1858,GrudgePlayer,134,249,383,12,43,GrudgePlayer
1859,GrudgePlayer,138,253,391,14,41,GrudgePlayer
1860,GrudgePlayer,142,262,404,15,37,GrudgePlayer
1861,GrudgePlayer,132,272,404,9,35,GrudgePlayer
1862,GrudgePlayer,127,272,399,13,38,GrudgePlayer
1863,GrudgePlayer,148,273,421,17,32,GrudgePlayer
1864,GrudgePlayer,112,262,374,3,43,GrudgePlayer
1865,GrudgePlayer,147,277,424,20,32,GrudgePlayer
1866,GrudgePlayer,132,252,384,13,43,GrudgePlayer
1867,GrudgePlayer,167,262,429,28,33,GrudgePlayer
1868,GrudgePlayer,129,244,373,8,45,GrudgePlayer
1869,GrudgePlayer,180,285,465,28,21,GrudgePlayer
1870,GrudgePlayer,111,256,367,2,45,GrudgePlayer
1871,GrudgePlayer,149,254,403,14,37,GrudgePlayer
1872,GrudgePlayer,161,276,437,24,29,GrudgePlayer
1873,GrudgePlayer,140,275,415,17,34,GrudgePlayer
1874,GrudgePlayer,135,270,405,13,36,GrudgePlayer
1875,GrudgePlayer,133,248,381,13,44,GrudgePlayer
1876,GrudgePlayer,129,264,393,13,40,GrudgePlayer
1877,GrudgePlayer,124,254,378,7,43,GrudgePlayer
1878,GrudgePlayer,138,258,396,7,37,GrudgePlayer
1879,GrudgePlayer,118,248,366,4,46,GrudgePlayer
1880,GrudgePlayer,153,273,426,19,31,GrudgePlayer
1881,GrudgePlayer,144,259,403,14,37,GrudgePlayer
1882,GrudgePlayer,128,278,406,11,35,GrudgePlayer
1883,GrudgePlayer,118,263,381,7,42,GrudgePlayer
1884,GrudgePlayer,146,261,407,12,35,GrudgePlayer
1885,GrudgePlayer,141,251,392,15,41,GrudgePlayer
1886,GrudgePlayer,147,282,429,16,29,GrudgePlayer
1887,GrudgePlayer,145,260,405,16,37,GrudgePlayer
1888,GrudgePlayer,147,252,399,19,40,GrudgePlayer
1889,GrudgePlayer,138,268,406,14,36,GrudgePlayer
1890,GrudgePlayer,144,259,403,17,38,GrudgePlayer
1891,GrudgePlayer,124,274,398,9,37,GrudgePlayer
1892,GrudgePlayer,113,223,336,4,56,GrudgePlayer
1893,GrudgePlayer,109,259,368,3,45,GrudgePlayer
1894,GrudgePlayer,147,267,414,16,34,GrudgePlayer
1895,GrudgePlayer,122,247,369,10,47,GrudgePlayer
1896,GrudgePlayer,136,266,402,10,36,GrudgePlayer
1897,GrudgePlayer,135,285,420,16,32,GrudgePlayer
1898,GrudgePlayer,148,258,406,14,36,GrudgePlayer
1899,GrudgePlayer,139,274,413,12,33,GrudgePlayer
1900,GrudgePlayer,169,269,438,19,27,GrudgePlayer
1901,GrudgePlayer,133,268,401,9,36,GrudgePlayer
1902,GrudgePlayer,151,271,422,21,33,GrudgePlayer
1903,GrudgePlayer,109,249,358,8,50,GrudgePlayer
1904,GrudgePlayer,145,255,400,11,37,GrudgePlayer
1905,GrudgePlayer,133,273,406,14,36,GrudgePlayer
1906,GrudgePlayer,157,272,429,22,31,GrudgePlayer
1907,GrudgePlayer,135,275,410,15,35,GrudgePlayer
1908,GrudgePlayer,156,251,407,18,37,GrudgePlayer
1909,GrudgePlayer,137,262,399,13,38,GrudgePlayer
1910,GrudgePlayer,153,268,421,17,32,GrudgePlayer
1911,GrudgePlayer,150,280,430,11,27,GrudgePlayer
1912,GrudgePlayer,134,269,403,11,36,GrudgePlayer
1913,GrudgePlayer,152,257,409,17,36,GrudgePlayer
1914,GrudgePlayer,130,250,380,12,44,GrudgePlayer
1915,GrudgePlayer,123,258,381,7,42,GrudgePlayer
1916,GrudgePlayer,121,266,387,7,40,GrudgePlayer
1917,GrudgePlayer,130,295,425,12,29,GrudgePlayer
1918,GrudgePlayer,156,246,402,19,39,GrudgePlayer
1919,GrudgePlayer,160,260,420,22,34,GrudgePlayer
1920,GrudgePlayer,142,272,414,16,34,GrudgePlayer
1921,GrudgePlayer,153,258,411,22,37,GrudgePlayer
1922,GrudgePlayer,127,272,399,7,36,GrudgePlayer
1923,GrudgePlayer,150,275,425,12,29,GrudgePlayer
1924,GrudgePlayer,139,254,393,13,40,GrudgePlayer
1925,GrudgePlayer,116,261,377,6,43,GrudgePlayer
1926,GrudgePlayer,139,269,408,13,35,GrudgePlayer
1927,GrudgePlayer,155,265,420,19,33,GrudgePlayer
1928,GrudgePlayer,140,260,400,11,37,GrudgePlayer
1929,GrudgePlayer,139,264,403,8,35,GrudgePlayer
1930,GrudgePlayer,126,261,387,13,42,GrudgePlayer
1931,GrudgePlayer,136,251,387,7,40,GrudgePlayer
1932,GrudgePlayer,132,247,379,11,44,GrudgePlayer
1933,GrudgePlayer,142,277,419,12,31,GrudgePlayer
1934,GrudgePlayer,127,257,384,10,42,GrudgePlayer
1935,GrudgePlayer,141,256,397,17,40,GrudgePlayer
1936,GrudgePlayer,122,232,354,10,52,GrudgePlayer
1937,GrudgePlayer,135,255,390,13,41,GrudgePlayer
1938,GrudgePlayer,139,269,408,10,34,GrudgePlayer
1939,GrudgePlayer,134,274,408,13,35,GrudgePlayer
1940,GrudgePlayer,140,255,395,15,40,GrudgePlayer
1941,GrudgePlayer,141,266,407,15,36,GrudgePlayer
1942,GrudgePlayer,151,271,422,21,33,GrudgePlayer
1943,GrudgePlayer,157,262,419,21,34,GrudgePlayer
1944,GrudgePlayer,130,270,400,11,37,GrudgePlayer
1945,GrudgePlayer,153,263,416,15,33,GrudgePlayer
1946,GrudgePlayer,180,295,475,29,18,GrudgePlayer
1947,GrudgePlayer,127,277,404,12,36,GrudgePlayer
1948,GrudgePlayer,129,254,383,9,42,GrudgePlayer
1949,GrudgePlayer,128,283,411,7,32,GrudgePlayer
1950,GrudgePlayer,138,263,401,9,36,GrudgePlayer
1951,GrudgePlayer,141,261,402,13,37,GrudgePlayer
1952,GrudgePlayer,134,259,393,7,38,GrudgePlayer
1953,GrudgePlayer,128,253,381,16,45,GrudgePlayer
1954,GrudgePlayer,132,252,384,10,42,GrudgePlayer
1955,GrudgePlayer,124,279,403,8,35,GrudgePlayer
1956,GrudgePlayer,139,264,403,14,37,GrudgePlayer
1957,GrudgePlayer,132,267,399,13,38,GrudgePlayer
1958,GrudgePlayer,156,266,422,18,32,GrudgePlayer
1959,GrudgePlayer,151,251,402,16,38,GrudgePlayer
1960,GrudgePlayer,136,256,392,15,41,GrudgePlayer
1961,GrudgePlayer,139,254,393,10,39,GrudgePlayer
1962,GrudgePlayer,144,274,418,14,32,GrudgePlayer
1963,GrudgePlayer,151,261,412,20,36,GrudgePlayer
1964,GrudgePlayer,125,280,405,10,35,GrudgePlayer
1965,GrudgePlayer,150,255,405,16,37,GrudgePlayer
1966,GrudgePlayer,134,254,388,14,42,GrudgePlayer
1967,GrudgePlayer,158,263,421,17,32,GrudgePlayer
1968,GrudgePlayer,142,277,419,15,32,GrudgePlayer
1969,GrudgePlayer,119,249,368,9,47,GrudgePlayer
1970,GrudgePlayer,140,275,415,11,32,GrudgePlayer
1971,GrudgePlayer,113,248,361,5,48,GrudgePlayer
1972,GrudgePlayer,152,282,434,18,28,GrudgePlayer
1973,GrudgePlayer,134,254,388,11,41,GrudgePlayer
1974,GrudgePlayer,136,261,397,11,38,GrudgePlayer
1975,GrudgePlayer,134,259,393,13,40,GrudgePlayer
1976,GrudgePlayer,133,268,401,6,35,GrudgePlayer
1977,GrudgePlayer,149,259,408,19,37,GrudgePlayer
1978,GrudgePlayer,152,277,429,13,28,GrudgePlayer
1979,GrudgePlayer,132,282,414,10,32,GrudgePlayer
1980,GrudgePlayer,134,259,393,13,40,GrudgePlayer
1981,GrudgePlayer,137,267,404,15,37,GrudgePlayer
1982,GrudgePlayer,120,260,380,6,42,GrudgePlayer
1983,GrudgePlayer,120,250,370,8,46,GrudgePlayer
1984,GrudgePlayer,121,271,392,12,40,GrudgePlayer
1985,GrudgePlayer,136,276,412,14,34,GrudgePlayer
1986,GrudgePlayer,137,257,394,14,40,GrudgePlayer
1987,GrudgePlayer,100,250,350,3,51,GrudgePlayer
1988,GrudgePlayer,131,261,392,15,41,GrudgePlayer
1989,GrudgePlayer,143,273,416,15,33,GrudgePlayer
1990,GrudgePlayer,132,252,384,13,43,GrudgePlayer
1991,GrudgePlayer,105,250,355,5,50,GrudgePlayer
1992,GrudgePlayer,130,240,370,11,47,GrudgePlayer
1993,GrudgePlayer,115,250,365,6,47,GrudgePlayer
1994,GrudgePlayer,157,252,409,17,36,GrudgePlayer
1995,GrudgePlayer,141,266,407,9,34,GrudgePlayer
1996,GrudgePlayer,130,260,390,7,39,GrudgePlayer
1997,GrudgePlayer,159,259,418,17,33,GrudgePlayer
1998,GrudgePlayer,126,266,392,9,39,GrudgePlayer
1999,GrudgePlayer,139,249,388,14,42,GrudgePlayer
2000,GrudgePlayer,132,267,399,10,37,GrudgePlayer
2001,GrudgePlayer,148,268,416,18,34,GrudgePlayer
2002,GrudgePlayer,155,270,425,12,29,GrudgePlayer
2003,GrudgePlayer,147,282,429,13,28,GrudgePlayer
2004,GrudgePlayer,130,265,395,9,38,GrudgePlayer
2005,GrudgePlayer,131,256,387,13,42,GrudgePlayer
2006,GrudgePlayer,119,259,378,7,43,GrudgePlayer
2007,GrudgePlayer,161,256,417,25,36,GrudgePlayer
2008,GrudgePlayer,141,276,417,16,33,GrudgePlayer
2009,GrudgePlayer,126,246,372,7,45,GrudgePlayer
2010,GrudgePlayer,137,252,389,12,41,GrudgePlayer
2011,GrudgePlayer,115,230,345,10,55,GrudgePlayer
2012,GrudgePlayer,128,248,376,11,45,GrudgePlayer
2013,GrudgePlayer,113,238,351,4,51,GrudgePlayer
2014,GrudgePlayer,126,261,387,13,42,GrudgePlayer
2015,GrudgePlayer,147,257,404,15,37,GrudgePlayer
2016,GrudgePlayer,142,272,414,16,34,GrudgePlayer
2017,GrudgePlayer,147,257,404,15,37,GrudgePlayer
2018,GrudgePlayer,134,269,403,11,36,GrudgePlayer
2019,GrudgePlayer,143,258,401,12,37,GrudgePlayer
2020,GrudgePlayer,160,285,445,17,24,GrudgePlayer
2021,GrudgePlayer,169,279,448,20,24,GrudgePlayer
2022,GrudgePlayer,122,252,374,6,44,GrudgePlayer
2023,GrudgePlayer,148,248,396,19,41,GrudgePlayer
2024,GrudgePlayer,134,249,383,15,44,GrudgePlayer
2025,GrudgePlayer,135,270,405,13,36,GrudgePlayer
2026,GrudgePlayer,138,253,391,8,39,GrudgePlayer
2027,GrudgePlayer,125,245,370,11,47,GrudgePlayer
2028,GrudgePlayer,129,264,393,7,38,GrudgePlayer
2029,GrudgePlayer,131,261,392,9,39,GrudgePlayer
2030,GrudgePlayer,146,281,427,14,29,GrudgePlayer
2031,GrudgePlayer,144,274,418,14,32,GrudgePlayer
2032,GrudgePlayer,140,260,400,11,37,GrudgePlayer
2033,GrudgePlayer,130,270,400,8,36,GrudgePlayer
2034,GrudgePlayer,123,263,386,9,41,GrudgePlayer
2035,GrudgePlayer,146,286,432,13,27,GrudgePlayer
2036,GrudgePlayer,126,261,387,10,41,GrudgePlayer
2037,GrudgePlayer,124,254,378,7,43,GrudgePlayer
2038,GrudgePlayer,119,254,373,5,44,GrudgePlayer
2039,GrudgePlayer,139,249,388,14,42,GrudgePlayer
2040,GrudgePlayer,142,267,409,14,35,GrudgePlayer
2041,GrudgePlayer,149,264,413,18,35,GrudgePlayer
2042,GrudgePlayer,139,269,408,13,35,GrudgePlayer
2043,GrudgePlayer,106,276,382,8,42,GrudgePlayer
2044,GrudgePlayer,143,253,396,16,40,GrudgePlayer
2045,GrudgePlayer,113,268,381,1,40,GrudgePlayer
2046,GrudgePlayer,139,254,393,10,39,GrudgePlayer
2047,GrudgePlayer,119,269,388,5,39,GrudgePlayer
2048,GrudgePlayer,157,262,419,15,32,GrudgePlayer
2049,GrudgePlayer,125,245,370,5,45,GrudgePlayer
2050,GrudgePlayer,135,275,410,9,33,GrudgePlayer
2051,GrudgePlayer,123,258,381,10,43,GrudgePlayer
2052,GrudgePlayer,126,256,382,8,42,GrudgePlayer
2053,GrudgePlayer,130,260,390,13,41,GrudgePlayer
2054,GrudgePlayer,113,238,351,7,52,GrudgePlayer
2055,GrudgePlayer,140,255,395,18,41,GrudgePlayer
2056,GrudgePlayer,138,278,416,9,31,GrudgePlayer
2057,GrudgePlayer,116,236,352,5,51,GrudgePlayer
2058,GrudgePlayer,122,257,379,14,45,GrudgePlayer
2059,GrudgePlayer,137,277,414,13,33,GrudgePlayer
2060,GrudgePlayer,148,283,431,18,29,GrudgePlayer
2061,GrudgePlayer,156,266,422,15,31,GrudgePlayer
2062,GrudgePlayer,125,260,385,8,41,GrudgePlayer
2063,GrudgePlayer,123,233,356,6,50,GrudgePlayer
2064,GrudgePlayer,143,278,421,11,30,GrudgePlayer
2065,GrudgePlayer,128,243,371,9,46,GrudgePlayer
2066,GrudgePlayer,149,274,423,16,31,GrudgePlayer
2067,GrudgePlayer,134,254,388,11,41,GrudgePlayer
2068,GrudgePlayer,153,268,421,14,31,GrudgePlayer
2069,GrudgePlayer,139,254,393,13,40,GrudgePlayer
2070,GrudgePlayer,146,271,417,19,34,GrudgePlayer
2071,GrudgePlayer,127,262,389,12,41,GrudgePlayer
2072,GrudgePlayer,161,266,427,20,31,GrudgePlayer
2073,GrudgePlayer,147,282,429,19,30,GrudgePlayer
2074,GrudgePlayer,157,282,439,20,27,GrudgePlayer
2075,GrudgePlayer,126,271,397,5,36,GrudgePlayer
2076,GrudgePlayer,128,253,381,10,43,GrudgePlayer
2077,GrudgePlayer,122,247,369,7,46,GrudgePlayer
2078,GrudgePlayer,122,262,384,10,42,GrudgePlayer
2079,GrudgePlayer,139,279,418,8,30,GrudgePlayer
2080,GrudgePlayer,121,236,357,7,50,GrudgePlayer
2081,GrudgePlayer,140,275,415,11,32,GrudgePlayer
2082,GrudgePlayer,117,262,379,8,43,GrudgePlayer
2083,GrudgePlayer,139,244,383,12,43,GrudgePlayer
2084,GrudgePlayer,136,271,407,9,34,GrudgePlayer
2085,GrudgePlayer,150,255,405,19,38,GrudgePlayer
2086,GrudgePlayer,137,262,399,13,38,GrudgePlayer
2087,GrudgePlayer,124,249,373,11,46,GrudgePlayer
2088,GrudgePlayer,134,254,388,8,40,GrudgePlayer
2089,GrudgePlayer,157,267,424,20,32,GrudgePlayer
2090,GrudgePlayer,134,264,398,12,38,GrudgePlayer
2091,GrudgePlayer,153,278,431,18,29,GrudgePlayer
2092,GrudgePlayer,135,255,390,16,42,GrudgePlayer
2093,GrudgePlayer,132,262,394,11,39,GrudgePlayer
2094,GrudgePlayer,137,272,409,11,34,GrudgePlayer
2095,GrudgePlayer,163,278,441,19,26,GrudgePlayer
2096,GrudgePlayer,163,273,436,20,28,GrudgePlayer
2097,GrudgePlayer,125,280,405,10,35,GrudgePlayer
2098,GrudgePlayer,144,264,408,16,36,GrudgePlayer
2099,GrudgePlayer,137,237,374,15,47,GrudgePlayer
2100,GrudgePlayer,141,271,412,11,33,GrudgePlayer
2101,GrudgePlayer,146,286,432,13,27,GrudgePlayer
2102,GrudgePlayer,138,253,391,14,41,GrudgePlayer
2103,GrudgePlayer,146,266,412,11,33,GrudgePlayer
2104,GrudgePlayer,130,260,390,10,40,GrudgePlayer
2105,GrudgePlayer,134,264,398,9,37,GrudgePlayer
2106,GrudgePlayer,138,273,411,10,33,GrudgePlayer
2107,GrudgePlayer,153,268,421,14,31,GrudgePlayer
2108,GrudgePlayer,131,266,397,8,37,GrudgePlayer
2109,GrudgePlayer,139,269,408,10,34,GrudgePlayer
2110,GrudgePlayer,161,271,432,22,30,GrudgePlayer
2111,GrudgePlayer,111,256,367,8,47,GrudgePlayer
2112,GrudgePlayer,151,281,432,25,31,GrudgePlayer
2113,GrudgePlayer,139,254,393,16,41,GrudgePlayer
2114,GrudgePlayer,135,270,405,13,36,GrudgePlayer
2115,GrudgePlayer,134,259,393,13,40,GrudgePlayer
2116,GrudgePlayer,142,272,414,13,33,GrudgePlayer
2117,GrudgePlayer,127,257,384,10,42,GrudgePlayer
2118,GrudgePlayer,122,262,384,7,41,GrudgePlayer
2119,GrudgePlayer,130,275,405,10,35,GrudgePlayer
2120,GrudgePlayer,136,241,377,12,45,GrudgePlayer
2121,GrudgePlayer,130,240,370,8,46,GrudgePlayer
2122,GrudgePlayer,172,277,449,27,26,GrudgePlayer
2123,GrudgePlayer,143,273,416,15,33,GrudgePlayer
2124,GrudgePlayer,160,270,430,20,30,GrudgePlayer
2125,GrudgePlayer,149,279,428,18,30,GrudgePlayer
2126,GrudgePlayer,136,251,387,13,42,GrudgePlayer
2127,GrudgePlayer,142,262,404,12,36,GrudgePlayer
2128,GrudgePlayer,124,264,388,5,39,GrudgePlayer
2129,GrudgePlayer,123,258,381,10,43,GrudgePlayer
2130,GrudgePlayer,137,287,424,11,29,GrudgePlayer
2131,GrudgePlayer,152,272,424,14,30,GrudgePlayer
2132,GrudgePlayer,138,273,411,10,33,GrudgePlayer
2133,GrudgePlayer,116,241,357,10,51,GrudgePlayer
2134,GrudgePlayer,145,260,405,16,37,GrudgePlayer
2135,GrudgePlayer,137,272,409,11,34,GrudgePlayer
2136,GrudgePlayer,140,275,415,11,32,GrudgePlayer
2137,GrudgePlayer,137,257,394,11,39,GrudgePlayer
2138,GrudgePlayer,129,254,383,12,43,GrudgePlayer
2139,GrudgePlayer,141,281,422,12,30,GrudgePlayer
2140,GrudgePlayer,113,253,366,7,47,GrudgePlayer
2141,GrudgePlayer,134,259,393,10,39,GrudgePlayer
2142,GrudgePlayer,155,265,420,19,33,GrudgePlayer
2143,GrudgePlayer,128,258,386,9,41,GrudgePlayer
2144,GrudgePlayer,127,257,384,7,41,GrudgePlayer
2145,GrudgePlayer,154,274,428,18,30,GrudgePlayer
2146,GrudgePlayer,128,233,361,11,50,GrudgePlayer
2147,GrudgePlayer,124,259,383,9,42,GrudgePlayer
2148,GrudgePlayer,150,270,420,13,31,GrudgePlayer
2149,GrudgePlayer,121,266,387,10,41,GrudgePlayer
2150,GrudgePlayer,113,243,356,6,50,GrudgePlayer
2151,GrudgePlayer,130,260,390,7,39,GrudgePlayer
2152,GrudgePlayer,141,266,407,9,34,GrudgePlayer
2153,GrudgePlayer,128,258,386,9,41,GrudgePlayer
2154,GrudgePlayer,131,236,367,11,48,GrudgePlayer
2155,GrudgePlayer,129,244,373,11,46,GrudgePlayer
2156,GrudgePlayer,127,247,374,9,45,GrudgePlayer
2157,GrudgePlayer,136,276,412,14,34,GrudgePlayer
2158,GrudgePlayer,136,276,412,11,33,GrudgePlayer
2159,GrudgePlayer,132,262,394,8,38,GrudgePlayer
2160,GrudgePlayer,125,270,395,12,39,GrudgePlayer
2161,GrudgePlayer,113,268,381,7,42,GrudgePlayer
2162,GrudgePlayer,144,264,408,13,35,GrudgePlayer
2163,GrudgePlayer,151,271,422,12,30,GrudgePlayer
2164,GrudgePlayer,128,253,381,13,44,GrudgePlayer
2165,GrudgePlayer,144,254,398,12,38,GrudgePlayer
2166,GrudgePlayer,122,252,374,9,45,GrudgePlayer
2167,GrudgePlayer,154,269,423,19,32,GrudgePlayer
2168,GrudgePlayer,142,257,399,13,38,GrudgePlayer
2169,GrudgePlayer,139,274,413,12,33,GrudgePlayer
2170,GrudgePlayer,127,247,374,6,44,GrudgePlayer
2171,GrudgePlayer,133,248,381,10,43,GrudgePlayer
2172,GrudgePlayer,143,273,416,15,33,GrudgePlayer
2173,GrudgePlayer,126,271,397,8,37,GrudgePlayer
2174,GrudgePlayer,95,250,345,4,53,GrudgePlayer
2175,GrudgePlayer,138,263,401,15,38,GrudgePlayer
2176,GrudgePlayer,140,270,410,15,35,GrudgePlayer
2177,GrudgePlayer,130,255,385,8,41,GrudgePlayer
2178,GrudgePlayer,126,271,397,11,38,GrudgePlayer
2179,GrudgePlayer,124,234,358,11,51,GrudgePlayer
2180,GrudgePlayer,119,249,368,6,46,GrudgePlayer
2181,GrudgePlayer,152,277,429,19,30,GrudgePlayer
2182,GrudgePlayer,123,228,351,7,52,GrudgePlayer
2183,GrudgePlayer,167,272,439,23,28,GrudgePlayer
2184,GrudgePlayer,127,257,384,7,41,GrudgePlayer
2185,GrudgePlayer,136,276,412,11,33,GrudgePlayer
2186,GrudgePlayer,153,278,431,18,29,GrudgePlayer
2187,GrudgePlayer,141,261,402,13,37,GrudgePlayer
2188,GrudgePlayer,135,250,385,14,43,GrudgePlayer
2189,GrudgePlayer,149,264,413,15,34,GrudgePlayer
2190,GrudgePlayer,145,260,405,19,38,GrudgePlayer
2191,GrudgePlayer,149,299,448,11,21,GrudgePlayer
2192,GrudgePlayer,132,247,379,8,43,GrudgePlayer
2193,GrudgePlayer,153,283,436,17,27,GrudgePlayer
2194,GrudgePlayer,142,282,424,14,30,GrudgePlayer
2195,GrudgePlayer,153,273,426,19,31,GrudgePlayer
2196,GrudgePlayer,144,269,413,15,34,GrudgePlayer
2197,GrudgePlayer,140,265,405,16,37,GrudgePlayer
2198,GrudgePlayer,135,275,410,12,34,GrudgePlayer
2199,GrudgePlayer,130,240,370,14,48,GrudgePlayer
2200,GrudgePlayer,144,244,388,20,44,GrudgePlayer
2201,GrudgePlayer,138,268,406,17,37,GrudgePlayer
2202,GrudgePlayer,192,292,484,29,15,GrudgePlayer
2203,GrudgePlayer,121,261,382,5,41,GrudgePlayer
2204,GrudgePlayer,154,259,413,18,35,GrudgePlayer
2205,GrudgePlayer,126,246,372,10,46,GrudgePlayer
2206,GrudgePlayer,128,258,386,9,41,GrudgePlayer
2207,GrudgePlayer,164,279,443,21,26,GrudgePlayer
2208,GrudgePlayer,142,267,409,14,35,GrudgePlayer
2209,GrudgePlayer,154,269,423,19,32,GrudgePlayer
2210,GrudgePlayer,156,261,417,19,34,GrudgePlayer
2211,GrudgePlayer,140,275,415,14,33,GrudgePlayer
2212,GrudgePlayer,123,268,391,8,39,GrudgePlayer
2213,GrudgePlayer,128,263,391,5,38,GrudgePlayer
2214,GrudgePlayer,121,266,387,7,40,GrudgePlayer
2215,GrudgePlayer,139,274,413,15,34,GrudgePlayer
2216,GrudgePlayer,136,256,392,15,41,GrudgePlayer
2217,GrudgePlayer,138,288,426,13,29,GrudgePlayer
2218,GrudgePlayer,142,287,429,13,28,GrudgePlayer
2219,GrudgePlayer,128,263,391,11,40,GrudgePlayer
2220,GrudgePlayer,144,274,418,17,33,GrudgePlayer
2221,GrudgePlayer,163,258,421,26,35,GrudgePlayer
2222,GrudgePlayer,144,249,393,10,39,GrudgePlayer
2223,GrudgePlayer,174,274,448,23,25,GrudgePlayer
2224,GrudgePlayer,128,268,396,10,38,GrudgePlayer
2225,GrudgePlayer,120,255,375,10,45,GrudgePlayer
2226,GrudgePlayer,131,256,387,10,41,GrudgePlayer
2227,GrudgePlayer,139,264,403,17,38,GrudgePlayer
2228,GrudgePlayer,126,226,352,8,52,GrudgePlayer
2229,GrudgePlayer,129,274,403,8,35,GrudgePlayer
2230,GrudgePlayer,141,266,407,12,35,GrudgePlayer
2231,GrudgePlayer,167,252,419,24,35,GrudgePlayer
2232,GrudgePlayer,149,269,418,20,34,GrudgePlayer
2233,GrudgePlayer,131,261,392,9,39,GrudgePlayer
2234,GrudgePlayer,146,256,402,13,37,GrudgePlayer
2235,GrudgePlayer,113,248,361,5,48,GrudgePlayer
2236,GrudgePlayer,139,264,403,14,37,GrudgePlayer
2237,GrudgePlayer,160,265,425,18,31,GrudgePlayer
2238,GrudgePlayer,127,282,409,8,33,GrudgePlayer
2239,GrudgePlayer,134,239,373,11,46,GrudgePlayer
2240,GrudgePlayer,131,251,382,14,44,GrudgePlayer
2241,GrudgePlayer,183,278,461,27,22,GrudgePlayer
2242,GrudgePlayer,128,243,371,6,45,GrudgePlayer
2243,GrudgePlayer,127,237,364,5,47,GrudgePlayer
2244,GrudgePlayer,123,273,396,7,37,GrudgePlayer
2245,GrudgePlayer,143,258,401,12,37,GrudgePlayer
2246,GrudgePlayer,142,277,419,18,33,GrudgePlayer
2247,GrudgePlayer,140,255,395,12,39,GrudgePlayer
2248,GrudgePlayer,133,258,391,11,40,GrudgePlayer
2249,GrudgePlayer,147,282,429,16,29,GrudgePlayer
2250,GrudgePlayer,128,263,391,11,40,GrudgePlayer
2251,GrudgePlayer,136,251,387,10,41,GrudgePlayer
2252,GrudgePlayer,110,250,360,4,48,GrudgePlayer
2253,GrudgePlayer,130,255,385,8,41,GrudgePlayer
2254,GrudgePlayer,139,274,413,12,33,GrudgePlayer
2255,GrudgePlayer,136,261,397,11,38,GrudgePlayer
2256,GrudgePlayer,156,281,437,15,26,GrudgePlayer
2257,GrudgePlayer,144,269,413,15,34,GrudgePlayer
2258,GrudgePlayer,134,259,393,10,39,GrudgePlayer
2259,GrudgePlayer,152,272,424,17,31,GrudgePlayer
2260,GrudgePlayer,132,267,399,10,37,GrudgePlayer
2261,GrudgePlayer,146,266,412,11,33,GrudgePlayer
2262,GrudgePlayer,150,265,415,14,33,GrudgePlayer
2263,GrudgePlayer,115,265,380,6,42,GrudgePlayer
2264,GrudgePlayer,145,255,400,14,38,GrudgePlayer
2265,GrudgePlayer,131,221,352,8,52,GrudgePlayer
2266,GrudgePlayer,146,251,397,14,39,GrudgePlayer
2267,GrudgePlayer,142,282,424,14,30,GrudgePlayer
2268,GrudgePlayer,134,269,403,8,35,GrudgePlayer
2269,GrudgePlayer,126,276,402,10,36,GrudgePlayer
2270,GrudgePlayer,144,264,408,16,36,GrudgePlayer
2271,GrudgePlayer,161,286,447,19,24,GrudgePlayer
2272,GrudgePlayer,126,271,397,8,37,GrudgePlayer
2273,GrudgePlayer,142,252,394,14,40,GrudgePlayer
2274,GrudgePlayer,121,261,382,5,41,GrudgePlayer
2275,GrudgePlayer,150,275,425,18,31,GrudgePlayer
2276,GrudgePlayer,170,295,465,25,20,GrudgePlayer
2277,GrudgePlayer,130,250,380,9,43,GrudgePlayer
2278,GrudgePlayer,143,278,421,11,30,GrudgePlayer
2279,GrudgePlayer,137,267,404,9,35,GrudgePlayer
2280,GrudgePlayer,138,258,396,13,39,GrudgePlayer
2281,GrudgePlayer,137,262,399,13,38,GrudgePlayer
2282,GrudgePlayer,128,253,381,13,44,GrudgePlayer
2283,GrudgePlayer,154,274,428,18,30,GrudgePlayer
2284,GrudgePlayer,121,271,392,9,39,GrudgePlayer
2285,GrudgePlayer,127,262,389,9,40,GrudgePlayer
2286,GrudgePlayer,129,269,398,6,36,GrudgePlayer
2287,GrudgePlayer,122,252,374,6,44,GrudgePlayer
2288,GrudgePlayer,142,267,409,14,35,GrudgePlayer
2289,GrudgePlayer,143,273,416,15,33,GrudgePlayer
2290,GrudgePlayer,149,244,393,16,41,GrudgePlayer
2291,GrudgePlayer,139,249,388,11,41,GrudgePlayer
2292,GrudgePlayer,126,261,387,7,40,GrudgePlayer
2293,GrudgePlayer,133,258,391,11,40,GrudgePlayer
2294,GrudgePlayer,144,264,408,13,35,GrudgePlayer
2295,GrudgePlayer,132,272,404,12,36,GrudgePlayer
2296,GrudgePlayer,146,266,412,17,35,GrudgePlayer
2297,GrudgePlayer,134,274,408,16,36,GrudgePlayer
2298,GrudgePlayer,134,259,393,10,39,GrudgePlayer
2299,GrudgePlayer,124,244,368,9,47,GrudgePlayer
2300,GrudgePlayer,127,272,399,10,37,GrudgePlayer
2301,GrudgePlayer,150,275,425,18,31,GrudgePlayer
2302,GrudgePlayer,164,254,418,23,35,GrudgePlayer
2303,GrudgePlayer,134,264,398,12,38,GrudgePlayer
2304,GrudgePlayer,125,245,370,11,47,GrudgePlayer
2305,GrudgePlayer,123,263,386,12,42,GrudgePlayer
2306,GrudgePlayer,127,257,384,7,41,GrudgePlayer
2307,GrudgePlayer,140,260,400,11,37,GrudgePlayer
2308,GrudgePlayer,134,269,403,8,35,GrudgePlayer
2309,GrudgePlayer,124,284,408,10,34,GrudgePlayer
2310,GrudgePlayer,143,273,416,18,34,GrudgePlayer
2311,GrudgePlayer,105,245,350,6,52,GrudgePlayer
2312,GrudgePlayer,138,258,396,13,39,GrudgePlayer
2313,GrudgePlayer,140,290,430,5,25,GrudgePlayer
2314,GrudgePlayer,137,282,419,9,30,GrudgePlayer
2315,GrudgePlayer,152,267,419,21,34,GrudgePlayer
2316,GrudgePlayer,138,268,406,8,34,GrudgePlayer
2317,GrudgePlayer,138,258,396,10,38,GrudgePlayer
2318,GrudgePlayer,123,248,371,9,46,GrudgePlayer
2319,GrudgePlayer,132,267,399,10,37,GrudgePlayer
2320,GrudgePlayer,142,262,404,15,37,GrudgePlayer
2321,GrudgePlayer,132,252,384,10,42,GrudgePlayer
2322,GrudgePlayer,147,287,434,15,27,GrudgePlayer
2323,GrudgePlayer,137,262,399,10,37,GrudgePlayer
2324,GrudgePlayer,162,262,424,20,32,GrudgePlayer
2325,GrudgePlayer,133,258,391,11,40,GrudgePlayer
2326,GrudgePlayer,139,254,393,13,40,GrudgePlayer
2327,GrudgePlayer,127,242,369,10,47,GrudgePlayer
2328,GrudgePlayer,128,253,381,7,42,GrudgePlayer
2329,GrudgePlayer,160,290,450,22,24,GrudgePlayer
2330,GrudgePlayer,148,273,421,14,31,GrudgePlayer
2331,GrudgePlayer,140,275,415,14,33,GrudgePlayer
2332,GrudgePlayer,141,271,412,14,34,GrudgePlayer
2333,GrudgePlayer,154,269,423,16,31,GrudgePlayer
2334,GrudgePlayer,128,253,381,10,43,GrudgePlayer
2335,GrudgePlayer,129,264,393,7,38,GrudgePlayer
2336,GrudgePlayer,157,277,434,21,29,GrudgePlayer
2337,GrudgePlayer,124,269,393,7,38,GrudgePlayer
2338,GrudgePlayer,116,251,367,8,47,GrudgePlayer
2339,GrudgePlayer,148,273,421,14,31,GrudgePlayer
2340,GrudgePlayer,116,256,372,7,45,GrudgePlayer
2341,GrudgePlayer,133,248,381,13,44,GrudgePlayer
2342,GrudgePlayer,141,256,397,17,40,GrudgePlayer
2343,GrudgePlayer,137,262,399,13,38,GrudgePlayer
2344,GrudgePlayer,116,261,377,6,43,GrudgePlayer
2345,GrudgePlayer,125,265,390,7,39,GrudgePlayer
2346,GrudgePlayer,140,260,400,11,37,GrudgePlayer
2347,GrudgePlayer,153,268,421,20,33,GrudgePlayer
2348,GrudgePlayer,153,278,431,21,30,GrudgePlayer
2349,GrudgePlayer,143,263,406,11,35,GrudgePlayer
2350,GrudgePlayer,130,260,390,10,40,GrudgePlayer
2351,GrudgePlayer,151,281,432,19,29,GrudgePlayer
2352,GrudgePlayer,144,274,418,17,33,GrudgePlayer
2353,GrudgePlayer,114,249,363,4,47,GrudgePlayer
2354,GrudgePlayer,110,260,370,5,45,GrudgePlayer
2355,GrudgePlayer,168,278,446,24,26,GrudgePlayer
2356,GrudgePlayer,114,254,368,6,46,GrudgePlayer
2357,GrudgePlayer,168,283,451,23,24,GrudgePlayer
2358,GrudgePlayer,120,245,365,6,47,GrudgePlayer
2359,GrudgePlayer,133,258,391,11,40,GrudgePlayer
2360,GrudgePlayer,117,277,394,5,37,GrudgePlayer
2361,GrudgePlayer,134,264,398,12,38,GrudgePlayer
2362,GrudgePlayer,139,264,403,14,37,GrudgePlayer
2363,GrudgePlayer,138,263,401,12,37,GrudgePlayer
2364,GrudgePlayer,135,245,380,9,43,GrudgePlayer
2365,GrudgePlayer,135,265,400,14,38,GrudgePlayer
2366,GrudgePlayer,130,250,380,9,43,GrudgePlayer
2367,GrudgePlayer,146,261,407,12,35,GrudgePlayer
2368,GrudgePlayer,152,272,424,20,32,GrudgePlayer
2369,GrudgePlayer,132,247,379,11,44,GrudgePlayer
2370,GrudgePlayer,144,264,408,13,35,GrudgePlayer
2371,GrudgePlayer,117,247,364,5,47,GrudgePlayer
2372,GrudgePlayer,125,255,380,9,43,GrudgePlayer
2373,GrudgePlayer,137,257,394,14,40,GrudgePlayer
2374,GrudgePlayer,142,257,399,16,39,GrudgePlayer
2375,GrudgePlayer,134,269,403,11,36,GrudgePlayer
2376,GrudgePlayer,148,268,416,15,33,GrudgePlayer
2377,GrudgePlayer,114,254,368,3,45,GrudgePlayer
2378,GrudgePlayer,126,256,382,8,42,GrudgePlayer
2379,GrudgePlayer,136,266,402,13,37,GrudgePlayer
2380,GrudgePlayer,135,275,410,9,33,GrudgePlayer
2381,GrudgePlayer,130,240,370,5,45,GrudgePlayer
2382,GrudgePlayer,122,252,374,9,45,GrudgePlayer
2383,GrudgePlayer,129,264,393,13,40,GrudgePlayer
2384,GrudgePlayer,145,270,415,14,33,GrudgePlayer
2385,GrudgePlayer,136,251,387,13,42,GrudgePlayer
2386,GrudgePlayer,129,269,398,6,36,GrudgePlayer
2387,GrudgePlayer,122,247,369,10,47,GrudgePlayer
2388,GrudgePlayer,138,278,416,12,32,GrudgePlayer
2389,GrudgePlayer,126,261,387,7,40,GrudgePlayer
2390,GrudgePlayer,154,264,418,17,33,GrudgePlayer
2391,GrudgePlayer,134,264,398,12,38,GrudgePlayer
2392,GrudgePlayer,138,268,406,14,36,GrudgePlayer
2393,GrudgePlayer,137,262,399,10,37,GrudgePlayer
2394,GrudgePlayer,151,266,417,16,33,GrudgePlayer
2395,GrudgePlayer,118,253,371,9,46,GrudgePlayer
2396,GrudgePlayer,155,255,410,15,35,GrudgePlayer
2397,GrudgePlayer,122,237,359,6,49,GrudgePlayer
2398,GrudgePlayer,134,264,398,15,39,GrudgePlayer
2399,GrudgePlayer,136,256,392,12,40,GrudgePlayer
2400,GrudgePlayer,134,264,398,15,39,GrudgePlayer
2401,GrudgePlayer,147,287,434,15,27,GrudgePlayer
2402,GrudgePlayer,151,266,417,19,34,GrudgePlayer
2403,GrudgePlayer,162,277,439,20,27,GrudgePlayer
2404,GrudgePlayer,148,263,411,16,35,GrudgePlayer
2405,GrudgePlayer,155,275,430,17,29,GrudgePlayer
2406,GrudgePlayer,125,250,375,10,45,GrudgePlayer
2407,GrudgePlayer,148,268,416,18,34,GrudgePlayer
2408,GrudgePlayer,145,255,400,17,39,GrudgePlayer
2409,GrudgePlayer,130,260,390,7,39,GrudgePlayer
2410,GrudgePlayer,125,245,370,8,46,GrudgePlayer
2411,GrudgePlayer,153,273,426,19,31,GrudgePlayer
2412,GrudgePlayer,148,258,406,14,36,GrudgePlayer
2413,GrudgePlayer,152,267,419,15,32,GrudgePlayer
2414,GrudgePlayer,142,247,389,12,41,GrudgePlayer
2415,GrudgePlayer,138,278,416,9,31,GrudgePlayer
2416,GrudgePlayer,133,248,381,10,43,GrudgePlayer
2417,GrudgePlayer,153,283,436,20,28,GrudgePlayer
2418,GrudgePlayer,124,249,373,5,44,GrudgePlayer
2419,GrudgePlayer,150,265,415,17,34,GrudgePlayer
2420,GrudgePlayer,141,266,407,9,34,GrudgePlayer
2421,GrudgePlayer,129,249,378,13,45,GrudgePlayer
2422,GrudgePlayer,126,256,382,8,42,GrudgePlayer
2423,GrudgePlayer,143,283,426,13,29,GrudgePlayer
2424,GrudgePlayer,146,276,422,18,32,GrudgePlayer
2425,GrudgePlayer,142,252,394,14,40,GrudgePlayer
2426,GrudgePlayer,116,251,367,8,47,GrudgePlayer
2427,GrudgePlayer,150,265,415,17,34,GrudgePlayer
2428,GrudgePlayer,119,254,373,5,44,GrudgePlayer
2429,GrudgePlayer,161,276,437,24,29,GrudgePlayer
2430,GrudgePlayer,118,253,371,6,45,GrudgePlayer
2431,GrudgePlayer,127,267,394,8,38,GrudgePlayer
2432,GrudgePlayer,116,271,387,7,40,GrudgePlayer
2433,GrudgePlayer,171,256,427,29,34,GrudgePlayer
2434,GrudgePlayer,123,243,366,7,47,GrudgePlayer
2435,GrudgePlayer,140,260,400,14,38,GrudgePlayer
2436,GrudgePlayer,126,256,382,5,41,GrudgePlayer
2437,GrudgePlayer,128,258,386,6,40,GrudgePlayer
2438,GrudgePlayer,136,251,387,10,41,GrudgePlayer
2439,GrudgePlayer,115,235,350,6,52,GrudgePlayer
2440,GrudgePlayer,122,247,369,7,46,GrudgePlayer
2441,GrudgePlayer,133,258,391,11,40,GrudgePlayer
2442,GrudgePlayer,119,244,363,7,48,GrudgePlayer
2443,GrudgePlayer,131,241,372,7,45,GrudgePlayer
2444,GrudgePlayer,144,254,398,15,39,GrudgePlayer
2445,GrudgePlayer,153,258,411,16,35,GrudgePlayer
2446,GrudgePlayer,138,263,401,15,38,GrudgePlayer
2447,GrudgePlayer,135,255,390,13,41,GrudgePlayer
2448,GrudgePlayer,115,250,365,6,47,GrudgePlayer
2449,GrudgePlayer,118,258,376,8,44,GrudgePlayer
2450,GrudgePlayer,153,278,431,15,28,GrudgePlayer
2451,GrudgePlayer,148,258,406,14,36,GrudgePlayer
2452,GrudgePlayer,147,262,409,17,36,GrudgePlayer
2453,GrudgePlayer,136,261,397,14,39,GrudgePlayer
2454,GrudgePlayer,128,283,411,7,32,GrudgePlayer
2455,GrudgePlayer,154,264,418,14,32,GrudgePlayer
2456,GrudgePlayer,169,274,443,21,26,GrudgePlayer
2457,GrudgePlayer,162,277,439,20,27,GrudgePlayer
2458,GrudgePlayer,153,273,426,19,31,GrudgePlayer
2459,GrudgePlayer,156,266,422,21,33,GrudgePlayer
2460,GrudgePlayer,132,247,379,14,45,GrudgePlayer
2461,GrudgePlayer,156,261,417,16,33,GrudgePlayer
2462,GrudgePlayer,168,283,451,26,25,GrudgePlayer
2463,GrudgePlayer,124,264,388,8,40,GrudgePlayer
2464,GrudgePlayer,140,255,395,12,39,GrudgePlayer
2465,GrudgePlayer,147,267,414,13,33,GrudgePlayer
2466,GrudgePlayer,154,269,423,19,32,GrudgePlayer
2467,GrudgePlayer,145,270,415,11,32,GrudgePlayer
2468,GrudgePlayer,130,260,390,13,41,GrudgePlayer
2469,GrudgePlayer,143,253,396,13,39,GrudgePlayer
2470,GrudgePlayer,141,256,397,14,39,GrudgePlayer
2471,GrudgePlayer,149,254,403,23,40,GrudgePlayer
2472,GrudgePlayer,126,251,377,9,44,GrudgePlayer
2473,GrudgePlayer,160,270,430,20,30,GrudgePlayer
2474,GrudgePlayer,127,232,359,9,50,GrudgePlayer
2475,GrudgePlayer,135,230,365,9,48,GrudgePlayer
2476,GrudgePlayer,157,272,429,16,29,GrudgePlayer
2477,GrudgePlayer,114,254,368,6,46,GrudgePlayer
2478,GrudgePlayer,150,270,420,16,32,GrudgePlayer
2479,GrudgePlayer,134,264,398,12,38,GrudgePlayer
2480,GrudgePlayer,128,263,391,5,38,GrudgePlayer
2481,GrudgePlayer,144,254,398,15,39,GrudgePlayer
2482,GrudgePlayer,144,274,418,14,32,GrudgePlayer
2483,GrudgePlayer,148,263,411,16,35,GrudgePlayer
2484,GrudgePlayer,131,261,392,12,40,GrudgePlayer
2485,GrudgePlayer,131,271,402,13,37,GrudgePlayer
2486,GrudgePlayer,145,290,435,10,25,GrudgePlayer
2487,GrudgePlayer,136,266,402,13,37,GrudgePlayer
2488,GrudgePlayer,144,274,418,17,33,GrudgePlayer
2489,GrudgePlayer,148,263,411,19,36,GrudgePlayer
2490,GrudgePlayer,140,270,410,15,35,GrudgePlayer
2491,GrudgePlayer,125,270,395,6,37,GrudgePlayer
2492,GrudgePlayer,136,266,402,13,37,GrudgePlayer
2493,GrudgePlayer,133,278,411,10,33,GrudgePlayer
2494,GrudgePlayer,142,257,399,16,39,GrudgePlayer
2495,GrudgePlayer,145,255,400,17,39,GrudgePlayer
2496,GrudgePlayer,129,264,393,7,38,GrudgePlayer
2497,GrudgePlayer,141,271,412,11,33,GrudgePlayer
2498,GrudgePlayer,118,258,376,5,43,GrudgePlayer
2499,GrudgePlayer,155,250,405,22,39,GrudgePlayer
2500,GrudgePlayer,118,248,366,7,47,GrudgePlayer
2501,GrudgePlayer,137,267,404,12,36,GrudgePlayer
2502,GrudgePlayer,141,266,407,12,35,GrudgePlayer
2503,GrudgePlayer,135,255,390,16,42,GrudgePlayer
2504,GrudgePlayer,121,246,367,5,46,GrudgePlayer
2505,GrudgePlayer,148,273,421,17,32,GrudgePlayer
2506,GrudgePlayer,133,268,401,9,36,GrudgePlayer
2507,GrudgePlayer,128,268,396,10,38,GrudgePlayer
2508,GrudgePlayer,122,257,379,5,42,GrudgePlayer
2509,GrudgePlayer,130,260,390,4,38,GrudgePlayer
2510,GrudgePlayer,155,270,425,18,31,GrudgePlayer
2511,GrudgePlayer,134,264,398,12,38,GrudgePlayer
2512,GrudgePlayer,139,264,403,17,38,GrudgePlayer
2513,GrudgePlayer,123,238,361,8,49,GrudgePlayer
2514,GrudgePlayer,121,261,382,8,42,GrudgePlayer
2515,GrudgePlayer,128,248,376,11,45,GrudgePlayer
2516,GrudgePlayer,132,272,404,6,34,GrudgePlayer
2517,GrudgePlayer,125,270,395,9,38,GrudgePlayer
2518,GrudgePlayer,144,269,413,18,35,GrudgePlayer
2519,GrudgePlayer,145,270,415,14,33,GrudgePlayer
2520,GrudgePlayer,131,271,402,16,38,GrudgePlayer
2521,GrudgePlayer,143,248,391,14,41,GrudgePlayer
2522,GrudgePlayer,143,278,421,14,31,GrudgePlayer
2523,GrudgePlayer,143,268,411,16,35,GrudgePlayer
2524,GrudgePlayer,148,268,416,15,33,GrudgePlayer
2525,GrudgePlayer,125,235,360,7,49,GrudgePlayer
2526,GrudgePlayer,128,253,381,10,43,GrudgePlayer
2527,GrudgePlayer,132,242,374,9,45,GrudgePlayer
2528,GrudgePlayer,137,272,409,8,33,GrudgePlayer
2529,GrudgePlayer,135,275,410,12,34,GrudgePlayer
2530,GrudgePlayer,123,253,376,8,44,GrudgePlayer
2531,GrudgePlayer,137,262,399,16,39,GrudgePlayer
2532,GrudgePlayer,134,269,403,14,37,GrudgePlayer
2533,GrudgePlayer,133,253,386,12,42,GrudgePlayer
2534,GrudgePlayer,105,245,350,3,51,GrudgePlayer
2535,GrudgePlayer,133,258,391,11,40,GrudgePlayer
2536,GrudgePlayer,141,271,412,14,34,GrudgePlayer
2537,GrudgePlayer,127,242,369,7,46,GrudgePlayer
2538,GrudgePlayer,133,268,401,9,36,GrudgePlayer
2539,GrudgePlayer,135,275,410,18,36,GrudgePlayer
2540,GrudgePlayer,111,246,357,7,50,GrudgePlayer
2541,GrudgePlayer,143,258,401,12,37,GrudgePlayer
2542,GrudgePlayer,133,268,401,6,35,GrudgePlayer
2543,GrudgePlayer,123,243,366,7,47,GrudgePlayer
2544,GrudgePlayer,137,252,389,12,41,GrudgePlayer
2545,GrudgePlayer,149,259,408,13,35,GrudgePlayer
2546,GrudgePlayer,151,271,422,15,31,GrudgePlayer
2547,GrudgePlayer,141,261,402,13,37,GrudgePlayer
2548,GrudgePlayer,146,276,422,15,31,GrudgePlayer
2549,GrudgePlayer,145,250,395,18,41,GrudgePlayer
2550,GrudgePlayer,143,258,401,12,37,GrudgePlayer
2551,GrudgePlayer,141,256,397,17,40,GrudgePlayer
2552,GrudgePlayer,116,241,357,4,49,GrudgePlayer
2553,GrudgePlayer,135,275,410,9,33,GrudgePlayer
2554,GrudgePlayer,136,261,397,8,37,GrudgePlayer
2555,GrudgePlayer,130,255,385,8,41,GrudgePlayer
2556,GrudgePlayer,150,270,420,13,31,GrudgePlayer
2557,GrudgePlayer,139,259,398,15,39,GrudgePlayer
2558,GrudgePlayer,149,259,408,16,36,GrudgePlayer
2559,GrudgePlayer,153,273,426,19,31,GrudgePlayer
2560,GrudgePlayer,142,272,414,13,33,GrudgePlayer
2561,GrudgePlayer,143,243,386,12,42,GrudgePlayer
2562,GrudgePlayer,139,259,398,12,38,GrudgePlayer
2563,GrudgePlayer,153,268,421,17,32,GrudgePlayer
2564,GrudgePlayer,119,249,368,6,46,GrudgePlayer
2565,GrudgePlayer,140,265,405,13,36,GrudgePlayer
2566,GrudgePlayer,159,274,433,14,27,GrudgePlayer
2567,GrudgePlayer,128,238,366,10,48,GrudgePlayer
2568,GrudgePlayer,149,284,433,14,27,GrudgePlayer
2569,GrudgePlayer,125,250,375,7,44,GrudgePlayer
2570,GrudgePlayer,135,255,390,10,40,GrudgePlayer
2571,GrudgePlayer,122,247,369,10,47,GrudgePlayer
2572,GrudgePlayer,126,251,377,12,45,GrudgePlayer
2573,GrudgePlayer,160,275,435,16,27,GrudgePlayer
2574,GrudgePlayer,119,249,368,9,47,GrudgePlayer
2575,GrudgePlayer,143,253,396,13,39,GrudgePlayer
2576,GrudgePlayer,136,256,392,9,39,GrudgePlayer
2577,GrudgePlayer,156,286,442,14,24,GrudgePlayer
2578,GrudgePlayer,124,269,393,7,38,GrudgePlayer
2579,GrudgePlayer,154,264,418,17,33,GrudgePlayer
2580,GrudgePlayer,132,272,404,12,36,GrudgePlayer
2581,GrudgePlayer,166,281,447,22,25,GrudgePlayer
2582,GrudgePlayer,143,248,391,17,42,GrudgePlayer
2583,GrudgePlayer,126,246,372,10,46,GrudgePlayer
2584,GrudgePlayer,125,255,380,9,43,GrudgePlayer
2585,GrudgePlayer,158,283,441,16,25,GrudgePlayer
2586,GrudgePlayer,148,263,411,16,35,GrudgePlayer
2587,GrudgePlayer,125,260,385,8,41,GrudgePlayer
2588,GrudgePlayer,126,241,367,11,48,GrudgePlayer
2589,GrudgePlayer,141,256,397,14,39,GrudgePlayer
2590,GrudgePlayer,135,240,375,13,46,GrudgePlayer
2591,GrudgePlayer,122,277,399,10,37,GrudgePlayer
2592,GrudgePlayer,156,261,417,19,34,GrudgePlayer
2593,GrudgePlayer,113,253,366,4,46,GrudgePlayer
2594,GrudgePlayer,123,278,401,6,35,GrudgePlayer
2595,GrudgePlayer,126,246,372,4,44,GrudgePlayer
2596,GrudgePlayer,118,263,381,7,42,GrudgePlayer
2597,GrudgePlayer,125,245,370,8,46,GrudgePlayer
2598,GrudgePlayer,123,253,376,8,44,GrudgePlayer
2599,GrudgePlayer,129,254,383,9,42,GrudgePlayer
2600,GrudgePlayer,105,255,360,4,48,GrudgePlayer
2601,GrudgePlayer,132,277,409,5,32,GrudgePlayer
2602,GrudgePlayer,138,258,396,16,40,GrudgePlayer
2603,GrudgePlayer,134,254,388,14,42,GrudgePlayer
2604,GrudgePlayer,117,227,344,6,54,GrudgePlayer
2605,GrudgePlayer,167,277,444,25,27,GrudgePlayer
2606,GrudgePlayer,112,247,359,6,49,GrudgePlayer
2607,GrudgePlayer,137,267,404,15,37,GrudgePlayer
2608,GrudgePlayer,155,270,425,18,31,GrudgePlayer
2609,GrudgePlayer,127,267,394,11,39,GrudgePlayer
2610,GrudgePlayer,184,289,473,30,19,GrudgePlayer
2611,GrudgePlayer,130,265,395,12,39,GrudgePlayer
2612,GrudgePlayer,157,287,444,19,25,GrudgePlayer
2613,GrudgePlayer,138,238,376,11,45,GrudgePlayer
2614,GrudgePlayer,129,249,378,7,43,GrudgePlayer
2615,GrudgePlayer,144,259,403,14,37,GrudgePlayer
2616,GrudgePlayer,127,262,389,12,41,GrudgePlayer
2617,GrudgePlayer,120,250,370,11,47,GrudgePlayer
2618,GrudgePlayer,131,261,392,9,39,GrudgePlayer
2619,GrudgePlayer,138,263,401,12,37,GrudgePlayer
2620,GrudgePlayer,111,251,362,6,48,GrudgePlayer
2621,GrudgePlayer,137,262,399,10,37,GrudgePlayer
2622,GrudgePlayer,131,246,377,9,44,GrudgePlayer
2623,GrudgePlayer,138,253,391,17,42,GrudgePlayer
2624,GrudgePlayer,155,265,420,13,31,GrudgePlayer
2625,GrudgePlayer,127,262,389,6,39,GrudgePlayer
2626,GrudgePlayer,158,288,446,18,24,GrudgePlayer
2627,GrudgePlayer,103,258,361,5,48,GrudgePlayer
2628,GrudgePlayer,164,274,438,22,28,GrudgePlayer
2629,GrudgePlayer,144,249,393,16,41,GrudgePlayer
2630,GrudgePlayer,125,260,385,11,42,GrudgePlayer
2631,GrudgePlayer,138,278,416,9,31,GrudgePlayer
2632,GrudgePlayer,141,261,402,16,38,GrudgePlayer
2633,GrudgePlayer,148,268,416,12,32,GrudgePlayer
2634,GrudgePlayer,125,235,360,7,49,GrudgePlayer
2635,GrudgePlayer,144,264,408,13,35,GrudgePlayer
2636,GrudgePlayer,126,261,387,10,41,GrudgePlayer
2637,GrudgePlayer,136,236,372,13,47,GrudgePlayer
2638,GrudgePlayer,136,266,402,16,38,GrudgePlayer
2639,GrudgePlayer,140,265,405,13,36,GrudgePlayer
2640,GrudgePlayer,138,248,386,15,43,GrudgePlayer
2641,GrudgePlayer,136,276,412,8,32,GrudgePlayer
2642,GrudgePlayer,120,275,395,9,38,GrudgePlayer
2643,GrudgePlayer,159,269,428,18,30,GrudgePlayer
2644,GrudgePlayer,151,271,422,12,30,GrudgePlayer
2645,GrudgePlayer,127,232,359,12,51,GrudgePlayer
2646,GrudgePlayer,139,269,408,13,35,GrudgePlayer
2647,GrudgePlayer,152,262,414,13,33,GrudgePlayer
2648,GrudgePlayer,152,287,439,20,27,GrudgePlayer
2649,GrudgePlayer,154,269,423,16,31,GrudgePlayer
2650,GrudgePlayer,131,271,402,13,37,GrudgePlayer
2651,GrudgePlayer,125,245,370,11,47,GrudgePlayer
2652,GrudgePlayer,147,262,409,14,35,GrudgePlayer
2653,GrudgePlayer,148,273,421,14,31,GrudgePlayer
2654,GrudgePlayer,144,249,393,16,41,GrudgePlayer
2655,GrudgePlayer,146,256,402,13,37,GrudgePlayer
2656,GrudgePlayer,125,270,395,12,39,GrudgePlayer
2657,GrudgePlayer,120,240,360,7,49,GrudgePlayer
2658,GrudgePlayer,131,261,392,12,40,GrudgePlayer
2659,GrudgePlayer,137,277,414,7,31,GrudgePlayer
2660,GrudgePlayer,172,267,439,26,29,GrudgePlayer
2661,GrudgePlayer,116,216,332,3,57,GrudgePlayer
2662,GrudgePlayer,127,257,384,13,43,GrudgePlayer
2663,GrudgePlayer,136,251,387,13,42,GrudgePlayer
2664,GrudgePlayer,141,256,397,11,38,GrudgePlayer
2665,GrudgePlayer,146,251,397,14,39,GrudgePlayer
2666,GrudgePlayer,122,247,369,10,47,GrudgePlayer
2667,GrudgePlayer,120,265,385,8,41,GrudgePlayer
2668,GrudgePlayer,141,266,407,12,35,GrudgePlayer
2669,GrudgePlayer,130,265,395,9,38,GrudgePlayer
2670,GrudgePlayer,127,267,394,8,38,GrudgePlayer
2671,GrudgePlayer,141,261,402,13,37,GrudgePlayer
2672,GrudgePlayer,132,252,384,10,42,GrudgePlayer
2673,GrudgePlayer,139,249,388,14,42,GrudgePlayer
2674,GrudgePlayer,136,266,402,16,38,GrudgePlayer
2675,GrudgePlayer,151,276,427,17,30,GrudgePlayer
2676,GrudgePlayer,134,254,388,11,41,GrudgePlayer
2677,GrudgePlayer,140,270,410,9,33,GrudgePlayer
2678,GrudgePlayer,128,253,381,10,43,GrudgePlayer
2679,GrudgePlayer,138,263,401,12,37,GrudgePlayer
2680,GrudgePlayer,130,270,400,11,37,GrudgePlayer
2681,GrudgePlayer,113,253,366,7,47,GrudgePlayer
2682,GrudgePlayer,144,259,403,14,37,GrudgePlayer
2683,GrudgePlayer,125,260,385,5,40,GrudgePlayer
2684,GrudgePlayer,131,231,362,12,50,GrudgePlayer
2685,GrudgePlayer,162,262,424,20,32,GrudgePlayer
2686,GrudgePlayer,135,255,390,13,41,GrudgePlayer
2687,GrudgePlayer,185,285,470,27,19,GrudgePlayer
2688,GrudgePlayer,143,263,406,8,34,GrudgePlayer
2689,GrudgePlayer,123,253,376,5,43,GrudgePlayer
2690,GrudgePlayer,135,260,395,12,39,GrudgePlayer
2691,GrudgePlayer,142,252,394,14,40,GrudgePlayer
2692,GrudgePlayer,144,269,413,12,33,GrudgePlayer
2693,GrudgePlayer,123,248,371,9,46,GrudgePlayer
2694,GrudgePlayer,128,248,376,11,45,GrudgePlayer
2695,GrudgePlayer,130,250,380,9,43,GrudgePlayer
2696,GrudgePlayer,126,246,372,7,45,GrudgePlayer
2697,GrudgePlayer,134,244,378,13,45,GrudgePlayer
2698,GrudgePlayer,136,266,402,13,37,GrudgePlayer
2699,GrudgePlayer,140,255,395,15,40,GrudgePlayer
2700,GrudgePlayer,150,270,420,13,31,GrudgePlayer
2701,GrudgePlayer,140,270,410,15,35,GrudgePlayer
2702,GrudgePlayer,166,276,442,23,27,GrudgePlayer
2703,GrudgePlayer,114,249,363,4,47,GrudgePlayer
2704,GrudgePlayer,142,252,394,14,40,GrudgePlayer
2705,GrudgePlayer,109,244,353,6,51,GrudgePlayer
2706,GrudgePlayer,147,267,414,13,33,GrudgePlayer
2707,GrudgePlayer,150,280,430,17,29,GrudgePlayer
2708,GrudgePlayer,152,277,429,13,28,GrudgePlayer
2709,GrudgePlayer,123,243,366,10,48,GrudgePlayer
2710,GrudgePlayer,154,269,423,16,31,GrudgePlayer
2711,GrudgePlayer,133,268,401,6,35,GrudgePlayer
2712,GrudgePlayer,144,274,418,14,32,GrudgePlayer
2713,GrudgePlayer,132,267,399,10,37,GrudgePlayer
2714,GrudgePlayer,152,262,414,16,34,GrudgePlayer
2715,GrudgePlayer,126,241,367,8,47,GrudgePlayer
2716,GrudgePlayer,126,251,377,9,44,GrudgePlayer
2717,GrudgePlayer,139,234,373,11,46,GrudgePlayer
2718,GrudgePlayer,139,269,408,10,34,GrudgePlayer
2719,GrudgePlayer,142,282,424,11,29,GrudgePlayer
2720,GrudgePlayer,142,257,399,19,40,GrudgePlayer
2721,GrudgePlayer,125,250,375,10,45,GrudgePlayer
2722,GrudgePlayer,135,275,410,12,34,GrudgePlayer
2723,GrudgePlayer,143,238,381,13,44,GrudgePlayer
2724,GrudgePlayer,155,275,430,20,30,GrudgePlayer
2725,GrudgePlayer,157,257,414,19,35,GrudgePlayer
2726,GrudgePlayer,146,266,412,14,34,GrudgePlayer
2727,GrudgePlayer,129,274,403,8,35,GrudgePlayer
2728,GrudgePlayer,164,274,438,22,28,GrudgePlayer
2729,GrudgePlayer,127,262,389,9,40,GrudgePlayer
2730,GrudgePlayer,154,269,423,19,32,GrudgePlayer
2731,GrudgePlayer,137,252,389,12,41,GrudgePlayer
2732,GrudgePlayer,118,258,376,11,45,GrudgePlayer
2733,GrudgePlayer,166,256,422,27,35,GrudgePlayer
2734,GrudgePlayer,119,259,378,7,43,GrudgePlayer
2735,GrudgePlayer,135,255,390,10,40,GrudgePlayer
2736,GrudgePlayer,123,258,381,7,42,GrudgePlayer
2737,GrudgePlayer,157,277,434,18,28,GrudgePlayer
2738,GrudgePlayer,135,255,390,10,40,GrudgePlayer
2739,GrudgePlayer,103,248,351,4,51,GrudgePlayer
2740,GrudgePlayer,146,256,402,13,37,GrudgePlayer
2741,GrudgePlayer,149,279,428,12,28,GrudgePlayer
2742,GrudgePlayer,136,261,397,14,39,GrudgePlayer
2743,GrudgePlayer,151,271,422,18,32,GrudgePlayer
2744,GrudgePlayer,138,243,381,13,44,GrudgePlayer
2745,GrudgePlayer,138,248,386,12,42,GrudgePlayer
2746,GrudgePlayer,131,231,362,12,50,GrudgePlayer
2747,GrudgePlayer,134,264,398,9,37,GrudgePlayer
2748,GrudgePlayer,122,262,384,7,41,GrudgePlayer
2749,GrudgePlayer,145,265,410,18,36,GrudgePlayer
2750,GrudgePlayer,154,259,413,15,34,GrudgePlayer
2751,GrudgePlayer,129,244,373,8,45,GrudgePlayer
2752,GrudgePlayer,126,236,362,12,50,GrudgePlayer
2753,GrudgePlayer,143,263,406,17,37,GrudgePlayer
2754,GrudgePlayer,136,266,402,7,35,GrudgePlayer
2755,GrudgePlayer,120,245,365,6,47,GrudgePlayer
2756,GrudgePlayer,136,256,392,12,40,GrudgePlayer
2757,GrudgePlayer,102,252,354,4,50,GrudgePlayer
2758,GrudgePlayer,164,289,453,19,22,GrudgePlayer
2759,GrudgePlayer,142,262,404,18,38,GrudgePlayer
2760,GrudgePlayer,135,275,410,12,34,GrudgePlayer
2761,GrudgePlayer,136,271,407,15,36,GrudgePlayer
2762,GrudgePlayer,125,265,390,10,40,GrudgePlayer
2763,GrudgePlayer,140,270,410,15,35,GrudgePlayer
2764,GrudgePlayer,128,248,376,11,45,GrudgePlayer
2765,GrudgePlayer,131,266,397,8,37,GrudgePlayer
2766,GrudgePlayer,134,259,393,13,40,GrudgePlayer
2767,GrudgePlayer,153,278,431,24,31,GrudgePlayer
2768,GrudgePlayer,115,260,375,4,43,GrudgePlayer
2769,GrudgePlayer,135,245,380,12,44,GrudgePlayer
2770,GrudgePlayer,160,290,450,25,25,GrudgePlayer
2771,GrudgePlayer,141,271,412,14,34,GrudgePlayer
2772,GrudgePlayer,145,250,395,12,39,GrudgePlayer
2773,GrudgePlayer,150,260,410,15,35,GrudgePlayer
2774,GrudgePlayer,142,272,414,13,33,GrudgePlayer
2775,GrudgePlayer,143,273,416,15,33,GrudgePlayer
2776,GrudgePlayer,124,254,378,7,43,GrudgePlayer
2777,GrudgePlayer,135,250,385,8,41,GrudgePlayer
2778,GrudgePlayer,138,238,376,14,46,GrudgePlayer
2779,GrudgePlayer,123,248,371,9,46,GrudgePlayer
2780,GrudgePlayer,147,262,409,14,35,GrudgePlayer
2781,GrudgePlayer,141,266,407,15,36,GrudgePlayer
2782,GrudgePlayer,121,261,382,8,42,GrudgePlayer
2783,GrudgePlayer,141,261,402,13,37,GrudgePlayer
2784,GrudgePlayer,125,245,370,8,46,GrudgePlayer
2785,GrudgePlayer,151,271,422,18,32,GrudgePlayer
2786,GrudgePlayer,130,260,390,10,40,GrudgePlayer
2787,GrudgePlayer,138,278,416,15,33,GrudgePlayer
2788,GrudgePlayer,165,280,445,23,26,GrudgePlayer
2789,GrudgePlayer,134,259,393,10,39,GrudgePlayer
2790,GrudgePlayer,139,274,413,15,34,GrudgePlayer
2791,GrudgePlayer,139,269,408,16,36,GrudgePlayer
2792,GrudgePlayer,142,242,384,16,44,GrudgePlayer
2793,GrudgePlayer,126,256,382,8,42,GrudgePlayer
2794,GrudgePlayer,126,281,407,9,34,GrudgePlayer
2795,GrudgePlayer,134,244,378,7,43,GrudgePlayer
0,Gullible,402,147,549,49,0,Player A
1,Gullible,414,129,543,43,0,Player A
2,Gullible,400,150,550,50,0,Player A
3,Gullible,418,123,541,41,0,Player A
4,Gullible,396,156,552,52,0,Player A
5,Gullible,380,180,560,60,0,Player A
6,Gullible,386,171,557,57,0,Player A
7,Gullible,396,156,552,52,0,Player A
8,Gullible,392,162,554,54,0,Player A
9,Gullible,386,171,557,57,0,Player A
10,Gullible,398,153,551,51,0,Player A
11,Gullible,406,141,547,47,0,Player A
12,Gullible,382,177,559,59,0,Player A
13,Gullible,414,129,543,43,0,Player A
14,Gullible,390,165,555,55,0,Player A
15,Gullible,416,126,542,42,0,Player A
16,Gullible,404,144,548,48,0,Player A
17,Gullible,404,144,548,48,0,Player A
18,Gullible,388,168,556,56,0,Player A
19,Gullible,390,165,555,55,0,Player A
20,Gullible,392,162,554,54,0,Player A
21,Gullible,402,147,549,49,0,Player A
22,Gullible,398,153,551,51,0,Player A
23,Gullible,404,144,548,48,0,Player A
24,Gullible,410,135,545,45,0,Player A
25,Gullible,390,165,555,55,0,Player A
26,Gullible,392,162,554,54,0,Player A
27,Gullible,400,150,550,50,0,Player A
28,Gullible,382,177,559,59,0,Player A
29,Gullible,374,189,563,63,0,Player A
30,Gullible,412,132,544,44,0,Player A
31,Gullible,408,138,546,46,0,Player A
32,Gullible,406,141,547,47,0,Player A
33,Gullible,398,153,551,51,0,Player A
34,Gullible,402,147,549,49,0,Player A
35,Gullible,412,132,544,44,0,Player A
36,Gullible,408,138,546,46,0,Player A
37,Gullible,394,159,553,53,0,Player A
38,Gullible,408,138,546,46,0,Player A
39,Gullible,396,156,552,52,0,Player A
40,Gullible,394,159,553,53,0,Player A
41,Gullible,400,150,550,50,0,Player A
42,Gullible,408,138,546,46,0,Player A
43,Gullible,416,126,542,42,0,Player A
44,Gullible,412,132,544,44,0,Player A
45,Gullible,394,159,553,53,0,Player A
46,Gullible,390,165,555,55,0,Player A
47,Gullible,396,156,552,52,0,Player A
48,Gullible,398,153,551,51,0,Player A
49,Gullible,394,159,553,53,0,Player A
50,Gullible,392,162,554,54,0,Player A
51,Gullible,410,135,545,45,0,Player A
52,Gullible,394,159,553,53,0,Player A
53,Gullible,410,135,545,45,0,Player A
54,Gullible,386,171,557,57,0,Player A
55,Gullible,392,162,554,54,0,Player A
56,Gullible,404,144,548,48,0,Player A
57,Gullible,422,117,539,39,0,Player A
58,Gullible,394,159,553,53,0,Player A
59,Gullible,408,138,546,46,0,Player A
60,Gullible,394,159,553,53,0,Player A
61,Gullible,390,165,555,55,0,Player A
62,Gullible,394,159,553,53,0,Player A
63,Gullible,416,126,542,42,0,Player A
64,Gullible,400,150,550,50,0,Player A
65,Gullible,394,159,553,53,0,Player A
66,Gullible,406,141,547,47,0,Player A
67,Gullible,420,120,540,40,0,Player A
68,Gullible,420,120,540,40,0,Player A
69,Gullible,402,147,549,49,0,Player A
70,Gullible,396,156,552,52,0,Player A
71,Gullible,390,165,555,55,0,Player A
72,Gullible,402,147,549,49,0,Player A
73,Gullible,398,153,551,51,0,Player A
74,Gullible,410,135,545,45,0,Player A
75,Gullible,400,150,550,50,0,Player A
76,Gullible,374,189,563,63,0,Player A
77,Gullible,406,141,547,47,0,Player A
78,Gullible,388,168,556,56,0,Player A
79,Gullible,390,165,555,55,0,Player A
80,Gullible,414,129,543,43,0,Player A
81,Gullible,394,159,553,53,0,Player A
82,Gullible,408,138,546,46,0,Player A
83,Gullible,394,159,553,53,0,Player A
84,Gullible,394,159,553,53,0,Player A
85,Gullible,398,153,551,51,0,Player A
86,Gullible,414,129,543,43,0,Player A
87,Gullible,408,138,546,46,0,Player A
88,Gullible,400,150,550,50,0,Player A
89,Gullible,404,144,548,48,0,Player A
90,Gullible,380,180,560,60,0,Player A
91,Gullible,388,168,556,56,0,Player A
92,Gullible,402,147,549,49,0,Player A
93,Gullible,400,150,550,50,0,Player A
94,Gullible,386,171,557,57,0,Player A
95,Gullible,398,153,551,51,0,Player A
96,Gullible,398,153,551,51,0,Player A
97,Gullible,392,162,554,54,0,Player A
98,Gullible,400,150,550,50,0,Player A
99,Gullible,398,153,551,51,0,Player A
100,Gullible,412,132,544,44,0,Player A
101,Gullible,382,177,559,59,0,Player A
102,Gullible,418,123,541,41,0,Player A
103,Gullible,404,144,548,48,0,Player A
104,Gullible,402,147,549,49,0,Player A
105,Gullible,408,138,546,46,0,Player A
106,Gullible,408,138,546,46,0,Player A
107,Gullible,388,168,556,56,0,Player A
108,Gullible,388,168,556,56,0,Player A
109,Gullible,422,117,539,39,0,Player A
110,Gullible,402,147,549,49,0,Player A
111,Gullible,396,156,552,52,0,Player A
112,Gullible,400,150,550,50,0,Player A
113,Gullible,392,162,554,54,0,Player A
114,Gullible,390,165,555,55,0,Player A
115,Gullible,416,126,542,42,0,Player A
116,Gullible,404,144,548,48,0,Player A
117,Gullible,396,156,552,52,0,Player A
118,Gullible,398,153,551,51,0,Player A
119,Gullible,410,135,545,45,0,Player A
120,Gullible,412,132,544,44,0,Player A
121,Gullible,400,150,550,50,0,Player A
122,Gullible,380,180,560,60,0,Player A
123,Gullible,386,171,557,57,0,Player A
124,Gullible,410,135,545,45,0,Player A
125,Gullible,388,168,556,56,0,Player A
126,Gullible,390,165,555,55,0,Player A
127,Gullible,408,138,546,46,0,Player A
128,Gullible,412,132,544,44,0,Player A
129,Gullible,390,165,555,55,0,Player A
130,Gullible,396,156,552,52,0,Player A
131,Gullible,398,153,551,51,0,Player A
132,Gullible,416,126,542,42,0,Player A
133,Gullible,398,153,551,51,0,Player A
134,Gullible,408,138,546,46,0,Player A
135,Gullible,406,141,547,47,0,Player A
136,Gullible,388,168,556,56,0,Player A
137,Gullible,402,147,549,49,0,Player A
138,Gullible,394,159,553,53,0,Player A
139,Gullible,436,96,532,32,0,Player A
140,Gullible,408,138,546,46,0,Player A
141,Gullible,386,171,557,57,0,Player A
0,Sly Fox,49,304,353,0,49,Sly Fox
1,Sly Fox,51,296,347,0,51,Sly Fox
2,Sly Fox,53,288,341,0,53,Sly Fox
3,Sly Fox,53,288,341,0,53,Sly Fox
4,Sly Fox,53,288,341,0,53,Sly Fox
5,Sly Fox,39,344,383,0,39,Sly Fox
6,Sly Fox,53,288,341,0,53,Sly Fox
7,Sly Fox,49,304,353,0,49,Sly Fox
8,Sly Fox,45,320,365,0,45,Sly Fox
9,Sly Fox,52,292,344,0,52,Sly Fox
10,Sly Fox,46,316,362,0,46,Sly Fox
11,Sly Fox,54,284,338,0,54,Sly Fox
12,Sly Fox,42,332,374,0,42,Sly Fox
13,Sly Fox,51,296,347,0,51,Sly Fox
14,Sly Fox,37,352,389,0,37,Sly Fox
15,Sly Fox,44,324,368,0,44,Sly Fox
16,Sly Fox,53,288,341,0,53,Sly Fox
17,Sly Fox,48,308,356,0,48,Sly Fox
18,Sly Fox,51,296,347,0,51,Sly Fox
19,Sly Fox,44,324,368,0,44,Sly Fox
20,Sly Fox,54,284,338,0,54,Sly Fox
21,Sly Fox,52,292,344,0,52,Sly Fox
22,Sly Fox,51,296,347,0,51,Sly Fox
23,Sly Fox,43,328,371,0,43,Sly Fox
24,Sly Fox,43,328,371,0,43,Sly Fox
25,Sly Fox,46,316,362,0,46,Sly Fox
26,Sly Fox,54,284,338,0,54,Sly Fox
27,Sly Fox,56,276,332,0,56,Sly Fox
28,Sly Fox,42,332,374,0,42,Sly Fox
29,Sly Fox,58,268,326,0,58,Sly Fox
30,Sly Fox,48,308,356,0,48,Sly Fox
31,Sly Fox,55,280,335,0,55,Sly Fox
32,Sly Fox,45,320,365,0,45,Sly Fox
33,Sly Fox,56,276,332,0,56,Sly Fox
34,Sly Fox,52,292,344,0,52,Sly Fox
35,Sly Fox,48,308,356,0,48,Sly Fox
36,Sly Fox,44,324,368,0,44,Sly Fox
37,Sly Fox,47,312,359,0,47,Sly Fox
38,Sly Fox,49,304,353,0,49,Sly Fox
39,Sly Fox,56,276,332,0,56,Sly Fox
40,Sly Fox,50,300,350,0,50,Sly Fox
41,Sly Fox,44,324,368,0,44,Sly Fox
42,Sly Fox,53,288,341,0,53,Sly Fox
43,Sly Fox,48,308,356,0,48,Sly Fox
44,Sly Fox,52,292,344,0,52,Sly Fox
45,Sly Fox,52,292,344,0,52,Sly Fox
46,Sly Fox,58,268,326,0,58,Sly Fox
47,Sly Fox,55,280,335,0,55,Sly Fox
48,Sly Fox,44,324,368,0,44,Sly Fox
49,Sly Fox,53,288,341,0,53,Sly Fox
50,Sly Fox,43,328,371,0,43,Sly Fox
51,Sly Fox,51,296,347,0,51,Sly Fox
52,Sly Fox,43,328,371,0,43,Sly Fox
53,Sly Fox,56,276,332,0,56,Sly Fox
54,Sly Fox,44,324,368,0,44,Sly Fox
55,Sly Fox,50,300,350,0,50,Sly Fox
56,Sly Fox,58,268,326,0,58,Sly Fox
57,Sly Fox,49,304,353,0,49,Sly Fox
58,Sly Fox,57,272,329,0,57,Sly Fox
59,Sly Fox,51,296,347,0,51,Sly Fox
60,Sly Fox,61,256,317,0,61,Sly Fox
61,Sly Fox,53,288,341,0,53,Sly Fox
62,Sly Fox,53,288,341,0,53,Sly Fox
63,Sly Fox,52,292,344,0,52,Sly Fox
64,Sly Fox,53,288,341,0,53,Sly Fox
65,Sly Fox,44,324,368,0,44,Sly Fox
66,Sly Fox,51,296,347,0,51,Sly Fox
67,Sly Fox,55,280,335,0,55,Sly Fox
68,Sly Fox,43,328,371,0,43,Sly Fox
69,Sly Fox,50,300,350,0,50,Sly Fox
70,Sly Fox,35,360,395,0,35,Sly Fox
71,Sly Fox,48,308,356,0,48,Sly Fox
72,Sly Fox,54,284,338,0,54,Sly Fox
73,Sly Fox,52,292,344,0,52,Sly Fox
74,Sly Fox,49,304,353,0,49,Sly Fox
75,Sly Fox,47,312,359,0,47,Sly Fox
76,Sly Fox,49,304,353,0,49,Sly Fox
77,Sly Fox,48,308,356,0,48,Sly Fox
78,Sly Fox,59,264,323,0,59,Sly Fox
79,Sly Fox,60,260,320,0,60,Sly Fox
80,Sly Fox,53,288,341,0,53,Sly Fox
81,Sly Fox,51,296,347,0,51,Sly Fox
82,Sly Fox,52,292,344,0,52,Sly Fox
83,Sly Fox,54,284,338,0,54,Sly Fox
84,Sly Fox,52,292,344,0,52,Sly Fox
85,Sly Fox,51,296,347,0,51,Sly Fox
86,Sly Fox,40,340,380,0,40,Sly Fox
87,Sly Fox,54,284,338,0,54,Sly Fox
88,Sly Fox,48,308,356,0,48,Sly Fox
89,Sly Fox,48,308,356,0,48,Sly Fox
90,Sly Fox,53,288,341,0,53,Sly Fox
91,Sly Fox,51,296,347,0,51,Sly Fox
92,Sly Fox,48,308,356,0,48,Sly Fox
93,Sly Fox,48,308,356,0,48,Sly Fox
94,Sly Fox,50,300,350,0,50,Sly Fox
95,Sly Fox,49,304,353,0,49,Sly Fox
96,Sly Fox,46,316,362,0,46,Sly Fox
97,Sly Fox,53,288,341,0,53,Sly Fox
98,Sly Fox,51,296,347,0,51,Sly Fox
99,Sly Fox,39,344,383,0,39,Sly Fox
100,Sly Fox,50,300,350,0,50,Sly Fox
101,Sly Fox,43,328,371,0,43,Sly Fox
102,Sly Fox,45,320,365,0,45,Sly Fox
103,Sly Fox,50,300,350,0,50,Sly Fox
104,Sly Fox,55,280,335,0,55,Sly Fox
105,Sly Fox,47,312,359,0,47,Sly Fox
106,Sly Fox,43,328,371,0,43,Sly Fox
107,Sly Fox,52,292,344,0,52,Sly Fox
108,Sly Fox,58,268,326,0,58,Sly Fox
109,Sly Fox,42,332,374,0,42,Sly Fox
110,Sly Fox,50,300,350,0,50,Sly Fox
111,Sly Fox,45,320,365,0,45,Sly Fox
112,Sly Fox,46,316,362,0,46,Sly Fox
113,Sly Fox,46,316,362,0,46,Sly Fox
114,Sly Fox,55,280,335,0,55,Sly Fox
115,Sly Fox,49,304,353,0,49,Sly Fox
116,Sly Fox,46,316,362,0,46,Sly Fox
117,Sly Fox,59,264,323,0,59,Sly Fox
118,Sly Fox,46,316,362,0,46,Sly Fox
119,Sly Fox,55,280,335,0,55,Sly Fox
120,Sly Fox,58,268,326,0,58,Sly Fox
121,Sly Fox,53,288,341,0,53,Sly Fox
122,Sly Fox,40,340,380,0,40,Sly Fox
123,Sly Fox,51,296,347,0,51,Sly Fox
124,Sly Fox,47,312,359,0,47,Sly Fox
125,Sly Fox,49,304,353,0,49,Sly Fox
126,Sly Fox,45,320,365,0,45,Sly Fox
127,Sly Fox,52,292,344,0,52,Sly Fox
128,Sly Fox,49,304,353,0,49,Sly Fox
129,Sly Fox,52,292,344,0,52,Sly Fox
130,Sly Fox,55,280,335,0,55,Sly Fox
131,Sly Fox,48,308,356,0,48,Sly Fox
132,Sly Fox,41,336,377,0,41,Sly Fox
133,Sly Fox,43,328,371,0,43,Sly Fox
134,Sly Fox,56,276,332,0,56,Sly Fox
135,Sly Fox,45,320,365,0,45,Sly Fox
136,Sly Fox,51,296,347,0,51,Sly Fox
137,Sly Fox,37,352,389,0,37,Sly Fox
138,Sly Fox,41,336,377,0,41,Sly Fox
139,Sly Fox,51,296,347,0,51,Sly Fox
140,Sly Fox,42,332,374,0,42,Sly Fox
141,Sly Fox,50,300,350,0,50,Sly Fox
142,Sly Fox,52,292,344,0,52,Sly Fox
143,Sly Fox,55,280,335,0,55,Sly Fox
144,Sly Fox,56,276,332,0,56,Sly Fox
145,Sly Fox,49,304,353,0,49,Sly Fox
146,Sly Fox,53,288,341,0,53,Sly Fox
147,Sly Fox,49,304,353,0,49,Sly Fox
148,Sly Fox,48,308,356,0,48,Sly Fox
149,Sly Fox,42,332,374,0,42,Sly Fox
150,Sly Fox,55,280,335,0,55,Sly Fox
151,Sly Fox,53,288,341,0,53,Sly Fox
152,Sly Fox,52,292,344,0,52,Sly Fox
153,Sly Fox,51,296,347,0,51,Sly Fox
154,Sly Fox,52,292,344,0,52,Sly Fox
155,Sly Fox,53,288,341,0,53,Sly Fox
156,Sly Fox,58,268,326,0,58,Sly Fox
157,Sly Fox,50,300,350,0,50,Sly Fox
158,Sly Fox,52,292,344,0,52,Sly Fox
159,Sly Fox,51,296,347,0,51,Sly Fox
160,Sly Fox,54,284,338,0,54,Sly Fox
161,Sly Fox,41,336,377,0,41,Sly Fox
162,Sly Fox,50,300,350,0,50,Sly Fox
163,Sly Fox,48,308,356,0,48,Sly Fox
164,Sly Fox,55,280,335,0,55,Sly Fox
165,Sly Fox,50,300,350,0,50,Sly Fox
166,Sly Fox,53,288,341,0,53,Sly Fox
167,Sly Fox,45,320,365,0,45,Sly Fox
168,Sly Fox,49,304,353,0,49,Sly Fox
169,Sly Fox,57,272,329,0,57,Sly Fox
170,Sly Fox,59,264,323,0,59,Sly Fox
171,Sly Fox,52,292,344,0,52,Sly Fox
172,Sly Fox,43,328,371,0,43,Sly Fox
173,Sly Fox,58,268,326,0,58,Sly Fox
174,Sly Fox,52,292,344,0,52,Sly Fox
175,Sly Fox,49,304,353,0,49,Sly Fox
176,Sly Fox,59,264,323,0,59,Sly Fox
177,Sly Fox,42,332,374,0,42,Sly Fox
178,Sly Fox,53,288,341,0,53,Sly Fox
179,Sly Fox,46,316,362,0,46,Sly Fox
180,Sly Fox,55,280,335,0,55,Sly Fox
181,Sly Fox,41,336,377,0,41,Sly Fox
182,Sly Fox,44,324,368,0,44,Sly Fox
183,Sly Fox,53,288,341,0,53,Sly Fox
184,Sly Fox,42,332,374,0,42,Sly Fox
185,Sly Fox,49,304,353,0,49,Sly Fox
186,Sly Fox,40,340,380,0,40,Sly Fox
187,Sly Fox,52,292,344,0,52,Sly Fox
188,Sly Fox,48,308,356,0,48,Sly Fox
189,Sly Fox,48,308,356,0,48,Sly Fox
190,Sly Fox,52,292,344,0,52,Sly Fox
191,Sly Fox,57,272,329,0,57,Sly Fox
192,Sly Fox,46,316,362,0,46,Sly Fox
193,Sly Fox,59,264,323,0,59,Sly Fox
194,Sly Fox,56,276,332,0,56,Sly Fox
195,Sly Fox,42,332,374,0,42,Sly Fox
196,Sly Fox,42,332,374,0,42,Sly Fox
197,Sly Fox,53,288,341,0,53,Sly Fox
198,Sly Fox,50,300,350,0,50,Sly Fox
199,Sly Fox,55,280,335,0,55,Sly Fox
200,Sly Fox,49,304,353,0,49,Sly Fox
201,Sly Fox,46,316,362,0,46,Sly Fox
202,Sly Fox,43,328,371,0,43,Sly Fox
203,Sly Fox,49,304,353,0,49,Sly Fox
204,Sly Fox,60,260,320,0,60,Sly Fox
205,Sly Fox,47,312,359,0,47,Sly Fox
206,Sly Fox,49,304,353,0,49,Sly Fox
207,Sly Fox,48,308,356,0,48,Sly Fox
208,Sly Fox,55,280,335,0,55,Sly Fox
209,Sly Fox,47,312,359,0,47,Sly Fox
210,Sly Fox,58,268,326,0,58,Sly Fox
211,Sly Fox,52,292,344,0,52,Sly Fox
212,Sly Fox,51,296,347,0,51,Sly Fox
213,Sly Fox,52,292,344,0,52,Sly Fox
214,Sly Fox,48,308,356,0,48,Sly Fox
215,Sly Fox,47,312,359,0,47,Sly Fox
216,Sly Fox,52,292,344,0,52,Sly Fox
217,Sly Fox,59,264,323,0,59,Sly Fox
218,Sly Fox,44,324,368,0,44,Sly Fox
219,Sly Fox,54,284,338,0,54,Sly Fox
220,Sly Fox,46,316,362,0,46,Sly Fox
221,Sly Fox,56,276,332,0,56,Sly Fox
222,Sly Fox,46,316,362,0,46,Sly Fox
223,Sly Fox,48,308,356,0,48,Sly Fox
224,Sly Fox,40,340,380,0,40,Sly Fox
225,Sly Fox,58,268,326,0,58,Sly Fox
226,Sly Fox,42,332,374,0,42,Sly Fox
227,Sly Fox,60,260,320,0,60,Sly Fox
228,Sly Fox,55,280,335,0,55,Sly Fox
229,Sly Fox,40,340,380,0,40,Sly Fox
230,Sly Fox,50,300,350,0,50,Sly Fox
231,Sly Fox,50,300,350,0,50,Sly Fox
232,Sly Fox,54,284,338,0,54,Sly Fox
233,Sly Fox,52,292,344,0,52,Sly Fox
234,Sly Fox,53,288,341,0,53,Sly Fox
235,Sly Fox,53,288,341,0,53,Sly Fox
236,Sly Fox,54,284,338,0,54,Sly Fox
237,Sly Fox,37,352,389,0,37,Sly Fox
238,Sly Fox,56,276,332,0,56,Sly Fox
239,Sly Fox,43,328,371,0,43,Sly Fox
240,Sly Fox,48,308,356,0,48,Sly Fox
241,Sly Fox,46,316,362,0,46,Sly Fox
242,Sly Fox,54,284,338,0,54,Sly Fox
243,Sly Fox,53,288,341,0,53,Sly Fox
244,Sly Fox,47,312,359,0,47,Sly Fox
245,Sly Fox,50,300,350,0,50,Sly Fox
246,Sly Fox,55,280,335,0,55,Sly Fox
247,Sly Fox,52,292,344,0,52,Sly Fox
248,Sly Fox,50,300,350,0,50,Sly Fox
249,Sly Fox,47,312,359,0,47,Sly Fox
250,Sly Fox,51,296,347,0,51,Sly Fox
251,Sly Fox,51,296,347,0,51,Sly Fox
252,Sly Fox,49,304,353,0,49,Sly Fox
253,Sly Fox,50,300,350,0,50,Sly Fox
254,Sly Fox,52,292,344,0,52,Sly Fox
255,Sly Fox,55,280,335,0,55,Sly Fox
256,Sly Fox,50,300,350,0,50,Sly Fox
257,Sly Fox,41,336,377,0,41,Sly Fox
258,Sly Fox,48,308,356,0,48,Sly Fox
259,Sly Fox,50,300,350,0,50,Sly Fox
260,Sly Fox,45,320,365,0,45,Sly Fox
261,Sly Fox,50,300,350,0,50,Sly Fox
262,Sly Fox,52,292,344,0,52,Sly Fox
263,Sly Fox,47,312,359,0,47,Sly Fox
264,Sly Fox,51,296,347,0,51,Sly Fox
265,Sly Fox,46,316,362,0,46,Sly Fox
266,Sly Fox,49,304,353,0,49,Sly Fox
267,Sly Fox,53,288,341,0,53,Sly Fox
268,Sly Fox,54,284,338,0,54,Sly Fox
269,Sly Fox,55,280,335,0,55,Sly Fox
270,Sly Fox,54,284,338,0,54,Sly Fox
271,Sly Fox,42,332,374,0,42,Sly Fox
272,Sly Fox,53,288,341,0,53,Sly Fox
273,Sly Fox,49,304,353,0,49,Sly Fox
274,Sly Fox,43,328,371,0,43,Sly Fox
275,Sly Fox,46,316,362,0,46,Sly Fox
276,Sly Fox,51,296,347,0,51,Sly Fox
277,Sly Fox,45,320,365,0,45,Sly Fox
278,Sly Fox,47,312,359,0,47,Sly Fox
279,Sly Fox,53,288,341,0,53,Sly Fox
280,Sly Fox,50,300,350,0,50,Sly Fox
281,Sly Fox,50,300,350,0,50,Sly Fox
282,Sly Fox,51,296,347,0,51,Sly Fox
283,Sly Fox,53,288,341,0,53,Sly Fox
284,Sly Fox,49,304,353,0,49,Sly Fox
285,Sly Fox,56,276,332,0,56,Sly Fox
286,Sly Fox,51,296,347,0,51,Sly Fox
287,Sly Fox,53,288,341,0,53,Sly Fox
288,Sly Fox,47,312,359,0,47,Sly Fox
289,Sly Fox,58,268,326,0,58,Sly Fox
290,Sly Fox,48,308,356,0,48,Sly Fox
291,Sly Fox,50,300,350,0,50,Sly Fox
292,Sly Fox,45,320,365,0,45,Sly Fox
293,Sly Fox,50,300,350,0,50,Sly Fox
294,Sly Fox,55,280,335,0,55,Sly Fox
295,Sly Fox,45,320,365,0,45,Sly Fox
296,Sly Fox,48,308,356,0,48,Sly Fox
297,Sly Fox,57,272,329,0,57,Sly Fox
298,Sly Fox,49,304,353,0,49,Sly Fox
299,Sly Fox,49,304,353,0,49,Sly Fox
300,Sly Fox,46,316,362,0,46,Sly Fox
301,Sly Fox,49,304,353,0,49,Sly Fox
302,Sly Fox,46,316,362,0,46,Sly Fox
303,Sly Fox,55,280,335,0,55,Sly Fox
304,Sly Fox,48,308,356,0,48,Sly Fox
305,Sly Fox,57,272,329,0,57,Sly Fox
306,Sly Fox,59,264,323,0,59,Sly Fox
307,Sly Fox,47,312,359,0,47,Sly Fox
308,Sly Fox,49,304,353,0,49,Sly Fox
309,Sly Fox,51,296,347,0,51,Sly Fox
310,Sly Fox,54,284,338,0,54,Sly Fox
311,Sly Fox,45,320,365,0,45,Sly Fox
312,Sly Fox,43,328,371,0,43,Sly Fox
313,Sly Fox,47,312,359,0,47,Sly Fox
314,Sly Fox,48,308,356,0,48,Sly Fox
315,Sly Fox,48,308,356,0,48,Sly Fox
316,Sly Fox,47,312,359,0,47,Sly Fox
317,Sly Fox,51,296,347,0,51,Sly Fox
318,Sly Fox,51,296,347,0,51,Sly Fox
319,Sly Fox,50,300,350,0,50,Sly Fox
320,Sly Fox,53,288,341,0,53,Sly Fox
321,Sly Fox,40,340,380,0,40,Sly Fox
322,Sly Fox,50,300,350,0,50,Sly Fox
323,Sly Fox,50,300,350,0,50,Sly Fox
324,Sly Fox,41,336,377,0,41,Sly Fox
325,Sly Fox,50,300,350,0,50,Sly Fox
326,Sly Fox,52,292,344,0,52,Sly Fox
327,Sly Fox,56,276,332,0,56,Sly Fox
328,Sly Fox,50,300,350,0,50,Sly Fox
329,Sly Fox,49,304,353,0,49,Sly Fox
330,Sly Fox,55,280,335,0,55,Sly Fox
331,Sly Fox,49,304,353,0,49,Sly Fox
332,Sly Fox,50,300,350,0,50,Sly Fox
333,Sly Fox,44,324,368,0,44,Sly Fox
334,Sly Fox,42,332,374,0,42,Sly Fox
335,Sly Fox,49,304,353,0,49,Sly Fox
336,Sly Fox,51,296,347,0,51,Sly Fox
337,Sly Fox,43,328,371,0,43,Sly Fox
338,Sly Fox,37,352,389,0,37,Sly Fox
339,Sly Fox,46,316,362,0,46,Sly Fox
340,Sly Fox,47,312,359,0,47,Sly Fox
341,Sly Fox,52,292,344,0,52,Sly Fox
342,Sly Fox,41,336,377,0,41,Sly Fox
343,Sly Fox,45,320,365,0,45,Sly Fox
344,Sly Fox,45,320,365,0,45,Sly Fox
345,Sly Fox,51,296,347,0,51,Sly Fox
346,Sly Fox,54,284,338,0,54,Sly Fox
347,Sly Fox,48,308,356,0,48,Sly Fox
348,Sly Fox,45,320,365,0,45,Sly Fox
349,Sly Fox,46,316,362,0,46,Sly Fox
350,Sly Fox,51,296,347,0,51,Sly Fox
351,Sly Fox,46,316,362,0,46,Sly Fox
352,Sly Fox,48,308,356,0,48,Sly Fox
353,Sly Fox,45,320,365,0,45,Sly Fox
354,Sly Fox,51,296,347,0,51,Sly Fox
355,Sly Fox,49,304,353,0,49,Sly Fox
356,Sly Fox,51,296,347,0,51,Sly Fox
357,Sly Fox,47,312,359,0,47,Sly Fox
358,Sly Fox,46,316,362,0,46,Sly Fox
359,Sly Fox,44,324,368,0,44,Sly Fox
360,Sly Fox,56,276,332,0,56,Sly Fox
361,Sly Fox,44,324,368,0,44,Sly Fox
362,Sly Fox,45,320,365,0,45,Sly Fox
363,Sly Fox,40,340,380,0,40,Sly Fox
364,Sly Fox,59,264,323,0,59,Sly Fox
365,Sly Fox,53,288,341,0,53,Sly Fox
366,Sly Fox,45,320,365,0,45,Sly Fox
367,Sly Fox,58,268,326,0,58,Sly Fox
368,Sly Fox,54,284,338,0,54,Sly Fox
369,Sly Fox,45,320,365,0,45,Sly Fox
370,Sly Fox,50,300,350,0,50,Sly Fox
371,Sly Fox,53,288,341,0,53,Sly Fox
372,Sly Fox,58,268,326,0,58,Sly Fox
373,Sly Fox,56,276,332,0,56,Sly Fox
374,Sly Fox,53,288,341,0,53,Sly Fox
375,Sly Fox,49,304,353,0,49,Sly Fox
376,Sly Fox,44,324,368,0,44,Sly Fox
377,Sly Fox,37,352,389,0,37,Sly Fox
378,Sly Fox,47,312,359,0,47,Sly Fox
379,Sly Fox,55,280,335,0,55,Sly Fox
380,Sly Fox,42,332,374,0,42,Sly Fox
381,Sly Fox,51,296,347,0,51,Sly Fox
382,Sly Fox,48,308,356,0,48,Sly Fox
383,Sly Fox,49,304,353,0,49,Sly Fox
384,Sly Fox,42,332,374,0,42,Sly Fox
385,Sly Fox,47,312,359,0,47,Sly Fox
386,Sly Fox,51,296,347,0,51,Sly Fox
387,Sly Fox,53,288,341,0,53,Sly Fox
388,Sly Fox,42,332,374,0,42,Sly Fox
389,Sly Fox,49,304,353,0,49,Sly Fox
390,Sly Fox,48,308,356,0,48,Sly Fox
391,Sly Fox,45,320,365,0,45,Sly Fox
392,Sly Fox,43,328,371,0,43,Sly Fox
393,Sly Fox,50,300,350,0,50,Sly Fox
394,Sly Fox,57,272,329,0,57,Sly Fox
395,Sly Fox,52,292,344,0,52,Sly Fox
396,Sly Fox,56,276,332,0,56,Sly Fox
397,Sly Fox,58,268,326,0,58,Sly Fox
398,Sly Fox,60,260,320,0,60,Sly Fox
399,Sly Fox,47,312,359,0,47,Sly Fox
400,Sly Fox,51,296,347,0,51,Sly Fox
401,Sly Fox,47,312,359,0,47,Sly Fox
402,Sly Fox,45,320,365,0,45,Sly Fox
403,Sly Fox,43,328,371,0,43,Sly Fox
404,Sly Fox,48,308,356,0,48,Sly Fox
405,Sly Fox,45,320,365,0,45,Sly Fox
406,Sly Fox,54,284,338,0,54,Sly Fox
407,Sly Fox,48,308,356,0,48,Sly Fox
408,Sly Fox,50,300,350,0,50,Sly Fox
409,Sly Fox,58,268,326,0,58,Sly Fox
410,Sly Fox,54,284,338,0,54,Sly Fox
411,Sly Fox,57,272,329,0,57,Sly Fox
412,Sly Fox,56,276,332,0,56,Sly Fox
413,Sly Fox,48,308,356,0,48,Sly Fox
414,Sly Fox,50,300,350,0,50,Sly Fox
415,Sly Fox,57,272,329,0,57,Sly Fox
416,Sly Fox,58,268,326,0,58,Sly Fox
417,Sly Fox,47,312,359,0,47,Sly Fox
418,Sly Fox,51,296,347,0,51,Sly Fox
419,Sly Fox,54,284,338,0,54,Sly Fox
420,Sly Fox,46,316,362,0,46,Sly Fox
421,Sly Fox,51,296,347,0,51,Sly Fox
422,Sly Fox,57,272,329,0,57,Sly Fox
423,Sly Fox,52,292,344,0,52,Sly Fox
424,Sly Fox,48,308,356,0,48,Sly Fox
425,Sly Fox,50,300,350,0,50,Sly Fox
426,Sly Fox,61,256,317,0,61,Sly Fox
427,Sly Fox,48,308,356,0,48,Sly Fox
428,Sly Fox,47,312,359,0,47,Sly Fox
429,Sly Fox,53,288,341,0,53,Sly Fox
430,Sly Fox,51,296,347,0,51,Sly Fox
431,Sly Fox,51,296,347,0,51,Sly Fox
432,Sly Fox,46,316,362,0,46,Sly Fox
433,Sly Fox,44,324,368,0,44,Sly Fox
434,Sly Fox,41,336,377,0,41,Sly Fox
435,Sly Fox,53,288,341,0,53,Sly Fox
436,Sly Fox,55,280,335,0,55,Sly Fox
437,Sly Fox,50,300,350,0,50,Sly Fox
438,Sly Fox,43,328,371,0,43,Sly Fox
439,Sly Fox,56,276,332,0,56,Sly Fox
440,Sly Fox,47,312,359,0,47,Sly Fox
441,Sly Fox,46,316,362,0,46,Sly Fox
442,Sly Fox,40,340,380,0,40,Sly Fox
443,Sly Fox,47,312,359,0,47,Sly Fox
444,Sly Fox,58,268,326,0,58,Sly Fox
445,Sly Fox,46,316,362,0,46,Sly Fox
446,Sly Fox,54,284,338,0,54,Sly Fox
447,Sly Fox,54,284,338,0,54,Sly Fox
448,Sly Fox,59,264,323,0,59,Sly Fox
449,Sly Fox,57,272,329,0,57,Sly Fox
450,Sly Fox,52,292,344,0,52,Sly Fox
451,Sly Fox,47,312,359,0,47,Sly Fox
452,Sly Fox,45,320,365,0,45,Sly Fox
453,Sly Fox,49,304,353,0,49,Sly Fox
454,Sly Fox,50,300,350,0,50,Sly Fox
455,Sly Fox,52,292,344,0,52,Sly Fox
456,Sly Fox,49,304,353,0,49,Sly Fox
457,Sly Fox,54,284,338,0,54,Sly Fox
458,Sly Fox,55,280,335,0,55,Sly Fox
459,Sly Fox,56,276,332,0,56,Sly Fox
460,Sly Fox,48,308,356,0,48,Sly Fox
461,Sly Fox,49,304,353,0,49,Sly Fox
462,Sly Fox,46,316,362,0,46,Sly Fox
463,Sly Fox,53,288,341,0,53,Sly Fox
464,Sly Fox,39,344,383,0,39,Sly Fox
465,Sly Fox,55,280,335,0,55,Sly Fox
466,Sly Fox,58,268,326,0,58,Sly Fox
467,Sly Fox,47,312,359,0,47,Sly Fox
468,Sly Fox,52,292,344,0,52,Sly Fox
469,Sly Fox,51,296,347,0,51,Sly Fox
470,Sly Fox,48,308,356,0,48,Sly Fox
471,Sly Fox,47,312,359,0,47,Sly Fox
472,Sly Fox,54,284,338,0,54,Sly Fox
473,Sly Fox,45,320,365,0,45,Sly Fox
474,Sly Fox,55,280,335,0,55,Sly Fox
475,Sly Fox,53,288,341,0,53,Sly Fox
476,Sly Fox,49,304,353,0,49,Sly Fox
477,Sly Fox,48,308,356,0,48,Sly Fox
478,Sly Fox,48,308,356,0,48,Sly Fox
479,Sly Fox,49,304,353,0,49,Sly Fox
480,Sly Fox,52,292,344,0,52,Sly Fox
481,Sly Fox,47,312,359,0,47,Sly Fox
482,Sly Fox,45,320,365,0,45,Sly Fox
483,Sly Fox,46,316,362,0,46,Sly Fox
484,Sly Fox,54,284,338,0,54,Sly Fox
485,Sly Fox,55,280,335,0,55,Sly Fox
486,Sly Fox,50,300,350,0,50,Sly Fox
487,Sly Fox,45,320,365,0,45,Sly Fox
488,Sly Fox,47,312,359,0,47,Sly Fox
489,Sly Fox,40,340,380,0,40,Sly Fox
490,Sly Fox,50,300,350,0,50,Sly Fox
491,Sly Fox,49,304,353,0,49,Sly Fox
492,Sly Fox,50,300,350,0,50,Sly Fox
493,Sly Fox,43,328,371,0,43,Sly Fox
494,Sly Fox,51,296,347,0,51,Sly Fox
495,Sly Fox,50,300,350,0,50,Sly Fox
496,Sly Fox,61,256,317,0,61,Sly Fox
497,Sly Fox,53,288,341,0,53,Sly Fox
498,Sly Fox,61,256,317,0,61,Sly Fox
499,Sly Fox,58,268,326,0,58,Sly Fox
500,Sly Fox,54,284,338,0,54,Sly Fox
501,Sly Fox,52,292,344,0,52,Sly Fox
502,Sly Fox,54,284,338,0,54,Sly Fox
503,Sly Fox,52,292,344,0,52,Sly Fox
504,Sly Fox,50,300,350,0,50,Sly Fox
505,Sly Fox,51,296,347,0,51,Sly Fox
506,Sly Fox,49,304,353,0,49,Sly Fox
507,Sly Fox,43,328,371,0,43,Sly Fox
508,Sly Fox,50,300,350,0,50,Sly Fox
509,Sly Fox,50,300,350,0,50,Sly Fox
510,Sly Fox,57,272,329,0,57,Sly Fox
511,Sly Fox,51,296,347,0,51,Sly Fox
512,Sly Fox,45,320,365,0,45,Sly Fox
513,Sly Fox,48,308,356,0,48,Sly Fox
514,Sly Fox,54,284,338,0,54,Sly Fox
515,Sly Fox,40,340,380,0,40,Sly Fox
516,Sly Fox,56,276,332,0,56,Sly Fox
517,Sly Fox,55,280,335,0,55,Sly Fox
518,Sly Fox,48,308,356,0,48,Sly Fox
519,Sly Fox,59,264,323,0,59,Sly Fox
520,Sly Fox,54,284,338,0,54,Sly Fox
521,Sly Fox,44,324,368,0,44,Sly Fox
522,Sly Fox,50,300,350,0,50,Sly Fox
523,Sly Fox,43,328,371,0,43,Sly Fox
524,Sly Fox,53,288,341,0,53,Sly Fox
525,Sly Fox,50,300,350,0,50,Sly Fox
526,Sly Fox,50,300,350,0,50,Sly Fox
527,Sly Fox,54,284,338,0,54,Sly Fox
528,Sly Fox,51,296,347,0,51,Sly Fox
529,Sly Fox,54,284,338,0,54,Sly Fox
530,Sly Fox,50,300,350,0,50,Sly Fox
531,Sly Fox,41,336,377,0,41,Sly Fox
532,Sly Fox,53,288,341,0,53,Sly Fox
533,Sly Fox,58,268,326,0,58,Sly Fox
534,Sly Fox,49,304,353,0,49,Sly Fox
535,Sly Fox,46,316,362,0,46,Sly Fox
536,Sly Fox,56,276,332,0,56,Sly Fox
537,Sly Fox,60,260,320,0,60,Sly Fox
538,Sly Fox,44,324,368,0,44,Sly Fox
539,Sly Fox,55,280,335,0,55,Sly Fox
540,Sly Fox,50,300,350,0,50,Sly Fox
541,Sly Fox,54,284,338,0,54,Sly Fox
542,Sly Fox,59,264,323,0,59,Sly Fox
543,Sly Fox,48,308,356,0,48,Sly Fox
544,Sly Fox,53,288,341,0,53,Sly Fox
545,Sly Fox,43,328,371,0,43,Sly Fox
546,Sly Fox,54,284,338,0,54,Sly Fox
547,Sly Fox,57,272,329,0,57,Sly Fox
548,Sly Fox,49,304,353,0,49,Sly Fox
549,Sly Fox,52,292,344,0,52,Sly Fox
550,Sly Fox,58,268,326,0,58,Sly Fox
551,Sly Fox,41,336,377,0,41,Sly Fox
552,Sly Fox,47,312,359,0,47,Sly Fox
553,Sly Fox,46,316,362,0,46,Sly Fox
554,Sly Fox,45,320,365,0,45,Sly Fox
555,Sly Fox,47,312,359,0,47,Sly Fox
556,Sly Fox,51,296,347,0,51,Sly Fox
557,Sly Fox,53,288,341,0,53,Sly Fox
558,Sly Fox,53,288,341,0,53,Sly Fox
559,Sly Fox,53,288,341,0,53,Sly Fox
560,Sly Fox,42,332,374,0,42,Sly Fox
561,Sly Fox,43,328,371,0,43,Sly Fox
562,Sly Fox,48,308,356,0,48,Sly Fox
563,Sly Fox,51,296,347,0,51,Sly Fox
564,Sly Fox,57,272,329,0,57,Sly Fox
565,Sly Fox,44,324,368,0,44,Sly Fox
566,Sly Fox,52,292,344,0,52,Sly Fox
567,Sly Fox,45,320,365,0,45,Sly Fox
568,Sly Fox,58,268,326,0,58,Sly Fox
569,Sly Fox,51,296,347,0,51,Sly Fox
570,Sly Fox,55,280,335,0,55,Sly Fox
571,Sly Fox,42,332,374,0,42,Sly Fox
572,Sly Fox,50,300,350,0,50,Sly Fox
573,Sly Fox,58,268,326,0,58,Sly Fox
574,Sly Fox,40,340,380,0,40,Sly Fox
575,Sly Fox,50,300,350,0,50,Sly Fox
576,Sly Fox,49,304,353,0,49,Sly Fox
577,Sly Fox,51,296,347,0,51,Sly Fox
578,Sly Fox,51,296,347,0,51,Sly Fox
579,Sly Fox,45,320,365,0,45,Sly Fox
580,Sly Fox,50,300,350,0,50,Sly Fox
581,Sly Fox,54,284,338,0,54,Sly Fox
582,Sly Fox,45,320,365,0,45,Sly Fox
583,Sly Fox,52,292,344,0,52,Sly Fox
584,Sly Fox,55,280,335,0,55,Sly Fox
585,Sly Fox,51,296,347,0,51,Sly Fox
586,Sly Fox,55,280,335,0,55,Sly Fox
587,Sly Fox,49,304,353,0,49,Sly Fox
588,Sly Fox,53,288,341,0,53,Sly Fox
589,Sly Fox,47,312,359,0,47,Sly Fox
590,Sly Fox,46,316,362,0,46,Sly Fox
591,Sly Fox,54,284,338,0,54,Sly Fox
592,Sly Fox,50,300,350,0,50,Sly Fox
593,Sly Fox,47,312,359,0,47,Sly Fox
594,Sly Fox,60,260,320,0,60,Sly Fox
595,Sly Fox,48,308,356,0,48,Sly Fox
596,Sly Fox,59,264,323,0,59,Sly Fox
597,Sly Fox,49,304,353,0,49,Sly Fox
598,Sly Fox,59,264,323,0,59,Sly Fox
599,Sly Fox,52,292,344,0,52,Sly Fox
600,Sly Fox,60,260,320,0,60,Sly Fox
601,Sly Fox,44,324,368,0,44,Sly Fox
602,Sly Fox,45,320,365,0,45,Sly Fox
603,Sly Fox,50,300,350,0,50,Sly Fox
604,Sly Fox,48,308,356,0,48,Sly Fox
605,Sly Fox,54,284,338,0,54,Sly Fox
606,Sly Fox,40,340,380,0,40,Sly Fox
607,Sly Fox,59,264,323,0,59,Sly Fox
608,Sly Fox,44,324,368,0,44,Sly Fox
609,Sly Fox,58,268,326,0,58,Sly Fox
610,Sly Fox,46,316,362,0,46,Sly Fox
611,Sly Fox,46,316,362,0,46,Sly Fox
612,Sly Fox,45,320,365,0,45,Sly Fox
613,Sly Fox,50,300,350,0,50,Sly Fox
614,Sly Fox,56,276,332,0,56,Sly Fox
615,Sly Fox,57,272,329,0,57,Sly Fox
616,Sly Fox,59,264,323,0,59,Sly Fox
617,Sly Fox,50,300,350,0,50,Sly Fox
618,Sly Fox,56,276,332,0,56,Sly Fox
619,Sly Fox,50,300,350,0,50,Sly Fox
620,Sly Fox,49,304,353,0,49,Sly Fox
621,Sly Fox,52,292,344,0,52,Sly Fox
622,Sly Fox,50,300,350,0,50,Sly Fox
623,Sly Fox,45,320,365,0,45,Sly Fox
624,Sly Fox,50,300,350,0,50,Sly Fox
625,Sly Fox,46,316,362,0,46,Sly Fox
626,Sly Fox,49,304,353,0,49,Sly Fox
627,Sly Fox,61,256,317,0,61,Sly Fox
628,Sly Fox,48,308,356,0,48,Sly Fox
629,Sly Fox,59,264,323,0,59,Sly Fox
630,Sly Fox,49,304,353,0,49,Sly Fox
631,Sly Fox,61,256,317,0,61,Sly Fox
632,Sly Fox,50,300,350,0,50,Sly Fox
633,Sly Fox,50,300,350,0,50,Sly Fox
634,Sly Fox,46,316,362,0,46,Sly Fox
635,Sly Fox,59,264,323,0,59,Sly Fox
636,Sly Fox,57,272,329,0,57,Sly Fox
637,Sly Fox,50,300,350,0,50,Sly Fox
638,Sly Fox,51,296,347,0,51,Sly Fox
639,Sly Fox,49,304,353,0,49,Sly Fox
640,Sly Fox,49,304,353,0,49,Sly Fox
641,Sly Fox,46,316,362,0,46,Sly Fox
642,Sly Fox,58,268,326,0,58,Sly Fox
643,Sly Fox,45,320,365,0,45,Sly Fox
644,Sly Fox,58,268,326,0,58,Sly Fox
645,Sly Fox,39,344,383,0,39,Sly Fox
646,Sly Fox,52,292,344,0,52,Sly Fox
647,Sly Fox,49,304,353,0,49,Sly Fox
648,Sly Fox,50,300,350,0,50,Sly Fox
649,Sly Fox,60,260,320,0,60,Sly Fox
650,Sly Fox,52,292,344,0,52,Sly Fox
651,Sly Fox,53,288,341,0,53,Sly Fox
652,Sly Fox,51,296,347,0,51,Sly Fox
653,Sly Fox,54,284,338,0,54,Sly Fox
654,Sly Fox,56,276,332,0,56,Sly Fox
655,Sly Fox,43,328,371,0,43,Sly Fox
656,Sly Fox,51,296,347,0,51,Sly Fox
657,Sly Fox,53,288,341,0,53,Sly Fox
658,Sly Fox,48,308,356,0,48,Sly Fox
659,Sly Fox,55,280,335,0,55,Sly Fox
660,Sly Fox,48,308,356,0,48,Sly Fox
661,Sly Fox,50,300,350,0,50,Sly Fox
662,Sly Fox,48,308,356,0,48,Sly Fox
663,Sly Fox,41,336,377,0,41,Sly Fox
664,Sly Fox,54,284,338,0,54,Sly Fox
665,Sly Fox,59,264,323,0,59,Sly Fox
666,Sly Fox,52,292,344,0,52,Sly Fox
667,Sly Fox,44,324,368,0,44,Sly Fox
668,Sly Fox,48,308,356,0,48,Sly Fox
669,Sly Fox,49,304,353,0,49,Sly Fox
670,Sly Fox,53,288,341,0,53,Sly Fox
671,Sly Fox,54,284,338,0,54,Sly Fox
672,Sly Fox,62,252,314,0,62,Sly Fox
673,Sly Fox,50,300,350,0,50,Sly Fox
674,Sly Fox,55,280,335,0,55,Sly Fox
675,Sly Fox,54,284,338,0,54,Sly Fox
676,Sly Fox,39,344,383,0,39,Sly Fox
677,Sly Fox,49,304,353,0,49,Sly Fox
678,Sly Fox,54,284,338,0,54,Sly Fox
679,Sly Fox,50,300,350,0,50,Sly Fox
680,Sly Fox,50,300,350,0,50,Sly Fox
681,Sly Fox,55,280,335,0,55,Sly Fox
682,Sly Fox,52,292,344,0,52,Sly Fox
683,Sly Fox,52,292,344,0,52,Sly Fox
684,Sly Fox,47,312,359,0,47,Sly Fox
685,Sly Fox,53,288,341,0,53,Sly Fox
686,Sly Fox,45,320,365,0,45,Sly Fox
687,Sly Fox,54,284,338,0,54,Sly Fox
688,Sly Fox,51,296,347,0,51,Sly Fox
689,Sly Fox,54,284,338,0,54,Sly Fox
690,Sly Fox,58,268,326,0,58,Sly Fox
691,Sly Fox,48,308,356,0,48,Sly Fox
692,Sly Fox,60,260,320,0,60,Sly Fox
693,Sly Fox,56,276,332,0,56,Sly Fox
694,Sly Fox,65,240,305,0,65,Sly Fox
695,Sly Fox,43,328,371,0,43,Sly Fox
696,Sly Fox,43,328,371,0,43,Sly Fox
697,Sly Fox,48,308,356,0,48,Sly Fox
698,Sly Fox,54,284,338,0,54,Sly Fox
699,Sly Fox,50,300,350,0,50,Sly Fox
700,Sly Fox,48,308,356,0,48,Sly Fox
701,Sly Fox,47,312,359,0,47,Sly Fox
702,Sly Fox,60,260,320,0,60,Sly Fox
703,Sly Fox,57,272,329,0,57,Sly Fox
704,Sly Fox,50,300,350,0,50,Sly Fox
705,Sly Fox,41,336,377,0,41,Sly Fox
706,Sly Fox,56,276,332,0,56,Sly Fox
707,Sly Fox,56,276,332,0,56,Sly Fox
708,Sly Fox,49,304,353,0,49,Sly Fox
709,Sly Fox,45,320,365,0,45,Sly Fox
710,Sly Fox,58,268,326,0,58,Sly Fox
711,Sly Fox,41,336,377,0,41,Sly Fox
712,Sly Fox,51,296,347,0,51,Sly Fox
713,Sly Fox,42,332,374,0,42,Sly Fox
714,Sly Fox,48,308,356,0,48,Sly Fox
715,Sly Fox,57,272,329,0,57,Sly Fox
716,Sly Fox,56,276,332,0,56,Sly Fox
717,Sly Fox,55,280,335,0,55,Sly Fox
718,Sly Fox,47,312,359,0,47,Sly Fox
719,Sly Fox,45,320,365,0,45,Sly Fox
720,Sly Fox,48,308,356,0,48,Sly Fox
721,Sly Fox,54,284,338,0,54,Sly Fox
722,Sly Fox,54,284,338,0,54,Sly Fox
0,Evan,222,232,454,26,24,Evan
1,Evan,234,209,443,21,26,Player A
2,Evan,214,239,453,31,26,Evan
3,Evan,224,229,453,25,24,Evan
4,Evan,241,201,442,17,25,Player A
5,Evan,237,197,434,21,29,Player A
6,Evan,226,231,457,23,22,Evan
7,Evan,217,242,459,28,23,Evan
8,Evan,239,189,428,21,31,Player A
9,Evan,233,208,441,22,27,Player A
10,Evan,213,258,471,28,19,Evan
11,Evan,228,213,441,25,28,Player A
12,Evan,228,208,436,26,30,Player A
13,Evan,234,209,443,21,26,Player A
14,Evan,214,244,458,30,24,Evan
15,Evan,238,213,451,17,22,Player A
16,Evan,219,249,468,25,19,Evan
17,Evan,229,229,458,21,21,Tie
18,Evan,225,230,455,24,23,Evan
19,Evan,225,230,455,24,23,Evan
20,Evan,227,212,439,26,29,Player A
21,Evan,204,269,473,33,20,Evan
22,Evan,228,198,426,28,34,Player A
23,Evan,225,225,450,25,25,Tie
24,Evan,212,252,464,30,22,Evan
25,Evan,211,251,462,31,23,Evan
26,Evan,216,236,452,30,26,Evan
27,Evan,221,226,447,28,27,Evan
28,Evan,222,232,454,26,24,Evan
29,Evan,221,236,457,26,23,Evan
30,Evan,214,234,448,32,28,Evan
31,Evan,228,213,441,25,28,Player A
32,Evan,221,246,467,24,19,Evan
33,Evan,220,225,445,29,28,Evan
34,Evan,222,227,449,27,26,Evan
35,Evan,225,225,450,25,25,Tie
36,Evan,228,228,456,22,22,Tie
37,Evan,215,255,470,27,19,Evan
38,Evan,216,241,457,29,24,Evan
39,Evan,229,214,443,24,27,Player A
40,Evan,230,220,450,22,24,Player A
41,Evan,223,233,456,25,23,Evan
42,Evan,235,205,440,21,27,Player A
43,Evan,229,214,443,24,27,Player A
44,Evan,219,244,463,26,21,Evan
45,Evan,215,255,470,27,19,Evan
46,Evan,218,248,466,26,20,Evan
47,Evan,235,195,430,23,31,Player A
48,Evan,235,200,435,22,29,Player A
49,Evan,228,218,446,24,26,Player A
50,Evan,222,237,459,25,22,Evan
51,Evan,222,227,449,27,26,Evan
52,Evan,230,220,450,22,24,Player A
53,Evan,219,234,453,28,25,Evan
54,Evan,230,220,450,22,24,Player A
55,Evan,214,254,468,28,20,Evan
56,Evan,219,239,458,27,23,Evan
57,Evan,217,247,464,27,21,Evan
58,Evan,210,265,475,29,18,Evan
59,Evan,222,237,459,25,22,Evan
60,Evan,233,218,451,20,23,Player A
61,Evan,218,228,446,30,28,Evan
62,Evan,214,254,468,28,20,Evan
63,Evan,216,236,452,30,26,Evan
64,Evan,220,225,445,29,28,Evan
65,Evan,236,211,447,19,24,Player A
66,Evan,223,228,451,26,25,Evan
67,Evan,225,220,445,26,27,Player A
68,Evan,231,211,442,23,27,Player A
69,Evan,226,231,457,23,22,Evan
70,Evan,232,217,449,21,24,Player A
71,Evan,236,201,437,21,28,Player A
72,Evan,225,220,445,26,27,Player A
73,Evan,227,227,454,23,23,Tie
74,Evan,232,197,429,25,32,Player A
75,Evan,227,227,454,23,23,Tie
76,Evan,218,238,456,28,24,Evan
77,Evan,229,204,433,26,31,Player A
78,Evan,213,273,486,25,13,Evan
79,Evan,239,199,438,19,27,Player A
80,Evan,207,257,464,33,23,Evan
81,Evan,232,212,444,22,26,Player A
82,Evan,246,181,427,17,30,Player A
83,Evan,233,203,436,23,29,Player A
84,Evan,221,221,442,29,29,Tie
85,Evan,221,241,462,25,21,Evan
86,Evan,234,204,438,22,28,Player A
87,Evan,234,209,443,21,26,Player A
88,Evan,215,240,455,30,25,Evan
89,Evan,228,223,451,23,24,Player A
90,Evan,229,214,443,24,27,Player A
91,Evan,221,216,437,30,31,Player A
92,Evan,232,202,434,24,30,Player A
93,Evan,213,238,451,32,27,Evan
94,Evan,227,217,444,25,27,Player A
95,Evan,234,199,433,23,30,Player A
96,Evan,218,238,456,28,24,Evan
97,Evan,224,239,463,23,20,Evan
98,Evan,230,205,435,25,30,Player A
99,Evan,219,229,448,29,27,Evan
100,Evan,233,208,441,22,27,Player A
101,Evan,219,234,453,28,25,Evan
102,Evan,227,222,449,24,25,Player A
103,Evan,221,221,442,29,29,Tie
104,Evan,226,236,462,22,20,Evan
105,Evan,229,214,443,24,27,Player A
106,Evan,230,220,450,22,24,Player A
107,Evan,226,226,452,24,24,Tie
108,Evan,232,207,439,23,28,Player A
109,Evan,216,246,462,28,22,Evan
110,Evan,233,218,451,20,23,Player A
111,Evan,222,227,449,27,26,Evan
112,Evan,233,218,451,20,23,Player A
113,Evan,220,230,450,28,26,Evan
114,Evan,227,232,459,22,21,Evan
115,Evan,226,226,452,24,24,Tie
116,Evan,223,233,456,25,23,Evan
117,Evan,214,239,453,31,26,Evan
118,Evan,222,222,444,28,28,Tie
119,Evan,224,219,443,27,28,Player A
120,Evan,225,220,445,26,27,Player A
121,Evan,224,214,438,28,30,Player A
122,Evan,234,209,443,21,26,Player A
123,Evan,227,217,444,25,27,Player A
124,Evan,228,223,451,23,24,Player A
125,Evan,219,239,458,27,23,Evan
126,Evan,225,215,440,27,29,Player A
127,Evan,234,209,443,21,26,Player A
128,Evan,231,216,447,22,25,Player A
129,Evan,217,237,454,29,25,Evan
130,Evan,220,230,450,28,26,Evan
131,Evan,215,250,465,28,21,Evan
132,Evan,228,218,446,24,26,Player A
133,Evan,220,230,450,28,26,Evan
134,Evan,217,237,454,29,25,Evan
135,Evan,223,228,451,26,25,Evan
136,Evan,234,194,428,24,32,Player A
137,Evan,231,221,452,21,23,Player A
138,Evan,217,252,469,26,19,Evan
139,Evan,223,223,446,27,27,Tie
140,Evan,208,268,476,30,18,Evan
141,Evan,231,216,447,22,25,Player A
142,Evan,229,214,443,24,27,Player A
143,Evan,231,206,437,24,29,Player A
144,Evan,234,179,413,27,38,Player A
145,Evan,225,230,455,24,23,Evan
146,Evan,231,226,457,20,21,Player A
147,Evan,217,252,469,26,19,Evan
148,Evan,222,237,459,25,22,Evan
149,Evan,226,221,447,25,26,Player A
150,Evan,227,222,449,24,25,Player A
151,Evan,226,226,452,24,24,Tie
152,Evan,220,235,455,27,24,Evan
153,Evan,229,224,453,22,23,Player A
154,Evan,220,230,450,28,26,Evan
155,Evan,223,228,451,26,25,Evan
156,Evan,219,249,468,25,19,Evan
157,Evan,227,217,444,25,27,Player A
158,Evan,228,213,441,25,28,Player A
159,Evan,227,222,449,24,25,Player A
160,Evan,223,243,466,23,19,Evan
161,Evan,218,243,461,27,22,Evan
162,Evan,217,242,459,28,23,Evan
163,Evan,230,210,440,24,28,Player A
164,Evan,218,243,461,27,22,Evan
165,Evan,226,211,437,27,30,Player A
166,Evan,220,225,445,29,28,Evan
167,Evan,220,240,460,26,22,Evan
168,Evan,230,225,455,21,22,Player A
169,Evan,231,201,432,25,31,Player A
170,Evan,220,240,460,26,22,Evan
171,Evan,233,213,446,21,25,Player A
172,Evan,242,187,429,19,30,Player A
173,Evan,207,262,469,32,21,Evan
174,Evan,227,227,454,23,23,Tie
175,Evan,219,249,468,25,19,Evan
176,Evan,228,218,446,24,26,Player A
177,Evan,229,209,438,25,29,Player A
178,Evan,228,208,436,26,30,Player A
179,Evan,224,239,463,23,20,Evan
180,Evan,229,234,463,20,19,Evan
181,Evan,225,235,460,23,21,Evan
182,Evan,232,212,444,22,26,Player A
183,Evan,227,217,444,25,27,Player A
184,Evan,215,250,465,28,21,Evan
185,Evan,238,198,436,20,28,Player A
186,Evan,230,215,445,23,26,Player A
187,Evan,231,206,437,24,29,Player A
188,Evan,231,221,452,21,23,Player A
189,Evan,222,237,459,25,22,Evan
190,Evan,228,218,446,24,26,Player A
191,Evan,237,197,434,21,29,Player A
192,Evan,222,217,439,29,30,Player A
193,Evan,228,218,446,24,26,Player A
194,Evan,224,224,448,26,26,Tie
195,Evan,229,224,453,22,23,Player A
196,Evan,227,237,464,21,19,Evan
197,Evan,242,187,429,19,30,Player A
198,Evan,221,226,447,28,27,Evan
199,Evan,234,189,423,25,34,Player A
200,Evan,237,197,434,21,29,Player A
201,Evan,247,187,434,15,27,Player A
202,Evan,213,253,466,29,21,Evan
203,Evan,219,244,463,26,21,Evan
204,Evan,224,219,443,27,28,Player A
205,Evan,221,231,452,27,25,Evan
206,Evan,224,239,463,23,20,Evan
207,Evan,222,232,454,26,24,Evan
208,Evan,225,215,440,27,29,Player A
209,Evan,216,246,462,28,22,Evan
210,Evan,223,233,456,25,23,Evan
211,Evan,226,221,447,25,26,Player A
212,Evan,234,199,433,23,30,Player A
213,Evan,210,265,475,29,18,Evan
214,Evan,225,225,450,25,25,Tie
215,Evan,244,204,448,14,22,Player A
216,Evan,222,222,444,28,28,Tie
217,Evan,234,209,443,21,26,Player A
218,Evan,222,227,449,27,26,Evan
219,Evan,221,221,442,29,29,Tie
220,Evan,211,246,457,32,25,Evan
221,Evan,231,211,442,23,27,Player A
222,Evan,220,240,460,26,22,Evan
223,Evan,227,212,439,26,29,Player A
224,Evan,237,202,439,20,27,Player A
225,Evan,224,224,448,26,26,Tie
226,Evan,223,243,466,23,19,Evan
227,Evan,216,251,467,27,20,Evan
228,Evan,221,216,437,30,31,Player A
229,Evan,231,226,457,20,21,Player A
230,Evan,210,260,470,30,20,Evan
231,Evan,235,200,435,22,29,Player A
232,Evan,212,252,464,30,22,Evan
233,Evan,216,241,457,29,24,Evan
234,Evan,219,249,468,25,19,Evan
235,Evan,225,205,430,29,33,Player A
236,Evan,231,211,442,23,27,Player A
237,Evan,236,196,432,22,30,Player A
238,Evan,205,270,475,32,19,Evan
239,Evan,230,210,440,24,28,Player A
240,Evan,217,242,459,28,23,Evan
241,Evan,224,229,453,25,24,Evan
242,Evan,238,203,441,19,26,Player A
243,Evan,223,223,446,27,27,Tie
244,Evan,224,234,458,24,22,Evan
245,Evan,230,220,450,22,24,Player A
246,Evan,223,243,466,23,19,Evan
247,Evan,222,232,454,26,24,Evan
248,Evan,230,220,450,22,24,Player A
249,Evan,233,223,456,19,21,Player A
250,Evan,216,241,457,29,24,Evan
251,Evan,216,246,462,28,22,Evan
252,Evan,223,238,461,24,21,Evan
253,Evan,241,196,437,18,27,Player A
254,Evan,203,258,461,36,25,Evan
255,Evan,224,219,443,27,28,Player A
256,Evan,230,220,450,22,24,Player A
257,Evan,224,224,448,26,26,Tie
258,Evan,223,233,456,25,23,Evan
259,Evan,221,241,462,25,21,Evan
260,Evan,222,227,449,27,26,Evan
261,Evan,222,232,454,26,24,Evan
262,Evan,225,220,445,26,27,Player A
263,Evan,218,238,456,28,24,Evan
264,Evan,244,174,418,20,34,Player A
265,Evan,237,207,444,19,25,Player A
266,Evan,215,245,460,29,23,Evan
267,Evan,237,202,439,20,27,Player A
268,Evan,226,221,447,25,26,Player A
269,Evan,222,242,464,24,20,Evan
270,Evan,232,207,439,23,28,Player A
271,Evan,225,220,445,26,27,Player A
272,Evan,212,252,464,30,22,Evan
273,Evan,222,242,464,24,20,Evan
274,Evan,215,240,455,30,25,Evan
275,Evan,234,194,428,24,32,Player A
276,Evan,222,242,464,24,20,Evan
277,Evan,230,215,445,23,26,Player A
278,Evan,220,235,455,27,24,Evan
279,Evan,226,236,462,22,20,Evan
280,Evan,233,223,456,19,21,Player A
281,Evan,225,235,460,23,21,Evan
282,Evan,233,223,456,19,21,Player A
283,Evan,215,235,450,31,27,Evan
284,Evan,230,215,445,23,26,Player A
285,Evan,232,207,439,23,28,Player A
286,Evan,234,204,438,22,28,Player A
287,Evan,218,233,451,29,26,Evan
288,Evan,219,239,458,27,23,Evan
289,Evan,225,230,455,24,23,Evan
290,Evan,227,212,439,26,29,Player A
291,Evan,223,218,441,28,29,Player A
292,Evan,225,225,450,25,25,Tie
293,Evan,233,218,451,20,23,Player A
294,Evan,224,209,433,29,32,Player A
295,Evan,232,212,444,22,26,Player A
296,Evan,213,253,466,29,21,Evan
297,Evan,210,260,470,30,20,Evan
298,Evan,236,206,442,20,26,Player A
299,Evan,219,229,448,29,27,Evan
300,Evan,226,231,457,23,22,Evan
301,Evan,237,202,439,20,27,Player A
302,Evan,225,220,445,26,27,Player A
303,Evan,226,231,457,23,22,Evan
304,Evan,222,227,449,27,26,Evan
305,Evan,214,244,458,30,24,Evan
306,Evan,224,224,448,26,26,Tie
307,Evan,237,197,434,21,29,Player A
308,Evan,226,221,447,25,26,Player A
309,Evan,237,192,429,22,31,Player A
310,Evan,243,188,431,18,29,Player A
311,Evan,234,204,438,22,28,Player A
312,Evan,222,227,449,27,26,Evan
313,Evan,220,235,455,27,24,Evan
314,Evan,215,255,470,27,19,Evan
315,Evan,230,215,445,23,26,Player A
316,Evan,232,212,444,22,26,Player A
317,Evan,223,248,471,22,17,Evan
318,Evan,237,212,449,18,23,Player A
319,Evan,230,220,450,22,24,Player A
320,Evan,236,196,432,22,30,Player A
321,Evan,229,204,433,26,31,Player A
322,Evan,229,199,428,27,33,Player A
323,Evan,230,220,450,22,24,Player A
324,Evan,226,221,447,25,26,Player A
325,Evan,242,187,429,19,30,Player A
326,Evan,223,223,446,27,27,Tie
327,Evan,233,208,441,22,27,Player A
328,Evan,226,211,437,27,30,Player A
329,Evan,234,204,438,22,28,Player A
330,Evan,219,234,453,28,25,Evan
331,Evan,218,243,461,27,22,Evan
332,Evan,223,233,456,25,23,Evan
333,Evan,224,219,443,27,28,Player A
334,Evan,227,222,449,24,25,Player A
335,Evan,230,215,445,23,26,Player A
336,Evan,221,241,462,25,21,Evan
337,Evan,220,240,460,26,22,Evan
338,Evan,234,209,443,21,26,Player A
339,Evan,221,231,452,27,25,Evan
340,Evan,213,253,466,29,21,Evan
341,Evan,222,217,439,29,30,Player A
342,Evan,234,204,438,22,28,Player A
343,Evan,222,227,449,27,26,Evan
344,Evan,229,219,448,23,25,Player A
345,Evan,223,243,466,23,19,Evan
346,Evan,216,246,462,28,22,Evan
347,Evan,221,236,457,26,23,Evan
348,Evan,219,239,458,27,23,Evan
349,Evan,220,245,465,25,20,Evan
350,Evan,232,217,449,21,24,Player A
351,Evan,215,245,460,29,23,Evan
352,Evan,219,239,458,27,23,Evan
353,Evan,234,194,428,24,32,Player A
354,Evan,236,206,442,20,26,Player A
355,Evan,238,188,426,22,32,Player A
356,Evan,232,222,454,20,22,Player A
357,Evan,228,228,456,22,22,Tie
358,Evan,229,209,438,25,29,Player A
359,Evan,232,217,449,21,24,Player A
360,Evan,223,228,451,26,25,Evan
361,Evan,238,193,431,21,30,Player A
362,Evan,230,220,450,22,24,Player A
363,Evan,222,237,459,25,22,Evan
364,Evan,219,229,448,29,27,Evan
365,Evan,225,225,450,25,25,Tie
366,Evan,207,267,474,31,19,Evan
367,Evan,222,242,464,24,20,Evan
368,Evan,230,200,430,26,32,Player A
369,Evan,220,235,455,27,24,Evan
370,Evan,231,206,437,24,29,Player A
371,Evan,227,232,459,22,21,Evan
372,Evan,224,209,433,29,32,Player A
373,Evan,236,211,447,19,24,Player A
374,Evan,217,247,464,27,21,Evan
375,Evan,231,231,462,19,19,Tie
376,Evan,224,224,448,26,26,Tie
377,Evan,214,259,473,27,18,Evan
378,Evan,226,226,452,24,24,Tie
379,Evan,219,229,448,29,27,Evan
380,Evan,221,221,442,29,29,Tie
381,Evan,218,233,451,29,26,Evan
382,Evan,230,220,450,22,24,Player A
383,Evan,231,206,437,24,29,Player A
384,Evan,222,227,449,27,26,Evan
385,Evan,225,230,455,24,23,Evan
386,Evan,241,186,427,20,31,Player A
387,Evan,242,197,439,17,26,Player A
388,Evan,226,221,447,25,26,Player A
389,Evan,225,225,450,25,25,Tie
390,Evan,230,225,455,21,22,Player A
391,Evan,234,204,438,22,28,Player A
392,Evan,222,237,459,25,22,Evan
393,Evan,218,233,451,29,26,Evan
394,Evan,230,220,450,22,24,Player A
395,Evan,228,208,436,26,30,Player A
396,Evan,215,250,465,28,21,Evan
397,Evan,229,219,448,23,25,Player A
398,Evan,223,233,456,25,23,Evan
399,Evan,207,267,474,31,19,Evan
400,Evan,226,216,442,26,28,Player A
401,Evan,225,220,445,26,27,Player A
402,Evan,222,232,454,26,24,Evan
403,Evan,229,224,453,22,23,Player A
404,Evan,231,226,457,20,21,Player A
405,Evan,224,234,458,24,22,Evan
406,Evan,220,235,455,27,24,Evan
407,Evan,240,190,430,20,30,Player A
408,Evan,229,209,438,25,29,Player A
409,Evan,221,236,457,26,23,Evan
410,Evan,231,206,437,24,29,Player A
411,Evan,225,230,455,24,23,Evan
412,Evan,218,238,456,28,24,Evan
413,Evan,223,228,451,26,25,Evan
0,Randy,224,224,448,23,25,Tie
1,Randy,232,222,454,23,23,Player A
2,Randy,270,220,490,35,15,Player A
3,Randy,234,219,453,25,24,Player A
4,Randy,232,197,429,16,29,Player A
5,Randy,219,224,443,24,27,Randy
6,Randy,198,263,461,27,22,Randy
7,Randy,238,208,446,24,26,Player A
8,Randy,254,214,468,25,19,Player A
9,Randy,238,223,461,24,21,Player A
10,Randy,220,235,455,27,24,Randy
11,Randy,221,216,437,18,27,Player A
12,Randy,254,214,468,25,19,Player A
13,Randy,222,227,449,24,25,Randy
14,Randy,229,249,478,29,17,Randy
15,Randy,236,211,447,22,25,Player A
16,Randy,219,229,448,23,25,Randy
17,Randy,248,188,436,23,29,Player A
18,Randy,228,253,481,35,18,Randy
19,Randy,212,232,444,22,26,Randy
20,Randy,245,195,440,27,29,Player A
21,Randy,217,252,469,23,18,Randy
22,Randy,207,222,429,22,31,Randy
23,Randy,213,213,426,19,31,Tie
24,Randy,191,231,422,24,34,Randy
25,Randy,204,234,438,19,27,Randy
26,Randy,244,204,448,23,25,Player A
27,Randy,170,265,435,25,30,Randy
28,Randy,206,231,437,21,28,Randy
29,Randy,217,262,479,30,17,Randy
30,Randy,218,243,461,27,22,Randy
31,Randy,225,235,460,32,24,Randy
32,Randy,254,229,483,34,17,Player A
33,Randy,211,226,437,21,28,Randy
34,Randy,219,219,438,22,28,Tie
35,Randy,234,209,443,24,27,Player A
36,Randy,220,235,455,27,24,Randy
37,Randy,234,229,463,29,22,Player A
38,Randy,235,225,460,23,21,Player A
39,Randy,202,222,424,23,33,Randy
40,Randy,250,210,460,29,23,Player A
41,Randy,245,215,460,23,21,Player A
42,Randy,231,231,462,28,22,Tie
43,Randy,216,246,462,31,23,Randy
44,Randy,260,200,460,26,22,Player A
45,Randy,249,224,473,24,17,Player A
46,Randy,207,227,434,24,30,Randy
47,Randy,210,235,445,20,25,Randy
48,Randy,266,211,477,28,17,Player A
49,Randy,258,193,451,23,24,Player A
50,Randy,233,208,441,19,26,Player A
51,Randy,211,246,457,26,23,Randy
52,Randy,222,227,449,27,26,Randy
53,Randy,212,227,439,29,30,Randy
54,Randy,247,202,449,24,25,Player A
55,Randy,249,219,468,31,21,Player A
56,Randy,236,216,452,24,24,Player A
57,Randy,242,217,459,25,22,Player A
58,Randy,216,271,487,32,15,Randy
59,Randy,211,226,437,27,30,Randy
60,Randy,252,227,479,33,18,Player A
61,Randy,200,230,430,11,27,Randy
62,Randy,207,247,454,20,22,Randy
63,Randy,198,233,431,24,31,Randy
64,Randy,214,224,438,22,28,Randy
65,Randy,214,254,468,28,20,Randy
66,Randy,231,211,442,23,27,Player A
67,Randy,208,248,456,28,24,Randy
68,Randy,249,209,458,24,22,Player A
69,Randy,228,238,466,29,21,Randy
70,Randy,260,175,435,25,30,Player A
71,Randy,246,211,457,26,23,Player A
72,Randy,229,229,458,21,21,Tie
73,Randy,235,235,470,24,18,Tie
74,Randy,226,221,447,25,26,Player A
75,Randy,241,226,467,21,18,Player A
76,Randy,204,234,438,19,27,Randy
77,Randy,228,183,411,22,37,Player A
78,Randy,196,241,437,18,27,Randy
79,Randy,230,210,440,18,26,Player A
80,Randy,239,219,458,30,24,Player A
81,Randy,189,244,433,23,30,Randy
82,Randy,243,213,456,25,23,Player A
83,Randy,255,180,435,19,28,Player A
84,Randy,239,214,453,34,27,Player A
85,Randy,217,212,429,22,31,Player A
86,Randy,232,222,454,20,22,Player A
87,Randy,209,244,453,25,24,Randy
88,Randy,215,240,455,21,22,Randy
89,Randy,264,219,483,31,16,Player A
90,Randy,235,225,460,23,21,Player A
91,Randy,232,202,434,15,27,Player A
92,Randy,241,221,462,22,20,Player A
93,Randy,218,218,436,26,30,Tie
94,Randy,256,196,452,27,25,Player A
95,Randy,219,234,453,19,22,Randy
96,Randy,250,225,475,32,19,Player A
97,Randy,229,204,433,26,31,Player A
98,Randy,267,197,464,30,22,Player A
99,Randy,233,198,431,24,31,Player A
100,Randy,231,191,422,18,32,Player A
101,Randy,243,223,466,29,21,Player A
102,Randy,257,197,454,26,24,Player A
103,Randy,206,251,457,26,23,Randy
104,Randy,259,194,453,25,24,Player A
105,Randy,194,244,438,28,30,Randy
106,Randy,220,220,440,27,29,Tie
107,Randy,253,213,466,26,20,Player A
108,Randy,242,217,459,28,23,Player A
109,Randy,235,210,445,26,27,Player A
110,Randy,204,259,463,20,19,Randy
111,Randy,228,223,451,26,25,Player A
112,Randy,223,228,451,26,25,Randy
113,Randy,220,240,460,23,21,Randy
114,Randy,189,259,448,20,24,Randy
115,Randy,242,212,454,23,23,Player A
116,Randy,198,268,466,26,20,Randy
117,Randy,233,238,471,28,19,Randy
118,Randy,235,215,450,25,25,Player A
119,Randy,216,231,447,25,26,Randy
120,Randy,213,258,471,31,20,Randy
121,Randy,230,220,450,28,26,Player A
122,Randy,215,240,455,27,24,Randy
123,Randy,242,222,464,27,21,Player A
124,Randy,199,239,438,25,29,Randy
125,Randy,221,246,467,27,20,Randy
126,Randy,227,212,439,20,27,Player A
127,Randy,229,194,423,22,33,Player A
128,Randy,240,215,455,24,23,Player A
129,Randy,217,222,439,26,29,Randy
130,Randy,214,214,428,24,32,Tie
131,Randy,219,254,473,33,20,Randy
132,Randy,222,222,444,25,27,Tie
133,Randy,253,218,471,31,20,Player A
134,Randy,238,213,451,29,26,Player A
135,Randy,238,198,436,14,26,Player A
136,Randy,228,208,436,23,29,Player A
137,Randy,220,180,400,20,40,Player A
138,Randy,247,207,454,29,25,Player A
139,Randy,213,218,431,21,30,Randy
140,Randy,209,224,433,17,28,Randy
141,Randy,241,226,467,27,20,Player A
142,Randy,246,221,467,30,21,Player A
143,Randy,231,221,452,30,26,Player A
144,Randy,221,241,462,28,22,Randy
145,Randy,194,234,428,18,30,Randy
146,Randy,229,224,453,25,24,Player A
147,Randy,247,217,464,27,21,Player A
148,Randy,217,247,464,33,23,Randy
149,Randy,203,253,456,22,22,Randy
150,Randy,229,209,438,25,29,Player A
151,Randy,244,214,458,27,23,Player A
152,Randy,233,218,451,26,25,Player A
153,Randy,199,239,438,19,27,Randy
154,Randy,259,214,473,30,19,Player A
155,Randy,230,220,450,31,27,Player A
156,Randy,240,215,455,27,24,Player A
157,Randy,235,220,455,24,23,Player A
158,Randy,202,232,434,24,30,Randy
159,Randy,234,214,448,23,25,Player A
160,Randy,228,223,451,32,27,Player A
161,Randy,236,221,457,32,25,Player A
162,Randy,201,246,447,19,24,Randy
163,Randy,222,232,454,29,25,Randy
164,Randy,228,218,446,30,28,Player A
165,Randy,220,195,415,17,34,Player A
166,Randy,237,197,434,24,30,Player A
167,Randy,222,237,459,22,21,Randy
168,Randy,245,220,465,31,22,Player A
169,Randy,187,232,419,18,33,Randy
170,Randy,247,212,459,25,22,Player A
171,Randy,213,233,446,24,26,Randy
172,Randy,217,237,454,26,24,Randy
173,Randy,238,198,436,20,28,Player A
174,Randy,207,217,424,14,30,Randy
175,Randy,276,161,437,21,28,Player A
176,Randy,180,275,455,24,23,Randy
177,Randy,240,200,440,27,29,Player A
178,Randy,233,238,471,31,20,Randy
179,Randy,255,225,480,25,15,Player A
180,Randy,224,239,463,26,21,Randy
181,Randy,210,210,420,22,34,Tie
182,Randy,218,233,451,29,26,Randy
183,Randy,240,230,470,27,19,Player A
184,Randy,280,205,485,24,13,Player A
185,Randy,234,209,443,27,28,Player A
186,Randy,233,213,446,27,27,Player A
187,Randy,197,257,454,26,24,Randy
188,Randy,219,249,468,34,22,Randy
189,Randy,233,223,456,28,24,Player A
190,Randy,244,209,453,31,26,Player A
191,Randy,223,223,446,27,27,Tie
192,Randy,236,216,452,21,23,Player A
193,Randy,221,226,447,28,27,Randy
194,Randy,233,218,451,20,23,Player A
195,Randy,220,225,445,20,25,Randy
196,Randy,249,229,478,29,17,Player A
197,Randy,249,209,458,30,24,Player A
198,Randy,213,238,451,20,23,Randy
199,Randy,244,209,453,28,25,Player A
200,Randy,260,220,480,28,16,Player A
201,Randy,203,253,456,31,25,Randy
202,Randy,217,252,469,29,20,Randy
203,Randy,234,234,468,31,21,Tie
204,Randy,258,193,451,26,25,Player A
205,Randy,214,214,428,27,33,Tie
206,Randy,224,234,458,24,22,Randy
207,Randy,231,196,427,23,32,Player A
208,Randy,216,256,472,29,19,Randy
209,Randy,203,238,441,22,27,Randy
210,Randy,240,215,455,27,24,Player A
211,Randy,210,245,455,27,24,Randy
212,Randy,219,219,438,22,28,Tie
213,Randy,229,224,453,25,24,Player A
214,Randy,235,200,435,25,30,Player A
215,Randy,216,246,462,25,21,Randy
216,Randy,218,238,456,22,22,Randy
217,Randy,243,208,451,23,24,Player A
218,Randy,232,182,414,22,36,Player A
219,Randy,217,252,469,32,21,Randy
220,Randy,208,243,451,26,25,Randy
221,Randy,219,264,483,28,15,Randy
222,Randy,212,222,434,21,29,Randy
223,Randy,212,242,454,29,25,Randy
224,Randy,234,229,463,32,23,Player A
225,Randy,218,208,426,22,32,Player A
226,Randy,235,225,460,26,22,Player A
227,Randy,209,229,438,22,28,Randy
228,Randy,213,203,416,24,36,Player A
229,Randy,215,230,445,26,27,Randy
230,Randy,259,204,463,29,22,Player A
231,Randy,198,248,446,27,27,Randy
232,Randy,218,223,441,25,28,Randy
233,Randy,236,256,492,37,15,Randy
234,Randy,214,249,463,23,20,Randy
235,Randy,201,226,427,23,32,Randy
236,Randy,247,207,454,26,24,Player A
237,Randy,225,220,445,26,27,Player A
238,Randy,250,195,445,17,24,Player A
239,Randy,232,242,474,31,19,Randy
240,Randy,218,213,431,21,30,Player A
241,Randy,195,245,440,24,28,Randy
242,Randy,250,225,475,29,18,Player A
243,Randy,194,244,438,22,28,Randy
244,Randy,243,213,456,25,23,Player A
245,Randy,189,254,443,21,26,Randy
246,Randy,245,220,465,31,22,Player A
247,Randy,230,205,435,22,29,Player A
248,Randy,228,218,446,15,23,Player A
249,Randy,242,237,479,30,17,Player A
250,Randy,228,193,421,20,33,Player A
251,Randy,207,252,459,25,22,Randy
252,Randy,230,240,470,27,19,Randy
253,Randy,199,259,458,27,23,Randy
254,Randy,226,231,457,26,23,Randy
255,Randy,179,259,438,19,27,Randy
256,Randy,210,265,475,29,18,Randy
257,Randy,222,187,409,26,39,Player A
258,Randy,230,230,460,23,21,Tie
259,Randy,221,251,472,32,20,Randy
260,Randy,241,221,462,28,22,Player A
261,Randy,224,219,443,27,28,Player A
262,Randy,213,253,466,23,19,Randy
263,Randy,212,227,439,26,29,Randy
264,Randy,219,269,488,33,15,Randy
265,Randy,216,221,437,18,27,Randy
266,Randy,243,213,456,22,22,Player A
267,Randy,220,235,455,24,23,Randy
268,Randy,224,234,458,24,22,Randy
269,Randy,224,214,438,31,31,Player A
270,Randy,208,248,456,28,24,Randy
271,Randy,235,240,475,29,18,Randy
272,Randy,246,211,457,29,24,Player A
273,Randy,216,226,442,23,27,Randy
274,Randy,209,234,443,21,26,Randy
275,Randy,171,276,447,25,26,Randy
276,Randy,241,211,452,27,25,Player A
277,Randy,179,249,428,18,30,Randy
278,Randy,239,219,458,27,23,Player A
279,Randy,212,227,439,23,28,Randy
280,Randy,226,211,437,21,28,Player A
281,Randy,284,204,488,27,13,Player A
282,Randy,212,212,424,17,31,Tie
283,Randy,203,208,411,25,38,Randy
284,Randy,237,217,454,20,22,Player A
285,Randy,214,229,443,18,25,Randy
286,Randy,223,233,456,25,23,Randy
287,Randy,201,216,417,22,35,Randy
288,Randy,237,217,454,26,24,Player A
289,Randy,246,221,467,27,20,Player A
290,Randy,212,242,454,23,23,Randy
291,Randy,241,221,462,31,23,Player A
292,Randy,203,218,421,23,34,Randy
293,Randy,210,245,455,27,24,Randy
294,Randy,236,211,447,25,26,Player A
295,Randy,244,239,483,31,16,Player A
296,Randy,246,196,442,23,27,Player A
297,Randy,242,217,459,37,26,Player A
298,Randy,239,229,468,25,19,Player A
299,Randy,235,225,460,26,22,Player A
300,Randy,227,242,469,29,20,Randy
301,Randy,222,232,454,32,26,Randy
302,Randy,222,247,469,26,19,Randy
303,Randy,204,229,433,20,29,Randy
304,Randy,193,238,431,27,32,Randy
305,Randy,229,229,458,24,22,Tie
306,Randy,173,268,441,19,26,Randy
307,Randy,248,203,451,20,23,Player A
308,Randy,248,208,456,28,24,Player A
309,Randy,202,257,459,28,23,Randy
310,Randy,219,239,458,33,25,Randy
311,Randy,207,222,429,22,31,Randy
312,Randy,190,245,435,19,28,Randy
313,Randy,249,209,458,27,23,Player A
314,Randy,227,227,454,26,24,Tie
315,Randy,214,229,443,21,26,Randy
316,Randy,236,206,442,26,28,Player A
317,Randy,221,216,437,24,29,Player A
318,Randy,232,242,474,28,18,Randy
319,Randy,220,235,455,33,26,Randy
320,Randy,211,256,467,33,22,Randy
321,Randy,228,248,476,27,17,Randy
322,Randy,196,256,452,21,23,Randy
323,Randy,238,213,451,20,23,Player A
324,Randy,233,228,461,24,21,Player A
325,Randy,219,199,418,20,34,Player A
326,Randy,212,227,439,26,29,Randy
327,Randy,252,207,459,28,23,Player A
328,Randy,205,230,435,19,28,Randy
329,Randy,219,254,473,33,20,Randy
330,Randy,229,229,458,24,22,Tie
331,Randy,230,235,465,37,24,Randy
332,Randy,211,241,452,18,22,Randy
333,Randy,237,197,434,24,30,Player A
334,Randy,235,230,465,28,21,Player A
335,Randy,251,216,467,30,21,Player A
336,Randy,215,235,450,28,26,Randy
337,Randy,224,254,478,32,18,Randy
338,Randy,273,198,471,31,20,Player A
339,Randy,234,244,478,26,16,Randy
340,Randy,240,205,445,23,26,Player A
341,Randy,215,230,445,20,25,Randy
342,Randy,218,193,411,19,36,Player A
343,Randy,229,199,428,24,32,Player A
344,Randy,242,227,469,26,19,Player A
345,Randy,235,210,445,20,25,Player A
346,Randy,236,226,462,25,21,Player A
347,Randy,208,228,436,26,30,Randy
348,Randy,228,208,436,26,30,Player A
349,Randy,207,247,454,29,25,Randy
350,Randy,170,245,415,20,35,Randy
351,Randy,225,245,470,24,18,Randy
352,Randy,208,243,451,26,25,Randy
353,Randy,228,193,421,23,34,Player A
354,Randy,238,213,451,23,24,Player A
355,Randy,238,213,451,29,26,Player A
356,Randy,225,230,455,21,22,Randy
357,Randy,236,201,437,18,27,Player A
358,Randy,234,219,453,28,25,Player A
359,Randy,230,220,450,25,25,Player A
360,Randy,205,255,460,26,22,Randy
361,Randy,207,232,439,20,27,Randy
362,Randy,229,219,448,26,26,Player A
363,Randy,236,201,437,24,29,Player A
364,Randy,206,221,427,26,33,Randy
365,Randy,240,220,460,29,23,Player A
366,Randy,252,202,454,23,23,Player A
367,Randy,224,229,453,25,24,Randy
368,Randy,214,224,438,22,28,Randy
369,Randy,237,227,464,24,20,Player A
370,Randy,245,220,465,25,20,Player A
371,Randy,256,206,462,28,22,Player A
372,Randy,235,200,435,25,30,Player A
373,Randy,193,238,431,21,30,Randy
374,Randy,231,236,467,27,20,Randy
375,Randy,227,222,449,21,24,Player A
376,Randy,210,225,435,19,28,Randy
377,Randy,231,196,427,29,34,Player A
378,Randy,204,234,438,19,27,Randy
379,Randy,231,231,462,25,21,Tie
380,Randy,173,243,416,21,35,Randy
381,Randy,223,233,456,28,24,Randy
382,Randy,227,217,444,25,27,Player A
383,Randy,234,239,473,33,20,Randy
384,Randy,199,229,428,21,31,Randy
385,Randy,237,217,454,23,23,Player A
386,Randy,247,212,459,25,22,Player A
387,Randy,211,261,472,32,20,Randy
388,Randy,258,208,466,29,21,Player A
389,Randy,217,222,439,23,28,Randy
390,Randy,233,208,441,22,27,Player A
391,Randy,246,196,442,26,28,Player A
392,Randy,226,211,437,27,30,Player A
393,Randy,204,224,428,24,32,Randy
394,Randy,221,241,462,22,20,Randy
395,Randy,214,244,458,18,20,Randy
396,Randy,224,209,433,29,32,Player A
397,Randy,238,208,446,21,25,Player A
398,Randy,216,221,437,24,29,Randy
399,Randy,212,222,434,24,30,Randy
400,Randy,223,253,476,24,16,Randy
401,Randy,210,225,435,28,31,Randy
402,Randy,224,239,463,32,23,Randy
403,Randy,250,185,435,22,29,Player A
404,Randy,226,226,452,30,26,Tie
405,Randy,250,195,445,29,28,Player A
406,Randy,220,240,460,26,22,Randy
407,Randy,236,226,462,25,21,Player A
408,Randy,224,259,483,34,17,Randy
409,Randy,224,214,438,19,27,Player A
410,Randy,228,228,456,25,23,Tie
411,Randy,220,240,460,26,22,Randy
412,Randy,232,207,439,20,27,Player A
413,Randy,248,213,461,30,23,Player A
414,Randy,225,225,450,19,23,Tie
415,Randy,198,243,441,19,26,Randy
416,Randy,212,232,444,28,28,Randy
417,Randy,197,262,459,25,22,Randy
418,Randy,219,219,438,25,29,Tie
419,Randy,185,245,430,20,30,Randy
420,Randy,200,250,450,28,26,Randy
421,Randy,231,221,452,27,25,Player A
422,Randy,220,215,435,22,29,Player A
423,Randy,216,241,457,26,23,Randy
424,Randy,245,195,440,21,27,Player A
425,Randy,236,226,462,25,21,Player A
426,Randy,213,243,456,25,23,Randy
427,Randy,213,238,451,26,25,Randy
428,Randy,222,212,434,21,29,Player A
429,Randy,263,203,466,20,18,Player A
430,Randy,254,174,428,21,31,Player A
431,Randy,243,208,451,26,25,Player A
432,Randy,204,229,433,26,31,Randy
433,Randy,249,209,458,33,25,Player A
434,Randy,243,193,436,29,31,Player A
435,Randy,202,232,434,21,29,Randy
436,Randy,209,239,448,23,25,Randy
437,Randy,226,221,447,19,24,Player A
438,Randy,197,247,444,25,27,Randy
439,Randy,182,252,434,24,30,Randy
440,Randy,223,248,471,34,21,Randy
441,Randy,225,245,470,33,21,Randy
442,Randy,246,216,462,28,22,Player A
443,Randy,225,225,450,28,26,Tie
444,Randy,229,234,463,26,21,Randy
445,Randy,203,248,451,26,25,Randy
446,Randy,246,236,482,27,15,Player A
447,Randy,229,239,468,19,17,Randy
448,Randy,267,172,439,26,29,Player A
449,Randy,236,211,447,25,26,Player A
450,Randy,192,267,459,25,22,Randy
451,Randy,270,185,455,24,23,Player A
452,Randy,195,220,415,17,34,Randy
453,Randy,239,224,463,26,21,Player A
454,Randy,221,261,482,30,16,Randy
455,Randy,217,217,434,27,31,Tie
456,Randy,216,236,452,21,23,Randy
457,Randy,224,204,428,21,31,Player A
458,Randy,219,239,458,24,22,Randy
459,Randy,235,235,470,30,20,Tie
460,Randy,227,222,449,27,26,Player A
461,Randy,234,224,458,24,22,Player A
462,Randy,212,252,464,27,21,Randy
463,Randy,225,250,475,26,17,Randy
464,Randy,188,268,456,25,23,Randy
465,Randy,216,236,452,27,25,Randy
466,Randy,213,223,436,20,28,Randy
467,Randy,209,224,433,23,30,Randy
468,Randy,234,219,453,25,24,Player A
469,Randy,199,244,443,24,27,Randy
470,Randy,246,206,452,24,24,Player A
471,Randy,233,228,461,21,20,Player A
472,Randy,233,258,491,36,15,Randy
473,Randy,215,235,450,28,26,Randy
474,Randy,241,241,482,33,17,Tie
475,Randy,212,237,449,36,29,Randy
476,Randy,239,219,458,33,25,Player A
477,Randy,221,221,442,29,29,Tie
478,Randy,223,213,436,17,27,Player A
479,Randy,222,237,459,22,21,Randy
480,Randy,222,212,434,24,30,Player A
481,Randy,227,242,469,29,20,Randy
482,Randy,235,225,460,32,24,Player A
483,Randy,204,249,453,28,25,Randy
484,Randy,215,220,435,25,30,Randy
485,Randy,232,222,454,26,24,Player A
486,Randy,200,265,465,28,21,Randy
487,Randy,234,224,458,30,24,Player A
488,Randy,213,193,406,20,38,Player A
489,Randy,210,245,455,24,23,Randy
490,Randy,248,183,431,24,31,Player A
491,Randy,232,232,464,30,22,Tie
492,Randy,249,209,458,27,23,Player A
493,Randy,188,258,446,24,26,Randy
494,Randy,209,229,438,25,29,Randy
495,Randy,232,217,449,18,23,Player A
496,Randy,247,187,434,15,27,Player A
497,Randy,216,196,412,20,36,Player A
498,Randy,218,228,446,18,24,Randy
499,Randy,228,198,426,19,31,Player A
500,Randy,226,226,452,24,24,Tie
501,Randy,223,213,436,23,29,Player A
502,Randy,232,217,449,30,27,Player A
503,Randy,211,231,442,26,28,Randy
504,Randy,195,255,450,25,25,Randy
505,Randy,221,211,432,19,29,Player A
506,Randy,229,219,448,26,26,Player A
507,Randy,220,230,450,28,26,Randy
508,Randy,234,219,453,22,23,Player A
509,Randy,227,252,479,36,19,Randy
510,Randy,231,221,452,24,24,Player A
511,Randy,184,249,433,20,29,Randy
512,Randy,241,211,452,27,25,Player A
513,Randy,213,208,421,20,33,Player A
514,Randy,222,242,464,33,23,Randy
515,Randy,180,255,435,25,30,Randy
516,Randy,230,220,450,31,27,Player A
517,Randy,217,217,434,21,29,Tie
518,Randy,243,213,456,25,23,Player A
519,Randy,218,253,471,34,21,Randy
520,Randy,225,230,455,21,22,Randy
521,Randy,243,188,431,15,28,Player A
522,Randy,220,225,445,20,25,Randy
523,Randy,236,226,462,19,19,Player A
524,Randy,230,215,445,23,26,Player A
525,Randy,237,207,444,25,27,Player A
526,Randy,219,224,443,30,29,Randy
527,Randy,198,233,431,24,31,Randy
528,Randy,222,247,469,32,21,Randy
529,Randy,185,245,430,17,29,Randy
530,Randy,236,226,462,31,23,Player A
531,Randy,256,206,462,31,23,Player A
532,Randy,205,225,430,17,29,Randy
533,Randy,187,252,439,26,29,Randy
534,Randy,218,223,441,25,28,Randy
535,Randy,217,232,449,21,24,Randy
536,Randy,245,205,450,19,23,Player A
537,Randy,197,257,454,23,23,Randy
538,Randy,223,223,446,27,27,Tie
539,Randy,248,213,461,30,23,Player A
540,Randy,211,231,442,23,27,Randy
541,Randy,206,241,447,28,27,Randy
542,Randy,218,213,431,27,32,Player A
543,Randy,224,224,448,23,25,Tie
544,Randy,272,172,444,19,25,Player A
545,Randy,231,206,437,24,29,Player A
546,Randy,230,225,455,21,22,Player A
547,Randy,242,217,459,28,23,Player A
548,Randy,207,222,429,28,33,Randy
549,Randy,172,262,434,27,31,Randy
550,Randy,192,247,439,23,28,Randy
551,Randy,228,213,441,25,28,Player A
552,Randy,226,246,472,23,17,Randy
553,Randy,211,231,442,26,28,Randy
554,Randy,261,176,437,18,27,Player A
555,Randy,223,218,441,19,26,Player A
556,Randy,219,229,448,26,26,Randy
557,Randy,216,236,452,21,23,Randy
558,Randy,204,239,443,27,28,Randy
559,Randy,232,227,459,25,22,Player A
560,Randy,236,226,462,19,19,Player A
561,Randy,219,224,443,30,29,Randy
562,Randy,221,236,457,20,21,Randy
563,Randy,248,198,446,24,26,Player A
564,Randy,209,224,433,20,29,Randy
565,Randy,195,250,445,26,27,Randy
566,Randy,183,258,441,31,30,Randy
567,Randy,230,225,455,21,22,Player A
568,Randy,227,222,449,30,27,Player A
569,Randy,249,199,448,26,26,Player A
570,Randy,240,205,445,29,28,Player A
571,Randy,237,217,454,23,23,Player A
572,Randy,225,225,450,25,25,Tie
573,Randy,265,200,465,28,21,Player A
574,Randy,189,244,433,23,30,Randy
575,Randy,203,223,426,19,31,Randy
576,Randy,235,225,460,23,21,Player A
577,Randy,228,228,456,25,23,Tie
578,Randy,259,229,488,27,13,Player A
579,Randy,234,219,453,28,25,Player A
580,Randy,227,242,469,32,21,Randy
581,Randy,255,235,490,35,15,Player A
582,Randy,230,235,465,22,19,Randy
583,Randy,244,219,463,23,20,Player A
584,Randy,221,221,442,23,27,Tie
585,Randy,254,204,458,24,22,Player A
586,Randy,256,206,462,28,22,Player A
587,Randy,214,229,443,24,27,Randy
588,Randy,207,237,444,25,27,Randy
589,Randy,217,247,464,21,19,Randy
590,Randy,214,234,448,20,24,Randy
591,Randy,241,226,467,36,23,Player A
592,Randy,213,248,461,33,24,Randy
593,Randy,260,195,455,24,23,Player A
594,Randy,210,225,435,19,28,Randy
595,Randy,215,245,460,29,23,Randy
596,Randy,213,223,436,26,30,Randy
597,Randy,214,229,443,30,29,Randy
598,Randy,210,240,450,25,25,Randy
599,Randy,248,233,481,29,16,Player A
600,Randy,240,215,455,27,24,Player A
601,Randy,208,238,446,30,28,Randy
602,Randy,210,235,445,29,28,Randy
603,Randy,222,232,454,26,24,Randy
604,Randy,209,244,453,25,24,Randy
605,Randy,244,219,463,29,22,Player A
606,Randy,235,210,445,23,26,Player A
607,Randy,242,222,464,30,22,Player A
608,Randy,238,203,441,28,29,Player A
609,Randy,230,235,465,28,21,Randy
610,Randy,240,225,465,31,22,Player A
611,Randy,214,224,438,25,29,Randy
612,Randy,214,239,453,25,24,Randy
613,Randy,194,254,448,26,26,Randy
614,Randy,235,205,440,18,26,Player A
615,Randy,215,240,455,27,24,Randy
616,Randy,219,234,453,25,24,Randy
617,Randy,202,242,444,22,26,Randy
618,Randy,214,254,468,25,19,Randy
619,Randy,212,227,439,23,28,Randy
620,Randy,250,220,470,30,20,Player A
621,Randy,223,218,441,25,28,Player A
622,Randy,244,199,443,21,26,Player A
623,Randy,225,225,450,25,25,Tie
624,Randy,197,257,454,26,24,Randy
625,Randy,181,251,432,19,29,Randy
626,Randy,224,214,438,19,27,Player A
627,Randy,204,214,418,14,32,Randy
628,Randy,203,243,446,30,28,Randy
629,Randy,251,191,442,32,30,Player A
630,Randy,250,205,455,27,24,Player A
631,Randy,222,232,454,29,25,Randy
632,Randy,199,229,428,24,32,Randy
633,Randy,199,244,443,27,28,Randy
634,Randy,226,201,427,26,33,Player A
635,Randy,233,218,451,29,26,Player A
636,Randy,210,235,445,23,26,Randy
637,Randy,228,223,451,29,26,Player A
638,Randy,187,252,439,23,28,Randy
639,Randy,219,219,438,22,28,Tie
640,Randy,225,225,450,22,24,Tie
641,Randy,249,194,443,21,26,Player A
642,Randy,221,226,447,19,24,Randy
643,Randy,235,195,430,20,30,Player A
644,Randy,252,182,434,18,28,Player A
645,Randy,219,239,458,30,24,Randy
646,Randy,221,246,467,27,20,Randy
647,Randy,225,215,440,21,27,Player A
648,Randy,191,226,417,19,34,Randy
649,Randy,216,201,417,16,33,Player A
650,Randy,232,227,459,28,23,Player A
651,Randy,262,197,459,31,24,Player A
652,Randy,210,225,435,22,29,Randy
653,Randy,200,245,445,23,26,Randy
654,Randy,241,201,442,20,26,Player A
655,Randy,215,255,470,24,18,Randy
656,Randy,239,194,433,23,30,Player A
657,Randy,228,218,446,24,26,Player A
658,Randy,217,222,439,23,28,Randy
659,Randy,236,236,472,29,19,Tie
660,Randy,230,210,440,18,26,Player A
661,Randy,221,236,457,26,23,Randy
662,Randy,227,252,479,30,17,Randy
663,Randy,222,237,459,31,24,Randy
664,Randy,217,247,464,27,21,Randy
665,Randy,201,231,432,19,29,Randy
666,Randy,236,236,472,26,18,Tie
667,Randy,220,220,440,30,30,Tie
668,Randy,232,222,454,26,24,Player A
669,Randy,216,256,472,29,19,Randy
670,Randy,228,243,471,25,18,Randy
671,Randy,244,209,453,22,23,Player A
672,Randy,239,224,463,26,21,Player A
673,Randy,186,261,447,25,26,Randy
674,Randy,230,205,435,25,30,Player A
675,Randy,211,226,437,18,27,Randy
676,Randy,222,217,439,20,27,Player A
677,Randy,214,224,438,19,27,Randy
678,Randy,252,202,454,23,23,Player A
679,Randy,213,218,431,18,29,Randy
680,Randy,229,204,433,20,29,Player A
681,Randy,213,218,431,24,31,Randy
682,Randy,244,214,458,27,23,Player A
683,Randy,237,212,449,27,26,Player A
684,Randy,255,195,450,19,23,Player A
685,Randy,258,188,446,24,26,Player A
686,Randy,221,236,457,26,23,Randy
687,Randy,219,234,453,28,25,Randy
688,Randy,229,244,473,33,20,Randy
689,Randy,204,234,438,25,29,Randy
690,Randy,176,261,437,24,29,Randy
691,Randy,241,191,432,25,31,Player A
692,Randy,210,225,435,25,30,Randy
693,Randy,256,196,452,27,25,Player A
694,Randy,237,197,434,18,28,Player A
695,Randy,255,210,465,22,19,Player A
696,Randy,208,228,436,20,28,Randy
697,Randy,229,229,458,30,24,Tie
698,Randy,246,211,457,26,23,Player A
699,Randy,210,240,450,28,26,Randy
700,Randy,237,237,474,28,18,Tie
701,Randy,231,211,442,26,28,Player A
702,Randy,218,223,441,22,27,Randy
703,Randy,204,239,443,27,28,Randy
704,Randy,209,249,458,24,22,Randy
705,Randy,223,223,446,27,27,Tie
706,Randy,220,220,440,27,29,Tie
707,Randy,174,259,433,20,29,Randy
708,Randy,211,226,437,15,26,Randy
709,Randy,204,254,458,27,23,Randy
710,Randy,266,186,452,27,25,Player A
711,Randy,237,222,459,25,22,Player A
712,Randy,224,239,463,35,24,Randy
713,Randy,222,242,464,27,21,Randy
714,Randy,225,210,435,25,30,Player A
715,Randy,246,201,447,28,27,Player A
716,Randy,241,221,462,28,22,Player A
717,Randy,186,241,427,17,30,Randy
718,Randy,192,242,434,15,27,Randy
719,Randy,214,229,443,27,28,Randy
720,Randy,204,209,413,27,38,Randy
721,Randy,236,221,457,26,23,Player A
722,Randy,237,227,464,30,22,Player A
723,Randy,212,232,444,31,29,Randy
724,Randy,204,209,413,21,36,Randy
725,Randy,220,235,455,24,23,Randy
726,Randy,239,209,448,26,26,Player A
727,Randy,201,251,452,21,23,Randy
728,Randy,232,212,444,28,28,Player A
729,Randy,191,246,437,21,28,Randy
730,Randy,179,259,438,16,26,Randy
731,Randy,235,230,465,22,19,Player A
732,Randy,249,214,463,32,23,Player A
733,Randy,239,214,453,28,25,Player A
734,Randy,260,185,445,29,28,Player A
735,Randy,225,240,465,25,20,Randy
736,Randy,250,210,460,26,22,Player A
737,Randy,243,218,461,21,20,Player A
738,Randy,241,236,477,31,18,Player A
739,Randy,219,234,453,22,23,Randy
740,Randy,220,210,430,26,32,Player A
741,Randy,219,214,433,23,30,Player A
742,Randy,221,216,437,24,29,Player A
743,Randy,238,213,451,20,23,Player A
744,Randy,225,220,445,23,26,Player A
745,Randy,252,197,449,30,27,Player A
746,Randy,214,254,468,37,23,Randy
747,Randy,237,232,469,26,19,Player A
748,Randy,221,226,447,28,27,Randy
749,Randy,214,249,463,29,22,Randy
750,Randy,231,201,432,16,28,Player A
751,Randy,203,243,446,24,26,Randy
752,Randy,228,218,446,24,26,Player A
753,Randy,243,188,431,24,31,Player A
754,Randy,233,208,441,22,27,Player A
755,Randy,235,200,435,25,30,Player A
756,Randy,239,209,448,23,25,Player A
757,Randy,217,207,424,17,31,Player A
758,Randy,207,257,464,30,22,Randy
759,Randy,248,218,466,32,22,Player A
760,Randy,247,207,454,29,25,Player A
761,Randy,243,228,471,34,21,Player A
762,Randy,209,249,458,24,22,Randy
763,Randy,213,213,426,25,33,Tie
764,Randy,241,206,447,19,24,Player A
765,Randy,212,242,454,35,27,Randy
766,Randy,234,224,458,27,23,Player A
767,Randy,228,233,461,30,23,Randy
768,Randy,244,224,468,22,18,Player A
769,Randy,251,201,452,24,24,Player A
770,Randy,210,235,445,26,27,Randy
771,Randy,248,178,426,22,32,Player A
772,Randy,251,201,452,24,24,Player A
773,Randy,194,269,463,17,18,Randy
774,Randy,224,224,448,26,26,Tie
775,Randy,213,238,451,29,26,Randy
776,Randy,254,209,463,29,22,Player A
777,Randy,213,233,446,24,26,Randy
778,Randy,250,205,455,27,24,Player A
779,Randy,219,239,458,27,23,Randy
780,Randy,224,249,473,27,18,Randy
781,Randy,239,204,443,18,25,Player A
782,Randy,246,206,452,21,23,Player A
783,Randy,226,251,477,31,18,Randy
784,Randy,192,232,424,17,31,Randy
785,Randy,189,264,453,19,22,Randy
786,Randy,192,237,429,28,33,Randy
787,Randy,247,217,464,24,20,Player A
788,Randy,263,193,456,28,24,Player A
789,Randy,218,238,456,28,24,Randy
790,Randy,238,243,481,32,17,Randy
791,Randy,198,253,451,20,23,Randy
792,Randy,216,246,462,25,21,Randy
793,Randy,232,212,444,31,29,Player A
794,Randy,232,222,454,32,26,Player A
795,Randy,197,247,444,28,28,Randy
796,Randy,263,178,441,25,28,Player A
797,Randy,233,218,451,29,26,Player A
798,Randy,209,249,458,21,21,Randy
799,Randy,242,217,459,28,23,Player A
800,Randy,216,231,447,25,26,Randy
801,Randy,195,230,425,27,34,Randy
802,Randy,228,243,471,25,18,Randy
803,Randy,225,210,435,22,29,Player A
804,Randy,217,207,424,20,32,Player A
805,Randy,242,207,449,24,25,Player A
806,Randy,232,232,464,27,21,Tie
807,Randy,212,237,449,24,25,Randy
808,Randy,233,198,431,21,30,Player A
809,Randy,243,203,446,21,25,Player A
810,Randy,201,251,452,27,25,Randy
811,Randy,221,226,447,25,26,Randy
812,Randy,211,241,452,30,26,Randy
813,Randy,248,203,451,35,28,Player A
814,Randy,249,194,443,24,27,Player A
815,Randy,204,254,458,21,21,Randy
816,Randy,229,214,443,24,27,Player A
817,Randy,250,175,425,21,32,Player A
818,Randy,205,235,440,21,27,Randy
819,Randy,191,271,462,34,24,Randy
820,Randy,240,205,445,23,26,Player A
821,Randy,198,218,416,21,35,Randy
822,Randy,201,251,452,30,26,Randy
823,Randy,247,227,474,37,21,Player A
824,Randy,248,188,436,17,27,Player A
825,Randy,249,194,443,27,28,Player A
826,Randy,249,219,468,31,21,Player A
827,Randy,206,251,457,29,24,Randy
828,Randy,212,232,444,19,25,Randy
829,Randy,243,183,426,19,31,Player A
830,Randy,208,263,471,22,17,Randy
831,Randy,232,237,469,29,20,Randy
832,Randy,235,215,450,25,25,Player A
833,Randy,212,237,449,21,24,Randy
834,Randy,247,182,429,22,31,Player A
835,Randy,259,199,458,21,21,Player A
836,Randy,179,254,433,17,28,Randy
837,Randy,220,220,440,27,29,Tie
838,Randy,241,201,442,23,27,Player A
839,Randy,220,255,475,32,19,Randy
840,Randy,209,239,448,26,26,Randy
841,Randy,227,227,454,26,24,Tie
842,Randy,222,202,424,20,32,Player A
843,Randy,219,244,463,32,23,Randy
844,Randy,211,241,452,24,24,Randy
845,Randy,248,203,451,29,26,Player A
846,Randy,195,200,395,18,41,Randy
847,Randy,234,229,463,29,22,Player A
848,Randy,201,231,432,22,30,Randy
849,Randy,220,250,470,24,18,Randy
850,Randy,231,226,457,23,22,Player A
851,Randy,237,212,449,21,24,Player A
852,Randy,189,239,428,18,30,Randy
853,Randy,227,222,449,24,25,Player A
854,Randy,205,255,460,29,23,Randy
855,Randy,207,257,464,33,23,Randy
856,Randy,221,221,442,26,28,Tie
857,Randy,224,204,428,21,31,Player A
858,Randy,216,266,482,30,16,Randy
859,Randy,202,227,429,25,32,Randy
860,Randy,224,229,453,25,24,Randy
861,Randy,216,261,477,28,17,Randy
862,Randy,228,233,461,27,22,Randy
863,Randy,214,234,448,35,29,Randy
864,Randy,200,255,455,27,24,Randy
865,Randy,223,248,471,28,19,Randy
866,Randy,233,218,451,23,24,Player A
867,Randy,228,223,451,29,26,Player A
868,Randy,258,183,441,25,28,Player A
869,Randy,229,224,453,25,24,Player A
870,Randy,252,217,469,32,21,Player A
871,Randy,235,220,455,27,24,Player A
872,Randy,229,209,438,19,27,Player A
873,Randy,244,219,463,26,21,Player A
874,Randy,215,215,430,26,32,Tie
875,Randy,220,250,470,24,18,Randy
876,Randy,224,219,443,27,28,Player A
877,Randy,215,235,450,28,26,Randy
878,Randy,219,224,443,21,26,Randy
879,Randy,217,222,439,23,28,Randy
880,Randy,226,216,442,23,27,Player A
881,Randy,246,191,437,24,29,Player A
882,Randy,256,191,447,25,26,Player A
883,Randy,229,199,428,24,32,Player A
884,Randy,264,194,458,27,23,Player A
885,Randy,264,199,463,26,21,Player A
886,Randy,206,226,432,19,29,Randy
887,Randy,240,215,455,24,23,Player A
888,Randy,276,196,472,26,18,Player A
889,Randy,216,241,457,26,23,Randy
890,Randy,224,204,428,27,33,Player A
891,Randy,197,252,449,24,25,Randy
892,Randy,232,212,444,28,28,Player A
893,Randy,231,211,442,26,28,Player A
894,Randy,232,227,459,31,24,Player A
895,Randy,226,226,452,27,25,Tie
896,Randy,222,197,419,21,34,Player A
897,Randy,206,226,432,22,30,Randy
898,Randy,225,250,475,29,18,Randy
899,Randy,213,238,451,23,24,Randy
900,Randy,224,234,458,30,24,Randy
901,Randy,239,219,458,24,22,Player A
902,Randy,245,225,470,30,20,Player A
903,Randy,231,241,472,29,19,Randy
904,Randy,224,234,458,24,22,Randy
905,Randy,227,222,449,21,24,Player A
906,Randy,235,225,460,20,20,Player A
907,Randy,253,193,446,27,27,Player A
908,Randy,241,201,442,17,25,Player A
909,Randy,254,224,478,32,18,Player A
910,Randy,224,234,458,24,22,Randy
911,Randy,233,238,471,31,20,Randy
912,Randy,240,205,445,29,28,Player A
913,Randy,263,223,486,37,17,Player A
914,Randy,204,249,453,28,25,Randy
915,Randy,252,212,464,27,21,Player A
916,Randy,187,287,474,22,16,Randy
917,Randy,256,211,467,27,20,Player A
918,Randy,233,183,416,18,34,Player A
919,Randy,266,196,462,25,21,Player A
920,Randy,238,208,446,27,27,Player A
921,Randy,221,221,442,29,29,Tie
922,Randy,263,198,461,24,21,Player A
923,Randy,228,233,461,21,20,Randy
924,Randy,215,235,450,28,26,Randy
925,Randy,223,228,451,23,24,Randy
926,Randy,210,250,460,29,23,Randy
927,Randy,251,181,432,25,31,Player A
928,Randy,235,215,450,28,26,Player A
929,Randy,221,226,447,22,25,Randy
930,Randy,205,215,420,16,32,Randy
931,Randy,244,209,453,19,22,Player A
932,Randy,218,228,446,24,26,Randy
933,Randy,254,194,448,26,26,Player A
934,Randy,235,220,455,24,23,Player A
935,Randy,251,226,477,31,18,Player A
936,Randy,228,223,451,26,25,Player A
937,Randy,265,210,475,32,19,Player A
938,Randy,232,212,444,22,26,Player A
939,Randy,222,272,494,33,13,Randy
940,Randy,218,228,446,24,26,Randy
941,Randy,209,224,433,26,31,Randy
942,Randy,213,233,446,30,28,Randy
943,Randy,225,240,465,28,21,Randy
944,Randy,255,210,465,28,21,Player A
945,Randy,200,255,455,24,23,Randy
946,Randy,234,214,448,26,26,Player A
947,Randy,230,210,440,27,29,Player A
948,Randy,237,207,444,22,26,Player A
949,Randy,215,240,455,24,23,Randy
950,Randy,217,232,449,24,25,Randy
951,Randy,196,246,442,20,26,Randy
952,Randy,233,228,461,30,23,Player A
953,Randy,229,234,463,29,22,Randy
954,Randy,266,181,447,19,24,Player A
955,Randy,237,227,464,30,22,Player A
956,Randy,190,255,445,23,26,Randy
957,Randy,170,265,435,22,29,Randy
958,Randy,193,228,421,23,34,Randy
959,Randy,195,245,440,27,29,Randy
960,Randy,221,231,452,21,23,Randy
961,Randy,192,267,459,19,20,Randy
962,Randy,215,235,450,25,25,Randy
963,Randy,214,234,448,26,26,Randy
964,Randy,225,230,455,27,24,Randy
965,Randy,276,176,452,21,23,Player A
966,Randy,217,227,444,28,28,Randy
967,Randy,248,238,486,43,19,Player A
968,Randy,212,232,444,25,27,Randy
969,Randy,239,214,453,25,24,Player A
970,Randy,218,243,461,27,22,Randy
971,Randy,201,261,462,31,23,Randy
972,Randy,217,227,444,22,26,Randy
973,Randy,227,207,434,27,31,Player A
974,Randy,214,224,438,22,28,Randy
975,Randy,200,260,460,29,23,Randy
976,Randy,256,216,472,23,17,Player A
977,Randy,246,201,447,22,25,Player A
978,Randy,240,245,485,30,15,Randy
979,Randy,238,208,446,21,25,Player A
980,Randy,212,227,439,26,29,Randy
981,Randy,239,214,453,31,26,Player A
982,Randy,182,287,469,32,21,Randy
983,Randy,190,260,450,25,25,Randy
984,Randy,218,223,441,28,29,Randy
985,Randy,233,233,466,29,21,Tie
986,Randy,210,240,450,28,26,Randy
987,Randy,206,251,457,23,22,Randy
988,Randy,229,214,443,27,28,Player A
989,Randy,222,232,454,29,25,Randy
990,Randy,189,264,453,25,24,Randy
991,Randy,242,197,439,23,28,Player A
992,Randy,204,229,433,20,29,Randy
993,Randy,201,256,457,23,22,Randy
994,Randy,214,234,448,23,25,Randy
995,Randy,229,214,443,18,25,Player A
996,Randy,257,202,459,34,25,Player A
997,Randy,200,235,435,19,28,Randy
998,Randy,241,236,477,31,18,Player A
999,Randy,236,206,442,23,27,Player A
1000,Randy,208,218,426,22,32,Randy
1001,Randy,220,230,450,28,26,Randy
1002,Randy,249,214,463,23,20,Player A
1003,Randy,214,229,443,18,25,Randy
1004,Randy,198,248,446,24,26,Randy
1005,Randy,224,219,443,18,25,Player A
1006,Randy,212,237,449,24,25,Randy
1007,Randy,221,231,452,24,24,Randy
1008,Randy,249,189,438,19,27,Player A
1009,Randy,273,213,486,34,16,Player A
1010,Randy,242,192,434,21,29,Player A
1011,Randy,230,200,430,20,30,Player A
1012,Randy,287,177,464,27,21,Player A
1013,Randy,260,175,435,25,30,Player A
1014,Randy,260,190,450,28,26,Player A
1015,Randy,256,206,462,25,21,Player A
1016,Randy,216,221,437,18,27,Randy
1017,Randy,236,216,452,36,28,Player A
1018,Randy,231,221,452,30,26,Player A
1019,Randy,229,254,483,34,17,Randy
1020,Randy,193,213,406,20,38,Randy
1021,Randy,230,225,455,24,23,Player A
1022,Randy,213,213,426,16,30,Tie
1023,Randy,228,223,451,26,25,Player A
1024,Randy,220,235,455,24,23,Randy
1025,Randy,232,232,464,27,21,Tie
1026,Randy,204,249,453,25,24,Randy
1027,Randy,215,245,460,26,22,Randy
1028,Randy,240,210,450,22,24,Player A
1029,Randy,225,220,445,26,27,Player A
1030,Randy,269,184,453,22,23,Player A
1031,Randy,228,228,456,28,24,Tie
1032,Randy,224,214,438,22,28,Player A
1033,Randy,235,225,460,23,21,Player A
