Game,Opponent,PlayerA_Score,PlayerB_Score,Cumulative_Score,CCs,DDs,Winner
0,QLearningPlayer,204,209,413,21,36,QLearningPlayer
1,QLearningPlayer,221,221,442,23,27,Tie
2,QLearningPlayer,235,235,470,33,21,Tie
3,QLearningPlayer,235,230,465,31,22,Player A
4,QLearningPlayer,221,221,442,23,27,Tie
5,QLearningPlayer,239,239,478,32,18,Tie
6,QLearningPlayer,231,231,462,28,22,Tie
7,QLearningPlayer,221,221,442,23,27,Tie
8,QLearningPlayer,224,224,448,26,26,Tie
9,QLearningPlayer,219,224,443,27,28,QLearningPlayer
10,QLearningPlayer,220,220,440,18,26,Tie
11,QLearningPlayer,213,208,421,26,35,Player A
12,QLearningPlayer,229,234,463,29,22,QLearningPlayer
13,QLearningPlayer,225,225,450,28,26,Tie
14,QLearningPlayer,216,211,427,20,31,Player A
15,QLearningPlayer,218,223,441,22,27,QLearningPlayer
16,QLearningPlayer,216,216,432,22,30,Tie
17,QLearningPlayer,222,217,439,23,28,Player A
18,QLearningPlayer,233,238,471,25,18,QLearningPlayer
19,QLearningPlayer,225,225,450,28,26,Tie
20,QLearningPlayer,219,219,438,25,29,Tie
21,QLearningPlayer,235,230,465,28,21,Player A
22,QLearningPlayer,213,213,426,16,30,Tie
23,QLearningPlayer,234,234,468,34,22,Tie
24,QLearningPlayer,230,230,460,35,25,Tie
25,QLearningPlayer,222,222,444,28,28,Tie
26,QLearningPlayer,231,231,462,28,22,Tie
27,QLearningPlayer,227,232,459,25,22,QLearningPlayer
28,QLearningPlayer,217,212,429,22,31,Player A
29,QLearningPlayer,212,217,429,19,30,QLearningPlayer
30,QLearningPlayer,236,236,472,29,19,Tie
31,QLearningPlayer,211,206,417,25,36,Player A
32,QLearningPlayer,241,246,487,35,16,QLearningPlayer
33,QLearningPlayer,222,222,444,28,28,Tie
34,QLearningPlayer,229,224,453,31,26,Player A
35,QLearningPlayer,235,240,475,26,17,QLearningPlayer
36,QLearningPlayer,223,218,441,22,27,Player A
37,QLearningPlayer,209,209,418,26,36,Tie
38,QLearningPlayer,221,226,447,28,27,QLearningPlayer
39,QLearningPlayer,240,240,480,31,17,Tie
40,QLearningPlayer,227,222,449,24,25,Player A
41,QLearningPlayer,238,243,481,35,18,QLearningPlayer
42,QLearningPlayer,253,248,501,34,11,Player A
43,QLearningPlayer,221,221,442,20,26,Tie
44,QLearningPlayer,229,234,463,23,20,QLearningPlayer
45,QLearningPlayer,229,229,458,27,23,Tie
46,QLearningPlayer,211,211,422,18,32,Tie
47,QLearningPlayer,226,221,447,31,28,Player A
48,QLearningPlayer,226,231,457,23,22,QLearningPlayer
49,QLearningPlayer,229,224,453,31,26,Player A
50,QLearningPlayer,228,233,461,27,22,QLearningPlayer
51,QLearningPlayer,247,242,489,31,14,Player A
52,QLearningPlayer,215,215,430,17,29,Tie
53,QLearningPlayer,217,217,434,24,30,Tie
54,QLearningPlayer,214,214,428,18,30,Tie
55,QLearningPlayer,231,236,467,33,22,QLearningPlayer
56,QLearningPlayer,229,224,453,28,25,Player A
57,QLearningPlayer,215,220,435,22,29,QLearningPlayer
58,QLearningPlayer,228,228,456,22,22,Tie
59,QLearningPlayer,241,236,477,34,19,Player A
60,QLearningPlayer,221,226,447,25,26,QLearningPlayer
61,QLearningPlayer,224,224,448,17,23,Tie
62,QLearningPlayer,225,225,450,22,24,Tie
63,QLearningPlayer,235,235,470,24,18,Tie
64,QLearningPlayer,245,240,485,30,15,Player A
65,QLearningPlayer,218,223,441,19,26,QLearningPlayer
66,QLearningPlayer,217,217,434,21,29,Tie
67,QLearningPlayer,227,222,449,24,25,Player A
68,QLearningPlayer,224,224,448,23,25,Tie
69,QLearningPlayer,221,226,447,25,26,QLearningPlayer
70,QLearningPlayer,238,233,471,31,20,Player A
71,QLearningPlayer,223,228,451,29,26,QLearningPlayer
72,QLearningPlayer,237,237,474,34,20,Tie
73,QLearningPlayer,229,224,453,22,23,Player A
74,QLearningPlayer,225,230,455,27,24,QLearningPlayer
75,QLearningPlayer,220,220,440,24,28,Tie
76,QLearningPlayer,233,228,461,33,24,Player A
77,QLearningPlayer,236,241,477,28,17,QLearningPlayer
78,QLearningPlayer,232,232,464,27,21,Tie
79,QLearningPlayer,221,221,442,20,26,Tie
80,QLearningPlayer,237,232,469,26,19,Player A
81,QLearningPlayer,212,217,429,16,29,QLearningPlayer
82,QLearningPlayer,213,208,421,20,33,Player A
83,QLearningPlayer,232,232,464,24,20,Tie
84,QLearningPlayer,204,204,408,19,37,Tie
85,QLearningPlayer,225,225,450,22,24,Tie
86,QLearningPlayer,228,228,456,25,23,Tie
87,QLearningPlayer,227,232,459,25,22,QLearningPlayer
88,QLearningPlayer,227,222,449,21,24,Player A
89,QLearningPlayer,215,220,435,19,28,QLearningPlayer
90,QLearningPlayer,221,221,442,26,28,Tie
91,QLearningPlayer,203,198,401,21,40,Player A
92,QLearningPlayer,224,229,453,28,25,QLearningPlayer
93,QLearningPlayer,233,233,466,35,23,Tie
94,QLearningPlayer,235,235,470,30,20,Tie
95,QLearningPlayer,220,215,435,19,28,Player A
96,QLearningPlayer,207,212,419,18,33,QLearningPlayer
97,QLearningPlayer,219,214,433,26,31,Player A
98,QLearningPlayer,234,239,473,30,19,QLearningPlayer
99,QLearningPlayer,235,235,470,24,18,Tie
100,QLearningPlayer,232,232,464,30,22,Tie
101,QLearningPlayer,219,219,438,25,29,Tie
102,QLearningPlayer,221,216,437,18,27,Player A
103,QLearningPlayer,220,225,445,26,27,QLearningPlayer
104,QLearningPlayer,237,237,474,34,20,Tie
105,QLearningPlayer,219,219,438,25,29,Tie
106,QLearningPlayer,230,230,460,29,23,Tie
107,QLearningPlayer,226,221,447,25,26,Player A
108,QLearningPlayer,222,227,449,27,26,QLearningPlayer
109,QLearningPlayer,223,223,446,24,26,Tie
110,QLearningPlayer,220,220,440,21,27,Tie
111,QLearningPlayer,230,230,460,20,20,Tie
112,QLearningPlayer,220,220,440,27,29,Tie
113,QLearningPlayer,242,242,484,44,20,Tie
114,QLearningPlayer,232,232,464,27,21,Tie
115,QLearningPlayer,231,231,462,28,22,Tie
116,QLearningPlayer,231,226,457,23,22,Player A
117,QLearningPlayer,233,238,471,40,23,QLearningPlayer
118,QLearningPlayer,208,208,416,15,33,Tie
119,QLearningPlayer,238,233,471,28,19,Player A
120,QLearningPlayer,231,236,467,39,24,QLearningPlayer
121,QLearningPlayer,226,226,452,24,24,Tie
122,QLearningPlayer,221,221,442,29,29,Tie
123,QLearningPlayer,238,238,476,33,19,Tie
124,QLearningPlayer,215,215,430,20,30,Tie
125,QLearningPlayer,220,220,440,27,29,Tie
126,QLearningPlayer,231,226,457,26,23,Player A
127,QLearningPlayer,210,210,420,19,33,Tie
128,QLearningPlayer,226,226,452,24,24,Tie
129,QLearningPlayer,211,211,422,15,31,Tie
130,QLearningPlayer,220,225,445,26,27,QLearningPlayer
131,QLearningPlayer,212,212,424,17,31,Tie
132,QLearningPlayer,231,231,462,28,22,Tie
133,QLearningPlayer,208,208,416,18,34,Tie
134,QLearningPlayer,245,245,490,32,14,Tie
135,QLearningPlayer,218,218,436,14,26,Tie
136,QLearningPlayer,226,226,452,24,24,Tie
137,QLearningPlayer,222,222,444,25,27,Tie
138,QLearningPlayer,221,216,437,27,30,Player A
139,QLearningPlayer,240,240,480,34,18,Tie
140,QLearningPlayer,220,220,440,18,26,Tie
141,QLearningPlayer,236,236,472,26,18,Tie
142,QLearningPlayer,207,212,419,21,34,QLearningPlayer
143,QLearningPlayer,216,211,427,20,31,Player A
144,QLearningPlayer,250,250,500,42,14,Tie
145,QLearningPlayer,237,237,474,31,19,Tie
146,QLearningPlayer,213,218,431,18,29,QLearningPlayer
147,QLearningPlayer,236,236,472,29,19,Tie
148,QLearningPlayer,237,232,469,29,20,Player A
149,QLearningPlayer,217,217,434,15,27,Tie
150,QLearningPlayer,225,225,450,28,26,Tie
151,QLearningPlayer,233,238,471,28,19,QLearningPlayer
152,QLearningPlayer,238,233,471,28,19,Player A
153,QLearningPlayer,207,212,419,24,35,QLearningPlayer
154,QLearningPlayer,213,208,421,20,33,Player A
155,QLearningPlayer,237,237,474,25,17,Tie
156,QLearningPlayer,233,233,466,23,19,Tie
157,QLearningPlayer,230,235,465,22,19,QLearningPlayer
158,QLearningPlayer,222,217,439,23,28,Player A
159,QLearningPlayer,234,234,468,28,20,Tie
160,QLearningPlayer,239,239,478,29,17,Tie
161,QLearningPlayer,212,212,424,20,32,Tie
162,QLearningPlayer,236,241,477,28,17,QLearningPlayer
163,QLearningPlayer,207,202,409,14,35,Player A
164,QLearningPlayer,225,230,455,24,23,QLearningPlayer
165,QLearningPlayer,237,232,469,23,18,Player A
166,QLearningPlayer,222,227,449,21,24,QLearningPlayer
167,QLearningPlayer,221,221,442,23,27,Tie
168,QLearningPlayer,235,235,470,36,22,Tie
169,QLearningPlayer,232,232,464,21,19,Tie
170,QLearningPlayer,225,225,450,22,24,Tie
171,QLearningPlayer,235,230,465,25,20,Player A
172,QLearningPlayer,225,225,450,22,24,Tie
173,QLearningPlayer,233,238,471,28,19,QLearningPlayer
174,QLearningPlayer,222,222,444,25,27,Tie
175,QLearningPlayer,224,219,443,27,28,Player A
176,QLearningPlayer,217,222,439,26,29,QLearningPlayer
177,QLearningPlayer,227,227,454,26,24,Tie
178,QLearningPlayer,228,228,456,28,24,Tie
179,QLearningPlayer,228,223,451,20,23,Player A
180,QLearningPlayer,242,242,484,32,16,Tie
181,QLearningPlayer,214,219,433,26,31,QLearningPlayer
182,QLearningPlayer,244,239,483,28,15,Player A
183,QLearningPlayer,206,211,417,19,34,QLearningPlayer
184,QLearningPlayer,235,230,465,28,21,Player A
185,QLearningPlayer,225,230,455,24,23,QLearningPlayer
186,QLearningPlayer,216,211,427,23,32,Player A
187,QLearningPlayer,232,237,469,32,21,QLearningPlayer
188,QLearningPlayer,228,223,451,29,26,Player A
189,QLearningPlayer,212,212,424,17,31,Tie
190,QLearningPlayer,225,230,455,30,25,QLearningPlayer
191,QLearningPlayer,220,220,440,21,27,Tie
192,QLearningPlayer,222,217,439,23,28,Player A
193,QLearningPlayer,206,206,412,14,34,Tie
194,QLearningPlayer,198,203,401,18,39,QLearningPlayer
195,QLearningPlayer,226,226,452,27,25,Tie
196,QLearningPlayer,212,207,419,18,33,Player A
197,QLearningPlayer,223,223,446,24,26,Tie
198,QLearningPlayer,224,224,448,26,26,Tie
199,QLearningPlayer,209,214,423,25,34,QLearningPlayer
200,QLearningPlayer,227,227,454,32,26,Tie
201,QLearningPlayer,243,238,481,29,16,Player A
202,QLearningPlayer,229,229,458,27,23,Tie
203,QLearningPlayer,232,237,469,35,22,QLearningPlayer
204,QLearningPlayer,229,229,458,27,23,Tie
205,QLearningPlayer,214,214,428,24,32,Tie
206,QLearningPlayer,226,221,447,19,24,Player A
207,QLearningPlayer,231,231,462,31,23,Tie
208,QLearningPlayer,226,226,452,27,25,Tie
209,QLearningPlayer,228,228,456,28,24,Tie
210,QLearningPlayer,224,229,453,22,23,QLearningPlayer
211,QLearningPlayer,225,220,445,20,25,Player A
212,QLearningPlayer,230,230,460,32,24,Tie
213,QLearningPlayer,214,219,433,20,29,QLearningPlayer
214,QLearningPlayer,241,236,477,37,20,Player A
215,QLearningPlayer,217,222,439,23,28,QLearningPlayer
216,QLearningPlayer,231,231,462,25,21,Tie
217,QLearningPlayer,218,218,436,17,27,Tie
218,QLearningPlayer,225,225,450,22,24,Tie
219,QLearningPlayer,220,220,440,24,28,Tie
220,QLearningPlayer,233,228,461,27,22,Player A
221,QLearningPlayer,248,248,496,38,14,Tie
222,QLearningPlayer,228,233,461,24,21,QLearningPlayer
223,QLearningPlayer,222,222,444,25,27,Tie
224,QLearningPlayer,222,217,439,26,29,Player A
225,QLearningPlayer,232,237,469,26,19,QLearningPlayer
226,QLearningPlayer,229,224,453,25,24,Player A
227,QLearningPlayer,240,245,485,36,17,QLearningPlayer
228,QLearningPlayer,221,216,437,21,28,Player A
229,QLearningPlayer,233,233,466,26,20,Tie
230,QLearningPlayer,217,222,439,20,27,QLearningPlayer
231,QLearningPlayer,235,235,470,24,18,Tie
232,QLearningPlayer,236,236,472,29,19,Tie
233,QLearningPlayer,217,217,434,21,29,Tie
234,QLearningPlayer,224,219,443,21,26,Player A
235,QLearningPlayer,229,229,458,33,25,Tie
236,QLearningPlayer,229,229,458,24,22,Tie
237,QLearningPlayer,215,220,435,25,30,QLearningPlayer
238,QLearningPlayer,234,229,463,29,22,Player A
239,QLearningPlayer,232,232,464,24,20,Tie
240,QLearningPlayer,214,219,433,29,32,QLearningPlayer
241,QLearningPlayer,216,216,432,31,33,Tie
242,QLearningPlayer,215,210,425,18,31,Player A
243,QLearningPlayer,215,220,435,25,30,QLearningPlayer
244,QLearningPlayer,208,203,411,16,35,Player A
245,QLearningPlayer,223,223,446,24,26,Tie
246,QLearningPlayer,227,227,454,23,23,Tie
247,QLearningPlayer,211,211,422,18,32,Tie
248,QLearningPlayer,231,231,462,31,23,Tie
249,QLearningPlayer,205,210,415,23,36,QLearningPlayer
250,QLearningPlayer,216,216,432,22,30,Tie
251,QLearningPlayer,219,214,433,23,30,Player A
252,QLearningPlayer,226,226,452,24,24,Tie
253,QLearningPlayer,232,232,464,27,21,Tie
254,QLearningPlayer,220,220,440,21,27,Tie
255,QLearningPlayer,230,230,460,23,21,Tie
256,QLearningPlayer,216,221,437,21,28,QLearningPlayer
257,QLearningPlayer,226,226,452,24,24,Tie
258,QLearningPlayer,226,221,447,25,26,Player A
259,QLearningPlayer,223,223,446,21,25,Tie
260,QLearningPlayer,236,236,472,32,20,Tie
261,QLearningPlayer,225,230,455,30,25,QLearningPlayer
262,QLearningPlayer,225,225,450,28,26,Tie
263,QLearningPlayer,222,222,444,25,27,Tie
264,QLearningPlayer,247,242,489,31,14,Player A
265,QLearningPlayer,221,226,447,25,26,QLearningPlayer
266,QLearningPlayer,244,239,483,37,18,Player A
267,QLearningPlayer,212,217,429,16,29,QLearningPlayer
268,QLearningPlayer,226,226,452,21,23,Tie
269,QLearningPlayer,231,231,462,28,22,Tie
270,QLearningPlayer,212,212,424,20,32,Tie
271,QLearningPlayer,232,227,459,28,23,Player A
272,QLearningPlayer,217,222,439,20,27,QLearningPlayer
273,QLearningPlayer,220,220,440,27,29,Tie
274,QLearningPlayer,215,210,425,15,30,Player A
275,QLearningPlayer,223,228,451,29,26,QLearningPlayer
276,QLearningPlayer,214,209,423,19,32,Player A
277,QLearningPlayer,217,222,439,20,27,QLearningPlayer
278,QLearningPlayer,230,230,460,26,22,Tie
279,QLearningPlayer,232,227,459,25,22,Player A
280,QLearningPlayer,226,231,457,20,21,QLearningPlayer
281,QLearningPlayer,233,233,466,26,20,Tie
282,QLearningPlayer,211,211,422,24,34,Tie
283,QLearningPlayer,220,220,440,24,28,Tie
284,QLearningPlayer,208,208,416,18,34,Tie
285,QLearningPlayer,208,208,416,18,34,Tie
286,QLearningPlayer,234,229,463,23,20,Player A
287,QLearningPlayer,209,209,418,17,33,Tie
288,QLearningPlayer,227,227,454,26,24,Tie
289,QLearningPlayer,203,208,411,22,37,QLearningPlayer
290,QLearningPlayer,224,224,448,23,25,Tie
291,QLearningPlayer,234,234,468,25,19,Tie
292,QLearningPlayer,224,224,448,26,26,Tie
293,QLearningPlayer,223,223,446,30,28,Tie
294,QLearningPlayer,221,221,442,23,27,Tie
295,QLearningPlayer,227,222,449,21,24,Player A
296,QLearningPlayer,210,210,420,19,33,Tie
297,QLearningPlayer,224,224,448,20,24,Tie
298,QLearningPlayer,237,237,474,28,18,Tie
299,QLearningPlayer,241,241,482,27,15,Tie
300,QLearningPlayer,215,220,435,19,28,QLearningPlayer
301,QLearningPlayer,233,233,466,32,22,Tie
302,QLearningPlayer,235,235,470,30,20,Tie
303,QLearningPlayer,232,227,459,25,22,Player A
304,QLearningPlayer,237,237,474,28,18,Tie
305,QLearningPlayer,228,233,461,21,20,QLearningPlayer
306,QLearningPlayer,213,213,426,19,31,Tie
307,QLearningPlayer,229,224,453,28,25,Player A
308,QLearningPlayer,231,231,462,25,21,Tie
309,QLearningPlayer,231,236,467,30,21,QLearningPlayer
310,QLearningPlayer,224,224,448,29,27,Tie
311,QLearningPlayer,214,214,428,18,30,Tie
312,QLearningPlayer,217,217,434,21,29,Tie
313,QLearningPlayer,234,234,468,28,20,Tie
314,QLearningPlayer,227,222,449,24,25,Player A
315,QLearningPlayer,215,220,435,22,29,QLearningPlayer
316,QLearningPlayer,218,213,431,18,29,Player A
317,QLearningPlayer,221,226,447,22,25,QLearningPlayer
318,QLearningPlayer,239,239,478,35,19,Tie
319,QLearningPlayer,221,221,442,23,27,Tie
320,QLearningPlayer,213,213,426,19,31,Tie
321,QLearningPlayer,209,209,418,23,35,Tie
322,QLearningPlayer,229,229,458,30,24,Tie
323,QLearningPlayer,222,222,444,31,29,Tie
324,QLearningPlayer,236,236,472,23,17,Tie
325,QLearningPlayer,234,229,463,20,19,Player A
326,QLearningPlayer,230,235,465,28,21,QLearningPlayer
327,QLearningPlayer,226,221,447,25,26,Player A
328,QLearningPlayer,220,225,445,20,25,QLearningPlayer
329,QLearningPlayer,224,219,443,18,25,Player A
330,QLearningPlayer,235,240,475,29,18,QLearningPlayer
331,QLearningPlayer,214,214,428,18,30,Tie
332,QLearningPlayer,252,252,504,40,12,Tie
333,QLearningPlayer,234,229,463,26,21,Player A
334,QLearningPlayer,208,213,421,23,34,QLearningPlayer
335,QLearningPlayer,214,214,428,15,29,Tie
336,QLearningPlayer,226,221,447,25,26,Player A
337,QLearningPlayer,219,219,438,28,30,Tie
338,QLearningPlayer,228,233,461,21,20,QLearningPlayer
339,QLearningPlayer,215,215,430,20,30,Tie
340,QLearningPlayer,212,212,424,20,32,Tie
341,QLearningPlayer,235,235,470,24,18,Tie
342,QLearningPlayer,217,212,429,22,31,Player A
343,QLearningPlayer,222,222,444,25,27,Tie
344,QLearningPlayer,227,232,459,19,20,QLearningPlayer
345,QLearningPlayer,217,217,434,21,29,Tie
346,QLearningPlayer,231,226,457,23,22,Player A
347,QLearningPlayer,232,232,464,33,23,Tie
348,QLearningPlayer,195,195,390,10,40,Tie
349,QLearningPlayer,237,237,474,31,19,Tie
350,QLearningPlayer,211,211,422,27,35,Tie
351,QLearningPlayer,232,232,464,30,22,Tie
352,QLearningPlayer,220,220,440,21,27,Tie
353,QLearningPlayer,229,234,463,26,21,QLearningPlayer
354,QLearningPlayer,224,224,448,23,25,Tie
355,QLearningPlayer,242,237,479,36,19,Player A
356,QLearningPlayer,196,201,397,11,38,QLearningPlayer
357,QLearningPlayer,234,234,468,34,22,Tie
358,QLearningPlayer,218,213,431,24,31,Player A
359,QLearningPlayer,218,223,441,19,26,QLearningPlayer
360,QLearningPlayer,224,224,448,26,26,Tie
361,QLearningPlayer,225,220,445,26,27,Player A
362,QLearningPlayer,220,220,440,21,27,Tie
363,QLearningPlayer,217,217,434,27,31,Tie
364,QLearningPlayer,222,222,444,28,28,Tie
365,QLearningPlayer,217,217,434,24,30,Tie
366,QLearningPlayer,233,238,471,31,20,QLearningPlayer
367,QLearningPlayer,219,219,438,16,26,Tie
368,QLearningPlayer,225,225,450,28,26,Tie
369,QLearningPlayer,235,230,465,31,22,Player A
370,QLearningPlayer,217,222,439,23,28,QLearningPlayer
371,QLearningPlayer,219,219,438,28,30,Tie
372,QLearningPlayer,222,217,439,23,28,Player A
373,QLearningPlayer,233,233,466,26,20,Tie
374,QLearningPlayer,231,236,467,33,22,QLearningPlayer
375,QLearningPlayer,243,243,486,34,16,Tie
376,QLearningPlayer,232,227,459,22,21,Player A
377,QLearningPlayer,213,218,431,21,30,QLearningPlayer
378,QLearningPlayer,228,228,456,28,24,Tie
379,QLearningPlayer,226,226,452,27,25,Tie
380,QLearningPlayer,239,234,473,27,18,Player A
381,QLearningPlayer,221,226,447,28,27,QLearningPlayer
382,QLearningPlayer,233,228,461,33,24,Player A
383,QLearningPlayer,232,237,469,29,20,QLearningPlayer
384,QLearningPlayer,224,224,448,23,25,Tie
385,QLearningPlayer,222,217,439,26,29,Player A
386,QLearningPlayer,216,216,432,22,30,Tie
387,QLearningPlayer,223,228,451,35,28,QLearningPlayer
388,QLearningPlayer,235,230,465,31,22,Player A
389,QLearningPlayer,247,247,494,33,13,Tie
390,QLearningPlayer,234,239,473,27,18,QLearningPlayer
391,QLearningPlayer,235,230,465,28,21,Player A
392,QLearningPlayer,231,236,467,30,21,QLearningPlayer
393,QLearningPlayer,221,221,442,29,29,Tie
394,QLearningPlayer,233,233,466,32,22,Tie
395,QLearningPlayer,244,239,483,31,16,Player A
396,QLearningPlayer,208,213,421,20,33,QLearningPlayer
397,QLearningPlayer,223,218,441,22,27,Player A
398,QLearningPlayer,230,235,465,22,19,QLearningPlayer
399,QLearningPlayer,218,213,431,27,32,Player A
400,QLearningPlayer,230,230,460,23,21,Tie
401,QLearningPlayer,217,217,434,27,31,Tie
402,QLearningPlayer,239,244,483,34,17,QLearningPlayer
403,QLearningPlayer,230,230,460,26,22,Tie
404,QLearningPlayer,205,205,410,15,35,Tie
405,QLearningPlayer,232,232,464,33,23,Tie
406,QLearningPlayer,238,233,471,25,18,Player A
407,QLearningPlayer,217,222,439,29,30,QLearningPlayer
408,QLearningPlayer,228,223,451,26,25,Player A
409,QLearningPlayer,227,227,454,20,22,Tie
410,QLearningPlayer,234,234,468,31,21,Tie
411,QLearningPlayer,251,251,502,38,12,Tie
412,QLearningPlayer,225,225,450,28,26,Tie
413,QLearningPlayer,211,216,427,20,31,QLearningPlayer
414,QLearningPlayer,221,216,437,21,28,Player A
415,QLearningPlayer,236,236,472,32,20,Tie
416,QLearningPlayer,213,218,431,21,30,QLearningPlayer
417,QLearningPlayer,230,230,460,29,23,Tie
418,QLearningPlayer,243,238,481,23,14,Player A
419,QLearningPlayer,201,201,402,22,40,Tie
420,QLearningPlayer,222,227,449,27,26,QLearningPlayer
421,QLearningPlayer,242,237,479,30,17,Player A
422,QLearningPlayer,218,223,441,22,27,QLearningPlayer
423,QLearningPlayer,230,230,460,26,22,Tie
424,QLearningPlayer,209,204,413,18,35,Player A
425,QLearningPlayer,227,227,454,29,25,Tie
426,QLearningPlayer,230,230,460,26,22,Tie
427,QLearningPlayer,242,242,484,32,16,Tie
428,QLearningPlayer,221,221,442,23,27,Tie
429,QLearningPlayer,233,238,471,37,22,QLearningPlayer
430,QLearningPlayer,241,236,477,25,16,Player A
431,QLearningPlayer,235,235,470,30,20,Tie
432,QLearningPlayer,214,214,428,21,31,Tie
433,QLearningPlayer,245,250,495,31,12,QLearningPlayer
434,QLearningPlayer,238,233,471,31,20,Player A
435,QLearningPlayer,220,225,445,32,29,QLearningPlayer
436,QLearningPlayer,230,230,460,29,23,Tie
437,QLearningPlayer,230,230,460,26,22,Tie
438,QLearningPlayer,227,222,449,24,25,Player A
439,QLearningPlayer,210,210,420,22,34,Tie
440,QLearningPlayer,230,230,460,26,22,Tie
441,QLearningPlayer,233,233,466,23,19,Tie
442,QLearningPlayer,229,234,463,32,23,QLearningPlayer
443,QLearningPlayer,222,222,444,28,28,Tie
444,QLearningPlayer,236,231,467,30,21,Player A
445,QLearningPlayer,229,229,458,18,20,Tie
446,QLearningPlayer,237,242,479,27,16,QLearningPlayer
447,QLearningPlayer,206,206,412,14,34,Tie
448,QLearningPlayer,211,206,417,19,34,Player A
449,QLearningPlayer,231,236,467,24,19,QLearningPlayer
450,QLearningPlayer,235,235,470,24,18,Tie
451,QLearningPlayer,212,212,424,14,30,Tie
452,QLearningPlayer,232,227,459,28,23,Player A
453,QLearningPlayer,232,237,469,26,19,QLearningPlayer
454,QLearningPlayer,212,212,424,17,31,Tie
455,QLearningPlayer,225,220,445,23,26,Player A
456,QLearningPlayer,231,231,462,22,20,Tie
457,QLearningPlayer,219,224,443,24,27,QLearningPlayer
458,QLearningPlayer,218,218,436,26,30,Tie
459,QLearningPlayer,235,230,465,31,22,Player A
460,QLearningPlayer,223,223,446,21,25,Tie
461,QLearningPlayer,238,238,476,33,19,Tie
462,QLearningPlayer,231,236,467,30,21,QLearningPlayer
463,QLearningPlayer,224,224,448,23,25,Tie
464,QLearningPlayer,228,223,451,29,26,Player A
465,QLearningPlayer,230,235,465,28,21,QLearningPlayer
466,QLearningPlayer,237,237,474,31,19,Tie
467,QLearningPlayer,221,221,442,23,27,Tie
468,QLearningPlayer,212,212,424,20,32,Tie
469,QLearningPlayer,225,225,450,28,26,Tie
470,QLearningPlayer,217,212,429,19,30,Player A
471,QLearningPlayer,204,209,413,21,36,QLearningPlayer
472,QLearningPlayer,226,221,447,16,23,Player A
473,QLearningPlayer,195,200,395,12,39,QLearningPlayer
474,QLearningPlayer,225,220,445,26,27,Player A
475,QLearningPlayer,233,233,466,26,20,Tie
476,QLearningPlayer,221,226,447,31,28,QLearningPlayer
477,QLearningPlayer,230,225,455,27,24,Player A
478,QLearningPlayer,234,239,473,27,18,QLearningPlayer
479,QLearningPlayer,228,223,451,29,26,Player A
480,QLearningPlayer,240,245,485,30,15,QLearningPlayer
481,QLearningPlayer,217,217,434,21,29,Tie
482,QLearningPlayer,231,226,457,29,24,Player A
483,QLearningPlayer,222,227,449,24,25,QLearningPlayer
484,QLearningPlayer,224,219,443,21,26,Player A
485,QLearningPlayer,210,210,420,16,32,Tie
486,QLearningPlayer,228,233,461,30,23,QLearningPlayer
487,QLearningPlayer,238,238,476,27,17,Tie
488,QLearningPlayer,238,233,471,28,19,Player A
489,QLearningPlayer,222,222,444,25,27,Tie
490,QLearningPlayer,234,234,468,22,18,Tie
491,QLearningPlayer,199,204,403,20,39,QLearningPlayer
492,QLearningPlayer,220,220,440,24,28,Tie
493,QLearningPlayer,229,224,453,28,25,Player A
494,QLearningPlayer,223,223,446,24,26,Tie
495,QLearningPlayer,232,232,464,30,22,Tie
496,QLearningPlayer,228,228,456,28,24,Tie
497,QLearningPlayer,228,233,461,24,21,QLearningPlayer
498,QLearningPlayer,243,238,481,29,16,Player A
499,QLearningPlayer,220,225,445,20,25,QLearningPlayer
500,QLearningPlayer,215,210,425,18,31,Player A
501,QLearningPlayer,223,228,451,26,25,QLearningPlayer
502,QLearningPlayer,221,221,442,17,25,Tie
503,QLearningPlayer,237,232,469,29,20,Player A
504,QLearningPlayer,233,238,471,28,19,QLearningPlayer
505,QLearningPlayer,242,237,479,27,16,Player A
506,QLearningPlayer,225,225,450,19,23,Tie
507,QLearningPlayer,237,237,474,31,19,Tie
508,QLearningPlayer,230,235,465,34,23,QLearningPlayer
509,QLearningPlayer,225,225,450,25,25,Tie
510,QLearningPlayer,220,220,440,18,26,Tie
511,QLearningPlayer,232,227,459,22,21,Player A
512,QLearningPlayer,226,231,457,29,24,QLearningPlayer
513,QLearningPlayer,222,217,439,29,30,Player A
514,QLearningPlayer,235,235,470,24,18,Tie
515,QLearningPlayer,228,228,456,28,24,Tie
516,QLearningPlayer,217,217,434,21,29,Tie
517,QLearningPlayer,218,223,441,22,27,QLearningPlayer
518,QLearningPlayer,237,232,469,29,20,Player A
519,QLearningPlayer,228,228,456,25,23,Tie
520,QLearningPlayer,216,216,432,28,32,Tie
521,QLearningPlayer,221,226,447,19,24,QLearningPlayer
522,QLearningPlayer,237,232,469,23,18,Player A
523,QLearningPlayer,225,225,450,22,24,Tie
524,QLearningPlayer,214,214,428,18,30,Tie
525,QLearningPlayer,229,229,458,24,22,Tie
526,QLearningPlayer,224,224,448,26,26,Tie
527,QLearningPlayer,224,229,453,31,26,QLearningPlayer
528,QLearningPlayer,223,218,441,25,28,Player A
529,QLearningPlayer,239,244,483,34,17,QLearningPlayer
530,QLearningPlayer,232,227,459,25,22,Player A
531,QLearningPlayer,221,221,442,23,27,Tie
532,QLearningPlayer,211,216,427,20,31,QLearningPlayer
533,QLearningPlayer,226,221,447,22,25,Player A
534,QLearningPlayer,225,230,455,24,23,QLearningPlayer
535,QLearningPlayer,228,223,451,26,25,Player A
536,QLearningPlayer,219,224,443,24,27,QLearningPlayer
537,QLearningPlayer,226,221,447,31,28,Player A
538,QLearningPlayer,215,215,430,17,29,Tie
539,QLearningPlayer,223,223,446,24,26,Tie
540,QLearningPlayer,228,233,461,21,20,QLearningPlayer
541,QLearningPlayer,238,238,476,30,18,Tie
542,QLearningPlayer,241,241,482,27,15,Tie
543,QLearningPlayer,228,223,451,17,22,Player A
544,QLearningPlayer,223,228,451,23,24,QLearningPlayer
545,QLearningPlayer,213,208,421,20,33,Player A
546,QLearningPlayer,231,236,467,21,18,QLearningPlayer
547,QLearningPlayer,234,234,468,34,22,Tie
548,QLearningPlayer,244,239,483,34,17,Player A
549,QLearningPlayer,224,224,448,26,26,Tie
550,QLearningPlayer,244,244,488,42,18,Tie
551,QLearningPlayer,214,219,433,17,28,QLearningPlayer
552,QLearningPlayer,220,220,440,21,27,Tie
553,QLearningPlayer,229,224,453,25,24,Player A
554,QLearningPlayer,206,211,417,19,34,QLearningPlayer
555,QLearningPlayer,227,222,449,24,25,Player A
556,QLearningPlayer,219,219,438,16,26,Tie
557,QLearningPlayer,233,238,471,37,22,QLearningPlayer
558,QLearningPlayer,229,229,458,27,23,Tie
559,QLearningPlayer,213,213,426,19,31,Tie
560,QLearningPlayer,233,233,466,29,21,Tie
561,QLearningPlayer,212,207,419,24,35,Player A
562,QLearningPlayer,229,234,463,23,20,QLearningPlayer
563,QLearningPlayer,224,219,443,21,26,Player A
564,QLearningPlayer,228,233,461,24,21,QLearningPlayer
565,QLearningPlayer,226,221,447,25,26,Player A
566,QLearningPlayer,210,215,425,15,30,QLearningPlayer
567,QLearningPlayer,240,235,475,32,19,Player A
568,QLearningPlayer,223,223,446,27,27,Tie
569,QLearningPlayer,226,231,457,29,24,QLearningPlayer
570,QLearningPlayer,223,218,441,16,25,Player A
571,QLearningPlayer,227,227,454,26,24,Tie
572,QLearningPlayer,229,229,458,21,21,Tie
573,QLearningPlayer,233,238,471,31,20,QLearningPlayer
574,QLearningPlayer,229,229,458,21,21,Tie
575,QLearningPlayer,225,220,445,23,26,Player A
576,QLearningPlayer,226,231,457,29,24,QLearningPlayer
577,QLearningPlayer,212,212,424,29,35,Tie
578,QLearningPlayer,224,224,448,29,27,Tie
579,QLearningPlayer,217,217,434,18,28,Tie
580,QLearningPlayer,220,215,435,22,29,Player A
581,QLearningPlayer,222,222,444,25,27,Tie
582,QLearningPlayer,222,222,444,25,27,Tie
583,QLearningPlayer,213,218,431,27,32,QLearningPlayer
584,QLearningPlayer,221,221,442,23,27,Tie
585,QLearningPlayer,220,220,440,24,28,Tie
586,QLearningPlayer,234,234,468,25,19,Tie
587,QLearningPlayer,219,219,438,25,29,Tie
588,QLearningPlayer,233,233,466,26,20,Tie
589,QLearningPlayer,239,234,473,36,21,Player A
590,QLearningPlayer,224,224,448,23,25,Tie
591,QLearningPlayer,200,205,405,19,38,QLearningPlayer
592,QLearningPlayer,220,215,435,22,29,Player A
593,QLearningPlayer,209,214,423,16,31,QLearningPlayer
594,QLearningPlayer,219,219,438,25,29,Tie
595,QLearningPlayer,232,227,459,25,22,Player A
596,QLearningPlayer,231,231,462,25,21,Tie
597,QLearningPlayer,222,227,449,24,25,QLearningPlayer
598,QLearningPlayer,229,229,458,30,24,Tie
599,QLearningPlayer,227,227,454,26,24,Tie
600,QLearningPlayer,219,219,438,19,27,Tie
601,QLearningPlayer,232,227,459,31,24,Player A
602,QLearningPlayer,218,223,441,25,28,QLearningPlayer
603,QLearningPlayer,239,234,473,33,20,Player A
604,QLearningPlayer,221,221,442,26,28,Tie
605,QLearningPlayer,238,243,481,32,17,QLearningPlayer
606,QLearningPlayer,226,226,452,30,26,Tie
607,QLearningPlayer,252,247,499,38,13,Player A
608,QLearningPlayer,222,227,449,18,23,QLearningPlayer
609,QLearningPlayer,219,219,438,19,27,Tie
610,QLearningPlayer,229,224,453,34,27,Player A
611,QLearningPlayer,217,222,439,23,28,QLearningPlayer
612,QLearningPlayer,215,210,425,24,33,Player A
613,QLearningPlayer,221,226,447,22,25,QLearningPlayer
614,QLearningPlayer,227,222,449,21,24,Player A
615,QLearningPlayer,236,241,477,22,15,QLearningPlayer
616,QLearningPlayer,218,218,436,20,28,Tie
617,QLearningPlayer,208,208,416,15,33,Tie
618,QLearningPlayer,245,240,485,39,18,Player A
619,QLearningPlayer,213,218,431,21,30,QLearningPlayer
620,QLearningPlayer,224,219,443,24,27,Player A
621,QLearningPlayer,230,230,460,26,22,Tie
622,QLearningPlayer,225,225,450,22,24,Tie
623,QLearningPlayer,233,238,471,28,19,QLearningPlayer
624,QLearningPlayer,228,223,451,26,25,Player A
625,QLearningPlayer,219,219,438,25,29,Tie
626,QLearningPlayer,233,233,466,29,21,Tie
627,QLearningPlayer,225,230,455,30,25,QLearningPlayer
628,QLearningPlayer,228,228,456,25,23,Tie
629,QLearningPlayer,238,233,471,25,18,Player A
630,QLearningPlayer,224,229,453,25,24,QLearningPlayer
631,QLearningPlayer,214,209,423,22,33,Player A
632,QLearningPlayer,222,227,449,36,29,QLearningPlayer
633,QLearningPlayer,222,217,439,14,25,Player A
634,QLearningPlayer,224,224,448,32,28,Tie
635,QLearningPlayer,237,242,479,33,18,QLearningPlayer
636,QLearningPlayer,219,219,438,28,30,Tie
637,QLearningPlayer,235,235,470,30,20,Tie
638,QLearningPlayer,227,227,454,26,24,Tie
639,QLearningPlayer,226,226,452,21,23,Tie
640,QLearningPlayer,228,228,456,34,26,Tie
641,QLearningPlayer,214,209,423,22,33,Player A
642,QLearningPlayer,229,234,463,32,23,QLearningPlayer
643,QLearningPlayer,225,220,445,23,26,Player A
644,QLearningPlayer,234,234,468,28,20,Tie
645,QLearningPlayer,222,227,449,24,25,QLearningPlayer
646,QLearningPlayer,228,223,451,23,24,Player A
647,QLearningPlayer,219,224,443,21,26,QLearningPlayer
648,QLearningPlayer,230,230,460,35,25,Tie
649,QLearningPlayer,223,218,441,25,28,Player A
650,QLearningPlayer,206,211,417,13,32,QLearningPlayer
651,QLearningPlayer,226,226,452,30,26,Tie
652,QLearningPlayer,225,225,450,22,24,Tie
653,QLearningPlayer,207,207,414,16,34,Tie
654,QLearningPlayer,210,205,415,17,34,Player A
655,QLearningPlayer,230,230,460,23,21,Tie
656,QLearningPlayer,224,229,453,25,24,QLearningPlayer
657,QLearningPlayer,225,220,445,23,26,Player A
658,QLearningPlayer,225,230,455,24,23,QLearningPlayer
659,QLearningPlayer,214,209,423,19,32,Player A
660,QLearningPlayer,190,195,385,11,42,QLearningPlayer
661,QLearningPlayer,218,213,431,18,29,Player A
662,QLearningPlayer,238,243,481,26,15,QLearningPlayer
663,QLearningPlayer,240,235,475,29,18,Player A
664,QLearningPlayer,232,237,469,29,20,QLearningPlayer
665,QLearningPlayer,209,209,418,17,33,Tie
666,QLearningPlayer,246,241,487,29,14,Player A
667,QLearningPlayer,214,214,428,18,30,Tie
668,QLearningPlayer,236,236,472,26,18,Tie
669,QLearningPlayer,221,221,442,23,27,Tie
670,QLearningPlayer,220,220,440,21,27,Tie
671,QLearningPlayer,218,218,436,20,28,Tie
672,QLearningPlayer,245,245,490,29,13,Tie
673,QLearningPlayer,234,239,473,33,20,QLearningPlayer
674,QLearningPlayer,241,236,477,28,17,Player A
675,QLearningPlayer,230,235,465,25,20,QLearningPlayer
676,QLearningPlayer,218,218,436,23,29,Tie
677,QLearningPlayer,219,219,438,19,27,Tie
678,QLearningPlayer,227,227,454,23,23,Tie
679,QLearningPlayer,206,201,407,18,37,Player A
680,QLearningPlayer,242,247,489,31,14,QLearningPlayer
681,QLearningPlayer,211,206,417,16,33,Player A
682,QLearningPlayer,226,226,452,27,25,Tie
683,QLearningPlayer,223,228,451,23,24,QLearningPlayer
684,QLearningPlayer,224,224,448,26,26,Tie
685,QLearningPlayer,223,218,441,16,25,Player A
686,QLearningPlayer,230,235,465,28,21,QLearningPlayer
687,QLearningPlayer,219,219,438,25,29,Tie
688,QLearningPlayer,244,244,488,33,15,Tie
689,QLearningPlayer,247,242,489,31,14,Player A
690,QLearningPlayer,211,211,422,21,33,Tie
691,QLearningPlayer,207,212,419,15,32,QLearningPlayer
692,QLearningPlayer,224,219,443,24,27,Player A
693,QLearningPlayer,212,217,429,22,31,QLearningPlayer
694,QLearningPlayer,228,228,456,25,23,Tie
695,QLearningPlayer,233,228,461,24,21,Player A
696,QLearningPlayer,233,233,466,32,22,Tie
697,QLearningPlayer,232,232,464,36,24,Tie
698,QLearningPlayer,234,234,468,19,17,Tie
699,QLearningPlayer,227,227,454,32,26,Tie
700,QLearningPlayer,228,228,456,25,23,Tie
701,QLearningPlayer,223,223,446,21,25,Tie
702,QLearningPlayer,223,228,451,26,25,QLearningPlayer
703,QLearningPlayer,220,220,440,24,28,Tie
704,QLearningPlayer,210,210,420,19,33,Tie
705,QLearningPlayer,220,215,435,19,28,Player A
706,QLearningPlayer,218,218,436,17,27,Tie
707,QLearningPlayer,222,227,449,27,26,QLearningPlayer
708,QLearningPlayer,212,207,419,27,36,Player A
709,QLearningPlayer,224,229,453,19,22,QLearningPlayer
710,QLearningPlayer,221,221,442,29,29,Tie
711,QLearningPlayer,221,221,442,29,29,Tie
712,QLearningPlayer,229,224,453,25,24,Player A
713,QLearningPlayer,224,229,453,25,24,QLearningPlayer
714,QLearningPlayer,240,235,475,35,20,Player A
715,QLearningPlayer,230,230,460,32,24,Tie
716,QLearningPlayer,220,220,440,27,29,Tie
717,QLearningPlayer,208,213,421,20,33,QLearningPlayer
718,QLearningPlayer,211,206,417,13,32,Player A
719,QLearningPlayer,217,222,439,23,28,QLearningPlayer
720,QLearningPlayer,224,224,448,26,26,Tie
721,QLearningPlayer,214,214,428,21,31,Tie
722,QLearningPlayer,219,219,438,25,29,Tie
723,QLearningPlayer,231,226,457,32,25,Player A
724,QLearningPlayer,238,238,476,30,18,Tie
725,QLearningPlayer,215,220,435,22,29,QLearningPlayer
726,QLearningPlayer,240,235,475,32,19,Player A
727,QLearningPlayer,220,225,445,29,28,QLearningPlayer
728,QLearningPlayer,227,222,449,21,24,Player A
729,QLearningPlayer,234,234,468,31,21,Tie
730,QLearningPlayer,233,233,466,26,20,Tie
731,QLearningPlayer,237,237,474,37,21,Tie
732,QLearningPlayer,216,216,432,19,29,Tie
733,QLearningPlayer,206,211,417,22,35,QLearningPlayer
734,QLearningPlayer,236,231,467,30,21,Player A
735,QLearningPlayer,209,214,423,25,34,QLearningPlayer
736,QLearningPlayer,213,213,426,22,32,Tie
737,QLearningPlayer,209,204,413,18,35,Player A
738,QLearningPlayer,217,222,439,26,29,QLearningPlayer
739,QLearningPlayer,200,200,400,14,38,Tie
740,QLearningPlayer,243,238,481,35,18,Player A
741,QLearningPlayer,213,218,431,18,29,QLearningPlayer
742,QLearningPlayer,222,222,444,31,29,Tie
743,QLearningPlayer,208,208,416,12,32,Tie
744,QLearningPlayer,221,221,442,26,28,Tie
745,QLearningPlayer,214,214,428,21,31,Tie
746,QLearningPlayer,248,243,491,30,13,Player A
747,QLearningPlayer,217,222,439,23,28,QLearningPlayer
748,QLearningPlayer,245,245,490,29,13,Tie
749,QLearningPlayer,212,212,424,23,33,Tie
750,QLearningPlayer,204,199,403,17,38,Player A
751,QLearningPlayer,225,225,450,25,25,Tie
752,QLearningPlayer,207,212,419,21,34,QLearningPlayer
753,QLearningPlayer,212,207,419,21,34,Player A
754,QLearningPlayer,221,226,447,25,26,QLearningPlayer
755,QLearningPlayer,225,225,450,22,24,Tie
756,QLearningPlayer,224,219,443,24,27,Player A
757,QLearningPlayer,233,233,466,26,20,Tie
758,QLearningPlayer,214,219,433,17,28,QLearningPlayer
759,QLearningPlayer,224,219,443,27,28,Player A
760,QLearningPlayer,228,228,456,22,22,Tie
761,QLearningPlayer,229,234,463,29,22,QLearningPlayer
762,QLearningPlayer,210,205,415,14,33,Player A
763,QLearningPlayer,221,221,442,23,27,Tie
764,QLearningPlayer,209,209,418,20,34,Tie
765,QLearningPlayer,224,229,453,31,26,QLearningPlayer
766,QLearningPlayer,230,230,460,23,21,Tie
767,QLearningPlayer,220,220,440,24,28,Tie
768,QLearningPlayer,207,202,409,17,36,Player A
769,QLearningPlayer,223,223,446,21,25,Tie
770,QLearningPlayer,218,218,436,26,30,Tie
771,QLearningPlayer,225,225,450,28,26,Tie
772,QLearningPlayer,211,216,427,20,31,QLearningPlayer
773,QLearningPlayer,220,215,435,25,30,Player A
774,QLearningPlayer,227,232,459,22,21,QLearningPlayer
775,QLearningPlayer,227,222,449,21,24,Player A
776,QLearningPlayer,210,215,425,21,32,QLearningPlayer
777,QLearningPlayer,224,219,443,27,28,Player A
778,QLearningPlayer,233,233,466,32,22,Tie
779,QLearningPlayer,221,226,447,25,26,QLearningPlayer
780,QLearningPlayer,232,232,464,27,21,Tie
781,QLearningPlayer,244,244,488,30,14,Tie
782,QLearningPlayer,229,229,458,27,23,Tie
783,QLearningPlayer,228,228,456,31,25,Tie
784,QLearningPlayer,233,228,461,27,22,Player A
785,QLearningPlayer,229,234,463,26,21,QLearningPlayer
786,QLearningPlayer,234,229,463,23,20,Player A
787,QLearningPlayer,211,216,427,17,30,QLearningPlayer
788,QLearningPlayer,212,212,424,14,30,Tie
789,QLearningPlayer,212,212,424,17,31,Tie
790,QLearningPlayer,234,229,463,29,22,Player A
791,QLearningPlayer,237,242,479,27,16,QLearningPlayer
792,QLearningPlayer,250,245,495,31,12,Player A
793,QLearningPlayer,228,233,461,21,20,QLearningPlayer
794,QLearningPlayer,248,248,496,29,11,Tie
795,QLearningPlayer,236,231,467,24,19,Player A
796,QLearningPlayer,213,218,431,21,30,QLearningPlayer
797,QLearningPlayer,212,207,419,18,33,Player A
798,QLearningPlayer,229,234,463,20,19,QLearningPlayer
799,QLearningPlayer,232,232,464,21,19,Tie
800,QLearningPlayer,219,219,438,19,27,Tie
801,QLearningPlayer,246,246,492,28,12,Tie
802,QLearningPlayer,233,233,466,26,20,Tie
803,QLearningPlayer,222,222,444,31,29,Tie
804,QLearningPlayer,236,236,472,26,18,Tie
805,QLearningPlayer,206,201,407,12,35,Player A
806,QLearningPlayer,227,227,454,29,25,Tie
807,QLearningPlayer,207,207,414,19,35,Tie
808,QLearningPlayer,216,221,437,24,29,QLearningPlayer
809,QLearningPlayer,226,221,447,25,26,Player A
810,QLearningPlayer,221,226,447,22,25,QLearningPlayer
811,QLearningPlayer,218,213,431,18,29,Player A
812,QLearningPlayer,204,209,413,18,35,QLearningPlayer
813,QLearningPlayer,240,235,475,29,18,Player A
814,QLearningPlayer,207,212,419,15,32,QLearningPlayer
815,QLearningPlayer,233,233,466,29,21,Tie
816,QLearningPlayer,223,218,441,19,26,Player A
817,QLearningPlayer,238,238,476,30,18,Tie
818,QLearningPlayer,231,231,462,28,22,Tie
819,QLearningPlayer,239,239,478,32,18,Tie
820,QLearningPlayer,227,227,454,20,22,Tie
821,QLearningPlayer,212,217,429,22,31,QLearningPlayer
822,QLearningPlayer,217,217,434,24,30,Tie
823,QLearningPlayer,220,215,435,22,29,Player A
824,QLearningPlayer,231,236,467,24,19,QLearningPlayer
825,QLearningPlayer,232,227,459,31,24,Player A
826,QLearningPlayer,230,235,465,31,22,QLearningPlayer
827,QLearningPlayer,219,219,438,22,28,Tie
828,QLearningPlayer,231,226,457,29,24,Player A
829,QLearningPlayer,230,235,465,22,19,QLearningPlayer
830,QLearningPlayer,249,244,493,32,13,Player A
831,QLearningPlayer,215,215,430,26,32,Tie
832,QLearningPlayer,216,221,437,21,28,QLearningPlayer
833,QLearningPlayer,243,238,481,26,15,Player A
834,QLearningPlayer,237,237,474,31,19,Tie
835,QLearningPlayer,199,204,403,11,36,QLearningPlayer
836,QLearningPlayer,227,222,449,27,26,Player A
837,QLearningPlayer,244,249,493,38,15,QLearningPlayer
838,QLearningPlayer,213,208,421,14,31,Player A
839,QLearningPlayer,215,220,435,16,27,QLearningPlayer
840,QLearningPlayer,230,225,455,18,21,Player A
841,QLearningPlayer,225,230,455,27,24,QLearningPlayer
842,QLearningPlayer,222,222,444,22,26,Tie
843,QLearningPlayer,238,238,476,30,18,Tie
844,QLearningPlayer,224,219,443,24,27,Player A
845,QLearningPlayer,227,227,454,32,26,Tie
846,QLearningPlayer,214,214,428,18,30,Tie
847,QLearningPlayer,217,217,434,15,27,Tie
848,QLearningPlayer,223,228,451,23,24,QLearningPlayer
849,QLearningPlayer,229,229,458,27,23,Tie
850,QLearningPlayer,231,231,462,28,22,Tie
851,QLearningPlayer,215,215,430,20,30,Tie
852,QLearningPlayer,213,213,426,25,33,Tie
853,QLearningPlayer,226,226,452,24,24,Tie
854,QLearningPlayer,227,222,449,21,24,Player A
855,QLearningPlayer,222,227,449,18,23,QLearningPlayer
856,QLearningPlayer,212,212,424,17,31,Tie
857,QLearningPlayer,222,217,439,23,28,Player A
858,QLearningPlayer,238,238,476,33,19,Tie
859,QLearningPlayer,220,220,440,27,29,Tie
860,QLearningPlayer,233,233,466,23,19,Tie
861,QLearningPlayer,227,232,459,22,21,QLearningPlayer
862,QLearningPlayer,217,217,434,21,29,Tie
863,QLearningPlayer,230,230,460,26,22,Tie
864,QLearningPlayer,248,243,491,33,14,Player A
865,QLearningPlayer,221,226,447,25,26,QLearningPlayer
866,QLearningPlayer,236,236,472,29,19,Tie
867,QLearningPlayer,225,225,450,31,27,Tie
868,QLearningPlayer,234,234,468,34,22,Tie
869,QLearningPlayer,224,219,443,24,27,Player A
870,QLearningPlayer,218,223,441,25,28,QLearningPlayer
871,QLearningPlayer,228,228,456,25,23,Tie
872,QLearningPlayer,227,227,454,23,23,Tie
873,QLearningPlayer,227,227,454,29,25,Tie
874,QLearningPlayer,243,238,481,26,15,Player A
875,QLearningPlayer,220,225,445,32,29,QLearningPlayer
876,QLearningPlayer,232,232,464,30,22,Tie
877,QLearningPlayer,230,225,455,21,22,Player A
878,QLearningPlayer,225,230,455,21,22,QLearningPlayer
879,QLearningPlayer,221,216,437,21,28,Player A
880,QLearningPlayer,247,252,499,41,14,QLearningPlayer
881,QLearningPlayer,213,208,421,23,34,Player A
882,QLearningPlayer,213,218,431,21,30,QLearningPlayer
883,QLearningPlayer,229,229,458,24,22,Tie
884,QLearningPlayer,231,231,462,16,18,Tie
885,QLearningPlayer,236,231,467,30,21,Player A
886,QLearningPlayer,244,244,488,33,15,Tie
887,QLearningPlayer,244,244,488,36,16,Tie
888,QLearningPlayer,237,242,479,33,18,QLearningPlayer
889,QLearningPlayer,223,223,446,24,26,Tie
890,QLearningPlayer,221,221,442,23,27,Tie
891,QLearningPlayer,238,233,471,31,20,Player A
892,QLearningPlayer,241,241,482,30,16,Tie
893,QLearningPlayer,218,223,441,19,26,QLearningPlayer
894,QLearningPlayer,236,231,467,24,19,Player A
895,QLearningPlayer,243,243,486,31,15,Tie
896,QLearningPlayer,240,240,480,37,19,Tie
897,QLearningPlayer,224,229,453,19,22,QLearningPlayer
898,QLearningPlayer,224,219,443,24,27,Player A
899,QLearningPlayer,219,224,443,24,27,QLearningPlayer
900,QLearningPlayer,219,214,433,23,30,Player A
901,QLearningPlayer,206,206,412,17,35,Tie
902,QLearningPlayer,215,215,430,26,32,Tie
903,QLearningPlayer,234,234,468,31,21,Tie
904,QLearningPlayer,224,229,453,31,26,QLearningPlayer
905,QLearningPlayer,221,216,437,27,30,Player A
906,QLearningPlayer,210,215,425,21,32,QLearningPlayer
907,QLearningPlayer,229,224,453,31,26,Player A
908,QLearningPlayer,233,238,471,34,21,QLearningPlayer
909,QLearningPlayer,226,221,447,19,24,Player A
910,QLearningPlayer,229,229,458,24,22,Tie
911,QLearningPlayer,228,228,456,28,24,Tie
912,QLearningPlayer,220,220,440,24,28,Tie
913,QLearningPlayer,226,231,457,23,22,QLearningPlayer
914,QLearningPlayer,227,227,454,23,23,Tie
915,QLearningPlayer,205,205,410,15,35,Tie
916,QLearningPlayer,226,226,452,24,24,Tie
917,QLearningPlayer,230,225,455,27,24,Player A
918,QLearningPlayer,240,240,480,28,16,Tie
919,QLearningPlayer,231,231,462,25,21,Tie
920,QLearningPlayer,212,217,429,16,29,QLearningPlayer
921,QLearningPlayer,221,221,442,29,29,Tie
922,QLearningPlayer,227,227,454,17,21,Tie
923,QLearningPlayer,233,233,466,32,22,Tie
924,QLearningPlayer,233,228,461,24,21,Player A
925,QLearningPlayer,236,236,472,29,19,Tie
926,QLearningPlayer,207,207,414,19,35,Tie
927,QLearningPlayer,215,215,430,23,31,Tie
928,QLearningPlayer,212,212,424,17,31,Tie
929,QLearningPlayer,207,207,414,22,36,Tie
930,QLearningPlayer,220,225,445,20,25,QLearningPlayer
931,QLearningPlayer,226,226,452,24,24,Tie
932,QLearningPlayer,230,225,455,21,22,Player A
933,QLearningPlayer,224,224,448,29,27,Tie
934,QLearningPlayer,230,235,465,28,21,QLearningPlayer
935,QLearningPlayer,215,210,425,18,31,Player A
936,QLearningPlayer,236,236,472,26,18,Tie
937,QLearningPlayer,226,226,452,24,24,Tie
938,QLearningPlayer,238,238,476,30,18,Tie
939,QLearningPlayer,229,229,458,24,22,Tie
940,QLearningPlayer,220,220,440,18,26,Tie
941,QLearningPlayer,219,219,438,16,26,Tie
942,QLearningPlayer,232,232,464,21,19,Tie
943,QLearningPlayer,216,221,437,18,27,QLearningPlayer
944,QLearningPlayer,209,209,418,23,35,Tie
945,QLearningPlayer,223,223,446,30,28,Tie
946,QLearningPlayer,227,222,449,27,26,Player A
947,QLearningPlayer,232,237,469,23,18,QLearningPlayer
948,QLearningPlayer,225,220,445,20,25,Player A
949,QLearningPlayer,216,216,432,19,29,Tie
950,QLearningPlayer,220,220,440,18,26,Tie
951,QLearningPlayer,239,244,483,31,16,QLearningPlayer
952,QLearningPlayer,247,247,494,36,14,Tie
953,QLearningPlayer,238,233,471,31,20,Player A
954,QLearningPlayer,244,249,493,41,16,QLearningPlayer
955,QLearningPlayer,243,243,486,34,16,Tie
956,QLearningPlayer,243,243,486,28,14,Tie
957,QLearningPlayer,236,231,467,30,21,Player A
958,QLearningPlayer,216,221,437,18,27,QLearningPlayer
959,QLearningPlayer,232,232,464,30,22,Tie
960,QLearningPlayer,221,216,437,27,30,Player A
961,QLearningPlayer,230,230,460,29,23,Tie
962,QLearningPlayer,232,232,464,24,20,Tie
963,QLearningPlayer,248,253,501,40,13,QLearningPlayer
964,QLearningPlayer,226,226,452,24,24,Tie
965,QLearningPlayer,237,232,469,32,21,Player A
966,QLearningPlayer,216,221,437,33,32,QLearningPlayer
967,QLearningPlayer,231,226,457,29,24,Player A
968,QLearningPlayer,219,224,443,24,27,QLearningPlayer
969,QLearningPlayer,245,245,490,35,15,Tie
970,QLearningPlayer,232,232,464,27,21,Tie
971,QLearningPlayer,199,194,393,16,41,Player A
972,QLearningPlayer,218,223,441,19,26,QLearningPlayer
973,QLearningPlayer,223,223,446,18,24,Tie
974,QLearningPlayer,221,216,437,18,27,Player A
975,QLearningPlayer,244,244,488,42,18,Tie
976,QLearningPlayer,219,219,438,22,28,Tie
977,QLearningPlayer,221,226,447,22,25,QLearningPlayer
978,QLearningPlayer,244,239,483,31,16,Player A
979,QLearningPlayer,231,236,467,39,24,QLearningPlayer
980,QLearningPlayer,217,217,434,21,29,Tie
981,QLearningPlayer,226,221,447,22,25,Player A
982,QLearningPlayer,236,236,472,32,20,Tie
983,QLearningPlayer,214,219,433,23,30,QLearningPlayer
984,QLearningPlayer,219,219,438,25,29,Tie
985,QLearningPlayer,228,228,456,28,24,Tie
986,QLearningPlayer,201,201,402,16,38,Tie
987,QLearningPlayer,218,213,431,27,32,Player A
988,QLearningPlayer,212,212,424,26,34,Tie
989,QLearningPlayer,242,242,484,26,14,Tie
990,QLearningPlayer,227,227,454,29,25,Tie
991,QLearningPlayer,229,229,458,27,23,Tie
992,QLearningPlayer,226,231,457,32,25,QLearningPlayer
993,QLearningPlayer,244,239,483,31,16,Player A
994,QLearningPlayer,244,244,488,30,14,Tie
995,QLearningPlayer,218,223,441,19,26,QLearningPlayer
996,QLearningPlayer,229,224,453,28,25,Player A
997,QLearningPlayer,228,228,456,25,23,Tie
998,QLearningPlayer,226,231,457,26,23,QLearningPlayer
999,QLearningPlayer,235,230,465,28,21,Player A
1000,QLearningPlayer,242,242,484,41,19,Tie
1001,QLearningPlayer,231,236,467,27,20,QLearningPlayer
1002,QLearningPlayer,213,208,421,17,32,Player A
1003,QLearningPlayer,222,227,449,27,26,QLearningPlayer
1004,QLearningPlayer,210,210,420,16,32,Tie
1005,QLearningPlayer,224,219,443,18,25,Player A
1006,QLearningPlayer,227,232,459,28,23,QLearningPlayer
1007,QLearningPlayer,234,234,468,28,20,Tie
1008,QLearningPlayer,221,216,437,24,29,Player A
1009,QLearningPlayer,216,221,437,24,29,QLearningPlayer
1010,QLearningPlayer,245,240,485,30,15,Player A
1011,QLearningPlayer,217,222,439,26,29,QLearningPlayer
1012,QLearningPlayer,232,227,459,28,23,Player A
1013,QLearningPlayer,228,228,456,28,24,Tie
1014,QLearningPlayer,238,238,476,36,20,Tie
1015,QLearningPlayer,236,236,472,29,19,Tie
1016,QLearningPlayer,235,235,470,27,19,Tie
1017,QLearningPlayer,237,242,479,27,16,QLearningPlayer
1018,QLearningPlayer,212,212,424,17,31,Tie
1019,QLearningPlayer,233,233,466,26,20,Tie
1020,QLearningPlayer,224,219,443,24,27,Player A
1021,QLearningPlayer,232,232,464,30,22,Tie
1022,QLearningPlayer,219,219,438,16,26,Tie
1023,QLearningPlayer,217,222,439,20,27,QLearningPlayer
1024,QLearningPlayer,239,239,478,38,20,Tie
1025,QLearningPlayer,216,216,432,22,30,Tie
1026,QLearningPlayer,234,234,468,34,22,Tie
1027,QLearningPlayer,205,200,405,19,38,Player A
1028,QLearningPlayer,231,236,467,30,21,QLearningPlayer
1029,QLearningPlayer,216,216,432,25,31,Tie
1030,QLearningPlayer,227,222,449,27,26,Player A
1031,QLearningPlayer,212,217,429,13,28,QLearningPlayer
1032,QLearningPlayer,217,212,429,19,30,Player A
1033,QLearningPlayer,218,218,436,17,27,Tie
1034,QLearningPlayer,227,227,454,29,25,Tie
1035,QLearningPlayer,212,212,424,23,33,Tie
1036,QLearningPlayer,224,224,448,17,23,Tie
1037,QLearningPlayer,229,229,458,15,19,Tie
1038,QLearningPlayer,224,229,453,31,26,QLearningPlayer
1039,QLearningPlayer,209,209,418,17,33,Tie
1040,QLearningPlayer,225,225,450,25,25,Tie
1041,QLearningPlayer,238,238,476,39,21,Tie
1042,QLearningPlayer,220,215,435,19,28,Player A
1043,QLearningPlayer,234,239,473,30,19,QLearningPlayer
1044,QLearningPlayer,231,226,457,26,23,Player A
1045,QLearningPlayer,206,211,417,19,34,QLearningPlayer
1046,QLearningPlayer,216,211,427,20,31,Player A
1047,QLearningPlayer,236,241,477,37,20,QLearningPlayer
1048,QLearningPlayer,216,211,427,26,33,Player A
1049,QLearningPlayer,243,243,486,34,16,Tie
1050,QLearningPlayer,231,236,467,33,22,QLearningPlayer
1051,QLearningPlayer,229,224,453,31,26,Player A
1052,QLearningPlayer,214,214,428,24,32,Tie
1053,QLearningPlayer,228,228,456,28,24,Tie
1054,QLearningPlayer,234,234,468,31,21,Tie
1055,QLearningPlayer,223,223,446,30,28,Tie
1056,QLearningPlayer,223,228,451,26,25,QLearningPlayer
1057,QLearningPlayer,232,227,459,31,24,Player A
1058,QLearningPlayer,238,238,476,30,18,Tie
1059,QLearningPlayer,231,231,462,31,23,Tie
1060,QLearningPlayer,220,225,445,26,27,QLearningPlayer
1061,QLearningPlayer,230,230,460,26,22,Tie
1062,QLearningPlayer,230,230,460,26,22,Tie
1063,QLearningPlayer,232,232,464,30,22,Tie
1064,QLearningPlayer,211,206,417,19,34,Player A
1065,QLearningPlayer,231,231,462,22,20,Tie
1066,QLearningPlayer,223,223,446,27,27,Tie
1067,QLearningPlayer,208,213,421,20,33,QLearningPlayer
1068,QLearningPlayer,218,213,431,24,31,Player A
1069,QLearningPlayer,237,237,474,40,22,Tie
1070,QLearningPlayer,222,227,449,21,24,QLearningPlayer
1071,QLearningPlayer,238,233,471,28,19,Player A
1072,QLearningPlayer,239,239,478,32,18,Tie
1073,QLearningPlayer,234,234,468,31,21,Tie
1074,QLearningPlayer,229,229,458,30,24,Tie
1075,QLearningPlayer,233,233,466,32,22,Tie
1076,QLearningPlayer,199,199,398,18,40,Tie
1077,QLearningPlayer,232,237,469,29,20,QLearningPlayer
1078,QLearningPlayer,236,231,467,30,21,Player A
1079,QLearningPlayer,235,235,470,30,20,Tie
1080,QLearningPlayer,220,220,440,27,29,Tie
1081,QLearningPlayer,234,234,468,28,20,Tie
1082,QLearningPlayer,214,214,428,21,31,Tie
1083,QLearningPlayer,216,221,437,24,29,QLearningPlayer
1084,QLearningPlayer,230,225,455,24,23,Player A
1085,QLearningPlayer,202,207,409,20,37,QLearningPlayer
1086,QLearningPlayer,196,196,392,9,39,Tie
1087,QLearningPlayer,223,218,441,28,29,Player A
1088,QLearningPlayer,205,205,410,24,38,Tie
1089,QLearningPlayer,199,199,398,21,41,Tie
1090,QLearningPlayer,221,221,442,20,26,Tie
1091,QLearningPlayer,214,214,428,24,32,Tie
1092,QLearningPlayer,203,208,411,16,35,QLearningPlayer
1093,QLearningPlayer,231,231,462,22,20,Tie
1094,QLearningPlayer,215,210,425,15,30,Player A
1095,QLearningPlayer,241,241,482,33,17,Tie
1096,QLearningPlayer,229,234,463,26,21,QLearningPlayer
1097,QLearningPlayer,225,225,450,25,25,Tie
1098,QLearningPlayer,226,226,452,21,23,Tie
1099,QLearningPlayer,199,199,398,12,38,Tie
1100,QLearningPlayer,241,236,477,28,17,Player A
1101,QLearningPlayer,226,231,457,23,22,QLearningPlayer
1102,QLearningPlayer,238,233,471,31,20,Player A
1103,QLearningPlayer,239,239,478,29,17,Tie
1104,QLearningPlayer,216,216,432,19,29,Tie
1105,QLearningPlayer,230,235,465,28,21,QLearningPlayer
1106,QLearningPlayer,214,214,428,15,29,Tie
1107,QLearningPlayer,230,230,460,29,23,Tie
1108,QLearningPlayer,228,228,456,25,23,Tie
1109,QLearningPlayer,228,223,451,32,27,Player A
1110,QLearningPlayer,229,234,463,20,19,QLearningPlayer
1111,QLearningPlayer,234,229,463,26,21,Player A
1112,QLearningPlayer,227,232,459,25,22,QLearningPlayer
1113,QLearningPlayer,225,225,450,25,25,Tie
1114,QLearningPlayer,216,211,427,20,31,Player A
1115,QLearningPlayer,223,223,446,21,25,Tie
1116,QLearningPlayer,232,232,464,33,23,Tie
1117,QLearningPlayer,216,221,437,21,28,QLearningPlayer
1118,QLearningPlayer,215,210,425,15,30,Player A
1119,QLearningPlayer,221,226,447,25,26,QLearningPlayer
1120,QLearningPlayer,238,233,471,31,20,Player A
1121,QLearningPlayer,234,234,468,28,20,Tie
1122,QLearningPlayer,219,224,443,21,26,QLearningPlayer
1123,QLearningPlayer,223,218,441,19,26,Player A
1124,QLearningPlayer,222,227,449,21,24,QLearningPlayer
1125,QLearningPlayer,219,219,438,28,30,Tie
1126,QLearningPlayer,243,238,481,29,16,Player A
1127,QLearningPlayer,225,230,455,24,23,QLearningPlayer
1128,QLearningPlayer,238,233,471,34,21,Player A
1129,QLearningPlayer,243,248,491,33,14,QLearningPlayer
1130,QLearningPlayer,224,224,448,26,26,Tie
1131,QLearningPlayer,234,229,463,32,23,Player A
1132,QLearningPlayer,226,226,452,15,21,Tie
1133,QLearningPlayer,235,235,470,24,18,Tie
1134,QLearningPlayer,223,228,451,20,23,QLearningPlayer
1135,QLearningPlayer,226,226,452,24,24,Tie
1136,QLearningPlayer,221,221,442,23,27,Tie
1137,QLearningPlayer,214,214,428,21,31,Tie
1138,QLearningPlayer,233,233,466,26,20,Tie
1139,QLearningPlayer,215,215,430,23,31,Tie
1140,QLearningPlayer,234,229,463,26,21,Player A
1141,QLearningPlayer,229,229,458,30,24,Tie
1142,QLearningPlayer,228,228,456,28,24,Tie
1143,QLearningPlayer,232,237,469,20,17,QLearningPlayer
1144,QLearningPlayer,219,214,433,20,29,Player A
1145,QLearningPlayer,226,226,452,30,26,Tie
1146,QLearningPlayer,227,232,459,31,24,QLearningPlayer
1147,QLearningPlayer,241,236,477,28,17,Player A
1148,QLearningPlayer,217,217,434,24,30,Tie
1149,QLearningPlayer,243,243,486,37,17,Tie
1150,QLearningPlayer,221,226,447,22,25,QLearningPlayer
1151,QLearningPlayer,232,227,459,34,25,Player A
1152,QLearningPlayer,240,245,485,30,15,QLearningPlayer
1153,QLearningPlayer,212,207,419,18,33,Player A
1154,QLearningPlayer,233,238,471,34,21,QLearningPlayer
1155,QLearningPlayer,231,226,457,26,23,Player A
1156,QLearningPlayer,212,217,429,22,31,QLearningPlayer
1157,QLearningPlayer,252,247,499,35,12,Player A
1158,QLearningPlayer,223,223,446,30,28,Tie
1159,QLearningPlayer,211,216,427,23,32,QLearningPlayer
1160,QLearningPlayer,206,206,412,17,35,Tie
1161,QLearningPlayer,207,207,414,19,35,Tie
1162,QLearningPlayer,221,216,437,24,29,Player A
1163,QLearningPlayer,232,232,464,30,22,Tie
1164,QLearningPlayer,231,231,462,31,23,Tie
1165,QLearningPlayer,235,240,475,23,16,QLearningPlayer
1166,QLearningPlayer,223,218,441,22,27,Player A
1167,QLearningPlayer,229,234,463,29,22,QLearningPlayer
1168,QLearningPlayer,219,219,438,19,27,Tie
1169,QLearningPlayer,240,235,475,26,17,Player A
1170,QLearningPlayer,223,228,451,23,24,QLearningPlayer
1171,QLearningPlayer,225,220,445,20,25,Player A
1172,QLearningPlayer,218,223,441,25,28,QLearningPlayer
1173,QLearningPlayer,227,227,454,26,24,Tie
1174,QLearningPlayer,222,217,439,29,30,Player A
1175,QLearningPlayer,223,228,451,26,25,QLearningPlayer
1176,QLearningPlayer,229,224,453,25,24,Player A
1177,QLearningPlayer,211,211,422,18,32,Tie
1178,QLearningPlayer,234,234,468,31,21,Tie
1179,QLearningPlayer,215,215,430,20,30,Tie
1180,QLearningPlayer,223,223,446,24,26,Tie
1181,QLearningPlayer,218,218,436,23,29,Tie
1182,QLearningPlayer,223,223,446,30,28,Tie
1183,QLearningPlayer,223,228,451,26,25,QLearningPlayer
1184,QLearningPlayer,236,236,472,26,18,Tie
1185,QLearningPlayer,232,232,464,27,21,Tie
1186,QLearningPlayer,230,225,455,27,24,Player A
1187,QLearningPlayer,229,229,458,36,26,Tie
1188,QLearningPlayer,228,233,461,30,23,QLearningPlayer
1189,QLearningPlayer,229,224,453,19,22,Player A
1190,QLearningPlayer,222,227,449,18,23,QLearningPlayer
1191,QLearningPlayer,228,223,451,26,25,Player A
1192,QLearningPlayer,215,220,435,22,29,QLearningPlayer
1193,QLearningPlayer,244,239,483,34,17,Player A
1194,QLearningPlayer,225,230,455,33,26,QLearningPlayer
1195,QLearningPlayer,215,215,430,26,32,Tie
1196,QLearningPlayer,231,226,457,23,22,Player A
1197,QLearningPlayer,236,241,477,28,17,QLearningPlayer
1198,QLearningPlayer,228,223,451,29,26,Player A
1199,QLearningPlayer,217,217,434,15,27,Tie
1200,QLearningPlayer,226,226,452,27,25,Tie
1201,QLearningPlayer,221,221,442,17,25,Tie
1202,QLearningPlayer,230,235,465,28,21,QLearningPlayer
1203,QLearningPlayer,217,217,434,21,29,Tie
1204,QLearningPlayer,233,233,466,23,19,Tie
1205,QLearningPlayer,223,223,446,24,26,Tie
1206,QLearningPlayer,218,213,431,18,29,Player A
1207,QLearningPlayer,213,213,426,31,35,Tie
1208,QLearningPlayer,240,240,480,25,15,Tie
1209,QLearningPlayer,238,238,476,30,18,Tie
1210,QLearningPlayer,226,226,452,27,25,Tie
1211,QLearningPlayer,234,239,473,24,17,QLearningPlayer
1212,QLearningPlayer,216,211,427,23,32,Player A
1213,QLearningPlayer,220,220,440,24,28,Tie
1214,QLearningPlayer,220,220,440,21,27,Tie
1215,QLearningPlayer,218,223,441,28,29,QLearningPlayer
1216,QLearningPlayer,248,243,491,36,15,Player A
1217,QLearningPlayer,221,226,447,19,24,QLearningPlayer
1218,QLearningPlayer,225,220,445,26,27,Player A
1219,QLearningPlayer,231,236,467,27,20,QLearningPlayer
1220,QLearningPlayer,228,228,456,28,24,Tie
1221,QLearningPlayer,221,216,437,27,30,Player A
1222,QLearningPlayer,228,233,461,21,20,QLearningPlayer
1223,QLearningPlayer,221,216,437,21,28,Player A
1224,QLearningPlayer,221,221,442,20,26,Tie
1225,QLearningPlayer,217,217,434,18,28,Tie
1226,QLearningPlayer,219,224,443,18,25,QLearningPlayer
1227,QLearningPlayer,223,223,446,30,28,Tie
1228,QLearningPlayer,221,221,442,23,27,Tie
1229,QLearningPlayer,228,223,451,20,23,Player A
1230,QLearningPlayer,224,224,448,29,27,Tie
1231,QLearningPlayer,223,228,451,17,22,QLearningPlayer
1232,QLearningPlayer,229,229,458,24,22,Tie
1233,QLearningPlayer,225,225,450,25,25,Tie
1234,QLearningPlayer,224,219,443,24,27,Player A
1235,QLearningPlayer,217,222,439,23,28,QLearningPlayer
1236,QLearningPlayer,233,233,466,26,20,Tie
1237,QLearningPlayer,229,224,453,31,26,Player A
1238,QLearningPlayer,228,233,461,27,22,QLearningPlayer
1239,QLearningPlayer,220,220,440,21,27,Tie
1240,QLearningPlayer,217,212,429,25,32,Player A
1241,QLearningPlayer,221,226,447,28,27,QLearningPlayer
1242,QLearningPlayer,215,215,430,20,30,Tie
1243,QLearningPlayer,204,204,408,16,36,Tie
1244,QLearningPlayer,222,217,439,23,28,Player A
1245,QLearningPlayer,203,208,411,22,37,QLearningPlayer
1246,QLearningPlayer,228,228,456,22,22,Tie
1247,QLearningPlayer,230,225,455,24,23,Player A
1248,QLearningPlayer,208,213,421,20,33,QLearningPlayer
1249,QLearningPlayer,218,218,436,26,30,Tie
1250,QLearningPlayer,216,211,427,23,32,Player A
1251,QLearningPlayer,230,235,465,31,22,QLearningPlayer
1252,QLearningPlayer,228,223,451,26,25,Player A
1253,QLearningPlayer,207,207,414,16,34,Tie
1254,QLearningPlayer,230,230,460,29,23,Tie
1255,QLearningPlayer,218,223,441,25,28,QLearningPlayer
1256,QLearningPlayer,224,219,443,24,27,Player A
1257,QLearningPlayer,233,233,466,29,21,Tie
1258,QLearningPlayer,212,212,424,17,31,Tie
1259,QLearningPlayer,225,230,455,27,24,QLearningPlayer
1260,QLearningPlayer,231,231,462,28,22,Tie
1261,QLearningPlayer,249,244,493,29,12,Player A
1262,QLearningPlayer,216,221,437,21,28,QLearningPlayer
1263,QLearningPlayer,246,241,487,35,16,Player A
1264,QLearningPlayer,231,236,467,27,20,QLearningPlayer
1265,QLearningPlayer,217,212,429,22,31,Player A
1266,QLearningPlayer,200,205,405,22,39,QLearningPlayer
1267,QLearningPlayer,206,206,412,23,37,Tie
1268,QLearningPlayer,228,223,451,23,24,Player A
1269,QLearningPlayer,225,225,450,25,25,Tie
1270,QLearningPlayer,234,234,468,28,20,Tie
1271,QLearningPlayer,222,227,449,21,24,QLearningPlayer
1272,QLearningPlayer,225,220,445,20,25,Player A
1273,QLearningPlayer,208,213,421,20,33,QLearningPlayer
1274,QLearningPlayer,235,230,465,28,21,Player A
1275,QLearningPlayer,218,223,441,19,26,QLearningPlayer
1276,QLearningPlayer,238,233,471,25,18,Player A
1277,QLearningPlayer,224,224,448,26,26,Tie
1278,QLearningPlayer,229,234,463,23,20,QLearningPlayer
1279,QLearningPlayer,222,217,439,20,27,Player A
1280,QLearningPlayer,241,241,482,30,16,Tie
1281,QLearningPlayer,217,222,439,20,27,QLearningPlayer
1282,QLearningPlayer,250,245,495,34,13,Player A
1283,QLearningPlayer,214,219,433,26,31,QLearningPlayer
1284,QLearningPlayer,230,225,455,30,25,Player A
1285,QLearningPlayer,235,235,470,30,20,Tie
1286,QLearningPlayer,218,223,441,22,27,QLearningPlayer
1287,QLearningPlayer,233,228,461,27,22,Player A
1288,QLearningPlayer,241,241,482,27,15,Tie
1289,QLearningPlayer,248,248,496,44,16,Tie
1290,QLearningPlayer,244,249,493,35,14,QLearningPlayer
1291,QLearningPlayer,242,237,479,33,18,Player A
1292,QLearningPlayer,227,227,454,26,24,Tie
1293,QLearningPlayer,224,224,448,26,26,Tie
1294,QLearningPlayer,226,231,457,29,24,QLearningPlayer
1295,QLearningPlayer,228,228,456,28,24,Tie
1296,QLearningPlayer,216,216,432,19,29,Tie
1297,QLearningPlayer,241,236,477,34,19,Player A
1298,QLearningPlayer,210,215,425,15,30,QLearningPlayer
1299,QLearningPlayer,237,232,469,26,19,Player A
1300,QLearningPlayer,232,232,464,30,22,Tie
1301,QLearningPlayer,234,234,468,25,19,Tie
1302,QLearningPlayer,213,218,431,21,30,QLearningPlayer
1303,QLearningPlayer,235,230,465,31,22,Player A
1304,QLearningPlayer,236,241,477,28,17,QLearningPlayer
1305,QLearningPlayer,232,232,464,27,21,Tie
1306,QLearningPlayer,223,218,441,25,28,Player A
1307,QLearningPlayer,223,228,451,29,26,QLearningPlayer
1308,QLearningPlayer,214,209,423,22,33,Player A
1309,QLearningPlayer,233,233,466,32,22,Tie
1310,QLearningPlayer,241,241,482,27,15,Tie
1311,QLearningPlayer,235,235,470,33,21,Tie
1312,QLearningPlayer,212,217,429,19,30,QLearningPlayer
1313,QLearningPlayer,228,223,451,29,26,Player A
1314,QLearningPlayer,222,227,449,24,25,QLearningPlayer
1315,QLearningPlayer,225,225,450,25,25,Tie
1316,QLearningPlayer,225,225,450,28,26,Tie
1317,QLearningPlayer,211,206,417,22,35,Player A
1318,QLearningPlayer,228,228,456,28,24,Tie
1319,QLearningPlayer,236,241,477,34,19,QLearningPlayer
1320,QLearningPlayer,222,222,444,25,27,Tie
1321,QLearningPlayer,216,216,432,22,30,Tie
1322,QLearningPlayer,209,204,413,15,34,Player A
1323,QLearningPlayer,236,241,477,31,18,QLearningPlayer
1324,QLearningPlayer,219,219,438,25,29,Tie
1325,QLearningPlayer,228,223,451,26,25,Player A
1326,QLearningPlayer,229,229,458,30,24,Tie
1327,QLearningPlayer,224,229,453,25,24,QLearningPlayer
1328,QLearningPlayer,217,217,434,24,30,Tie
1329,QLearningPlayer,234,229,463,29,22,Player A
1330,QLearningPlayer,231,231,462,22,20,Tie
1331,QLearningPlayer,211,216,427,23,32,QLearningPlayer
1332,QLearningPlayer,218,213,431,18,29,Player A
1333,QLearningPlayer,220,220,440,18,26,Tie
1334,QLearningPlayer,231,231,462,31,23,Tie
1335,QLearningPlayer,232,232,464,30,22,Tie
1336,QLearningPlayer,220,225,445,26,27,QLearningPlayer
1337,QLearningPlayer,236,236,472,29,19,Tie
1338,QLearningPlayer,228,223,451,23,24,Player A
1339,QLearningPlayer,235,240,475,35,20,QLearningPlayer
1340,QLearningPlayer,243,238,481,32,17,Player A
1341,QLearningPlayer,218,223,441,22,27,QLearningPlayer
1342,QLearningPlayer,226,226,452,30,26,Tie
1343,QLearningPlayer,223,218,441,28,29,Player A
1344,QLearningPlayer,226,226,452,27,25,Tie
1345,QLearningPlayer,237,242,479,27,16,QLearningPlayer
1346,QLearningPlayer,227,227,454,26,24,Tie
1347,QLearningPlayer,223,223,446,15,23,Tie
1348,QLearningPlayer,230,225,455,27,24,Player A
1349,QLearningPlayer,216,221,437,15,26,QLearningPlayer
1350,QLearningPlayer,223,223,446,24,26,Tie
0,PatternLearningPlayer,299,294,593,96,1,Player A
1,PatternLearningPlayer,276,281,557,57,0,PatternLearningPlayer
2,PatternLearningPlayer,282,277,559,59,0,Player A
3,PatternLearningPlayer,280,280,560,60,0,Tie
4,PatternLearningPlayer,297,297,594,97,1,Tie
5,PatternLearningPlayer,295,295,590,96,2,Tie
6,PatternLearningPlayer,297,297,594,97,1,Tie
7,PatternLearningPlayer,297,297,594,97,1,Tie
8,PatternLearningPlayer,297,297,594,97,1,Tie
9,PatternLearningPlayer,295,295,590,96,2,Tie
10,PatternLearningPlayer,297,297,594,97,1,Tie
11,PatternLearningPlayer,297,297,594,97,1,Tie
12,PatternLearningPlayer,295,295,590,96,2,Tie
13,PatternLearningPlayer,299,299,598,98,0,Tie
14,PatternLearningPlayer,295,295,590,96,2,Tie
15,PatternLearningPlayer,297,297,594,97,1,Tie
16,PatternLearningPlayer,295,295,590,96,2,Tie
17,PatternLearningPlayer,276,281,557,57,0,PatternLearningPlayer
18,PatternLearningPlayer,299,294,593,96,1,Player A
19,PatternLearningPlayer,295,295,590,96,2,Tie
20,PatternLearningPlayer,295,295,590,96,2,Tie
21,PatternLearningPlayer,297,297,594,97,1,Tie
22,PatternLearningPlayer,276,281,557,57,0,PatternLearningPlayer
23,PatternLearningPlayer,295,290,585,94,3,Player A
24,PatternLearningPlayer,300,300,600,100,0,Tie
25,PatternLearningPlayer,297,297,594,97,1,Tie
26,PatternLearningPlayer,297,297,594,97,1,Tie
27,PatternLearningPlayer,297,297,594,97,1,Tie
28,PatternLearningPlayer,297,297,594,97,1,Tie
29,PatternLearningPlayer,276,281,557,57,0,PatternLearningPlayer
30,PatternLearningPlayer,299,294,593,96,1,Player A
31,PatternLearningPlayer,299,299,598,98,0,Tie
32,PatternLearningPlayer,297,297,594,97,1,Tie
33,PatternLearningPlayer,300,300,600,100,0,Tie
34,PatternLearningPlayer,299,299,598,98,0,Tie
35,PatternLearningPlayer,299,299,598,98,0,Tie
36,PatternLearningPlayer,295,295,590,96,2,Tie
37,PatternLearningPlayer,280,280,560,60,0,Tie
38,PatternLearningPlayer,280,280,560,60,0,Tie
39,PatternLearningPlayer,299,299,598,98,0,Tie
40,PatternLearningPlayer,295,295,590,96,2,Tie
41,PatternLearningPlayer,276,281,557,57,0,PatternLearningPlayer
42,PatternLearningPlayer,299,294,593,96,1,Player A
43,PatternLearningPlayer,276,281,557,57,0,PatternLearningPlayer
44,PatternLearningPlayer,295,290,585,94,3,Player A
45,PatternLearningPlayer,280,280,560,60,0,Tie
46,PatternLearningPlayer,297,297,594,97,1,Tie
47,PatternLearningPlayer,297,297,594,97,1,Tie
48,PatternLearningPlayer,280,280,560,60,0,Tie
49,PatternLearningPlayer,297,297,594,97,1,Tie
50,PatternLearningPlayer,299,299,598,98,0,Tie
51,PatternLearningPlayer,280,280,560,60,0,Tie
52,PatternLearningPlayer,297,297,594,97,1,Tie
53,PatternLearningPlayer,276,281,557,57,0,PatternLearningPlayer
54,PatternLearningPlayer,300,295,595,98,1,Player A
55,PatternLearningPlayer,276,281,557,57,0,PatternLearningPlayer
56,PatternLearningPlayer,302,297,599,99,0,Player A
57,PatternLearningPlayer,299,299,598,98,0,Tie
58,PatternLearningPlayer,276,281,557,57,0,PatternLearningPlayer
59,PatternLearningPlayer,298,293,591,97,2,Player A
60,PatternLearningPlayer,300,300,600,100,0,Tie
61,PatternLearningPlayer,280,280,560,60,0,Tie
62,PatternLearningPlayer,299,299,598,98,0,Tie
63,PatternLearningPlayer,299,299,598,98,0,Tie
64,PatternLearningPlayer,300,300,600,100,0,Tie
65,PatternLearningPlayer,299,299,598,98,0,Tie
66,PatternLearningPlayer,297,297,594,97,1,Tie
67,PatternLearningPlayer,295,295,590,96,2,Tie
68,PatternLearningPlayer,300,300,600,100,0,Tie
69,PatternLearningPlayer,297,297,594,97,1,Tie
70,PatternLearningPlayer,280,280,560,60,0,Tie
71,PatternLearningPlayer,300,300,600,100,0,Tie
72,PatternLearningPlayer,300,300,600,100,0,Tie
73,PatternLearningPlayer,297,297,594,97,1,Tie
74,PatternLearningPlayer,297,297,594,97,1,Tie
75,PatternLearningPlayer,295,295,590,96,2,Tie
76,PatternLearningPlayer,299,299,598,98,0,Tie
77,PatternLearningPlayer,299,299,598,98,0,Tie
78,PatternLearningPlayer,297,297,594,97,1,Tie
79,PatternLearningPlayer,299,299,598,98,0,Tie
80,PatternLearningPlayer,295,295,590,96,2,Tie
81,PatternLearningPlayer,299,299,598,98,0,Tie
82,PatternLearningPlayer,300,300,600,100,0,Tie
83,PatternLearningPlayer,300,300,600,100,0,Tie
84,PatternLearningPlayer,280,280,560,60,0,Tie
85,PatternLearningPlayer,295,295,590,96,2,Tie
86,PatternLearningPlayer,300,300,600,100,0,Tie
87,PatternLearningPlayer,295,295,590,96,2,Tie
88,PatternLearningPlayer,297,297,594,97,1,Tie
89,PatternLearningPlayer,276,281,557,57,0,PatternLearningPlayer
90,PatternLearningPlayer,301,296,597,97,0,Player A
91,PatternLearningPlayer,297,297,594,97,1,Tie
92,PatternLearningPlayer,297,297,594,97,1,Tie
93,PatternLearningPlayer,297,297,594,97,1,Tie
94,PatternLearningPlayer,280,280,560,60,0,Tie
95,PatternLearningPlayer,295,295,590,96,2,Tie
96,PatternLearningPlayer,297,297,594,97,1,Tie
97,PatternLearningPlayer,299,299,598,98,0,Tie
98,PatternLearningPlayer,295,295,590,96,2,Tie
99,PatternLearningPlayer,280,280,560,60,0,Tie
100,PatternLearningPlayer,299,299,598,98,0,Tie
101,PatternLearningPlayer,297,297,594,97,1,Tie
102,PatternLearningPlayer,295,295,590,96,2,Tie
103,PatternLearningPlayer,299,299,598,98,0,Tie
104,PatternLearningPlayer,297,297,594,97,1,Tie
105,PatternLearningPlayer,297,297,594,97,1,Tie
106,PatternLearningPlayer,295,295,590,96,2,Tie
107,PatternLearningPlayer,300,300,600,100,0,Tie
108,PatternLearningPlayer,276,281,557,57,0,PatternLearningPlayer
109,PatternLearningPlayer,295,290,585,94,3,Player A
110,PatternLearningPlayer,295,295,590,96,2,Tie
111,PatternLearningPlayer,295,295,590,96,2,Tie
112,PatternLearningPlayer,297,297,594,97,1,Tie
113,PatternLearningPlayer,299,299,598,98,0,Tie
114,PatternLearningPlayer,297,297,594,97,1,Tie
115,PatternLearningPlayer,280,280,560,60,0,Tie
116,PatternLearningPlayer,299,299,598,98,0,Tie
117,PatternLearningPlayer,280,280,560,60,0,Tie
118,PatternLearningPlayer,300,300,600,100,0,Tie
119,PatternLearningPlayer,300,300,600,100,0,Tie
120,PatternLearningPlayer,295,295,590,96,2,Tie
121,PatternLearningPlayer,297,297,594,97,1,Tie
122,PatternLearningPlayer,300,300,600,100,0,Tie
123,PatternLearningPlayer,297,297,594,97,1,Tie
124,PatternLearningPlayer,295,295,590,96,2,Tie
125,PatternLearningPlayer,297,297,594,97,1,Tie
126,PatternLearningPlayer,300,300,600,100,0,Tie
127,PatternLearningPlayer,297,297,594,97,1,Tie
128,PatternLearningPlayer,276,281,557,57,0,PatternLearningPlayer
129,PatternLearningPlayer,299,294,593,96,1,Player A
130,PatternLearningPlayer,300,300,600,100,0,Tie
131,PatternLearningPlayer,276,281,557,57,0,PatternLearningPlayer
132,PatternLearningPlayer,282,277,559,59,0,Player A
133,PatternLearningPlayer,276,281,557,57,0,PatternLearningPlayer
134,PatternLearningPlayer,302,297,599,99,0,Player A
135,PatternLearningPlayer,280,280,560,60,0,Tie
136,PatternLearningPlayer,299,299,598,98,0,Tie
137,PatternLearningPlayer,297,297,594,97,1,Tie
138,PatternLearningPlayer,276,281,557,57,0,PatternLearningPlayer
139,PatternLearningPlayer,295,290,585,94,3,Player A
140,PatternLearningPlayer,276,281,557,57,0,PatternLearningPlayer
141,PatternLearningPlayer,301,296,597,97,0,Player A
142,PatternLearningPlayer,297,297,594,97,1,Tie
143,PatternLearningPlayer,297,297,594,97,1,Tie
144,PatternLearningPlayer,280,280,560,60,0,Tie
145,PatternLearningPlayer,297,297,594,97,1,Tie
146,PatternLearningPlayer,299,299,598,98,0,Tie
147,PatternLearningPlayer,295,295,590,96,2,Tie
148,PatternLearningPlayer,276,281,557,57,0,PatternLearningPlayer
149,PatternLearningPlayer,300,295,595,98,1,Player A
150,PatternLearningPlayer,295,295,590,96,2,Tie
151,PatternLearningPlayer,280,280,560,60,0,Tie
152,PatternLearningPlayer,295,295,590,96,2,Tie
153,PatternLearningPlayer,297,297,594,97,1,Tie
154,PatternLearningPlayer,297,297,594,97,1,Tie
155,PatternLearningPlayer,295,295,590,96,2,Tie
156,PatternLearningPlayer,299,299,598,98,0,Tie
157,PatternLearningPlayer,295,295,590,96,2,Tie
158,PatternLearningPlayer,299,299,598,98,0,Tie
159,PatternLearningPlayer,297,297,594,97,1,Tie
160,PatternLearningPlayer,300,300,600,100,0,Tie
161,PatternLearningPlayer,295,295,590,96,2,Tie
162,PatternLearningPlayer,295,295,590,96,2,Tie
163,PatternLearningPlayer,280,280,560,60,0,Tie
164,PatternLearningPlayer,295,295,590,96,2,Tie
165,PatternLearningPlayer,299,299,598,98,0,Tie
166,PatternLearningPlayer,300,300,600,100,0,Tie
167,PatternLearningPlayer,300,300,600,100,0,Tie
168,PatternLearningPlayer,276,281,557,57,0,PatternLearningPlayer
169,PatternLearningPlayer,301,296,597,97,0,Player A
170,PatternLearningPlayer,297,297,594,97,1,Tie
171,PatternLearningPlayer,300,300,600,100,0,Tie
172,PatternLearningPlayer,297,297,594,97,1,Tie
173,PatternLearningPlayer,299,299,598,98,0,Tie
174,PatternLearningPlayer,280,280,560,60,0,Tie
175,PatternLearningPlayer,297,297,594,97,1,Tie
176,PatternLearningPlayer,297,297,594,97,1,Tie
177,PatternLearningPlayer,297,297,594,97,1,Tie
178,PatternLearningPlayer,297,297,594,97,1,Tie
179,PatternLearningPlayer,300,300,600,100,0,Tie
180,PatternLearningPlayer,300,300,600,100,0,Tie
181,PatternLearningPlayer,299,299,598,98,0,Tie
182,PatternLearningPlayer,295,295,590,96,2,Tie
183,PatternLearningPlayer,297,297,594,97,1,Tie
184,PatternLearningPlayer,276,281,557,57,0,PatternLearningPlayer
185,PatternLearningPlayer,299,294,593,96,1,Player A
186,PatternLearningPlayer,276,281,557,57,0,PatternLearningPlayer
187,PatternLearningPlayer,302,297,599,99,0,Player A
188,PatternLearningPlayer,299,299,598,98,0,Tie
189,PatternLearningPlayer,295,295,590,96,2,Tie
190,PatternLearningPlayer,280,280,560,60,0,Tie
191,PatternLearningPlayer,297,297,594,97,1,Tie
192,PatternLearningPlayer,300,300,600,100,0,Tie
193,PatternLearningPlayer,295,295,590,96,2,Tie
194,PatternLearningPlayer,297,297,594,97,1,Tie
195,PatternLearningPlayer,280,280,560,60,0,Tie
196,PatternLearningPlayer,295,295,590,96,2,Tie
197,PatternLearningPlayer,299,299,598,98,0,Tie
198,PatternLearningPlayer,280,280,560,60,0,Tie
199,PatternLearningPlayer,300,300,600,100,0,Tie
200,PatternLearningPlayer,299,299,598,98,0,Tie
201,PatternLearningPlayer,297,297,594,97,1,Tie
202,PatternLearningPlayer,299,299,598,98,0,Tie
203,PatternLearningPlayer,295,295,590,96,2,Tie
204,PatternLearningPlayer,295,295,590,96,2,Tie
205,PatternLearningPlayer,297,297,594,97,1,Tie
206,PatternLearningPlayer,297,297,594,97,1,Tie
207,PatternLearningPlayer,299,299,598,98,0,Tie
208,PatternLearningPlayer,276,281,557,57,0,PatternLearningPlayer
209,PatternLearningPlayer,300,295,595,98,1,Player A
210,PatternLearningPlayer,280,280,560,60,0,Tie
211,PatternLearningPlayer,295,295,590,96,2,Tie
212,PatternLearningPlayer,300,300,600,100,0,Tie
213,PatternLearningPlayer,295,295,590,96,2,Tie
214,PatternLearningPlayer,276,281,557,57,0,PatternLearningPlayer
215,PatternLearningPlayer,282,277,559,59,0,Player A
216,PatternLearningPlayer,299,299,598,98,0,Tie
217,PatternLearningPlayer,299,299,598,98,0,Tie
218,PatternLearningPlayer,297,297,594,97,1,Tie
219,PatternLearningPlayer,299,299,598,98,0,Tie
220,PatternLearningPlayer,295,295,590,96,2,Tie
221,PatternLearningPlayer,276,281,557,57,0,PatternLearningPlayer
222,PatternLearningPlayer,300,295,595,98,1,Player A
223,PatternLearningPlayer,299,299,598,98,0,Tie
224,PatternLearningPlayer,276,281,557,57,0,PatternLearningPlayer
225,PatternLearningPlayer,282,277,559,59,0,Player A
226,PatternLearningPlayer,280,280,560,60,0,Tie
227,PatternLearningPlayer,299,299,598,98,0,Tie
228,PatternLearningPlayer,297,297,594,97,1,Tie
229,PatternLearningPlayer,299,299,598,98,0,Tie
230,PatternLearningPlayer,300,300,600,100,0,Tie
231,PatternLearningPlayer,295,295,590,96,2,Tie
232,PatternLearningPlayer,300,300,600,100,0,Tie
233,PatternLearningPlayer,299,299,598,98,0,Tie
234,PatternLearningPlayer,299,299,598,98,0,Tie
235,PatternLearningPlayer,295,295,590,96,2,Tie
236,PatternLearningPlayer,300,300,600,100,0,Tie
237,PatternLearningPlayer,297,297,594,97,1,Tie
238,PatternLearningPlayer,295,295,590,96,2,Tie
239,PatternLearningPlayer,300,300,600,100,0,Tie
240,PatternLearningPlayer,299,299,598,98,0,Tie
241,PatternLearningPlayer,297,297,594,97,1,Tie
242,PatternLearningPlayer,297,297,594,97,1,Tie
243,PatternLearningPlayer,297,297,594,97,1,Tie
244,PatternLearningPlayer,297,297,594,97,1,Tie
245,PatternLearningPlayer,299,299,598,98,0,Tie
246,PatternLearningPlayer,297,297,594,97,1,Tie
247,PatternLearningPlayer,300,300,600,100,0,Tie
248,PatternLearningPlayer,295,295,590,96,2,Tie
249,PatternLearningPlayer,300,300,600,100,0,Tie
250,PatternLearningPlayer,297,297,594,97,1,Tie
251,PatternLearningPlayer,300,300,600,100,0,Tie
252,PatternLearningPlayer,299,299,598,98,0,Tie
253,PatternLearningPlayer,295,295,590,96,2,Tie
254,PatternLearningPlayer,299,299,598,98,0,Tie
255,PatternLearningPlayer,297,297,594,97,1,Tie
256,PatternLearningPlayer,297,297,594,97,1,Tie
257,PatternLearningPlayer,297,297,594,97,1,Tie
258,PatternLearningPlayer,276,281,557,57,0,PatternLearningPlayer
259,PatternLearningPlayer,298,293,591,97,2,Player A
260,PatternLearningPlayer,297,297,594,97,1,Tie
261,PatternLearningPlayer,299,299,598,98,0,Tie
262,PatternLearningPlayer,300,300,600,100,0,Tie
263,PatternLearningPlayer,297,297,594,97,1,Tie
264,PatternLearningPlayer,295,295,590,96,2,Tie
265,PatternLearningPlayer,297,297,594,97,1,Tie
266,PatternLearningPlayer,297,297,594,97,1,Tie
267,PatternLearningPlayer,297,297,594,97,1,Tie
268,PatternLearningPlayer,299,299,598,98,0,Tie
269,PatternLearningPlayer,299,299,598,98,0,Tie
270,PatternLearningPlayer,300,300,600,100,0,Tie
271,PatternLearningPlayer,276,281,557,57,0,PatternLearningPlayer
272,PatternLearningPlayer,282,277,559,59,0,Player A
273,PatternLearningPlayer,299,299,598,98,0,Tie
274,PatternLearningPlayer,297,297,594,97,1,Tie
275,PatternLearningPlayer,299,299,598,98,0,Tie
276,PatternLearningPlayer,297,297,594,97,1,Tie
277,PatternLearningPlayer,297,297,594,97,1,Tie
278,PatternLearningPlayer,295,295,590,96,2,Tie
279,PatternLearningPlayer,280,280,560,60,0,Tie
280,PatternLearningPlayer,276,281,557,57,0,PatternLearningPlayer
281,PatternLearningPlayer,295,290,585,94,3,Player A
282,PatternLearningPlayer,295,295,590,96,2,Tie
283,PatternLearningPlayer,276,281,557,57,0,PatternLearningPlayer
284,PatternLearningPlayer,300,295,595,98,1,Player A
285,PatternLearningPlayer,299,299,598,98,0,Tie
286,PatternLearningPlayer,297,297,594,97,1,Tie
287,PatternLearningPlayer,297,297,594,97,1,Tie
288,PatternLearningPlayer,299,299,598,98,0,Tie
289,PatternLearningPlayer,295,295,590,96,2,Tie
290,PatternLearningPlayer,297,297,594,97,1,Tie
291,PatternLearningPlayer,276,281,557,57,0,PatternLearningPlayer
292,PatternLearningPlayer,301,296,597,97,0,Player A
293,PatternLearningPlayer,299,299,598,98,0,Tie
294,PatternLearningPlayer,276,281,557,57,0,PatternLearningPlayer
295,PatternLearningPlayer,298,293,591,97,2,Player A
296,PatternLearningPlayer,276,281,557,57,0,PatternLearningPlayer
297,PatternLearningPlayer,298,293,591,97,2,Player A
298,PatternLearningPlayer,299,299,598,98,0,Tie
299,PatternLearningPlayer,297,297,594,97,1,Tie
300,PatternLearningPlayer,299,299,598,98,0,Tie
301,PatternLearningPlayer,297,297,594,97,1,Tie
302,PatternLearningPlayer,280,280,560,60,0,Tie
303,PatternLearningPlayer,280,280,560,60,0,Tie
304,PatternLearningPlayer,299,299,598,98,0,Tie
305,PatternLearningPlayer,300,300,600,100,0,Tie
306,PatternLearningPlayer,299,299,598,98,0,Tie
307,PatternLearningPlayer,295,295,590,96,2,Tie
308,PatternLearningPlayer,297,297,594,97,1,Tie
309,PatternLearningPlayer,297,297,594,97,1,Tie
310,PatternLearningPlayer,276,281,557,57,0,PatternLearningPlayer
311,PatternLearningPlayer,301,296,597,97,0,Player A
312,PatternLearningPlayer,276,281,557,57,0,PatternLearningPlayer
313,PatternLearningPlayer,299,294,593,96,1,Player A
314,PatternLearningPlayer,297,297,594,97,1,Tie
315,PatternLearningPlayer,295,295,590,96,2,Tie
316,PatternLearningPlayer,300,300,600,100,0,Tie
317,PatternLearningPlayer,299,299,598,98,0,Tie
318,PatternLearningPlayer,276,281,557,57,0,PatternLearningPlayer
319,PatternLearningPlayer,301,296,597,97,0,Player A
320,PatternLearningPlayer,276,281,557,57,0,PatternLearningPlayer
321,PatternLearningPlayer,282,277,559,59,0,Player A
322,PatternLearningPlayer,297,297,594,97,1,Tie
323,PatternLearningPlayer,299,299,598,98,0,Tie
324,PatternLearningPlayer,295,295,590,96,2,Tie
325,PatternLearningPlayer,299,299,598,98,0,Tie
326,PatternLearningPlayer,299,299,598,98,0,Tie
327,PatternLearningPlayer,299,299,598,98,0,Tie
328,PatternLearningPlayer,300,300,600,100,0,Tie
329,PatternLearningPlayer,297,297,594,97,1,Tie
330,PatternLearningPlayer,300,300,600,100,0,Tie
331,PatternLearningPlayer,299,299,598,98,0,Tie
332,PatternLearningPlayer,300,300,600,100,0,Tie
333,PatternLearningPlayer,300,300,600,100,0,Tie
334,PatternLearningPlayer,297,297,594,97,1,Tie
335,PatternLearningPlayer,299,299,598,98,0,Tie
336,PatternLearningPlayer,299,299,598,98,0,Tie
337,PatternLearningPlayer,297,297,594,97,1,Tie
338,PatternLearningPlayer,299,299,598,98,0,Tie
339,PatternLearningPlayer,299,299,598,98,0,Tie
340,PatternLearningPlayer,280,280,560,60,0,Tie
341,PatternLearningPlayer,300,300,600,100,0,Tie
342,PatternLearningPlayer,295,295,590,96,2,Tie
343,PatternLearningPlayer,297,297,594,97,1,Tie
344,PatternLearningPlayer,297,297,594,97,1,Tie
345,PatternLearningPlayer,299,299,598,98,0,Tie
346,PatternLearningPlayer,300,300,600,100,0,Tie
347,PatternLearningPlayer,280,280,560,60,0,Tie
348,PatternLearningPlayer,299,299,598,98,0,Tie
349,PatternLearningPlayer,299,299,598,98,0,Tie
350,PatternLearningPlayer,297,297,594,97,1,Tie
351,PatternLearningPlayer,297,297,594,97,1,Tie
352,PatternLearningPlayer,297,297,594,97,1,Tie
353,PatternLearningPlayer,299,299,598,98,0,Tie
354,PatternLearningPlayer,299,299,598,98,0,Tie
355,PatternLearningPlayer,280,280,560,60,0,Tie
356,PatternLearningPlayer,297,297,594,97,1,Tie
357,PatternLearningPlayer,299,299,598,98,0,Tie
358,PatternLearningPlayer,300,300,600,100,0,Tie
359,PatternLearningPlayer,297,297,594,97,1,Tie
360,PatternLearningPlayer,295,295,590,96,2,Tie
361,PatternLearningPlayer,280,280,560,60,0,Tie
362,PatternLearningPlayer,295,295,590,96,2,Tie
363,PatternLearningPlayer,276,281,557,57,0,PatternLearningPlayer
364,PatternLearningPlayer,295,290,585,94,3,Player A
365,PatternLearningPlayer,297,297,594,97,1,Tie
366,PatternLearningPlayer,300,300,600,100,0,Tie
367,PatternLearningPlayer,299,299,598,98,0,Tie
368,PatternLearningPlayer,299,299,598,98,0,Tie
369,PatternLearningPlayer,300,300,600,100,0,Tie
370,PatternLearningPlayer,280,280,560,60,0,Tie
371,PatternLearningPlayer,297,297,594,97,1,Tie
372,PatternLearningPlayer,280,280,560,60,0,Tie
373,PatternLearningPlayer,276,281,557,57,0,PatternLearningPlayer
374,PatternLearningPlayer,301,296,597,97,0,Player A
375,PatternLearningPlayer,280,280,560,60,0,Tie
376,PatternLearningPlayer,276,281,557,57,0,PatternLearningPlayer
377,PatternLearningPlayer,300,295,595,98,1,Player A
378,PatternLearningPlayer,295,295,590,96,2,Tie
379,PatternLearningPlayer,295,295,590,96,2,Tie
380,PatternLearningPlayer,297,297,594,97,1,Tie
381,PatternLearningPlayer,297,297,594,97,1,Tie
382,PatternLearningPlayer,295,295,590,96,2,Tie
383,PatternLearningPlayer,297,297,594,97,1,Tie
384,PatternLearningPlayer,300,300,600,100,0,Tie
385,PatternLearningPlayer,297,297,594,97,1,Tie
386,PatternLearningPlayer,280,280,560,60,0,Tie
387,PatternLearningPlayer,276,281,557,57,0,PatternLearningPlayer
388,PatternLearningPlayer,298,293,591,97,2,Player A
389,PatternLearningPlayer,295,295,590,96,2,Tie
390,PatternLearningPlayer,300,300,600,100,0,Tie
391,PatternLearningPlayer,299,299,598,98,0,Tie
392,PatternLearningPlayer,300,300,600,100,0,Tie
393,PatternLearningPlayer,276,281,557,57,0,PatternLearningPlayer
394,PatternLearningPlayer,295,290,585,94,3,Player A
395,PatternLearningPlayer,295,295,590,96,2,Tie
396,PatternLearningPlayer,299,299,598,98,0,Tie
397,PatternLearningPlayer,297,297,594,97,1,Tie
398,PatternLearningPlayer,276,281,557,57,0,PatternLearningPlayer
399,PatternLearningPlayer,299,294,593,96,1,Player A
400,PatternLearningPlayer,276,281,557,57,0,PatternLearningPlayer
401,PatternLearningPlayer,282,277,559,59,0,Player A
402,PatternLearningPlayer,276,281,557,57,0,PatternLearningPlayer
403,PatternLearningPlayer,300,295,595,98,1,Player A
404,PatternLearningPlayer,299,299,598,98,0,Tie
405,PatternLearningPlayer,299,299,598,98,0,Tie
406,PatternLearningPlayer,297,297,594,97,1,Tie
407,PatternLearningPlayer,299,299,598,98,0,Tie
408,PatternLearningPlayer,280,280,560,60,0,Tie
409,PatternLearningPlayer,299,299,598,98,0,Tie
410,PatternLearningPlayer,299,299,598,98,0,Tie
411,PatternLearningPlayer,300,300,600,100,0,Tie
412,PatternLearningPlayer,276,281,557,57,0,PatternLearningPlayer
413,PatternLearningPlayer,300,295,595,98,1,Player A
414,PatternLearningPlayer,297,297,594,97,1,Tie
415,PatternLearningPlayer,297,297,594,97,1,Tie
416,PatternLearningPlayer,280,280,560,60,0,Tie
417,PatternLearningPlayer,295,295,590,96,2,Tie
418,PatternLearningPlayer,297,297,594,97,1,Tie
419,PatternLearningPlayer,299,299,598,98,0,Tie
420,PatternLearningPlayer,299,299,598,98,0,Tie
421,PatternLearningPlayer,297,297,594,97,1,Tie
422,PatternLearningPlayer,280,280,560,60,0,Tie
423,PatternLearningPlayer,300,300,600,100,0,Tie
424,PatternLearningPlayer,276,281,557,57,0,PatternLearningPlayer
425,PatternLearningPlayer,282,277,559,59,0,Player A
426,PatternLearningPlayer,299,299,598,98,0,Tie
427,PatternLearningPlayer,299,299,598,98,0,Tie
428,PatternLearningPlayer,280,280,560,60,0,Tie
429,PatternLearningPlayer,300,300,600,100,0,Tie
430,PatternLearningPlayer,295,295,590,96,2,Tie
431,PatternLearningPlayer,300,300,600,100,0,Tie
432,PatternLearningPlayer,295,295,590,96,2,Tie
433,PatternLearningPlayer,280,280,560,60,0,Tie
434,PatternLearningPlayer,276,281,557,57,0,PatternLearningPlayer
435,PatternLearningPlayer,282,277,559,59,0,Player A
436,PatternLearningPlayer,300,300,600,100,0,Tie
437,PatternLearningPlayer,299,299,598,98,0,Tie
438,PatternLearningPlayer,276,281,557,57,0,PatternLearningPlayer
439,PatternLearningPlayer,299,294,593,96,1,Player A
440,PatternLearningPlayer,297,297,594,97,1,Tie
441,PatternLearningPlayer,299,299,598,98,0,Tie
442,PatternLearningPlayer,297,297,594,97,1,Tie
443,PatternLearningPlayer,295,295,590,96,2,Tie
444,PatternLearningPlayer,299,299,598,98,0,Tie
445,PatternLearningPlayer,295,295,590,96,2,Tie
446,PatternLearningPlayer,295,295,590,96,2,Tie
447,PatternLearningPlayer,295,295,590,96,2,Tie
448,PatternLearningPlayer,276,281,557,57,0,PatternLearningPlayer
449,PatternLearningPlayer,298,293,591,97,2,Player A
450,PatternLearningPlayer,300,300,600,100,0,Tie
451,PatternLearningPlayer,299,299,598,98,0,Tie
452,PatternLearningPlayer,295,295,590,96,2,Tie
453,PatternLearningPlayer,299,299,598,98,0,Tie
454,PatternLearningPlayer,297,297,594,97,1,Tie
455,PatternLearningPlayer,295,295,590,96,2,Tie
456,PatternLearningPlayer,300,300,600,100,0,Tie
457,PatternLearningPlayer,299,299,598,98,0,Tie
458,PatternLearningPlayer,297,297,594,97,1,Tie
459,PatternLearningPlayer,280,280,560,60,0,Tie
460,PatternLearningPlayer,276,281,557,57,0,PatternLearningPlayer
461,PatternLearningPlayer,302,297,599,99,0,Player A
462,PatternLearningPlayer,295,295,590,96,2,Tie
463,PatternLearningPlayer,299,299,598,98,0,Tie
464,PatternLearningPlayer,295,295,590,96,2,Tie
465,PatternLearningPlayer,300,300,600,100,0,Tie
466,PatternLearningPlayer,299,299,598,98,0,Tie
467,PatternLearningPlayer,276,281,557,57,0,PatternLearningPlayer
468,PatternLearningPlayer,282,277,559,59,0,Player A
469,PatternLearningPlayer,276,281,557,57,0,PatternLearningPlayer
470,PatternLearningPlayer,302,297,599,99,0,Player A
471,PatternLearningPlayer,280,280,560,60,0,Tie
472,PatternLearningPlayer,297,297,594,97,1,Tie
473,PatternLearningPlayer,280,280,560,60,0,Tie
474,PatternLearningPlayer,297,297,594,97,1,Tie
475,PatternLearningPlayer,300,300,600,100,0,Tie
476,PatternLearningPlayer,276,281,557,57,0,PatternLearningPlayer
477,PatternLearningPlayer,299,294,593,96,1,Player A
478,PatternLearningPlayer,295,295,590,96,2,Tie
479,PatternLearningPlayer,300,300,600,100,0,Tie
480,PatternLearningPlayer,300,300,600,100,0,Tie
481,PatternLearningPlayer,280,280,560,60,0,Tie
482,PatternLearningPlayer,297,297,594,97,1,Tie
483,PatternLearningPlayer,295,295,590,96,2,Tie
484,PatternLearningPlayer,295,295,590,96,2,Tie
485,PatternLearningPlayer,300,300,600,100,0,Tie
486,PatternLearningPlayer,276,281,557,57,0,PatternLearningPlayer
487,PatternLearningPlayer,298,293,591,97,2,Player A
488,PatternLearningPlayer,300,300,600,100,0,Tie
489,PatternLearningPlayer,295,295,590,96,2,Tie
490,PatternLearningPlayer,299,299,598,98,0,Tie
491,PatternLearningPlayer,280,280,560,60,0,Tie
492,PatternLearningPlayer,295,295,590,96,2,Tie
493,PatternLearningPlayer,297,297,594,97,1,Tie
494,PatternLearningPlayer,297,297,594,97,1,Tie
495,PatternLearningPlayer,300,300,600,100,0,Tie
496,PatternLearningPlayer,297,297,594,97,1,Tie
497,PatternLearningPlayer,299,299,598,98,0,Tie
498,PatternLearningPlayer,295,295,590,96,2,Tie
499,PatternLearningPlayer,297,297,594,97,1,Tie
500,PatternLearningPlayer,276,281,557,57,0,PatternLearningPlayer
501,PatternLearningPlayer,299,294,593,96,1,Player A
502,PatternLearningPlayer,280,280,560,60,0,Tie
503,PatternLearningPlayer,300,300,600,100,0,Tie
504,PatternLearningPlayer,297,297,594,97,1,Tie
505,PatternLearningPlayer,297,297,594,97,1,Tie
506,PatternLearningPlayer,299,299,598,98,0,Tie
507,PatternLearningPlayer,297,297,594,97,1,Tie
508,PatternLearningPlayer,276,281,557,57,0,PatternLearningPlayer
509,PatternLearningPlayer,302,297,599,99,0,Player A
510,PatternLearningPlayer,299,299,598,98,0,Tie
511,PatternLearningPlayer,297,297,594,97,1,Tie
512,PatternLearningPlayer,276,281,557,57,0,PatternLearningPlayer
513,PatternLearningPlayer,300,295,595,98,1,Player A
514,PatternLearningPlayer,299,299,598,98,0,Tie
515,PatternLearningPlayer,299,299,598,98,0,Tie
516,PatternLearningPlayer,295,295,590,96,2,Tie
517,PatternLearningPlayer,300,300,600,100,0,Tie
518,PatternLearningPlayer,299,299,598,98,0,Tie
519,PatternLearningPlayer,276,281,557,57,0,PatternLearningPlayer
520,PatternLearningPlayer,301,296,597,97,0,Player A
521,PatternLearningPlayer,295,295,590,96,2,Tie
522,PatternLearningPlayer,299,299,598,98,0,Tie
523,PatternLearningPlayer,297,297,594,97,1,Tie
524,PatternLearningPlayer,276,281,557,57,0,PatternLearningPlayer
525,PatternLearningPlayer,295,290,585,94,3,Player A
526,PatternLearningPlayer,300,300,600,100,0,Tie
527,PatternLearningPlayer,295,295,590,96,2,Tie
528,PatternLearningPlayer,300,300,600,100,0,Tie
529,PatternLearningPlayer,299,299,598,98,0,Tie
530,PatternLearningPlayer,300,300,600,100,0,Tie
531,PatternLearningPlayer,299,299,598,98,0,Tie
532,PatternLearningPlayer,299,299,598,98,0,Tie
533,PatternLearningPlayer,297,297,594,97,1,Tie
534,PatternLearningPlayer,295,295,590,96,2,Tie
535,PatternLearningPlayer,300,300,600,100,0,Tie
536,PatternLearningPlayer,276,281,557,57,0,PatternLearningPlayer
537,PatternLearningPlayer,295,290,585,94,3,Player A
538,PatternLearningPlayer,276,281,557,57,0,PatternLearningPlayer
539,PatternLearningPlayer,302,297,599,99,0,Player A
540,PatternLearningPlayer,295,295,590,96,2,Tie
541,PatternLearningPlayer,297,297,594,97,1,Tie
542,PatternLearningPlayer,297,297,594,97,1,Tie
543,PatternLearningPlayer,297,297,594,97,1,Tie
544,PatternLearningPlayer,299,299,598,98,0,Tie
545,PatternLearningPlayer,280,280,560,60,0,Tie
546,PatternLearningPlayer,297,297,594,97,1,Tie
547,PatternLearningPlayer,299,299,598,98,0,Tie
548,PatternLearningPlayer,297,297,594,97,1,Tie
549,PatternLearningPlayer,295,295,590,96,2,Tie
550,PatternLearningPlayer,299,299,598,98,0,Tie
551,PatternLearningPlayer,300,300,600,100,0,Tie
552,PatternLearningPlayer,295,295,590,96,2,Tie
553,PatternLearningPlayer,280,280,560,60,0,Tie
554,PatternLearningPlayer,297,297,594,97,1,Tie
555,PatternLearningPlayer,297,297,594,97,1,Tie
556,PatternLearningPlayer,276,281,557,57,0,PatternLearningPlayer
557,PatternLearningPlayer,299,294,593,96,1,Player A
558,PatternLearningPlayer,276,281,557,57,0,PatternLearningPlayer
559,PatternLearningPlayer,301,296,597,97,0,Player A
560,PatternLearningPlayer,276,281,557,57,0,PatternLearningPlayer
561,PatternLearningPlayer,282,277,559,59,0,Player A
562,PatternLearningPlayer,280,280,560,60,0,Tie
563,PatternLearningPlayer,297,297,594,97,1,Tie
564,PatternLearningPlayer,299,299,598,98,0,Tie
565,PatternLearningPlayer,299,299,598,98,0,Tie
566,PatternLearningPlayer,297,297,594,97,1,Tie
567,PatternLearningPlayer,276,281,557,57,0,PatternLearningPlayer
568,PatternLearningPlayer,299,294,593,96,1,Player A
569,PatternLearningPlayer,300,300,600,100,0,Tie
570,PatternLearningPlayer,299,299,598,98,0,Tie
571,PatternLearningPlayer,299,299,598,98,0,Tie
572,PatternLearningPlayer,297,297,594,97,1,Tie
573,PatternLearningPlayer,280,280,560,60,0,Tie
574,PatternLearningPlayer,297,297,594,97,1,Tie
575,PatternLearningPlayer,280,280,560,60,0,Tie
576,PatternLearningPlayer,299,299,598,98,0,Tie
577,PatternLearningPlayer,297,297,594,97,1,Tie
578,PatternLearningPlayer,297,297,594,97,1,Tie
579,PatternLearningPlayer,295,295,590,96,2,Tie
580,PatternLearningPlayer,299,299,598,98,0,Tie
581,PatternLearningPlayer,299,299,598,98,0,Tie
582,PatternLearningPlayer,300,300,600,100,0,Tie
583,PatternLearningPlayer,297,297,594,97,1,Tie
584,PatternLearningPlayer,276,281,557,57,0,PatternLearningPlayer
585,PatternLearningPlayer,300,295,595,98,1,Player A
586,PatternLearningPlayer,299,299,598,98,0,Tie
587,PatternLearningPlayer,300,300,600,100,0,Tie
588,PatternLearningPlayer,276,281,557,57,0,PatternLearningPlayer
589,PatternLearningPlayer,300,295,595,98,1,Player A
590,PatternLearningPlayer,295,295,590,96,2,Tie
591,PatternLearningPlayer,280,280,560,60,0,Tie
592,PatternLearningPlayer,300,300,600,100,0,Tie
593,PatternLearningPlayer,276,281,557,57,0,PatternLearningPlayer
594,PatternLearningPlayer,299,294,593,96,1,Player A
595,PatternLearningPlayer,299,299,598,98,0,Tie
596,PatternLearningPlayer,300,300,600,100,0,Tie
597,PatternLearningPlayer,297,297,594,97,1,Tie
598,PatternLearningPlayer,299,299,598,98,0,Tie
599,PatternLearningPlayer,295,295,590,96,2,Tie
600,PatternLearningPlayer,297,297,594,97,1,Tie
601,PatternLearningPlayer,297,297,594,97,1,Tie
602,PatternLearningPlayer,297,297,594,97,1,Tie
603,PatternLearningPlayer,299,299,598,98,0,Tie
604,PatternLearningPlayer,297,297,594,97,1,Tie
605,PatternLearningPlayer,276,281,557,57,0,PatternLearningPlayer
606,PatternLearningPlayer,301,296,597,97,0,Player A
607,PatternLearningPlayer,280,280,560,60,0,Tie
608,PatternLearningPlayer,297,297,594,97,1,Tie
609,PatternLearningPlayer,299,299,598,98,0,Tie
610,PatternLearningPlayer,299,299,598,98,0,Tie
611,PatternLearningPlayer,276,281,557,57,0,PatternLearningPlayer
612,PatternLearningPlayer,299,294,593,96,1,Player A
613,PatternLearningPlayer,299,299,598,98,0,Tie
614,PatternLearningPlayer,299,299,598,98,0,Tie
615,PatternLearningPlayer,299,299,598,98,0,Tie
616,PatternLearningPlayer,280,280,560,60,0,Tie
617,PatternLearningPlayer,297,297,594,97,1,Tie
618,PatternLearningPlayer,280,280,560,60,0,Tie
619,PatternLearningPlayer,299,299,598,98,0,Tie
620,PatternLearningPlayer,299,299,598,98,0,Tie
621,PatternLearningPlayer,295,295,590,96,2,Tie
622,PatternLearningPlayer,299,299,598,98,0,Tie
623,PatternLearningPlayer,299,299,598,98,0,Tie
624,PatternLearningPlayer,300,300,600,100,0,Tie
625,PatternLearningPlayer,297,297,594,97,1,Tie
626,PatternLearningPlayer,295,295,590,96,2,Tie
627,PatternLearningPlayer,299,299,598,98,0,Tie
628,PatternLearningPlayer,297,297,594,97,1,Tie
629,PatternLearningPlayer,297,297,594,97,1,Tie
630,PatternLearningPlayer,295,295,590,96,2,Tie
631,PatternLearningPlayer,297,297,594,97,1,Tie
632,PatternLearningPlayer,299,299,598,98,0,Tie
633,PatternLearningPlayer,297,297,594,97,1,Tie
634,PatternLearningPlayer,276,281,557,57,0,PatternLearningPlayer
635,PatternLearningPlayer,282,277,559,59,0,Player A
636,PatternLearningPlayer,297,297,594,97,1,Tie
637,PatternLearningPlayer,276,281,557,57,0,PatternLearningPlayer
638,PatternLearningPlayer,298,293,591,97,2,Player A
639,PatternLearningPlayer,297,297,594,97,1,Tie
640,PatternLearningPlayer,276,281,557,57,0,PatternLearningPlayer
641,PatternLearningPlayer,302,297,599,99,0,Player A
642,PatternLearningPlayer,299,299,598,98,0,Tie
643,PatternLearningPlayer,276,281,557,57,0,PatternLearningPlayer
644,PatternLearningPlayer,299,294,593,96,1,Player A
645,PatternLearningPlayer,297,297,594,97,1,Tie
646,PatternLearningPlayer,295,295,590,96,2,Tie
647,PatternLearningPlayer,300,300,600,100,0,Tie
648,PatternLearningPlayer,295,295,590,96,2,Tie
649,PatternLearningPlayer,299,299,598,98,0,Tie
650,PatternLearningPlayer,297,297,594,97,1,Tie
651,PatternLearningPlayer,300,300,600,100,0,Tie
652,PatternLearningPlayer,299,299,598,98,0,Tie
653,PatternLearningPlayer,299,299,598,98,0,Tie
654,PatternLearningPlayer,297,297,594,97,1,Tie
655,PatternLearningPlayer,276,281,557,57,0,PatternLearningPlayer
656,PatternLearningPlayer,299,294,593,96,1,Player A
657,PatternLearningPlayer,300,300,600,100,0,Tie
658,PatternLearningPlayer,276,281,557,57,0,PatternLearningPlayer
659,PatternLearningPlayer,299,294,593,96,1,Player A
660,PatternLearningPlayer,295,295,590,96,2,Tie
661,PatternLearningPlayer,295,295,590,96,2,Tie
662,PatternLearningPlayer,297,297,594,97,1,Tie
663,PatternLearningPlayer,300,300,600,100,0,Tie
664,PatternLearningPlayer,299,299,598,98,0,Tie
665,PatternLearningPlayer,280,280,560,60,0,Tie
666,PatternLearningPlayer,300,300,600,100,0,Tie
667,PatternLearningPlayer,299,299,598,98,0,Tie
668,PatternLearningPlayer,276,281,557,57,0,PatternLearningPlayer
669,PatternLearningPlayer,301,296,597,97,0,Player A
670,PatternLearningPlayer,276,281,557,57,0,PatternLearningPlayer
671,PatternLearningPlayer,282,277,559,59,0,Player A
672,PatternLearningPlayer,295,295,590,96,2,Tie
673,PatternLearningPlayer,297,297,594,97,1,Tie
674,PatternLearningPlayer,280,280,560,60,0,Tie
675,PatternLearningPlayer,297,297,594,97,1,Tie
676,PatternLearningPlayer,297,297,594,97,1,Tie
677,PatternLearningPlayer,276,281,557,57,0,PatternLearningPlayer
678,PatternLearningPlayer,282,277,559,59,0,Player A
679,PatternLearningPlayer,299,299,598,98,0,Tie
680,PatternLearningPlayer,299,299,598,98,0,Tie
681,PatternLearningPlayer,280,280,560,60,0,Tie
682,PatternLearningPlayer,300,300,600,100,0,Tie
683,PatternLearningPlayer,297,297,594,97,1,Tie
684,PatternLearningPlayer,300,300,600,100,0,Tie
685,PatternLearningPlayer,297,297,594,97,1,Tie
686,PatternLearningPlayer,280,280,560,60,0,Tie
687,PatternLearningPlayer,299,299,598,98,0,Tie
688,PatternLearningPlayer,297,297,594,97,1,Tie
689,PatternLearningPlayer,300,300,600,100,0,Tie
690,PatternLearningPlayer,300,300,600,100,0,Tie
691,PatternLearningPlayer,300,300,600,100,0,Tie
692,PatternLearningPlayer,276,281,557,57,0,PatternLearningPlayer
693,PatternLearningPlayer,299,294,593,96,1,Player A
694,PatternLearningPlayer,300,300,600,100,0,Tie
695,PatternLearningPlayer,297,297,594,97,1,Tie
696,PatternLearningPlayer,276,281,557,57,0,PatternLearningPlayer
697,PatternLearningPlayer,302,297,599,99,0,Player A
698,PatternLearningPlayer,295,295,590,96,2,Tie
699,PatternLearningPlayer,280,280,560,60,0,Tie
700,PatternLearningPlayer,295,295,590,96,2,Tie
701,PatternLearningPlayer,300,300,600,100,0,Tie
702,PatternLearningPlayer,300,300,600,100,0,Tie
703,PatternLearningPlayer,299,299,598,98,0,Tie
704,PatternLearningPlayer,276,281,557,57,0,PatternLearningPlayer
705,PatternLearningPlayer,301,296,597,97,0,Player A
706,PatternLearningPlayer,300,300,600,100,0,Tie
707,PatternLearningPlayer,299,299,598,98,0,Tie
708,PatternLearningPlayer,299,299,598,98,0,Tie
709,PatternLearningPlayer,297,297,594,97,1,Tie
710,PatternLearningPlayer,276,281,557,57,0,PatternLearningPlayer
711,PatternLearningPlayer,300,295,595,98,1,Player A
712,PatternLearningPlayer,300,300,600,100,0,Tie
713,PatternLearningPlayer,297,297,594,97,1,Tie
714,PatternLearningPlayer,300,300,600,100,0,Tie
715,PatternLearningPlayer,299,299,598,98,0,Tie
716,PatternLearningPlayer,299,299,598,98,0,Tie
717,PatternLearningPlayer,299,299,598,98,0,Tie
718,PatternLearningPlayer,299,299,598,98,0,Tie
719,PatternLearningPlayer,299,299,598,98,0,Tie
720,PatternLearningPlayer,299,299,598,98,0,Tie
721,PatternLearningPlayer,276,281,557,57,0,PatternLearningPlayer
722,PatternLearningPlayer,301,296,597,97,0,Player A
723,PatternLearningPlayer,295,295,590,96,2,Tie
724,PatternLearningPlayer,300,300,600,100,0,Tie
725,PatternLearningPlayer,295,295,590,96,2,Tie
726,PatternLearningPlayer,297,297,594,97,1,Tie
727,PatternLearningPlayer,299,299,598,98,0,Tie
728,PatternLearningPlayer,295,295,590,96,2,Tie
729,PatternLearningPlayer,299,299,598,98,0,Tie
730,PatternLearningPlayer,299,299,598,98,0,Tie
731,PatternLearningPlayer,276,281,557,57,0,PatternLearningPlayer
732,PatternLearningPlayer,298,293,591,97,2,Player A
733,PatternLearningPlayer,299,299,598,98,0,Tie
734,PatternLearningPlayer,299,299,598,98,0,Tie
735,PatternLearningPlayer,299,299,598,98,0,Tie
736,PatternLearningPlayer,299,299,598,98,0,Tie
737,PatternLearningPlayer,300,300,600,100,0,Tie
738,PatternLearningPlayer,276,281,557,57,0,PatternLearningPlayer
739,PatternLearningPlayer,301,296,597,97,0,Player A
740,PatternLearningPlayer,297,297,594,97,1,Tie
741,PatternLearningPlayer,299,299,598,98,0,Tie
742,PatternLearningPlayer,295,295,590,96,2,Tie
743,PatternLearningPlayer,297,297,594,97,1,Tie
744,PatternLearningPlayer,280,280,560,60,0,Tie
745,PatternLearningPlayer,276,281,557,57,0,PatternLearningPlayer
746,PatternLearningPlayer,299,294,593,96,1,Player A
747,PatternLearningPlayer,297,297,594,97,1,Tie
748,PatternLearningPlayer,276,281,557,57,0,PatternLearningPlayer
749,PatternLearningPlayer,301,296,597,97,0,Player A
750,PatternLearningPlayer,299,299,598,98,0,Tie
751,PatternLearningPlayer,297,297,594,97,1,Tie
752,PatternLearningPlayer,295,295,590,96,2,Tie
753,PatternLearningPlayer,280,280,560,60,0,Tie
754,PatternLearningPlayer,295,295,590,96,2,Tie
755,PatternLearningPlayer,297,297,594,97,1,Tie
756,PatternLearningPlayer,297,297,594,97,1,Tie
757,PatternLearningPlayer,295,295,590,96,2,Tie
758,PatternLearningPlayer,280,280,560,60,0,Tie
759,PatternLearningPlayer,297,297,594,97,1,Tie
760,PatternLearningPlayer,280,280,560,60,0,Tie
761,PatternLearningPlayer,280,280,560,60,0,Tie
762,PatternLearningPlayer,295,295,590,96,2,Tie
763,PatternLearningPlayer,297,297,594,97,1,Tie
764,PatternLearningPlayer,280,280,560,60,0,Tie
765,PatternLearningPlayer,297,297,594,97,1,Tie
766,PatternLearningPlayer,297,297,594,97,1,Tie
767,PatternLearningPlayer,297,297,594,97,1,Tie
768,PatternLearningPlayer,297,297,594,97,1,Tie
769,PatternLearningPlayer,300,300,600,100,0,Tie
770,PatternLearningPlayer,280,280,560,60,0,Tie
771,PatternLearningPlayer,299,299,598,98,0,Tie
772,PatternLearningPlayer,295,295,590,96,2,Tie
773,PatternLearningPlayer,299,299,598,98,0,Tie
774,PatternLearningPlayer,299,299,598,98,0,Tie
775,PatternLearningPlayer,297,297,594,97,1,Tie
776,PatternLearningPlayer,299,299,598,98,0,Tie
777,PatternLearningPlayer,299,299,598,98,0,Tie
778,PatternLearningPlayer,297,297,594,97,1,Tie
779,PatternLearningPlayer,280,280,560,60,0,Tie
780,PatternLearningPlayer,295,295,590,96,2,Tie
781,PatternLearningPlayer,280,280,560,60,0,Tie
782,PatternLearningPlayer,300,300,600,100,0,Tie
783,PatternLearningPlayer,295,295,590,96,2,Tie
784,PatternLearningPlayer,295,295,590,96,2,Tie
785,PatternLearningPlayer,297,297,594,97,1,Tie
786,PatternLearningPlayer,300,300,600,100,0,Tie
787,PatternLearningPlayer,295,295,590,96,2,Tie
788,PatternLearningPlayer,297,297,594,97,1,Tie
789,PatternLearningPlayer,280,280,560,60,0,Tie
790,PatternLearningPlayer,295,295,590,96,2,Tie
791,PatternLearningPlayer,295,295,590,96,2,Tie
792,PatternLearningPlayer,295,295,590,96,2,Tie
793,PatternLearningPlayer,280,280,560,60,0,Tie
794,PatternLearningPlayer,297,297,594,97,1,Tie
795,PatternLearningPlayer,300,300,600,100,0,Tie
796,PatternLearningPlayer,280,280,560,60,0,Tie
797,PatternLearningPlayer,299,299,598,98,0,Tie
798,PatternLearningPlayer,300,300,600,100,0,Tie
799,PatternLearningPlayer,299,299,598,98,0,Tie
800,PatternLearningPlayer,299,299,598,98,0,Tie
801,PatternLearningPlayer,297,297,594,97,1,Tie
802,PatternLearningPlayer,297,297,594,97,1,Tie
803,PatternLearningPlayer,300,300,600,100,0,Tie
804,PatternLearningPlayer,276,281,557,57,0,PatternLearningPlayer
805,PatternLearningPlayer,301,296,597,97,0,Player A
806,PatternLearningPlayer,300,300,600,100,0,Tie
807,PatternLearningPlayer,297,297,594,97,1,Tie
808,PatternLearningPlayer,299,299,598,98,0,Tie
809,PatternLearningPlayer,300,300,600,100,0,Tie
810,PatternLearningPlayer,295,295,590,96,2,Tie
811,PatternLearningPlayer,297,297,594,97,1,Tie
812,PatternLearningPlayer,299,299,598,98,0,Tie
813,PatternLearningPlayer,299,299,598,98,0,Tie
814,PatternLearningPlayer,276,281,557,57,0,PatternLearningPlayer
815,PatternLearningPlayer,300,295,595,98,1,Player A
816,PatternLearningPlayer,300,300,600,100,0,Tie
817,PatternLearningPlayer,297,297,594,97,1,Tie
818,PatternLearningPlayer,276,281,557,57,0,PatternLearningPlayer
819,PatternLearningPlayer,299,294,593,96,1,Player A
820,PatternLearningPlayer,297,297,594,97,1,Tie
821,PatternLearningPlayer,299,299,598,98,0,Tie
822,PatternLearningPlayer,297,297,594,97,1,Tie
823,PatternLearningPlayer,280,280,560,60,0,Tie
824,PatternLearningPlayer,299,299,598,98,0,Tie
825,PatternLearningPlayer,297,297,594,97,1,Tie
826,PatternLearningPlayer,295,295,590,96,2,Tie
827,PatternLearningPlayer,280,280,560,60,0,Tie
828,PatternLearningPlayer,300,300,600,100,0,Tie
829,PatternLearningPlayer,299,299,598,98,0,Tie
830,PatternLearningPlayer,280,280,560,60,0,Tie
831,PatternLearningPlayer,299,299,598,98,0,Tie
832,PatternLearningPlayer,297,297,594,97,1,Tie
833,PatternLearningPlayer,280,280,560,60,0,Tie
834,PatternLearningPlayer,297,297,594,97,1,Tie
835,PatternLearningPlayer,300,300,600,100,0,Tie
836,PatternLearningPlayer,295,295,590,96,2,Tie
837,PatternLearningPlayer,280,280,560,60,0,Tie
838,PatternLearningPlayer,280,280,560,60,0,Tie
839,PatternLearningPlayer,297,297,594,97,1,Tie
840,PatternLearningPlayer,276,281,557,57,0,PatternLearningPlayer
841,PatternLearningPlayer,298,293,591,97,2,Player A
842,PatternLearningPlayer,297,297,594,97,1,Tie
843,PatternLearningPlayer,295,295,590,96,2,Tie
844,PatternLearningPlayer,297,297,594,97,1,Tie
845,PatternLearningPlayer,295,295,590,96,2,Tie
846,PatternLearningPlayer,297,297,594,97,1,Tie
847,PatternLearningPlayer,300,300,600,100,0,Tie
848,PatternLearningPlayer,299,299,598,98,0,Tie
849,PatternLearningPlayer,299,299,598,98,0,Tie
850,PatternLearningPlayer,276,281,557,57,0,PatternLearningPlayer
851,PatternLearningPlayer,282,277,559,59,0,Player A
852,PatternLearningPlayer,297,297,594,97,1,Tie
853,PatternLearningPlayer,295,295,590,96,2,Tie
854,PatternLearningPlayer,297,297,594,97,1,Tie
855,PatternLearningPlayer,280,280,560,60,0,Tie
856,PatternLearningPlayer,276,281,557,57,0,PatternLearningPlayer
857,PatternLearningPlayer,301,296,597,97,0,Player A
858,PatternLearningPlayer,300,300,600,100,0,Tie
859,PatternLearningPlayer,300,300,600,100,0,Tie
860,PatternLearningPlayer,299,299,598,98,0,Tie
861,PatternLearningPlayer,297,297,594,97,1,Tie
862,PatternLearningPlayer,276,281,557,57,0,PatternLearningPlayer
863,PatternLearningPlayer,298,293,591,97,2,Player A
864,PatternLearningPlayer,276,281,557,57,0,PatternLearningPlayer
865,PatternLearningPlayer,295,290,585,94,3,Player A
866,PatternLearningPlayer,299,299,598,98,0,Tie
867,PatternLearningPlayer,295,295,590,96,2,Tie
868,PatternLearningPlayer,297,297,594,97,1,Tie
869,PatternLearningPlayer,299,299,598,98,0,Tie
870,PatternLearningPlayer,280,280,560,60,0,Tie
871,PatternLearningPlayer,299,299,598,98,0,Tie
872,PatternLearningPlayer,297,297,594,97,1,Tie
873,PatternLearningPlayer,280,280,560,60,0,Tie
874,PatternLearningPlayer,300,300,600,100,0,Tie
875,PatternLearningPlayer,276,281,557,57,0,PatternLearningPlayer
876,PatternLearningPlayer,299,294,593,96,1,Player A
877,PatternLearningPlayer,299,299,598,98,0,Tie
878,PatternLearningPlayer,297,297,594,97,1,Tie
879,PatternLearningPlayer,295,295,590,96,2,Tie
880,PatternLearningPlayer,297,297,594,97,1,Tie
881,PatternLearningPlayer,297,297,594,97,1,Tie
882,PatternLearningPlayer,297,297,594,97,1,Tie
883,PatternLearningPlayer,297,297,594,97,1,Tie
884,PatternLearningPlayer,276,281,557,57,0,PatternLearningPlayer
885,PatternLearningPlayer,282,277,559,59,0,Player A
886,PatternLearningPlayer,297,297,594,97,1,Tie
887,PatternLearningPlayer,297,297,594,97,1,Tie
888,PatternLearningPlayer,300,300,600,100,0,Tie
889,PatternLearningPlayer,299,299,598,98,0,Tie
890,PatternLearningPlayer,276,281,557,57,0,PatternLearningPlayer
891,PatternLearningPlayer,302,297,599,99,0,Player A
892,PatternLearningPlayer,297,297,594,97,1,Tie
893,PatternLearningPlayer,299,299,598,98,0,Tie
894,PatternLearningPlayer,299,299,598,98,0,Tie
895,PatternLearningPlayer,280,280,560,60,0,Tie
896,PatternLearningPlayer,299,299,598,98,0,Tie
897,PatternLearningPlayer,299,299,598,98,0,Tie
898,PatternLearningPlayer,299,299,598,98,0,Tie
899,PatternLearningPlayer,299,299,598,98,0,Tie
900,PatternLearningPlayer,300,300,600,100,0,Tie
901,PatternLearningPlayer,299,299,598,98,0,Tie
902,PatternLearningPlayer,297,297,594,97,1,Tie
903,PatternLearningPlayer,300,300,600,100,0,Tie
904,PatternLearningPlayer,280,280,560,60,0,Tie
905,PatternLearningPlayer,299,299,598,98,0,Tie
906,PatternLearningPlayer,280,280,560,60,0,Tie
907,PatternLearningPlayer,297,297,594,97,1,Tie
908,PatternLearningPlayer,276,281,557,57,0,PatternLearningPlayer
909,PatternLearningPlayer,299,294,593,96,1,Player A
910,PatternLearningPlayer,280,280,560,60,0,Tie
911,PatternLearningPlayer,297,297,594,97,1,Tie
912,PatternLearningPlayer,295,295,590,96,2,Tie
913,PatternLearningPlayer,276,281,557,57,0,PatternLearningPlayer
914,PatternLearningPlayer,299,294,593,96,1,Player A
915,PatternLearningPlayer,300,300,600,100,0,Tie
916,PatternLearningPlayer,299,299,598,98,0,Tie
917,PatternLearningPlayer,297,297,594,97,1,Tie
918,PatternLearningPlayer,295,295,590,96,2,Tie
919,PatternLearningPlayer,280,280,560,60,0,Tie
920,PatternLearningPlayer,297,297,594,97,1,Tie
921,PatternLearningPlayer,280,280,560,60,0,Tie
922,PatternLearningPlayer,276,281,557,57,0,PatternLearningPlayer
923,PatternLearningPlayer,299,294,593,96,1,Player A
924,PatternLearningPlayer,299,299,598,98,0,Tie
925,PatternLearningPlayer,297,297,594,97,1,Tie
926,PatternLearningPlayer,300,300,600,100,0,Tie
927,PatternLearningPlayer,295,295,590,96,2,Tie
928,PatternLearningPlayer,299,299,598,98,0,Tie
929,PatternLearningPlayer,300,300,600,100,0,Tie
930,PatternLearningPlayer,299,299,598,98,0,Tie
931,PatternLearningPlayer,297,297,594,97,1,Tie
932,PatternLearningPlayer,299,299,598,98,0,Tie
933,PatternLearningPlayer,300,300,600,100,0,Tie
934,PatternLearningPlayer,299,299,598,98,0,Tie
935,PatternLearningPlayer,280,280,560,60,0,Tie
936,PatternLearningPlayer,276,281,557,57,0,PatternLearningPlayer
937,PatternLearningPlayer,299,294,593,96,1,Player A
938,PatternLearningPlayer,297,297,594,97,1,Tie
939,PatternLearningPlayer,297,297,594,97,1,Tie
940,PatternLearningPlayer,300,300,600,100,0,Tie
941,PatternLearningPlayer,297,297,594,97,1,Tie
942,PatternLearningPlayer,276,281,557,57,0,PatternLearningPlayer
943,PatternLearningPlayer,295,290,585,94,3,Player A
944,PatternLearningPlayer,300,300,600,100,0,Tie
945,PatternLearningPlayer,300,300,600,100,0,Tie
946,PatternLearningPlayer,280,280,560,60,0,Tie
947,PatternLearningPlayer,297,297,594,97,1,Tie
948,PatternLearningPlayer,297,297,594,97,1,Tie
949,PatternLearningPlayer,295,295,590,96,2,Tie
950,PatternLearningPlayer,297,297,594,97,1,Tie
951,PatternLearningPlayer,299,299,598,98,0,Tie
952,PatternLearningPlayer,297,297,594,97,1,Tie
953,PatternLearningPlayer,276,281,557,57,0,PatternLearningPlayer
954,PatternLearningPlayer,295,290,585,94,3,Player A
955,PatternLearningPlayer,299,299,598,98,0,Tie
956,PatternLearningPlayer,297,297,594,97,1,Tie
957,PatternLearningPlayer,297,297,594,97,1,Tie
958,PatternLearningPlayer,299,299,598,98,0,Tie
959,PatternLearningPlayer,276,281,557,57,0,PatternLearningPlayer
960,PatternLearningPlayer,282,277,559,59,0,Player A
961,PatternLearningPlayer,276,281,557,57,0,PatternLearningPlayer
962,PatternLearningPlayer,300,295,595,98,1,Player A
963,PatternLearningPlayer,297,297,594,97,1,Tie
964,PatternLearningPlayer,299,299,598,98,0,Tie
965,PatternLearningPlayer,300,300,600,100,0,Tie
966,PatternLearningPlayer,276,281,557,57,0,PatternLearningPlayer
967,PatternLearningPlayer,295,290,585,94,3,Player A
968,PatternLearningPlayer,297,297,594,97,1,Tie
969,PatternLearningPlayer,297,297,594,97,1,Tie
970,PatternLearningPlayer,297,297,594,97,1,Tie
971,PatternLearningPlayer,300,300,600,100,0,Tie
972,PatternLearningPlayer,295,295,590,96,2,Tie
973,PatternLearningPlayer,280,280,560,60,0,Tie
974,PatternLearningPlayer,299,299,598,98,0,Tie
975,PatternLearningPlayer,280,280,560,60,0,Tie
976,PatternLearningPlayer,276,281,557,57,0,PatternLearningPlayer
977,PatternLearningPlayer,299,294,593,96,1,Player A
978,PatternLearningPlayer,299,299,598,98,0,Tie
979,PatternLearningPlayer,280,280,560,60,0,Tie
980,PatternLearningPlayer,299,299,598,98,0,Tie
981,PatternLearningPlayer,297,297,594,97,1,Tie
982,PatternLearningPlayer,297,297,594,97,1,Tie
983,PatternLearningPlayer,280,280,560,60,0,Tie
984,PatternLearningPlayer,300,300,600,100,0,Tie
985,PatternLearningPlayer,295,295,590,96,2,Tie
986,PatternLearningPlayer,299,299,598,98,0,Tie
987,PatternLearningPlayer,276,281,557,57,0,PatternLearningPlayer
988,PatternLearningPlayer,299,294,593,96,1,Player A
989,PatternLearningPlayer,295,295,590,96,2,Tie
990,PatternLearningPlayer,299,299,598,98,0,Tie
991,PatternLearningPlayer,295,295,590,96,2,Tie
992,PatternLearningPlayer,297,297,594,97,1,Tie
993,PatternLearningPlayer,297,297,594,97,1,Tie
994,PatternLearningPlayer,276,281,557,57,0,PatternLearningPlayer
995,PatternLearningPlayer,299,294,593,96,1,Player A
996,PatternLearningPlayer,297,297,594,97,1,Tie
997,PatternLearningPlayer,300,300,600,100,0,Tie
998,PatternLearningPlayer,299,299,598,98,0,Tie
999,PatternLearningPlayer,299,299,598,98,0,Tie
1000,PatternLearningPlayer,297,297,594,97,1,Tie
1001,PatternLearningPlayer,276,281,557,57,0,PatternLearningPlayer
1002,PatternLearningPlayer,302,297,599,99,0,Player A
1003,PatternLearningPlayer,300,300,600,100,0,Tie
1004,PatternLearningPlayer,299,299,598,98,0,Tie
1005,PatternLearningPlayer,300,300,600,100,0,Tie
1006,PatternLearningPlayer,297,297,594,97,1,Tie
1007,PatternLearningPlayer,280,280,560,60,0,Tie
1008,PatternLearningPlayer,300,300,600,100,0,Tie
1009,PatternLearningPlayer,280,280,560,60,0,Tie
1010,PatternLearningPlayer,280,280,560,60,0,Tie
1011,PatternLearningPlayer,299,299,598,98,0,Tie
1012,PatternLearningPlayer,297,297,594,97,1,Tie
1013,PatternLearningPlayer,276,281,557,57,0,PatternLearningPlayer
1014,PatternLearningPlayer,282,277,559,59,0,Player A
1015,PatternLearningPlayer,300,300,600,100,0,Tie
1016,PatternLearningPlayer,297,297,594,97,1,Tie
1017,PatternLearningPlayer,297,297,594,97,1,Tie
1018,PatternLearningPlayer,295,295,590,96,2,Tie
1019,PatternLearningPlayer,276,281,557,57,0,PatternLearningPlayer
1020,PatternLearningPlayer,301,296,597,97,0,Player A
1021,PatternLearningPlayer,299,299,598,98,0,Tie
1022,PatternLearningPlayer,280,280,560,60,0,Tie
1023,PatternLearningPlayer,300,300,600,100,0,Tie
1024,PatternLearningPlayer,297,297,594,97,1,Tie
1025,PatternLearningPlayer,297,297,594,97,1,Tie
1026,PatternLearningPlayer,295,295,590,96,2,Tie
1027,PatternLearningPlayer,299,299,598,98,0,Tie
1028,PatternLearningPlayer,297,297,594,97,1,Tie
1029,PatternLearningPlayer,276,281,557,57,0,PatternLearningPlayer
1030,PatternLearningPlayer,301,296,597,97,0,Player A
1031,PatternLearningPlayer,297,297,594,97,1,Tie
1032,PatternLearningPlayer,280,280,560,60,0,Tie
1033,PatternLearningPlayer,295,295,590,96,2,Tie
1034,PatternLearningPlayer,297,297,594,97,1,Tie
1035,PatternLearningPlayer,297,297,594,97,1,Tie
1036,PatternLearningPlayer,300,300,600,100,0,Tie
1037,PatternLearningPlayer,295,295,590,96,2,Tie
1038,PatternLearningPlayer,299,299,598,98,0,Tie
1039,PatternLearningPlayer,299,299,598,98,0,Tie
1040,PatternLearningPlayer,295,295,590,96,2,Tie
1041,PatternLearningPlayer,300,300,600,100,0,Tie
1042,PatternLearningPlayer,280,280,560,60,0,Tie
1043,PatternLearningPlayer,297,297,594,97,1,Tie
1044,PatternLearningPlayer,299,299,598,98,0,Tie
1045,PatternLearningPlayer,299,299,598,98,0,Tie
1046,PatternLearningPlayer,300,300,600,100,0,Tie
1047,PatternLearningPlayer,297,297,594,97,1,Tie
1048,PatternLearningPlayer,276,281,557,57,0,PatternLearningPlayer
1049,PatternLearningPlayer,282,277,559,59,0,Player A
1050,PatternLearningPlayer,299,299,598,98,0,Tie
0,TitForTat,300,300,600,100,0,Tie
1,TitForTat,300,300,600,100,0,Tie
2,TitForTat,300,300,600,100,0,Tie
3,TitForTat,300,300,600,100,0,Tie
4,TitForTat,300,300,600,100,0,Tie
5,TitForTat,300,300,600,100,0,Tie
6,TitForTat,300,300,600,100,0,Tie
7,TitForTat,300,300,600,100,0,Tie
8,TitForTat,300,300,600,100,0,Tie
9,TitForTat,300,300,600,100,0,Tie
10,TitForTat,300,300,600,100,0,Tie
0,Bayesian,213,218,431,24,31,Bayesian
1,Bayesian,206,201,407,15,36,Player A
2,Bayesian,218,218,436,26,30,Tie
3,Bayesian,225,230,455,24,23,Bayesian
4,Bayesian,234,229,463,26,21,Player A
5,Bayesian,223,228,451,20,23,Bayesian
6,Bayesian,234,234,468,25,19,Tie
7,Bayesian,212,207,419,24,35,Player A
8,Bayesian,224,229,453,31,26,Bayesian
9,Bayesian,225,220,445,17,24,Player A
10,Bayesian,241,241,482,36,18,Tie
11,Bayesian,229,229,458,18,20,Tie
12,Bayesian,234,234,468,28,20,Tie
13,Bayesian,229,229,458,21,21,Tie
14,Bayesian,231,231,462,25,21,Tie
15,Bayesian,235,235,470,27,19,Tie
16,Bayesian,232,232,464,33,23,Tie
17,Bayesian,223,223,446,18,24,Tie
18,Bayesian,239,239,478,35,19,Tie
19,Bayesian,227,227,454,26,24,Tie
20,Bayesian,227,232,459,31,24,Bayesian
21,Bayesian,217,212,429,19,30,Player A
22,Bayesian,214,214,428,18,30,Tie
23,Bayesian,237,237,474,31,19,Tie
24,Bayesian,222,227,449,21,24,Bayesian
25,Bayesian,229,229,458,30,24,Tie
26,Bayesian,228,223,451,17,22,Player A
27,Bayesian,217,222,439,23,28,Bayesian
28,Bayesian,232,227,459,25,22,Player A
29,Bayesian,227,227,454,23,23,Tie
30,Bayesian,235,235,470,33,21,Tie
31,Bayesian,211,216,427,20,31,Bayesian
32,Bayesian,230,230,460,26,22,Tie
33,Bayesian,237,237,474,28,18,Tie
34,Bayesian,217,217,434,21,29,Tie
35,Bayesian,227,227,454,23,23,Tie
36,Bayesian,234,234,468,25,19,Tie
37,Bayesian,226,226,452,24,24,Tie
38,Bayesian,233,228,461,24,21,Player A
39,Bayesian,213,218,431,24,31,Bayesian
40,Bayesian,223,218,441,19,26,Player A
41,Bayesian,227,232,459,22,21,Bayesian
42,Bayesian,236,236,472,26,18,Tie
43,Bayesian,226,226,452,27,25,Tie
44,Bayesian,212,212,424,23,33,Tie
45,Bayesian,219,214,433,20,29,Player A
46,Bayesian,223,223,446,18,24,Tie
47,Bayesian,225,230,455,33,26,Bayesian
48,Bayesian,224,224,448,32,28,Tie
49,Bayesian,229,229,458,21,21,Tie
50,Bayesian,217,217,434,18,28,Tie
51,Bayesian,244,239,483,28,15,Player A
52,Bayesian,231,236,467,30,21,Bayesian
53,Bayesian,241,236,477,31,18,Player A
54,Bayesian,203,208,411,13,34,Bayesian
55,Bayesian,234,229,463,26,21,Player A
56,Bayesian,242,247,489,34,15,Bayesian
57,Bayesian,227,227,454,26,24,Tie
58,Bayesian,219,219,438,22,28,Tie
59,Bayesian,240,235,475,26,17,Player A
60,Bayesian,229,234,463,26,21,Bayesian
61,Bayesian,235,230,465,28,21,Player A
62,Bayesian,226,231,457,23,22,Bayesian
63,Bayesian,225,225,450,22,24,Tie
64,Bayesian,243,238,481,38,19,Player A
65,Bayesian,211,216,427,14,29,Bayesian
66,Bayesian,246,246,492,37,15,Tie
67,Bayesian,240,235,475,29,18,Player A
68,Bayesian,224,229,453,25,24,Bayesian
69,Bayesian,234,234,468,31,21,Tie
70,Bayesian,222,217,439,26,29,Player A
71,Bayesian,219,219,438,19,27,Tie
72,Bayesian,213,218,431,21,30,Bayesian
73,Bayesian,227,227,454,26,24,Tie
74,Bayesian,240,235,475,26,17,Player A
75,Bayesian,223,223,446,24,26,Tie
76,Bayesian,228,228,456,34,26,Tie
77,Bayesian,231,236,467,24,19,Bayesian
78,Bayesian,227,227,454,29,25,Tie
79,Bayesian,236,231,467,33,22,Player A
80,Bayesian,213,218,431,24,31,Bayesian
81,Bayesian,230,230,460,29,23,Tie
82,Bayesian,212,212,424,23,33,Tie
83,Bayesian,230,225,455,21,22,Player A
84,Bayesian,220,220,440,18,26,Tie
85,Bayesian,226,226,452,24,24,Tie
86,Bayesian,220,225,445,26,27,Bayesian
87,Bayesian,223,223,446,24,26,Tie
88,Bayesian,181,181,362,9,49,Tie
89,Bayesian,222,217,439,23,28,Player A
90,Bayesian,241,246,487,29,14,Bayesian
91,Bayesian,243,243,486,34,16,Tie
92,Bayesian,242,242,484,32,16,Tie
93,Bayesian,224,219,443,24,27,Player A
94,Bayesian,221,226,447,22,25,Bayesian
95,Bayesian,227,227,454,26,24,Tie
96,Bayesian,225,225,450,22,24,Tie
97,Bayesian,211,211,422,15,31,Tie
98,Bayesian,224,219,443,24,27,Player A
99,Bayesian,228,228,456,25,23,Tie
100,Bayesian,231,236,467,36,23,Bayesian
101,Bayesian,206,206,412,11,33,Tie
102,Bayesian,240,235,475,26,17,Player A
103,Bayesian,226,226,452,24,24,Tie
104,Bayesian,227,232,459,19,20,Bayesian
105,Bayesian,236,231,467,30,21,Player A
106,Bayesian,211,216,427,20,31,Bayesian
107,Bayesian,222,217,439,23,28,Player A
108,Bayesian,218,223,441,19,26,Bayesian
109,Bayesian,237,232,469,23,18,Player A
110,Bayesian,222,227,449,24,25,Bayesian
111,Bayesian,234,234,468,28,20,Tie
112,Bayesian,228,228,456,28,24,Tie
113,Bayesian,243,238,481,32,17,Player A
114,Bayesian,216,216,432,28,32,Tie
115,Bayesian,233,233,466,29,21,Tie
116,Bayesian,206,206,412,23,37,Tie
117,Bayesian,224,224,448,26,26,Tie
118,Bayesian,224,224,448,23,25,Tie
119,Bayesian,213,218,431,18,29,Bayesian
120,Bayesian,204,204,408,16,36,Tie
121,Bayesian,243,238,481,35,18,Player A
122,Bayesian,226,231,457,26,23,Bayesian
123,Bayesian,224,224,448,29,27,Tie
124,Bayesian,237,237,474,31,19,Tie
125,Bayesian,241,241,482,24,14,Tie
126,Bayesian,235,230,465,25,20,Player A
127,Bayesian,241,241,482,33,17,Tie
128,Bayesian,223,223,446,27,27,Tie
129,Bayesian,211,216,427,20,31,Bayesian
130,Bayesian,225,220,445,23,26,Player A
131,Bayesian,221,226,447,22,25,Bayesian
132,Bayesian,237,232,469,32,21,Player A
133,Bayesian,205,210,415,17,34,Bayesian
134,Bayesian,232,232,464,24,20,Tie
135,Bayesian,247,242,489,40,17,Player A
136,Bayesian,239,239,478,38,20,Tie
137,Bayesian,229,234,463,29,22,Bayesian
138,Bayesian,238,233,471,34,21,Player A
139,Bayesian,227,232,459,28,23,Bayesian
140,Bayesian,224,219,443,18,25,Player A
141,Bayesian,221,226,447,19,24,Bayesian
142,Bayesian,229,229,458,30,24,Tie
143,Bayesian,227,222,449,24,25,Player A
144,Bayesian,218,223,441,19,26,Bayesian
145,Bayesian,223,223,446,27,27,Tie
146,Bayesian,228,223,451,20,23,Player A
147,Bayesian,225,225,450,25,25,Tie
148,Bayesian,211,211,422,18,32,Tie
149,Bayesian,231,231,462,22,20,Tie
150,Bayesian,234,234,468,31,21,Tie
151,Bayesian,238,243,481,32,17,Bayesian
152,Bayesian,233,233,466,29,21,Tie
153,Bayesian,230,225,455,27,24,Player A
154,Bayesian,228,233,461,24,21,Bayesian
155,Bayesian,232,227,459,28,23,Player A
156,Bayesian,229,229,458,21,21,Tie
157,Bayesian,231,236,467,30,21,Bayesian
158,Bayesian,226,226,452,27,25,Tie
159,Bayesian,211,211,422,21,33,Tie
160,Bayesian,239,234,473,39,22,Player A
161,Bayesian,222,222,444,25,27,Tie
162,Bayesian,235,240,475,26,17,Bayesian
163,Bayesian,230,225,455,21,22,Player A
164,Bayesian,234,234,468,31,21,Tie
165,Bayesian,226,226,452,21,23,Tie
166,Bayesian,227,232,459,22,21,Bayesian
167,Bayesian,224,219,443,21,26,Player A
168,Bayesian,221,226,447,19,24,Bayesian
169,Bayesian,229,224,453,28,25,Player A
170,Bayesian,239,239,478,29,17,Tie
171,Bayesian,239,239,478,35,19,Tie
172,Bayesian,194,199,393,19,42,Bayesian
173,Bayesian,229,229,458,27,23,Tie
174,Bayesian,240,240,480,25,15,Tie
175,Bayesian,226,221,447,25,26,Player A
176,Bayesian,220,220,440,24,28,Tie
177,Bayesian,216,221,437,27,30,Bayesian
178,Bayesian,220,220,440,18,26,Tie
179,Bayesian,223,223,446,21,25,Tie
180,Bayesian,237,232,469,32,21,Player A
181,Bayesian,203,208,411,16,35,Bayesian
182,Bayesian,226,221,447,19,24,Player A
183,Bayesian,237,242,479,33,18,Bayesian
184,Bayesian,217,217,434,24,30,Tie
185,Bayesian,243,238,481,35,18,Player A
186,Bayesian,228,228,456,22,22,Tie
187,Bayesian,235,235,470,30,20,Tie
188,Bayesian,229,229,458,21,21,Tie
189,Bayesian,222,222,444,19,25,Tie
190,Bayesian,232,232,464,24,20,Tie
191,Bayesian,216,221,437,24,29,Bayesian
192,Bayesian,222,217,439,26,29,Player A
193,Bayesian,240,245,485,39,18,Bayesian
194,Bayesian,225,225,450,19,23,Tie
195,Bayesian,241,241,482,27,15,Tie
196,Bayesian,221,216,437,21,28,Player A
197,Bayesian,232,237,469,35,22,Bayesian
198,Bayesian,234,229,463,29,22,Player A
199,Bayesian,229,229,458,24,22,Tie
200,Bayesian,228,233,461,21,20,Bayesian
201,Bayesian,228,228,456,28,24,Tie
202,Bayesian,221,221,442,17,25,Tie
203,Bayesian,240,235,475,35,20,Player A
204,Bayesian,228,228,456,22,22,Tie
205,Bayesian,216,221,437,27,30,Bayesian
206,Bayesian,221,216,437,27,30,Player A
207,Bayesian,215,220,435,28,31,Bayesian
208,Bayesian,228,223,451,32,27,Player A
209,Bayesian,224,229,453,28,25,Bayesian
210,Bayesian,229,229,458,24,22,Tie
211,Bayesian,243,238,481,32,17,Player A
212,Bayesian,222,227,449,24,25,Bayesian
213,Bayesian,217,212,429,16,29,Player A
214,Bayesian,234,234,468,25,19,Tie
215,Bayesian,219,219,438,28,30,Tie
216,Bayesian,222,227,449,30,27,Bayesian
217,Bayesian,220,220,440,21,27,Tie
218,Bayesian,224,224,448,23,25,Tie
219,Bayesian,232,227,459,28,23,Player A
220,Bayesian,206,211,417,19,34,Bayesian
221,Bayesian,226,221,447,25,26,Player A
222,Bayesian,232,232,464,24,20,Tie
223,Bayesian,215,215,430,17,29,Tie
224,Bayesian,232,232,464,27,21,Tie
225,Bayesian,230,235,465,34,23,Bayesian
226,Bayesian,234,234,468,28,20,Tie
227,Bayesian,238,233,471,34,21,Player A
228,Bayesian,208,213,421,20,33,Bayesian
229,Bayesian,208,208,416,18,34,Tie
230,Bayesian,228,223,451,26,25,Player A
231,Bayesian,239,244,483,34,17,Bayesian
232,Bayesian,219,219,438,19,27,Tie
233,Bayesian,221,221,442,26,28,Tie
234,Bayesian,223,218,441,22,27,Player A
235,Bayesian,205,210,415,23,36,Bayesian
236,Bayesian,218,213,431,24,31,Player A
237,Bayesian,209,214,423,19,32,Bayesian
238,Bayesian,225,225,450,28,26,Tie
239,Bayesian,228,223,451,23,24,Player A
240,Bayesian,223,223,446,24,26,Tie
241,Bayesian,234,239,473,27,18,Bayesian
242,Bayesian,229,224,453,19,22,Player A
243,Bayesian,224,224,448,17,23,Tie
244,Bayesian,218,223,441,22,27,Bayesian
245,Bayesian,209,209,418,20,34,Tie
246,Bayesian,248,248,496,35,13,Tie
247,Bayesian,236,236,472,26,18,Tie
248,Bayesian,238,238,476,27,17,Tie
249,Bayesian,218,218,436,20,28,Tie
250,Bayesian,227,222,449,21,24,Player A
251,Bayesian,226,226,452,24,24,Tie
252,Bayesian,239,239,478,29,17,Tie
253,Bayesian,225,230,455,24,23,Bayesian
254,Bayesian,223,218,441,22,27,Player A
255,Bayesian,211,211,422,18,32,Tie
256,Bayesian,225,230,455,21,22,Bayesian
257,Bayesian,220,215,435,16,27,Player A
258,Bayesian,229,229,458,27,23,Tie
259,Bayesian,233,233,466,17,17,Tie
260,Bayesian,221,226,447,22,25,Bayesian
261,Bayesian,220,220,440,18,26,Tie
262,Bayesian,242,242,484,38,18,Tie
263,Bayesian,223,223,446,21,25,Tie
264,Bayesian,240,235,475,29,18,Player A
265,Bayesian,233,233,466,29,21,Tie
266,Bayesian,237,237,474,31,19,Tie
267,Bayesian,222,222,444,25,27,Tie
268,Bayesian,228,228,456,28,24,Tie
269,Bayesian,209,209,418,20,34,Tie
270,Bayesian,220,220,440,27,29,Tie
271,Bayesian,227,227,454,20,22,Tie
272,Bayesian,214,219,433,20,29,Bayesian
273,Bayesian,228,223,451,20,23,Player A
274,Bayesian,217,217,434,24,30,Tie
275,Bayesian,224,224,448,23,25,Tie
276,Bayesian,229,229,458,27,23,Tie
277,Bayesian,217,222,439,23,28,Bayesian
278,Bayesian,209,209,418,20,34,Tie
279,Bayesian,244,244,488,30,14,Tie
280,Bayesian,217,212,429,16,29,Player A
281,Bayesian,205,210,415,17,34,Bayesian
282,Bayesian,229,229,458,30,24,Tie
283,Bayesian,229,229,458,30,24,Tie
284,Bayesian,229,224,453,25,24,Player A
285,Bayesian,229,234,463,23,20,Bayesian
286,Bayesian,224,219,443,24,27,Player A
287,Bayesian,242,247,489,37,16,Bayesian
288,Bayesian,228,223,451,26,25,Player A
289,Bayesian,228,228,456,28,24,Tie
290,Bayesian,221,221,442,17,25,Tie
291,Bayesian,187,187,374,9,45,Tie
292,Bayesian,225,225,450,25,25,Tie
293,Bayesian,222,227,449,24,25,Bayesian
294,Bayesian,212,207,419,15,32,Player A
295,Bayesian,209,209,418,17,33,Tie
296,Bayesian,211,216,427,23,32,Bayesian
297,Bayesian,225,220,445,26,27,Player A
298,Bayesian,203,203,406,23,39,Tie
299,Bayesian,233,233,466,26,20,Tie
300,Bayesian,247,252,499,35,12,Bayesian
301,Bayesian,230,230,460,32,24,Tie
302,Bayesian,229,224,453,25,24,Player A
303,Bayesian,229,229,458,21,21,Tie
304,Bayesian,227,227,454,26,24,Tie
305,Bayesian,224,229,453,25,24,Bayesian
306,Bayesian,231,226,457,23,22,Player A
307,Bayesian,205,210,415,17,34,Bayesian
308,Bayesian,206,206,412,20,36,Tie
309,Bayesian,220,220,440,27,29,Tie
310,Bayesian,227,227,454,29,25,Tie
311,Bayesian,223,223,446,24,26,Tie
312,Bayesian,245,240,485,33,16,Player A
313,Bayesian,214,214,428,18,30,Tie
314,Bayesian,221,226,447,31,28,Bayesian
315,Bayesian,244,239,483,31,16,Player A
316,Bayesian,233,233,466,26,20,Tie
317,Bayesian,221,221,442,23,27,Tie
318,Bayesian,217,222,439,20,27,Bayesian
319,Bayesian,216,216,432,22,30,Tie
320,Bayesian,218,213,431,21,30,Player A
321,Bayesian,225,225,450,25,25,Tie
322,Bayesian,230,235,465,25,20,Bayesian
323,Bayesian,216,216,432,22,30,Tie
324,Bayesian,226,226,452,30,26,Tie
325,Bayesian,229,229,458,27,23,Tie
326,Bayesian,222,222,444,16,24,Tie
327,Bayesian,235,230,465,31,22,Player A
328,Bayesian,228,233,461,27,22,Bayesian
329,Bayesian,226,221,447,28,27,Player A
330,Bayesian,214,219,433,23,30,Bayesian
331,Bayesian,224,224,448,26,26,Tie
332,Bayesian,233,233,466,29,21,Tie
333,Bayesian,224,224,448,20,24,Tie
334,Bayesian,235,235,470,27,19,Tie
335,Bayesian,229,224,453,25,24,Player A
336,Bayesian,225,225,450,22,24,Tie
337,Bayesian,229,229,458,27,23,Tie
338,Bayesian,223,228,451,23,24,Bayesian
339,Bayesian,203,203,406,20,38,Tie
340,Bayesian,212,207,419,24,35,Player A
341,Bayesian,243,243,486,37,17,Tie
342,Bayesian,233,233,466,26,20,Tie
343,Bayesian,252,252,504,34,10,Tie
344,Bayesian,231,236,467,27,20,Bayesian
345,Bayesian,239,234,473,33,20,Player A
346,Bayesian,213,213,426,22,32,Tie
347,Bayesian,234,234,468,34,22,Tie
348,Bayesian,226,226,452,30,26,Tie
349,Bayesian,232,237,469,29,20,Bayesian
350,Bayesian,227,227,454,29,25,Tie
351,Bayesian,241,236,477,31,18,Player A
352,Bayesian,223,228,451,23,24,Bayesian
353,Bayesian,210,210,420,16,32,Tie
354,Bayesian,238,233,471,28,19,Player A
355,Bayesian,224,224,448,23,25,Tie
356,Bayesian,224,224,448,23,25,Tie
357,Bayesian,227,227,454,29,25,Tie
358,Bayesian,211,216,427,20,31,Bayesian
359,Bayesian,231,231,462,28,22,Tie
360,Bayesian,222,217,439,23,28,Player A
361,Bayesian,231,231,462,22,20,Tie
362,Bayesian,211,216,427,20,31,Bayesian
363,Bayesian,225,225,450,22,24,Tie
364,Bayesian,241,241,482,27,15,Tie
365,Bayesian,221,216,437,24,29,Player A
366,Bayesian,211,216,427,17,30,Bayesian
367,Bayesian,211,211,422,18,32,Tie
368,Bayesian,214,214,428,24,32,Tie
369,Bayesian,232,227,459,28,23,Player A
370,Bayesian,237,237,474,28,18,Tie
371,Bayesian,214,219,433,17,28,Bayesian
372,Bayesian,225,220,445,23,26,Player A
373,Bayesian,226,226,452,24,24,Tie
374,Bayesian,225,225,450,28,26,Tie
375,Bayesian,241,241,482,30,16,Tie
376,Bayesian,220,225,445,17,24,Bayesian
377,Bayesian,226,226,452,24,24,Tie
378,Bayesian,224,219,443,21,26,Player A
379,Bayesian,226,231,457,26,23,Bayesian
380,Bayesian,223,218,441,19,26,Player A
381,Bayesian,239,239,478,23,15,Tie
382,Bayesian,214,219,433,20,29,Bayesian
383,Bayesian,230,225,455,30,25,Player A
384,Bayesian,231,236,467,27,20,Bayesian
385,Bayesian,248,243,491,36,15,Player A
386,Bayesian,232,237,469,26,19,Bayesian
387,Bayesian,225,220,445,26,27,Player A
388,Bayesian,218,218,436,20,28,Tie
389,Bayesian,217,217,434,18,28,Tie
390,Bayesian,236,236,472,32,20,Tie
391,Bayesian,228,228,456,28,24,Tie
392,Bayesian,231,231,462,28,22,Tie
393,Bayesian,221,226,447,19,24,Bayesian
394,Bayesian,218,213,431,21,30,Player A
395,Bayesian,220,220,440,24,28,Tie
396,Bayesian,220,225,445,26,27,Bayesian
397,Bayesian,220,220,440,24,28,Tie
398,Bayesian,227,227,454,26,24,Tie
399,Bayesian,218,218,436,23,29,Tie
400,Bayesian,226,226,452,21,23,Tie
401,Bayesian,231,226,457,35,26,Player A
402,Bayesian,235,240,475,32,19,Bayesian
403,Bayesian,214,214,428,21,31,Tie
404,Bayesian,213,208,421,17,32,Player A
405,Bayesian,226,226,452,24,24,Tie
406,Bayesian,233,238,471,31,20,Bayesian
407,Bayesian,209,209,418,17,33,Tie
408,Bayesian,212,207,419,15,32,Player A
409,Bayesian,227,232,459,28,23,Bayesian
410,Bayesian,229,229,458,24,22,Tie
411,Bayesian,216,211,427,20,31,Player A
412,Bayesian,217,222,439,26,29,Bayesian
413,Bayesian,222,222,444,25,27,Tie
414,Bayesian,214,214,428,24,32,Tie
415,Bayesian,219,214,433,20,29,Player A
416,Bayesian,228,233,461,27,22,Bayesian
417,Bayesian,227,227,454,20,22,Tie
418,Bayesian,226,221,447,22,25,Player A
419,Bayesian,230,235,465,34,23,Bayesian
420,Bayesian,221,221,442,20,26,Tie
421,Bayesian,222,222,444,25,27,Tie
422,Bayesian,217,217,434,18,28,Tie
423,Bayesian,238,233,471,34,21,Player A
424,Bayesian,232,232,464,27,21,Tie
425,Bayesian,213,218,431,21,30,Bayesian
426,Bayesian,226,221,447,19,24,Player A
427,Bayesian,228,228,456,31,25,Tie
428,Bayesian,228,228,456,25,23,Tie
429,Bayesian,226,231,457,26,23,Bayesian
430,Bayesian,221,221,442,26,28,Tie
431,Bayesian,219,219,438,19,27,Tie
432,Bayesian,214,209,423,22,33,Player A
433,Bayesian,236,236,472,26,18,Tie
434,Bayesian,223,223,446,27,27,Tie
435,Bayesian,229,234,463,32,23,Bayesian
436,Bayesian,248,248,496,29,11,Tie
437,Bayesian,210,210,420,19,33,Tie
438,Bayesian,203,203,406,14,36,Tie
439,Bayesian,230,230,460,26,22,Tie
440,Bayesian,234,234,468,25,19,Tie
441,Bayesian,219,219,438,22,28,Tie
442,Bayesian,212,207,419,18,33,Player A
443,Bayesian,222,227,449,24,25,Bayesian
444,Bayesian,217,212,429,22,31,Player A
445,Bayesian,229,229,458,21,21,Tie
446,Bayesian,225,225,450,25,25,Tie
447,Bayesian,215,220,435,16,27,Bayesian
448,Bayesian,218,218,436,20,28,Tie
449,Bayesian,233,233,466,26,20,Tie
450,Bayesian,219,219,438,22,28,Tie
451,Bayesian,230,225,455,24,23,Player A
452,Bayesian,230,235,465,28,21,Bayesian
453,Bayesian,222,222,444,31,29,Tie
454,Bayesian,223,223,446,24,26,Tie
455,Bayesian,220,215,435,28,31,Player A
456,Bayesian,233,238,471,31,20,Bayesian
457,Bayesian,224,224,448,29,27,Tie
458,Bayesian,206,206,412,23,37,Tie
459,Bayesian,247,247,494,33,13,Tie
460,Bayesian,234,229,463,32,23,Player A
461,Bayesian,218,218,436,17,27,Tie
462,Bayesian,220,220,440,27,29,Tie
463,Bayesian,200,200,400,11,37,Tie
464,Bayesian,226,226,452,21,23,Tie
465,Bayesian,233,233,466,26,20,Tie
466,Bayesian,221,226,447,25,26,Bayesian
467,Bayesian,208,208,416,21,35,Tie
468,Bayesian,217,212,429,16,29,Player A
469,Bayesian,225,225,450,25,25,Tie
470,Bayesian,236,236,472,26,18,Tie
471,Bayesian,212,212,424,20,32,Tie
472,Bayesian,231,231,462,34,24,Tie
473,Bayesian,229,229,458,24,22,Tie
474,Bayesian,230,230,460,32,24,Tie
475,Bayesian,227,232,459,25,22,Bayesian
476,Bayesian,228,223,451,23,24,Player A
477,Bayesian,221,226,447,25,26,Bayesian
478,Bayesian,241,241,482,30,16,Tie
479,Bayesian,216,211,427,14,29,Player A
480,Bayesian,217,222,439,20,27,Bayesian
481,Bayesian,225,225,450,25,25,Tie
482,Bayesian,209,209,418,14,32,Tie
483,Bayesian,229,224,453,28,25,Player A
484,Bayesian,232,232,464,27,21,Tie
485,Bayesian,204,209,413,12,33,Bayesian
486,Bayesian,212,212,424,23,33,Tie
487,Bayesian,202,202,404,15,37,Tie
488,Bayesian,232,227,459,28,23,Player A
489,Bayesian,206,206,412,23,37,Tie
490,Bayesian,228,228,456,19,21,Tie
491,Bayesian,241,246,487,29,14,Bayesian
492,Bayesian,217,212,429,22,31,Player A
493,Bayesian,221,226,447,22,25,Bayesian
494,Bayesian,224,219,443,24,27,Player A
495,Bayesian,225,225,450,25,25,Tie
496,Bayesian,238,243,481,32,17,Bayesian
497,Bayesian,212,207,419,18,33,Player A
498,Bayesian,222,227,449,24,25,Bayesian
499,Bayesian,235,235,470,24,18,Tie
500,Bayesian,213,208,421,23,34,Player A
501,Bayesian,220,220,440,24,28,Tie
502,Bayesian,214,219,433,26,31,Bayesian
503,Bayesian,226,226,452,24,24,Tie
504,Bayesian,238,233,471,25,18,Player A
505,Bayesian,230,235,465,31,22,Bayesian
506,Bayesian,238,238,476,33,19,Tie
507,Bayesian,217,217,434,24,30,Tie
508,Bayesian,227,227,454,29,25,Tie
509,Bayesian,235,230,465,28,21,Player A
510,Bayesian,216,221,437,18,27,Bayesian
511,Bayesian,236,231,467,30,21,Player A
512,Bayesian,225,230,455,21,22,Bayesian
513,Bayesian,228,223,451,14,21,Player A
514,Bayesian,199,204,403,17,38,Bayesian
515,Bayesian,197,192,389,15,42,Player A
516,Bayesian,230,235,465,28,21,Bayesian
517,Bayesian,253,248,501,40,13,Player A
518,Bayesian,224,224,448,29,27,Tie
519,Bayesian,229,229,458,24,22,Tie
520,Bayesian,225,225,450,31,27,Tie
521,Bayesian,240,240,480,31,17,Tie
522,Bayesian,229,234,463,32,23,Bayesian
523,Bayesian,227,222,449,21,24,Player A
524,Bayesian,230,230,460,29,23,Tie
525,Bayesian,226,226,452,27,25,Tie
526,Bayesian,216,221,437,21,28,Bayesian
527,Bayesian,212,207,419,18,33,Player A
528,Bayesian,218,218,436,20,28,Tie
529,Bayesian,225,225,450,34,28,Tie
530,Bayesian,213,218,431,24,31,Bayesian
531,Bayesian,231,226,457,23,22,Player A
532,Bayesian,222,227,449,30,27,Bayesian
533,Bayesian,217,217,434,21,29,Tie
534,Bayesian,231,231,462,25,21,Tie
535,Bayesian,243,238,481,29,16,Player A
536,Bayesian,241,241,482,36,18,Tie
537,Bayesian,222,222,444,22,26,Tie
538,Bayesian,231,231,462,25,21,Tie
539,Bayesian,223,228,451,26,25,Bayesian
540,Bayesian,208,208,416,12,32,Tie
541,Bayesian,213,213,426,22,32,Tie
542,Bayesian,220,215,435,28,31,Player A
543,Bayesian,240,240,480,28,16,Tie
544,Bayesian,225,230,455,27,24,Bayesian
545,Bayesian,226,226,452,24,24,Tie
546,Bayesian,248,243,491,33,14,Player A
547,Bayesian,233,233,466,20,18,Tie
548,Bayesian,208,213,421,17,32,Bayesian
549,Bayesian,227,222,449,24,25,Player A
550,Bayesian,236,236,472,32,20,Tie
551,Bayesian,243,243,486,31,15,Tie
552,Bayesian,238,238,476,24,16,Tie
553,Bayesian,237,237,474,28,18,Tie
554,Bayesian,214,214,428,21,31,Tie
555,Bayesian,232,232,464,33,23,Tie
556,Bayesian,224,224,448,26,26,Tie
557,Bayesian,215,220,435,22,29,Bayesian
558,Bayesian,219,219,438,22,28,Tie
559,Bayesian,217,212,429,25,32,Player A
560,Bayesian,226,231,457,23,22,Bayesian
561,Bayesian,210,205,415,20,35,Player A
562,Bayesian,216,221,437,21,28,Bayesian
563,Bayesian,236,231,467,33,22,Player A
564,Bayesian,231,231,462,22,20,Tie
565,Bayesian,227,232,459,37,26,Bayesian
566,Bayesian,229,229,458,21,21,Tie
567,Bayesian,227,227,454,29,25,Tie
568,Bayesian,208,208,416,12,32,Tie
569,Bayesian,219,219,438,22,28,Tie
570,Bayesian,217,217,434,18,28,Tie
571,Bayesian,204,204,408,16,36,Tie
572,Bayesian,244,239,483,40,19,Player A
573,Bayesian,220,225,445,23,26,Bayesian
574,Bayesian,231,231,462,22,20,Tie
575,Bayesian,215,215,430,23,31,Tie
576,Bayesian,219,219,438,22,28,Tie
577,Bayesian,228,223,451,26,25,Player A
578,Bayesian,246,246,492,37,15,Tie
579,Bayesian,219,224,443,24,27,Bayesian
580,Bayesian,229,224,453,22,23,Player A
581,Bayesian,233,238,471,28,19,Bayesian
582,Bayesian,216,211,427,26,33,Player A
583,Bayesian,231,231,462,28,22,Tie
584,Bayesian,254,259,513,40,9,Bayesian
585,Bayesian,243,238,481,41,20,Player A
586,Bayesian,221,221,442,23,27,Tie
587,Bayesian,209,214,423,19,32,Bayesian
588,Bayesian,218,218,436,23,29,Tie
589,Bayesian,216,211,427,20,31,Player A
590,Bayesian,230,235,465,25,20,Bayesian
591,Bayesian,228,223,451,23,24,Player A
592,Bayesian,226,231,457,20,21,Bayesian
593,Bayesian,206,206,412,14,34,Tie
594,Bayesian,220,215,435,25,30,Player A
595,Bayesian,245,245,490,29,13,Tie
596,Bayesian,235,240,475,29,18,Bayesian
597,Bayesian,230,230,460,26,22,Tie
598,Bayesian,234,234,468,25,19,Tie
599,Bayesian,229,224,453,31,26,Player A
600,Bayesian,248,248,496,29,11,Tie
601,Bayesian,206,206,412,17,35,Tie
602,Bayesian,246,251,497,33,12,Bayesian
603,Bayesian,212,212,424,20,32,Tie
604,Bayesian,228,223,451,23,24,Player A
605,Bayesian,234,239,473,33,20,Bayesian
606,Bayesian,226,221,447,25,26,Player A
607,Bayesian,219,224,443,24,27,Bayesian
608,Bayesian,231,226,457,23,22,Player A
609,Bayesian,220,225,445,23,26,Bayesian
610,Bayesian,213,213,426,19,31,Tie
611,Bayesian,233,233,466,23,19,Tie
612,Bayesian,233,233,466,26,20,Tie
613,Bayesian,210,205,415,17,34,Player A
614,Bayesian,227,232,459,25,22,Bayesian
615,Bayesian,228,223,451,29,26,Player A
616,Bayesian,224,224,448,20,24,Tie
617,Bayesian,201,206,407,21,38,Bayesian
618,Bayesian,222,217,439,23,28,Player A
619,Bayesian,228,228,456,25,23,Tie
620,Bayesian,214,219,433,14,27,Bayesian
621,Bayesian,239,234,473,33,20,Player A
622,Bayesian,238,243,481,35,18,Bayesian
623,Bayesian,225,220,445,23,26,Player A
624,Bayesian,225,225,450,31,27,Tie
625,Bayesian,242,247,489,28,13,Bayesian
626,Bayesian,229,224,453,28,25,Player A
627,Bayesian,213,213,426,25,33,Tie
628,Bayesian,239,239,478,35,19,Tie
629,Bayesian,231,231,462,28,22,Tie
630,Bayesian,244,244,488,30,14,Tie
631,Bayesian,226,226,452,27,25,Tie
632,Bayesian,247,247,494,42,16,Tie
633,Bayesian,229,234,463,32,23,Bayesian
634,Bayesian,218,213,431,21,30,Player A
635,Bayesian,238,238,476,27,17,Tie
636,Bayesian,235,235,470,27,19,Tie
637,Bayesian,235,235,470,30,20,Tie
638,Bayesian,220,220,440,24,28,Tie
639,Bayesian,233,233,466,32,22,Tie
640,Bayesian,230,235,465,25,20,Bayesian
641,Bayesian,224,224,448,17,23,Tie
642,Bayesian,247,242,489,31,14,Player A
643,Bayesian,213,218,431,15,28,Bayesian
644,Bayesian,215,215,430,26,32,Tie
645,Bayesian,230,225,455,18,21,Player A
646,Bayesian,225,230,455,24,23,Bayesian
647,Bayesian,213,213,426,22,32,Tie
648,Bayesian,239,234,473,24,17,Player A
649,Bayesian,218,223,441,22,27,Bayesian
650,Bayesian,227,227,454,26,24,Tie
651,Bayesian,228,228,456,34,26,Tie
652,Bayesian,217,212,429,13,28,Player A
653,Bayesian,221,221,442,23,27,Tie
654,Bayesian,236,241,477,43,22,Bayesian
655,Bayesian,240,240,480,31,17,Tie
656,Bayesian,215,215,430,23,31,Tie
657,Bayesian,231,231,462,28,22,Tie
658,Bayesian,218,218,436,26,30,Tie
659,Bayesian,237,237,474,34,20,Tie
660,Bayesian,234,234,468,28,20,Tie
661,Bayesian,238,238,476,33,19,Tie
662,Bayesian,221,221,442,23,27,Tie
663,Bayesian,221,221,442,29,29,Tie
664,Bayesian,218,218,436,23,29,Tie
665,Bayesian,228,223,451,29,26,Player A
666,Bayesian,226,226,452,27,25,Tie
667,Bayesian,244,244,488,39,17,Tie
668,Bayesian,219,224,443,24,27,Bayesian
669,Bayesian,224,219,443,24,27,Player A
670,Bayesian,208,208,416,18,34,Tie
671,Bayesian,239,239,478,29,17,Tie
672,Bayesian,201,206,407,18,37,Bayesian
673,Bayesian,221,221,442,23,27,Tie
674,Bayesian,245,240,485,36,17,Player A
675,Bayesian,242,247,489,31,14,Bayesian
676,Bayesian,225,220,445,23,26,Player A
677,Bayesian,226,226,452,21,23,Tie
678,Bayesian,232,232,464,24,20,Tie
679,Bayesian,235,235,470,30,20,Tie
680,Bayesian,227,227,454,23,23,Tie
681,Bayesian,213,213,426,16,30,Tie
682,Bayesian,229,234,463,26,21,Bayesian
683,Bayesian,222,217,439,23,28,Player A
684,Bayesian,220,220,440,15,25,Tie
685,Bayesian,217,222,439,26,29,Bayesian
686,Bayesian,224,224,448,23,25,Tie
687,Bayesian,234,234,468,25,19,Tie
688,Bayesian,203,203,406,17,37,Tie
689,Bayesian,234,229,463,23,20,Player A
690,Bayesian,230,230,460,29,23,Tie
691,Bayesian,219,224,443,21,26,Bayesian
692,Bayesian,239,234,473,30,19,Player A
693,Bayesian,223,228,451,26,25,Bayesian
694,Bayesian,228,228,456,25,23,Tie
695,Bayesian,232,227,459,28,23,Player A
696,Bayesian,218,218,436,20,28,Tie
697,Bayesian,221,221,442,23,27,Tie
698,Bayesian,212,217,429,16,29,Bayesian
699,Bayesian,217,217,434,15,27,Tie
700,Bayesian,228,228,456,22,22,Tie
701,Bayesian,216,211,427,20,31,Player A
702,Bayesian,212,212,424,17,31,Tie
703,Bayesian,226,226,452,30,26,Tie
704,Bayesian,209,214,423,19,32,Bayesian
705,Bayesian,217,217,434,24,30,Tie
706,Bayesian,222,222,444,25,27,Tie
707,Bayesian,218,213,431,18,29,Player A
708,Bayesian,247,247,494,36,14,Tie
709,Bayesian,214,214,428,21,31,Tie
710,Bayesian,222,222,444,31,29,Tie
711,Bayesian,207,207,414,19,35,Tie
712,Bayesian,225,230,455,33,26,Bayesian
713,Bayesian,223,223,446,24,26,Tie
714,Bayesian,226,226,452,21,23,Tie
715,Bayesian,230,230,460,26,22,Tie
716,Bayesian,220,220,440,18,26,Tie
717,Bayesian,252,247,499,41,14,Player A
718,Bayesian,224,224,448,29,27,Tie
719,Bayesian,211,216,427,23,32,Bayesian
720,Bayesian,217,217,434,18,28,Tie
721,Bayesian,238,238,476,27,17,Tie
722,Bayesian,239,234,473,27,18,Player A
723,Bayesian,214,219,433,20,29,Bayesian
724,Bayesian,214,209,423,16,31,Player A
725,Bayesian,252,252,504,46,14,Tie
726,Bayesian,233,233,466,32,22,Tie
727,Bayesian,248,248,496,35,13,Tie
728,Bayesian,212,212,424,11,29,Tie
729,Bayesian,223,223,446,21,25,Tie
730,Bayesian,215,215,430,20,30,Tie
731,Bayesian,239,239,478,32,18,Tie
732,Bayesian,240,245,485,39,18,Bayesian
733,Bayesian,242,237,479,30,17,Player A
734,Bayesian,229,229,458,27,23,Tie
735,Bayesian,227,232,459,25,22,Bayesian
736,Bayesian,222,222,444,22,26,Tie
737,Bayesian,227,222,449,24,25,Player A
738,Bayesian,225,230,455,24,23,Bayesian
739,Bayesian,221,221,442,23,27,Tie
740,Bayesian,214,214,428,21,31,Tie
741,Bayesian,212,212,424,20,32,Tie
742,Bayesian,223,218,441,25,28,Player A
743,Bayesian,210,215,425,24,33,Bayesian
744,Bayesian,235,235,470,27,19,Tie
745,Bayesian,220,220,440,27,29,Tie
746,Bayesian,204,204,408,13,35,Tie
747,Bayesian,222,222,444,28,28,Tie
748,Bayesian,240,235,475,38,21,Player A
749,Bayesian,224,224,448,26,26,Tie
750,Bayesian,243,243,486,31,15,Tie
751,Bayesian,216,216,432,22,30,Tie
752,Bayesian,225,225,450,25,25,Tie
753,Bayesian,208,213,421,17,32,Bayesian
754,Bayesian,230,225,455,30,25,Player A
755,Bayesian,221,221,442,26,28,Tie
756,Bayesian,213,218,431,18,29,Bayesian
757,Bayesian,212,212,424,14,30,Tie
758,Bayesian,206,201,407,15,36,Player A
759,Bayesian,211,216,427,14,29,Bayesian
760,Bayesian,236,231,467,30,21,Player A
761,Bayesian,234,239,473,30,19,Bayesian
762,Bayesian,230,225,455,27,24,Player A
763,Bayesian,233,233,466,29,21,Tie
764,Bayesian,248,248,496,41,15,Tie
765,Bayesian,237,237,474,28,18,Tie
766,Bayesian,227,227,454,23,23,Tie
767,Bayesian,234,239,473,36,21,Bayesian
768,Bayesian,223,218,441,28,29,Player A
769,Bayesian,222,227,449,30,27,Bayesian
770,Bayesian,221,221,442,20,26,Tie
771,Bayesian,233,228,461,30,23,Player A
772,Bayesian,240,240,480,25,15,Tie
773,Bayesian,224,224,448,23,25,Tie
774,Bayesian,229,234,463,20,19,Bayesian
775,Bayesian,235,235,470,36,22,Tie
776,Bayesian,242,242,484,32,16,Tie
777,Bayesian,235,230,465,37,24,Player A
778,Bayesian,223,223,446,30,28,Tie
779,Bayesian,232,232,464,30,22,Tie
780,Bayesian,221,221,442,20,26,Tie
781,Bayesian,226,231,457,26,23,Bayesian
782,Bayesian,226,221,447,25,26,Player A
783,Bayesian,206,206,412,17,35,Tie
784,Bayesian,231,231,462,28,22,Tie
785,Bayesian,229,229,458,33,25,Tie
786,Bayesian,225,225,450,28,26,Tie
787,Bayesian,227,232,459,28,23,Bayesian
788,Bayesian,231,226,457,23,22,Player A
789,Bayesian,226,226,452,27,25,Tie
790,Bayesian,215,220,435,22,29,Bayesian
791,Bayesian,226,221,447,25,26,Player A
792,Bayesian,213,213,426,25,33,Tie
793,Bayesian,212,217,429,19,30,Bayesian
794,Bayesian,222,217,439,23,28,Player A
795,Bayesian,223,223,446,21,25,Tie
796,Bayesian,232,232,464,30,22,Tie
797,Bayesian,217,217,434,24,30,Tie
798,Bayesian,228,233,461,24,21,Bayesian
799,Bayesian,238,233,471,31,20,Player A
800,Bayesian,228,233,461,24,21,Bayesian
801,Bayesian,236,231,467,18,17,Player A
802,Bayesian,231,236,467,27,20,Bayesian
803,Bayesian,222,222,444,22,26,Tie
804,Bayesian,213,208,421,17,32,Player A
805,Bayesian,218,218,436,23,29,Tie
806,Bayesian,240,240,480,22,14,Tie
807,Bayesian,237,237,474,31,19,Tie
808,Bayesian,212,217,429,10,27,Bayesian
809,Bayesian,238,238,476,30,18,Tie
810,Bayesian,239,239,478,32,18,Tie
811,Bayesian,236,236,472,32,20,Tie
812,Bayesian,221,216,437,21,28,Player A
813,Bayesian,240,245,485,36,17,Bayesian
814,Bayesian,220,220,440,21,27,Tie
815,Bayesian,222,217,439,23,28,Player A
816,Bayesian,214,219,433,26,31,Bayesian
817,Bayesian,229,229,458,24,22,Tie
818,Bayesian,220,220,440,30,30,Tie
819,Bayesian,238,238,476,30,18,Tie
820,Bayesian,212,212,424,17,31,Tie
821,Bayesian,225,225,450,25,25,Tie
822,Bayesian,228,223,451,29,26,Player A
823,Bayesian,225,230,455,27,24,Bayesian
824,Bayesian,227,227,454,26,24,Tie
825,Bayesian,225,225,450,28,26,Tie
826,Bayesian,226,221,447,19,24,Player A
827,Bayesian,226,231,457,26,23,Bayesian
828,Bayesian,231,226,457,23,22,Player A
829,Bayesian,231,231,462,25,21,Tie
830,Bayesian,225,230,455,24,23,Bayesian
831,Bayesian,215,210,425,18,31,Player A
832,Bayesian,205,210,415,23,36,Bayesian
833,Bayesian,222,217,439,23,28,Player A
834,Bayesian,233,238,471,34,21,Bayesian
835,Bayesian,236,231,467,27,20,Player A
836,Bayesian,237,237,474,37,21,Tie
837,Bayesian,214,219,433,20,29,Bayesian
838,Bayesian,218,218,436,17,27,Tie
839,Bayesian,211,211,422,18,32,Tie
840,Bayesian,214,209,423,25,34,Player A
841,Bayesian,234,234,468,31,21,Tie
842,Bayesian,213,218,431,18,29,Bayesian
843,Bayesian,242,237,479,36,19,Player A
844,Bayesian,232,232,464,27,21,Tie
845,Bayesian,232,237,469,32,21,Bayesian
846,Bayesian,239,239,478,23,15,Tie
847,Bayesian,215,210,425,15,30,Player A
848,Bayesian,222,227,449,24,25,Bayesian
849,Bayesian,225,220,445,23,26,Player A
850,Bayesian,233,233,466,32,22,Tie
851,Bayesian,207,212,419,21,34,Bayesian
852,Bayesian,217,217,434,15,27,Tie
853,Bayesian,224,219,443,24,27,Player A
854,Bayesian,247,247,494,33,13,Tie
855,Bayesian,218,218,436,23,29,Tie
856,Bayesian,228,233,461,21,20,Bayesian
857,Bayesian,218,213,431,24,31,Player A
858,Bayesian,220,220,440,24,28,Tie
859,Bayesian,229,234,463,29,22,Bayesian
860,Bayesian,210,210,420,16,32,Tie
861,Bayesian,240,235,475,35,20,Player A
862,Bayesian,243,243,486,31,15,Tie
863,Bayesian,235,235,470,30,20,Tie
864,Bayesian,205,205,410,12,34,Tie
865,Bayesian,232,232,464,24,20,Tie
866,Bayesian,221,221,442,20,26,Tie
867,Bayesian,207,207,414,22,36,Tie
868,Bayesian,229,229,458,27,23,Tie
869,Bayesian,217,222,439,26,29,Bayesian
870,Bayesian,223,218,441,22,27,Player A
871,Bayesian,220,225,445,29,28,Bayesian
872,Bayesian,216,216,432,22,30,Tie
873,Bayesian,236,236,472,35,21,Tie
874,Bayesian,209,209,418,17,33,Tie
875,Bayesian,218,218,436,17,27,Tie
876,Bayesian,196,196,392,12,40,Tie
877,Bayesian,217,217,434,21,29,Tie
878,Bayesian,234,234,468,31,21,Tie
879,Bayesian,214,214,428,18,30,Tie
880,Bayesian,228,228,456,22,22,Tie
881,Bayesian,231,231,462,22,20,Tie
882,Bayesian,220,215,435,22,29,Player A
883,Bayesian,237,242,479,36,19,Bayesian
884,Bayesian,223,223,446,21,25,Tie
885,Bayesian,226,221,447,22,25,Player A
886,Bayesian,242,242,484,41,19,Tie
887,Bayesian,215,220,435,25,30,Bayesian
888,Bayesian,208,208,416,21,35,Tie
889,Bayesian,232,232,464,36,24,Tie
890,Bayesian,222,217,439,23,28,Player A
891,Bayesian,227,232,459,19,20,Bayesian
892,Bayesian,204,204,408,16,36,Tie
893,Bayesian,214,214,428,27,33,Tie
894,Bayesian,226,226,452,24,24,Tie
895,Bayesian,231,231,462,25,21,Tie
896,Bayesian,246,241,487,26,13,Player A
897,Bayesian,224,224,448,26,26,Tie
898,Bayesian,217,222,439,20,27,Bayesian
899,Bayesian,232,227,459,28,23,Player A
900,Bayesian,219,224,443,30,29,Bayesian
901,Bayesian,227,222,449,21,24,Player A
902,Bayesian,232,232,464,27,21,Tie
903,Bayesian,214,214,428,18,30,Tie
904,Bayesian,247,247,494,45,17,Tie
905,Bayesian,219,224,443,24,27,Bayesian
906,Bayesian,215,215,430,17,29,Tie
907,Bayesian,240,235,475,35,20,Player A
908,Bayesian,224,229,453,31,26,Bayesian
909,Bayesian,236,231,467,24,19,Player A
910,Bayesian,237,237,474,31,19,Tie
911,Bayesian,232,232,464,27,21,Tie
912,Bayesian,212,217,429,22,31,Bayesian
913,Bayesian,229,229,458,33,25,Tie
914,Bayesian,224,224,448,32,28,Tie
915,Bayesian,197,197,394,11,39,Tie
916,Bayesian,216,216,432,19,29,Tie
917,Bayesian,228,228,456,28,24,Tie
918,Bayesian,230,230,460,20,20,Tie
919,Bayesian,224,224,448,20,24,Tie
920,Bayesian,229,229,458,27,23,Tie
921,Bayesian,242,237,479,27,16,Player A
922,Bayesian,235,235,470,30,20,Tie
923,Bayesian,227,227,454,23,23,Tie
924,Bayesian,204,209,413,15,34,Bayesian
925,Bayesian,230,230,460,26,22,Tie
926,Bayesian,219,219,438,25,29,Tie
927,Bayesian,231,231,462,19,19,Tie
928,Bayesian,224,224,448,29,27,Tie
929,Bayesian,220,215,435,25,30,Player A
930,Bayesian,232,237,469,29,20,Bayesian
931,Bayesian,241,236,477,34,19,Player A
932,Bayesian,200,205,405,19,38,Bayesian
933,Bayesian,225,220,445,23,26,Player A
934,Bayesian,211,216,427,20,31,Bayesian
935,Bayesian,230,230,460,26,22,Tie
936,Bayesian,233,228,461,24,21,Player A
937,Bayesian,232,237,469,32,21,Bayesian
938,Bayesian,227,227,454,20,22,Tie
939,Bayesian,225,220,445,26,27,Player A
940,Bayesian,204,209,413,15,34,Bayesian
941,Bayesian,226,221,447,28,27,Player A
942,Bayesian,232,232,464,30,22,Tie
943,Bayesian,241,246,487,32,15,Bayesian
944,Bayesian,217,212,429,19,30,Player A
945,Bayesian,214,219,433,26,31,Bayesian
946,Bayesian,230,225,455,21,22,Player A
947,Bayesian,230,230,460,26,22,Tie
948,Bayesian,230,230,460,29,23,Tie
949,Bayesian,216,221,437,21,28,Bayesian
950,Bayesian,237,237,474,31,19,Tie
951,Bayesian,237,232,469,29,20,Player A
952,Bayesian,237,242,479,30,17,Bayesian
953,Bayesian,242,237,479,30,17,Player A
954,Bayesian,221,221,442,26,28,Tie
955,Bayesian,231,231,462,34,24,Tie
956,Bayesian,218,223,441,22,27,Bayesian
957,Bayesian,221,216,437,18,27,Player A
958,Bayesian,226,231,457,23,22,Bayesian
959,Bayesian,222,217,439,26,29,Player A
960,Bayesian,225,230,455,24,23,Bayesian
961,Bayesian,221,221,442,23,27,Tie
962,Bayesian,237,232,469,29,20,Player A
963,Bayesian,217,222,439,23,28,Bayesian
964,Bayesian,225,225,450,25,25,Tie
965,Bayesian,224,224,448,29,27,Tie
966,Bayesian,233,228,461,27,22,Player A
967,Bayesian,224,229,453,25,24,Bayesian
968,Bayesian,226,221,447,28,27,Player A
969,Bayesian,227,232,459,28,23,Bayesian
970,Bayesian,230,230,460,20,20,Tie
971,Bayesian,228,223,451,26,25,Player A
972,Bayesian,238,238,476,30,18,Tie
973,Bayesian,236,236,472,32,20,Tie
974,Bayesian,234,234,468,25,19,Tie
975,Bayesian,243,243,486,34,16,Tie
976,Bayesian,227,227,454,26,24,Tie
977,Bayesian,217,217,434,24,30,Tie
978,Bayesian,242,242,484,35,17,Tie
979,Bayesian,221,221,442,29,29,Tie
980,Bayesian,247,252,499,44,15,Bayesian
981,Bayesian,230,225,455,24,23,Player A
982,Bayesian,226,231,457,26,23,Bayesian
983,Bayesian,221,216,437,24,29,Player A
984,Bayesian,223,223,446,27,27,Tie
985,Bayesian,233,233,466,26,20,Tie
986,Bayesian,236,236,472,35,21,Tie
987,Bayesian,213,213,426,25,33,Tie
988,Bayesian,218,218,436,17,27,Tie
989,Bayesian,227,227,454,29,25,Tie
990,Bayesian,223,223,446,21,25,Tie
991,Bayesian,226,231,457,26,23,Bayesian
992,Bayesian,232,232,464,27,21,Tie
993,Bayesian,222,217,439,20,27,Player A
994,Bayesian,233,238,471,31,20,Bayesian
995,Bayesian,231,231,462,34,24,Tie
996,Bayesian,226,221,447,22,25,Player A
997,Bayesian,232,237,469,32,21,Bayesian
998,Bayesian,220,220,440,21,27,Tie
999,Bayesian,234,229,463,32,23,Player A
1000,Bayesian,213,218,431,27,32,Bayesian
1001,Bayesian,232,227,459,22,21,Player A
1002,Bayesian,220,225,445,17,24,Bayesian
1003,Bayesian,227,222,449,24,25,Player A
1004,Bayesian,217,222,439,17,26,Bayesian
1005,Bayesian,220,215,435,16,27,Player A
1006,Bayesian,236,236,472,29,19,Tie
1007,Bayesian,237,242,479,33,18,Bayesian
1008,Bayesian,223,218,441,25,28,Player A
1009,Bayesian,219,224,443,15,24,Bayesian
1010,Bayesian,237,232,469,35,22,Player A
1011,Bayesian,226,231,457,23,22,Bayesian
1012,Bayesian,226,221,447,22,25,Player A
1013,Bayesian,215,220,435,19,28,Bayesian
1014,Bayesian,223,223,446,24,26,Tie
1015,Bayesian,233,233,466,29,21,Tie
1016,Bayesian,237,232,469,35,22,Player A
1017,Bayesian,243,243,486,37,17,Tie
1018,Bayesian,233,238,471,25,18,Bayesian
1019,Bayesian,220,215,435,19,28,Player A
1020,Bayesian,226,231,457,29,24,Bayesian
1021,Bayesian,231,226,457,29,24,Player A
1022,Bayesian,232,237,469,26,19,Bayesian
1023,Bayesian,218,213,431,24,31,Player A
1024,Bayesian,247,247,494,33,13,Tie
1025,Bayesian,240,240,480,28,16,Tie
1026,Bayesian,213,213,426,22,32,Tie
1027,Bayesian,215,220,435,19,28,Bayesian
1028,Bayesian,232,232,464,24,20,Tie
1029,Bayesian,239,234,473,36,21,Player A
1030,Bayesian,210,215,425,24,33,Bayesian
1031,Bayesian,231,226,457,26,23,Player A
1032,Bayesian,232,232,464,21,19,Tie
1033,Bayesian,237,237,474,28,18,Tie
1034,Bayesian,225,230,455,33,26,Bayesian
1035,Bayesian,236,231,467,27,20,Player A
1036,Bayesian,231,236,467,27,20,Bayesian
1037,Bayesian,232,232,464,30,22,Tie
1038,Bayesian,247,247,494,39,15,Tie
1039,Bayesian,224,219,443,21,26,Player A
1040,Bayesian,238,238,476,30,18,Tie
1041,Bayesian,230,235,465,31,22,Bayesian
1042,Bayesian,220,215,435,16,27,Player A
1043,Bayesian,211,216,427,20,31,Bayesian
1044,Bayesian,211,211,422,21,33,Tie
1045,Bayesian,206,206,412,20,36,Tie
1046,Bayesian,235,230,465,31,22,Player A
1047,Bayesian,227,232,459,25,22,Bayesian
1048,Bayesian,234,234,468,25,19,Tie
1049,Bayesian,235,235,470,30,20,Tie
1050,Bayesian,213,213,426,19,31,Tie
1051,Bayesian,218,213,431,18,29,Player A
1052,Bayesian,245,245,490,38,16,Tie
1053,Bayesian,214,219,433,23,30,Bayesian
1054,Bayesian,221,216,437,24,29,Player A
1055,Bayesian,228,233,461,33,24,Bayesian
1056,Bayesian,212,212,424,20,32,Tie
1057,Bayesian,240,240,480,28,16,Tie
1058,Bayesian,222,217,439,23,28,Player A
1059,Bayesian,209,209,418,20,34,Tie
1060,Bayesian,207,207,414,22,36,Tie
1061,Bayesian,216,216,432,25,31,Tie
1062,Bayesian,233,238,471,31,20,Bayesian
1063,Bayesian,236,231,467,24,19,Player A
1064,Bayesian,223,223,446,30,28,Tie
1065,Bayesian,225,225,450,22,24,Tie
1066,Bayesian,230,230,460,35,25,Tie
1067,Bayesian,215,220,435,16,27,Bayesian
1068,Bayesian,244,239,483,40,19,Player A
1069,Bayesian,224,229,453,28,25,Bayesian
1070,Bayesian,242,237,479,30,17,Player A
1071,Bayesian,245,245,490,29,13,Tie
1072,Bayesian,233,238,471,25,18,Bayesian
1073,Bayesian,223,223,446,18,24,Tie
1074,Bayesian,232,227,459,25,22,Player A
1075,Bayesian,226,231,457,29,24,Bayesian
1076,Bayesian,233,228,461,27,22,Player A
1077,Bayesian,233,233,466,32,22,Tie
1078,Bayesian,236,236,472,32,20,Tie
1079,Bayesian,217,217,434,30,32,Tie
1080,Bayesian,235,235,470,27,19,Tie
1081,Bayesian,228,233,461,27,22,Bayesian
1082,Bayesian,212,207,419,18,33,Player A
1083,Bayesian,218,223,441,19,26,Bayesian
1084,Bayesian,231,226,457,23,22,Player A
1085,Bayesian,228,233,461,30,23,Bayesian
1086,Bayesian,239,234,473,33,20,Player A
1087,Bayesian,222,227,449,21,24,Bayesian
1088,Bayesian,205,200,405,13,36,Player A
1089,Bayesian,239,239,478,29,17,Tie
1090,Bayesian,225,225,450,25,25,Tie
1091,Bayesian,235,235,470,30,20,Tie
1092,Bayesian,201,206,407,18,37,Bayesian
1093,Bayesian,230,225,455,24,23,Player A
1094,Bayesian,208,213,421,17,32,Bayesian
1095,Bayesian,229,229,458,24,22,Tie
1096,Bayesian,243,243,486,22,12,Tie
1097,Bayesian,238,238,476,33,19,Tie
1098,Bayesian,227,227,454,29,25,Tie
1099,Bayesian,236,236,472,35,21,Tie
1100,Bayesian,210,210,420,22,34,Tie
1101,Bayesian,230,230,460,29,23,Tie
1102,Bayesian,232,232,464,24,20,Tie
1103,Bayesian,228,223,451,26,25,Player A
1104,Bayesian,214,219,433,17,28,Bayesian
1105,Bayesian,214,214,428,21,31,Tie
1106,Bayesian,248,248,496,32,12,Tie
1107,Bayesian,226,221,447,22,25,Player A
1108,Bayesian,224,224,448,23,25,Tie
1109,Bayesian,239,239,478,26,16,Tie
1110,Bayesian,223,223,446,24,26,Tie
1111,Bayesian,234,234,468,31,21,Tie
1112,Bayesian,235,235,470,30,20,Tie
1113,Bayesian,224,224,448,29,27,Tie
1114,Bayesian,228,228,456,28,24,Tie
1115,Bayesian,212,217,429,19,30,Bayesian
1116,Bayesian,215,215,430,23,31,Tie
1117,Bayesian,241,241,482,33,17,Tie
1118,Bayesian,230,225,455,24,23,Player A
1119,Bayesian,231,236,467,30,21,Bayesian
1120,Bayesian,221,216,437,24,29,Player A
1121,Bayesian,224,224,448,26,26,Tie
1122,Bayesian,221,221,442,29,29,Tie
1123,Bayesian,228,228,456,25,23,Tie
1124,Bayesian,219,219,438,28,30,Tie
1125,Bayesian,224,224,448,17,23,Tie
1126,Bayesian,228,228,456,28,24,Tie
1127,Bayesian,237,237,474,37,21,Tie
1128,Bayesian,221,226,447,28,27,Bayesian
1129,Bayesian,226,221,447,25,26,Player A
1130,Bayesian,223,228,451,26,25,Bayesian
1131,Bayesian,218,213,431,27,32,Player A
1132,Bayesian,220,225,445,26,27,Bayesian
1133,Bayesian,230,225,455,21,22,Player A
1134,Bayesian,230,230,460,29,23,Tie
1135,Bayesian,221,221,442,17,25,Tie
1136,Bayesian,238,238,476,30,18,Tie
1137,Bayesian,234,234,468,31,21,Tie
1138,Bayesian,211,211,422,18,32,Tie
1139,Bayesian,227,227,454,26,24,Tie
1140,Bayesian,230,235,465,28,21,Bayesian
1141,Bayesian,230,230,460,29,23,Tie
1142,Bayesian,224,224,448,26,26,Tie
1143,Bayesian,226,221,447,22,25,Player A
1144,Bayesian,239,244,483,37,18,Bayesian
1145,Bayesian,241,236,477,31,18,Player A
1146,Bayesian,213,213,426,19,31,Tie
1147,Bayesian,231,231,462,28,22,Tie
1148,Bayesian,221,226,447,28,27,Bayesian
1149,Bayesian,226,221,447,25,26,Player A
1150,Bayesian,236,241,477,28,17,Bayesian
1151,Bayesian,226,221,447,25,26,Player A
1152,Bayesian,217,217,434,21,29,Tie
1153,Bayesian,223,228,451,29,26,Bayesian
1154,Bayesian,229,224,453,25,24,Player A
1155,Bayesian,211,216,427,20,31,Bayesian
1156,Bayesian,234,229,463,29,22,Player A
1157,Bayesian,228,228,456,31,25,Tie
1158,Bayesian,219,219,438,25,29,Tie
1159,Bayesian,224,229,453,28,25,Bayesian
1160,Bayesian,242,237,479,33,18,Player A
1161,Bayesian,226,231,457,23,22,Bayesian
1162,Bayesian,221,216,437,21,28,Player A
1163,Bayesian,224,224,448,23,25,Tie
1164,Bayesian,229,234,463,23,20,Bayesian
1165,Bayesian,225,220,445,26,27,Player A
1166,Bayesian,226,231,457,23,22,Bayesian
1167,Bayesian,237,237,474,28,18,Tie
1168,Bayesian,219,219,438,19,27,Tie
1169,Bayesian,213,213,426,16,30,Tie
1170,Bayesian,217,212,429,16,29,Player A
1171,Bayesian,217,222,439,29,30,Bayesian
1172,Bayesian,222,222,444,28,28,Tie
1173,Bayesian,238,233,471,31,20,Player A
1174,Bayesian,232,237,469,29,20,Bayesian
1175,Bayesian,232,227,459,28,23,Player A
1176,Bayesian,204,204,408,13,35,Tie
1177,Bayesian,223,223,446,18,24,Tie
1178,Bayesian,242,247,489,37,16,Bayesian
1179,Bayesian,220,220,440,27,29,Tie
1180,Bayesian,232,227,459,25,22,Player A
1181,Bayesian,222,222,444,25,27,Tie
1182,Bayesian,232,237,469,29,20,Bayesian
1183,Bayesian,219,219,438,22,28,Tie
1184,Bayesian,222,222,444,25,27,Tie
1185,Bayesian,200,195,395,12,39,Player A
1186,Bayesian,208,213,421,23,34,Bayesian
1187,Bayesian,232,227,459,25,22,Player A
1188,Bayesian,217,222,439,26,29,Bayesian
1189,Bayesian,232,227,459,31,24,Player A
1190,Bayesian,229,234,463,29,22,Bayesian
1191,Bayesian,232,227,459,28,23,Player A
1192,Bayesian,207,212,419,18,33,Bayesian
1193,Bayesian,207,207,414,19,35,Tie
1194,Bayesian,215,215,430,20,30,Tie
1195,Bayesian,209,209,418,17,33,Tie
1196,Bayesian,229,229,458,30,24,Tie
1197,Bayesian,216,216,432,16,28,Tie
1198,Bayesian,248,248,496,35,13,Tie
1199,Bayesian,201,196,397,17,40,Player A
1200,Bayesian,221,226,447,19,24,Bayesian
1201,Bayesian,215,215,430,17,29,Tie
1202,Bayesian,222,222,444,28,28,Tie
1203,Bayesian,227,227,454,26,24,Tie
1204,Bayesian,229,229,458,30,24,Tie
1205,Bayesian,230,230,460,20,20,Tie
1206,Bayesian,229,224,453,28,25,Player A
1207,Bayesian,221,226,447,22,25,Bayesian
1208,Bayesian,224,219,443,21,26,Player A
1209,Bayesian,248,248,496,38,14,Tie
1210,Bayesian,207,212,419,24,35,Bayesian
1211,Bayesian,220,220,440,24,28,Tie
1212,Bayesian,221,221,442,23,27,Tie
1213,Bayesian,234,234,468,28,20,Tie
1214,Bayesian,222,222,444,25,27,Tie
1215,Bayesian,214,214,428,21,31,Tie
1216,Bayesian,219,214,433,20,29,Player A
1217,Bayesian,223,223,446,21,25,Tie
1218,Bayesian,210,210,420,19,33,Tie
1219,Bayesian,221,221,442,23,27,Tie
1220,Bayesian,219,224,443,30,29,Bayesian
1221,Bayesian,228,228,456,19,21,Tie
1222,Bayesian,236,236,472,26,18,Tie
1223,Bayesian,225,225,450,25,25,Tie
1224,Bayesian,227,227,454,20,22,Tie
1225,Bayesian,231,226,457,26,23,Player A
1226,Bayesian,238,238,476,33,19,Tie
1227,Bayesian,218,218,436,23,29,Tie
1228,Bayesian,217,217,434,24,30,Tie
1229,Bayesian,227,232,459,28,23,Bayesian
1230,Bayesian,209,204,413,18,35,Player A
1231,Bayesian,231,231,462,31,23,Tie
1232,Bayesian,229,229,458,27,23,Tie
1233,Bayesian,210,210,420,16,32,Tie
1234,Bayesian,222,222,444,25,27,Tie
1235,Bayesian,228,233,461,24,21,Bayesian
1236,Bayesian,234,234,468,28,20,Tie
1237,Bayesian,202,202,404,18,38,Tie
1238,Bayesian,214,214,428,21,31,Tie
1239,Bayesian,234,229,463,29,22,Player A
1240,Bayesian,209,209,418,20,34,Tie
1241,Bayesian,217,222,439,29,30,Bayesian
1242,Bayesian,239,239,478,32,18,Tie
1243,Bayesian,222,217,439,17,26,Player A
1244,Bayesian,234,239,473,27,18,Bayesian
1245,Bayesian,231,231,462,31,23,Tie
1246,Bayesian,230,230,460,26,22,Tie
1247,Bayesian,222,222,444,16,24,Tie
1248,Bayesian,220,220,440,27,29,Tie
1249,Bayesian,216,216,432,19,29,Tie
1250,Bayesian,212,207,419,18,33,Player A
1251,Bayesian,236,236,472,26,18,Tie
1252,Bayesian,223,228,451,32,27,Bayesian
1253,Bayesian,239,239,478,23,15,Tie
1254,Bayesian,237,237,474,31,19,Tie
1255,Bayesian,224,219,443,21,26,Player A
1256,Bayesian,229,229,458,24,22,Tie
1257,Bayesian,231,231,462,25,21,Tie
1258,Bayesian,223,228,451,26,25,Bayesian
1259,Bayesian,213,208,421,23,34,Player A
1260,Bayesian,230,230,460,20,20,Tie
1261,Bayesian,231,231,462,31,23,Tie
1262,Bayesian,232,232,464,30,22,Tie
1263,Bayesian,208,208,416,18,34,Tie
1264,Bayesian,225,225,450,25,25,Tie
1265,Bayesian,211,216,427,20,31,Bayesian
1266,Bayesian,229,229,458,33,25,Tie
1267,Bayesian,217,217,434,21,29,Tie
1268,Bayesian,223,223,446,24,26,Tie
1269,Bayesian,221,221,442,20,26,Tie
1270,Bayesian,233,228,461,24,21,Player A
1271,Bayesian,227,232,459,28,23,Bayesian
1272,Bayesian,222,222,444,25,27,Tie
1273,Bayesian,234,229,463,26,21,Player A
1274,Bayesian,219,224,443,24,27,Bayesian
1275,Bayesian,231,226,457,32,25,Player A
1276,Bayesian,213,218,431,21,30,Bayesian
1277,Bayesian,227,227,454,23,23,Tie
1278,Bayesian,252,247,499,35,12,Player A
1279,Bayesian,239,239,478,32,18,Tie
1280,Bayesian,209,209,418,17,33,Tie
1281,Bayesian,228,233,461,21,20,Bayesian
1282,Bayesian,221,221,442,32,30,Tie
1283,Bayesian,207,207,414,16,34,Tie
1284,Bayesian,204,199,403,14,37,Player A
1285,Bayesian,230,235,465,34,23,Bayesian
1286,Bayesian,209,209,418,23,35,Tie
1287,Bayesian,233,233,466,32,22,Tie
1288,Bayesian,215,215,430,20,30,Tie
1289,Bayesian,228,223,451,26,25,Player A
1290,Bayesian,240,245,485,30,15,Bayesian
1291,Bayesian,235,230,465,28,21,Player A
1292,Bayesian,229,234,463,29,22,Bayesian
1293,Bayesian,231,231,462,22,20,Tie
1294,Bayesian,235,230,465,34,23,Player A
1295,Bayesian,223,228,451,26,25,Bayesian
1296,Bayesian,233,228,461,30,23,Player A
1297,Bayesian,225,225,450,25,25,Tie
1298,Bayesian,230,230,460,29,23,Tie
1299,Bayesian,229,229,458,21,21,Tie
1300,Bayesian,223,228,451,26,25,Bayesian
1301,Bayesian,222,222,444,25,27,Tie
1302,Bayesian,232,227,459,28,23,Player A
1303,Bayesian,220,220,440,27,29,Tie
1304,Bayesian,214,219,433,23,30,Bayesian
1305,Bayesian,223,218,441,28,29,Player A
1306,Bayesian,212,212,424,20,32,Tie
1307,Bayesian,227,227,454,26,24,Tie
1308,Bayesian,247,247,494,33,13,Tie
1309,Bayesian,236,241,477,31,18,Bayesian
1310,Bayesian,224,224,448,29,27,Tie
1311,Bayesian,237,232,469,26,19,Player A
1312,Bayesian,220,225,445,26,27,Bayesian
1313,Bayesian,220,220,440,15,25,Tie
1314,Bayesian,227,227,454,26,24,Tie
1315,Bayesian,236,231,467,27,20,Player A
1316,Bayesian,210,210,420,25,35,Tie
1317,Bayesian,234,239,473,30,19,Bayesian
1318,Bayesian,237,237,474,28,18,Tie
1319,Bayesian,243,243,486,37,17,Tie
1320,Bayesian,216,211,427,14,29,Player A
1321,Bayesian,228,233,461,27,22,Bayesian
1322,Bayesian,229,229,458,21,21,Tie
1323,Bayesian,245,245,490,35,15,Tie
1324,Bayesian,217,217,434,24,30,Tie
1325,Bayesian,206,206,412,20,36,Tie
1326,Bayesian,216,211,427,23,32,Player A
1327,Bayesian,224,229,453,28,25,Bayesian
1328,Bayesian,225,220,445,17,24,Player A
1329,Bayesian,230,235,465,22,19,Bayesian
1330,Bayesian,207,202,409,14,35,Player A
1331,Bayesian,220,220,440,15,25,Tie
1332,Bayesian,218,218,436,20,28,Tie
1333,Bayesian,226,231,457,23,22,Bayesian
1334,Bayesian,220,220,440,21,27,Tie
1335,Bayesian,230,225,455,30,25,Player A
1336,Bayesian,233,238,471,34,21,Bayesian
1337,Bayesian,216,211,427,20,31,Player A
1338,Bayesian,219,219,438,22,28,Tie
1339,Bayesian,234,239,473,33,20,Bayesian
1340,Bayesian,248,243,491,30,13,Player A
1341,Bayesian,217,222,439,20,27,Bayesian
1342,Bayesian,218,213,431,18,29,Player A
1343,Bayesian,228,228,456,25,23,Tie
1344,Bayesian,229,229,458,27,23,Tie
1345,Bayesian,221,221,442,17,25,Tie
1346,Bayesian,230,230,460,23,21,Tie
1347,Bayesian,240,245,485,36,17,Bayesian
1348,Bayesian,238,233,471,28,19,Player A
1349,Bayesian,216,221,437,18,27,Bayesian
1350,Bayesian,225,220,445,26,27,Player A
1351,Bayesian,229,229,458,30,24,Tie
1352,Bayesian,211,216,427,20,31,Bayesian
1353,Bayesian,217,212,429,19,30,Player A
1354,Bayesian,216,221,437,27,30,Bayesian
1355,Bayesian,219,214,433,20,29,Player A
1356,Bayesian,225,225,450,19,23,Tie
1357,Bayesian,234,234,468,25,19,Tie
1358,Bayesian,228,228,456,31,25,Tie
1359,Bayesian,223,228,451,23,24,Bayesian
1360,Bayesian,216,216,432,22,30,Tie
1361,Bayesian,208,208,416,24,36,Tie
1362,Bayesian,245,240,485,30,15,Player A
1363,Bayesian,240,245,485,36,17,Bayesian
1364,Bayesian,218,213,431,18,29,Player A
1365,Bayesian,216,221,437,21,28,Bayesian
1366,Bayesian,219,219,438,22,28,Tie
1367,Bayesian,225,220,445,32,29,Player A
1368,Bayesian,216,221,437,24,29,Bayesian
1369,Bayesian,224,219,443,21,26,Player A
1370,Bayesian,236,236,472,29,19,Tie
1371,Bayesian,217,217,434,21,29,Tie
1372,Bayesian,236,236,472,29,19,Tie
1373,Bayesian,222,227,449,18,23,Bayesian
1374,Bayesian,225,225,450,25,25,Tie
1375,Bayesian,227,227,454,23,23,Tie
1376,Bayesian,223,223,446,24,26,Tie
1377,Bayesian,232,227,459,31,24,Player A
1378,Bayesian,227,227,454,23,23,Tie
1379,Bayesian,223,223,446,24,26,Tie
1380,Bayesian,236,236,472,32,20,Tie
1381,Bayesian,215,220,435,22,29,Bayesian
1382,Bayesian,227,222,449,24,25,Player A
1383,Bayesian,224,229,453,22,23,Bayesian
1384,Bayesian,233,228,461,27,22,Player A
1385,Bayesian,224,224,448,23,25,Tie
1386,Bayesian,235,235,470,24,18,Tie
1387,Bayesian,230,230,460,29,23,Tie
1388,Bayesian,231,231,462,25,21,Tie
1389,Bayesian,223,228,451,20,23,Bayesian
1390,Bayesian,212,207,419,21,34,Player A
1391,Bayesian,213,213,426,25,33,Tie
1392,Bayesian,228,233,461,24,21,Bayesian
1393,Bayesian,215,210,425,18,31,Player A
1394,Bayesian,222,227,449,18,23,Bayesian
1395,Bayesian,244,239,483,37,18,Player A
1396,Bayesian,226,226,452,27,25,Tie
1397,Bayesian,242,247,489,37,16,Bayesian
1398,Bayesian,226,226,452,24,24,Tie
1399,Bayesian,211,211,422,24,34,Tie
1400,Bayesian,227,222,449,24,25,Player A
1401,Bayesian,224,229,453,22,23,Bayesian
1402,Bayesian,223,223,446,27,27,Tie
1403,Bayesian,215,210,425,15,30,Player A
1404,Bayesian,221,221,442,23,27,Tie
1405,Bayesian,215,220,435,22,29,Bayesian
1406,Bayesian,222,217,439,26,29,Player A
1407,Bayesian,228,228,456,22,22,Tie
1408,Bayesian,220,225,445,26,27,Bayesian
1409,Bayesian,215,210,425,18,31,Player A
1410,Bayesian,216,221,437,27,30,Bayesian
1411,Bayesian,229,229,458,21,21,Tie
1412,Bayesian,241,236,477,34,19,Player A
1413,Bayesian,234,239,473,30,19,Bayesian
1414,Bayesian,209,204,413,12,33,Player A
1415,Bayesian,203,203,406,11,35,Tie
1416,Bayesian,250,250,500,36,12,Tie
1417,Bayesian,226,226,452,27,25,Tie
1418,Bayesian,232,232,464,36,24,Tie
1419,Bayesian,223,223,446,30,28,Tie
1420,Bayesian,206,206,412,17,35,Tie
1421,Bayesian,226,226,452,27,25,Tie
1422,Bayesian,224,224,448,17,23,Tie
1423,Bayesian,221,226,447,22,25,Bayesian
1424,Bayesian,225,225,450,22,24,Tie
1425,Bayesian,232,227,459,28,23,Player A
1426,Bayesian,228,228,456,22,22,Tie
1427,Bayesian,217,217,434,21,29,Tie
1428,Bayesian,215,215,430,26,32,Tie
1429,Bayesian,219,224,443,21,26,Bayesian
1430,Bayesian,227,222,449,18,23,Player A
1431,Bayesian,210,210,420,19,33,Tie
1432,Bayesian,226,226,452,27,25,Tie
1433,Bayesian,239,244,483,31,16,Bayesian
1434,Bayesian,226,226,452,24,24,Tie
1435,Bayesian,239,234,473,33,20,Player A
1436,Bayesian,228,233,461,24,21,Bayesian
1437,Bayesian,227,222,449,24,25,Player A
1438,Bayesian,242,247,489,37,16,Bayesian
1439,Bayesian,243,238,481,35,18,Player A
1440,Bayesian,228,228,456,28,24,Tie
1441,Bayesian,230,235,465,25,20,Bayesian
1442,Bayesian,231,231,462,28,22,Tie
1443,Bayesian,224,219,443,21,26,Player A
1444,Bayesian,222,227,449,27,26,Bayesian
1445,Bayesian,241,241,482,36,18,Tie
1446,Bayesian,226,226,452,30,26,Tie
1447,Bayesian,228,223,451,23,24,Player A
1448,Bayesian,224,224,448,26,26,Tie
1449,Bayesian,227,227,454,20,22,Tie
1450,Bayesian,230,235,465,34,23,Bayesian
1451,Bayesian,222,217,439,20,27,Player A
0,UCBPlayer,119,124,243,1,86,UCBPlayer
1,UCBPlayer,115,115,230,0,90,Tie
2,UCBPlayer,115,115,230,0,90,Tie
3,UCBPlayer,116,111,227,0,91,Player A
4,UCBPlayer,111,116,227,0,91,UCBPlayer
5,UCBPlayer,115,115,230,0,90,Tie
6,UCBPlayer,115,115,230,0,90,Tie
7,UCBPlayer,115,115,230,0,90,Tie
8,UCBPlayer,115,115,230,0,90,Tie
9,UCBPlayer,115,115,230,0,90,Tie
10,UCBPlayer,115,115,230,0,90,Tie
11,UCBPlayer,115,115,230,0,90,Tie
12,UCBPlayer,115,115,230,0,90,Tie
13,UCBPlayer,115,115,230,0,90,Tie
14,UCBPlayer,115,115,230,0,90,Tie
15,UCBPlayer,115,115,230,0,90,Tie
16,UCBPlayer,115,115,230,0,90,Tie
17,UCBPlayer,115,115,230,0,90,Tie
18,UCBPlayer,115,115,230,0,90,Tie
19,UCBPlayer,115,115,230,0,90,Tie
20,UCBPlayer,115,115,230,0,90,Tie
21,UCBPlayer,115,115,230,0,90,Tie
22,UCBPlayer,116,111,227,0,91,Player A
23,UCBPlayer,111,116,227,0,91,UCBPlayer
24,UCBPlayer,115,115,230,0,90,Tie
25,UCBPlayer,115,115,230,0,90,Tie
26,UCBPlayer,115,115,230,0,90,Tie
27,UCBPlayer,115,115,230,0,90,Tie
28,UCBPlayer,115,115,230,0,90,Tie
29,UCBPlayer,115,115,230,0,90,Tie
30,UCBPlayer,115,115,230,0,90,Tie
31,UCBPlayer,115,115,230,0,90,Tie
32,UCBPlayer,115,115,230,0,90,Tie
33,UCBPlayer,115,115,230,0,90,Tie
34,UCBPlayer,115,115,230,0,90,Tie
35,UCBPlayer,116,111,227,0,91,Player A
36,UCBPlayer,111,116,227,0,91,UCBPlayer
37,UCBPlayer,115,115,230,0,90,Tie
38,UCBPlayer,115,115,230,0,90,Tie
39,UCBPlayer,115,115,230,0,90,Tie
40,UCBPlayer,115,115,230,0,90,Tie
41,UCBPlayer,115,115,230,0,90,Tie
42,UCBPlayer,115,115,230,0,90,Tie
43,UCBPlayer,115,115,230,0,90,Tie
44,UCBPlayer,116,111,227,0,91,Player A
45,UCBPlayer,111,116,227,0,91,UCBPlayer
46,UCBPlayer,115,115,230,0,90,Tie
47,UCBPlayer,115,115,230,0,90,Tie
48,UCBPlayer,115,115,230,0,90,Tie
49,UCBPlayer,115,115,230,0,90,Tie
50,UCBPlayer,112,112,224,0,92,Tie
51,UCBPlayer,115,115,230,0,90,Tie
52,UCBPlayer,115,115,230,0,90,Tie
53,UCBPlayer,115,115,230,0,90,Tie
54,UCBPlayer,116,111,227,0,91,Player A
55,UCBPlayer,111,116,227,0,91,UCBPlayer
56,UCBPlayer,115,115,230,0,90,Tie
57,UCBPlayer,115,115,230,0,90,Tie
58,UCBPlayer,115,115,230,0,90,Tie
59,UCBPlayer,115,115,230,0,90,Tie
60,UCBPlayer,115,115,230,0,90,Tie
61,UCBPlayer,115,115,230,0,90,Tie
62,UCBPlayer,115,115,230,0,90,Tie
63,UCBPlayer,115,115,230,0,90,Tie
64,UCBPlayer,115,115,230,0,90,Tie
65,UCBPlayer,115,115,230,0,90,Tie
66,UCBPlayer,115,115,230,0,90,Tie
67,UCBPlayer,115,115,230,0,90,Tie
68,UCBPlayer,115,115,230,0,90,Tie
69,UCBPlayer,115,115,230,0,90,Tie
70,UCBPlayer,115,115,230,0,90,Tie
71,UCBPlayer,115,115,230,0,90,Tie
72,UCBPlayer,115,115,230,0,90,Tie
73,UCBPlayer,116,111,227,0,91,Player A
74,UCBPlayer,111,116,227,0,91,UCBPlayer
75,UCBPlayer,115,115,230,0,90,Tie
76,UCBPlayer,115,115,230,0,90,Tie
77,UCBPlayer,115,115,230,0,90,Tie
0,JointPQPlayer,177,172,349,11,54,Player A
1,JointPQPlayer,259,259,518,54,12,Tie
2,JointPQPlayer,204,204,408,28,40,Tie
3,JointPQPlayer,196,201,397,17,40,JointPQPlayer
4,JointPQPlayer,260,255,515,45,10,Player A
5,JointPQPlayer,184,184,368,9,47,Tie
6,JointPQPlayer,238,243,481,35,18,JointPQPlayer
7,JointPQPlayer,263,258,521,48,9,Player A
8,JointPQPlayer,192,197,389,15,42,JointPQPlayer
9,JointPQPlayer,219,214,433,29,32,Player A
10,JointPQPlayer,269,269,538,56,6,Tie
11,JointPQPlayer,242,242,484,35,17,Tie
12,JointPQPlayer,257,262,519,49,10,JointPQPlayer
13,JointPQPlayer,168,168,336,7,57,Tie
14,JointPQPlayer,275,270,545,63,6,Player A
15,JointPQPlayer,259,264,523,50,9,JointPQPlayer
16,JointPQPlayer,268,263,531,55,8,Player A
17,JointPQPlayer,214,219,433,26,31,JointPQPlayer
18,JointPQPlayer,267,267,534,55,7,Tie
19,JointPQPlayer,249,244,493,38,15,Player A
20,JointPQPlayer,264,264,528,52,8,Tie
21,JointPQPlayer,259,259,518,54,12,Tie
22,JointPQPlayer,277,277,554,57,1,Tie
23,JointPQPlayer,177,182,359,9,50,JointPQPlayer
24,JointPQPlayer,201,196,397,8,37,Player A
25,JointPQPlayer,166,166,332,9,59,Tie
26,JointPQPlayer,248,248,496,35,13,Tie
27,JointPQPlayer,251,251,502,50,16,Tie
28,JointPQPlayer,272,272,544,56,4,Tie
29,JointPQPlayer,270,270,540,55,5,Tie
30,JointPQPlayer,166,171,337,5,56,JointPQPlayer
31,JointPQPlayer,241,236,477,37,20,Player A
32,JointPQPlayer,190,195,385,17,44,JointPQPlayer
33,JointPQPlayer,234,229,463,35,24,Player A
34,JointPQPlayer,228,228,456,34,26,Tie
35,JointPQPlayer,219,219,438,34,32,Tie
36,JointPQPlayer,254,259,513,43,10,JointPQPlayer
37,JointPQPlayer,253,248,501,43,14,Player A
38,JointPQPlayer,250,250,500,48,16,Tie
39,JointPQPlayer,238,238,476,33,19,Tie
40,JointPQPlayer,256,256,512,51,13,Tie
41,JointPQPlayer,265,265,530,57,9,Tie
42,JointPQPlayer,254,254,508,38,10,Tie
43,JointPQPlayer,253,258,511,53,14,JointPQPlayer
44,JointPQPlayer,242,237,479,39,20,Player A
45,JointPQPlayer,262,262,524,57,11,Tie
46,JointPQPlayer,240,240,480,37,19,Tie
47,JointPQPlayer,249,249,498,40,14,Tie
48,JointPQPlayer,197,202,399,19,40,JointPQPlayer
49,JointPQPlayer,178,178,356,6,50,Tie
50,JointPQPlayer,245,240,485,39,18,Player A
51,JointPQPlayer,189,189,378,13,45,Tie
52,JointPQPlayer,199,199,398,21,41,Tie
53,JointPQPlayer,244,244,488,39,17,Tie
54,JointPQPlayer,247,252,499,41,14,JointPQPlayer
55,JointPQPlayer,173,173,346,5,53,Tie
56,JointPQPlayer,256,251,507,40,11,Player A
57,JointPQPlayer,263,263,526,47,7,Tie
58,JointPQPlayer,252,257,509,51,14,JointPQPlayer
59,JointPQPlayer,266,261,527,45,6,Player A
60,JointPQPlayer,244,249,493,44,17,JointPQPlayer
61,JointPQPlayer,259,254,513,40,9,Player A
62,JointPQPlayer,255,255,510,52,14,Tie
63,JointPQPlayer,261,261,522,55,11,Tie
64,JointPQPlayer,245,245,490,41,17,Tie
65,JointPQPlayer,265,265,530,54,8,Tie
66,JointPQPlayer,175,180,355,8,51,JointPQPlayer
67,JointPQPlayer,256,251,507,49,14,Player A
68,JointPQPlayer,261,261,522,52,10,Tie
69,JointPQPlayer,252,257,509,39,10,JointPQPlayer
70,JointPQPlayer,270,270,540,55,5,Tie
71,JointPQPlayer,264,259,523,50,9,Player A
72,JointPQPlayer,259,259,518,48,10,Tie
73,JointPQPlayer,251,256,507,40,11,JointPQPlayer
74,JointPQPlayer,272,267,539,54,5,Player A
75,JointPQPlayer,251,256,507,43,12,JointPQPlayer
76,JointPQPlayer,161,161,322,8,62,Tie
77,JointPQPlayer,264,264,528,52,8,Tie
78,JointPQPlayer,259,254,513,46,11,Player A
79,JointPQPlayer,171,176,347,6,53,JointPQPlayer
80,JointPQPlayer,178,173,351,10,53,Player A
81,JointPQPlayer,244,249,493,35,14,JointPQPlayer
82,JointPQPlayer,257,252,509,39,10,Player A
83,JointPQPlayer,255,260,515,48,11,JointPQPlayer
84,JointPQPlayer,270,270,540,55,5,Tie
85,JointPQPlayer,251,251,502,41,13,Tie
86,JointPQPlayer,251,251,502,44,14,Tie
87,JointPQPlayer,260,255,515,51,12,Player A
88,JointPQPlayer,260,260,520,44,8,Tie
89,JointPQPlayer,267,272,539,57,6,JointPQPlayer
90,JointPQPlayer,238,233,471,37,22,Player A
91,JointPQPlayer,179,184,363,13,50,JointPQPlayer
92,JointPQPlayer,271,266,537,55,6,Player A
93,JointPQPlayer,261,261,522,43,7,Tie
94,JointPQPlayer,158,163,321,4,61,JointPQPlayer
95,JointPQPlayer,255,255,510,43,11,Tie
96,JointPQPlayer,263,258,521,45,8,Player A
97,JointPQPlayer,238,238,476,45,23,Tie
98,JointPQPlayer,250,250,500,42,14,Tie
99,JointPQPlayer,264,264,528,49,7,Tie
100,JointPQPlayer,220,225,445,29,28,JointPQPlayer
101,JointPQPlayer,276,271,547,62,5,Player A
102,JointPQPlayer,261,261,522,46,8,Tie
103,JointPQPlayer,233,233,466,35,23,Tie
104,JointPQPlayer,267,267,534,52,6,Tie
105,JointPQPlayer,183,188,371,6,45,JointPQPlayer
106,JointPQPlayer,261,261,522,46,8,Tie
107,JointPQPlayer,191,186,377,15,46,Player A
108,JointPQPlayer,235,240,475,38,21,JointPQPlayer
109,JointPQPlayer,214,209,423,19,32,Player A
110,JointPQPlayer,266,266,532,50,6,Tie
111,JointPQPlayer,264,269,533,54,7,JointPQPlayer
112,JointPQPlayer,201,201,402,22,40,Tie
113,JointPQPlayer,234,229,463,41,26,Player A
114,JointPQPlayer,253,253,506,42,12,Tie
115,JointPQPlayer,168,173,341,9,56,JointPQPlayer
116,JointPQPlayer,259,254,513,43,10,Player A
117,JointPQPlayer,242,242,484,38,18,Tie
118,JointPQPlayer,183,188,371,15,48,JointPQPlayer
119,JointPQPlayer,231,231,462,34,24,Tie
120,JointPQPlayer,230,230,460,41,27,Tie
121,JointPQPlayer,254,254,508,47,13,Tie
122,JointPQPlayer,185,185,370,8,46,Tie
123,JointPQPlayer,268,263,531,49,6,Player A
124,JointPQPlayer,258,258,516,52,12,Tie
125,JointPQPlayer,275,275,550,62,4,Tie
126,JointPQPlayer,253,258,511,44,11,JointPQPlayer
127,JointPQPlayer,256,251,507,43,12,Player A
128,JointPQPlayer,233,238,471,37,22,JointPQPlayer
129,JointPQPlayer,271,271,542,57,5,Tie
130,JointPQPlayer,274,269,543,58,5,Player A
131,JointPQPlayer,225,230,455,30,25,JointPQPlayer
132,JointPQPlayer,235,230,465,34,23,Player A
133,JointPQPlayer,235,235,470,39,23,Tie
134,JointPQPlayer,230,230,460,29,23,Tie
135,JointPQPlayer,162,167,329,3,58,JointPQPlayer
136,JointPQPlayer,253,248,501,40,13,Player A
137,JointPQPlayer,256,256,512,39,9,Tie
138,JointPQPlayer,238,238,476,36,20,Tie
139,JointPQPlayer,195,195,390,22,44,Tie
140,JointPQPlayer,263,263,526,56,10,Tie
141,JointPQPlayer,209,214,423,22,33,JointPQPlayer
142,JointPQPlayer,191,191,382,23,47,Tie
143,JointPQPlayer,265,260,525,49,8,Player A
144,JointPQPlayer,216,216,432,37,35,Tie
145,JointPQPlayer,265,270,535,53,6,JointPQPlayer
146,JointPQPlayer,239,234,473,39,22,Player A
147,JointPQPlayer,223,223,446,30,28,Tie
148,JointPQPlayer,261,266,527,54,9,JointPQPlayer
149,JointPQPlayer,265,265,530,51,7,Tie
150,JointPQPlayer,236,236,472,44,24,Tie
151,JointPQPlayer,252,247,499,38,13,Player A
152,JointPQPlayer,166,166,332,6,58,Tie
153,JointPQPlayer,257,257,514,47,11,Tie
154,JointPQPlayer,253,253,506,48,14,Tie
155,JointPQPlayer,241,241,482,39,19,Tie
156,JointPQPlayer,270,270,540,52,4,Tie
157,JointPQPlayer,243,243,486,40,18,Tie
158,JointPQPlayer,256,256,512,51,13,Tie
159,JointPQPlayer,261,261,522,52,10,Tie
160,JointPQPlayer,260,260,520,47,9,Tie
161,JointPQPlayer,211,216,427,23,32,JointPQPlayer
162,JointPQPlayer,256,256,512,57,15,Tie
163,JointPQPlayer,269,269,538,62,8,Tie
164,JointPQPlayer,221,216,437,27,30,Player A
165,JointPQPlayer,264,264,528,49,7,Tie
166,JointPQPlayer,236,236,472,47,25,Tie
167,JointPQPlayer,256,261,517,50,11,JointPQPlayer
168,JointPQPlayer,252,247,499,38,13,Player A
169,JointPQPlayer,254,254,508,38,10,Tie
170,JointPQPlayer,252,252,504,52,16,Tie
171,JointPQPlayer,250,250,500,42,14,Tie
172,JointPQPlayer,249,249,498,40,14,Tie
173,JointPQPlayer,262,262,524,54,10,Tie
174,JointPQPlayer,244,249,493,44,17,JointPQPlayer
175,JointPQPlayer,259,259,518,51,11,Tie
176,JointPQPlayer,237,237,474,40,22,Tie
177,JointPQPlayer,174,174,348,13,55,Tie
178,JointPQPlayer,263,258,521,48,9,Player A
179,JointPQPlayer,254,254,508,41,11,Tie
180,JointPQPlayer,246,246,492,34,14,Tie
181,JointPQPlayer,157,162,319,8,63,JointPQPlayer
182,JointPQPlayer,255,250,505,41,12,Player A
183,JointPQPlayer,266,266,532,53,7,Tie
184,JointPQPlayer,170,175,345,7,54,JointPQPlayer
185,JointPQPlayer,250,245,495,43,16,Player A
186,JointPQPlayer,260,260,520,47,9,Tie
187,JointPQPlayer,177,182,359,9,50,JointPQPlayer
188,JointPQPlayer,270,265,535,53,6,Player A
189,JointPQPlayer,249,249,498,49,17,Tie
190,JointPQPlayer,232,232,464,42,26,Tie
191,JointPQPlayer,270,275,545,60,5,JointPQPlayer
192,JointPQPlayer,267,262,529,53,8,Player A
193,JointPQPlayer,174,174,348,10,54,Tie
194,JointPQPlayer,243,243,486,49,21,Tie
195,JointPQPlayer,253,253,506,42,12,Tie
196,JointPQPlayer,240,240,480,49,23,Tie
197,JointPQPlayer,265,265,530,60,10,Tie
198,JointPQPlayer,192,192,384,22,46,Tie
199,JointPQPlayer,260,260,520,50,10,Tie
200,JointPQPlayer,266,266,532,47,5,Tie
201,JointPQPlayer,259,259,518,42,8,Tie
202,JointPQPlayer,229,229,458,39,27,Tie
203,JointPQPlayer,246,246,492,37,15,Tie
204,JointPQPlayer,264,264,528,46,6,Tie
205,JointPQPlayer,254,259,513,49,12,JointPQPlayer
206,JointPQPlayer,264,259,523,47,8,Player A
207,JointPQPlayer,256,256,512,48,12,Tie
208,JointPQPlayer,262,262,524,45,7,Tie
209,JointPQPlayer,224,224,448,29,27,Tie
210,JointPQPlayer,260,260,520,41,7,Tie
211,JointPQPlayer,267,267,534,55,7,Tie
212,JointPQPlayer,228,228,456,37,27,Tie
213,JointPQPlayer,251,256,507,43,12,JointPQPlayer
214,JointPQPlayer,179,179,358,8,50,Tie
215,JointPQPlayer,257,252,509,57,16,Player A
216,JointPQPlayer,232,232,464,30,22,Tie
217,JointPQPlayer,270,270,540,49,3,Tie
218,JointPQPlayer,255,255,510,40,10,Tie
219,JointPQPlayer,263,263,526,59,11,Tie
220,JointPQPlayer,261,261,522,52,10,Tie
221,JointPQPlayer,268,268,536,63,9,Tie
222,JointPQPlayer,268,268,536,54,6,Tie
223,JointPQPlayer,252,257,509,45,12,JointPQPlayer
224,JointPQPlayer,173,173,346,5,53,Tie
225,JointPQPlayer,205,200,405,28,41,Player A
226,JointPQPlayer,261,261,522,52,10,Tie
227,JointPQPlayer,227,227,454,35,27,Tie
228,JointPQPlayer,251,256,507,43,12,JointPQPlayer
229,JointPQPlayer,250,250,500,45,15,Tie
230,JointPQPlayer,255,255,510,46,12,Tie
231,JointPQPlayer,259,254,513,55,14,Player A
232,JointPQPlayer,266,266,532,53,7,Tie
233,JointPQPlayer,257,257,514,47,11,Tie
234,JointPQPlayer,245,245,490,44,18,Tie
235,JointPQPlayer,228,228,456,34,26,Tie
236,JointPQPlayer,253,253,506,48,14,Tie
237,JointPQPlayer,165,170,335,6,57,JointPQPlayer
238,JointPQPlayer,254,249,503,36,11,Player A
239,JointPQPlayer,257,257,514,44,10,Tie
240,JointPQPlayer,265,265,530,51,7,Tie
241,JointPQPlayer,261,261,522,52,10,Tie
242,JointPQPlayer,171,171,342,4,54,Tie
243,JointPQPlayer,258,263,521,45,8,JointPQPlayer
244,JointPQPlayer,245,240,485,39,18,Player A
245,JointPQPlayer,258,258,516,40,8,Tie
246,JointPQPlayer,159,164,323,3,60,JointPQPlayer
247,JointPQPlayer,272,267,539,54,5,Player A
248,JointPQPlayer,266,266,532,50,6,Tie
249,JointPQPlayer,252,252,504,40,12,Tie
250,JointPQPlayer,228,233,461,33,24,JointPQPlayer
251,JointPQPlayer,240,235,475,41,22,Player A
252,JointPQPlayer,246,251,497,45,16,JointPQPlayer
253,JointPQPlayer,271,266,537,55,6,Player A
254,JointPQPlayer,216,216,432,28,32,Tie
255,JointPQPlayer,255,255,510,37,9,Tie
256,JointPQPlayer,233,233,466,35,23,Tie
257,JointPQPlayer,173,178,351,13,54,JointPQPlayer
258,JointPQPlayer,259,259,518,48,10,Tie
259,JointPQPlayer,273,268,541,53,4,Player A
260,JointPQPlayer,269,269,538,56,6,Tie
261,JointPQPlayer,239,244,483,37,18,JointPQPlayer
262,JointPQPlayer,239,234,473,39,22,Player A
263,JointPQPlayer,265,265,530,51,7,Tie
264,JointPQPlayer,258,263,521,48,9,JointPQPlayer
265,JointPQPlayer,256,251,507,37,10,Player A
266,JointPQPlayer,266,271,537,58,7,JointPQPlayer
267,JointPQPlayer,258,258,516,49,11,Tie
268,JointPQPlayer,268,263,531,52,7,Player A
269,JointPQPlayer,258,258,516,52,12,Tie
270,JointPQPlayer,234,234,468,31,21,Tie
271,JointPQPlayer,272,272,544,56,4,Tie
272,JointPQPlayer,168,173,341,12,57,JointPQPlayer
273,JointPQPlayer,249,249,498,40,14,Tie
274,JointPQPlayer,261,256,517,47,10,Player A
275,JointPQPlayer,194,199,393,7,38,JointPQPlayer
276,JointPQPlayer,265,265,530,54,8,Tie
277,JointPQPlayer,240,235,475,38,21,Player A
278,JointPQPlayer,274,274,548,60,4,Tie
279,JointPQPlayer,170,175,345,10,55,JointPQPlayer
280,JointPQPlayer,270,265,535,47,4,Player A
281,JointPQPlayer,163,168,331,5,58,JointPQPlayer
282,JointPQPlayer,272,267,539,57,6,Player A
283,JointPQPlayer,275,275,550,62,4,Tie
284,JointPQPlayer,174,179,353,9,52,JointPQPlayer
285,JointPQPlayer,259,254,513,55,14,Player A
286,JointPQPlayer,249,249,498,43,15,Tie
287,JointPQPlayer,191,191,382,14,44,Tie
288,JointPQPlayer,175,175,350,6,52,Tie
289,JointPQPlayer,196,201,397,17,40,JointPQPlayer
290,JointPQPlayer,251,246,497,45,16,Player A
291,JointPQPlayer,272,277,549,58,3,JointPQPlayer
292,JointPQPlayer,256,251,507,46,13,Player A
293,JointPQPlayer,238,238,476,30,18,Tie
294,JointPQPlayer,195,195,390,10,40,Tie
295,JointPQPlayer,236,236,472,38,22,Tie
296,JointPQPlayer,194,199,393,13,40,JointPQPlayer
297,JointPQPlayer,182,182,364,5,47,Tie
298,JointPQPlayer,240,240,480,34,18,Tie
299,JointPQPlayer,255,250,505,47,14,Player A
300,JointPQPlayer,256,261,517,53,12,JointPQPlayer
301,JointPQPlayer,253,248,501,49,16,Player A
302,JointPQPlayer,259,264,523,44,7,JointPQPlayer
303,JointPQPlayer,188,183,371,12,47,Player A
304,JointPQPlayer,272,272,544,62,6,Tie
305,JointPQPlayer,259,259,518,54,12,Tie
306,JointPQPlayer,262,262,524,51,9,Tie
307,JointPQPlayer,271,271,542,57,5,Tie
308,JointPQPlayer,270,270,540,55,5,Tie
309,JointPQPlayer,166,171,337,5,56,JointPQPlayer
310,JointPQPlayer,257,257,514,38,8,Tie
311,JointPQPlayer,185,185,370,11,47,Tie
312,JointPQPlayer,259,254,513,43,10,Player A
313,JointPQPlayer,261,261,522,46,8,Tie
314,JointPQPlayer,229,229,458,36,26,Tie
315,JointPQPlayer,257,257,514,41,9,Tie
316,JointPQPlayer,273,273,546,61,5,Tie
317,JointPQPlayer,254,259,513,46,11,JointPQPlayer
318,JointPQPlayer,231,231,462,37,25,Tie
319,JointPQPlayer,241,241,482,42,20,Tie
320,JointPQPlayer,268,263,531,49,6,Player A
321,JointPQPlayer,191,196,387,22,45,JointPQPlayer
322,JointPQPlayer,251,251,502,41,13,Tie
323,JointPQPlayer,160,160,320,6,62,Tie
324,JointPQPlayer,194,194,388,17,43,Tie
325,JointPQPlayer,239,239,478,35,19,Tie
326,JointPQPlayer,274,269,543,58,5,Player A
327,JointPQPlayer,208,208,416,30,38,Tie
328,JointPQPlayer,269,269,538,53,5,Tie
329,JointPQPlayer,264,264,528,52,8,Tie
330,JointPQPlayer,179,184,363,7,48,JointPQPlayer
331,JointPQPlayer,264,259,523,50,9,Player A
332,JointPQPlayer,251,251,502,47,15,Tie
333,JointPQPlayer,155,160,315,4,63,JointPQPlayer
334,JointPQPlayer,223,218,441,28,29,Player A
335,JointPQPlayer,273,273,546,55,3,Tie
336,JointPQPlayer,258,263,521,48,9,JointPQPlayer
337,JointPQPlayer,180,175,355,5,50,Player A
338,JointPQPlayer,256,261,517,44,9,JointPQPlayer
339,JointPQPlayer,188,188,376,14,46,Tie
340,JointPQPlayer,253,248,501,40,13,Player A
341,JointPQPlayer,185,190,375,10,45,JointPQPlayer
342,JointPQPlayer,228,223,451,38,29,Player A
343,JointPQPlayer,265,265,530,48,6,Tie
344,JointPQPlayer,197,197,394,20,42,Tie
345,JointPQPlayer,186,186,372,13,47,Tie
346,JointPQPlayer,266,271,537,58,7,JointPQPlayer
347,JointPQPlayer,254,249,503,45,14,Player A
348,JointPQPlayer,169,174,343,11,56,JointPQPlayer
349,JointPQPlayer,236,231,467,33,22,Player A
350,JointPQPlayer,260,260,520,50,10,Tie
351,JointPQPlayer,183,188,371,9,46,JointPQPlayer
352,JointPQPlayer,254,254,508,47,13,Tie
353,JointPQPlayer,227,222,449,33,28,Player A
354,JointPQPlayer,165,165,330,4,58,Tie
355,JointPQPlayer,246,246,492,34,14,Tie
356,JointPQPlayer,257,257,514,44,10,Tie
357,JointPQPlayer,260,265,525,49,8,JointPQPlayer
358,JointPQPlayer,261,256,517,47,10,Player A
359,JointPQPlayer,265,265,530,54,8,Tie
360,JointPQPlayer,229,229,458,39,27,Tie
361,JointPQPlayer,250,250,500,39,13,Tie
362,JointPQPlayer,252,257,509,48,13,JointPQPlayer
363,JointPQPlayer,263,258,521,48,9,Player A
364,JointPQPlayer,233,233,466,32,22,Tie
365,JointPQPlayer,266,266,532,56,8,Tie
366,JointPQPlayer,249,254,503,48,15,JointPQPlayer
367,JointPQPlayer,260,260,520,41,7,Tie
368,JointPQPlayer,257,252,509,48,13,Player A
369,JointPQPlayer,218,218,436,26,30,Tie
370,JointPQPlayer,240,240,480,34,18,Tie
371,JointPQPlayer,169,174,343,5,54,JointPQPlayer
372,JointPQPlayer,258,253,511,41,10,Player A
373,JointPQPlayer,255,255,510,43,11,Tie
374,JointPQPlayer,263,263,526,47,7,Tie
375,JointPQPlayer,239,239,478,41,21,Tie
376,JointPQPlayer,266,266,532,47,5,Tie
377,JointPQPlayer,249,249,498,46,16,Tie
378,JointPQPlayer,243,243,486,46,20,Tie
379,JointPQPlayer,270,270,540,61,7,Tie
380,JointPQPlayer,189,189,378,16,46,Tie
381,JointPQPlayer,257,257,514,50,12,Tie
382,JointPQPlayer,179,179,358,11,51,Tie
383,JointPQPlayer,272,272,544,59,5,Tie
384,JointPQPlayer,259,259,518,48,10,Tie
385,JointPQPlayer,248,248,496,38,14,Tie
386,JointPQPlayer,261,261,522,49,9,Tie
387,JointPQPlayer,190,195,385,11,42,JointPQPlayer
388,JointPQPlayer,250,245,495,37,14,Player A
389,JointPQPlayer,239,239,478,38,20,Tie
390,JointPQPlayer,235,240,475,38,21,JointPQPlayer
391,JointPQPlayer,267,262,529,50,7,Player A
392,JointPQPlayer,251,256,507,40,11,JointPQPlayer
393,JointPQPlayer,249,244,493,38,15,Player A
394,JointPQPlayer,230,230,460,35,25,Tie
395,JointPQPlayer,192,197,389,18,43,JointPQPlayer
396,JointPQPlayer,238,233,471,37,22,Player A
397,JointPQPlayer,217,217,434,30,32,Tie
398,JointPQPlayer,266,266,532,47,5,Tie
399,JointPQPlayer,265,265,530,54,8,Tie
400,JointPQPlayer,255,260,515,42,9,JointPQPlayer
401,JointPQPlayer,267,262,529,53,8,Player A
402,JointPQPlayer,198,198,396,16,40,Tie
403,JointPQPlayer,186,191,377,12,45,JointPQPlayer
404,JointPQPlayer,163,158,321,7,62,Player A
405,JointPQPlayer,249,254,503,45,14,JointPQPlayer
406,JointPQPlayer,245,240,485,36,17,Player A
407,JointPQPlayer,265,270,535,50,5,JointPQPlayer
408,JointPQPlayer,264,259,523,50,9,Player A
409,JointPQPlayer,243,248,491,39,16,JointPQPlayer
410,JointPQPlayer,224,219,443,36,31,Player A
411,JointPQPlayer,263,263,526,47,7,Tie
412,JointPQPlayer,167,172,339,7,56,JointPQPlayer
413,JointPQPlayer,202,197,399,16,39,Player A
414,JointPQPlayer,264,264,528,49,7,Tie
415,JointPQPlayer,196,196,392,15,41,Tie
416,JointPQPlayer,259,259,518,42,8,Tie
417,JointPQPlayer,258,258,516,52,12,Tie
418,JointPQPlayer,266,266,532,56,8,Tie
419,JointPQPlayer,230,230,460,35,25,Tie
420,JointPQPlayer,185,185,370,11,47,Tie
421,JointPQPlayer,240,245,485,39,18,JointPQPlayer
422,JointPQPlayer,186,181,367,5,46,Player A
423,JointPQPlayer,260,260,520,50,10,Tie
424,JointPQPlayer,256,256,512,45,11,Tie
425,JointPQPlayer,252,257,509,42,11,JointPQPlayer
426,JointPQPlayer,245,240,485,39,18,Player A
427,JointPQPlayer,242,242,484,38,18,Tie
428,JointPQPlayer,267,267,534,55,7,Tie
429,JointPQPlayer,259,259,518,48,10,Tie
430,JointPQPlayer,254,254,508,44,12,Tie
431,JointPQPlayer,172,177,349,5,52,JointPQPlayer
432,JointPQPlayer,210,205,415,20,35,Player A
433,JointPQPlayer,180,185,365,9,48,JointPQPlayer
434,JointPQPlayer,258,258,516,46,10,Tie
435,JointPQPlayer,220,220,440,36,32,Tie
436,JointPQPlayer,243,238,481,38,19,Player A
437,JointPQPlayer,212,217,429,28,33,JointPQPlayer
438,JointPQPlayer,257,252,509,48,13,Player A
439,JointPQPlayer,266,266,532,53,7,Tie
440,JointPQPlayer,237,237,474,34,20,Tie
441,JointPQPlayer,213,213,426,34,36,Tie
442,JointPQPlayer,250,250,500,42,14,Tie
443,JointPQPlayer,256,256,512,45,11,Tie
444,JointPQPlayer,255,260,515,51,12,JointPQPlayer
445,JointPQPlayer,261,256,517,53,12,Player A
446,JointPQPlayer,159,164,323,3,60,JointPQPlayer
447,JointPQPlayer,269,264,533,54,7,Player A
448,JointPQPlayer,266,266,532,59,9,Tie
449,JointPQPlayer,259,264,523,47,8,JointPQPlayer
450,JointPQPlayer,246,241,487,41,18,Player A
451,JointPQPlayer,243,243,486,40,18,Tie
452,JointPQPlayer,261,261,522,49,9,Tie
453,JointPQPlayer,218,218,436,29,31,Tie
454,JointPQPlayer,241,241,482,36,18,Tie
455,JointPQPlayer,259,264,523,44,7,JointPQPlayer
456,JointPQPlayer,257,252,509,45,12,Player A
457,JointPQPlayer,254,254,508,44,12,Tie
458,JointPQPlayer,255,260,515,48,11,JointPQPlayer
459,JointPQPlayer,173,173,346,5,53,Tie
460,JointPQPlayer,239,239,478,35,19,Tie
461,JointPQPlayer,248,243,491,36,15,Player A
462,JointPQPlayer,260,260,520,56,12,Tie
463,JointPQPlayer,161,166,327,7,60,JointPQPlayer
464,JointPQPlayer,268,263,531,49,6,Player A
465,JointPQPlayer,261,261,522,52,10,Tie
466,JointPQPlayer,238,243,481,41,20,JointPQPlayer
467,JointPQPlayer,260,255,515,45,10,Player A
468,JointPQPlayer,172,177,349,2,51,JointPQPlayer
469,JointPQPlayer,176,171,347,9,54,Player A
470,JointPQPlayer,220,220,440,36,32,Tie
471,JointPQPlayer,243,243,486,43,19,Tie
472,JointPQPlayer,243,248,491,42,17,JointPQPlayer
473,JointPQPlayer,258,253,511,41,10,Player A
474,JointPQPlayer,261,266,527,48,7,JointPQPlayer
475,JointPQPlayer,184,184,368,12,48,Tie
476,JointPQPlayer,199,194,393,10,39,Player A
477,JointPQPlayer,267,272,539,51,4,JointPQPlayer
478,JointPQPlayer,247,247,494,45,17,Tie
479,JointPQPlayer,265,260,525,49,8,Player A
480,JointPQPlayer,267,267,534,52,6,Tie
481,JointPQPlayer,227,227,454,32,26,Tie
482,JointPQPlayer,245,245,490,38,16,Tie
483,JointPQPlayer,255,255,510,46,12,Tie
484,JointPQPlayer,256,256,512,42,10,Tie
485,JointPQPlayer,241,241,482,36,18,Tie
486,JointPQPlayer,188,193,381,7,42,JointPQPlayer
487,JointPQPlayer,249,249,498,37,13,Tie
488,JointPQPlayer,267,262,529,53,8,Player A
489,JointPQPlayer,246,246,492,43,17,Tie
490,JointPQPlayer,260,265,525,49,8,JointPQPlayer
491,JointPQPlayer,269,264,533,51,6,Player A
492,JointPQPlayer,272,272,544,53,3,Tie
493,JointPQPlayer,254,254,508,41,11,Tie
494,JointPQPlayer,243,243,486,43,19,Tie
495,JointPQPlayer,266,266,532,53,7,Tie
496,JointPQPlayer,261,261,522,52,10,Tie
497,JointPQPlayer,243,248,491,36,15,JointPQPlayer
498,JointPQPlayer,181,176,357,22,55,Player A
499,JointPQPlayer,169,174,343,11,56,JointPQPlayer
500,JointPQPlayer,250,250,500,39,13,Tie
501,JointPQPlayer,167,167,334,5,57,Tie
502,JointPQPlayer,267,262,529,59,10,Player A
503,JointPQPlayer,240,240,480,37,19,Tie
504,JointPQPlayer,253,253,506,42,12,Tie
505,JointPQPlayer,271,271,542,63,7,Tie
506,JointPQPlayer,230,230,460,32,24,Tie
507,JointPQPlayer,233,233,466,32,22,Tie
508,JointPQPlayer,189,189,378,7,43,Tie
509,JointPQPlayer,260,265,525,49,8,JointPQPlayer
510,JointPQPlayer,223,223,446,33,29,Tie
511,JointPQPlayer,224,219,443,27,28,Player A
512,JointPQPlayer,247,247,494,42,16,Tie
513,JointPQPlayer,261,261,522,58,12,Tie
514,JointPQPlayer,248,253,501,46,15,JointPQPlayer
515,JointPQPlayer,172,172,344,6,54,Tie
516,JointPQPlayer,244,239,483,40,19,Player A
517,JointPQPlayer,222,222,444,40,32,Tie
518,JointPQPlayer,260,260,520,41,7,Tie
519,JointPQPlayer,279,279,558,64,2,Tie
520,JointPQPlayer,258,258,516,49,11,Tie
521,JointPQPlayer,267,267,534,58,8,Tie
522,JointPQPlayer,227,227,454,38,28,Tie
523,JointPQPlayer,255,255,510,52,14,Tie
524,JointPQPlayer,262,262,524,51,9,Tie
525,JointPQPlayer,268,273,541,53,4,JointPQPlayer
526,JointPQPlayer,251,246,497,45,16,Player A
527,JointPQPlayer,216,216,432,28,32,Tie
528,JointPQPlayer,263,263,526,50,8,Tie
529,JointPQPlayer,238,238,476,33,19,Tie
530,JointPQPlayer,263,263,526,50,8,Tie
531,JointPQPlayer,273,273,546,58,4,Tie
532,JointPQPlayer,265,265,530,51,7,Tie
533,JointPQPlayer,247,252,499,47,16,JointPQPlayer
534,JointPQPlayer,248,243,491,39,16,Player A
535,JointPQPlayer,256,256,512,39,9,Tie
536,JointPQPlayer,248,248,496,44,16,Tie
537,JointPQPlayer,244,249,493,47,18,JointPQPlayer
538,JointPQPlayer,254,249,503,60,19,Player A
539,JointPQPlayer,152,157,309,7,66,JointPQPlayer
540,JointPQPlayer,231,226,457,44,29,Player A
541,JointPQPlayer,194,194,388,11,41,Tie
542,JointPQPlayer,258,263,521,48,9,JointPQPlayer
543,JointPQPlayer,259,254,513,49,12,Player A
544,JointPQPlayer,219,224,443,27,28,JointPQPlayer
545,JointPQPlayer,248,248,496,41,15,Tie
546,JointPQPlayer,268,263,531,58,9,Player A
547,JointPQPlayer,239,239,478,41,21,Tie
548,JointPQPlayer,186,186,372,10,46,Tie
549,JointPQPlayer,244,249,493,44,17,JointPQPlayer
550,JointPQPlayer,239,239,478,35,19,Tie
551,JointPQPlayer,184,179,363,13,50,Player A
552,JointPQPlayer,236,241,477,37,20,JointPQPlayer
553,JointPQPlayer,241,241,482,42,20,Tie
554,JointPQPlayer,239,234,473,39,22,Player A
555,JointPQPlayer,267,267,534,58,8,Tie
556,JointPQPlayer,169,169,338,6,56,Tie
557,JointPQPlayer,200,200,400,14,38,Tie
558,JointPQPlayer,254,259,513,40,9,JointPQPlayer
559,JointPQPlayer,248,243,491,48,19,Player A
560,JointPQPlayer,254,254,508,47,13,Tie
561,JointPQPlayer,195,195,390,13,41,Tie
562,JointPQPlayer,235,235,470,36,22,Tie
563,JointPQPlayer,267,272,539,57,6,JointPQPlayer
564,JointPQPlayer,268,263,531,55,8,Player A
565,JointPQPlayer,187,187,374,15,47,Tie
566,JointPQPlayer,262,262,524,48,8,Tie
567,JointPQPlayer,262,267,529,47,6,JointPQPlayer
568,JointPQPlayer,183,183,366,10,48,Tie
569,JointPQPlayer,207,207,414,22,36,Tie
570,JointPQPlayer,210,210,420,34,38,Tie
571,JointPQPlayer,249,244,493,35,14,Player A
572,JointPQPlayer,235,240,475,38,21,JointPQPlayer
573,JointPQPlayer,271,266,537,52,5,Player A
574,JointPQPlayer,213,213,426,22,32,Tie
575,JointPQPlayer,265,265,530,57,9,Tie
576,JointPQPlayer,248,248,496,38,14,Tie
577,JointPQPlayer,251,251,502,38,12,Tie
578,JointPQPlayer,237,242,479,39,20,JointPQPlayer
579,JointPQPlayer,263,258,521,48,9,Player A
580,JointPQPlayer,232,232,464,33,23,Tie
581,JointPQPlayer,256,256,512,42,10,Tie
582,JointPQPlayer,225,230,455,33,26,JointPQPlayer
583,JointPQPlayer,222,217,439,32,31,Player A
584,JointPQPlayer,258,258,516,49,11,Tie
585,JointPQPlayer,271,271,542,57,5,Tie
586,JointPQPlayer,264,264,528,49,7,Tie
587,JointPQPlayer,246,251,497,48,17,JointPQPlayer
588,JointPQPlayer,172,172,344,3,53,Tie
589,JointPQPlayer,266,266,532,56,8,Tie
590,JointPQPlayer,173,168,341,3,54,Player A
591,JointPQPlayer,205,205,410,18,36,Tie
592,JointPQPlayer,196,201,397,11,38,JointPQPlayer
593,JointPQPlayer,269,264,533,48,5,Player A
594,JointPQPlayer,263,263,526,47,7,Tie
595,JointPQPlayer,255,255,510,46,12,Tie
596,JointPQPlayer,242,247,489,49,20,JointPQPlayer
597,JointPQPlayer,237,232,469,38,23,Player A
598,JointPQPlayer,244,244,488,42,18,Tie
599,JointPQPlayer,260,260,520,53,11,Tie
600,JointPQPlayer,268,268,536,51,5,Tie
601,JointPQPlayer,256,256,512,45,11,Tie
602,JointPQPlayer,256,256,512,45,11,Tie
603,JointPQPlayer,265,265,530,51,7,Tie
604,JointPQPlayer,255,255,510,40,10,Tie
605,JointPQPlayer,246,251,497,39,14,JointPQPlayer
606,JointPQPlayer,246,246,492,40,16,Tie
607,JointPQPlayer,243,238,481,38,19,Player A
608,JointPQPlayer,245,245,490,38,16,Tie
609,JointPQPlayer,190,195,385,20,45,JointPQPlayer
610,JointPQPlayer,279,274,553,65,4,Player A
611,JointPQPlayer,266,271,537,52,5,JointPQPlayer
612,JointPQPlayer,219,219,438,34,32,Tie
613,JointPQPlayer,260,255,515,54,13,Player A
614,JointPQPlayer,256,261,517,50,11,JointPQPlayer
615,JointPQPlayer,258,253,511,53,14,Player A
616,JointPQPlayer,209,214,423,22,33,JointPQPlayer
617,JointPQPlayer,254,249,503,42,13,Player A
618,JointPQPlayer,276,276,552,61,3,Tie
619,JointPQPlayer,186,186,372,13,47,Tie
620,JointPQPlayer,275,275,550,65,5,Tie
621,JointPQPlayer,267,267,534,52,6,Tie
622,JointPQPlayer,236,236,472,38,22,Tie
623,JointPQPlayer,270,270,540,58,6,Tie
624,JointPQPlayer,263,263,526,41,5,Tie
625,JointPQPlayer,242,242,484,38,18,Tie
626,JointPQPlayer,182,187,369,7,46,JointPQPlayer
627,JointPQPlayer,239,239,478,38,20,Tie
628,JointPQPlayer,268,263,531,55,8,Player A
629,JointPQPlayer,216,216,432,28,32,Tie
630,JointPQPlayer,174,179,353,6,51,JointPQPlayer
631,JointPQPlayer,187,187,374,12,46,Tie
632,JointPQPlayer,262,257,519,58,13,Player A
633,JointPQPlayer,239,239,478,41,21,Tie
634,JointPQPlayer,253,258,511,50,13,JointPQPlayer
635,JointPQPlayer,258,253,511,50,13,Player A
636,JointPQPlayer,259,264,523,50,9,JointPQPlayer
637,JointPQPlayer,266,261,527,54,9,Player A
638,JointPQPlayer,269,269,538,56,6,Tie
639,JointPQPlayer,259,259,518,51,11,Tie
640,JointPQPlayer,258,258,516,46,10,Tie
641,JointPQPlayer,259,259,518,48,10,Tie
642,JointPQPlayer,261,266,527,48,7,JointPQPlayer
643,JointPQPlayer,178,178,356,6,50,Tie
644,JointPQPlayer,262,257,519,43,8,Player A
645,JointPQPlayer,248,248,496,41,15,Tie
646,JointPQPlayer,259,264,523,50,9,JointPQPlayer
647,JointPQPlayer,267,267,534,58,8,Tie
648,JointPQPlayer,221,216,437,27,30,Player A
649,JointPQPlayer,212,212,424,29,35,Tie
650,JointPQPlayer,246,246,492,49,19,Tie
651,JointPQPlayer,180,185,365,12,49,JointPQPlayer
652,JointPQPlayer,172,167,339,10,57,Player A
653,JointPQPlayer,231,236,467,36,23,JointPQPlayer
654,JointPQPlayer,215,215,430,26,32,Tie
655,JointPQPlayer,250,245,495,43,16,Player A
656,JointPQPlayer,209,209,418,29,37,Tie
657,JointPQPlayer,263,268,531,52,7,JointPQPlayer
658,JointPQPlayer,171,166,337,5,56,Player A
659,JointPQPlayer,257,257,514,47,11,Tie
660,JointPQPlayer,256,261,517,47,10,JointPQPlayer
661,JointPQPlayer,220,220,440,24,28,Tie
662,JointPQPlayer,187,187,374,18,48,Tie
663,JointPQPlayer,260,260,520,50,10,Tie
664,JointPQPlayer,228,228,456,31,25,Tie
665,JointPQPlayer,277,272,549,61,4,Player A
666,JointPQPlayer,228,228,456,43,29,Tie
667,JointPQPlayer,168,173,341,9,56,JointPQPlayer
668,JointPQPlayer,170,170,340,8,56,Tie
669,JointPQPlayer,260,255,515,54,13,Player A
670,JointPQPlayer,177,177,354,10,52,Tie
671,JointPQPlayer,198,198,396,22,42,Tie
672,JointPQPlayer,253,253,506,45,13,Tie
673,JointPQPlayer,174,179,353,6,51,JointPQPlayer
674,JointPQPlayer,264,259,523,50,9,Player A
675,JointPQPlayer,179,184,363,10,49,JointPQPlayer
676,JointPQPlayer,266,261,527,48,7,Player A
677,JointPQPlayer,252,257,509,48,13,JointPQPlayer
678,JointPQPlayer,177,177,354,10,52,Tie
679,JointPQPlayer,271,266,537,55,6,Player A
680,JointPQPlayer,252,252,504,43,13,Tie
681,JointPQPlayer,267,267,534,55,7,Tie
682,JointPQPlayer,166,171,337,8,57,JointPQPlayer
683,JointPQPlayer,249,244,493,41,16,Player A
684,JointPQPlayer,244,244,488,42,18,Tie
685,JointPQPlayer,230,230,460,35,25,Tie
686,JointPQPlayer,191,196,387,13,42,JointPQPlayer
687,JointPQPlayer,203,203,406,17,37,Tie
688,JointPQPlayer,196,196,392,9,39,Tie
689,JointPQPlayer,181,181,362,9,49,Tie
690,JointPQPlayer,238,238,476,45,23,Tie
691,JointPQPlayer,240,240,480,46,22,Tie
692,JointPQPlayer,203,198,401,21,40,Player A
693,JointPQPlayer,240,240,480,40,20,Tie
694,JointPQPlayer,260,260,520,53,11,Tie
695,JointPQPlayer,254,259,513,49,12,JointPQPlayer
696,JointPQPlayer,228,228,456,31,25,Tie
697,JointPQPlayer,256,251,507,46,13,Player A
698,JointPQPlayer,264,264,528,55,9,Tie
699,JointPQPlayer,251,251,502,47,15,Tie
700,JointPQPlayer,240,245,485,45,20,JointPQPlayer
701,JointPQPlayer,261,256,517,59,14,Player A
702,JointPQPlayer,227,227,454,38,28,Tie
703,JointPQPlayer,245,250,495,40,15,JointPQPlayer
704,JointPQPlayer,248,243,491,42,17,Player A
705,JointPQPlayer,252,252,504,49,15,Tie
706,JointPQPlayer,258,263,521,54,11,JointPQPlayer
707,JointPQPlayer,266,261,527,54,9,Player A
708,JointPQPlayer,261,266,527,51,8,JointPQPlayer
709,JointPQPlayer,240,235,475,38,21,Player A
710,JointPQPlayer,268,268,536,57,7,Tie
711,JointPQPlayer,258,258,516,49,11,Tie
712,JointPQPlayer,239,244,483,37,18,JointPQPlayer
713,JointPQPlayer,270,265,535,47,4,Player A
714,JointPQPlayer,266,266,532,56,8,Tie
715,JointPQPlayer,248,253,501,46,15,JointPQPlayer
716,JointPQPlayer,269,264,533,54,7,Player A
717,JointPQPlayer,149,154,303,4,67,JointPQPlayer
718,JointPQPlayer,245,245,490,35,15,Tie
719,JointPQPlayer,271,271,542,57,5,Tie
720,JointPQPlayer,257,252,509,48,13,Player A
721,JointPQPlayer,252,252,504,43,13,Tie
722,JointPQPlayer,258,258,516,46,10,Tie
723,JointPQPlayer,240,240,480,40,20,Tie
724,JointPQPlayer,267,267,534,58,8,Tie
725,JointPQPlayer,257,262,519,46,9,JointPQPlayer
726,JointPQPlayer,237,237,474,40,22,Tie
727,JointPQPlayer,252,247,499,41,14,Player A
728,JointPQPlayer,220,220,440,36,32,Tie
729,JointPQPlayer,251,251,502,41,13,Tie
730,JointPQPlayer,242,242,484,41,19,Tie
731,JointPQPlayer,217,222,439,32,31,JointPQPlayer
732,JointPQPlayer,163,163,326,9,61,Tie
733,JointPQPlayer,163,163,326,3,59,Tie
734,JointPQPlayer,185,180,365,9,48,Player A
735,JointPQPlayer,237,237,474,43,23,Tie
736,JointPQPlayer,181,186,367,8,47,JointPQPlayer
737,JointPQPlayer,208,208,416,24,36,Tie
738,JointPQPlayer,279,274,553,62,3,Player A
739,JointPQPlayer,255,255,510,43,11,Tie
740,JointPQPlayer,239,239,478,32,18,Tie
741,JointPQPlayer,267,272,539,57,6,JointPQPlayer
742,JointPQPlayer,260,255,515,36,7,Player A
743,JointPQPlayer,253,253,506,45,13,Tie
744,JointPQPlayer,236,241,477,34,19,JointPQPlayer
745,JointPQPlayer,260,255,515,45,10,Player A
746,JointPQPlayer,257,257,514,50,12,Tie
747,JointPQPlayer,252,252,504,46,14,Tie
748,JointPQPlayer,261,261,522,52,10,Tie
749,JointPQPlayer,269,269,538,59,7,Tie
750,JointPQPlayer,229,229,458,45,29,Tie
751,JointPQPlayer,171,176,347,12,55,JointPQPlayer
752,JointPQPlayer,255,250,505,41,12,Player A
753,JointPQPlayer,259,259,518,54,12,Tie
754,JointPQPlayer,251,256,507,52,15,JointPQPlayer
755,JointPQPlayer,177,177,354,13,53,Tie
756,JointPQPlayer,246,241,487,38,17,Player A
757,JointPQPlayer,250,255,505,41,12,JointPQPlayer
758,JointPQPlayer,214,209,423,28,35,Player A
759,JointPQPlayer,264,269,533,51,6,JointPQPlayer
760,JointPQPlayer,244,239,483,43,20,Player A
761,JointPQPlayer,223,223,446,36,30,Tie
762,JointPQPlayer,246,251,497,42,15,JointPQPlayer
763,JointPQPlayer,215,210,425,30,35,Player A
764,JointPQPlayer,181,186,367,11,48,JointPQPlayer
765,JointPQPlayer,166,166,332,6,58,Tie
766,JointPQPlayer,268,263,531,55,8,Player A
767,JointPQPlayer,250,250,500,39,13,Tie
768,JointPQPlayer,268,268,536,48,4,Tie
769,JointPQPlayer,240,245,485,33,16,JointPQPlayer
770,JointPQPlayer,224,224,448,32,28,Tie
771,JointPQPlayer,253,248,501,40,13,Player A
772,JointPQPlayer,266,266,532,56,8,Tie
773,JointPQPlayer,225,225,450,28,26,Tie
774,JointPQPlayer,186,191,377,9,44,JointPQPlayer
775,JointPQPlayer,271,266,537,58,7,Player A
776,JointPQPlayer,251,251,502,47,15,Tie
777,JointPQPlayer,261,261,522,46,8,Tie
778,JointPQPlayer,257,262,519,46,9,JointPQPlayer
779,JointPQPlayer,252,247,499,41,14,Player A
780,JointPQPlayer,161,166,327,4,59,JointPQPlayer
781,JointPQPlayer,190,185,375,13,46,Player A
782,JointPQPlayer,261,261,522,46,8,Tie
783,JointPQPlayer,252,252,504,49,15,Tie
784,JointPQPlayer,258,258,516,43,9,Tie
785,JointPQPlayer,238,238,476,33,19,Tie
786,JointPQPlayer,164,164,328,5,59,Tie
787,JointPQPlayer,171,176,347,9,54,JointPQPlayer
788,JointPQPlayer,265,265,530,54,8,Tie
789,JointPQPlayer,231,226,457,32,25,Player A
790,JointPQPlayer,261,261,522,49,9,Tie
791,JointPQPlayer,237,237,474,37,21,Tie
792,JointPQPlayer,256,256,512,48,12,Tie
793,JointPQPlayer,243,243,486,37,17,Tie
794,JointPQPlayer,271,271,542,54,4,Tie
795,JointPQPlayer,221,221,442,26,28,Tie
796,JointPQPlayer,274,274,548,57,3,Tie
797,JointPQPlayer,222,227,449,33,28,JointPQPlayer
798,JointPQPlayer,265,265,530,57,9,Tie
799,JointPQPlayer,209,209,418,20,34,Tie
800,JointPQPlayer,262,257,519,43,8,Player A
801,JointPQPlayer,256,256,512,45,11,Tie
802,JointPQPlayer,189,189,378,10,44,Tie
803,JointPQPlayer,246,246,492,43,17,Tie
804,JointPQPlayer,238,238,476,39,21,Tie
805,JointPQPlayer,243,243,486,37,17,Tie
806,JointPQPlayer,261,261,522,40,6,Tie
807,JointPQPlayer,180,185,365,9,48,JointPQPlayer
808,JointPQPlayer,266,261,527,54,9,Player A
809,JointPQPlayer,268,268,536,54,6,Tie
810,JointPQPlayer,182,182,364,8,48,Tie
811,JointPQPlayer,255,255,510,49,13,Tie
812,JointPQPlayer,264,264,528,52,8,Tie
813,JointPQPlayer,194,194,388,20,44,Tie
814,JointPQPlayer,245,245,490,41,17,Tie
815,JointPQPlayer,190,195,385,17,44,JointPQPlayer
816,JointPQPlayer,269,264,533,54,7,Player A
817,JointPQPlayer,270,270,540,52,4,Tie
818,JointPQPlayer,217,217,434,27,31,Tie
819,JointPQPlayer,266,266,532,56,8,Tie
820,JointPQPlayer,245,245,490,41,17,Tie
821,JointPQPlayer,172,177,349,11,54,JointPQPlayer
822,JointPQPlayer,249,244,493,47,18,Player A
823,JointPQPlayer,166,171,337,2,55,JointPQPlayer
824,JointPQPlayer,173,173,346,5,53,Tie
825,JointPQPlayer,260,255,515,48,11,Player A
826,JointPQPlayer,250,255,505,44,13,JointPQPlayer
827,JointPQPlayer,269,269,538,53,5,Tie
828,JointPQPlayer,250,245,495,37,14,Player A
829,JointPQPlayer,257,257,514,53,13,Tie
830,JointPQPlayer,262,267,529,50,7,JointPQPlayer
831,JointPQPlayer,248,243,491,39,16,Player A
832,JointPQPlayer,180,180,360,10,50,Tie
833,JointPQPlayer,267,267,534,55,7,Tie
834,JointPQPlayer,240,240,480,37,19,Tie
835,JointPQPlayer,253,258,511,47,12,JointPQPlayer
836,JointPQPlayer,256,256,512,48,12,Tie
837,JointPQPlayer,262,262,524,48,8,Tie
838,JointPQPlayer,224,219,443,33,30,Player A
839,JointPQPlayer,253,253,506,48,14,Tie
840,JointPQPlayer,183,188,371,9,46,JointPQPlayer
841,JointPQPlayer,246,241,487,44,19,Player A
842,JointPQPlayer,252,252,504,43,13,Tie
843,JointPQPlayer,252,257,509,48,13,JointPQPlayer
844,JointPQPlayer,264,259,523,47,8,Player A
845,JointPQPlayer,239,239,478,41,21,Tie
846,JointPQPlayer,265,265,530,45,5,Tie
847,JointPQPlayer,254,254,508,44,12,Tie
848,JointPQPlayer,250,250,500,42,14,Tie
849,JointPQPlayer,263,263,526,47,7,Tie
850,JointPQPlayer,248,248,496,38,14,Tie
851,JointPQPlayer,268,268,536,54,6,Tie
852,JointPQPlayer,253,258,511,44,11,JointPQPlayer
853,JointPQPlayer,181,181,362,6,48,Tie
854,JointPQPlayer,245,240,485,39,18,Player A
855,JointPQPlayer,176,181,357,7,50,JointPQPlayer
856,JointPQPlayer,271,266,537,61,8,Player A
857,JointPQPlayer,265,265,530,48,6,Tie
858,JointPQPlayer,240,240,480,37,19,Tie
859,JointPQPlayer,255,260,515,51,12,JointPQPlayer
860,JointPQPlayer,256,251,507,43,12,Player A
861,JointPQPlayer,264,264,528,55,9,Tie
862,JointPQPlayer,250,255,505,47,14,JointPQPlayer
863,JointPQPlayer,253,253,506,48,14,Tie
864,JointPQPlayer,198,198,396,19,41,Tie
865,JointPQPlayer,257,252,509,45,12,Player A
866,JointPQPlayer,164,164,328,5,59,Tie
867,JointPQPlayer,189,189,378,4,42,Tie
868,JointPQPlayer,157,157,314,9,65,Tie
869,JointPQPlayer,164,169,333,4,57,JointPQPlayer
870,JointPQPlayer,248,248,496,47,17,Tie
871,JointPQPlayer,252,252,504,46,14,Tie
872,JointPQPlayer,269,264,533,54,7,Player A
873,JointPQPlayer,269,274,543,55,4,JointPQPlayer
874,JointPQPlayer,259,259,518,48,10,Tie
875,JointPQPlayer,266,261,527,54,9,Player A
876,JointPQPlayer,249,249,498,34,12,Tie
877,JointPQPlayer,245,250,495,49,18,JointPQPlayer
878,JointPQPlayer,178,178,356,9,51,Tie
879,JointPQPlayer,261,256,517,50,11,Player A
880,JointPQPlayer,268,268,536,57,7,Tie
881,JointPQPlayer,255,255,510,43,11,Tie
882,JointPQPlayer,246,246,492,49,19,Tie
883,JointPQPlayer,228,233,461,39,26,JointPQPlayer
884,JointPQPlayer,273,268,541,56,5,Player A
885,JointPQPlayer,235,240,475,47,24,JointPQPlayer
886,JointPQPlayer,172,167,339,13,58,Player A
887,JointPQPlayer,243,248,491,42,17,JointPQPlayer
888,JointPQPlayer,234,229,463,29,22,Player A
889,JointPQPlayer,211,211,422,24,34,Tie
890,JointPQPlayer,224,229,453,25,24,JointPQPlayer
891,JointPQPlayer,264,259,523,53,10,Player A
892,JointPQPlayer,188,188,376,14,46,Tie
893,JointPQPlayer,248,248,496,44,16,Tie
894,JointPQPlayer,247,252,499,47,16,JointPQPlayer
895,JointPQPlayer,258,258,516,52,12,Tie
896,JointPQPlayer,261,256,517,44,9,Player A
897,JointPQPlayer,266,271,537,52,5,JointPQPlayer
898,JointPQPlayer,250,245,495,43,16,Player A
899,JointPQPlayer,236,241,477,28,17,JointPQPlayer
900,JointPQPlayer,249,244,493,41,16,Player A
901,JointPQPlayer,263,263,526,47,7,Tie
902,JointPQPlayer,246,251,497,42,15,JointPQPlayer
903,JointPQPlayer,251,246,497,39,14,Player A
904,JointPQPlayer,210,215,425,30,35,JointPQPlayer
905,JointPQPlayer,237,232,469,35,22,Player A
906,JointPQPlayer,272,277,549,64,5,JointPQPlayer
907,JointPQPlayer,269,264,533,54,7,Player A
908,JointPQPlayer,197,197,394,17,41,Tie
909,JointPQPlayer,259,259,518,54,12,Tie
910,JointPQPlayer,184,189,373,11,46,JointPQPlayer
911,JointPQPlayer,255,250,505,38,11,Player A
912,JointPQPlayer,244,244,488,45,19,Tie
913,JointPQPlayer,257,257,514,47,11,Tie
914,JointPQPlayer,228,233,461,33,24,JointPQPlayer
915,JointPQPlayer,265,260,525,46,7,Player A
916,JointPQPlayer,236,236,472,38,22,Tie
917,JointPQPlayer,218,218,436,32,32,Tie
918,JointPQPlayer,250,250,500,45,15,Tie
919,JointPQPlayer,253,253,506,39,11,Tie
920,JointPQPlayer,267,272,539,54,5,JointPQPlayer
921,JointPQPlayer,269,264,533,51,6,Player A
922,JointPQPlayer,272,272,544,59,5,Tie
923,JointPQPlayer,268,268,536,57,7,Tie
924,JointPQPlayer,251,251,502,44,14,Tie
925,JointPQPlayer,169,169,338,3,55,Tie
926,JointPQPlayer,262,267,529,50,7,JointPQPlayer
927,JointPQPlayer,198,198,396,25,43,Tie
928,JointPQPlayer,249,249,498,37,13,Tie
929,JointPQPlayer,166,166,332,3,57,Tie
930,JointPQPlayer,186,186,372,10,46,Tie
931,JointPQPlayer,256,251,507,49,14,Player A
932,JointPQPlayer,239,244,483,37,18,JointPQPlayer
933,JointPQPlayer,267,267,534,55,7,Tie
934,JointPQPlayer,235,230,465,40,25,Player A
935,JointPQPlayer,237,237,474,34,20,Tie
936,JointPQPlayer,184,189,373,11,46,JointPQPlayer
937,JointPQPlayer,254,254,508,44,12,Tie
938,JointPQPlayer,258,258,516,52,12,Tie
939,JointPQPlayer,263,258,521,45,8,Player A
940,JointPQPlayer,247,247,494,42,16,Tie
941,JointPQPlayer,189,194,383,15,44,JointPQPlayer
942,JointPQPlayer,245,240,485,36,17,Player A
943,JointPQPlayer,253,253,506,42,12,Tie
944,JointPQPlayer,241,241,482,42,20,Tie
945,JointPQPlayer,257,257,514,44,10,Tie
946,JointPQPlayer,234,234,468,31,21,Tie
947,JointPQPlayer,235,235,470,39,23,Tie
948,JointPQPlayer,255,260,515,45,10,JointPQPlayer
949,JointPQPlayer,250,245,495,49,18,Player A
950,JointPQPlayer,240,245,485,45,20,JointPQPlayer
951,JointPQPlayer,225,220,445,38,31,Player A
952,JointPQPlayer,262,262,524,48,8,Tie
953,JointPQPlayer,249,249,498,49,17,Tie
954,JointPQPlayer,210,210,420,25,35,Tie
955,JointPQPlayer,255,255,510,40,10,Tie
956,JointPQPlayer,253,253,506,51,15,Tie
957,JointPQPlayer,245,245,490,41,17,Tie
958,JointPQPlayer,191,196,387,16,43,JointPQPlayer
959,JointPQPlayer,282,277,559,68,3,Player A
960,JointPQPlayer,185,190,375,13,46,JointPQPlayer
961,JointPQPlayer,222,222,444,31,29,Tie
962,JointPQPlayer,253,248,501,40,13,Player A
963,JointPQPlayer,245,250,495,40,15,JointPQPlayer
964,JointPQPlayer,256,251,507,52,15,Player A
965,JointPQPlayer,247,247,494,36,14,Tie
966,JointPQPlayer,253,258,511,44,11,JointPQPlayer
967,JointPQPlayer,248,248,496,44,16,Tie
968,JointPQPlayer,272,267,539,51,4,Player A
969,JointPQPlayer,260,265,525,46,7,JointPQPlayer
970,JointPQPlayer,259,259,518,45,9,Tie
971,JointPQPlayer,241,236,477,40,21,Player A
972,JointPQPlayer,186,191,377,12,45,JointPQPlayer
973,JointPQPlayer,257,257,514,44,10,Tie
974,JointPQPlayer,246,246,492,46,18,Tie
975,JointPQPlayer,239,234,473,39,22,Player A
976,JointPQPlayer,238,238,476,33,19,Tie
977,JointPQPlayer,221,226,447,31,28,JointPQPlayer
978,JointPQPlayer,259,254,513,49,12,Player A
979,JointPQPlayer,253,258,511,44,11,JointPQPlayer
980,JointPQPlayer,266,266,532,53,7,Tie
981,JointPQPlayer,261,256,517,50,11,Player A
982,JointPQPlayer,219,219,438,34,32,Tie
983,JointPQPlayer,227,232,459,34,25,JointPQPlayer
984,JointPQPlayer,192,187,379,14,45,Player A
985,JointPQPlayer,254,259,513,46,11,JointPQPlayer
986,JointPQPlayer,180,175,355,5,50,Player A
987,JointPQPlayer,217,222,439,32,31,JointPQPlayer
988,JointPQPlayer,253,248,501,43,14,Player A
989,JointPQPlayer,256,261,517,41,8,JointPQPlayer
990,JointPQPlayer,271,271,542,51,3,Tie
991,JointPQPlayer,253,248,501,37,12,Player A
992,JointPQPlayer,261,261,522,55,11,Tie
993,JointPQPlayer,189,194,383,21,46,JointPQPlayer
994,JointPQPlayer,262,262,524,51,9,Tie
995,JointPQPlayer,257,252,509,48,13,Player A
996,JointPQPlayer,224,224,448,32,28,Tie
997,JointPQPlayer,225,230,455,36,27,JointPQPlayer
998,JointPQPlayer,254,249,503,39,12,Player A
999,JointPQPlayer,260,260,520,53,11,Tie
1000,JointPQPlayer,265,270,535,53,6,JointPQPlayer
1001,JointPQPlayer,170,170,340,5,55,Tie
1002,JointPQPlayer,265,260,525,52,9,Player A
1003,JointPQPlayer,240,240,480,46,22,Tie
1004,JointPQPlayer,189,194,383,6,41,JointPQPlayer
1005,JointPQPlayer,247,247,494,42,16,Tie
1006,JointPQPlayer,252,247,499,44,15,Player A
1007,JointPQPlayer,244,244,488,39,17,Tie
1008,JointPQPlayer,211,216,427,23,32,JointPQPlayer
1009,JointPQPlayer,186,186,372,13,47,Tie
1010,JointPQPlayer,261,261,522,52,10,Tie
1011,JointPQPlayer,265,260,525,52,9,Player A
1012,JointPQPlayer,228,228,456,37,27,Tie
1013,JointPQPlayer,268,268,536,54,6,Tie
1014,JointPQPlayer,253,253,506,45,13,Tie
1015,JointPQPlayer,270,270,540,58,6,Tie
1016,JointPQPlayer,257,257,514,38,8,Tie
1017,JointPQPlayer,268,268,536,57,7,Tie
1018,JointPQPlayer,268,273,541,59,6,JointPQPlayer
1019,JointPQPlayer,235,230,465,34,23,Player A
1020,JointPQPlayer,251,251,502,38,12,Tie
1021,JointPQPlayer,243,243,486,46,20,Tie
1022,JointPQPlayer,256,256,512,42,10,Tie
1023,JointPQPlayer,169,174,343,8,55,JointPQPlayer
1024,JointPQPlayer,251,251,502,38,12,Tie
1025,JointPQPlayer,262,257,519,43,8,Player A
1026,JointPQPlayer,272,272,544,68,8,Tie
1027,JointPQPlayer,258,258,516,46,10,Tie
1028,JointPQPlayer,163,168,331,5,58,JointPQPlayer
1029,JointPQPlayer,264,259,523,50,9,Player A
1030,JointPQPlayer,198,198,396,25,43,Tie
1031,JointPQPlayer,180,185,365,9,48,JointPQPlayer
1032,JointPQPlayer,254,249,503,42,13,Player A
1033,JointPQPlayer,173,178,351,7,52,JointPQPlayer
1034,JointPQPlayer,243,238,481,38,19,Player A
1035,JointPQPlayer,169,169,338,3,55,Tie
1036,JointPQPlayer,246,246,492,40,16,Tie
1037,JointPQPlayer,185,190,375,13,46,JointPQPlayer
1038,JointPQPlayer,269,264,533,51,6,Player A
1039,JointPQPlayer,179,184,363,16,51,JointPQPlayer
1040,JointPQPlayer,261,261,522,40,6,Tie
1041,JointPQPlayer,196,191,387,16,43,Player A
1042,JointPQPlayer,257,257,514,44,10,Tie
1043,JointPQPlayer,247,252,499,41,14,JointPQPlayer
1044,JointPQPlayer,256,251,507,55,16,Player A
1045,JointPQPlayer,218,218,436,32,32,Tie
1046,JointPQPlayer,181,186,367,8,47,JointPQPlayer
1047,JointPQPlayer,187,187,374,6,44,Tie
1048,JointPQPlayer,259,254,513,46,11,Player A
1049,JointPQPlayer,260,260,520,44,8,Tie
1050,JointPQPlayer,210,210,420,22,34,Tie
1051,JointPQPlayer,197,197,394,20,42,Tie
1052,JointPQPlayer,249,249,498,46,16,Tie
1053,JointPQPlayer,259,259,518,45,9,Tie
1054,JointPQPlayer,246,251,497,42,15,JointPQPlayer
1055,JointPQPlayer,260,255,515,54,13,Player A
1056,JointPQPlayer,216,221,437,30,31,JointPQPlayer
1057,JointPQPlayer,238,233,471,34,21,Player A
1058,JointPQPlayer,252,252,504,52,16,Tie
1059,JointPQPlayer,272,272,544,56,4,Tie
1060,JointPQPlayer,247,247,494,48,18,Tie
1061,JointPQPlayer,258,258,516,55,13,Tie
1062,JointPQPlayer,271,276,547,53,2,JointPQPlayer
1063,JointPQPlayer,253,248,501,37,12,Player A
1064,JointPQPlayer,236,236,472,41,23,Tie
1065,JointPQPlayer,161,161,322,5,61,Tie
1066,JointPQPlayer,222,227,449,33,28,JointPQPlayer
1067,JointPQPlayer,250,245,495,43,16,Player A
1068,JointPQPlayer,257,257,514,47,11,Tie
1069,JointPQPlayer,253,258,511,44,11,JointPQPlayer
1070,JointPQPlayer,237,232,469,38,23,Player A
1071,JointPQPlayer,271,271,542,57,5,Tie
1072,JointPQPlayer,191,191,382,11,43,Tie
1073,JointPQPlayer,253,253,506,45,13,Tie
1074,JointPQPlayer,256,256,512,45,11,Tie
1075,JointPQPlayer,244,244,488,39,17,Tie
1076,JointPQPlayer,263,268,531,52,7,JointPQPlayer
1077,JointPQPlayer,248,248,496,47,17,Tie
1078,JointPQPlayer,162,162,324,7,61,Tie
1079,JointPQPlayer,184,184,368,9,47,Tie
1080,JointPQPlayer,204,199,403,20,39,Player A
1081,JointPQPlayer,209,209,418,29,37,Tie
1082,JointPQPlayer,257,257,514,41,9,Tie
1083,JointPQPlayer,178,183,361,8,49,JointPQPlayer
1084,JointPQPlayer,209,204,413,24,37,Player A
1085,JointPQPlayer,230,230,460,41,27,Tie
1086,JointPQPlayer,243,248,491,42,17,JointPQPlayer
1087,JointPQPlayer,268,268,536,54,6,Tie
1088,JointPQPlayer,232,227,459,31,24,Player A
1089,JointPQPlayer,234,234,468,34,22,Tie
1090,JointPQPlayer,203,203,406,32,42,Tie
1091,JointPQPlayer,183,183,366,10,48,Tie
1092,JointPQPlayer,260,260,520,41,7,Tie
1093,JointPQPlayer,256,261,517,44,9,JointPQPlayer
1094,JointPQPlayer,245,245,490,47,19,Tie
1095,JointPQPlayer,182,182,364,8,48,Tie
1096,JointPQPlayer,264,264,528,49,7,Tie
1097,JointPQPlayer,262,257,519,46,9,Player A
1098,JointPQPlayer,242,247,489,46,19,JointPQPlayer
1099,JointPQPlayer,269,269,538,50,4,Tie
1100,JointPQPlayer,235,230,465,34,23,Player A
1101,JointPQPlayer,183,188,371,18,49,JointPQPlayer
1102,JointPQPlayer,263,258,521,42,7,Player A
1103,JointPQPlayer,236,236,472,35,21,Tie
1104,JointPQPlayer,247,247,494,45,17,Tie
1105,JointPQPlayer,238,243,481,41,20,JointPQPlayer
1106,JointPQPlayer,251,246,497,42,15,Player A
1107,JointPQPlayer,257,257,514,50,12,Tie
1108,JointPQPlayer,208,208,416,30,38,Tie
1109,JointPQPlayer,188,193,381,22,47,JointPQPlayer
1110,JointPQPlayer,234,229,463,41,26,Player A
1111,JointPQPlayer,249,254,503,42,13,JointPQPlayer
1112,JointPQPlayer,210,205,415,23,36,Player A
1113,JointPQPlayer,236,236,472,26,18,Tie
1114,JointPQPlayer,190,190,380,18,46,Tie
1115,JointPQPlayer,272,277,549,58,3,JointPQPlayer
1116,JointPQPlayer,266,261,527,54,9,Player A
1117,JointPQPlayer,256,256,512,45,11,Tie
1118,JointPQPlayer,244,244,488,39,17,Tie
1119,JointPQPlayer,252,252,504,37,11,Tie
1120,JointPQPlayer,165,170,335,6,57,JointPQPlayer
1121,JointPQPlayer,237,232,469,32,21,Player A
1122,JointPQPlayer,172,177,349,5,52,JointPQPlayer
1123,JointPQPlayer,179,179,358,11,51,Tie
1124,JointPQPlayer,180,175,355,11,52,Player A
1125,JointPQPlayer,267,267,534,52,6,Tie
1126,JointPQPlayer,173,178,351,4,51,JointPQPlayer
1127,JointPQPlayer,234,229,463,38,25,Player A
1128,JointPQPlayer,269,269,538,56,6,Tie
1129,JointPQPlayer,259,259,518,48,10,Tie
1130,JointPQPlayer,161,166,327,4,59,JointPQPlayer
1131,JointPQPlayer,270,265,535,56,7,Player A
1132,JointPQPlayer,236,236,472,38,22,Tie
1133,JointPQPlayer,178,183,361,8,49,JointPQPlayer
1134,JointPQPlayer,205,200,405,22,39,Player A
1135,JointPQPlayer,195,200,395,18,41,JointPQPlayer
1136,JointPQPlayer,262,257,519,52,11,Player A
1137,JointPQPlayer,246,246,492,43,17,Tie
1138,JointPQPlayer,263,263,526,50,8,Tie
1139,JointPQPlayer,254,254,508,47,13,Tie
1140,JointPQPlayer,255,255,510,49,13,Tie
1141,JointPQPlayer,248,253,501,43,14,JointPQPlayer
1142,JointPQPlayer,261,256,517,47,10,Player A
1143,JointPQPlayer,244,249,493,38,15,JointPQPlayer
1144,JointPQPlayer,227,222,449,33,28,Player A
1145,JointPQPlayer,251,251,502,38,12,Tie
1146,JointPQPlayer,180,185,365,9,48,JointPQPlayer
1147,JointPQPlayer,275,275,550,65,5,Tie
1148,JointPQPlayer,229,224,453,37,28,Player A
1149,JointPQPlayer,238,243,481,41,20,JointPQPlayer
1150,JointPQPlayer,249,244,493,41,16,Player A
1151,JointPQPlayer,252,257,509,48,13,JointPQPlayer
1152,JointPQPlayer,249,244,493,44,17,Player A
1153,JointPQPlayer,249,254,503,45,14,JointPQPlayer
1154,JointPQPlayer,271,266,537,55,6,Player A
1155,JointPQPlayer,157,157,314,6,64,Tie
1156,JointPQPlayer,272,277,549,61,4,JointPQPlayer
1157,JointPQPlayer,177,177,354,7,51,Tie
1158,JointPQPlayer,219,214,433,32,33,Player A
1159,JointPQPlayer,258,258,516,55,13,Tie
1160,JointPQPlayer,228,228,456,28,24,Tie
1161,JointPQPlayer,255,260,515,48,11,JointPQPlayer
1162,JointPQPlayer,257,252,509,39,10,Player A
1163,JointPQPlayer,262,262,524,42,6,Tie
1164,JointPQPlayer,258,258,516,49,11,Tie
1165,JointPQPlayer,218,218,436,26,30,Tie
1166,JointPQPlayer,178,183,361,5,48,JointPQPlayer
1167,JointPQPlayer,257,252,509,48,13,Player A
1168,JointPQPlayer,258,258,516,49,11,Tie
1169,JointPQPlayer,241,241,482,42,20,Tie
1170,JointPQPlayer,252,252,504,43,13,Tie
1171,JointPQPlayer,228,228,456,31,25,Tie
1172,JointPQPlayer,248,253,501,46,15,JointPQPlayer
1173,JointPQPlayer,172,167,339,4,55,Player A
1174,JointPQPlayer,244,244,488,45,19,Tie
1175,JointPQPlayer,235,235,470,48,26,Tie
1176,JointPQPlayer,262,262,524,48,8,Tie
1177,JointPQPlayer,251,256,507,37,10,JointPQPlayer
1178,JointPQPlayer,232,227,459,37,26,Player A
1179,JointPQPlayer,254,254,508,47,13,Tie
1180,JointPQPlayer,170,175,345,4,53,JointPQPlayer
1181,JointPQPlayer,254,254,508,44,12,Tie
1182,JointPQPlayer,256,251,507,46,13,Player A
1183,JointPQPlayer,272,272,544,59,5,Tie
1184,JointPQPlayer,264,264,528,52,8,Tie
1185,JointPQPlayer,254,254,508,50,14,Tie
1186,JointPQPlayer,259,259,518,42,8,Tie
1187,JointPQPlayer,231,236,467,30,21,JointPQPlayer
1188,JointPQPlayer,265,260,525,55,10,Player A
1189,JointPQPlayer,173,173,346,8,54,Tie
1190,JointPQPlayer,251,256,507,43,12,JointPQPlayer
1191,JointPQPlayer,207,202,409,32,41,Player A
1192,JointPQPlayer,258,258,516,49,11,Tie
1193,JointPQPlayer,257,257,514,50,12,Tie
1194,JointPQPlayer,267,272,539,54,5,JointPQPlayer
1195,JointPQPlayer,244,244,488,42,18,Tie
1196,JointPQPlayer,246,246,492,43,17,Tie
1197,JointPQPlayer,265,260,525,46,7,Player A
1198,JointPQPlayer,253,253,506,45,13,Tie
1199,JointPQPlayer,245,245,490,38,16,Tie
1200,JointPQPlayer,231,236,467,30,21,JointPQPlayer
1201,JointPQPlayer,246,241,487,41,18,Player A
1202,JointPQPlayer,174,179,353,6,51,JointPQPlayer
1203,JointPQPlayer,270,265,535,53,6,Player A
1204,JointPQPlayer,262,267,529,50,7,JointPQPlayer
1205,JointPQPlayer,272,267,539,57,6,Player A
1206,JointPQPlayer,159,159,318,4,62,Tie
1207,JointPQPlayer,264,264,528,55,9,Tie
1208,JointPQPlayer,242,247,489,40,17,JointPQPlayer
1209,JointPQPlayer,274,269,543,58,5,Player A
1210,JointPQPlayer,243,243,486,40,18,Tie
1211,JointPQPlayer,243,248,491,45,18,JointPQPlayer
1212,JointPQPlayer,212,212,424,29,35,Tie
1213,JointPQPlayer,266,261,527,51,8,Player A
1214,JointPQPlayer,219,219,438,28,30,Tie
1215,JointPQPlayer,181,186,367,8,47,JointPQPlayer
1216,JointPQPlayer,192,187,379,11,44,Player A
1217,JointPQPlayer,257,257,514,47,11,Tie
1218,JointPQPlayer,250,250,500,36,12,Tie
1219,JointPQPlayer,172,177,349,8,53,JointPQPlayer
1220,JointPQPlayer,252,247,499,35,12,Player A
1221,JointPQPlayer,265,270,535,44,3,JointPQPlayer
1222,JointPQPlayer,188,188,376,17,47,Tie
1223,JointPQPlayer,235,230,465,37,24,Player A
1224,JointPQPlayer,232,232,464,36,24,Tie
1225,JointPQPlayer,165,165,330,10,60,Tie
1226,JointPQPlayer,254,254,508,41,11,Tie
1227,JointPQPlayer,183,188,371,15,48,JointPQPlayer
1228,JointPQPlayer,265,265,530,54,8,Tie
1229,JointPQPlayer,243,243,486,40,18,Tie
1230,JointPQPlayer,254,254,508,35,9,Tie
1231,JointPQPlayer,171,171,342,7,55,Tie
1232,JointPQPlayer,237,232,469,35,22,Player A
1233,JointPQPlayer,238,238,476,36,20,Tie
1234,JointPQPlayer,273,273,546,58,4,Tie
1235,JointPQPlayer,182,182,364,8,48,Tie
1236,JointPQPlayer,198,198,396,19,41,Tie
1237,JointPQPlayer,248,248,496,38,14,Tie
1238,JointPQPlayer,268,268,536,48,4,Tie
1239,JointPQPlayer,260,260,520,59,13,Tie
1240,JointPQPlayer,262,262,524,51,9,Tie
1241,JointPQPlayer,182,187,369,10,47,JointPQPlayer
1242,JointPQPlayer,265,260,525,52,9,Player A
1243,JointPQPlayer,217,222,439,29,30,JointPQPlayer
1244,JointPQPlayer,203,203,406,23,39,Tie
1245,JointPQPlayer,249,249,498,40,14,Tie
1246,JointPQPlayer,216,211,427,29,34,Player A
1247,JointPQPlayer,253,258,511,41,10,JointPQPlayer
1248,JointPQPlayer,240,240,480,46,22,Tie
1249,JointPQPlayer,272,267,539,54,5,Player A
1250,JointPQPlayer,239,244,483,25,14,JointPQPlayer
1251,JointPQPlayer,266,261,527,54,9,Player A
1252,JointPQPlayer,256,256,512,45,11,Tie
1253,JointPQPlayer,245,245,490,44,18,Tie
1254,JointPQPlayer,253,253,506,48,14,Tie
1255,JointPQPlayer,212,217,429,28,33,JointPQPlayer
1256,JointPQPlayer,221,216,437,36,33,Player A
1257,JointPQPlayer,233,233,466,35,23,Tie
1258,JointPQPlayer,261,261,522,40,6,Tie
1259,JointPQPlayer,244,249,493,41,16,JointPQPlayer
1260,JointPQPlayer,269,269,538,62,8,Tie
1261,JointPQPlayer,265,260,525,46,7,Player A
1262,JointPQPlayer,242,242,484,38,18,Tie
1263,JointPQPlayer,237,237,474,37,21,Tie
1264,JointPQPlayer,254,254,508,44,12,Tie
1265,JointPQPlayer,264,264,528,58,10,Tie
1266,JointPQPlayer,242,242,484,50,22,Tie
1267,JointPQPlayer,255,255,510,43,11,Tie
1268,JointPQPlayer,260,260,520,50,10,Tie
1269,JointPQPlayer,263,263,526,50,8,Tie
1270,JointPQPlayer,243,243,486,34,16,Tie
1271,JointPQPlayer,170,175,345,7,54,JointPQPlayer
1272,JointPQPlayer,161,161,322,5,61,Tie
1273,JointPQPlayer,220,215,435,28,31,Player A
1274,JointPQPlayer,258,258,516,46,10,Tie
1275,JointPQPlayer,172,177,349,5,52,JointPQPlayer
1276,JointPQPlayer,188,183,371,9,46,Player A
1277,JointPQPlayer,263,263,526,50,8,Tie
1278,JointPQPlayer,246,246,492,43,17,Tie
1279,JointPQPlayer,249,254,503,54,17,JointPQPlayer
1280,JointPQPlayer,242,237,479,42,21,Player A
1281,JointPQPlayer,258,258,516,52,12,Tie
1282,JointPQPlayer,262,262,524,51,9,Tie
1283,JointPQPlayer,259,259,518,51,11,Tie
1284,JointPQPlayer,264,264,528,46,6,Tie
1285,JointPQPlayer,248,253,501,46,15,JointPQPlayer
1286,JointPQPlayer,268,263,531,52,7,Player A
1287,JointPQPlayer,263,263,526,50,8,Tie
1288,JointPQPlayer,264,264,528,55,9,Tie
1289,JointPQPlayer,255,255,510,43,11,Tie
1290,JointPQPlayer,264,264,528,52,8,Tie
1291,JointPQPlayer,265,270,535,56,7,JointPQPlayer
1292,JointPQPlayer,174,174,348,7,53,Tie
1293,JointPQPlayer,248,243,491,39,16,Player A
1294,JointPQPlayer,241,246,487,32,15,JointPQPlayer
1295,JointPQPlayer,217,212,429,25,32,Player A
1296,JointPQPlayer,247,252,499,41,14,JointPQPlayer
1297,JointPQPlayer,198,198,396,13,39,Tie
1298,JointPQPlayer,185,185,370,14,48,Tie
1299,JointPQPlayer,172,172,344,12,56,Tie
1300,JointPQPlayer,249,249,498,37,13,Tie
1301,JointPQPlayer,251,246,497,42,15,Player A
1302,JointPQPlayer,245,245,490,47,19,Tie
1303,JointPQPlayer,266,266,532,50,6,Tie
1304,JointPQPlayer,191,196,387,13,42,JointPQPlayer
1305,JointPQPlayer,233,233,466,35,23,Tie
1306,JointPQPlayer,257,252,509,42,11,Player A
1307,JointPQPlayer,265,270,535,50,5,JointPQPlayer
1308,JointPQPlayer,250,250,500,48,16,Tie
1309,JointPQPlayer,259,254,513,46,11,Player A
1310,JointPQPlayer,265,265,530,60,10,Tie
1311,JointPQPlayer,238,238,476,36,20,Tie
1312,JointPQPlayer,203,203,406,14,36,Tie
1313,JointPQPlayer,187,192,379,17,46,JointPQPlayer
1314,JointPQPlayer,263,263,526,47,7,Tie
1315,JointPQPlayer,252,252,504,43,13,Tie
1316,JointPQPlayer,272,267,539,54,5,Player A
1317,JointPQPlayer,260,260,520,50,10,Tie
1318,JointPQPlayer,178,183,361,11,50,JointPQPlayer
1319,JointPQPlayer,247,242,489,34,15,Player A
1320,JointPQPlayer,240,240,480,40,20,Tie
1321,JointPQPlayer,162,167,329,3,58,JointPQPlayer
1322,JointPQPlayer,262,262,524,45,7,Tie
1323,JointPQPlayer,243,238,481,41,20,Player A
1324,JointPQPlayer,275,275,550,56,2,Tie
1325,JointPQPlayer,247,247,494,48,18,Tie
1326,JointPQPlayer,272,272,544,62,6,Tie
1327,JointPQPlayer,255,255,510,52,14,Tie
1328,JointPQPlayer,243,243,486,37,17,Tie
1329,JointPQPlayer,237,237,474,37,21,Tie
1330,JointPQPlayer,269,269,538,53,5,Tie
1331,JointPQPlayer,266,266,532,50,6,Tie
1332,JointPQPlayer,184,189,373,20,49,JointPQPlayer
1333,JointPQPlayer,240,240,480,43,21,Tie
1334,JointPQPlayer,219,219,438,25,29,Tie
1335,JointPQPlayer,209,204,413,24,37,Player A
1336,JointPQPlayer,249,249,498,37,13,Tie
1337,JointPQPlayer,246,251,497,51,18,JointPQPlayer
1338,JointPQPlayer,255,250,505,38,11,Player A
1339,JointPQPlayer,176,176,352,8,52,Tie
1340,JointPQPlayer,262,262,524,57,11,Tie
1341,JointPQPlayer,205,205,410,21,37,Tie
1342,JointPQPlayer,259,259,518,48,10,Tie
1343,JointPQPlayer,211,211,422,27,35,Tie
1344,JointPQPlayer,263,268,531,46,5,JointPQPlayer
1345,JointPQPlayer,257,252,509,36,9,Player A
1346,JointPQPlayer,254,254,508,47,13,Tie
1347,JointPQPlayer,237,237,474,43,23,Tie
1348,JointPQPlayer,256,256,512,51,13,Tie
1349,JointPQPlayer,263,263,526,50,8,Tie
1350,JointPQPlayer,163,168,331,2,57,JointPQPlayer
1351,JointPQPlayer,281,276,557,63,2,Player A
1352,JointPQPlayer,239,239,478,38,20,Tie
1353,JointPQPlayer,248,248,496,41,15,Tie
1354,JointPQPlayer,179,179,358,5,49,Tie
1355,JointPQPlayer,180,185,365,9,48,JointPQPlayer
1356,JointPQPlayer,270,265,535,56,7,Player A
1357,JointPQPlayer,253,253,506,45,13,Tie
1358,JointPQPlayer,241,241,482,42,20,Tie
1359,JointPQPlayer,259,259,518,48,10,Tie
1360,JointPQPlayer,248,253,501,46,15,JointPQPlayer
1361,JointPQPlayer,262,262,524,54,10,Tie
1362,JointPQPlayer,253,253,506,48,14,Tie
1363,JointPQPlayer,188,183,371,6,45,Player A
1364,JointPQPlayer,242,247,489,46,19,JointPQPlayer
1365,JointPQPlayer,173,168,341,6,55,Player A
1366,JointPQPlayer,261,261,522,52,10,Tie
1367,JointPQPlayer,169,174,343,5,54,JointPQPlayer
1368,JointPQPlayer,190,190,380,9,43,Tie
1369,JointPQPlayer,248,243,491,39,16,Player A
1370,JointPQPlayer,221,221,442,32,30,Tie
1371,JointPQPlayer,260,265,525,58,11,JointPQPlayer
1372,JointPQPlayer,195,195,390,19,43,Tie
1373,JointPQPlayer,234,234,468,43,25,Tie
1374,JointPQPlayer,231,226,457,35,26,Player A
1375,JointPQPlayer,274,274,548,54,2,Tie
1376,JointPQPlayer,237,242,479,42,21,JointPQPlayer
1377,JointPQPlayer,168,168,336,4,56,Tie
1378,JointPQPlayer,252,247,499,41,14,Player A
1379,JointPQPlayer,248,248,496,44,16,Tie
1380,JointPQPlayer,187,192,379,11,44,JointPQPlayer
1381,JointPQPlayer,261,256,517,47,10,Player A
1382,JointPQPlayer,241,241,482,33,17,Tie
1383,JointPQPlayer,259,259,518,51,11,Tie
1384,JointPQPlayer,245,245,490,44,18,Tie
1385,JointPQPlayer,263,263,526,47,7,Tie
1386,JointPQPlayer,267,267,534,52,6,Tie
1387,JointPQPlayer,250,250,500,48,16,Tie
1388,JointPQPlayer,249,249,498,46,16,Tie
1389,JointPQPlayer,205,205,410,24,38,Tie
1390,JointPQPlayer,246,246,492,40,16,Tie
1391,JointPQPlayer,270,270,540,61,7,Tie
1392,JointPQPlayer,229,234,463,38,25,JointPQPlayer
1393,JointPQPlayer,227,222,449,30,27,Player A
1394,JointPQPlayer,258,263,521,51,10,JointPQPlayer
1395,JointPQPlayer,256,251,507,43,12,Player A
1396,JointPQPlayer,259,264,523,50,9,JointPQPlayer
1397,JointPQPlayer,232,232,464,33,23,Tie
1398,JointPQPlayer,244,244,488,36,16,Tie
1399,JointPQPlayer,268,263,531,46,5,Player A
1400,JointPQPlayer,269,269,538,53,5,Tie
1401,JointPQPlayer,260,260,520,50,10,Tie
1402,JointPQPlayer,271,271,542,51,3,Tie
1403,JointPQPlayer,260,260,520,53,11,Tie
1404,JointPQPlayer,163,168,331,5,58,JointPQPlayer
1405,JointPQPlayer,249,244,493,41,16,Player A
1406,JointPQPlayer,254,254,508,44,12,Tie
1407,JointPQPlayer,263,263,526,50,8,Tie
1408,JointPQPlayer,238,238,476,39,21,Tie
1409,JointPQPlayer,168,168,336,7,57,Tie
1410,JointPQPlayer,266,266,532,50,6,Tie
1411,JointPQPlayer,211,216,427,20,31,JointPQPlayer
1412,JointPQPlayer,206,206,412,26,38,Tie
1413,JointPQPlayer,272,267,539,57,6,Player A
1414,JointPQPlayer,190,190,380,3,41,Tie
1415,JointPQPlayer,255,255,510,49,13,Tie
1416,JointPQPlayer,222,222,444,28,28,Tie
1417,JointPQPlayer,187,192,379,20,47,JointPQPlayer
1418,JointPQPlayer,245,240,485,48,21,Player A
1419,JointPQPlayer,272,272,544,59,5,Tie
1420,JointPQPlayer,249,249,498,49,17,Tie
1421,JointPQPlayer,264,264,528,49,7,Tie
1422,JointPQPlayer,179,184,363,10,49,JointPQPlayer
1423,JointPQPlayer,196,196,392,15,41,Tie
1424,JointPQPlayer,193,193,386,21,45,Tie
1425,JointPQPlayer,257,252,509,42,11,Player A
1426,JointPQPlayer,273,273,546,58,4,Tie
1427,JointPQPlayer,221,221,442,32,30,Tie
1428,JointPQPlayer,266,271,537,55,6,JointPQPlayer
1429,JointPQPlayer,186,186,372,10,46,Tie
1430,JointPQPlayer,222,217,439,29,30,Player A
1431,JointPQPlayer,230,235,465,37,24,JointPQPlayer
1432,JointPQPlayer,190,190,380,6,42,Tie
1433,JointPQPlayer,178,173,351,7,52,Player A
1434,JointPQPlayer,242,242,484,41,19,Tie
1435,JointPQPlayer,243,243,486,43,19,Tie
1436,JointPQPlayer,252,252,504,43,13,Tie
1437,JointPQPlayer,266,266,532,50,6,Tie
1438,JointPQPlayer,184,189,373,8,45,JointPQPlayer
1439,JointPQPlayer,245,245,490,53,21,Tie
1440,JointPQPlayer,268,263,531,49,6,Player A
1441,JointPQPlayer,245,250,495,37,14,JointPQPlayer
1442,JointPQPlayer,256,251,507,43,12,Player A
1443,JointPQPlayer,243,243,486,43,19,Tie
1444,JointPQPlayer,259,259,518,51,11,Tie
1445,JointPQPlayer,176,176,352,11,53,Tie
1446,JointPQPlayer,192,192,384,10,42,Tie
1447,JointPQPlayer,235,235,470,33,21,Tie
1448,JointPQPlayer,257,262,519,55,12,JointPQPlayer
1449,JointPQPlayer,255,255,510,46,12,Tie
1450,JointPQPlayer,265,260,525,52,9,Player A
1451,JointPQPlayer,252,252,504,40,12,Tie
1452,JointPQPlayer,185,185,370,11,47,Tie
1453,JointPQPlayer,243,248,491,39,16,JointPQPlayer
1454,JointPQPlayer,270,265,535,56,7,Player A
1455,JointPQPlayer,268,268,536,57,7,Tie
1456,JointPQPlayer,172,177,349,11,54,JointPQPlayer
1457,JointPQPlayer,182,182,364,11,49,Tie
1458,JointPQPlayer,183,183,366,16,50,Tie
1459,JointPQPlayer,238,233,471,37,22,Player A
1460,JointPQPlayer,253,253,506,39,11,Tie
1461,JointPQPlayer,258,263,521,48,9,JointPQPlayer
1462,JointPQPlayer,259,254,513,46,11,Player A
1463,JointPQPlayer,163,168,331,5,58,JointPQPlayer
1464,JointPQPlayer,249,244,493,41,16,Player A
1465,JointPQPlayer,183,188,371,3,44,JointPQPlayer
1466,JointPQPlayer,236,236,472,38,22,Tie
1467,JointPQPlayer,260,255,515,45,10,Player A
1468,JointPQPlayer,254,254,508,50,14,Tie
1469,JointPQPlayer,238,243,481,32,17,JointPQPlayer
1470,JointPQPlayer,224,219,443,36,31,Player A
1471,JointPQPlayer,254,259,513,43,10,JointPQPlayer
1472,JointPQPlayer,234,229,463,35,24,Player A
1473,JointPQPlayer,255,260,515,42,9,JointPQPlayer
1474,JointPQPlayer,261,261,522,46,8,Tie
1475,JointPQPlayer,253,248,501,40,13,Player A
1476,JointPQPlayer,268,268,536,54,6,Tie
1477,JointPQPlayer,248,248,496,41,15,Tie
1478,JointPQPlayer,256,256,512,45,11,Tie
1479,JointPQPlayer,262,262,524,45,7,Tie
1480,JointPQPlayer,266,266,532,44,4,Tie
1481,JointPQPlayer,247,247,494,42,16,Tie
1482,JointPQPlayer,245,245,490,38,16,Tie
1483,JointPQPlayer,262,267,529,47,6,JointPQPlayer
1484,JointPQPlayer,259,254,513,52,13,Player A
1485,JointPQPlayer,264,269,533,51,6,JointPQPlayer
1486,JointPQPlayer,189,189,378,16,46,Tie
1487,JointPQPlayer,264,259,523,59,12,Player A
1488,JointPQPlayer,255,255,510,46,12,Tie
1489,JointPQPlayer,225,225,450,28,26,Tie
1490,JointPQPlayer,244,244,488,42,18,Tie
1491,JointPQPlayer,267,267,534,52,6,Tie
1492,JointPQPlayer,203,208,411,22,37,JointPQPlayer
1493,JointPQPlayer,265,260,525,61,12,Player A
1494,JointPQPlayer,257,262,519,46,9,JointPQPlayer
1495,JointPQPlayer,271,266,537,55,6,Player A
1496,JointPQPlayer,270,270,540,55,5,Tie
1497,JointPQPlayer,261,266,527,48,7,JointPQPlayer
1498,JointPQPlayer,162,162,324,4,60,Tie
1499,JointPQPlayer,252,247,499,41,14,Player A
1500,JointPQPlayer,260,260,520,44,8,Tie
1501,JointPQPlayer,257,262,519,49,10,JointPQPlayer
1502,JointPQPlayer,251,246,497,48,17,Player A
1503,JointPQPlayer,256,256,512,45,11,Tie
1504,JointPQPlayer,246,246,492,43,17,Tie
1505,JointPQPlayer,273,273,546,55,3,Tie
1506,JointPQPlayer,233,238,471,40,23,JointPQPlayer
1507,JointPQPlayer,160,160,320,3,61,Tie
1508,JointPQPlayer,257,257,514,50,12,Tie
1509,JointPQPlayer,254,254,508,44,12,Tie
1510,JointPQPlayer,241,236,477,49,24,Player A
1511,JointPQPlayer,206,211,417,22,35,JointPQPlayer
1512,JointPQPlayer,243,243,486,34,16,Tie
1513,JointPQPlayer,265,265,530,54,8,Tie
1514,JointPQPlayer,260,255,515,39,8,Player A
1515,JointPQPlayer,264,269,533,48,5,JointPQPlayer
1516,JointPQPlayer,176,176,352,11,53,Tie
1517,JointPQPlayer,179,179,358,8,50,Tie
1518,JointPQPlayer,251,246,497,51,18,Player A
1519,JointPQPlayer,260,260,520,47,9,Tie
1520,JointPQPlayer,222,227,449,36,29,JointPQPlayer
1521,JointPQPlayer,278,273,551,66,5,Player A
1522,JointPQPlayer,215,220,435,34,33,JointPQPlayer
1523,JointPQPlayer,221,221,442,35,31,Tie
1524,JointPQPlayer,260,255,515,51,12,Player A
1525,JointPQPlayer,269,269,538,56,6,Tie
1526,JointPQPlayer,262,262,524,51,9,Tie
1527,JointPQPlayer,245,245,490,41,17,Tie
1528,JointPQPlayer,216,221,437,33,32,JointPQPlayer
1529,JointPQPlayer,252,252,504,37,11,Tie
1530,JointPQPlayer,243,238,481,41,20,Player A
1531,JointPQPlayer,159,164,323,3,60,JointPQPlayer
1532,JointPQPlayer,156,156,312,7,65,Tie
1533,JointPQPlayer,253,248,501,40,13,Player A
1534,JointPQPlayer,268,268,536,48,4,Tie
1535,JointPQPlayer,161,166,327,7,60,JointPQPlayer
1536,JointPQPlayer,253,248,501,46,15,Player A
1537,JointPQPlayer,231,231,462,31,23,Tie
1538,JointPQPlayer,185,185,370,20,50,Tie
1539,JointPQPlayer,239,244,483,43,20,JointPQPlayer
1540,JointPQPlayer,234,229,463,38,25,Player A
1541,JointPQPlayer,257,257,514,44,10,Tie
1542,JointPQPlayer,240,245,485,42,19,JointPQPlayer
1543,JointPQPlayer,192,192,384,13,43,Tie
1544,JointPQPlayer,257,252,509,45,12,Player A
1545,JointPQPlayer,241,246,487,38,17,JointPQPlayer
1546,JointPQPlayer,171,166,337,8,57,Player A
1547,JointPQPlayer,254,254,508,47,13,Tie
1548,JointPQPlayer,241,241,482,42,20,Tie
1549,JointPQPlayer,175,180,355,2,49,JointPQPlayer
1550,JointPQPlayer,254,249,503,39,12,Player A
1551,JointPQPlayer,273,278,551,60,3,JointPQPlayer
1552,JointPQPlayer,227,222,449,30,27,Player A
1553,JointPQPlayer,252,252,504,43,13,Tie
1554,JointPQPlayer,246,246,492,46,18,Tie
1555,JointPQPlayer,257,262,519,49,10,JointPQPlayer
1556,JointPQPlayer,253,248,501,46,15,Player A
1557,JointPQPlayer,264,269,533,51,6,JointPQPlayer
1558,JointPQPlayer,178,173,351,10,53,Player A
1559,JointPQPlayer,270,270,540,55,5,Tie
1560,JointPQPlayer,226,231,457,38,27,JointPQPlayer
1561,JointPQPlayer,278,273,551,57,2,Player A
1562,JointPQPlayer,183,188,371,18,49,JointPQPlayer
1563,JointPQPlayer,259,254,513,43,10,Player A
1564,JointPQPlayer,268,268,536,57,7,Tie
1565,JointPQPlayer,260,265,525,49,8,JointPQPlayer
1566,JointPQPlayer,232,227,459,34,25,Player A
1567,JointPQPlayer,214,214,428,18,30,Tie
1568,JointPQPlayer,259,259,518,51,11,Tie
1569,JointPQPlayer,250,250,500,45,15,Tie
1570,JointPQPlayer,257,257,514,53,13,Tie
1571,JointPQPlayer,259,259,518,51,11,Tie
1572,JointPQPlayer,224,224,448,38,30,Tie
1573,JointPQPlayer,256,261,517,50,11,JointPQPlayer
1574,JointPQPlayer,254,249,503,39,12,Player A
1575,JointPQPlayer,245,245,490,35,15,Tie
1576,JointPQPlayer,257,257,514,47,11,Tie
1577,JointPQPlayer,267,272,539,60,7,JointPQPlayer
1578,JointPQPlayer,244,239,483,49,22,Player A
1579,JointPQPlayer,262,262,524,45,7,Tie
1580,JointPQPlayer,260,260,520,53,11,Tie
1581,JointPQPlayer,259,264,523,50,9,JointPQPlayer
1582,JointPQPlayer,249,244,493,41,16,Player A
1583,JointPQPlayer,189,194,383,15,44,JointPQPlayer
1584,JointPQPlayer,236,236,472,32,20,Tie
1585,JointPQPlayer,260,260,520,50,10,Tie
1586,JointPQPlayer,220,215,435,28,31,Player A
1587,JointPQPlayer,268,268,536,57,7,Tie
1588,JointPQPlayer,238,238,476,39,21,Tie
1589,JointPQPlayer,260,260,520,47,9,Tie
1590,JointPQPlayer,260,260,520,41,7,Tie
1591,JointPQPlayer,243,243,486,37,17,Tie
1592,JointPQPlayer,191,191,382,14,44,Tie
1593,JointPQPlayer,263,263,526,47,7,Tie
1594,JointPQPlayer,234,239,473,39,22,JointPQPlayer
1595,JointPQPlayer,232,227,459,31,24,Player A
1596,JointPQPlayer,271,276,547,59,4,JointPQPlayer
1597,JointPQPlayer,257,257,514,47,11,Tie
1598,JointPQPlayer,263,258,521,48,9,Player A
1599,JointPQPlayer,263,263,526,53,9,Tie
1600,JointPQPlayer,268,268,536,60,8,Tie
1601,JointPQPlayer,178,183,361,8,49,JointPQPlayer
1602,JointPQPlayer,244,239,483,34,17,Player A
1603,JointPQPlayer,174,174,348,7,53,Tie
1604,JointPQPlayer,250,255,505,44,13,JointPQPlayer
1605,JointPQPlayer,269,264,533,51,6,Player A
1606,JointPQPlayer,250,255,505,50,15,JointPQPlayer
1607,JointPQPlayer,187,187,374,12,46,Tie
1608,JointPQPlayer,263,258,521,54,11,Player A
1609,JointPQPlayer,270,270,540,58,6,Tie
1610,JointPQPlayer,240,240,480,40,20,Tie
1611,JointPQPlayer,270,270,540,46,2,Tie
1612,JointPQPlayer,253,258,511,41,10,JointPQPlayer
1613,JointPQPlayer,267,262,529,47,6,Player A
1614,JointPQPlayer,165,165,330,13,61,Tie
1615,JointPQPlayer,256,256,512,51,13,Tie
1616,JointPQPlayer,253,258,511,44,11,JointPQPlayer
1617,JointPQPlayer,230,225,455,33,26,Player A
1618,JointPQPlayer,166,171,337,5,56,JointPQPlayer
1619,JointPQPlayer,186,186,372,19,49,Tie
1620,JointPQPlayer,246,241,487,44,19,Player A
1621,JointPQPlayer,270,270,540,61,7,Tie
1622,JointPQPlayer,253,258,511,47,12,JointPQPlayer
1623,JointPQPlayer,223,218,441,31,30,Player A
1624,JointPQPlayer,259,264,523,44,7,JointPQPlayer
1625,JointPQPlayer,253,253,506,33,9,Tie
1626,JointPQPlayer,241,236,477,46,23,Player A
1627,JointPQPlayer,254,254,508,41,11,Tie
1628,JointPQPlayer,234,239,473,42,23,JointPQPlayer
1629,JointPQPlayer,232,227,459,34,25,Player A
1630,JointPQPlayer,257,257,514,47,11,Tie
1631,JointPQPlayer,259,259,518,42,8,Tie
1632,JointPQPlayer,226,231,457,38,27,JointPQPlayer
1633,JointPQPlayer,256,251,507,49,14,Player A
1634,JointPQPlayer,266,266,532,47,5,Tie
1635,JointPQPlayer,207,207,414,25,37,Tie
1636,JointPQPlayer,238,243,481,44,21,JointPQPlayer
1637,JointPQPlayer,263,258,521,51,10,Player A
1638,JointPQPlayer,254,254,508,53,15,Tie
1639,JointPQPlayer,257,257,514,47,11,Tie
1640,JointPQPlayer,178,178,356,6,50,Tie
1641,JointPQPlayer,253,253,506,39,11,Tie
1642,JointPQPlayer,260,260,520,50,10,Tie
1643,JointPQPlayer,175,175,350,12,54,Tie
1644,JointPQPlayer,170,170,340,5,55,Tie
1645,JointPQPlayer,233,238,471,37,22,JointPQPlayer
1646,JointPQPlayer,260,255,515,54,13,Player A
1647,JointPQPlayer,188,193,381,7,42,JointPQPlayer
1648,JointPQPlayer,261,256,517,41,8,Player A
1649,JointPQPlayer,250,250,500,45,15,Tie
1650,JointPQPlayer,253,253,506,42,12,Tie
1651,JointPQPlayer,253,253,506,42,12,Tie
1652,JointPQPlayer,245,250,495,46,17,JointPQPlayer
1653,JointPQPlayer,217,212,429,25,32,Player A
1654,JointPQPlayer,246,251,497,48,17,JointPQPlayer
1655,JointPQPlayer,176,171,347,9,54,Player A
1656,JointPQPlayer,250,250,500,45,15,Tie
1657,JointPQPlayer,269,269,538,50,4,Tie
1658,JointPQPlayer,190,190,380,24,48,Tie
1659,JointPQPlayer,188,188,376,8,44,Tie
1660,JointPQPlayer,258,258,516,46,10,Tie
1661,JointPQPlayer,271,271,542,60,6,Tie
1662,JointPQPlayer,252,252,504,46,14,Tie
1663,JointPQPlayer,261,261,522,55,11,Tie
1664,JointPQPlayer,268,273,541,56,5,JointPQPlayer
1665,JointPQPlayer,251,246,497,36,13,Player A
1666,JointPQPlayer,199,204,403,23,40,JointPQPlayer
1667,JointPQPlayer,248,243,491,51,20,Player A
1668,JointPQPlayer,238,238,476,36,20,Tie
1669,JointPQPlayer,207,212,419,24,35,JointPQPlayer
1670,JointPQPlayer,234,229,463,41,26,Player A
1671,JointPQPlayer,244,244,488,39,17,Tie
1672,JointPQPlayer,180,185,365,6,47,JointPQPlayer
1673,JointPQPlayer,200,200,400,26,42,Tie
1674,JointPQPlayer,179,179,358,11,51,Tie
1675,JointPQPlayer,263,258,521,48,9,Player A
1676,JointPQPlayer,170,175,345,13,56,JointPQPlayer
1677,JointPQPlayer,227,222,449,33,28,Player A
1678,JointPQPlayer,252,252,504,55,17,Tie
1679,JointPQPlayer,264,269,533,48,5,JointPQPlayer
1680,JointPQPlayer,176,176,352,5,51,Tie
1681,JointPQPlayer,249,244,493,41,16,Player A
1682,JointPQPlayer,253,253,506,45,13,Tie
1683,JointPQPlayer,257,257,514,50,12,Tie
1684,JointPQPlayer,251,251,502,35,11,Tie
1685,JointPQPlayer,206,211,417,25,36,JointPQPlayer
1686,JointPQPlayer,255,250,505,38,11,Player A
1687,JointPQPlayer,207,212,419,27,36,JointPQPlayer
1688,JointPQPlayer,181,181,362,9,49,Tie
1689,JointPQPlayer,253,248,501,46,15,Player A
1690,JointPQPlayer,270,275,545,57,4,JointPQPlayer
1691,JointPQPlayer,243,238,481,38,19,Player A
1692,JointPQPlayer,265,265,530,51,7,Tie
1693,JointPQPlayer,214,214,428,24,32,Tie
1694,JointPQPlayer,238,238,476,33,19,Tie
1695,JointPQPlayer,259,259,518,48,10,Tie
1696,JointPQPlayer,176,181,357,13,52,JointPQPlayer
1697,JointPQPlayer,179,174,353,6,51,Player A
1698,JointPQPlayer,253,253,506,42,12,Tie
1699,JointPQPlayer,269,269,538,59,7,Tie
1700,JointPQPlayer,207,212,419,30,37,JointPQPlayer
1701,JointPQPlayer,183,183,366,16,50,Tie
1702,JointPQPlayer,262,257,519,46,9,Player A
1703,JointPQPlayer,173,178,351,7,52,JointPQPlayer
1704,JointPQPlayer,249,249,498,40,14,Tie
1705,JointPQPlayer,219,214,433,29,32,Player A
1706,JointPQPlayer,247,252,499,38,13,JointPQPlayer
1707,JointPQPlayer,199,199,398,24,42,Tie
1708,JointPQPlayer,251,251,502,38,12,Tie
1709,JointPQPlayer,246,241,487,41,18,Player A
1710,JointPQPlayer,261,261,522,49,9,Tie
1711,JointPQPlayer,254,254,508,44,12,Tie
1712,JointPQPlayer,248,248,496,41,15,Tie
1713,JointPQPlayer,234,234,468,40,24,Tie
1714,JointPQPlayer,269,269,538,50,4,Tie
1715,JointPQPlayer,224,229,453,34,27,JointPQPlayer
1716,JointPQPlayer,271,266,537,49,4,Player A
1717,JointPQPlayer,243,243,486,43,19,Tie
1718,JointPQPlayer,276,276,552,58,2,Tie
1719,JointPQPlayer,264,264,528,49,7,Tie
1720,JointPQPlayer,246,246,492,40,16,Tie
1721,JointPQPlayer,251,256,507,40,11,JointPQPlayer
1722,JointPQPlayer,255,250,505,38,11,Player A
1723,JointPQPlayer,249,249,498,49,17,Tie
1724,JointPQPlayer,270,270,540,55,5,Tie
1725,JointPQPlayer,171,176,347,12,55,JointPQPlayer
1726,JointPQPlayer,173,173,346,8,54,Tie
1727,JointPQPlayer,240,235,475,35,20,Player A
1728,JointPQPlayer,182,187,369,7,46,JointPQPlayer
1729,JointPQPlayer,230,225,455,39,28,Player A
1730,JointPQPlayer,179,184,363,16,51,JointPQPlayer
1731,JointPQPlayer,268,263,531,52,7,Player A
1732,JointPQPlayer,259,264,523,44,7,JointPQPlayer
1733,JointPQPlayer,239,234,473,33,20,Player A
1734,JointPQPlayer,266,266,532,53,7,Tie
1735,JointPQPlayer,238,238,476,39,21,Tie
1736,JointPQPlayer,272,272,544,59,5,Tie
1737,JointPQPlayer,269,269,538,56,6,Tie
1738,JointPQPlayer,246,251,497,42,15,JointPQPlayer
1739,JointPQPlayer,267,262,529,44,5,Player A
1740,JointPQPlayer,189,194,383,12,43,JointPQPlayer
1741,JointPQPlayer,248,243,491,45,18,Player A
1742,JointPQPlayer,262,262,524,51,9,Tie
1743,JointPQPlayer,265,265,530,54,8,Tie
1744,JointPQPlayer,189,194,383,9,42,JointPQPlayer
1745,JointPQPlayer,239,234,473,39,22,Player A
1746,JointPQPlayer,274,274,548,57,3,Tie
1747,JointPQPlayer,245,245,490,41,17,Tie
1748,JointPQPlayer,244,244,488,45,19,Tie
1749,JointPQPlayer,174,179,353,9,52,JointPQPlayer
1750,JointPQPlayer,155,155,310,2,64,Tie
1751,JointPQPlayer,249,244,493,38,15,Player A
1752,JointPQPlayer,268,268,536,54,6,Tie
1753,JointPQPlayer,274,274,548,63,5,Tie
1754,JointPQPlayer,272,277,549,61,4,JointPQPlayer
1755,JointPQPlayer,225,220,445,32,29,Player A
1756,JointPQPlayer,202,202,404,18,38,Tie
1757,JointPQPlayer,243,243,486,37,17,Tie
1758,JointPQPlayer,180,185,365,9,48,JointPQPlayer
1759,JointPQPlayer,254,249,503,42,13,Player A
1760,JointPQPlayer,254,254,508,47,13,Tie
1761,JointPQPlayer,269,269,538,59,7,Tie
1762,JointPQPlayer,262,267,529,44,5,JointPQPlayer
1763,JointPQPlayer,230,225,455,33,26,Player A
1764,JointPQPlayer,246,246,492,43,17,Tie
1765,JointPQPlayer,258,258,516,49,11,Tie
1766,JointPQPlayer,255,255,510,43,11,Tie
1767,JointPQPlayer,178,178,356,6,50,Tie
1768,JointPQPlayer,254,254,508,44,12,Tie
1769,JointPQPlayer,271,271,542,60,6,Tie
1770,JointPQPlayer,269,269,538,53,5,Tie
1771,JointPQPlayer,266,266,532,56,8,Tie
1772,JointPQPlayer,192,192,384,25,47,Tie
1773,JointPQPlayer,198,203,401,18,39,JointPQPlayer
1774,JointPQPlayer,232,227,459,34,25,Player A
1775,JointPQPlayer,252,257,509,42,11,JointPQPlayer
1776,JointPQPlayer,243,243,486,37,17,Tie
1777,JointPQPlayer,237,237,474,40,22,Tie
1778,JointPQPlayer,233,233,466,35,23,Tie
1779,JointPQPlayer,261,261,522,46,8,Tie
1780,JointPQPlayer,252,247,499,44,15,Player A
1781,JointPQPlayer,253,258,511,44,11,JointPQPlayer
1782,JointPQPlayer,173,173,346,8,54,Tie
1783,JointPQPlayer,248,243,491,45,18,Player A
1784,JointPQPlayer,255,255,510,46,12,Tie
1785,JointPQPlayer,252,252,504,49,15,Tie
1786,JointPQPlayer,255,255,510,43,11,Tie
1787,JointPQPlayer,247,252,499,35,12,JointPQPlayer
1788,JointPQPlayer,263,258,521,48,9,Player A
1789,JointPQPlayer,237,237,474,37,21,Tie
1790,JointPQPlayer,264,264,528,52,8,Tie
1791,JointPQPlayer,237,237,474,37,21,Tie
1792,JointPQPlayer,178,183,361,8,49,JointPQPlayer
1793,JointPQPlayer,219,219,438,28,30,Tie
1794,JointPQPlayer,231,231,462,40,26,Tie
1795,JointPQPlayer,164,159,323,9,62,Player A
1796,JointPQPlayer,262,267,529,53,8,JointPQPlayer
1797,JointPQPlayer,219,219,438,22,28,Tie
1798,JointPQPlayer,264,259,523,47,8,Player A
1799,JointPQPlayer,251,251,502,44,14,Tie
1800,JointPQPlayer,211,216,427,26,33,JointPQPlayer
1801,JointPQPlayer,184,184,368,15,49,Tie
1802,JointPQPlayer,175,170,345,7,54,Player A
1803,JointPQPlayer,216,216,432,31,33,Tie
1804,JointPQPlayer,271,271,542,54,4,Tie
1805,JointPQPlayer,174,174,348,7,53,Tie
1806,JointPQPlayer,259,259,518,39,7,Tie
1807,JointPQPlayer,191,196,387,22,45,JointPQPlayer
1808,JointPQPlayer,254,249,503,54,17,Player A
1809,JointPQPlayer,213,213,426,31,35,Tie
1810,JointPQPlayer,268,268,536,60,8,Tie
1811,JointPQPlayer,253,258,511,44,11,JointPQPlayer
1812,JointPQPlayer,260,255,515,48,11,Player A
1813,JointPQPlayer,254,259,513,40,9,JointPQPlayer
1814,JointPQPlayer,264,259,523,50,9,Player A
1815,JointPQPlayer,249,254,503,45,14,JointPQPlayer
1816,JointPQPlayer,259,259,518,42,8,Tie
1817,JointPQPlayer,264,259,523,47,8,Player A
1818,JointPQPlayer,197,202,399,16,39,JointPQPlayer
1819,JointPQPlayer,245,240,485,45,20,Player A
1820,JointPQPlayer,272,272,544,56,4,Tie
1821,JointPQPlayer,258,263,521,48,9,JointPQPlayer
1822,JointPQPlayer,247,247,494,42,16,Tie
1823,JointPQPlayer,276,276,552,58,2,Tie
1824,JointPQPlayer,239,234,473,39,22,Player A
1825,JointPQPlayer,254,254,508,47,13,Tie
1826,JointPQPlayer,209,209,418,20,34,Tie
1827,JointPQPlayer,177,182,359,9,50,JointPQPlayer
1828,JointPQPlayer,262,262,524,48,8,Tie
1829,JointPQPlayer,241,236,477,37,20,Player A
1830,JointPQPlayer,258,258,516,52,12,Tie
1831,JointPQPlayer,263,263,526,53,9,Tie
1832,JointPQPlayer,256,256,512,48,12,Tie
1833,JointPQPlayer,257,262,519,46,9,JointPQPlayer
1834,JointPQPlayer,268,263,531,49,6,Player A
1835,JointPQPlayer,220,225,445,35,30,JointPQPlayer
1836,JointPQPlayer,229,229,458,39,27,Tie
1837,JointPQPlayer,253,253,506,45,13,Tie
1838,JointPQPlayer,254,254,508,47,13,Tie
1839,JointPQPlayer,251,246,497,39,14,Player A
1840,JointPQPlayer,263,263,526,53,9,Tie
1841,JointPQPlayer,236,236,472,32,20,Tie
1842,JointPQPlayer,167,172,339,4,55,JointPQPlayer
1843,JointPQPlayer,261,256,517,47,10,Player A
1844,JointPQPlayer,190,190,380,21,47,Tie
1845,JointPQPlayer,247,252,499,44,15,JointPQPlayer
1846,JointPQPlayer,252,252,504,46,14,Tie
1847,JointPQPlayer,241,236,477,40,21,Player A
1848,JointPQPlayer,189,194,383,15,44,JointPQPlayer
1849,JointPQPlayer,251,246,497,45,16,Player A
1850,JointPQPlayer,254,254,508,47,13,Tie
1851,JointPQPlayer,218,218,436,26,30,Tie
1852,JointPQPlayer,252,252,504,40,12,Tie
1853,JointPQPlayer,260,260,520,47,9,Tie
1854,JointPQPlayer,264,264,528,52,8,Tie
1855,JointPQPlayer,163,168,331,5,58,JointPQPlayer
1856,JointPQPlayer,222,222,444,34,30,Tie
1857,JointPQPlayer,168,168,336,10,58,Tie
1858,JointPQPlayer,221,221,442,29,29,Tie
1859,JointPQPlayer,242,242,484,41,19,Tie
1860,JointPQPlayer,166,166,332,6,58,Tie
1861,JointPQPlayer,164,159,323,6,61,Player A
1862,JointPQPlayer,243,243,486,46,20,Tie
1863,JointPQPlayer,265,265,530,51,7,Tie
1864,JointPQPlayer,200,200,400,17,39,Tie
1865,JointPQPlayer,248,248,496,50,18,Tie
1866,JointPQPlayer,280,280,560,66,2,Tie
1867,JointPQPlayer,250,250,500,42,14,Tie
1868,JointPQPlayer,243,243,486,43,19,Tie
1869,JointPQPlayer,241,241,482,36,18,Tie
1870,JointPQPlayer,239,244,483,40,19,JointPQPlayer
1871,JointPQPlayer,179,179,358,11,51,Tie
1872,JointPQPlayer,176,171,347,6,53,Player A
1873,JointPQPlayer,237,237,474,40,22,Tie
1874,JointPQPlayer,203,203,406,26,40,Tie
1875,JointPQPlayer,246,246,492,37,15,Tie
1876,JointPQPlayer,157,162,319,5,62,JointPQPlayer
1877,JointPQPlayer,233,233,466,38,24,Tie
1878,JointPQPlayer,264,264,528,52,8,Tie
1879,JointPQPlayer,275,275,550,59,3,Tie
1880,JointPQPlayer,266,261,527,51,8,Player A
1881,JointPQPlayer,269,269,538,53,5,Tie
1882,JointPQPlayer,246,246,492,43,17,Tie
1883,JointPQPlayer,269,269,538,47,3,Tie
1884,JointPQPlayer,267,267,534,49,5,Tie
1885,JointPQPlayer,262,262,524,51,9,Tie
1886,JointPQPlayer,249,249,498,43,15,Tie
1887,JointPQPlayer,163,163,326,3,59,Tie
1888,JointPQPlayer,175,175,350,6,52,Tie
1889,JointPQPlayer,240,240,480,40,20,Tie
1890,JointPQPlayer,236,241,477,43,22,JointPQPlayer
1891,JointPQPlayer,245,245,490,41,17,Tie
1892,JointPQPlayer,244,244,488,42,18,Tie
1893,JointPQPlayer,224,219,443,27,28,Player A
1894,JointPQPlayer,239,239,478,35,19,Tie
1895,JointPQPlayer,232,232,464,39,25,Tie
1896,JointPQPlayer,170,170,340,5,55,Tie
1897,JointPQPlayer,215,220,435,28,31,JointPQPlayer
1898,JointPQPlayer,213,208,421,29,36,Player A
1899,JointPQPlayer,178,183,361,11,50,JointPQPlayer
1900,JointPQPlayer,245,245,490,44,18,Tie
1901,JointPQPlayer,172,172,344,6,54,Tie
1902,JointPQPlayer,271,266,537,58,7,Player A
1903,JointPQPlayer,224,229,453,40,29,JointPQPlayer
1904,JointPQPlayer,242,242,484,35,17,Tie
1905,JointPQPlayer,158,158,316,5,63,Tie
1906,JointPQPlayer,240,235,475,35,20,Player A
1907,JointPQPlayer,250,250,500,39,13,Tie
1908,JointPQPlayer,264,264,528,52,8,Tie
1909,JointPQPlayer,250,255,505,50,15,JointPQPlayer
1910,JointPQPlayer,184,184,368,9,47,Tie
1911,JointPQPlayer,258,258,516,43,9,Tie
1912,JointPQPlayer,211,206,417,25,36,Player A
1913,JointPQPlayer,270,275,545,57,4,JointPQPlayer
1914,JointPQPlayer,248,248,496,44,16,Tie
1915,JointPQPlayer,223,223,446,30,28,Tie
1916,JointPQPlayer,269,264,533,48,5,Player A
1917,JointPQPlayer,265,265,530,45,5,Tie
1918,JointPQPlayer,270,275,545,57,4,JointPQPlayer
1919,JointPQPlayer,195,195,390,19,43,Tie
1920,JointPQPlayer,232,232,464,33,23,Tie
1921,JointPQPlayer,234,229,463,41,26,Player A
1922,JointPQPlayer,266,266,532,53,7,Tie
1923,JointPQPlayer,243,248,491,48,19,JointPQPlayer
1924,JointPQPlayer,260,255,515,39,8,Player A
1925,JointPQPlayer,231,236,467,39,24,JointPQPlayer
1926,JointPQPlayer,260,255,515,42,9,Player A
1927,JointPQPlayer,262,267,529,53,8,JointPQPlayer
1928,JointPQPlayer,175,170,345,10,55,Player A
1929,JointPQPlayer,213,213,426,28,34,Tie
1930,JointPQPlayer,264,264,528,52,8,Tie
1931,JointPQPlayer,266,266,532,50,6,Tie
1932,JointPQPlayer,246,251,497,45,16,JointPQPlayer
1933,JointPQPlayer,255,250,505,47,14,Player A
1934,JointPQPlayer,257,257,514,41,9,Tie
1935,JointPQPlayer,241,241,482,39,19,Tie
1936,JointPQPlayer,233,233,466,38,24,Tie
1937,JointPQPlayer,269,269,538,56,6,Tie
1938,JointPQPlayer,248,248,496,38,14,Tie
1939,JointPQPlayer,241,246,487,38,17,JointPQPlayer
1940,JointPQPlayer,251,251,502,41,13,Tie
1941,JointPQPlayer,268,263,531,46,5,Player A
1942,JointPQPlayer,269,269,538,50,4,Tie
1943,JointPQPlayer,263,268,531,55,8,JointPQPlayer
1944,JointPQPlayer,257,252,509,42,11,Player A
1945,JointPQPlayer,245,245,490,41,17,Tie
1946,JointPQPlayer,261,261,522,52,10,Tie
1947,JointPQPlayer,237,242,479,39,20,JointPQPlayer
1948,JointPQPlayer,272,267,539,54,5,Player A
1949,JointPQPlayer,231,236,467,45,26,JointPQPlayer
1950,JointPQPlayer,275,270,545,60,5,Player A
1951,JointPQPlayer,183,188,371,12,47,JointPQPlayer
1952,JointPQPlayer,260,260,520,44,8,Tie
1953,JointPQPlayer,224,219,443,30,29,Player A
1954,JointPQPlayer,216,216,432,31,33,Tie
1955,JointPQPlayer,246,251,497,45,16,JointPQPlayer
1956,JointPQPlayer,266,261,527,48,7,Player A
1957,JointPQPlayer,259,259,518,48,10,Tie
1958,JointPQPlayer,264,264,528,49,7,Tie
1959,JointPQPlayer,173,173,346,5,53,Tie
1960,JointPQPlayer,243,243,486,37,17,Tie
1961,JointPQPlayer,264,264,528,52,8,Tie
1962,JointPQPlayer,253,258,511,41,10,JointPQPlayer
1963,JointPQPlayer,188,183,371,9,46,Player A
1964,JointPQPlayer,204,204,408,16,36,Tie
1965,JointPQPlayer,241,241,482,42,20,Tie
1966,JointPQPlayer,261,261,522,52,10,Tie
1967,JointPQPlayer,260,260,520,47,9,Tie
1968,JointPQPlayer,256,256,512,51,13,Tie
1969,JointPQPlayer,242,242,484,47,21,Tie
1970,JointPQPlayer,236,241,477,40,21,JointPQPlayer
1971,JointPQPlayer,265,265,530,51,7,Tie
1972,JointPQPlayer,248,243,491,45,18,Player A
1973,JointPQPlayer,233,238,471,43,24,JointPQPlayer
1974,JointPQPlayer,249,249,498,43,15,Tie
1975,JointPQPlayer,255,250,505,47,14,Player A
1976,JointPQPlayer,265,265,530,51,7,Tie
1977,JointPQPlayer,219,219,438,31,31,Tie
1978,JointPQPlayer,252,252,504,43,13,Tie
1979,JointPQPlayer,207,212,419,27,36,JointPQPlayer
1980,JointPQPlayer,245,240,485,42,19,Player A
1981,JointPQPlayer,266,271,537,55,6,JointPQPlayer
1982,JointPQPlayer,213,213,426,16,30,Tie
1983,JointPQPlayer,249,249,498,46,16,Tie
1984,JointPQPlayer,250,245,495,46,17,Player A
1985,JointPQPlayer,257,257,514,44,10,Tie
1986,JointPQPlayer,274,274,548,57,3,Tie
1987,JointPQPlayer,260,260,520,44,8,Tie
1988,JointPQPlayer,214,214,428,33,35,Tie
1989,JointPQPlayer,267,272,539,60,7,JointPQPlayer
1990,JointPQPlayer,202,202,404,21,39,Tie
1991,JointPQPlayer,263,258,521,51,10,Player A
1992,JointPQPlayer,275,275,550,56,2,Tie
1993,JointPQPlayer,263,263,526,53,9,Tie
1994,JointPQPlayer,187,192,379,14,45,JointPQPlayer
1995,JointPQPlayer,250,245,495,40,15,Player A
1996,JointPQPlayer,164,169,333,7,58,JointPQPlayer
1997,JointPQPlayer,163,163,326,3,59,Tie
1998,JointPQPlayer,258,258,516,46,10,Tie
1999,JointPQPlayer,252,247,499,41,14,Player A
2000,JointPQPlayer,264,264,528,52,8,Tie
2001,JointPQPlayer,274,274,548,60,4,Tie
2002,JointPQPlayer,265,270,535,56,7,JointPQPlayer
2003,JointPQPlayer,242,237,479,39,20,Player A
2004,JointPQPlayer,202,207,409,23,38,JointPQPlayer
2005,JointPQPlayer,258,253,511,50,13,Player A
2006,JointPQPlayer,269,274,543,58,5,JointPQPlayer
2007,JointPQPlayer,216,211,427,26,33,Player A
2008,JointPQPlayer,236,241,477,43,22,JointPQPlayer
2009,JointPQPlayer,177,177,354,7,51,Tie
2010,JointPQPlayer,260,260,520,50,10,Tie
2011,JointPQPlayer,256,256,512,39,9,Tie
2012,JointPQPlayer,239,234,473,36,21,Player A
2013,JointPQPlayer,253,253,506,48,14,Tie
2014,JointPQPlayer,250,250,500,45,15,Tie
2015,JointPQPlayer,230,230,460,35,25,Tie
2016,JointPQPlayer,266,271,537,52,5,JointPQPlayer
2017,JointPQPlayer,250,245,495,40,15,Player A
2018,JointPQPlayer,217,217,434,33,33,Tie
2019,JointPQPlayer,268,268,536,51,5,Tie
2020,JointPQPlayer,252,257,509,45,12,JointPQPlayer
2021,JointPQPlayer,253,253,506,42,12,Tie
2022,JointPQPlayer,189,184,373,11,46,Player A
2023,JointPQPlayer,214,214,428,30,34,Tie
2024,JointPQPlayer,268,268,536,57,7,Tie
2025,JointPQPlayer,206,206,412,26,38,Tie
2026,JointPQPlayer,270,270,540,58,6,Tie
2027,JointPQPlayer,240,240,480,34,18,Tie
2028,JointPQPlayer,257,257,514,53,13,Tie
2029,JointPQPlayer,249,249,498,40,14,Tie
2030,JointPQPlayer,226,226,452,36,28,Tie
2031,JointPQPlayer,242,242,484,44,20,Tie
2032,JointPQPlayer,164,169,333,10,59,JointPQPlayer
2033,JointPQPlayer,254,249,503,45,14,Player A
2034,JointPQPlayer,241,246,487,38,17,JointPQPlayer
2035,JointPQPlayer,235,230,465,40,25,Player A
2036,JointPQPlayer,248,253,501,37,12,JointPQPlayer
2037,JointPQPlayer,249,244,493,44,17,Player A
2038,JointPQPlayer,253,258,511,47,12,JointPQPlayer
2039,JointPQPlayer,256,251,507,43,12,Player A
2040,JointPQPlayer,240,240,480,43,21,Tie
2041,JointPQPlayer,248,248,496,38,14,Tie
2042,JointPQPlayer,254,259,513,52,13,JointPQPlayer
2043,JointPQPlayer,220,215,435,25,30,Player A
2044,JointPQPlayer,247,252,499,38,13,JointPQPlayer
2045,JointPQPlayer,263,258,521,45,8,Player A
2046,JointPQPlayer,250,250,500,39,13,Tie
2047,JointPQPlayer,253,253,506,45,13,Tie
2048,JointPQPlayer,194,199,393,13,40,JointPQPlayer
2049,JointPQPlayer,240,235,475,41,22,Player A
2050,JointPQPlayer,261,261,522,46,8,Tie
2051,JointPQPlayer,249,254,503,48,15,JointPQPlayer
2052,JointPQPlayer,261,261,522,43,7,Tie
2053,JointPQPlayer,166,161,327,7,60,Player A
2054,JointPQPlayer,246,251,497,39,14,JointPQPlayer
2055,JointPQPlayer,259,254,513,46,11,Player A
2056,JointPQPlayer,250,250,500,51,17,Tie
2057,JointPQPlayer,265,265,530,51,7,Tie
2058,JointPQPlayer,254,254,508,47,13,Tie
2059,JointPQPlayer,257,257,514,50,12,Tie
2060,JointPQPlayer,263,263,526,47,7,Tie
2061,JointPQPlayer,269,274,543,55,4,JointPQPlayer
2062,JointPQPlayer,261,256,517,47,10,Player A
2063,JointPQPlayer,250,250,500,42,14,Tie
2064,JointPQPlayer,239,239,478,38,20,Tie
2065,JointPQPlayer,222,222,444,31,29,Tie
2066,JointPQPlayer,259,259,518,39,7,Tie
2067,JointPQPlayer,268,268,536,54,6,Tie
2068,JointPQPlayer,238,238,476,39,21,Tie
2069,JointPQPlayer,273,273,546,58,4,Tie
2070,JointPQPlayer,242,247,489,43,18,JointPQPlayer
2071,JointPQPlayer,267,262,529,50,7,Player A
2072,JointPQPlayer,247,247,494,45,17,Tie
2073,JointPQPlayer,265,270,535,56,7,JointPQPlayer
2074,JointPQPlayer,259,259,518,48,10,Tie
2075,JointPQPlayer,264,264,528,49,7,Tie
2076,JointPQPlayer,238,233,471,34,21,Player A
2077,JointPQPlayer,244,244,488,39,17,Tie
2078,JointPQPlayer,257,262,519,49,10,JointPQPlayer
2079,JointPQPlayer,245,240,485,42,19,Player A
2080,JointPQPlayer,252,252,504,46,14,Tie
2081,JointPQPlayer,241,246,487,35,16,JointPQPlayer
2082,JointPQPlayer,251,246,497,48,17,Player A
2083,JointPQPlayer,260,265,525,52,9,JointPQPlayer
2084,JointPQPlayer,258,258,516,49,11,Tie
2085,JointPQPlayer,256,251,507,46,13,Player A
2086,JointPQPlayer,269,269,538,59,7,Tie
2087,JointPQPlayer,264,264,528,58,10,Tie
2088,JointPQPlayer,189,189,378,10,44,Tie
2089,JointPQPlayer,163,168,331,5,58,JointPQPlayer
2090,JointPQPlayer,251,251,502,44,14,Tie
2091,JointPQPlayer,216,216,432,31,33,Tie
2092,JointPQPlayer,269,264,533,51,6,Player A
2093,JointPQPlayer,250,250,500,48,16,Tie
2094,JointPQPlayer,185,190,375,13,46,JointPQPlayer
2095,JointPQPlayer,218,218,436,38,34,Tie
2096,JointPQPlayer,219,214,433,29,32,Player A
2097,JointPQPlayer,177,182,359,9,50,JointPQPlayer
2098,JointPQPlayer,181,176,357,13,52,Player A
2099,JointPQPlayer,262,262,524,48,8,Tie
2100,JointPQPlayer,268,268,536,48,4,Tie
2101,JointPQPlayer,242,242,484,41,19,Tie
2102,JointPQPlayer,243,243,486,40,18,Tie
2103,JointPQPlayer,174,179,353,9,52,JointPQPlayer
2104,JointPQPlayer,251,246,497,45,16,Player A
2105,JointPQPlayer,161,166,327,7,60,JointPQPlayer
2106,JointPQPlayer,244,239,483,43,20,Player A
2107,JointPQPlayer,208,208,416,24,36,Tie
2108,JointPQPlayer,256,256,512,45,11,Tie
2109,JointPQPlayer,218,218,436,32,32,Tie
2110,JointPQPlayer,267,272,539,51,4,JointPQPlayer
2111,JointPQPlayer,238,238,476,30,18,Tie
2112,JointPQPlayer,251,246,497,48,17,Player A
2113,JointPQPlayer,245,245,490,38,16,Tie
2114,JointPQPlayer,247,247,494,33,13,Tie
2115,JointPQPlayer,248,253,501,46,15,JointPQPlayer
2116,JointPQPlayer,275,270,545,63,6,Player A
2117,JointPQPlayer,264,264,528,43,5,Tie
2118,JointPQPlayer,261,261,522,46,8,Tie
2119,JointPQPlayer,154,159,313,5,64,JointPQPlayer
2120,JointPQPlayer,260,255,515,51,12,Player A
2121,JointPQPlayer,187,192,379,8,43,JointPQPlayer
2122,JointPQPlayer,248,248,496,44,16,Tie
2123,JointPQPlayer,246,241,487,32,15,Player A
2124,JointPQPlayer,255,260,515,45,10,JointPQPlayer
2125,JointPQPlayer,253,253,506,45,13,Tie
2126,JointPQPlayer,272,267,539,54,5,Player A
2127,JointPQPlayer,263,263,526,47,7,Tie
2128,JointPQPlayer,210,210,420,25,35,Tie
2129,JointPQPlayer,251,251,502,38,12,Tie
2130,JointPQPlayer,271,271,542,54,4,Tie
2131,JointPQPlayer,245,250,495,43,16,JointPQPlayer
2132,JointPQPlayer,238,233,471,34,21,Player A
2133,JointPQPlayer,272,277,549,58,3,JointPQPlayer
2134,JointPQPlayer,247,242,489,43,18,Player A
2135,JointPQPlayer,264,264,528,52,8,Tie
2136,JointPQPlayer,266,266,532,47,5,Tie
2137,JointPQPlayer,182,182,364,11,49,Tie
2138,JointPQPlayer,261,261,522,46,8,Tie
2139,JointPQPlayer,239,239,478,35,19,Tie
2140,JointPQPlayer,171,176,347,6,53,JointPQPlayer
2141,JointPQPlayer,260,255,515,48,11,Player A
2142,JointPQPlayer,243,243,486,43,19,Tie
2143,JointPQPlayer,244,249,493,41,16,JointPQPlayer
2144,JointPQPlayer,261,261,522,46,8,Tie
2145,JointPQPlayer,260,260,520,47,9,Tie
2146,JointPQPlayer,265,260,525,52,9,Player A
2147,JointPQPlayer,262,262,524,51,9,Tie
2148,JointPQPlayer,264,264,528,49,7,Tie
2149,JointPQPlayer,236,236,472,35,21,Tie
2150,JointPQPlayer,252,257,509,36,9,JointPQPlayer
2151,JointPQPlayer,263,258,521,48,9,Player A
2152,JointPQPlayer,273,273,546,58,4,Tie
2153,JointPQPlayer,253,253,506,42,12,Tie
2154,JointPQPlayer,213,218,431,27,32,JointPQPlayer
2155,JointPQPlayer,236,231,467,42,25,Player A
2156,JointPQPlayer,171,176,347,9,54,JointPQPlayer
2157,JointPQPlayer,165,165,330,4,58,Tie
2158,JointPQPlayer,189,189,378,10,44,Tie
2159,JointPQPlayer,190,185,375,13,46,Player A
2160,JointPQPlayer,259,259,518,48,10,Tie
2161,JointPQPlayer,252,252,504,43,13,Tie
2162,JointPQPlayer,267,267,534,43,3,Tie
2163,JointPQPlayer,247,247,494,45,17,Tie
2164,JointPQPlayer,216,221,437,27,30,JointPQPlayer
2165,JointPQPlayer,250,245,495,49,18,Player A
2166,JointPQPlayer,260,260,520,62,14,Tie
2167,JointPQPlayer,240,240,480,40,20,Tie
2168,JointPQPlayer,260,260,520,44,8,Tie
2169,JointPQPlayer,252,257,509,48,13,JointPQPlayer
2170,JointPQPlayer,250,245,495,40,15,Player A
2171,JointPQPlayer,254,259,513,40,9,JointPQPlayer
2172,JointPQPlayer,252,247,499,44,15,Player A
2173,JointPQPlayer,271,271,542,57,5,Tie
2174,JointPQPlayer,249,254,503,48,15,JointPQPlayer
2175,JointPQPlayer,240,235,475,41,22,Player A
2176,JointPQPlayer,251,256,507,46,13,JointPQPlayer
2177,JointPQPlayer,266,266,532,47,5,Tie
2178,JointPQPlayer,255,250,505,44,13,Player A
2179,JointPQPlayer,270,270,540,61,7,Tie
2180,JointPQPlayer,247,247,494,42,16,Tie
2181,JointPQPlayer,270,270,540,61,7,Tie
2182,JointPQPlayer,268,268,536,54,6,Tie
2183,JointPQPlayer,257,257,514,50,12,Tie
2184,JointPQPlayer,265,270,535,47,4,JointPQPlayer
2185,JointPQPlayer,257,252,509,45,12,Player A
2186,JointPQPlayer,218,223,441,31,30,JointPQPlayer
2187,JointPQPlayer,255,250,505,47,14,Player A
2188,JointPQPlayer,253,258,511,50,13,JointPQPlayer
2189,JointPQPlayer,274,274,548,57,3,Tie
2190,JointPQPlayer,267,262,529,50,7,Player A
2191,JointPQPlayer,236,236,472,41,23,Tie
2192,JointPQPlayer,234,234,468,37,23,Tie
2193,JointPQPlayer,258,258,516,49,11,Tie
2194,JointPQPlayer,220,225,445,32,29,JointPQPlayer
2195,JointPQPlayer,263,258,521,42,7,Player A
2196,JointPQPlayer,251,251,502,47,15,Tie
2197,JointPQPlayer,251,256,507,49,14,JointPQPlayer
2198,JointPQPlayer,215,210,425,21,32,Player A
2199,JointPQPlayer,270,270,540,58,6,Tie
2200,JointPQPlayer,264,264,528,46,6,Tie
2201,JointPQPlayer,215,215,430,23,31,Tie
2202,JointPQPlayer,263,268,531,43,4,JointPQPlayer
2203,JointPQPlayer,267,262,529,56,9,Player A
2204,JointPQPlayer,260,260,520,50,10,Tie
2205,JointPQPlayer,252,257,509,48,13,JointPQPlayer
2206,JointPQPlayer,240,240,480,31,17,Tie
2207,JointPQPlayer,254,249,503,48,15,Player A
2208,JointPQPlayer,249,254,503,39,12,JointPQPlayer
2209,JointPQPlayer,255,255,510,55,15,Tie
2210,JointPQPlayer,259,254,513,46,11,Player A
2211,JointPQPlayer,247,247,494,45,17,Tie
2212,JointPQPlayer,269,274,543,52,3,JointPQPlayer
2213,JointPQPlayer,223,218,441,37,32,Player A
2214,JointPQPlayer,241,241,482,51,23,Tie
2215,JointPQPlayer,242,242,484,44,20,Tie
2216,JointPQPlayer,262,267,529,50,7,JointPQPlayer
2217,JointPQPlayer,264,259,523,53,10,Player A
2218,JointPQPlayer,242,247,489,43,18,JointPQPlayer
2219,JointPQPlayer,260,255,515,39,8,Player A
2220,JointPQPlayer,259,259,518,51,11,Tie
2221,JointPQPlayer,269,269,538,53,5,Tie
2222,JointPQPlayer,185,185,370,14,48,Tie
2223,JointPQPlayer,275,275,550,53,1,Tie
2224,JointPQPlayer,257,257,514,56,14,Tie
2225,JointPQPlayer,248,248,496,35,13,Tie
2226,JointPQPlayer,264,264,528,55,9,Tie
2227,JointPQPlayer,243,243,486,31,15,Tie
2228,JointPQPlayer,255,255,510,49,13,Tie
2229,JointPQPlayer,267,267,534,58,8,Tie
2230,JointPQPlayer,253,253,506,48,14,Tie
2231,JointPQPlayer,250,255,505,47,14,JointPQPlayer
2232,JointPQPlayer,248,248,496,41,15,Tie
2233,JointPQPlayer,201,196,397,14,39,Player A
2234,JointPQPlayer,227,227,454,41,29,Tie
2235,JointPQPlayer,210,215,425,24,33,JointPQPlayer
2236,JointPQPlayer,233,228,461,36,25,Player A
2237,JointPQPlayer,186,191,377,12,45,JointPQPlayer
2238,JointPQPlayer,255,250,505,41,12,Player A
2239,JointPQPlayer,228,233,461,39,26,JointPQPlayer
2240,JointPQPlayer,227,227,454,29,25,Tie
2241,JointPQPlayer,271,266,537,52,5,Player A
2242,JointPQPlayer,269,269,538,50,4,Tie
2243,JointPQPlayer,241,241,482,39,19,Tie
2244,JointPQPlayer,242,247,489,40,17,JointPQPlayer
2245,JointPQPlayer,265,260,525,52,9,Player A
2246,JointPQPlayer,253,253,506,51,15,Tie
2247,JointPQPlayer,270,270,540,52,4,Tie
2248,JointPQPlayer,197,202,399,25,42,JointPQPlayer
2249,JointPQPlayer,261,261,522,55,11,Tie
2250,JointPQPlayer,195,190,385,14,43,Player A
2251,JointPQPlayer,181,181,362,9,49,Tie
2252,JointPQPlayer,259,259,518,48,10,Tie
2253,JointPQPlayer,266,271,537,52,5,JointPQPlayer
2254,JointPQPlayer,173,173,346,11,55,Tie
2255,JointPQPlayer,182,182,364,8,48,Tie
2256,JointPQPlayer,262,257,519,52,11,Player A
2257,JointPQPlayer,263,268,531,49,6,JointPQPlayer
2258,JointPQPlayer,175,175,350,12,54,Tie
2259,JointPQPlayer,199,199,398,18,40,Tie
2260,JointPQPlayer,218,213,431,33,34,Player A
2261,JointPQPlayer,265,265,530,54,8,Tie
2262,JointPQPlayer,250,250,500,39,13,Tie
2263,JointPQPlayer,264,264,528,52,8,Tie
2264,JointPQPlayer,264,264,528,46,6,Tie
2265,JointPQPlayer,239,244,483,37,18,JointPQPlayer
2266,JointPQPlayer,221,216,437,33,32,Player A
2267,JointPQPlayer,256,256,512,51,13,Tie
2268,JointPQPlayer,273,273,546,58,4,Tie
2269,JointPQPlayer,252,252,504,43,13,Tie
2270,JointPQPlayer,248,248,496,38,14,Tie
2271,JointPQPlayer,248,248,496,47,17,Tie
2272,JointPQPlayer,231,236,467,36,23,JointPQPlayer
2273,JointPQPlayer,221,216,437,30,31,Player A
2274,JointPQPlayer,273,273,546,58,4,Tie
2275,JointPQPlayer,208,213,421,35,38,JointPQPlayer
2276,JointPQPlayer,254,249,503,45,14,Player A
2277,JointPQPlayer,252,252,504,43,13,Tie
2278,JointPQPlayer,266,271,537,58,7,JointPQPlayer
2279,JointPQPlayer,247,242,489,43,18,Player A
2280,JointPQPlayer,256,256,512,42,10,Tie
2281,JointPQPlayer,259,259,518,51,11,Tie
2282,JointPQPlayer,260,260,520,47,9,Tie
2283,JointPQPlayer,256,256,512,48,12,Tie
2284,JointPQPlayer,253,253,506,48,14,Tie
2285,JointPQPlayer,205,210,415,26,37,JointPQPlayer
2286,JointPQPlayer,252,252,504,43,13,Tie
2287,JointPQPlayer,259,259,518,51,11,Tie
2288,JointPQPlayer,218,218,436,32,32,Tie
2289,JointPQPlayer,268,263,531,49,6,Player A
2290,JointPQPlayer,253,258,511,41,10,JointPQPlayer
2291,JointPQPlayer,256,251,507,40,11,Player A
2292,JointPQPlayer,261,266,527,57,10,JointPQPlayer
2293,JointPQPlayer,265,260,525,49,8,Player A
2294,JointPQPlayer,200,200,400,17,39,Tie
2295,JointPQPlayer,260,260,520,41,7,Tie
2296,JointPQPlayer,196,196,392,12,40,Tie
2297,JointPQPlayer,262,262,524,51,9,Tie
2298,JointPQPlayer,249,249,498,43,15,Tie
2299,JointPQPlayer,259,259,518,48,10,Tie
2300,JointPQPlayer,174,179,353,12,53,JointPQPlayer
2301,JointPQPlayer,216,216,432,28,32,Tie
2302,JointPQPlayer,247,247,494,36,14,Tie
2303,JointPQPlayer,258,253,511,44,11,Player A
2304,JointPQPlayer,167,172,339,7,56,JointPQPlayer
2305,JointPQPlayer,277,277,554,66,4,Tie
2306,JointPQPlayer,244,239,483,43,20,Player A
2307,JointPQPlayer,209,209,418,23,35,Tie
2308,JointPQPlayer,260,265,525,49,8,JointPQPlayer
2309,JointPQPlayer,253,248,501,46,15,Player A
2310,JointPQPlayer,260,265,525,52,9,JointPQPlayer
2311,JointPQPlayer,274,269,543,64,7,Player A
2312,JointPQPlayer,262,262,524,42,6,Tie
2313,JointPQPlayer,253,253,506,42,12,Tie
2314,JointPQPlayer,255,255,510,43,11,Tie
2315,JointPQPlayer,235,240,475,35,20,JointPQPlayer
2316,JointPQPlayer,266,261,527,51,8,Player A
2317,JointPQPlayer,247,252,499,38,13,JointPQPlayer
2318,JointPQPlayer,260,255,515,42,9,Player A
2319,JointPQPlayer,251,251,502,41,13,Tie
2320,JointPQPlayer,181,186,367,11,48,JointPQPlayer
2321,JointPQPlayer,214,209,423,28,35,Player A
2322,JointPQPlayer,254,259,513,52,13,JointPQPlayer
2323,JointPQPlayer,237,237,474,37,21,Tie
2324,JointPQPlayer,255,255,510,46,12,Tie
2325,JointPQPlayer,242,237,479,42,21,Player A
2326,JointPQPlayer,226,231,457,38,27,JointPQPlayer
2327,JointPQPlayer,189,184,373,14,47,Player A
2328,JointPQPlayer,262,262,524,54,10,Tie
2329,JointPQPlayer,266,266,532,47,5,Tie
2330,JointPQPlayer,244,244,488,45,19,Tie
2331,JointPQPlayer,273,273,546,58,4,Tie
2332,JointPQPlayer,173,178,351,4,51,JointPQPlayer
2333,JointPQPlayer,261,256,517,56,13,Player A
2334,JointPQPlayer,263,263,526,50,8,Tie
2335,JointPQPlayer,260,265,525,46,7,JointPQPlayer
2336,JointPQPlayer,214,209,423,28,35,Player A
2337,JointPQPlayer,189,189,378,13,45,Tie
2338,JointPQPlayer,218,218,436,29,31,Tie
2339,JointPQPlayer,240,245,485,33,16,JointPQPlayer
2340,JointPQPlayer,271,266,537,49,4,Player A
2341,JointPQPlayer,261,261,522,55,11,Tie
2342,JointPQPlayer,241,241,482,45,21,Tie
2343,JointPQPlayer,257,257,514,44,10,Tie
2344,JointPQPlayer,248,248,496,35,13,Tie
2345,JointPQPlayer,213,218,431,30,33,JointPQPlayer
2346,JointPQPlayer,260,255,515,48,11,Player A
2347,JointPQPlayer,215,220,435,28,31,JointPQPlayer
2348,JointPQPlayer,262,262,524,51,9,Tie
2349,JointPQPlayer,256,256,512,51,13,Tie
2350,JointPQPlayer,167,167,334,5,57,Tie
2351,JointPQPlayer,252,247,499,44,15,Player A
2352,JointPQPlayer,240,240,480,40,20,Tie
2353,JointPQPlayer,263,263,526,50,8,Tie
2354,JointPQPlayer,256,261,517,50,11,JointPQPlayer
2355,JointPQPlayer,275,270,545,60,5,Player A
2356,JointPQPlayer,180,185,365,9,48,JointPQPlayer
2357,JointPQPlayer,245,240,485,36,17,Player A
2358,JointPQPlayer,254,259,513,49,12,JointPQPlayer
2359,JointPQPlayer,246,241,487,41,18,Player A
2360,JointPQPlayer,250,250,500,45,15,Tie
2361,JointPQPlayer,243,243,486,43,19,Tie
2362,JointPQPlayer,242,247,489,40,17,JointPQPlayer
2363,JointPQPlayer,233,228,461,27,22,Player A
2364,JointPQPlayer,237,237,474,43,23,Tie
2365,JointPQPlayer,260,260,520,50,10,Tie
2366,JointPQPlayer,270,270,540,58,6,Tie
2367,JointPQPlayer,257,257,514,47,11,Tie
2368,JointPQPlayer,267,267,534,52,6,Tie
2369,JointPQPlayer,254,254,508,50,14,Tie
2370,JointPQPlayer,271,271,542,54,4,Tie
2371,JointPQPlayer,169,169,338,9,57,Tie
2372,JointPQPlayer,257,257,514,50,12,Tie
2373,JointPQPlayer,172,177,349,5,52,JointPQPlayer
2374,JointPQPlayer,217,217,434,33,33,Tie
2375,JointPQPlayer,266,261,527,48,7,Player A
2376,JointPQPlayer,265,265,530,48,6,Tie
2377,JointPQPlayer,225,230,455,39,28,JointPQPlayer
2378,JointPQPlayer,269,264,533,54,7,Player A
2379,JointPQPlayer,201,201,402,28,42,Tie
2380,JointPQPlayer,245,250,495,37,14,JointPQPlayer
2381,JointPQPlayer,171,171,342,7,55,Tie
2382,JointPQPlayer,256,251,507,49,14,Player A
2383,JointPQPlayer,251,256,507,43,12,JointPQPlayer
2384,JointPQPlayer,268,263,531,49,6,Player A
2385,JointPQPlayer,251,256,507,43,12,JointPQPlayer
2386,JointPQPlayer,276,271,547,62,5,Player A
2387,JointPQPlayer,236,236,472,41,23,Tie
2388,JointPQPlayer,203,203,406,20,38,Tie
2389,JointPQPlayer,256,256,512,48,12,Tie
2390,JointPQPlayer,261,261,522,52,10,Tie
2391,JointPQPlayer,236,241,477,40,21,JointPQPlayer
2392,JointPQPlayer,236,231,467,33,22,Player A
2393,JointPQPlayer,255,255,510,52,14,Tie
2394,JointPQPlayer,238,243,481,44,21,JointPQPlayer
2395,JointPQPlayer,246,246,492,37,15,Tie
2396,JointPQPlayer,188,188,376,17,47,Tie
2397,JointPQPlayer,263,258,521,57,12,Player A
2398,JointPQPlayer,257,257,514,44,10,Tie
2399,JointPQPlayer,261,261,522,46,8,Tie
2400,JointPQPlayer,223,228,451,35,28,JointPQPlayer
2401,JointPQPlayer,202,197,399,28,43,Player A
2402,JointPQPlayer,181,186,367,11,48,JointPQPlayer
2403,JointPQPlayer,186,186,372,16,48,Tie
2404,JointPQPlayer,181,176,357,10,51,Player A
2405,JointPQPlayer,226,226,452,27,25,Tie
2406,JointPQPlayer,229,229,458,36,26,Tie
2407,JointPQPlayer,254,254,508,44,12,Tie
2408,JointPQPlayer,223,223,446,33,29,Tie
2409,JointPQPlayer,201,206,407,30,41,JointPQPlayer
2410,JointPQPlayer,256,256,512,42,10,Tie
2411,JointPQPlayer,260,255,515,42,9,Player A
2412,JointPQPlayer,242,247,489,40,17,JointPQPlayer
2413,JointPQPlayer,185,180,365,12,49,Player A
2414,JointPQPlayer,221,221,442,29,29,Tie
2415,JointPQPlayer,257,262,519,43,8,JointPQPlayer
2416,JointPQPlayer,177,172,349,5,52,Player A
2417,JointPQPlayer,240,240,480,40,20,Tie
2418,JointPQPlayer,266,266,532,56,8,Tie
2419,JointPQPlayer,271,276,547,59,4,JointPQPlayer
2420,JointPQPlayer,267,267,534,58,8,Tie
2421,JointPQPlayer,251,251,502,44,14,Tie
2422,JointPQPlayer,263,263,526,56,10,Tie
2423,JointPQPlayer,283,278,561,67,2,Player A
2424,JointPQPlayer,172,177,349,11,54,JointPQPlayer
2425,JointPQPlayer,261,261,522,49,9,Tie
2426,JointPQPlayer,227,222,449,33,28,Player A
2427,JointPQPlayer,219,219,438,34,32,Tie
2428,JointPQPlayer,204,204,408,19,37,Tie
2429,JointPQPlayer,250,250,500,42,14,Tie
2430,JointPQPlayer,202,207,409,17,36,JointPQPlayer
2431,JointPQPlayer,272,267,539,54,5,Player A
2432,JointPQPlayer,220,225,445,35,30,JointPQPlayer
2433,JointPQPlayer,273,273,546,55,3,Tie
2434,JointPQPlayer,248,243,491,48,19,Player A
2435,JointPQPlayer,268,268,536,51,5,Tie
2436,JointPQPlayer,264,264,528,55,9,Tie
2437,JointPQPlayer,256,261,517,44,9,JointPQPlayer
2438,JointPQPlayer,264,259,523,50,9,Player A
2439,JointPQPlayer,253,253,506,45,13,Tie
2440,JointPQPlayer,246,246,492,40,16,Tie
2441,JointPQPlayer,246,246,492,46,18,Tie
2442,JointPQPlayer,255,260,515,54,13,JointPQPlayer
2443,JointPQPlayer,220,215,435,31,32,Player A
2444,JointPQPlayer,268,268,536,48,4,Tie
2445,JointPQPlayer,206,211,417,22,35,JointPQPlayer
2446,JointPQPlayer,268,263,531,52,7,Player A
2447,JointPQPlayer,254,259,513,40,9,JointPQPlayer
2448,JointPQPlayer,251,251,502,44,14,Tie
2449,JointPQPlayer,240,235,475,38,21,Player A
2450,JointPQPlayer,159,164,323,6,61,JointPQPlayer
2451,JointPQPlayer,262,257,519,46,9,Player A
2452,JointPQPlayer,267,272,539,54,5,JointPQPlayer
2453,JointPQPlayer,267,262,529,53,8,Player A
2454,JointPQPlayer,253,258,511,44,11,JointPQPlayer
2455,JointPQPlayer,277,272,549,61,4,Player A
2456,JointPQPlayer,251,256,507,49,14,JointPQPlayer
2457,JointPQPlayer,227,227,454,44,30,Tie
2458,JointPQPlayer,246,246,492,43,17,Tie
2459,JointPQPlayer,250,245,495,46,17,Player A
2460,JointPQPlayer,236,241,477,37,20,JointPQPlayer
2461,JointPQPlayer,273,268,541,59,6,Player A
2462,JointPQPlayer,258,258,516,46,10,Tie
2463,JointPQPlayer,259,259,518,48,10,Tie
2464,JointPQPlayer,237,242,479,39,20,JointPQPlayer
2465,JointPQPlayer,258,253,511,47,12,Player A
2466,JointPQPlayer,238,238,476,36,20,Tie
2467,JointPQPlayer,176,181,357,7,50,JointPQPlayer
2468,JointPQPlayer,226,221,447,28,27,Player A
2469,JointPQPlayer,257,257,514,47,11,Tie
2470,JointPQPlayer,246,246,492,40,16,Tie
2471,JointPQPlayer,266,271,537,61,8,JointPQPlayer
2472,JointPQPlayer,225,225,450,37,29,Tie
2473,JointPQPlayer,175,175,350,9,53,Tie
2474,JointPQPlayer,267,262,529,53,8,Player A
2475,JointPQPlayer,268,268,536,51,5,Tie
2476,JointPQPlayer,230,235,465,40,25,JointPQPlayer
2477,JointPQPlayer,272,267,539,57,6,Player A
2478,JointPQPlayer,268,268,536,60,8,Tie
2479,JointPQPlayer,255,255,510,52,14,Tie
2480,JointPQPlayer,254,254,508,47,13,Tie
2481,JointPQPlayer,274,274,548,54,2,Tie
2482,JointPQPlayer,262,262,524,51,9,Tie
2483,JointPQPlayer,251,251,502,41,13,Tie
2484,JointPQPlayer,171,176,347,3,52,JointPQPlayer
2485,JointPQPlayer,234,229,463,38,25,Player A
2486,JointPQPlayer,246,246,492,40,16,Tie
2487,JointPQPlayer,262,267,529,53,8,JointPQPlayer
2488,JointPQPlayer,268,263,531,52,7,Player A
2489,JointPQPlayer,236,236,472,32,20,Tie
2490,JointPQPlayer,148,153,301,2,67,JointPQPlayer
2491,JointPQPlayer,252,247,499,47,16,Player A
2492,JointPQPlayer,261,261,522,49,9,Tie
2493,JointPQPlayer,243,243,486,37,17,Tie
2494,JointPQPlayer,259,259,518,48,10,Tie
2495,JointPQPlayer,254,254,508,44,12,Tie
2496,JointPQPlayer,272,272,544,53,3,Tie
2497,JointPQPlayer,252,257,509,42,11,JointPQPlayer
2498,JointPQPlayer,255,255,510,46,12,Tie
2499,JointPQPlayer,167,162,329,9,60,Player A
2500,JointPQPlayer,224,224,448,41,31,Tie
2501,JointPQPlayer,236,236,472,38,22,Tie
2502,JointPQPlayer,229,234,463,32,23,JointPQPlayer
2503,JointPQPlayer,258,253,511,35,8,Player A
2504,JointPQPlayer,258,258,516,40,8,Tie
2505,JointPQPlayer,165,170,335,9,58,JointPQPlayer
2506,JointPQPlayer,256,256,512,48,12,Tie
2507,JointPQPlayer,263,263,526,53,9,Tie
2508,JointPQPlayer,269,264,533,54,7,Player A
2509,JointPQPlayer,250,250,500,48,16,Tie
2510,JointPQPlayer,273,278,551,60,3,JointPQPlayer
2511,JointPQPlayer,254,254,508,50,14,Tie
2512,JointPQPlayer,257,257,514,47,11,Tie
2513,JointPQPlayer,265,260,525,46,7,Player A
2514,JointPQPlayer,260,260,520,50,10,Tie
2515,JointPQPlayer,234,234,468,40,24,Tie
2516,JointPQPlayer,261,266,527,54,9,JointPQPlayer
2517,JointPQPlayer,262,262,524,54,10,Tie
2518,JointPQPlayer,174,174,348,7,53,Tie
2519,JointPQPlayer,209,209,418,32,38,Tie
2520,JointPQPlayer,224,219,443,30,29,Player A
2521,JointPQPlayer,256,256,512,45,11,Tie
2522,JointPQPlayer,240,240,480,37,19,Tie
2523,JointPQPlayer,262,262,524,45,7,Tie
2524,JointPQPlayer,263,263,526,56,10,Tie
2525,JointPQPlayer,257,257,514,47,11,Tie
2526,JointPQPlayer,266,266,532,53,7,Tie
2527,JointPQPlayer,239,244,483,34,17,JointPQPlayer
2528,JointPQPlayer,267,262,529,47,6,Player A
2529,JointPQPlayer,187,192,379,17,46,JointPQPlayer
2530,JointPQPlayer,264,259,523,56,11,Player A
2531,JointPQPlayer,255,255,510,46,12,Tie
2532,JointPQPlayer,148,148,296,6,70,Tie
2533,JointPQPlayer,257,262,519,55,12,JointPQPlayer
2534,JointPQPlayer,264,264,528,46,6,Tie
2535,JointPQPlayer,240,240,480,40,20,Tie
2536,JointPQPlayer,258,253,511,47,12,Player A
2537,JointPQPlayer,167,172,339,10,57,JointPQPlayer
2538,JointPQPlayer,252,247,499,50,17,Player A
2539,JointPQPlayer,244,244,488,36,16,Tie
2540,JointPQPlayer,175,175,350,9,53,Tie
2541,JointPQPlayer,238,238,476,39,21,Tie
2542,JointPQPlayer,246,246,492,46,18,Tie
2543,JointPQPlayer,268,268,536,54,6,Tie
2544,JointPQPlayer,233,238,471,37,22,JointPQPlayer
2545,JointPQPlayer,254,254,508,41,11,Tie
2546,JointPQPlayer,233,228,461,36,25,Player A
2547,JointPQPlayer,262,267,529,47,6,JointPQPlayer
2548,JointPQPlayer,266,261,527,51,8,Player A
2549,JointPQPlayer,241,241,482,42,20,Tie
2550,JointPQPlayer,192,192,384,13,43,Tie
2551,JointPQPlayer,248,253,501,46,15,JointPQPlayer
2552,JointPQPlayer,250,245,495,43,16,Player A
2553,JointPQPlayer,268,273,541,56,5,JointPQPlayer
2554,JointPQPlayer,214,214,428,27,33,Tie
2555,JointPQPlayer,255,250,505,50,15,Player A
2556,JointPQPlayer,269,274,543,55,4,JointPQPlayer
2557,JointPQPlayer,249,244,493,38,15,Player A
2558,JointPQPlayer,253,253,506,42,12,Tie
2559,JointPQPlayer,266,266,532,50,6,Tie
2560,JointPQPlayer,267,272,539,51,4,JointPQPlayer
2561,JointPQPlayer,266,266,532,56,8,Tie
2562,JointPQPlayer,263,258,521,48,9,Player A
2563,JointPQPlayer,261,261,522,52,10,Tie
2564,JointPQPlayer,260,265,525,46,7,JointPQPlayer
2565,JointPQPlayer,251,246,497,45,16,Player A
2566,JointPQPlayer,254,254,508,44,12,Tie
2567,JointPQPlayer,277,277,554,66,4,Tie
2568,JointPQPlayer,254,254,508,44,12,Tie
2569,JointPQPlayer,275,275,550,62,4,Tie
2570,JointPQPlayer,272,272,544,59,5,Tie
2571,JointPQPlayer,222,222,444,31,29,Tie
2572,JointPQPlayer,235,235,470,36,22,Tie
2573,JointPQPlayer,257,257,514,47,11,Tie
2574,JointPQPlayer,244,244,488,42,18,Tie
2575,JointPQPlayer,177,182,359,9,50,JointPQPlayer
2576,JointPQPlayer,188,183,371,21,50,Player A
2577,JointPQPlayer,252,252,504,52,16,Tie
2578,JointPQPlayer,213,218,431,27,32,JointPQPlayer
2579,JointPQPlayer,167,167,334,8,58,Tie
2580,JointPQPlayer,167,167,334,5,57,Tie
2581,JointPQPlayer,267,267,534,55,7,Tie
2582,JointPQPlayer,267,262,529,50,7,Player A
2583,JointPQPlayer,259,259,518,48,10,Tie
2584,JointPQPlayer,235,235,470,39,23,Tie
2585,JointPQPlayer,264,264,528,46,6,Tie
2586,JointPQPlayer,264,269,533,54,7,JointPQPlayer
2587,JointPQPlayer,268,263,531,55,8,Player A
2588,JointPQPlayer,176,181,357,13,52,JointPQPlayer
2589,JointPQPlayer,269,269,538,59,7,Tie
2590,JointPQPlayer,257,257,514,44,10,Tie
2591,JointPQPlayer,246,241,487,41,18,Player A
2592,JointPQPlayer,236,236,472,41,23,Tie
2593,JointPQPlayer,168,173,341,12,57,JointPQPlayer
2594,JointPQPlayer,259,254,513,49,12,Player A
2595,JointPQPlayer,177,177,354,10,52,Tie
2596,JointPQPlayer,272,272,544,56,4,Tie
2597,JointPQPlayer,247,247,494,45,17,Tie
2598,JointPQPlayer,251,251,502,38,12,Tie
2599,JointPQPlayer,256,256,512,48,12,Tie
2600,JointPQPlayer,260,260,520,44,8,Tie
2601,JointPQPlayer,267,267,534,49,5,Tie
2602,JointPQPlayer,253,253,506,48,14,Tie
2603,JointPQPlayer,251,251,502,41,13,Tie
2604,JointPQPlayer,260,260,520,53,11,Tie
2605,JointPQPlayer,251,251,502,41,13,Tie
2606,JointPQPlayer,249,249,498,43,15,Tie
2607,JointPQPlayer,246,251,497,48,17,JointPQPlayer
2608,JointPQPlayer,221,216,437,36,33,Player A
2609,JointPQPlayer,205,205,410,18,36,Tie
2610,JointPQPlayer,250,255,505,41,12,JointPQPlayer
2611,JointPQPlayer,222,217,439,29,30,Player A
2612,JointPQPlayer,221,226,447,25,26,JointPQPlayer
2613,JointPQPlayer,268,268,536,51,5,Tie
2614,JointPQPlayer,176,171,347,9,54,Player A
2615,JointPQPlayer,163,168,331,5,58,JointPQPlayer
2616,JointPQPlayer,247,242,489,34,15,Player A
2617,JointPQPlayer,227,227,454,35,27,Tie
2618,JointPQPlayer,244,249,493,38,15,JointPQPlayer
2619,JointPQPlayer,254,249,503,45,14,Player A
2620,JointPQPlayer,244,249,493,44,17,JointPQPlayer
2621,JointPQPlayer,198,198,396,19,41,Tie
2622,JointPQPlayer,191,191,382,20,46,Tie
2623,JointPQPlayer,244,239,483,49,22,Player A
2624,JointPQPlayer,258,258,516,46,10,Tie
2625,JointPQPlayer,258,258,516,58,14,Tie
2626,JointPQPlayer,193,198,391,20,43,JointPQPlayer
2627,JointPQPlayer,265,260,525,46,7,Player A
2628,JointPQPlayer,262,262,524,48,8,Tie
2629,JointPQPlayer,237,237,474,40,22,Tie
2630,JointPQPlayer,261,261,522,46,8,Tie
2631,JointPQPlayer,256,256,512,45,11,Tie
2632,JointPQPlayer,256,261,517,50,11,JointPQPlayer
2633,JointPQPlayer,186,181,367,20,51,Player A
2634,JointPQPlayer,243,243,486,43,19,Tie
2635,JointPQPlayer,256,256,512,48,12,Tie
2636,JointPQPlayer,268,273,541,59,6,JointPQPlayer
2637,JointPQPlayer,248,243,491,48,19,Player A
2638,JointPQPlayer,259,259,518,45,9,Tie
2639,JointPQPlayer,269,274,543,55,4,JointPQPlayer
2640,JointPQPlayer,263,258,521,45,8,Player A
2641,JointPQPlayer,231,231,462,37,25,Tie
2642,JointPQPlayer,263,263,526,50,8,Tie
2643,JointPQPlayer,224,229,453,31,26,JointPQPlayer
2644,JointPQPlayer,186,186,372,22,50,Tie
2645,JointPQPlayer,245,245,490,38,16,Tie
2646,JointPQPlayer,223,218,441,28,29,Player A
2647,JointPQPlayer,269,269,538,53,5,Tie
2648,JointPQPlayer,249,249,498,37,13,Tie
2649,JointPQPlayer,252,257,509,39,10,JointPQPlayer
2650,JointPQPlayer,203,198,401,21,40,Player A
2651,JointPQPlayer,175,180,355,14,53,JointPQPlayer
2652,JointPQPlayer,184,184,368,12,48,Tie
2653,JointPQPlayer,260,255,515,45,10,Player A
2654,JointPQPlayer,256,261,517,47,10,JointPQPlayer
2655,JointPQPlayer,209,204,413,30,39,Player A
2656,JointPQPlayer,226,231,457,29,24,JointPQPlayer
2657,JointPQPlayer,219,214,433,29,32,Player A
2658,JointPQPlayer,257,257,514,41,9,Tie
2659,JointPQPlayer,179,179,358,8,50,Tie
2660,JointPQPlayer,199,204,403,23,40,JointPQPlayer
2661,JointPQPlayer,180,180,360,10,50,Tie
2662,JointPQPlayer,239,234,473,36,21,Player A
2663,JointPQPlayer,255,255,510,52,14,Tie
2664,JointPQPlayer,254,254,508,44,12,Tie
2665,JointPQPlayer,271,271,542,51,3,Tie
2666,JointPQPlayer,250,250,500,42,14,Tie
2667,JointPQPlayer,239,239,478,41,21,Tie
2668,JointPQPlayer,250,250,500,45,15,Tie
2669,JointPQPlayer,249,254,503,42,13,JointPQPlayer
2670,JointPQPlayer,235,230,465,34,23,Player A
2671,JointPQPlayer,157,162,319,2,61,JointPQPlayer
2672,JointPQPlayer,258,253,511,44,11,Player A
2673,JointPQPlayer,260,265,525,58,11,JointPQPlayer
2674,JointPQPlayer,263,263,526,53,9,Tie
2675,JointPQPlayer,227,222,449,39,30,Player A
2676,JointPQPlayer,254,259,513,37,8,JointPQPlayer
2677,JointPQPlayer,202,197,399,22,41,Player A
2678,JointPQPlayer,269,269,538,62,8,Tie
2679,JointPQPlayer,266,266,532,56,8,Tie
2680,JointPQPlayer,264,264,528,52,8,Tie
2681,JointPQPlayer,177,182,359,12,51,JointPQPlayer
2682,JointPQPlayer,172,172,344,9,55,Tie
2683,JointPQPlayer,253,253,506,45,13,Tie
2684,JointPQPlayer,272,267,539,54,5,Player A
2685,JointPQPlayer,246,246,492,43,17,Tie
2686,JointPQPlayer,217,217,434,27,31,Tie
2687,JointPQPlayer,222,222,444,28,28,Tie
2688,JointPQPlayer,240,245,485,39,18,JointPQPlayer
2689,JointPQPlayer,270,265,535,50,5,Player A
2690,JointPQPlayer,260,260,520,47,9,Tie
2691,JointPQPlayer,181,181,362,15,51,Tie
2692,JointPQPlayer,177,182,359,6,49,JointPQPlayer
2693,JointPQPlayer,276,271,547,59,4,Player A
2694,JointPQPlayer,180,185,365,12,49,JointPQPlayer
2695,JointPQPlayer,270,270,540,58,6,Tie
2696,JointPQPlayer,260,255,515,54,13,Player A
2697,JointPQPlayer,276,276,552,64,4,Tie
2698,JointPQPlayer,263,263,526,50,8,Tie
2699,JointPQPlayer,255,260,515,57,14,JointPQPlayer
2700,JointPQPlayer,182,177,359,9,50,Player A
2701,JointPQPlayer,265,265,530,60,10,Tie
2702,JointPQPlayer,253,258,511,41,10,JointPQPlayer
2703,JointPQPlayer,232,227,459,40,27,Player A
2704,JointPQPlayer,259,259,518,39,7,Tie
2705,JointPQPlayer,262,267,529,53,8,JointPQPlayer
2706,JointPQPlayer,265,260,525,49,8,Player A
2707,JointPQPlayer,246,246,492,37,15,Tie
2708,JointPQPlayer,259,259,518,45,9,Tie
2709,JointPQPlayer,270,270,540,55,5,Tie
2710,JointPQPlayer,268,268,536,51,5,Tie
2711,JointPQPlayer,238,238,476,45,23,Tie
2712,JointPQPlayer,263,263,526,50,8,Tie
2713,JointPQPlayer,209,214,423,25,34,JointPQPlayer
2714,JointPQPlayer,262,257,519,46,9,Player A
2715,JointPQPlayer,271,276,547,56,3,JointPQPlayer
2716,JointPQPlayer,257,252,509,42,11,Player A
2717,JointPQPlayer,259,259,518,48,10,Tie
2718,JointPQPlayer,243,243,486,40,18,Tie
2719,JointPQPlayer,267,267,534,58,8,Tie
2720,JointPQPlayer,257,257,514,47,11,Tie
2721,JointPQPlayer,270,275,545,57,4,JointPQPlayer
2722,JointPQPlayer,248,243,491,42,17,Player A
2723,JointPQPlayer,187,192,379,17,46,JointPQPlayer
2724,JointPQPlayer,255,250,505,47,14,Player A
2725,JointPQPlayer,276,276,552,64,4,Tie
2726,JointPQPlayer,249,254,503,42,13,JointPQPlayer
2727,JointPQPlayer,270,265,535,56,7,Player A
2728,JointPQPlayer,216,216,432,25,31,Tie
2729,JointPQPlayer,184,184,368,6,46,Tie
2730,JointPQPlayer,244,244,488,45,19,Tie
2731,JointPQPlayer,258,258,516,46,10,Tie
2732,JointPQPlayer,238,243,481,35,18,JointPQPlayer
2733,JointPQPlayer,244,239,483,46,21,Player A
2734,JointPQPlayer,268,268,536,48,4,Tie
2735,JointPQPlayer,266,271,537,52,5,JointPQPlayer
2736,JointPQPlayer,270,265,535,53,6,Player A
2737,JointPQPlayer,179,179,358,11,51,Tie
2738,JointPQPlayer,175,175,350,6,52,Tie
2739,JointPQPlayer,245,250,495,40,15,JointPQPlayer
2740,JointPQPlayer,276,271,547,65,6,Player A
2741,JointPQPlayer,190,190,380,12,44,Tie
2742,JointPQPlayer,230,230,460,35,25,Tie
2743,JointPQPlayer,199,199,398,9,37,Tie
2744,JointPQPlayer,261,266,527,48,7,JointPQPlayer
2745,JointPQPlayer,237,237,474,40,22,Tie
2746,JointPQPlayer,171,171,342,7,55,Tie
2747,JointPQPlayer,202,197,399,31,44,Player A
2748,JointPQPlayer,256,256,512,45,11,Tie
2749,JointPQPlayer,235,235,470,36,22,Tie
2750,JointPQPlayer,262,262,524,51,9,Tie
2751,JointPQPlayer,265,265,530,54,8,Tie
2752,JointPQPlayer,193,198,391,20,43,JointPQPlayer
2753,JointPQPlayer,227,222,449,33,28,Player A
2754,JointPQPlayer,257,262,519,49,10,JointPQPlayer
2755,JointPQPlayer,251,251,502,38,12,Tie
2756,JointPQPlayer,262,257,519,46,9,Player A
2757,JointPQPlayer,240,240,480,40,20,Tie
2758,JointPQPlayer,267,267,534,55,7,Tie
2759,JointPQPlayer,264,264,528,40,4,Tie
2760,JointPQPlayer,254,254,508,53,15,Tie
2761,JointPQPlayer,244,244,488,42,18,Tie
2762,JointPQPlayer,249,254,503,48,15,JointPQPlayer
2763,JointPQPlayer,236,236,472,44,24,Tie
2764,JointPQPlayer,271,266,537,55,6,Player A
2765,JointPQPlayer,241,241,482,42,20,Tie
2766,JointPQPlayer,238,243,481,44,21,JointPQPlayer
2767,JointPQPlayer,180,180,360,13,51,Tie
2768,JointPQPlayer,258,258,516,46,10,Tie
2769,JointPQPlayer,267,262,529,53,8,Player A
2770,JointPQPlayer,257,262,519,52,11,JointPQPlayer
2771,JointPQPlayer,261,261,522,49,9,Tie
2772,JointPQPlayer,247,242,489,46,19,Player A
2773,JointPQPlayer,210,215,425,21,32,JointPQPlayer
2774,JointPQPlayer,266,266,532,53,7,Tie
2775,JointPQPlayer,253,248,501,40,13,Player A
2776,JointPQPlayer,240,240,480,43,21,Tie
2777,JointPQPlayer,193,198,391,11,40,JointPQPlayer
2778,JointPQPlayer,257,252,509,51,14,Player A
2779,JointPQPlayer,259,259,518,54,12,Tie
2780,JointPQPlayer,274,274,548,69,7,Tie
2781,JointPQPlayer,249,249,498,46,16,Tie
2782,JointPQPlayer,259,259,518,48,10,Tie
2783,JointPQPlayer,252,252,504,52,16,Tie
2784,JointPQPlayer,187,192,379,8,43,JointPQPlayer
2785,JointPQPlayer,239,234,473,45,24,Player A
2786,JointPQPlayer,207,212,419,27,36,JointPQPlayer
2787,JointPQPlayer,255,255,510,43,11,Tie
2788,JointPQPlayer,208,203,411,31,40,Player A
2789,JointPQPlayer,244,244,488,42,18,Tie
2790,JointPQPlayer,214,214,428,27,33,Tie
2791,JointPQPlayer,262,267,529,44,5,JointPQPlayer
2792,JointPQPlayer,189,189,378,19,47,Tie
2793,JointPQPlayer,242,237,479,33,18,Player A
2794,JointPQPlayer,197,202,399,16,39,JointPQPlayer
2795,JointPQPlayer,260,255,515,57,14,Player A
2796,JointPQPlayer,261,266,527,51,8,JointPQPlayer
2797,JointPQPlayer,262,257,519,49,10,Player A
2798,JointPQPlayer,213,218,431,30,33,JointPQPlayer
2799,JointPQPlayer,254,254,508,38,10,Tie
2800,JointPQPlayer,271,266,537,52,5,Player A
2801,JointPQPlayer,246,246,492,37,15,Tie
2802,JointPQPlayer,269,269,538,53,5,Tie
2803,JointPQPlayer,240,245,485,39,18,JointPQPlayer
2804,JointPQPlayer,269,264,533,60,9,Player A
2805,JointPQPlayer,256,256,512,45,11,Tie
2806,JointPQPlayer,217,222,439,32,31,JointPQPlayer
2807,JointPQPlayer,253,248,501,40,13,Player A
2808,JointPQPlayer,246,251,497,45,16,JointPQPlayer
2809,JointPQPlayer,241,241,482,39,19,Tie
2810,JointPQPlayer,240,235,475,41,22,Player A
2811,JointPQPlayer,242,242,484,47,21,Tie
2812,JointPQPlayer,265,265,530,51,7,Tie
2813,JointPQPlayer,266,266,532,59,9,Tie
2814,JointPQPlayer,252,252,504,46,14,Tie
2815,JointPQPlayer,248,248,496,44,16,Tie
2816,JointPQPlayer,256,256,512,48,12,Tie
2817,JointPQPlayer,266,266,532,59,9,Tie
2818,JointPQPlayer,268,268,536,57,7,Tie
2819,JointPQPlayer,258,258,516,43,9,Tie
2820,JointPQPlayer,258,263,521,45,8,JointPQPlayer
2821,JointPQPlayer,245,240,485,42,19,Player A
2822,JointPQPlayer,247,247,494,51,19,Tie
2823,JointPQPlayer,257,262,519,49,10,JointPQPlayer
2824,JointPQPlayer,253,253,506,42,12,Tie
2825,JointPQPlayer,212,212,424,26,34,Tie
2826,JointPQPlayer,178,173,351,10,53,Player A
2827,JointPQPlayer,242,242,484,35,17,Tie
2828,JointPQPlayer,265,265,530,51,7,Tie
2829,JointPQPlayer,260,260,520,50,10,Tie
2830,JointPQPlayer,265,265,530,57,9,Tie
2831,JointPQPlayer,196,201,397,11,38,JointPQPlayer
2832,JointPQPlayer,256,251,507,49,14,Player A
2833,JointPQPlayer,266,271,537,55,6,JointPQPlayer
2834,JointPQPlayer,266,261,527,54,9,Player A
2835,JointPQPlayer,179,179,358,11,51,Tie
2836,JointPQPlayer,248,248,496,38,14,Tie
2837,JointPQPlayer,229,234,463,32,23,JointPQPlayer
2838,JointPQPlayer,233,233,466,35,23,Tie
2839,JointPQPlayer,212,207,419,27,36,Player A
2840,JointPQPlayer,257,262,519,52,11,JointPQPlayer
2841,JointPQPlayer,265,260,525,49,8,Player A
2842,JointPQPlayer,238,238,476,39,21,Tie
2843,JointPQPlayer,190,190,380,24,48,Tie
2844,JointPQPlayer,233,238,471,37,22,JointPQPlayer
2845,JointPQPlayer,264,264,528,43,5,Tie
2846,JointPQPlayer,276,276,552,61,3,Tie
2847,JointPQPlayer,255,250,505,38,11,Player A
2848,JointPQPlayer,255,255,510,52,14,Tie
2849,JointPQPlayer,264,264,528,46,6,Tie
2850,JointPQPlayer,252,257,509,42,11,JointPQPlayer
2851,JointPQPlayer,181,181,362,9,49,Tie
2852,JointPQPlayer,261,256,517,44,9,Player A
2853,JointPQPlayer,245,250,495,40,15,JointPQPlayer
2854,JointPQPlayer,270,265,535,53,6,Player A
2855,JointPQPlayer,272,272,544,59,5,Tie
2856,JointPQPlayer,266,266,532,50,6,Tie
2857,JointPQPlayer,184,189,373,14,47,JointPQPlayer
2858,JointPQPlayer,191,191,382,14,44,Tie
2859,JointPQPlayer,234,234,468,31,21,Tie
2860,JointPQPlayer,184,184,368,15,49,Tie
2861,JointPQPlayer,249,249,498,40,14,Tie
2862,JointPQPlayer,178,173,351,7,52,Player A
2863,JointPQPlayer,241,241,482,36,18,Tie
2864,JointPQPlayer,254,259,513,43,10,JointPQPlayer
2865,JointPQPlayer,254,249,503,45,14,Player A
2866,JointPQPlayer,258,258,516,49,11,Tie
2867,JointPQPlayer,257,262,519,49,10,JointPQPlayer
2868,JointPQPlayer,250,245,495,37,14,Player A
2869,JointPQPlayer,239,239,478,35,19,Tie
2870,JointPQPlayer,248,248,496,44,16,Tie
2871,JointPQPlayer,183,188,371,6,45,JointPQPlayer
2872,JointPQPlayer,235,230,465,37,24,Player A
2873,JointPQPlayer,231,231,462,25,21,Tie
2874,JointPQPlayer,193,198,391,11,40,JointPQPlayer
2875,JointPQPlayer,185,185,370,8,46,Tie
2876,JointPQPlayer,257,252,509,45,12,Player A
2877,JointPQPlayer,244,244,488,39,17,Tie
2878,JointPQPlayer,263,263,526,50,8,Tie
2879,JointPQPlayer,248,253,501,43,14,JointPQPlayer
2880,JointPQPlayer,268,268,536,51,5,Tie
2881,JointPQPlayer,272,267,539,54,5,Player A
2882,JointPQPlayer,266,266,532,59,9,Tie
2883,JointPQPlayer,262,262,524,45,7,Tie
2884,JointPQPlayer,186,191,377,12,45,JointPQPlayer
2885,JointPQPlayer,238,233,471,34,21,Player A
2886,JointPQPlayer,226,226,452,30,26,Tie
2887,JointPQPlayer,258,258,516,55,13,Tie
2888,JointPQPlayer,175,180,355,8,51,JointPQPlayer
2889,JointPQPlayer,192,192,384,16,44,Tie
2890,JointPQPlayer,265,260,525,52,9,Player A
2891,JointPQPlayer,260,260,520,47,9,Tie
2892,JointPQPlayer,142,147,289,2,71,JointPQPlayer
2893,JointPQPlayer,171,171,342,4,54,Tie
2894,JointPQPlayer,243,238,481,35,18,Player A
2895,JointPQPlayer,213,213,426,31,35,Tie
2896,JointPQPlayer,261,261,522,52,10,Tie
2897,JointPQPlayer,249,249,498,40,14,Tie
2898,JointPQPlayer,201,206,407,27,40,JointPQPlayer
2899,JointPQPlayer,175,175,350,9,53,Tie
2900,JointPQPlayer,256,256,512,45,11,Tie
2901,JointPQPlayer,250,250,500,45,15,Tie
2902,JointPQPlayer,242,237,479,39,20,Player A
2903,JointPQPlayer,180,180,360,7,49,Tie
2904,JointPQPlayer,252,257,509,45,12,JointPQPlayer
2905,JointPQPlayer,190,190,380,12,44,Tie
2906,JointPQPlayer,246,241,487,41,18,Player A
2907,JointPQPlayer,189,194,383,12,43,JointPQPlayer
2908,JointPQPlayer,242,237,479,42,21,Player A
2909,JointPQPlayer,237,242,479,48,23,JointPQPlayer
2910,JointPQPlayer,174,174,348,7,53,Tie
2911,JointPQPlayer,243,243,486,28,14,Tie
2912,JointPQPlayer,237,232,469,38,23,Player A
2913,JointPQPlayer,271,271,542,60,6,Tie
2914,JointPQPlayer,255,255,510,46,12,Tie
2915,JointPQPlayer,268,268,536,54,6,Tie
2916,JointPQPlayer,259,259,518,45,9,Tie
2917,JointPQPlayer,239,239,478,32,18,Tie
2918,JointPQPlayer,258,258,516,34,6,Tie
2919,JointPQPlayer,242,242,484,29,15,Tie
2920,JointPQPlayer,201,206,407,18,37,JointPQPlayer
2921,JointPQPlayer,183,183,366,13,49,Tie
2922,JointPQPlayer,275,270,545,54,3,Player A
2923,JointPQPlayer,259,259,518,51,11,Tie
2924,JointPQPlayer,241,246,487,38,17,JointPQPlayer
2925,JointPQPlayer,259,254,513,46,11,Player A
2926,JointPQPlayer,256,256,512,45,11,Tie
2927,JointPQPlayer,260,260,520,53,11,Tie
2928,JointPQPlayer,224,229,453,31,26,JointPQPlayer
2929,JointPQPlayer,198,193,391,14,41,Player A
2930,JointPQPlayer,258,258,516,43,9,Tie
2931,JointPQPlayer,243,248,491,33,14,JointPQPlayer
2932,JointPQPlayer,263,258,521,48,9,Player A
2933,JointPQPlayer,259,259,518,48,10,Tie
2934,JointPQPlayer,186,191,377,21,48,JointPQPlayer
2935,JointPQPlayer,263,263,526,50,8,Tie
2936,JointPQPlayer,253,253,506,48,14,Tie
2937,JointPQPlayer,223,218,441,34,31,Player A
2938,JointPQPlayer,267,267,534,55,7,Tie
2939,JointPQPlayer,208,208,416,27,37,Tie
2940,JointPQPlayer,243,243,486,34,16,Tie
2941,JointPQPlayer,235,235,470,30,20,Tie
2942,JointPQPlayer,212,217,429,28,33,JointPQPlayer
2943,JointPQPlayer,260,255,515,42,9,Player A
2944,JointPQPlayer,263,263,526,50,8,Tie
2945,JointPQPlayer,238,238,476,36,20,Tie
2946,JointPQPlayer,227,227,454,38,28,Tie
2947,JointPQPlayer,253,258,511,44,11,JointPQPlayer
2948,JointPQPlayer,219,214,433,29,32,Player A
2949,JointPQPlayer,248,248,496,41,15,Tie
2950,JointPQPlayer,241,241,482,39,19,Tie
2951,JointPQPlayer,254,254,508,41,11,Tie
2952,JointPQPlayer,185,185,370,14,48,Tie
2953,JointPQPlayer,254,254,508,44,12,Tie
2954,JointPQPlayer,267,267,534,58,8,Tie
2955,JointPQPlayer,212,212,424,23,33,Tie
2956,JointPQPlayer,169,174,343,11,56,JointPQPlayer
2957,JointPQPlayer,252,247,499,47,16,Player A
2958,JointPQPlayer,163,168,331,5,58,JointPQPlayer
2959,JointPQPlayer,270,270,540,55,5,Tie
2960,JointPQPlayer,158,158,316,2,62,Tie
2961,JointPQPlayer,227,222,449,30,27,Player A
2962,JointPQPlayer,254,259,513,46,11,JointPQPlayer
2963,JointPQPlayer,267,262,529,50,7,Player A
2964,JointPQPlayer,258,263,521,51,10,JointPQPlayer
2965,JointPQPlayer,188,183,371,15,48,Player A
2966,JointPQPlayer,236,236,472,38,22,Tie
2967,JointPQPlayer,251,256,507,43,12,JointPQPlayer
2968,JointPQPlayer,224,224,448,32,28,Tie
2969,JointPQPlayer,270,270,540,46,2,Tie
2970,JointPQPlayer,273,273,546,55,3,Tie
2971,JointPQPlayer,220,215,435,34,33,Player A
2972,JointPQPlayer,181,181,362,12,50,Tie
2973,JointPQPlayer,201,206,407,21,38,JointPQPlayer
2974,JointPQPlayer,250,245,495,40,15,Player A
2975,JointPQPlayer,200,205,405,19,38,JointPQPlayer
2976,JointPQPlayer,253,248,501,49,16,Player A
2977,JointPQPlayer,175,180,355,5,50,JointPQPlayer
2978,JointPQPlayer,250,245,495,46,17,Player A
2979,JointPQPlayer,250,250,500,45,15,Tie
2980,JointPQPlayer,154,159,313,2,63,JointPQPlayer
2981,JointPQPlayer,173,173,346,2,52,Tie
2982,JointPQPlayer,252,247,499,44,15,Player A
2983,JointPQPlayer,177,182,359,9,50,JointPQPlayer
2984,JointPQPlayer,271,266,537,55,6,Player A
2985,JointPQPlayer,252,257,509,51,14,JointPQPlayer
2986,JointPQPlayer,260,255,515,51,12,Player A
2987,JointPQPlayer,215,220,435,28,31,JointPQPlayer
2988,JointPQPlayer,263,258,521,48,9,Player A
2989,JointPQPlayer,244,244,488,48,20,Tie
2990,JointPQPlayer,242,242,484,35,17,Tie
2991,JointPQPlayer,179,184,363,10,49,JointPQPlayer
2992,JointPQPlayer,265,265,530,54,8,Tie
2993,JointPQPlayer,242,242,484,44,20,Tie
2994,JointPQPlayer,261,256,517,50,11,Player A
2995,JointPQPlayer,260,260,520,47,9,Tie
2996,JointPQPlayer,229,234,463,41,26,JointPQPlayer
2997,JointPQPlayer,262,257,519,49,10,Player A
2998,JointPQPlayer,239,239,478,41,21,Tie
2999,JointPQPlayer,259,259,518,45,9,Tie
3000,JointPQPlayer,256,261,517,47,10,JointPQPlayer
3001,JointPQPlayer,252,252,504,46,14,Tie
3002,JointPQPlayer,248,243,491,42,17,Player A
3003,JointPQPlayer,248,248,496,50,18,Tie
3004,JointPQPlayer,254,254,508,47,13,Tie
3005,JointPQPlayer,254,259,513,52,13,JointPQPlayer
3006,JointPQPlayer,180,180,360,13,51,Tie
3007,JointPQPlayer,239,234,473,36,21,Player A
3008,JointPQPlayer,246,251,497,39,14,JointPQPlayer
3009,JointPQPlayer,244,239,483,40,19,Player A
3010,JointPQPlayer,186,186,372,19,49,Tie
3011,JointPQPlayer,172,177,349,5,52,JointPQPlayer
3012,JointPQPlayer,251,246,497,42,15,Player A
3013,JointPQPlayer,170,175,345,4,53,JointPQPlayer
3014,JointPQPlayer,246,246,492,46,18,Tie
3015,JointPQPlayer,184,184,368,9,47,Tie
3016,JointPQPlayer,247,242,489,40,17,Player A
3017,JointPQPlayer,225,225,450,34,28,Tie
3018,JointPQPlayer,272,272,544,59,5,Tie
3019,JointPQPlayer,226,226,452,27,25,Tie
3020,JointPQPlayer,264,264,528,46,6,Tie
3021,JointPQPlayer,269,269,538,53,5,Tie
3022,JointPQPlayer,255,255,510,55,15,Tie
3023,JointPQPlayer,247,252,499,41,14,JointPQPlayer
3024,JointPQPlayer,254,254,508,44,12,Tie
3025,JointPQPlayer,244,244,488,42,18,Tie
3026,JointPQPlayer,256,256,512,39,9,Tie
3027,JointPQPlayer,188,188,376,8,44,Tie
3028,JointPQPlayer,195,195,390,22,44,Tie
3029,JointPQPlayer,263,263,526,53,9,Tie
3030,JointPQPlayer,239,234,473,30,19,Player A
3031,JointPQPlayer,251,251,502,44,14,Tie
3032,JointPQPlayer,237,242,479,36,19,JointPQPlayer
3033,JointPQPlayer,260,255,515,48,11,Player A
3034,JointPQPlayer,255,255,510,49,13,Tie
3035,JointPQPlayer,162,167,329,6,59,JointPQPlayer
3036,JointPQPlayer,201,196,397,14,39,Player A
3037,JointPQPlayer,260,260,520,53,11,Tie
3038,JointPQPlayer,260,260,520,50,10,Tie
3039,JointPQPlayer,262,267,529,59,10,JointPQPlayer
3040,JointPQPlayer,242,242,484,35,17,Tie
3041,JointPQPlayer,170,170,340,8,56,Tie
3042,JointPQPlayer,243,238,481,38,19,Player A
3043,JointPQPlayer,257,257,514,44,10,Tie
3044,JointPQPlayer,204,209,413,33,40,JointPQPlayer
3045,JointPQPlayer,274,269,543,61,6,Player A
3046,JointPQPlayer,259,259,518,45,9,Tie
3047,JointPQPlayer,263,268,531,52,7,JointPQPlayer
3048,JointPQPlayer,259,259,518,42,8,Tie
3049,JointPQPlayer,269,264,533,54,7,Player A
3050,JointPQPlayer,263,263,526,56,10,Tie
3051,JointPQPlayer,268,268,536,51,5,Tie
3052,JointPQPlayer,164,169,333,4,57,JointPQPlayer
3053,JointPQPlayer,266,261,527,54,9,Player A
3054,JointPQPlayer,264,264,528,46,6,Tie
3055,JointPQPlayer,244,244,488,45,19,Tie
3056,JointPQPlayer,187,192,379,14,45,JointPQPlayer
3057,JointPQPlayer,260,255,515,45,10,Player A
3058,JointPQPlayer,267,272,539,57,6,JointPQPlayer
3059,JointPQPlayer,268,263,531,55,8,Player A
3060,JointPQPlayer,163,168,331,5,58,JointPQPlayer
3061,JointPQPlayer,261,256,517,44,9,Player A
3062,JointPQPlayer,212,212,424,23,33,Tie
3063,JointPQPlayer,214,214,428,30,34,Tie
3064,JointPQPlayer,263,268,531,49,6,JointPQPlayer
3065,JointPQPlayer,250,245,495,43,16,Player A
3066,JointPQPlayer,237,237,474,40,22,Tie
3067,JointPQPlayer,251,251,502,47,15,Tie
3068,JointPQPlayer,247,247,494,45,17,Tie
3069,JointPQPlayer,261,266,527,51,8,JointPQPlayer
3070,JointPQPlayer,250,250,500,48,16,Tie
3071,JointPQPlayer,266,266,532,56,8,Tie
3072,JointPQPlayer,215,210,425,21,32,Player A
3073,JointPQPlayer,275,275,550,59,3,Tie
3074,JointPQPlayer,276,276,552,64,4,Tie
3075,JointPQPlayer,171,176,347,6,53,JointPQPlayer
3076,JointPQPlayer,255,255,510,46,12,Tie
3077,JointPQPlayer,254,249,503,39,12,Player A
3078,JointPQPlayer,270,270,540,55,5,Tie
3079,JointPQPlayer,195,195,390,16,42,Tie
3080,JointPQPlayer,220,225,445,32,29,JointPQPlayer
3081,JointPQPlayer,167,167,334,5,57,Tie
3082,JointPQPlayer,183,178,361,5,48,Player A
3083,JointPQPlayer,263,268,531,58,9,JointPQPlayer
3084,JointPQPlayer,222,222,444,25,27,Tie
3085,JointPQPlayer,249,249,498,40,14,Tie
3086,JointPQPlayer,209,204,413,21,36,Player A
3087,JointPQPlayer,240,245,485,39,18,JointPQPlayer
3088,JointPQPlayer,269,269,538,59,7,Tie
3089,JointPQPlayer,273,268,541,56,5,Player A
3090,JointPQPlayer,256,256,512,48,12,Tie
3091,JointPQPlayer,243,248,491,51,20,JointPQPlayer
3092,JointPQPlayer,191,191,382,20,46,Tie
3093,JointPQPlayer,234,229,463,32,23,Player A
3094,JointPQPlayer,215,215,430,26,32,Tie
3095,JointPQPlayer,239,239,478,41,21,Tie
3096,JointPQPlayer,267,267,534,55,7,Tie
3097,JointPQPlayer,266,271,537,52,5,JointPQPlayer
3098,JointPQPlayer,263,263,526,56,10,Tie
3099,JointPQPlayer,259,254,513,46,11,Player A
3100,JointPQPlayer,269,274,543,55,4,JointPQPlayer
3101,JointPQPlayer,198,193,391,17,42,Player A
3102,JointPQPlayer,243,248,491,45,18,JointPQPlayer
3103,JointPQPlayer,248,243,491,42,17,Player A
3104,JointPQPlayer,186,191,377,18,47,JointPQPlayer
3105,JointPQPlayer,241,241,482,42,20,Tie
3106,JointPQPlayer,257,252,509,48,13,Player A
3107,JointPQPlayer,264,269,533,51,6,JointPQPlayer
3108,JointPQPlayer,260,255,515,48,11,Player A
3109,JointPQPlayer,223,223,446,30,28,Tie
3110,JointPQPlayer,242,242,484,38,18,Tie
3111,JointPQPlayer,252,252,504,43,13,Tie
3112,JointPQPlayer,151,156,307,2,65,JointPQPlayer
3113,JointPQPlayer,186,181,367,8,47,Player A
3114,JointPQPlayer,271,271,542,60,6,Tie
3115,JointPQPlayer,186,191,377,18,47,JointPQPlayer
3116,JointPQPlayer,260,255,515,51,12,Player A
3117,JointPQPlayer,209,209,418,20,34,Tie
3118,JointPQPlayer,169,174,343,8,55,JointPQPlayer
3119,JointPQPlayer,267,262,529,53,8,Player A
3120,JointPQPlayer,248,248,496,32,12,Tie
3121,JointPQPlayer,219,219,438,25,29,Tie
3122,JointPQPlayer,231,231,462,34,24,Tie
3123,JointPQPlayer,186,186,372,10,46,Tie
3124,JointPQPlayer,257,262,519,43,8,JointPQPlayer
3125,JointPQPlayer,216,211,427,32,35,Player A
3126,JointPQPlayer,273,273,546,55,3,Tie
3127,JointPQPlayer,243,248,491,36,15,JointPQPlayer
3128,JointPQPlayer,190,190,380,9,43,Tie
3129,JointPQPlayer,186,181,367,8,47,Player A
3130,JointPQPlayer,247,247,494,39,15,Tie
3131,JointPQPlayer,240,240,480,34,18,Tie
3132,JointPQPlayer,227,227,454,35,27,Tie
3133,JointPQPlayer,250,250,500,42,14,Tie
3134,JointPQPlayer,253,253,506,39,11,Tie
3135,JointPQPlayer,241,241,482,39,19,Tie
3136,JointPQPlayer,255,255,510,46,12,Tie
3137,JointPQPlayer,266,266,532,50,6,Tie
3138,JointPQPlayer,224,229,453,34,27,JointPQPlayer
3139,JointPQPlayer,193,193,386,15,43,Tie
3140,JointPQPlayer,237,237,474,37,21,Tie
3141,JointPQPlayer,252,247,499,35,12,Player A
3142,JointPQPlayer,187,187,374,21,49,Tie
3143,JointPQPlayer,268,268,536,57,7,Tie
3144,JointPQPlayer,253,258,511,44,11,JointPQPlayer
3145,JointPQPlayer,249,244,493,47,18,Player A
3146,JointPQPlayer,215,215,430,32,34,Tie
3147,JointPQPlayer,245,245,490,50,20,Tie
3148,JointPQPlayer,220,225,445,35,30,JointPQPlayer
3149,JointPQPlayer,269,264,533,48,5,Player A
3150,JointPQPlayer,187,187,374,21,49,Tie
3151,JointPQPlayer,252,252,504,43,13,Tie
3152,JointPQPlayer,218,218,436,23,29,Tie
3153,JointPQPlayer,273,273,546,64,6,Tie
3154,JointPQPlayer,247,252,499,38,13,JointPQPlayer
3155,JointPQPlayer,169,169,338,9,57,Tie
3156,JointPQPlayer,240,235,475,38,21,Player A
3157,JointPQPlayer,256,256,512,45,11,Tie
3158,JointPQPlayer,202,202,404,21,39,Tie
3159,JointPQPlayer,264,264,528,52,8,Tie
3160,JointPQPlayer,183,188,371,12,47,JointPQPlayer
3161,JointPQPlayer,188,183,371,9,46,Player A
3162,JointPQPlayer,197,202,399,16,39,JointPQPlayer
3163,JointPQPlayer,203,198,401,21,40,Player A
3164,JointPQPlayer,252,252,504,46,14,Tie
3165,JointPQPlayer,233,233,466,41,25,Tie
3166,JointPQPlayer,248,248,496,38,14,Tie
3167,JointPQPlayer,250,250,500,45,15,Tie
3168,JointPQPlayer,258,258,516,49,11,Tie
3169,JointPQPlayer,235,240,475,35,20,JointPQPlayer
3170,JointPQPlayer,252,252,504,49,15,Tie
3171,JointPQPlayer,265,260,525,49,8,Player A
3172,JointPQPlayer,185,190,375,16,47,JointPQPlayer
3173,JointPQPlayer,207,207,414,25,37,Tie
3174,JointPQPlayer,256,256,512,42,10,Tie
3175,JointPQPlayer,267,262,529,56,9,Player A
3176,JointPQPlayer,270,270,540,52,4,Tie
3177,JointPQPlayer,216,216,432,28,32,Tie
3178,JointPQPlayer,166,166,332,3,57,Tie
3179,JointPQPlayer,170,170,340,5,55,Tie
3180,JointPQPlayer,198,203,401,24,41,JointPQPlayer
3181,JointPQPlayer,188,188,376,11,45,Tie
3182,JointPQPlayer,183,178,361,8,49,Player A
3183,JointPQPlayer,261,261,522,52,10,Tie
3184,JointPQPlayer,235,235,470,36,22,Tie
3185,JointPQPlayer,273,273,546,58,4,Tie
3186,JointPQPlayer,266,266,532,53,7,Tie
3187,JointPQPlayer,234,239,473,42,23,JointPQPlayer
3188,JointPQPlayer,260,260,520,47,9,Tie
3189,JointPQPlayer,247,242,489,34,15,Player A
3190,JointPQPlayer,267,267,534,55,7,Tie
3191,JointPQPlayer,175,180,355,8,51,JointPQPlayer
3192,JointPQPlayer,262,257,519,46,9,Player A
3193,JointPQPlayer,255,255,510,49,13,Tie
3194,JointPQPlayer,200,205,405,19,38,JointPQPlayer
3195,JointPQPlayer,194,194,388,11,41,Tie
3196,JointPQPlayer,209,209,418,26,36,Tie
3197,JointPQPlayer,249,244,493,44,17,Player A
3198,JointPQPlayer,162,167,329,3,58,JointPQPlayer
3199,JointPQPlayer,188,183,371,9,46,Player A
3200,JointPQPlayer,258,263,521,54,11,JointPQPlayer
3201,JointPQPlayer,263,258,521,45,8,Player A
3202,JointPQPlayer,245,245,490,47,19,Tie
3203,JointPQPlayer,260,260,520,47,9,Tie
3204,JointPQPlayer,269,269,538,53,5,Tie
3205,JointPQPlayer,260,260,520,44,8,Tie
3206,JointPQPlayer,254,259,513,43,10,JointPQPlayer
3207,JointPQPlayer,253,248,501,40,13,Player A
3208,JointPQPlayer,235,235,470,36,22,Tie
3209,JointPQPlayer,258,258,516,43,9,Tie
3210,JointPQPlayer,254,254,508,50,14,Tie
3211,JointPQPlayer,192,192,384,13,43,Tie
3212,JointPQPlayer,266,266,532,59,9,Tie
3213,JointPQPlayer,255,260,515,51,12,JointPQPlayer
3214,JointPQPlayer,243,238,481,41,20,Player A
3215,JointPQPlayer,257,262,519,49,10,JointPQPlayer
3216,JointPQPlayer,249,244,493,47,18,Player A
3217,JointPQPlayer,246,246,492,37,15,Tie
3218,JointPQPlayer,173,178,351,7,52,JointPQPlayer
3219,JointPQPlayer,251,246,497,39,14,Player A
3220,JointPQPlayer,261,261,522,49,9,Tie
3221,JointPQPlayer,256,256,512,42,10,Tie
3222,JointPQPlayer,262,267,529,50,7,JointPQPlayer
3223,JointPQPlayer,245,240,485,36,17,Player A
3224,JointPQPlayer,254,259,513,52,13,JointPQPlayer
3225,JointPQPlayer,264,259,523,50,9,Player A
3226,JointPQPlayer,247,247,494,51,19,Tie
3227,JointPQPlayer,257,257,514,53,13,Tie
3228,JointPQPlayer,255,255,510,49,13,Tie
3229,JointPQPlayer,277,277,554,57,1,Tie
3230,JointPQPlayer,267,267,534,58,8,Tie
3231,JointPQPlayer,228,228,456,37,27,Tie
3232,JointPQPlayer,274,274,548,60,4,Tie
3233,JointPQPlayer,189,189,378,22,48,Tie
3234,JointPQPlayer,244,244,488,42,18,Tie
3235,JointPQPlayer,266,266,532,50,6,Tie
3236,JointPQPlayer,248,253,501,34,11,JointPQPlayer
3237,JointPQPlayer,195,195,390,19,43,Tie
3238,JointPQPlayer,187,187,374,12,46,Tie
3239,JointPQPlayer,261,256,517,44,9,Player A
3240,JointPQPlayer,260,260,520,47,9,Tie
3241,JointPQPlayer,157,162,319,5,62,JointPQPlayer
3242,JointPQPlayer,246,241,487,35,16,Player A
3243,JointPQPlayer,206,206,412,26,38,Tie
3244,JointPQPlayer,238,243,481,47,22,JointPQPlayer
3245,JointPQPlayer,251,246,497,48,17,Player A
3246,JointPQPlayer,259,264,523,50,9,JointPQPlayer
3247,JointPQPlayer,255,250,505,41,12,Player A
3248,JointPQPlayer,261,266,527,57,10,JointPQPlayer
3249,JointPQPlayer,223,218,441,34,31,Player A
3250,JointPQPlayer,264,264,528,49,7,Tie
3251,JointPQPlayer,222,227,449,27,26,JointPQPlayer
3252,JointPQPlayer,216,211,427,26,33,Player A
3253,JointPQPlayer,258,258,516,49,11,Tie
3254,JointPQPlayer,240,240,480,34,18,Tie
3255,JointPQPlayer,261,261,522,46,8,Tie
3256,JointPQPlayer,255,255,510,46,12,Tie
3257,JointPQPlayer,229,229,458,33,25,Tie
3258,JointPQPlayer,202,202,404,21,39,Tie
3259,JointPQPlayer,254,254,508,47,13,Tie
3260,JointPQPlayer,188,188,376,11,45,Tie
3261,JointPQPlayer,248,248,496,41,15,Tie
3262,JointPQPlayer,239,239,478,44,22,Tie
3263,JointPQPlayer,199,199,398,24,42,Tie
3264,JointPQPlayer,249,249,498,40,14,Tie
3265,JointPQPlayer,184,184,368,15,49,Tie
3266,JointPQPlayer,261,261,522,52,10,Tie
3267,JointPQPlayer,250,255,505,50,15,JointPQPlayer
3268,JointPQPlayer,185,185,370,17,49,Tie
3269,JointPQPlayer,271,266,537,58,7,Player A
3270,JointPQPlayer,266,271,537,52,5,JointPQPlayer
3271,JointPQPlayer,258,253,511,50,13,Player A
3272,JointPQPlayer,260,260,520,41,7,Tie
3273,JointPQPlayer,269,274,543,52,3,JointPQPlayer
3274,JointPQPlayer,248,243,491,45,18,Player A
3275,JointPQPlayer,243,243,486,40,18,Tie
3276,JointPQPlayer,188,188,376,14,46,Tie
3277,JointPQPlayer,221,226,447,37,30,JointPQPlayer
3278,JointPQPlayer,185,185,370,8,46,Tie
3279,JointPQPlayer,249,249,498,40,14,Tie
3280,JointPQPlayer,266,261,527,54,9,Player A
3281,JointPQPlayer,269,269,538,50,4,Tie
3282,JointPQPlayer,166,166,332,6,58,Tie
3283,JointPQPlayer,257,257,514,38,8,Tie
3284,JointPQPlayer,260,265,525,49,8,JointPQPlayer
3285,JointPQPlayer,243,238,481,41,20,Player A
3286,JointPQPlayer,257,257,514,53,13,Tie
3287,JointPQPlayer,254,259,513,49,12,JointPQPlayer
3288,JointPQPlayer,197,192,389,12,41,Player A
3289,JointPQPlayer,260,260,520,47,9,Tie
3290,JointPQPlayer,237,237,474,49,25,Tie
3291,JointPQPlayer,210,210,420,25,35,Tie
3292,JointPQPlayer,258,258,516,46,10,Tie
3293,JointPQPlayer,255,255,510,40,10,Tie
3294,JointPQPlayer,264,264,528,52,8,Tie
3295,JointPQPlayer,189,194,383,12,43,JointPQPlayer
3296,JointPQPlayer,245,245,490,41,17,Tie
3297,JointPQPlayer,252,247,499,53,18,Player A
3298,JointPQPlayer,183,188,371,12,47,JointPQPlayer
3299,JointPQPlayer,263,263,526,47,7,Tie
3300,JointPQPlayer,251,246,497,45,16,Player A
3301,JointPQPlayer,223,223,446,27,27,Tie
3302,JointPQPlayer,191,196,387,7,40,JointPQPlayer
3303,JointPQPlayer,271,266,537,55,6,Player A
3304,JointPQPlayer,245,245,490,41,17,Tie
3305,JointPQPlayer,252,257,509,39,10,JointPQPlayer
3306,JointPQPlayer,270,265,535,47,4,Player A
3307,JointPQPlayer,250,255,505,47,14,JointPQPlayer
3308,JointPQPlayer,235,230,465,31,22,Player A
3309,JointPQPlayer,260,260,520,53,11,Tie
3310,JointPQPlayer,261,261,522,46,8,Tie
3311,JointPQPlayer,223,223,446,33,29,Tie
3312,JointPQPlayer,259,264,523,53,10,JointPQPlayer
3313,JointPQPlayer,165,165,330,4,58,Tie
3314,JointPQPlayer,259,254,513,52,13,Player A
3315,JointPQPlayer,245,245,490,41,17,Tie
3316,JointPQPlayer,268,273,541,56,5,JointPQPlayer
3317,JointPQPlayer,259,254,513,46,11,Player A
3318,JointPQPlayer,240,245,485,39,18,JointPQPlayer
3319,JointPQPlayer,266,266,532,53,7,Tie
3320,JointPQPlayer,262,262,524,51,9,Tie
3321,JointPQPlayer,237,232,469,41,24,Player A
3322,JointPQPlayer,235,235,470,36,22,Tie
3323,JointPQPlayer,265,270,535,53,6,JointPQPlayer
3324,JointPQPlayer,263,258,521,42,7,Player A
3325,JointPQPlayer,167,172,339,7,56,JointPQPlayer
3326,JointPQPlayer,264,264,528,55,9,Tie
3327,JointPQPlayer,237,237,474,43,23,Tie
3328,JointPQPlayer,247,242,489,40,17,Player A
3329,JointPQPlayer,270,270,540,61,7,Tie
3330,JointPQPlayer,276,276,552,64,4,Tie
3331,JointPQPlayer,192,197,389,24,45,JointPQPlayer
3332,JointPQPlayer,180,180,360,7,49,Tie
3333,JointPQPlayer,222,222,444,37,31,Tie
3334,JointPQPlayer,256,256,512,42,10,Tie
3335,JointPQPlayer,246,246,492,43,17,Tie
3336,JointPQPlayer,165,165,330,7,59,Tie
3337,JointPQPlayer,171,166,337,11,58,Player A
3338,JointPQPlayer,256,261,517,47,10,JointPQPlayer
3339,JointPQPlayer,184,184,368,6,46,Tie
3340,JointPQPlayer,267,262,529,50,7,Player A
3341,JointPQPlayer,236,236,472,38,22,Tie
3342,JointPQPlayer,241,241,482,45,21,Tie
3343,JointPQPlayer,187,192,379,11,44,JointPQPlayer
3344,JointPQPlayer,193,193,386,18,44,Tie
3345,JointPQPlayer,220,220,440,24,28,Tie
3346,JointPQPlayer,259,259,518,45,9,Tie
3347,JointPQPlayer,255,255,510,49,13,Tie
3348,JointPQPlayer,236,236,472,32,20,Tie
3349,JointPQPlayer,169,169,338,9,57,Tie
3350,JointPQPlayer,220,215,435,31,32,Player A
3351,JointPQPlayer,224,224,448,41,31,Tie
3352,JointPQPlayer,218,218,436,38,34,Tie
3353,JointPQPlayer,242,247,489,43,18,JointPQPlayer
3354,JointPQPlayer,256,251,507,46,13,Player A
3355,JointPQPlayer,249,249,498,40,14,Tie
3356,JointPQPlayer,257,262,519,49,10,JointPQPlayer
3357,JointPQPlayer,253,253,506,45,13,Tie
3358,JointPQPlayer,248,248,496,41,15,Tie
3359,JointPQPlayer,152,152,304,2,66,Tie
3360,JointPQPlayer,249,244,493,44,17,Player A
3361,JointPQPlayer,246,246,492,40,16,Tie
3362,JointPQPlayer,236,241,477,34,19,JointPQPlayer
3363,JointPQPlayer,265,265,530,48,6,Tie
3364,JointPQPlayer,228,223,451,32,27,Player A
3365,JointPQPlayer,254,254,508,47,13,Tie
3366,JointPQPlayer,254,259,513,46,11,JointPQPlayer
3367,JointPQPlayer,261,256,517,44,9,Player A
3368,JointPQPlayer,250,250,500,48,16,Tie
3369,JointPQPlayer,200,200,400,23,41,Tie
3370,JointPQPlayer,257,257,514,44,10,Tie
3371,JointPQPlayer,249,249,498,49,17,Tie
3372,JointPQPlayer,197,197,394,17,41,Tie
3373,JointPQPlayer,197,202,399,10,37,JointPQPlayer
3374,JointPQPlayer,166,166,332,6,58,Tie
3375,JointPQPlayer,259,259,518,42,8,Tie
3376,JointPQPlayer,264,259,523,50,9,Player A
3377,JointPQPlayer,196,201,397,11,38,JointPQPlayer
3378,JointPQPlayer,279,279,558,64,2,Tie
3379,JointPQPlayer,239,239,478,35,19,Tie
3380,JointPQPlayer,255,250,505,47,14,Player A
3381,JointPQPlayer,218,218,436,26,30,Tie
3382,JointPQPlayer,260,260,520,50,10,Tie
3383,JointPQPlayer,261,266,527,48,7,JointPQPlayer
3384,JointPQPlayer,247,242,489,40,17,Player A
3385,JointPQPlayer,258,258,516,40,8,Tie
3386,JointPQPlayer,269,274,543,64,7,JointPQPlayer
3387,JointPQPlayer,187,187,374,12,46,Tie
3388,JointPQPlayer,223,218,441,25,28,Player A
3389,JointPQPlayer,263,263,526,53,9,Tie
3390,JointPQPlayer,180,185,365,9,48,JointPQPlayer
3391,JointPQPlayer,190,190,380,18,46,Tie
3392,JointPQPlayer,257,257,514,53,13,Tie
3393,JointPQPlayer,263,258,521,48,9,Player A
3394,JointPQPlayer,252,252,504,49,15,Tie
3395,JointPQPlayer,264,264,528,55,9,Tie
3396,JointPQPlayer,268,268,536,51,5,Tie
3397,JointPQPlayer,261,266,527,54,9,JointPQPlayer
3398,JointPQPlayer,249,249,498,46,16,Tie
3399,JointPQPlayer,197,197,394,23,43,Tie
3400,JointPQPlayer,235,235,470,30,20,Tie
3401,JointPQPlayer,242,242,484,44,20,Tie
3402,JointPQPlayer,249,244,493,41,16,Player A
3403,JointPQPlayer,183,188,371,9,46,JointPQPlayer
3404,JointPQPlayer,261,256,517,47,10,Player A
3405,JointPQPlayer,268,273,541,56,5,JointPQPlayer
3406,JointPQPlayer,247,247,494,54,20,Tie
3407,JointPQPlayer,189,184,373,8,45,Player A
3408,JointPQPlayer,235,235,470,33,21,Tie
3409,JointPQPlayer,249,254,503,51,16,JointPQPlayer
3410,JointPQPlayer,217,217,434,30,32,Tie
3411,JointPQPlayer,261,256,517,56,13,Player A
3412,JointPQPlayer,256,261,517,53,12,JointPQPlayer
3413,JointPQPlayer,252,252,504,49,15,Tie
3414,JointPQPlayer,255,250,505,47,14,Player A
3415,JointPQPlayer,239,239,478,32,18,Tie
3416,JointPQPlayer,237,242,479,48,23,JointPQPlayer
3417,JointPQPlayer,258,258,516,49,11,Tie
3418,JointPQPlayer,270,265,535,50,5,Player A
3419,JointPQPlayer,173,178,351,7,52,JointPQPlayer
3420,JointPQPlayer,260,260,520,44,8,Tie
3421,JointPQPlayer,187,187,374,15,47,Tie
3422,JointPQPlayer,235,230,465,40,25,Player A
3423,JointPQPlayer,251,256,507,46,13,JointPQPlayer
3424,JointPQPlayer,279,274,553,65,4,Player A
3425,JointPQPlayer,230,235,465,37,24,JointPQPlayer
3426,JointPQPlayer,232,227,459,34,25,Player A
3427,JointPQPlayer,206,206,412,26,38,Tie
3428,JointPQPlayer,259,259,518,48,10,Tie
3429,JointPQPlayer,244,244,488,39,17,Tie
3430,JointPQPlayer,245,245,490,29,13,Tie
3431,JointPQPlayer,263,263,526,50,8,Tie
3432,JointPQPlayer,177,182,359,6,49,JointPQPlayer
3433,JointPQPlayer,260,255,515,45,10,Player A
3434,JointPQPlayer,260,260,520,47,9,Tie
3435,JointPQPlayer,272,272,544,56,4,Tie
3436,JointPQPlayer,265,265,530,51,7,Tie
3437,JointPQPlayer,252,252,504,43,13,Tie
3438,JointPQPlayer,177,177,354,4,50,Tie
3439,JointPQPlayer,178,183,361,5,48,JointPQPlayer
3440,JointPQPlayer,217,212,429,31,34,Player A
3441,JointPQPlayer,270,270,540,58,6,Tie
3442,JointPQPlayer,242,247,489,40,17,JointPQPlayer
3443,JointPQPlayer,181,181,362,12,50,Tie
3444,JointPQPlayer,276,271,547,59,4,Player A
3445,JointPQPlayer,265,265,530,54,8,Tie
3446,JointPQPlayer,243,243,486,43,19,Tie
3447,JointPQPlayer,216,216,432,34,34,Tie
3448,JointPQPlayer,250,255,505,38,11,JointPQPlayer
3449,JointPQPlayer,275,270,545,63,6,Player A
3450,JointPQPlayer,256,256,512,39,9,Tie
3451,JointPQPlayer,272,272,544,53,3,Tie
3452,JointPQPlayer,234,239,473,39,22,JointPQPlayer
3453,JointPQPlayer,238,238,476,33,19,Tie
3454,JointPQPlayer,260,255,515,48,11,Player A
3455,JointPQPlayer,256,256,512,48,12,Tie
3456,JointPQPlayer,233,233,466,38,24,Tie
3457,JointPQPlayer,186,186,372,13,47,Tie
3458,JointPQPlayer,254,254,508,41,11,Tie
3459,JointPQPlayer,251,256,507,43,12,JointPQPlayer
3460,JointPQPlayer,254,249,503,42,13,Player A
3461,JointPQPlayer,225,225,450,31,27,Tie
3462,JointPQPlayer,265,265,530,54,8,Tie
3463,JointPQPlayer,250,250,500,51,17,Tie
3464,JointPQPlayer,252,252,504,46,14,Tie
3465,JointPQPlayer,260,265,525,52,9,JointPQPlayer
3466,JointPQPlayer,249,244,493,44,17,Player A
3467,JointPQPlayer,250,250,500,42,14,Tie
3468,JointPQPlayer,264,264,528,58,10,Tie
3469,JointPQPlayer,259,259,518,51,11,Tie
3470,JointPQPlayer,259,259,518,51,11,Tie
3471,JointPQPlayer,239,239,478,41,21,Tie
3472,JointPQPlayer,250,250,500,45,15,Tie
3473,JointPQPlayer,151,156,307,5,66,JointPQPlayer
3474,JointPQPlayer,192,192,384,16,44,Tie
3475,JointPQPlayer,168,168,336,7,57,Tie
3476,JointPQPlayer,236,231,467,39,24,Player A
3477,JointPQPlayer,183,188,371,12,47,JointPQPlayer
3478,JointPQPlayer,230,225,455,33,26,Player A
3479,JointPQPlayer,245,245,490,32,14,Tie
3480,JointPQPlayer,243,243,486,34,16,Tie
3481,JointPQPlayer,252,257,509,45,12,JointPQPlayer
3482,JointPQPlayer,253,248,501,43,14,Player A
3483,JointPQPlayer,255,255,510,52,14,Tie
3484,JointPQPlayer,241,246,487,35,16,JointPQPlayer
3485,JointPQPlayer,194,194,388,17,43,Tie
3486,JointPQPlayer,251,246,497,39,14,Player A
3487,JointPQPlayer,224,229,453,28,25,JointPQPlayer
3488,JointPQPlayer,260,260,520,50,10,Tie
3489,JointPQPlayer,255,250,505,47,14,Player A
3490,JointPQPlayer,269,269,538,59,7,Tie
3491,JointPQPlayer,253,253,506,45,13,Tie
3492,JointPQPlayer,241,241,482,39,19,Tie
3493,JointPQPlayer,173,173,346,11,55,Tie
3494,JointPQPlayer,221,226,447,34,29,JointPQPlayer
3495,JointPQPlayer,183,183,366,7,47,Tie
3496,JointPQPlayer,254,249,503,48,15,Player A
3497,JointPQPlayer,236,241,477,31,18,JointPQPlayer
3498,JointPQPlayer,245,245,490,32,14,Tie
3499,JointPQPlayer,155,155,310,2,64,Tie
3500,JointPQPlayer,252,247,499,44,15,Player A
3501,JointPQPlayer,226,231,457,38,27,JointPQPlayer
3502,JointPQPlayer,225,220,445,32,29,Player A
3503,JointPQPlayer,227,227,454,35,27,Tie
3504,JointPQPlayer,257,257,514,47,11,Tie
3505,JointPQPlayer,187,192,379,11,44,JointPQPlayer
3506,JointPQPlayer,230,225,455,36,27,Player A
3507,JointPQPlayer,265,265,530,48,6,Tie
3508,JointPQPlayer,202,202,404,24,40,Tie
3509,JointPQPlayer,239,239,478,41,21,Tie
3510,JointPQPlayer,266,266,532,50,6,Tie
3511,JointPQPlayer,269,269,538,62,8,Tie
3512,JointPQPlayer,261,261,522,46,8,Tie
3513,JointPQPlayer,165,170,335,6,57,JointPQPlayer
3514,JointPQPlayer,224,219,443,30,29,Player A
3515,JointPQPlayer,212,212,424,29,35,Tie
3516,JointPQPlayer,257,257,514,47,11,Tie
3517,JointPQPlayer,217,222,439,26,29,JointPQPlayer
3518,JointPQPlayer,271,266,537,55,6,Player A
3519,JointPQPlayer,246,246,492,43,17,Tie
3520,JointPQPlayer,248,253,501,46,15,JointPQPlayer
3521,JointPQPlayer,180,180,360,7,49,Tie
3522,JointPQPlayer,269,269,538,50,4,Tie
3523,JointPQPlayer,263,258,521,48,9,Player A
3524,JointPQPlayer,244,249,493,38,15,JointPQPlayer
3525,JointPQPlayer,184,184,368,18,50,Tie
3526,JointPQPlayer,241,236,477,34,19,Player A
3527,JointPQPlayer,263,268,531,55,8,JointPQPlayer
3528,JointPQPlayer,209,204,413,18,35,Player A
3529,JointPQPlayer,267,267,534,52,6,Tie
3530,JointPQPlayer,178,183,361,11,50,JointPQPlayer
3531,JointPQPlayer,264,259,523,50,9,Player A
3532,JointPQPlayer,254,259,513,49,12,JointPQPlayer
3533,JointPQPlayer,238,233,471,37,22,Player A
3534,JointPQPlayer,239,239,478,44,22,Tie
3535,JointPQPlayer,238,238,476,39,21,Tie
3536,JointPQPlayer,162,167,329,6,59,JointPQPlayer
3537,JointPQPlayer,264,259,523,50,9,Player A
3538,JointPQPlayer,251,256,507,43,12,JointPQPlayer
3539,JointPQPlayer,260,255,515,42,9,Player A
3540,JointPQPlayer,258,258,516,46,10,Tie
3541,JointPQPlayer,242,247,489,40,17,JointPQPlayer
3542,JointPQPlayer,198,193,391,20,43,Player A
3543,JointPQPlayer,213,213,426,31,35,Tie
3544,JointPQPlayer,267,267,534,49,5,Tie
3545,JointPQPlayer,266,266,532,53,7,Tie
3546,JointPQPlayer,262,262,524,54,10,Tie
3547,JointPQPlayer,262,267,529,50,7,JointPQPlayer
3548,JointPQPlayer,255,255,510,49,13,Tie
3549,JointPQPlayer,196,191,387,19,44,Player A
3550,JointPQPlayer,221,226,447,31,28,JointPQPlayer
3551,JointPQPlayer,165,165,330,7,59,Tie
3552,JointPQPlayer,248,248,496,50,18,Tie
3553,JointPQPlayer,248,243,491,42,17,Player A
3554,JointPQPlayer,245,245,490,35,15,Tie
3555,JointPQPlayer,259,264,523,44,7,JointPQPlayer
3556,JointPQPlayer,265,260,525,55,10,Player A
3557,JointPQPlayer,233,233,466,35,23,Tie
3558,JointPQPlayer,245,250,495,46,17,JointPQPlayer
3559,JointPQPlayer,177,177,354,7,51,Tie
3560,JointPQPlayer,176,176,352,5,51,Tie
3561,JointPQPlayer,191,186,377,12,45,Player A
3562,JointPQPlayer,239,244,483,40,19,JointPQPlayer
3563,JointPQPlayer,244,244,488,36,16,Tie
3564,JointPQPlayer,237,237,474,43,23,Tie
3565,JointPQPlayer,250,245,495,40,15,Player A
3566,JointPQPlayer,166,171,337,8,57,JointPQPlayer
3567,JointPQPlayer,229,224,453,34,27,Player A
3568,JointPQPlayer,252,257,509,42,11,JointPQPlayer
3569,JointPQPlayer,254,249,503,42,13,Player A
3570,JointPQPlayer,271,271,542,60,6,Tie
3571,JointPQPlayer,243,248,491,36,15,JointPQPlayer
3572,JointPQPlayer,256,256,512,45,11,Tie
3573,JointPQPlayer,258,253,511,41,10,Player A
3574,JointPQPlayer,267,272,539,60,7,JointPQPlayer
3575,JointPQPlayer,241,236,477,43,22,Player A
3576,JointPQPlayer,264,264,528,55,9,Tie
3577,JointPQPlayer,262,262,524,51,9,Tie
3578,JointPQPlayer,192,197,389,12,41,JointPQPlayer
3579,JointPQPlayer,183,183,366,10,48,Tie
3580,JointPQPlayer,259,259,518,48,10,Tie
3581,JointPQPlayer,275,270,545,54,3,Player A
3582,JointPQPlayer,193,193,386,21,45,Tie
3583,JointPQPlayer,255,260,515,42,9,JointPQPlayer
3584,JointPQPlayer,255,255,510,49,13,Tie
3585,JointPQPlayer,252,247,499,44,15,Player A
3586,JointPQPlayer,261,261,522,46,8,Tie
3587,JointPQPlayer,187,192,379,8,43,JointPQPlayer
3588,JointPQPlayer,259,259,518,51,11,Tie
3589,JointPQPlayer,220,220,440,27,29,Tie
3590,JointPQPlayer,173,168,341,6,55,Player A
3591,JointPQPlayer,199,199,398,15,39,Tie
3592,JointPQPlayer,255,255,510,49,13,Tie
3593,JointPQPlayer,166,171,337,8,57,JointPQPlayer
3594,JointPQPlayer,248,248,496,44,16,Tie
3595,JointPQPlayer,258,258,516,52,12,Tie
3596,JointPQPlayer,183,183,366,10,48,Tie
3597,JointPQPlayer,255,255,510,49,13,Tie
3598,JointPQPlayer,251,251,502,38,12,Tie
3599,JointPQPlayer,271,266,537,46,3,Player A
3600,JointPQPlayer,247,247,494,48,18,Tie
3601,JointPQPlayer,261,261,522,46,8,Tie
3602,JointPQPlayer,245,245,490,44,18,Tie
3603,JointPQPlayer,264,264,528,52,8,Tie
3604,JointPQPlayer,234,234,468,34,22,Tie
3605,JointPQPlayer,258,263,521,54,11,JointPQPlayer
3606,JointPQPlayer,246,246,492,43,17,Tie
3607,JointPQPlayer,239,234,473,36,21,Player A
3608,JointPQPlayer,178,183,361,11,50,JointPQPlayer
3609,JointPQPlayer,257,252,509,45,12,Player A
3610,JointPQPlayer,254,254,508,53,15,Tie
3611,JointPQPlayer,244,244,488,42,18,Tie
3612,JointPQPlayer,239,239,478,41,21,Tie
3613,JointPQPlayer,192,192,384,16,44,Tie
3614,JointPQPlayer,254,259,513,43,10,JointPQPlayer
3615,JointPQPlayer,234,229,463,35,24,Player A
3616,JointPQPlayer,218,218,436,26,30,Tie
3617,JointPQPlayer,244,249,493,41,16,JointPQPlayer
3618,JointPQPlayer,268,268,536,51,5,Tie
3619,JointPQPlayer,180,180,360,7,49,Tie
3620,JointPQPlayer,214,209,423,31,36,Player A
3621,JointPQPlayer,200,205,405,25,40,JointPQPlayer
3622,JointPQPlayer,261,256,517,44,9,Player A
3623,JointPQPlayer,261,266,527,54,9,JointPQPlayer
3624,JointPQPlayer,160,160,320,3,61,Tie
3625,JointPQPlayer,270,265,535,59,8,Player A
3626,JointPQPlayer,256,261,517,47,10,JointPQPlayer
3627,JointPQPlayer,180,180,360,7,49,Tie
3628,JointPQPlayer,245,245,490,44,18,Tie
3629,JointPQPlayer,260,255,515,54,13,Player A
3630,JointPQPlayer,224,229,453,34,27,JointPQPlayer
3631,JointPQPlayer,181,181,362,6,48,Tie
3632,JointPQPlayer,247,242,489,40,17,Player A
3633,JointPQPlayer,259,259,518,54,12,Tie
3634,JointPQPlayer,253,258,511,44,11,JointPQPlayer
3635,JointPQPlayer,188,183,371,6,45,Player A
3636,JointPQPlayer,145,150,295,2,69,JointPQPlayer
3637,JointPQPlayer,156,156,312,7,65,Tie
3638,JointPQPlayer,276,271,547,59,4,Player A
3639,JointPQPlayer,270,270,540,49,3,Tie
3640,JointPQPlayer,271,271,542,54,4,Tie
3641,JointPQPlayer,190,190,380,12,44,Tie
3642,JointPQPlayer,188,188,376,11,45,Tie
3643,JointPQPlayer,186,186,372,13,47,Tie
3644,JointPQPlayer,263,263,526,47,7,Tie
3645,JointPQPlayer,266,266,532,53,7,Tie
3646,JointPQPlayer,251,256,507,43,12,JointPQPlayer
3647,JointPQPlayer,254,249,503,42,13,Player A
3648,JointPQPlayer,250,255,505,44,13,JointPQPlayer
3649,JointPQPlayer,252,247,499,41,14,Player A
3650,JointPQPlayer,183,188,371,6,45,JointPQPlayer
3651,JointPQPlayer,259,254,513,55,14,Player A
3652,JointPQPlayer,271,276,547,56,3,JointPQPlayer
3653,JointPQPlayer,252,247,499,44,15,Player A
3654,JointPQPlayer,236,236,472,29,19,Tie
3655,JointPQPlayer,266,266,532,50,6,Tie
3656,JointPQPlayer,264,269,533,51,6,JointPQPlayer
3657,JointPQPlayer,168,168,336,7,57,Tie
3658,JointPQPlayer,260,255,515,48,11,Player A
3659,JointPQPlayer,245,250,495,46,17,JointPQPlayer
3660,JointPQPlayer,271,266,537,58,7,Player A
3661,JointPQPlayer,259,264,523,47,8,JointPQPlayer
3662,JointPQPlayer,247,247,494,36,14,Tie
3663,JointPQPlayer,258,253,511,44,11,Player A
3664,JointPQPlayer,246,246,492,43,17,Tie
3665,JointPQPlayer,172,177,349,5,52,JointPQPlayer
3666,JointPQPlayer,216,216,432,25,31,Tie
3667,JointPQPlayer,237,232,469,41,24,Player A
3668,JointPQPlayer,258,258,516,46,10,Tie
3669,JointPQPlayer,259,259,518,45,9,Tie
3670,JointPQPlayer,270,270,540,55,5,Tie
3671,JointPQPlayer,250,250,500,42,14,Tie
3672,JointPQPlayer,182,187,369,13,48,JointPQPlayer
3673,JointPQPlayer,180,175,355,8,51,Player A
3674,JointPQPlayer,236,236,472,41,23,Tie
3675,JointPQPlayer,222,222,444,28,28,Tie
3676,JointPQPlayer,180,185,365,9,48,JointPQPlayer
3677,JointPQPlayer,253,248,501,43,14,Player A
3678,JointPQPlayer,209,214,423,31,36,JointPQPlayer
3679,JointPQPlayer,241,236,477,34,19,Player A
3680,JointPQPlayer,274,274,548,57,3,Tie
3681,JointPQPlayer,251,256,507,52,15,JointPQPlayer
3682,JointPQPlayer,262,262,524,54,10,Tie
3683,JointPQPlayer,197,197,394,17,41,Tie
3684,JointPQPlayer,261,256,517,44,9,Player A
3685,JointPQPlayer,247,252,499,38,13,JointPQPlayer
3686,JointPQPlayer,190,185,375,13,46,Player A
3687,JointPQPlayer,242,242,484,41,19,Tie
3688,JointPQPlayer,239,239,478,38,20,Tie
3689,JointPQPlayer,242,247,489,46,19,JointPQPlayer
3690,JointPQPlayer,247,242,489,37,16,Player A
3691,JointPQPlayer,266,271,537,46,3,JointPQPlayer
3692,JointPQPlayer,253,248,501,37,12,Player A
3693,JointPQPlayer,156,156,312,4,64,Tie
3694,JointPQPlayer,178,178,356,6,50,Tie
3695,JointPQPlayer,176,181,357,10,51,JointPQPlayer
3696,JointPQPlayer,249,244,493,32,13,Player A
3697,JointPQPlayer,254,254,508,44,12,Tie
3698,JointPQPlayer,250,250,500,45,15,Tie
3699,JointPQPlayer,227,227,454,38,28,Tie
3700,JointPQPlayer,255,260,515,54,13,JointPQPlayer
3701,JointPQPlayer,248,243,491,39,16,Player A
3702,JointPQPlayer,183,183,366,7,47,Tie
3703,JointPQPlayer,263,268,531,55,8,JointPQPlayer
3704,JointPQPlayer,182,182,364,11,49,Tie
3705,JointPQPlayer,273,268,541,56,5,Player A
3706,JointPQPlayer,248,248,496,41,15,Tie
3707,JointPQPlayer,255,255,510,46,12,Tie
3708,JointPQPlayer,247,252,499,35,12,JointPQPlayer
3709,JointPQPlayer,204,199,403,20,39,Player A
3710,JointPQPlayer,245,250,495,43,16,JointPQPlayer
3711,JointPQPlayer,271,271,542,51,3,Tie
3712,JointPQPlayer,265,260,525,55,10,Player A
3713,JointPQPlayer,246,246,492,43,17,Tie
3714,JointPQPlayer,257,262,519,49,10,JointPQPlayer
3715,JointPQPlayer,248,243,491,42,17,Player A
3716,JointPQPlayer,234,239,473,39,22,JointPQPlayer
3717,JointPQPlayer,275,270,545,60,5,Player A
3718,JointPQPlayer,256,256,512,48,12,Tie
3719,JointPQPlayer,229,229,458,36,26,Tie
3720,JointPQPlayer,252,252,504,43,13,Tie
3721,JointPQPlayer,253,253,506,48,14,Tie
3722,JointPQPlayer,241,246,487,41,18,JointPQPlayer
3723,JointPQPlayer,227,222,449,27,26,Player A
3724,JointPQPlayer,165,170,335,9,58,JointPQPlayer
3725,JointPQPlayer,245,245,490,38,16,Tie
3726,JointPQPlayer,247,247,494,42,16,Tie
3727,JointPQPlayer,260,255,515,45,10,Player A
3728,JointPQPlayer,265,265,530,54,8,Tie
3729,JointPQPlayer,270,270,540,55,5,Tie
3730,JointPQPlayer,190,195,385,20,45,JointPQPlayer
3731,JointPQPlayer,251,246,497,42,15,Player A
3732,JointPQPlayer,256,256,512,39,9,Tie
3733,JointPQPlayer,248,253,501,43,14,JointPQPlayer
3734,JointPQPlayer,248,248,496,50,18,Tie
3735,JointPQPlayer,255,250,505,41,12,Player A
3736,JointPQPlayer,250,250,500,42,14,Tie
3737,JointPQPlayer,232,237,469,38,23,JointPQPlayer
3738,JointPQPlayer,258,253,511,47,12,Player A
3739,JointPQPlayer,261,261,522,49,9,Tie
3740,JointPQPlayer,261,266,527,48,7,JointPQPlayer
3741,JointPQPlayer,170,170,340,2,54,Tie
3742,JointPQPlayer,257,257,514,44,10,Tie
3743,JointPQPlayer,216,211,427,23,32,Player A
3744,JointPQPlayer,261,261,522,49,9,Tie
3745,JointPQPlayer,262,262,524,48,8,Tie
3746,JointPQPlayer,272,272,544,59,5,Tie
3747,JointPQPlayer,246,246,492,43,17,Tie
3748,JointPQPlayer,257,257,514,53,13,Tie
3749,JointPQPlayer,237,237,474,34,20,Tie
3750,JointPQPlayer,173,178,351,7,52,JointPQPlayer
3751,JointPQPlayer,268,268,536,57,7,Tie
3752,JointPQPlayer,226,221,447,31,28,Player A
3753,JointPQPlayer,239,244,483,37,18,JointPQPlayer
3754,JointPQPlayer,262,257,519,55,12,Player A
3755,JointPQPlayer,185,185,370,5,45,Tie
3756,JointPQPlayer,261,261,522,52,10,Tie
3757,JointPQPlayer,261,261,522,49,9,Tie
3758,JointPQPlayer,253,253,506,45,13,Tie
3759,JointPQPlayer,243,243,486,43,19,Tie
3760,JointPQPlayer,165,170,335,6,57,JointPQPlayer
3761,JointPQPlayer,266,261,527,57,10,Player A
3762,JointPQPlayer,259,259,518,48,10,Tie
3763,JointPQPlayer,195,195,390,19,43,Tie
3764,JointPQPlayer,265,265,530,51,7,Tie
3765,JointPQPlayer,200,205,405,22,39,JointPQPlayer
3766,JointPQPlayer,170,170,340,8,56,Tie
3767,JointPQPlayer,237,237,474,34,20,Tie
3768,JointPQPlayer,237,232,469,35,22,Player A
3769,JointPQPlayer,227,227,454,29,25,Tie
3770,JointPQPlayer,263,263,526,50,8,Tie
3771,JointPQPlayer,239,239,478,41,21,Tie
3772,JointPQPlayer,260,260,520,47,9,Tie
3773,JointPQPlayer,220,225,445,26,27,JointPQPlayer
3774,JointPQPlayer,266,266,532,53,7,Tie
3775,JointPQPlayer,177,177,354,7,51,Tie
3776,JointPQPlayer,263,258,521,45,8,Player A
3777,JointPQPlayer,263,263,526,53,9,Tie
3778,JointPQPlayer,268,273,541,56,5,JointPQPlayer
3779,JointPQPlayer,268,263,531,58,9,Player A
3780,JointPQPlayer,224,224,448,35,29,Tie
3781,JointPQPlayer,218,218,436,35,33,Tie
3782,JointPQPlayer,256,256,512,45,11,Tie
3783,JointPQPlayer,213,213,426,31,35,Tie
3784,JointPQPlayer,266,266,532,56,8,Tie
3785,JointPQPlayer,264,269,533,51,6,JointPQPlayer
3786,JointPQPlayer,180,180,360,7,49,Tie
3787,JointPQPlayer,237,237,474,37,21,Tie
3788,JointPQPlayer,246,241,487,47,20,Player A
3789,JointPQPlayer,257,257,514,53,13,Tie
3790,JointPQPlayer,227,227,454,26,24,Tie
3791,JointPQPlayer,224,229,453,28,25,JointPQPlayer
3792,JointPQPlayer,239,234,473,30,19,Player A
3793,JointPQPlayer,267,272,539,60,7,JointPQPlayer
3794,JointPQPlayer,253,253,506,45,13,Tie
3795,JointPQPlayer,252,247,499,50,17,Player A
3796,JointPQPlayer,261,261,522,43,7,Tie
3797,JointPQPlayer,260,265,525,52,9,JointPQPlayer
3798,JointPQPlayer,207,202,409,23,38,Player A
3799,JointPQPlayer,196,196,392,15,41,Tie
3800,JointPQPlayer,252,252,504,49,15,Tie
3801,JointPQPlayer,255,260,515,45,10,JointPQPlayer
3802,JointPQPlayer,215,215,430,23,31,Tie
3803,JointPQPlayer,253,253,506,54,16,Tie
3804,JointPQPlayer,267,262,529,50,7,Player A
3805,JointPQPlayer,257,257,514,41,9,Tie
3806,JointPQPlayer,211,211,422,24,34,Tie
3807,JointPQPlayer,247,252,499,38,13,JointPQPlayer
3808,JointPQPlayer,276,271,547,56,3,Player A
3809,JointPQPlayer,272,272,544,56,4,Tie
3810,JointPQPlayer,240,245,485,39,18,JointPQPlayer
3811,JointPQPlayer,267,262,529,53,8,Player A
3812,JointPQPlayer,258,258,516,52,12,Tie
3813,JointPQPlayer,234,239,473,42,23,JointPQPlayer
3814,JointPQPlayer,215,210,425,27,34,Player A
3815,JointPQPlayer,270,270,540,58,6,Tie
3816,JointPQPlayer,279,279,558,64,2,Tie
3817,JointPQPlayer,254,254,508,44,12,Tie
3818,JointPQPlayer,228,228,456,31,25,Tie
3819,JointPQPlayer,165,170,335,12,59,JointPQPlayer
3820,JointPQPlayer,244,244,488,36,16,Tie
3821,JointPQPlayer,273,268,541,50,3,Player A
3822,JointPQPlayer,254,254,508,44,12,Tie
3823,JointPQPlayer,249,249,498,43,15,Tie
3824,JointPQPlayer,270,270,540,52,4,Tie
3825,JointPQPlayer,242,247,489,37,16,JointPQPlayer
3826,JointPQPlayer,162,162,324,4,60,Tie
3827,JointPQPlayer,230,230,460,32,24,Tie
3828,JointPQPlayer,223,218,441,28,29,Player A
3829,JointPQPlayer,247,247,494,39,15,Tie
3830,JointPQPlayer,252,252,504,52,16,Tie
3831,JointPQPlayer,195,195,390,13,41,Tie
3832,JointPQPlayer,184,189,373,17,48,JointPQPlayer
3833,JointPQPlayer,268,263,531,52,7,Player A
3834,JointPQPlayer,246,246,492,49,19,Tie
3835,JointPQPlayer,183,188,371,6,45,JointPQPlayer
3836,JointPQPlayer,189,189,378,7,43,Tie
3837,JointPQPlayer,251,246,497,48,17,Player A
3838,JointPQPlayer,256,256,512,45,11,Tie
3839,JointPQPlayer,265,270,535,56,7,JointPQPlayer
3840,JointPQPlayer,174,174,348,4,52,Tie
3841,JointPQPlayer,249,244,493,50,19,Player A
3842,JointPQPlayer,179,179,358,11,51,Tie
3843,JointPQPlayer,250,255,505,47,14,JointPQPlayer
3844,JointPQPlayer,254,249,503,42,13,Player A
3845,JointPQPlayer,268,268,536,57,7,Tie
3846,JointPQPlayer,178,183,361,8,49,JointPQPlayer
3847,JointPQPlayer,167,162,329,6,59,Player A
3848,JointPQPlayer,256,256,512,54,14,Tie
3849,JointPQPlayer,257,262,519,49,10,JointPQPlayer
3850,JointPQPlayer,253,248,501,46,15,Player A
3851,JointPQPlayer,250,255,505,44,13,JointPQPlayer
3852,JointPQPlayer,228,228,456,28,24,Tie
3853,JointPQPlayer,256,251,507,37,10,Player A
3854,JointPQPlayer,238,238,476,42,22,Tie
3855,JointPQPlayer,191,191,382,14,44,Tie
3856,JointPQPlayer,254,254,508,41,11,Tie
3857,JointPQPlayer,246,246,492,43,17,Tie
3858,JointPQPlayer,252,252,504,43,13,Tie
3859,JointPQPlayer,259,259,518,51,11,Tie
3860,JointPQPlayer,192,197,389,21,44,JointPQPlayer
3861,JointPQPlayer,242,237,479,42,21,Player A
3862,JointPQPlayer,261,261,522,43,7,Tie
3863,JointPQPlayer,263,263,526,47,7,Tie
3864,JointPQPlayer,269,269,538,53,5,Tie
3865,JointPQPlayer,176,181,357,7,50,JointPQPlayer
3866,JointPQPlayer,266,261,527,54,9,Player A
3867,JointPQPlayer,267,267,534,52,6,Tie
3868,JointPQPlayer,198,198,396,16,40,Tie
3869,JointPQPlayer,186,186,372,16,48,Tie
3870,JointPQPlayer,275,275,550,62,4,Tie
3871,JointPQPlayer,248,248,496,41,15,Tie
3872,JointPQPlayer,261,261,522,46,8,Tie
3873,JointPQPlayer,233,238,471,34,21,JointPQPlayer
3874,JointPQPlayer,168,163,331,5,58,Player A
3875,JointPQPlayer,245,245,490,44,18,Tie
3876,JointPQPlayer,265,265,530,54,8,Tie
3877,JointPQPlayer,263,268,531,46,5,JointPQPlayer
3878,JointPQPlayer,213,208,421,26,35,Player A
3879,JointPQPlayer,275,275,550,62,4,Tie
3880,JointPQPlayer,194,199,393,22,43,JointPQPlayer
3881,JointPQPlayer,233,228,461,39,26,Player A
3882,JointPQPlayer,254,259,513,49,12,JointPQPlayer
3883,JointPQPlayer,244,239,483,46,21,Player A
3884,JointPQPlayer,238,238,476,39,21,Tie
3885,JointPQPlayer,246,246,492,43,17,Tie
3886,JointPQPlayer,252,257,509,39,10,JointPQPlayer
3887,JointPQPlayer,270,265,535,53,6,Player A
3888,JointPQPlayer,258,258,516,49,11,Tie
3889,JointPQPlayer,267,267,534,58,8,Tie
3890,JointPQPlayer,267,267,534,52,6,Tie
3891,JointPQPlayer,255,260,515,39,8,JointPQPlayer
3892,JointPQPlayer,265,260,525,43,6,Player A
3893,JointPQPlayer,266,266,532,59,9,Tie
3894,JointPQPlayer,264,269,533,48,5,JointPQPlayer
3895,JointPQPlayer,268,263,531,49,6,Player A
3896,JointPQPlayer,257,262,519,58,13,JointPQPlayer
3897,JointPQPlayer,269,269,538,59,7,Tie
3898,JointPQPlayer,205,200,405,25,40,Player A
3899,JointPQPlayer,188,188,376,14,46,Tie
3900,JointPQPlayer,248,248,496,41,15,Tie
3901,JointPQPlayer,265,265,530,51,7,Tie
3902,JointPQPlayer,256,261,517,50,11,JointPQPlayer
3903,JointPQPlayer,273,268,541,53,4,Player A
3904,JointPQPlayer,254,259,513,49,12,JointPQPlayer
3905,JointPQPlayer,192,192,384,16,44,Tie
3906,JointPQPlayer,274,269,543,52,3,Player A
3907,JointPQPlayer,235,235,470,36,22,Tie
3908,JointPQPlayer,253,258,511,47,12,JointPQPlayer
3909,JointPQPlayer,269,264,533,54,7,Player A
3910,JointPQPlayer,248,248,496,50,18,Tie
3911,JointPQPlayer,265,265,530,57,9,Tie
3912,JointPQPlayer,267,272,539,57,6,JointPQPlayer
3913,JointPQPlayer,259,254,513,46,11,Player A
3914,JointPQPlayer,190,190,380,15,45,Tie
3915,JointPQPlayer,236,241,477,34,19,JointPQPlayer
3916,JointPQPlayer,263,258,521,51,10,Player A
3917,JointPQPlayer,261,261,522,49,9,Tie
3918,JointPQPlayer,212,212,424,26,34,Tie
3919,JointPQPlayer,265,265,530,60,10,Tie
3920,JointPQPlayer,234,239,473,42,23,JointPQPlayer
3921,JointPQPlayer,213,208,421,17,32,Player A
3922,JointPQPlayer,241,241,482,48,22,Tie
3923,JointPQPlayer,175,180,355,5,50,JointPQPlayer
3924,JointPQPlayer,231,231,462,34,24,Tie
3925,JointPQPlayer,260,260,520,47,9,Tie
3926,JointPQPlayer,248,248,496,41,15,Tie
3927,JointPQPlayer,240,240,480,40,20,Tie
3928,JointPQPlayer,252,247,499,50,17,Player A
3929,JointPQPlayer,246,251,497,42,15,JointPQPlayer
3930,JointPQPlayer,236,231,467,45,26,Player A
3931,JointPQPlayer,246,246,492,37,15,Tie
3932,JointPQPlayer,257,257,514,38,8,Tie
3933,JointPQPlayer,269,269,538,59,7,Tie
3934,JointPQPlayer,249,249,498,46,16,Tie
3935,JointPQPlayer,271,271,542,57,5,Tie
3936,JointPQPlayer,248,248,496,47,17,Tie
3937,JointPQPlayer,253,253,506,39,11,Tie
3938,JointPQPlayer,259,259,518,45,9,Tie
3939,JointPQPlayer,224,229,453,37,28,JointPQPlayer
3940,JointPQPlayer,244,239,483,40,19,Player A
3941,JointPQPlayer,270,270,540,55,5,Tie
3942,JointPQPlayer,259,259,518,45,9,Tie
3943,JointPQPlayer,257,257,514,44,10,Tie
3944,JointPQPlayer,229,229,458,30,24,Tie
3945,JointPQPlayer,257,257,514,47,11,Tie
3946,JointPQPlayer,279,279,558,64,2,Tie
3947,JointPQPlayer,264,264,528,52,8,Tie
3948,JointPQPlayer,260,260,520,44,8,Tie
3949,JointPQPlayer,248,253,501,43,14,JointPQPlayer
3950,JointPQPlayer,199,194,393,13,40,Player A
3951,JointPQPlayer,251,256,507,52,15,JointPQPlayer
3952,JointPQPlayer,250,245,495,40,15,Player A
3953,JointPQPlayer,267,267,534,55,7,Tie
3954,JointPQPlayer,263,263,526,50,8,Tie
3955,JointPQPlayer,246,246,492,46,18,Tie
3956,JointPQPlayer,271,271,542,54,4,Tie
3957,JointPQPlayer,216,216,432,28,32,Tie
3958,JointPQPlayer,259,264,523,47,8,JointPQPlayer
3959,JointPQPlayer,187,187,374,6,44,Tie
3960,JointPQPlayer,254,249,503,39,12,Player A
3961,JointPQPlayer,259,259,518,39,7,Tie
3962,JointPQPlayer,219,224,443,30,29,JointPQPlayer
3963,JointPQPlayer,256,251,507,49,14,Player A
3964,JointPQPlayer,249,249,498,40,14,Tie
3965,JointPQPlayer,240,240,480,43,21,Tie
3966,JointPQPlayer,261,266,527,45,6,JointPQPlayer
3967,JointPQPlayer,217,217,434,30,32,Tie
3968,JointPQPlayer,228,223,451,29,26,Player A
3969,JointPQPlayer,271,271,542,57,5,Tie
3970,JointPQPlayer,209,209,418,20,34,Tie
3971,JointPQPlayer,267,267,534,52,6,Tie
3972,JointPQPlayer,208,208,416,30,38,Tie
3973,JointPQPlayer,255,260,515,51,12,JointPQPlayer
3974,JointPQPlayer,212,212,424,29,35,Tie
3975,JointPQPlayer,271,266,537,55,6,Player A
3976,JointPQPlayer,269,269,538,59,7,Tie
3977,JointPQPlayer,162,167,329,9,60,JointPQPlayer
3978,JointPQPlayer,265,260,525,46,7,Player A
3979,JointPQPlayer,256,261,517,50,11,JointPQPlayer
3980,JointPQPlayer,256,251,507,46,13,Player A
3981,JointPQPlayer,258,258,516,49,11,Tie
3982,JointPQPlayer,249,249,498,43,15,Tie
3983,JointPQPlayer,220,220,440,30,30,Tie
3984,JointPQPlayer,270,270,540,61,7,Tie
3985,JointPQPlayer,246,246,492,49,19,Tie
3986,JointPQPlayer,178,183,361,5,48,JointPQPlayer
3987,JointPQPlayer,185,180,365,12,49,Player A
3988,JointPQPlayer,266,271,537,58,7,JointPQPlayer
3989,JointPQPlayer,245,240,485,36,17,Player A
3990,JointPQPlayer,261,266,527,51,8,JointPQPlayer
3991,JointPQPlayer,246,246,492,40,16,Tie
3992,JointPQPlayer,233,233,466,32,22,Tie
3993,JointPQPlayer,174,169,343,8,55,Player A
3994,JointPQPlayer,179,179,358,14,52,Tie
3995,JointPQPlayer,183,188,371,9,46,JointPQPlayer
3996,JointPQPlayer,259,254,513,46,11,Player A
3997,JointPQPlayer,201,201,402,22,40,Tie
3998,JointPQPlayer,259,259,518,48,10,Tie
3999,JointPQPlayer,167,167,334,5,57,Tie
4000,JointPQPlayer,266,266,532,59,9,Tie
4001,JointPQPlayer,273,273,546,55,3,Tie
4002,JointPQPlayer,263,263,526,50,8,Tie
4003,JointPQPlayer,267,267,534,58,8,Tie
4004,JointPQPlayer,266,266,532,50,6,Tie
4005,JointPQPlayer,242,247,489,49,20,JointPQPlayer
4006,JointPQPlayer,184,184,368,9,47,Tie
4007,JointPQPlayer,173,173,346,5,53,Tie
4008,JointPQPlayer,231,231,462,34,24,Tie
4009,JointPQPlayer,267,262,529,50,7,Player A
4010,JointPQPlayer,224,224,448,26,26,Tie
4011,JointPQPlayer,251,251,502,50,16,Tie
4012,JointPQPlayer,261,261,522,58,12,Tie
4013,JointPQPlayer,158,163,321,4,61,JointPQPlayer
4014,JointPQPlayer,270,270,540,52,4,Tie
4015,JointPQPlayer,258,258,516,40,8,Tie
4016,JointPQPlayer,171,171,342,7,55,Tie
4017,JointPQPlayer,231,231,462,31,23,Tie
4018,JointPQPlayer,226,226,452,33,27,Tie
4019,JointPQPlayer,261,256,517,38,7,Player A
4020,JointPQPlayer,269,269,538,50,4,Tie
4021,JointPQPlayer,256,256,512,42,10,Tie
4022,JointPQPlayer,270,270,540,61,7,Tie
4023,JointPQPlayer,173,178,351,7,52,JointPQPlayer
4024,JointPQPlayer,254,249,503,48,15,Player A
4025,JointPQPlayer,224,224,448,29,27,Tie
4026,JointPQPlayer,238,238,476,33,19,Tie
4027,JointPQPlayer,239,239,478,41,21,Tie
4028,JointPQPlayer,252,252,504,40,12,Tie
4029,JointPQPlayer,149,154,303,4,67,JointPQPlayer
4030,JointPQPlayer,265,265,530,57,9,Tie
4031,JointPQPlayer,264,259,523,44,7,Player A
4032,JointPQPlayer,229,229,458,39,27,Tie
4033,JointPQPlayer,247,247,494,42,16,Tie
4034,JointPQPlayer,174,179,353,9,52,JointPQPlayer
4035,JointPQPlayer,249,244,493,38,15,Player A
4036,JointPQPlayer,264,269,533,54,7,JointPQPlayer
4037,JointPQPlayer,270,265,535,53,6,Player A
4038,JointPQPlayer,239,239,478,44,22,Tie
4039,JointPQPlayer,256,261,517,41,8,JointPQPlayer
4040,JointPQPlayer,223,218,441,31,30,Player A
4041,JointPQPlayer,260,260,520,53,11,Tie
4042,JointPQPlayer,255,255,510,43,11,Tie
4043,JointPQPlayer,233,233,466,41,25,Tie
4044,JointPQPlayer,185,190,375,10,45,JointPQPlayer
4045,JointPQPlayer,254,249,503,48,15,Player A
4046,JointPQPlayer,265,265,530,54,8,Tie
4047,JointPQPlayer,187,192,379,5,42,JointPQPlayer
4048,JointPQPlayer,251,246,497,45,16,Player A
4049,JointPQPlayer,269,269,538,56,6,Tie
4050,JointPQPlayer,263,268,531,52,7,JointPQPlayer
4051,JointPQPlayer,229,224,453,28,25,Player A
4052,JointPQPlayer,210,215,425,27,34,JointPQPlayer
4053,JointPQPlayer,252,247,499,41,14,Player A
4054,JointPQPlayer,262,262,524,45,7,Tie
4055,JointPQPlayer,249,249,498,40,14,Tie
4056,JointPQPlayer,230,230,460,35,25,Tie
4057,JointPQPlayer,187,192,379,14,45,JointPQPlayer
4058,JointPQPlayer,242,237,479,42,21,Player A
4059,JointPQPlayer,257,257,514,47,11,Tie
4060,JointPQPlayer,272,272,544,62,6,Tie
4061,JointPQPlayer,242,247,489,40,17,JointPQPlayer
4062,JointPQPlayer,235,235,470,36,22,Tie
4063,JointPQPlayer,257,257,514,47,11,Tie
4064,JointPQPlayer,250,250,500,48,16,Tie
4065,JointPQPlayer,272,267,539,57,6,Player A
4066,JointPQPlayer,190,195,385,14,43,JointPQPlayer
4067,JointPQPlayer,270,270,540,64,8,Tie
4068,JointPQPlayer,254,249,503,36,11,Player A
4069,JointPQPlayer,250,250,500,42,14,Tie
4070,JointPQPlayer,253,253,506,45,13,Tie
4071,JointPQPlayer,170,175,345,7,54,JointPQPlayer
4072,JointPQPlayer,227,222,449,33,28,Player A
4073,JointPQPlayer,253,253,506,48,14,Tie
4074,JointPQPlayer,248,248,496,44,16,Tie
4075,JointPQPlayer,256,261,517,47,10,JointPQPlayer
4076,JointPQPlayer,254,249,503,39,12,Player A
4077,JointPQPlayer,230,230,460,38,26,Tie
4078,JointPQPlayer,264,264,528,55,9,Tie
4079,JointPQPlayer,244,244,488,39,17,Tie
4080,JointPQPlayer,190,195,385,14,43,JointPQPlayer
4081,JointPQPlayer,234,234,468,34,22,Tie
4082,JointPQPlayer,250,245,495,40,15,Player A
4083,JointPQPlayer,261,261,522,49,9,Tie
4084,JointPQPlayer,247,252,499,50,17,JointPQPlayer
4085,JointPQPlayer,250,245,495,37,14,Player A
4086,JointPQPlayer,262,262,524,51,9,Tie
4087,JointPQPlayer,238,238,476,36,20,Tie
4088,JointPQPlayer,235,235,470,36,22,Tie
4089,JointPQPlayer,257,257,514,41,9,Tie
4090,JointPQPlayer,252,257,509,48,13,JointPQPlayer
4091,JointPQPlayer,260,255,515,54,13,Player A
4092,JointPQPlayer,262,262,524,48,8,Tie
4093,JointPQPlayer,206,206,412,26,38,Tie
4094,JointPQPlayer,261,261,522,46,8,Tie
4095,JointPQPlayer,270,270,540,67,9,Tie
4096,JointPQPlayer,262,262,524,51,9,Tie
4097,JointPQPlayer,252,252,504,43,13,Tie
4098,JointPQPlayer,222,222,444,34,30,Tie
4099,JointPQPlayer,150,155,305,3,66,JointPQPlayer
4100,JointPQPlayer,249,249,498,43,15,Tie
4101,JointPQPlayer,275,270,545,60,5,Player A
4102,JointPQPlayer,254,254,508,44,12,Tie
4103,JointPQPlayer,183,188,371,9,46,JointPQPlayer
4104,JointPQPlayer,254,249,503,51,16,Player A
4105,JointPQPlayer,186,186,372,7,45,Tie
4106,JointPQPlayer,250,250,500,45,15,Tie
4107,JointPQPlayer,247,247,494,39,15,Tie
4108,JointPQPlayer,256,256,512,48,12,Tie
4109,JointPQPlayer,240,240,480,40,20,Tie
4110,JointPQPlayer,229,229,458,33,25,Tie
4111,JointPQPlayer,246,251,497,45,16,JointPQPlayer
4112,JointPQPlayer,251,246,497,42,15,Player A
4113,JointPQPlayer,222,222,444,40,32,Tie
4114,JointPQPlayer,185,190,375,16,47,JointPQPlayer
4115,JointPQPlayer,189,189,378,7,43,Tie
4116,JointPQPlayer,255,250,505,53,16,Player A
4117,JointPQPlayer,247,252,499,53,18,JointPQPlayer
4118,JointPQPlayer,256,256,512,48,12,Tie
4119,JointPQPlayer,238,238,476,39,21,Tie
4120,JointPQPlayer,231,231,462,34,24,Tie
4121,JointPQPlayer,258,253,511,47,12,Player A
4122,JointPQPlayer,247,252,499,47,16,JointPQPlayer
4123,JointPQPlayer,228,223,451,32,27,Player A
4124,JointPQPlayer,245,250,495,40,15,JointPQPlayer
4125,JointPQPlayer,175,175,350,9,53,Tie
4126,JointPQPlayer,252,247,499,41,14,Player A
4127,JointPQPlayer,268,268,536,54,6,Tie
4128,JointPQPlayer,180,185,365,18,51,JointPQPlayer
4129,JointPQPlayer,175,170,345,4,53,Player A
4130,JointPQPlayer,268,268,536,54,6,Tie
4131,JointPQPlayer,241,241,482,48,22,Tie
4132,JointPQPlayer,251,256,507,40,11,JointPQPlayer
4133,JointPQPlayer,193,193,386,27,47,Tie
4134,JointPQPlayer,239,239,478,44,22,Tie
4135,JointPQPlayer,264,259,523,53,10,Player A
4136,JointPQPlayer,256,256,512,36,8,Tie
4137,JointPQPlayer,268,268,536,48,4,Tie
4138,JointPQPlayer,241,246,487,38,17,JointPQPlayer
4139,JointPQPlayer,227,222,449,33,28,Player A
4140,JointPQPlayer,223,228,451,38,29,JointPQPlayer
4141,JointPQPlayer,194,194,388,11,41,Tie
4142,JointPQPlayer,249,249,498,37,13,Tie
4143,JointPQPlayer,185,185,370,14,48,Tie
4144,JointPQPlayer,261,256,517,47,10,Player A
4145,JointPQPlayer,257,257,514,53,13,Tie
4146,JointPQPlayer,256,256,512,48,12,Tie
4147,JointPQPlayer,264,264,528,49,7,Tie
4148,JointPQPlayer,180,185,365,6,47,JointPQPlayer
4149,JointPQPlayer,259,254,513,43,10,Player A
4150,JointPQPlayer,174,179,353,6,51,JointPQPlayer
4151,JointPQPlayer,264,264,528,55,9,Tie
4152,JointPQPlayer,243,238,481,44,21,Player A
4153,JointPQPlayer,272,277,549,58,3,JointPQPlayer
4154,JointPQPlayer,177,172,349,5,52,Player A
4155,JointPQPlayer,224,229,453,37,28,JointPQPlayer
4156,JointPQPlayer,253,253,506,39,11,Tie
4157,JointPQPlayer,251,246,497,36,13,Player A
4158,JointPQPlayer,252,252,504,40,12,Tie
4159,JointPQPlayer,232,232,464,39,25,Tie
4160,JointPQPlayer,240,240,480,37,19,Tie
4161,JointPQPlayer,262,267,529,44,5,JointPQPlayer
4162,JointPQPlayer,200,195,395,18,41,Player A
4163,JointPQPlayer,246,251,497,48,17,JointPQPlayer
4164,JointPQPlayer,181,181,362,12,50,Tie
4165,JointPQPlayer,252,247,499,41,14,Player A
4166,JointPQPlayer,241,241,482,36,18,Tie
4167,JointPQPlayer,200,200,400,17,39,Tie
4168,JointPQPlayer,225,230,455,36,27,JointPQPlayer
4169,JointPQPlayer,263,258,521,42,7,Player A
4170,JointPQPlayer,165,170,335,3,56,JointPQPlayer
4171,JointPQPlayer,173,173,346,5,53,Tie
4172,JointPQPlayer,254,249,503,48,15,Player A
4173,JointPQPlayer,271,271,542,54,4,Tie
4174,JointPQPlayer,264,264,528,55,9,Tie
4175,JointPQPlayer,263,263,526,50,8,Tie
4176,JointPQPlayer,264,269,533,57,8,JointPQPlayer
4177,JointPQPlayer,228,223,451,29,26,Player A
4178,JointPQPlayer,238,238,476,33,19,Tie
4179,JointPQPlayer,263,263,526,50,8,Tie
4180,JointPQPlayer,191,196,387,25,46,JointPQPlayer
4181,JointPQPlayer,235,235,470,39,23,Tie
4182,JointPQPlayer,279,274,553,56,1,Player A
4183,JointPQPlayer,253,253,506,51,15,Tie
4184,JointPQPlayer,234,239,473,33,20,JointPQPlayer
4185,JointPQPlayer,187,187,374,9,45,Tie
4186,JointPQPlayer,252,252,504,43,13,Tie
4187,JointPQPlayer,185,185,370,11,47,Tie
4188,JointPQPlayer,260,260,520,50,10,Tie
4189,JointPQPlayer,233,228,461,30,23,Player A
4190,JointPQPlayer,179,184,363,16,51,JointPQPlayer
4191,JointPQPlayer,278,278,556,62,2,Tie
4192,JointPQPlayer,196,191,387,16,43,Player A
4193,JointPQPlayer,179,184,363,10,49,JointPQPlayer
4194,JointPQPlayer,218,218,436,29,31,Tie
4195,JointPQPlayer,195,190,385,14,43,Player A
4196,JointPQPlayer,271,271,542,60,6,Tie
4197,JointPQPlayer,236,236,472,35,21,Tie
4198,JointPQPlayer,258,263,521,48,9,JointPQPlayer
4199,JointPQPlayer,258,258,516,49,11,Tie
4200,JointPQPlayer,259,259,518,48,10,Tie
4201,JointPQPlayer,250,245,495,40,15,Player A
4202,JointPQPlayer,253,253,506,45,13,Tie
4203,JointPQPlayer,260,265,525,55,10,JointPQPlayer
4204,JointPQPlayer,252,247,499,47,16,Player A
4205,JointPQPlayer,231,231,462,34,24,Tie
4206,JointPQPlayer,265,265,530,51,7,Tie
4207,JointPQPlayer,201,206,407,24,39,JointPQPlayer
4208,JointPQPlayer,275,270,545,60,5,Player A
4209,JointPQPlayer,236,241,477,34,19,JointPQPlayer
4210,JointPQPlayer,250,245,495,40,15,Player A
4211,JointPQPlayer,187,192,379,20,47,JointPQPlayer
4212,JointPQPlayer,173,173,346,5,53,Tie
4213,JointPQPlayer,182,182,364,8,48,Tie
4214,JointPQPlayer,248,243,491,42,17,Player A
4215,JointPQPlayer,263,263,526,53,9,Tie
4216,JointPQPlayer,253,253,506,45,13,Tie
4217,JointPQPlayer,235,235,470,36,22,Tie
4218,JointPQPlayer,272,272,544,53,3,Tie
4219,JointPQPlayer,263,268,531,52,7,JointPQPlayer
4220,JointPQPlayer,271,266,537,52,5,Player A
4221,JointPQPlayer,274,279,553,68,5,JointPQPlayer
4222,JointPQPlayer,224,224,448,38,30,Tie
4223,JointPQPlayer,176,176,352,17,55,Tie
4224,JointPQPlayer,194,189,383,21,46,Player A
4225,JointPQPlayer,244,244,488,36,16,Tie
4226,JointPQPlayer,215,215,430,32,34,Tie
4227,JointPQPlayer,264,264,528,49,7,Tie
4228,JointPQPlayer,179,184,363,13,50,JointPQPlayer
4229,JointPQPlayer,254,249,503,45,14,Player A
4230,JointPQPlayer,234,234,468,37,23,Tie
4231,JointPQPlayer,259,264,523,50,9,JointPQPlayer
4232,JointPQPlayer,270,265,535,59,8,Player A
4233,JointPQPlayer,227,227,454,38,28,Tie
4234,JointPQPlayer,181,186,367,11,48,JointPQPlayer
4235,JointPQPlayer,263,258,521,45,8,Player A
4236,JointPQPlayer,222,227,449,30,27,JointPQPlayer
4237,JointPQPlayer,258,253,511,50,13,Player A
4238,JointPQPlayer,232,232,464,39,25,Tie
4239,JointPQPlayer,239,239,478,41,21,Tie
4240,JointPQPlayer,261,266,527,48,7,JointPQPlayer
4241,JointPQPlayer,264,259,523,47,8,Player A
4242,JointPQPlayer,274,279,553,62,3,JointPQPlayer
4243,JointPQPlayer,273,268,541,56,5,Player A
4244,JointPQPlayer,251,256,507,43,12,JointPQPlayer
4245,JointPQPlayer,273,268,541,56,5,Player A
4246,JointPQPlayer,227,227,454,32,26,Tie
4247,JointPQPlayer,197,197,394,11,39,Tie
4248,JointPQPlayer,243,243,486,40,18,Tie
4249,JointPQPlayer,268,268,536,57,7,Tie
4250,JointPQPlayer,245,250,495,46,17,JointPQPlayer
4251,JointPQPlayer,158,158,316,2,62,Tie
4252,JointPQPlayer,239,239,478,32,18,Tie
4253,JointPQPlayer,218,213,431,27,32,Player A
4254,JointPQPlayer,260,265,525,52,9,JointPQPlayer
4255,JointPQPlayer,218,213,431,30,33,Player A
4256,JointPQPlayer,246,246,492,43,17,Tie
4257,JointPQPlayer,267,267,534,55,7,Tie
4258,JointPQPlayer,257,262,519,49,10,JointPQPlayer
4259,JointPQPlayer,266,261,527,48,7,Player A
4260,JointPQPlayer,273,273,546,58,4,Tie
4261,JointPQPlayer,262,262,524,57,11,Tie
4262,JointPQPlayer,181,181,362,12,50,Tie
4263,JointPQPlayer,237,237,474,37,21,Tie
4264,JointPQPlayer,177,182,359,6,49,JointPQPlayer
4265,JointPQPlayer,202,197,399,16,39,Player A
4266,JointPQPlayer,234,234,468,40,24,Tie
4267,JointPQPlayer,268,273,541,56,5,JointPQPlayer
4268,JointPQPlayer,260,255,515,54,13,Player A
4269,JointPQPlayer,191,191,382,14,44,Tie
4270,JointPQPlayer,261,261,522,49,9,Tie
4271,JointPQPlayer,241,241,482,39,19,Tie
4272,JointPQPlayer,268,268,536,54,6,Tie
4273,JointPQPlayer,224,229,453,37,28,JointPQPlayer
4274,JointPQPlayer,270,265,535,50,5,Player A
4275,JointPQPlayer,237,237,474,37,21,Tie
4276,JointPQPlayer,231,236,467,42,25,JointPQPlayer
4277,JointPQPlayer,238,238,476,36,20,Tie
4278,JointPQPlayer,168,163,331,5,58,Player A
4279,JointPQPlayer,268,268,536,54,6,Tie
4280,JointPQPlayer,172,177,349,5,52,JointPQPlayer
4281,JointPQPlayer,181,176,357,10,51,Player A
4282,JointPQPlayer,261,261,522,58,12,Tie
4283,JointPQPlayer,247,247,494,36,14,Tie
4284,JointPQPlayer,262,267,529,59,10,JointPQPlayer
4285,JointPQPlayer,270,270,540,61,7,Tie
4286,JointPQPlayer,268,268,536,48,4,Tie
4287,JointPQPlayer,251,251,502,47,15,Tie
4288,JointPQPlayer,170,170,340,8,56,Tie
4289,JointPQPlayer,259,259,518,51,11,Tie
4290,JointPQPlayer,248,243,491,42,17,Player A
4291,JointPQPlayer,250,250,500,42,14,Tie
4292,JointPQPlayer,239,239,478,47,23,Tie
4293,JointPQPlayer,246,251,497,42,15,JointPQPlayer
4294,JointPQPlayer,177,177,354,7,51,Tie
4295,JointPQPlayer,181,181,362,9,49,Tie
4296,JointPQPlayer,249,249,498,40,14,Tie
4297,JointPQPlayer,256,251,507,46,13,Player A
4298,JointPQPlayer,248,248,496,41,15,Tie
4299,JointPQPlayer,247,252,499,41,14,JointPQPlayer
4300,JointPQPlayer,267,262,529,47,6,Player A
4301,JointPQPlayer,256,256,512,39,9,Tie
4302,JointPQPlayer,222,222,444,31,29,Tie
4303,JointPQPlayer,267,267,534,52,6,Tie
4304,JointPQPlayer,238,238,476,30,18,Tie
4305,JointPQPlayer,192,192,384,16,44,Tie
4306,JointPQPlayer,230,230,460,35,25,Tie
4307,JointPQPlayer,214,214,428,21,31,Tie
4308,JointPQPlayer,263,268,531,55,8,JointPQPlayer
4309,JointPQPlayer,257,257,514,50,12,Tie
4310,JointPQPlayer,187,187,374,12,46,Tie
4311,JointPQPlayer,240,235,475,44,23,Player A
4312,JointPQPlayer,273,273,546,61,5,Tie
4313,JointPQPlayer,226,226,452,39,29,Tie
4314,JointPQPlayer,254,254,508,44,12,Tie
4315,JointPQPlayer,249,254,503,48,15,JointPQPlayer
4316,JointPQPlayer,213,208,421,32,37,Player A
4317,JointPQPlayer,237,237,474,37,21,Tie
4318,JointPQPlayer,247,247,494,39,15,Tie
4319,JointPQPlayer,219,219,438,31,31,Tie
4320,JointPQPlayer,264,264,528,55,9,Tie
4321,JointPQPlayer,246,246,492,52,20,Tie
4322,JointPQPlayer,265,265,530,54,8,Tie
4323,JointPQPlayer,259,264,523,41,6,JointPQPlayer
4324,JointPQPlayer,183,178,361,14,51,Player A
4325,JointPQPlayer,270,270,540,55,5,Tie
4326,JointPQPlayer,251,251,502,53,17,Tie
4327,JointPQPlayer,207,212,419,27,36,JointPQPlayer
4328,JointPQPlayer,185,185,370,17,49,Tie
4329,JointPQPlayer,262,257,519,43,8,Player A
4330,JointPQPlayer,252,257,509,45,12,JointPQPlayer
4331,JointPQPlayer,238,238,476,39,21,Tie
4332,JointPQPlayer,183,183,366,10,48,Tie
4333,JointPQPlayer,173,173,346,5,53,Tie
4334,JointPQPlayer,258,258,516,43,9,Tie
4335,JointPQPlayer,274,274,548,60,4,Tie
4336,JointPQPlayer,267,267,534,52,6,Tie
4337,JointPQPlayer,178,178,356,6,50,Tie
4338,JointPQPlayer,177,177,354,13,53,Tie
4339,JointPQPlayer,239,234,473,42,23,Player A
4340,JointPQPlayer,249,249,498,43,15,Tie
4341,JointPQPlayer,274,274,548,60,4,Tie
4342,JointPQPlayer,259,259,518,48,10,Tie
4343,JointPQPlayer,218,218,436,32,32,Tie
4344,JointPQPlayer,212,212,424,23,33,Tie
4345,JointPQPlayer,261,261,522,49,9,Tie
4346,JointPQPlayer,242,247,489,40,17,JointPQPlayer
4347,JointPQPlayer,254,249,503,48,15,Player A
4348,JointPQPlayer,257,257,514,44,10,Tie
4349,JointPQPlayer,265,265,530,60,10,Tie
4350,JointPQPlayer,235,240,475,38,21,JointPQPlayer
4351,JointPQPlayer,280,275,555,61,2,Player A
4352,JointPQPlayer,167,167,334,5,57,Tie
4353,JointPQPlayer,250,255,505,47,14,JointPQPlayer
4354,JointPQPlayer,259,254,513,43,10,Player A
4355,JointPQPlayer,262,262,524,57,11,Tie
4356,JointPQPlayer,181,186,367,5,46,JointPQPlayer
4357,JointPQPlayer,187,182,369,13,48,Player A
4358,JointPQPlayer,262,262,524,45,7,Tie
4359,JointPQPlayer,263,263,526,47,7,Tie
4360,JointPQPlayer,232,232,464,33,23,Tie
4361,JointPQPlayer,175,180,355,5,50,JointPQPlayer
4362,JointPQPlayer,269,264,533,54,7,Player A
4363,JointPQPlayer,263,263,526,50,8,Tie
4364,JointPQPlayer,269,274,543,58,5,JointPQPlayer
4365,JointPQPlayer,279,274,553,62,3,Player A
4366,JointPQPlayer,257,262,519,46,9,JointPQPlayer
4367,JointPQPlayer,251,251,502,44,14,Tie
4368,JointPQPlayer,263,258,521,45,8,Player A
4369,JointPQPlayer,269,269,538,59,7,Tie
4370,JointPQPlayer,254,259,513,52,13,JointPQPlayer
4371,JointPQPlayer,258,258,516,52,12,Tie
4372,JointPQPlayer,196,196,392,9,39,Tie
4373,JointPQPlayer,260,260,520,47,9,Tie
4374,JointPQPlayer,172,167,339,4,55,Player A
4375,JointPQPlayer,267,267,534,55,7,Tie
4376,JointPQPlayer,167,167,334,8,58,Tie
4377,JointPQPlayer,285,285,570,70,0,Tie
4378,JointPQPlayer,269,269,538,62,8,Tie
4379,JointPQPlayer,262,262,524,51,9,Tie
4380,JointPQPlayer,268,273,541,68,9,JointPQPlayer
4381,JointPQPlayer,165,160,325,8,61,Player A
4382,JointPQPlayer,174,179,353,6,51,JointPQPlayer
4383,JointPQPlayer,262,257,519,52,11,Player A
4384,JointPQPlayer,201,206,407,24,39,JointPQPlayer
4385,JointPQPlayer,267,267,534,58,8,Tie
4386,JointPQPlayer,263,263,526,53,9,Tie
4387,JointPQPlayer,273,273,546,58,4,Tie
4388,JointPQPlayer,238,233,471,28,19,Player A
4389,JointPQPlayer,259,259,518,51,11,Tie
4390,JointPQPlayer,179,184,363,7,48,JointPQPlayer
4391,JointPQPlayer,262,262,524,48,8,Tie
4392,JointPQPlayer,248,248,496,44,16,Tie
4393,JointPQPlayer,247,242,489,43,18,Player A
4394,JointPQPlayer,238,238,476,39,21,Tie
4395,JointPQPlayer,193,198,391,17,42,JointPQPlayer
4396,JointPQPlayer,253,253,506,45,13,Tie
4397,JointPQPlayer,253,253,506,42,12,Tie
4398,JointPQPlayer,170,170,340,8,56,Tie
4399,JointPQPlayer,236,231,467,30,21,Player A
4400,JointPQPlayer,263,263,526,47,7,Tie
4401,JointPQPlayer,270,270,540,55,5,Tie
4402,JointPQPlayer,246,246,492,49,19,Tie
4403,JointPQPlayer,268,268,536,54,6,Tie
4404,JointPQPlayer,230,235,465,40,25,JointPQPlayer
4405,JointPQPlayer,264,259,523,47,8,Player A
4406,JointPQPlayer,259,259,518,45,9,Tie
4407,JointPQPlayer,271,271,542,54,4,Tie
4408,JointPQPlayer,263,263,526,47,7,Tie
4409,JointPQPlayer,257,257,514,44,10,Tie
4410,JointPQPlayer,175,175,350,6,52,Tie
4411,JointPQPlayer,250,250,500,45,15,Tie
4412,JointPQPlayer,250,255,505,44,13,JointPQPlayer
4413,JointPQPlayer,230,225,455,30,25,Player A
4414,JointPQPlayer,265,265,530,51,7,Tie
4415,JointPQPlayer,260,260,520,44,8,Tie
4416,JointPQPlayer,263,263,526,59,11,Tie
4417,JointPQPlayer,241,246,487,35,16,JointPQPlayer
4418,JointPQPlayer,167,167,334,5,57,Tie
4419,JointPQPlayer,259,254,513,46,11,Player A
4420,JointPQPlayer,255,255,510,46,12,Tie
4421,JointPQPlayer,262,267,529,53,8,JointPQPlayer
4422,JointPQPlayer,253,248,501,46,15,Player A
4423,JointPQPlayer,257,257,514,50,12,Tie
4424,JointPQPlayer,252,252,504,46,14,Tie
4425,JointPQPlayer,247,252,499,35,12,JointPQPlayer
4426,JointPQPlayer,242,237,479,42,21,Player A
4427,JointPQPlayer,221,226,447,28,27,JointPQPlayer
4428,JointPQPlayer,256,251,507,49,14,Player A
4429,JointPQPlayer,192,192,384,16,44,Tie
4430,JointPQPlayer,243,243,486,40,18,Tie
4431,JointPQPlayer,215,215,430,32,34,Tie
4432,JointPQPlayer,237,237,474,43,23,Tie
4433,JointPQPlayer,236,236,472,35,21,Tie
4434,JointPQPlayer,255,255,510,40,10,Tie
4435,JointPQPlayer,230,235,465,34,23,JointPQPlayer
4436,JointPQPlayer,231,226,457,35,26,Player A
4437,JointPQPlayer,219,224,443,24,27,JointPQPlayer
4438,JointPQPlayer,155,150,305,3,66,Player A
4439,JointPQPlayer,245,250,495,49,18,JointPQPlayer
4440,JointPQPlayer,219,214,433,26,31,Player A
4441,JointPQPlayer,234,234,468,34,22,Tie
4442,JointPQPlayer,265,265,530,48,6,Tie
4443,JointPQPlayer,255,255,510,46,12,Tie
4444,JointPQPlayer,260,260,520,50,10,Tie
4445,JointPQPlayer,233,233,466,41,25,Tie
4446,JointPQPlayer,178,183,361,11,50,JointPQPlayer
4447,JointPQPlayer,271,271,542,60,6,Tie
4448,JointPQPlayer,269,264,533,54,7,Player A
4449,JointPQPlayer,263,263,526,50,8,Tie
4450,JointPQPlayer,254,254,508,38,10,Tie
4451,JointPQPlayer,204,209,413,24,37,JointPQPlayer
4452,JointPQPlayer,261,256,517,50,11,Player A
4453,JointPQPlayer,272,272,544,59,5,Tie
4454,JointPQPlayer,182,182,364,8,48,Tie
4455,JointPQPlayer,250,250,500,45,15,Tie
4456,JointPQPlayer,268,273,541,56,5,JointPQPlayer
4457,JointPQPlayer,171,166,337,2,55,Player A
4458,JointPQPlayer,273,273,546,61,5,Tie
4459,JointPQPlayer,181,181,362,12,50,Tie
4460,JointPQPlayer,207,207,414,25,37,Tie
4461,JointPQPlayer,193,198,391,17,42,JointPQPlayer
4462,JointPQPlayer,151,151,302,3,67,Tie
4463,JointPQPlayer,268,263,531,49,6,Player A
4464,JointPQPlayer,245,250,495,49,18,JointPQPlayer
4465,JointPQPlayer,262,257,519,49,10,Player A
4466,JointPQPlayer,207,212,419,30,37,JointPQPlayer
4467,JointPQPlayer,245,240,485,39,18,Player A
4468,JointPQPlayer,168,173,341,6,55,JointPQPlayer
4469,JointPQPlayer,258,253,511,44,11,Player A
4470,JointPQPlayer,270,270,540,58,6,Tie
4471,JointPQPlayer,243,248,491,51,20,JointPQPlayer
4472,JointPQPlayer,263,258,521,51,10,Player A
4473,JointPQPlayer,187,192,379,17,46,JointPQPlayer
4474,JointPQPlayer,216,211,427,26,33,Player A
4475,JointPQPlayer,266,266,532,56,8,Tie
4476,JointPQPlayer,223,223,446,36,30,Tie
4477,JointPQPlayer,245,250,495,46,17,JointPQPlayer
4478,JointPQPlayer,248,248,496,32,12,Tie
4479,JointPQPlayer,257,252,509,51,14,Player A
4480,JointPQPlayer,172,177,349,8,53,JointPQPlayer
4481,JointPQPlayer,243,238,481,38,19,Player A
4482,JointPQPlayer,272,272,544,53,3,Tie
4483,JointPQPlayer,258,258,516,55,13,Tie
4484,JointPQPlayer,256,256,512,51,13,Tie
4485,JointPQPlayer,235,240,475,35,20,JointPQPlayer
4486,JointPQPlayer,260,255,515,54,13,Player A
4487,JointPQPlayer,253,253,506,36,10,Tie
4488,JointPQPlayer,174,179,353,15,54,JointPQPlayer
4489,JointPQPlayer,271,271,542,66,8,Tie
4490,JointPQPlayer,230,230,460,38,26,Tie
4491,JointPQPlayer,254,249,503,42,13,Player A
4492,JointPQPlayer,253,253,506,42,12,Tie
4493,JointPQPlayer,271,271,542,54,4,Tie
4494,JointPQPlayer,223,223,446,33,29,Tie
4495,JointPQPlayer,262,262,524,48,8,Tie
4496,JointPQPlayer,173,178,351,4,51,JointPQPlayer
4497,JointPQPlayer,170,170,340,5,55,Tie
4498,JointPQPlayer,258,258,516,46,10,Tie
4499,JointPQPlayer,245,245,490,44,18,Tie
4500,JointPQPlayer,253,248,501,49,16,Player A
4501,JointPQPlayer,254,254,508,47,13,Tie
4502,JointPQPlayer,254,259,513,40,9,JointPQPlayer
4503,JointPQPlayer,197,197,394,11,39,Tie
4504,JointPQPlayer,248,243,491,48,19,Player A
4505,JointPQPlayer,271,271,542,48,2,Tie
4506,JointPQPlayer,222,227,449,33,28,JointPQPlayer
4507,JointPQPlayer,242,237,479,33,18,Player A
4508,JointPQPlayer,255,255,510,49,13,Tie
4509,JointPQPlayer,236,236,472,44,24,Tie
4510,JointPQPlayer,239,244,483,37,18,JointPQPlayer
4511,JointPQPlayer,215,210,425,27,34,Player A
4512,JointPQPlayer,224,224,448,26,26,Tie
4513,JointPQPlayer,229,229,458,33,25,Tie
4514,JointPQPlayer,186,186,372,7,45,Tie
4515,JointPQPlayer,184,189,373,11,46,JointPQPlayer
4516,JointPQPlayer,254,249,503,48,15,Player A
4517,JointPQPlayer,217,222,439,26,29,JointPQPlayer
4518,JointPQPlayer,219,219,438,34,32,Tie
4519,JointPQPlayer,238,233,471,49,26,Player A
4520,JointPQPlayer,274,274,548,60,4,Tie
4521,JointPQPlayer,262,262,524,57,11,Tie
4522,JointPQPlayer,219,219,438,28,30,Tie
4523,JointPQPlayer,257,257,514,44,10,Tie
4524,JointPQPlayer,208,208,416,27,37,Tie
4525,JointPQPlayer,225,225,450,28,26,Tie
4526,JointPQPlayer,232,237,469,35,22,JointPQPlayer
4527,JointPQPlayer,257,257,514,44,10,Tie
4528,JointPQPlayer,205,205,410,12,34,Tie
4529,JointPQPlayer,232,232,464,33,23,Tie
4530,JointPQPlayer,257,257,514,47,11,Tie
4531,JointPQPlayer,253,248,501,46,15,Player A
4532,JointPQPlayer,273,273,546,55,3,Tie
4533,JointPQPlayer,215,215,430,23,31,Tie
4534,JointPQPlayer,166,171,337,5,56,JointPQPlayer
4535,JointPQPlayer,180,180,360,7,49,Tie
4536,JointPQPlayer,192,187,379,8,43,Player A
4537,JointPQPlayer,212,212,424,29,35,Tie
4538,JointPQPlayer,265,265,530,57,9,Tie
4539,JointPQPlayer,251,251,502,44,14,Tie
4540,JointPQPlayer,251,256,507,46,13,JointPQPlayer
4541,JointPQPlayer,265,260,525,58,11,Player A
4542,JointPQPlayer,251,251,502,41,13,Tie
4543,JointPQPlayer,197,197,394,17,41,Tie
4544,JointPQPlayer,262,262,524,54,10,Tie
4545,JointPQPlayer,259,259,518,45,9,Tie
4546,JointPQPlayer,255,255,510,49,13,Tie
4547,JointPQPlayer,270,275,545,51,2,JointPQPlayer
4548,JointPQPlayer,254,249,503,42,13,Player A
4549,JointPQPlayer,274,279,553,65,4,JointPQPlayer
4550,JointPQPlayer,219,219,438,22,28,Tie
4551,JointPQPlayer,256,251,507,43,12,Player A
4552,JointPQPlayer,158,163,321,4,61,JointPQPlayer
4553,JointPQPlayer,253,248,501,43,14,Player A
4554,JointPQPlayer,235,235,470,36,22,Tie
4555,JointPQPlayer,241,241,482,39,19,Tie
4556,JointPQPlayer,183,188,371,12,47,JointPQPlayer
4557,JointPQPlayer,242,237,479,39,20,Player A
4558,JointPQPlayer,245,245,490,44,18,Tie
4559,JointPQPlayer,269,269,538,59,7,Tie
4560,JointPQPlayer,272,272,544,62,6,Tie
4561,JointPQPlayer,264,264,528,52,8,Tie
4562,JointPQPlayer,221,221,442,32,30,Tie
4563,JointPQPlayer,238,238,476,39,21,Tie
4564,JointPQPlayer,192,197,389,9,40,JointPQPlayer
4565,JointPQPlayer,269,269,538,56,6,Tie
4566,JointPQPlayer,262,257,519,52,11,Player A
4567,JointPQPlayer,265,265,530,54,8,Tie
4568,JointPQPlayer,192,192,384,10,42,Tie
4569,JointPQPlayer,233,238,471,31,20,JointPQPlayer
4570,JointPQPlayer,263,263,526,53,9,Tie
4571,JointPQPlayer,256,251,507,43,12,Player A
4572,JointPQPlayer,259,259,518,48,10,Tie
4573,JointPQPlayer,245,250,495,40,15,JointPQPlayer
4574,JointPQPlayer,274,269,543,64,7,Player A
4575,JointPQPlayer,261,261,522,49,9,Tie
4576,JointPQPlayer,262,267,529,50,7,JointPQPlayer
4577,JointPQPlayer,254,249,503,48,15,Player A
4578,JointPQPlayer,254,259,513,49,12,JointPQPlayer
4579,JointPQPlayer,250,250,500,45,15,Tie
4580,JointPQPlayer,201,196,397,23,42,Player A
4581,JointPQPlayer,270,270,540,58,6,Tie
4582,JointPQPlayer,261,261,522,49,9,Tie
4583,JointPQPlayer,166,171,337,5,56,JointPQPlayer
4584,JointPQPlayer,260,255,515,48,11,Player A
4585,JointPQPlayer,184,189,373,8,45,JointPQPlayer
4586,JointPQPlayer,242,242,484,44,20,Tie
4587,JointPQPlayer,206,201,407,21,38,Player A
4588,JointPQPlayer,252,257,509,39,10,JointPQPlayer
4589,JointPQPlayer,254,254,508,47,13,Tie
4590,JointPQPlayer,242,237,479,36,19,Player A
4591,JointPQPlayer,238,238,476,33,19,Tie
4592,JointPQPlayer,256,261,517,47,10,JointPQPlayer
4593,JointPQPlayer,192,192,384,16,44,Tie
4594,JointPQPlayer,270,265,535,56,7,Player A
4595,JointPQPlayer,240,245,485,42,19,JointPQPlayer
4596,JointPQPlayer,258,258,516,52,12,Tie
4597,JointPQPlayer,170,170,340,5,55,Tie
4598,JointPQPlayer,236,236,472,44,24,Tie
4599,JointPQPlayer,258,253,511,41,10,Player A
4600,JointPQPlayer,264,264,528,49,7,Tie
4601,JointPQPlayer,245,245,490,44,18,Tie
4602,JointPQPlayer,273,273,546,58,4,Tie
4603,JointPQPlayer,280,280,560,66,2,Tie
4604,JointPQPlayer,258,258,516,46,10,Tie
4605,JointPQPlayer,262,267,529,50,7,JointPQPlayer
4606,JointPQPlayer,270,265,535,53,6,Player A
4607,JointPQPlayer,256,256,512,42,10,Tie
4608,JointPQPlayer,238,238,476,42,22,Tie
4609,JointPQPlayer,248,248,496,32,12,Tie
4610,JointPQPlayer,180,185,365,12,49,JointPQPlayer
4611,JointPQPlayer,280,275,555,64,3,Player A
4612,JointPQPlayer,267,267,534,52,6,Tie
4613,JointPQPlayer,259,259,518,51,11,Tie
4614,JointPQPlayer,259,259,518,42,8,Tie
4615,JointPQPlayer,225,230,455,24,23,JointPQPlayer
4616,JointPQPlayer,253,248,501,46,15,Player A
4617,JointPQPlayer,263,263,526,50,8,Tie
4618,JointPQPlayer,271,271,542,60,6,Tie
4619,JointPQPlayer,240,240,480,37,19,Tie
4620,JointPQPlayer,265,265,530,51,7,Tie
4621,JointPQPlayer,226,226,452,27,25,Tie
4622,JointPQPlayer,244,244,488,42,18,Tie
4623,JointPQPlayer,223,228,451,41,30,JointPQPlayer
4624,JointPQPlayer,216,211,427,35,36,Player A
4625,JointPQPlayer,193,198,391,14,41,JointPQPlayer
4626,JointPQPlayer,248,248,496,44,16,Tie
4627,JointPQPlayer,232,227,459,34,25,Player A
4628,JointPQPlayer,183,183,366,7,47,Tie
4629,JointPQPlayer,259,264,523,47,8,JointPQPlayer
4630,JointPQPlayer,262,257,519,46,9,Player A
4631,JointPQPlayer,182,182,364,14,50,Tie
4632,JointPQPlayer,173,178,351,4,51,JointPQPlayer
4633,JointPQPlayer,257,252,509,39,10,Player A
4634,JointPQPlayer,243,248,491,45,18,JointPQPlayer
4635,JointPQPlayer,223,218,441,28,29,Player A
4636,JointPQPlayer,250,255,505,35,10,JointPQPlayer
4637,JointPQPlayer,262,257,519,49,10,Player A
4638,JointPQPlayer,256,256,512,51,13,Tie
4639,JointPQPlayer,270,270,540,52,4,Tie
4640,JointPQPlayer,192,197,389,15,42,JointPQPlayer
4641,JointPQPlayer,248,243,491,39,16,Player A
4642,JointPQPlayer,255,255,510,46,12,Tie
4643,JointPQPlayer,228,228,456,31,25,Tie
4644,JointPQPlayer,263,263,526,47,7,Tie
4645,JointPQPlayer,247,252,499,35,12,JointPQPlayer
4646,JointPQPlayer,168,168,336,10,58,Tie
4647,JointPQPlayer,263,258,521,45,8,Player A
4648,JointPQPlayer,258,258,516,52,12,Tie
4649,JointPQPlayer,166,171,337,5,56,JointPQPlayer
4650,JointPQPlayer,264,259,523,50,9,Player A
4651,JointPQPlayer,254,254,508,47,13,Tie
4652,JointPQPlayer,244,249,493,44,17,JointPQPlayer
4653,JointPQPlayer,249,244,493,44,17,Player A
4654,JointPQPlayer,239,239,478,38,20,Tie
4655,JointPQPlayer,188,188,376,11,45,Tie
4656,JointPQPlayer,204,204,408,19,37,Tie
4657,JointPQPlayer,245,245,490,38,16,Tie
4658,JointPQPlayer,267,272,539,54,5,JointPQPlayer
4659,JointPQPlayer,248,243,491,42,17,Player A
4660,JointPQPlayer,240,240,480,37,19,Tie
4661,JointPQPlayer,165,170,335,6,57,JointPQPlayer
4662,JointPQPlayer,210,205,415,23,36,Player A
4663,JointPQPlayer,219,219,438,28,30,Tie
4664,JointPQPlayer,211,211,422,30,36,Tie
4665,JointPQPlayer,247,247,494,42,16,Tie
4666,JointPQPlayer,191,191,382,11,43,Tie
4667,JointPQPlayer,263,268,531,55,8,JointPQPlayer
4668,JointPQPlayer,256,256,512,48,12,Tie
4669,JointPQPlayer,221,221,442,26,28,Tie
4670,JointPQPlayer,266,261,527,51,8,Player A
4671,JointPQPlayer,258,258,516,55,13,Tie
4672,JointPQPlayer,258,258,516,46,10,Tie
4673,JointPQPlayer,249,249,498,43,15,Tie
4674,JointPQPlayer,243,248,491,33,14,JointPQPlayer
4675,JointPQPlayer,171,166,337,5,56,Player A
4676,JointPQPlayer,247,252,499,41,14,JointPQPlayer
4677,JointPQPlayer,265,260,525,49,8,Player A
4678,JointPQPlayer,260,260,520,47,9,Tie
4679,JointPQPlayer,262,262,524,48,8,Tie
4680,JointPQPlayer,249,254,503,48,15,JointPQPlayer
4681,JointPQPlayer,253,248,501,46,15,Player A
4682,JointPQPlayer,258,263,521,42,7,JointPQPlayer
4683,JointPQPlayer,178,178,356,15,53,Tie
4684,JointPQPlayer,264,259,523,47,8,Player A
4685,JointPQPlayer,259,264,523,50,9,JointPQPlayer
4686,JointPQPlayer,246,241,487,38,17,Player A
4687,JointPQPlayer,254,254,508,50,14,Tie
4688,JointPQPlayer,182,187,369,13,48,JointPQPlayer
4689,JointPQPlayer,261,261,522,52,10,Tie
4690,JointPQPlayer,255,255,510,46,12,Tie
4691,JointPQPlayer,263,258,521,45,8,Player A
4692,JointPQPlayer,216,216,432,28,32,Tie
4693,JointPQPlayer,250,250,500,42,14,Tie
4694,JointPQPlayer,180,180,360,7,49,Tie
4695,JointPQPlayer,257,257,514,41,9,Tie
4696,JointPQPlayer,257,257,514,50,12,Tie
4697,JointPQPlayer,246,246,492,43,17,Tie
4698,JointPQPlayer,245,250,495,40,15,JointPQPlayer
4699,JointPQPlayer,244,239,483,37,18,Player A
4700,JointPQPlayer,173,178,351,10,53,JointPQPlayer
4701,JointPQPlayer,190,190,380,12,44,Tie
4702,JointPQPlayer,254,249,503,42,13,Player A
4703,JointPQPlayer,175,175,350,9,53,Tie
4704,JointPQPlayer,265,265,530,45,5,Tie
4705,JointPQPlayer,184,189,373,14,47,JointPQPlayer
4706,JointPQPlayer,253,248,501,37,12,Player A
4707,JointPQPlayer,220,220,440,33,31,Tie
4708,JointPQPlayer,263,263,526,56,10,Tie
4709,JointPQPlayer,258,258,516,52,12,Tie
4710,JointPQPlayer,185,190,375,7,44,JointPQPlayer
4711,JointPQPlayer,254,249,503,39,12,Player A
4712,JointPQPlayer,244,249,493,47,18,JointPQPlayer
4713,JointPQPlayer,261,261,522,52,10,Tie
4714,JointPQPlayer,270,265,535,59,8,Player A
4715,JointPQPlayer,264,269,533,57,8,JointPQPlayer
4716,JointPQPlayer,245,240,485,36,17,Player A
4717,JointPQPlayer,169,174,343,11,56,JointPQPlayer
4718,JointPQPlayer,264,259,523,47,8,Player A
4719,JointPQPlayer,254,254,508,41,11,Tie
4720,JointPQPlayer,259,264,523,47,8,JointPQPlayer
4721,JointPQPlayer,265,265,530,54,8,Tie
4722,JointPQPlayer,261,261,522,49,9,Tie
4723,JointPQPlayer,258,253,511,50,13,Player A
4724,JointPQPlayer,210,215,425,30,35,JointPQPlayer
4725,JointPQPlayer,210,210,420,28,36,Tie
4726,JointPQPlayer,170,170,340,5,55,Tie
4727,JointPQPlayer,177,177,354,10,52,Tie
4728,JointPQPlayer,262,257,519,46,9,Player A
4729,JointPQPlayer,244,249,493,41,16,JointPQPlayer
4730,JointPQPlayer,270,265,535,50,5,Player A
4731,JointPQPlayer,249,249,498,40,14,Tie
4732,JointPQPlayer,262,267,529,53,8,JointPQPlayer
4733,JointPQPlayer,248,243,491,36,15,Player A
4734,JointPQPlayer,263,263,526,44,6,Tie
4735,JointPQPlayer,184,189,373,8,45,JointPQPlayer
4736,JointPQPlayer,246,246,492,40,16,Tie
4737,JointPQPlayer,224,219,443,33,30,Player A
4738,JointPQPlayer,255,255,510,46,12,Tie
4739,JointPQPlayer,264,264,528,61,11,Tie
4740,JointPQPlayer,262,267,529,53,8,JointPQPlayer
4741,JointPQPlayer,264,264,528,55,9,Tie
4742,JointPQPlayer,273,268,541,59,6,Player A
4743,JointPQPlayer,198,198,396,16,40,Tie
4744,JointPQPlayer,190,195,385,17,44,JointPQPlayer
4745,JointPQPlayer,224,224,448,32,28,Tie
4746,JointPQPlayer,256,251,507,43,12,Player A
4747,JointPQPlayer,251,251,502,41,13,Tie
4748,JointPQPlayer,248,248,496,50,18,Tie
4749,JointPQPlayer,239,239,478,38,20,Tie
4750,JointPQPlayer,187,187,374,9,45,Tie
4751,JointPQPlayer,243,243,486,43,19,Tie
4752,JointPQPlayer,240,240,480,34,18,Tie
4753,JointPQPlayer,259,259,518,45,9,Tie
4754,JointPQPlayer,260,260,520,41,7,Tie
4755,JointPQPlayer,259,259,518,48,10,Tie
4756,JointPQPlayer,214,219,433,26,31,JointPQPlayer
4757,JointPQPlayer,233,228,461,33,24,Player A
4758,JointPQPlayer,263,268,531,52,7,JointPQPlayer
4759,JointPQPlayer,251,246,497,36,13,Player A
4760,JointPQPlayer,238,238,476,33,19,Tie
4761,JointPQPlayer,205,205,410,21,37,Tie
4762,JointPQPlayer,214,219,433,23,30,JointPQPlayer
4763,JointPQPlayer,259,254,513,43,10,Player A
4764,JointPQPlayer,217,217,434,30,32,Tie
4765,JointPQPlayer,255,255,510,49,13,Tie
4766,JointPQPlayer,227,227,454,35,27,Tie
4767,JointPQPlayer,172,177,349,5,52,JointPQPlayer
4768,JointPQPlayer,257,257,514,50,12,Tie
4769,JointPQPlayer,175,170,345,10,55,Player A
4770,JointPQPlayer,183,188,371,9,46,JointPQPlayer
4771,JointPQPlayer,259,254,513,49,12,Player A
4772,JointPQPlayer,272,272,544,56,4,Tie
4773,JointPQPlayer,259,259,518,48,10,Tie
4774,JointPQPlayer,253,253,506,45,13,Tie
4775,JointPQPlayer,259,259,518,48,10,Tie
4776,JointPQPlayer,162,162,324,7,61,Tie
4777,JointPQPlayer,246,246,492,43,17,Tie
4778,JointPQPlayer,209,209,418,26,36,Tie
4779,JointPQPlayer,261,261,522,52,10,Tie
4780,JointPQPlayer,173,178,351,7,52,JointPQPlayer
4781,JointPQPlayer,268,263,531,52,7,Player A
4782,JointPQPlayer,171,176,347,9,54,JointPQPlayer
4783,JointPQPlayer,272,267,539,57,6,Player A
4784,JointPQPlayer,241,246,487,35,16,JointPQPlayer
4785,JointPQPlayer,240,240,480,40,20,Tie
4786,JointPQPlayer,253,248,501,43,14,Player A
4787,JointPQPlayer,266,266,532,56,8,Tie
4788,JointPQPlayer,221,221,442,26,28,Tie
4789,JointPQPlayer,230,230,460,32,24,Tie
4790,JointPQPlayer,207,212,419,24,35,JointPQPlayer
4791,JointPQPlayer,250,250,500,39,13,Tie
4792,JointPQPlayer,261,256,517,50,11,Player A
4793,JointPQPlayer,182,187,369,10,47,JointPQPlayer
4794,JointPQPlayer,262,257,519,52,11,Player A
4795,JointPQPlayer,261,261,522,52,10,Tie
4796,JointPQPlayer,256,256,512,45,11,Tie
4797,JointPQPlayer,262,267,529,50,7,JointPQPlayer
4798,JointPQPlayer,202,197,399,19,40,Player A
4799,JointPQPlayer,251,251,502,41,13,Tie
4800,JointPQPlayer,263,263,526,53,9,Tie
4801,JointPQPlayer,261,261,522,49,9,Tie
4802,JointPQPlayer,246,246,492,46,18,Tie
4803,JointPQPlayer,255,255,510,46,12,Tie
4804,JointPQPlayer,252,252,504,43,13,Tie
4805,JointPQPlayer,213,218,431,33,34,JointPQPlayer
4806,JointPQPlayer,250,245,495,43,16,Player A
4807,JointPQPlayer,228,228,456,37,27,Tie
4808,JointPQPlayer,190,190,380,9,43,Tie
4809,JointPQPlayer,216,216,432,25,31,Tie
4810,JointPQPlayer,267,272,539,54,5,JointPQPlayer
4811,JointPQPlayer,264,259,523,50,9,Player A
4812,JointPQPlayer,256,256,512,48,12,Tie
4813,JointPQPlayer,260,260,520,53,11,Tie
4814,JointPQPlayer,268,268,536,54,6,Tie
4815,JointPQPlayer,277,277,554,60,2,Tie
4816,JointPQPlayer,266,266,532,50,6,Tie
4817,JointPQPlayer,256,261,517,50,11,JointPQPlayer
4818,JointPQPlayer,235,235,470,33,21,Tie
4819,JointPQPlayer,211,206,417,34,39,Player A
4820,JointPQPlayer,267,267,534,52,6,Tie
4821,JointPQPlayer,264,264,528,55,9,Tie
4822,JointPQPlayer,239,239,478,41,21,Tie
4823,JointPQPlayer,244,244,488,42,18,Tie
4824,JointPQPlayer,256,256,512,45,11,Tie
4825,JointPQPlayer,217,217,434,24,30,Tie
4826,JointPQPlayer,234,239,473,36,21,JointPQPlayer
4827,JointPQPlayer,269,264,533,60,9,Player A
4828,JointPQPlayer,251,251,502,50,16,Tie
4829,JointPQPlayer,248,248,496,41,15,Tie
4830,JointPQPlayer,260,265,525,52,9,JointPQPlayer
4831,JointPQPlayer,237,237,474,31,19,Tie
4832,JointPQPlayer,256,251,507,46,13,Player A
4833,JointPQPlayer,253,258,511,53,14,JointPQPlayer
4834,JointPQPlayer,215,210,425,24,33,Player A
4835,JointPQPlayer,240,240,480,43,21,Tie
4836,JointPQPlayer,242,247,489,43,18,JointPQPlayer
4837,JointPQPlayer,236,231,467,39,24,Player A
4838,JointPQPlayer,193,198,391,14,41,JointPQPlayer
4839,JointPQPlayer,269,264,533,48,5,Player A
4840,JointPQPlayer,267,267,534,52,6,Tie
4841,JointPQPlayer,182,187,369,7,46,JointPQPlayer
4842,JointPQPlayer,251,251,502,50,16,Tie
4843,JointPQPlayer,175,175,350,6,52,Tie
4844,JointPQPlayer,269,264,533,57,8,Player A
4845,JointPQPlayer,273,273,546,55,3,Tie
4846,JointPQPlayer,251,256,507,40,11,JointPQPlayer
4847,JointPQPlayer,195,195,390,19,43,Tie
4848,JointPQPlayer,189,189,378,13,45,Tie
4849,JointPQPlayer,256,251,507,52,15,Player A
4850,JointPQPlayer,261,266,527,54,9,JointPQPlayer
4851,JointPQPlayer,254,249,503,45,14,Player A
4852,JointPQPlayer,221,221,442,26,28,Tie
4853,JointPQPlayer,198,198,396,22,42,Tie
4854,JointPQPlayer,173,178,351,10,53,JointPQPlayer
4855,JointPQPlayer,266,266,532,50,6,Tie
4856,JointPQPlayer,219,214,433,29,32,Player A
4857,JointPQPlayer,254,259,513,49,12,JointPQPlayer
4858,JointPQPlayer,263,263,526,50,8,Tie
4859,JointPQPlayer,235,235,470,36,22,Tie
4860,JointPQPlayer,243,243,486,40,18,Tie
4861,JointPQPlayer,261,256,517,47,10,Player A
4862,JointPQPlayer,155,160,315,4,63,JointPQPlayer
4863,JointPQPlayer,238,238,476,42,22,Tie
4864,JointPQPlayer,231,226,457,26,23,Player A
4865,JointPQPlayer,271,276,547,56,3,JointPQPlayer
4866,JointPQPlayer,184,184,368,9,47,Tie
4867,JointPQPlayer,245,240,485,30,15,Player A
4868,JointPQPlayer,166,166,332,6,58,Tie
4869,JointPQPlayer,185,190,375,13,46,JointPQPlayer
4870,JointPQPlayer,191,191,382,8,42,Tie
4871,JointPQPlayer,239,239,478,41,21,Tie
4872,JointPQPlayer,253,248,501,37,12,Player A
4873,JointPQPlayer,257,262,519,52,11,JointPQPlayer
4874,JointPQPlayer,255,250,505,53,16,Player A
4875,JointPQPlayer,265,265,530,51,7,Tie
4876,JointPQPlayer,186,191,377,12,45,JointPQPlayer
4877,JointPQPlayer,240,240,480,37,19,Tie
4878,JointPQPlayer,258,253,511,44,11,Player A
4879,JointPQPlayer,254,254,508,44,12,Tie
4880,JointPQPlayer,235,240,475,38,21,JointPQPlayer
4881,JointPQPlayer,217,217,434,24,30,Tie
4882,JointPQPlayer,230,225,455,36,27,Player A
4883,JointPQPlayer,273,273,546,55,3,Tie
4884,JointPQPlayer,253,253,506,45,13,Tie
4885,JointPQPlayer,238,238,476,42,22,Tie
4886,JointPQPlayer,253,258,511,53,14,JointPQPlayer
4887,JointPQPlayer,237,232,469,32,21,Player A
4888,JointPQPlayer,259,259,518,54,12,Tie
4889,JointPQPlayer,267,267,534,49,5,Tie
4890,JointPQPlayer,204,209,413,18,35,JointPQPlayer
4891,JointPQPlayer,245,245,490,38,16,Tie
4892,JointPQPlayer,256,251,507,43,12,Player A
4893,JointPQPlayer,263,263,526,47,7,Tie
4894,JointPQPlayer,257,262,519,49,10,JointPQPlayer
4895,JointPQPlayer,262,257,519,46,9,Player A
4896,JointPQPlayer,245,245,490,41,17,Tie
4897,JointPQPlayer,252,257,509,42,11,JointPQPlayer
4898,JointPQPlayer,256,251,507,49,14,Player A
4899,JointPQPlayer,244,244,488,39,17,Tie
4900,JointPQPlayer,248,248,496,38,14,Tie
4901,JointPQPlayer,263,268,531,52,7,JointPQPlayer
4902,JointPQPlayer,184,184,368,6,46,Tie
4903,JointPQPlayer,271,266,537,55,6,Player A
4904,JointPQPlayer,267,267,534,52,6,Tie
4905,JointPQPlayer,243,248,491,42,17,JointPQPlayer
4906,JointPQPlayer,256,256,512,45,11,Tie
4907,JointPQPlayer,265,260,525,49,8,Player A
4908,JointPQPlayer,253,253,506,45,13,Tie
4909,JointPQPlayer,208,213,421,35,38,JointPQPlayer
4910,JointPQPlayer,165,165,330,4,58,Tie
4911,JointPQPlayer,247,242,489,49,20,Player A
4912,JointPQPlayer,251,251,502,41,13,Tie
4913,JointPQPlayer,241,241,482,45,21,Tie
4914,JointPQPlayer,181,181,362,9,49,Tie
4915,JointPQPlayer,266,271,537,55,6,JointPQPlayer
4916,JointPQPlayer,262,257,519,55,12,Player A
4917,JointPQPlayer,174,174,348,7,53,Tie
4918,JointPQPlayer,254,254,508,44,12,Tie
4919,JointPQPlayer,240,240,480,34,18,Tie
4920,JointPQPlayer,244,249,493,41,16,JointPQPlayer
4921,JointPQPlayer,213,208,421,23,34,Player A
4922,JointPQPlayer,258,263,521,54,11,JointPQPlayer
4923,JointPQPlayer,168,168,336,7,57,Tie
4924,JointPQPlayer,224,224,448,32,28,Tie
4925,JointPQPlayer,242,242,484,41,19,Tie
4926,JointPQPlayer,243,243,486,46,20,Tie
4927,JointPQPlayer,272,267,539,57,6,Player A
4928,JointPQPlayer,258,263,521,45,8,JointPQPlayer
4929,JointPQPlayer,249,244,493,41,16,Player A
4930,JointPQPlayer,271,271,542,60,6,Tie
4931,JointPQPlayer,251,256,507,52,15,JointPQPlayer
4932,JointPQPlayer,235,230,465,28,21,Player A
4933,JointPQPlayer,242,247,489,40,17,JointPQPlayer
4934,JointPQPlayer,266,261,527,45,6,Player A
4935,JointPQPlayer,255,255,510,46,12,Tie
4936,JointPQPlayer,248,253,501,40,13,JointPQPlayer
4937,JointPQPlayer,257,257,514,44,10,Tie
4938,JointPQPlayer,269,264,533,54,7,Player A
4939,JointPQPlayer,248,248,496,44,16,Tie
4940,JointPQPlayer,259,259,518,45,9,Tie
4941,JointPQPlayer,264,264,528,49,7,Tie
4942,JointPQPlayer,271,271,542,57,5,Tie
4943,JointPQPlayer,246,246,492,40,16,Tie
4944,JointPQPlayer,223,228,451,32,27,JointPQPlayer
4945,JointPQPlayer,209,204,413,21,36,Player A
4946,JointPQPlayer,231,231,462,34,24,Tie
4947,JointPQPlayer,170,170,340,8,56,Tie
4948,JointPQPlayer,231,231,462,31,23,Tie
4949,JointPQPlayer,264,264,528,52,8,Tie
4950,JointPQPlayer,201,206,407,30,41,JointPQPlayer
4951,JointPQPlayer,255,250,505,53,16,Player A
4952,JointPQPlayer,262,267,529,44,5,JointPQPlayer
4953,JointPQPlayer,243,243,486,46,20,Tie
4954,JointPQPlayer,265,260,525,49,8,Player A
4955,JointPQPlayer,185,190,375,7,44,JointPQPlayer
4956,JointPQPlayer,277,272,549,61,4,Player A
4957,JointPQPlayer,255,260,515,51,12,JointPQPlayer
4958,JointPQPlayer,187,182,369,10,47,Player A
4959,JointPQPlayer,257,262,519,49,10,JointPQPlayer
4960,JointPQPlayer,274,269,543,64,7,Player A
4961,JointPQPlayer,264,264,528,52,8,Tie
4962,JointPQPlayer,187,187,374,21,49,Tie
4963,JointPQPlayer,256,261,517,47,10,JointPQPlayer
4964,JointPQPlayer,271,266,537,55,6,Player A
4965,JointPQPlayer,166,171,337,8,57,JointPQPlayer
4966,JointPQPlayer,278,273,551,60,3,Player A
4967,JointPQPlayer,181,186,367,17,50,JointPQPlayer
4968,JointPQPlayer,263,263,526,44,6,Tie
4969,JointPQPlayer,248,248,496,47,17,Tie
4970,JointPQPlayer,264,264,528,55,9,Tie
4971,JointPQPlayer,246,246,492,43,17,Tie
4972,JointPQPlayer,227,227,454,26,24,Tie
4973,JointPQPlayer,266,261,527,54,9,Player A
4974,JointPQPlayer,217,222,439,29,30,JointPQPlayer
4975,JointPQPlayer,246,241,487,38,17,Player A
4976,JointPQPlayer,156,161,317,3,62,JointPQPlayer
4977,JointPQPlayer,257,257,514,47,11,Tie
4978,JointPQPlayer,261,256,517,50,11,Player A
4979,JointPQPlayer,259,264,523,53,10,JointPQPlayer
4980,JointPQPlayer,269,269,538,56,6,Tie
4981,JointPQPlayer,258,253,511,50,13,Player A
4982,JointPQPlayer,233,233,466,38,24,Tie
4983,JointPQPlayer,235,235,470,33,21,Tie
4984,JointPQPlayer,259,264,523,47,8,JointPQPlayer
4985,JointPQPlayer,273,268,541,59,6,Player A
4986,JointPQPlayer,272,272,544,56,4,Tie
4987,JointPQPlayer,253,253,506,39,11,Tie
4988,JointPQPlayer,233,238,471,34,21,JointPQPlayer
4989,JointPQPlayer,255,255,510,40,10,Tie
4990,JointPQPlayer,270,270,540,58,6,Tie
4991,JointPQPlayer,169,164,333,4,57,Player A
4992,JointPQPlayer,175,175,350,9,53,Tie
4993,JointPQPlayer,278,278,556,59,1,Tie
4994,JointPQPlayer,259,259,518,57,13,Tie
4995,JointPQPlayer,206,211,417,22,35,JointPQPlayer
4996,JointPQPlayer,216,211,427,29,34,Player A
4997,JointPQPlayer,233,233,466,44,26,Tie
4998,JointPQPlayer,221,221,442,26,28,Tie
4999,JointPQPlayer,180,185,365,9,48,JointPQPlayer
5000,JointPQPlayer,269,269,538,50,4,Tie
5001,JointPQPlayer,255,255,510,43,11,Tie
5002,JointPQPlayer,173,168,341,6,55,Player A
5003,JointPQPlayer,268,268,536,54,6,Tie
5004,JointPQPlayer,263,268,531,58,9,JointPQPlayer
5005,JointPQPlayer,265,260,525,46,7,Player A
5006,JointPQPlayer,263,268,531,49,6,JointPQPlayer
5007,JointPQPlayer,240,235,475,41,22,Player A
5008,JointPQPlayer,188,193,381,13,44,JointPQPlayer
5009,JointPQPlayer,159,159,318,4,62,Tie
5010,JointPQPlayer,175,170,345,10,55,Player A
5011,JointPQPlayer,265,270,535,59,8,JointPQPlayer
5012,JointPQPlayer,252,252,504,46,14,Tie
5013,JointPQPlayer,227,222,449,36,29,Player A
5014,JointPQPlayer,247,252,499,44,15,JointPQPlayer
5015,JointPQPlayer,221,221,442,26,28,Tie
5016,JointPQPlayer,273,268,541,59,6,Player A
5017,JointPQPlayer,260,260,520,50,10,Tie
5018,JointPQPlayer,278,278,556,65,3,Tie
5019,JointPQPlayer,245,245,490,38,16,Tie
5020,JointPQPlayer,264,264,528,55,9,Tie
5021,JointPQPlayer,253,258,511,50,13,JointPQPlayer
5022,JointPQPlayer,197,197,394,20,42,Tie
5023,JointPQPlayer,237,232,469,38,23,Player A
5024,JointPQPlayer,233,233,466,38,24,Tie
5025,JointPQPlayer,253,253,506,36,10,Tie
5026,JointPQPlayer,247,247,494,45,17,Tie
5027,JointPQPlayer,241,246,487,44,19,JointPQPlayer
5028,JointPQPlayer,255,250,505,44,13,Player A
5029,JointPQPlayer,264,264,528,46,6,Tie
5030,JointPQPlayer,158,163,321,4,61,JointPQPlayer
5031,JointPQPlayer,234,229,463,35,24,Player A
5032,JointPQPlayer,262,262,524,51,9,Tie
5033,JointPQPlayer,232,232,464,36,24,Tie
5034,JointPQPlayer,276,276,552,61,3,Tie
5035,JointPQPlayer,229,229,458,30,24,Tie
5036,JointPQPlayer,241,246,487,38,17,JointPQPlayer
5037,JointPQPlayer,248,243,491,39,16,Player A
5038,JointPQPlayer,263,263,526,47,7,Tie
5039,JointPQPlayer,252,257,509,51,14,JointPQPlayer
5040,JointPQPlayer,264,264,528,55,9,Tie
5041,JointPQPlayer,269,264,533,57,8,Player A
5042,JointPQPlayer,251,251,502,44,14,Tie
5043,JointPQPlayer,199,199,398,18,40,Tie
5044,JointPQPlayer,232,232,464,36,24,Tie
5045,JointPQPlayer,256,261,517,53,12,JointPQPlayer
5046,JointPQPlayer,227,222,449,30,27,Player A
5047,JointPQPlayer,267,267,534,55,7,Tie
5048,JointPQPlayer,202,202,404,24,40,Tie
5049,JointPQPlayer,272,272,544,59,5,Tie
5050,JointPQPlayer,261,261,522,52,10,Tie
5051,JointPQPlayer,249,254,503,45,14,JointPQPlayer
5052,JointPQPlayer,160,155,315,10,65,Player A
5053,JointPQPlayer,173,178,351,10,53,JointPQPlayer
5054,JointPQPlayer,259,254,513,40,9,Player A
5055,JointPQPlayer,175,175,350,9,53,Tie
5056,JointPQPlayer,245,245,490,41,17,Tie
5057,JointPQPlayer,265,265,530,63,11,Tie
5058,JointPQPlayer,206,211,417,25,36,JointPQPlayer
5059,JointPQPlayer,228,228,456,31,25,Tie
5060,JointPQPlayer,273,268,541,62,7,Player A
5061,JointPQPlayer,267,267,534,49,5,Tie
5062,JointPQPlayer,254,259,513,49,12,JointPQPlayer
5063,JointPQPlayer,261,256,517,41,8,Player A
5064,JointPQPlayer,270,270,540,61,7,Tie
5065,JointPQPlayer,226,231,457,38,27,JointPQPlayer
5066,JointPQPlayer,269,269,538,50,4,Tie
5067,JointPQPlayer,242,237,479,36,19,Player A
5068,JointPQPlayer,185,185,370,17,49,Tie
5069,JointPQPlayer,176,176,352,8,52,Tie
5070,JointPQPlayer,233,233,466,41,25,Tie
5071,JointPQPlayer,272,277,549,55,2,JointPQPlayer
5072,JointPQPlayer,191,186,377,9,44,Player A
5073,JointPQPlayer,187,187,374,6,44,Tie
5074,JointPQPlayer,260,260,520,44,8,Tie
5075,JointPQPlayer,265,265,530,51,7,Tie
5076,JointPQPlayer,250,255,505,47,14,JointPQPlayer
5077,JointPQPlayer,260,260,520,50,10,Tie
5078,JointPQPlayer,283,278,561,67,2,Player A
5079,JointPQPlayer,183,183,366,13,49,Tie
5080,JointPQPlayer,254,254,508,41,11,Tie
5081,JointPQPlayer,252,252,504,46,14,Tie
5082,JointPQPlayer,263,263,526,44,6,Tie
5083,JointPQPlayer,172,177,349,8,53,JointPQPlayer
5084,JointPQPlayer,227,227,454,32,26,Tie
5085,JointPQPlayer,172,167,339,7,56,Player A
5086,JointPQPlayer,194,199,393,19,42,JointPQPlayer
5087,JointPQPlayer,263,258,521,48,9,Player A
5088,JointPQPlayer,250,250,500,48,16,Tie
5089,JointPQPlayer,263,263,526,50,8,Tie
5090,JointPQPlayer,239,239,478,41,21,Tie
5091,JointPQPlayer,263,263,526,53,9,Tie
5092,JointPQPlayer,252,257,509,57,16,JointPQPlayer
5093,JointPQPlayer,172,167,339,10,57,Player A
5094,JointPQPlayer,257,262,519,52,11,JointPQPlayer
5095,JointPQPlayer,245,245,490,41,17,Tie
5096,JointPQPlayer,232,227,459,37,26,Player A
5097,JointPQPlayer,249,254,503,45,14,JointPQPlayer
5098,JointPQPlayer,179,174,353,9,52,Player A
5099,JointPQPlayer,235,240,475,41,22,JointPQPlayer
5100,JointPQPlayer,169,164,333,7,58,Player A
5101,JointPQPlayer,157,162,319,5,62,JointPQPlayer
5102,JointPQPlayer,235,235,470,36,22,Tie
5103,JointPQPlayer,261,256,517,47,10,Player A
5104,JointPQPlayer,247,247,494,45,17,Tie
5105,JointPQPlayer,256,256,512,45,11,Tie
5106,JointPQPlayer,267,267,534,61,9,Tie
5107,JointPQPlayer,163,168,331,5,58,JointPQPlayer
5108,JointPQPlayer,263,258,521,48,9,Player A
5109,JointPQPlayer,248,248,496,44,16,Tie
5110,JointPQPlayer,275,275,550,62,4,Tie
5111,JointPQPlayer,245,245,490,47,19,Tie
5112,JointPQPlayer,234,234,468,28,20,Tie
5113,JointPQPlayer,179,184,363,13,50,JointPQPlayer
5114,JointPQPlayer,259,254,513,43,10,Player A
5115,JointPQPlayer,242,242,484,41,19,Tie
5116,JointPQPlayer,269,269,538,62,8,Tie
5117,JointPQPlayer,238,243,481,35,18,JointPQPlayer
5118,JointPQPlayer,232,227,459,40,27,Player A
5119,JointPQPlayer,268,273,541,56,5,JointPQPlayer
5120,JointPQPlayer,205,205,410,27,39,Tie
5121,JointPQPlayer,238,233,471,37,22,Player A
5122,JointPQPlayer,251,251,502,47,15,Tie
5123,JointPQPlayer,173,178,351,7,52,JointPQPlayer
5124,JointPQPlayer,203,198,401,27,42,Player A
5125,JointPQPlayer,258,258,516,43,9,Tie
5126,JointPQPlayer,225,230,455,30,25,JointPQPlayer
5127,JointPQPlayer,238,233,471,40,23,Player A
5128,JointPQPlayer,238,243,481,35,18,JointPQPlayer
5129,JointPQPlayer,267,262,529,53,8,Player A
5130,JointPQPlayer,279,279,558,61,1,Tie
5131,JointPQPlayer,163,168,331,8,59,JointPQPlayer
5132,JointPQPlayer,213,208,421,32,37,Player A
5133,JointPQPlayer,247,247,494,45,17,Tie
5134,JointPQPlayer,209,209,418,38,40,Tie
5135,JointPQPlayer,231,231,462,40,26,Tie
5136,JointPQPlayer,251,251,502,44,14,Tie
5137,JointPQPlayer,270,270,540,58,6,Tie
5138,JointPQPlayer,252,257,509,42,11,JointPQPlayer
5139,JointPQPlayer,274,269,543,58,5,Player A
5140,JointPQPlayer,243,243,486,40,18,Tie
5141,JointPQPlayer,176,181,357,7,50,JointPQPlayer
5142,JointPQPlayer,262,257,519,46,9,Player A
5143,JointPQPlayer,264,264,528,52,8,Tie
5144,JointPQPlayer,268,268,536,54,6,Tie
5145,JointPQPlayer,248,248,496,44,16,Tie
5146,JointPQPlayer,260,265,525,46,7,JointPQPlayer
5147,JointPQPlayer,171,171,342,13,57,Tie
5148,JointPQPlayer,243,243,486,43,19,Tie
5149,JointPQPlayer,265,265,530,54,8,Tie
5150,JointPQPlayer,253,248,501,46,15,Player A
5151,JointPQPlayer,257,257,514,47,11,Tie
5152,JointPQPlayer,255,255,510,49,13,Tie
5153,JointPQPlayer,258,258,516,46,10,Tie
5154,JointPQPlayer,238,243,481,38,19,JointPQPlayer
5155,JointPQPlayer,258,253,511,47,12,Player A
5156,JointPQPlayer,275,275,550,59,3,Tie
5157,JointPQPlayer,248,248,496,41,15,Tie
5158,JointPQPlayer,247,252,499,38,13,JointPQPlayer
5159,JointPQPlayer,246,241,487,41,18,Player A
5160,JointPQPlayer,260,260,520,50,10,Tie
5161,JointPQPlayer,250,255,505,47,14,JointPQPlayer
5162,JointPQPlayer,185,185,370,11,47,Tie
5163,JointPQPlayer,190,190,380,21,47,Tie
5164,JointPQPlayer,261,256,517,47,10,Player A
5165,JointPQPlayer,179,184,363,13,50,JointPQPlayer
5166,JointPQPlayer,270,265,535,56,7,Player A
5167,JointPQPlayer,220,225,445,35,30,JointPQPlayer
5168,JointPQPlayer,263,263,526,44,6,Tie
5169,JointPQPlayer,249,244,493,47,18,Player A
5170,JointPQPlayer,229,229,458,30,24,Tie
5171,JointPQPlayer,251,251,502,53,17,Tie
5172,JointPQPlayer,243,248,491,39,16,JointPQPlayer
5173,JointPQPlayer,216,216,432,31,33,Tie
5174,JointPQPlayer,254,254,508,50,14,Tie
5175,JointPQPlayer,269,264,533,54,7,Player A
5176,JointPQPlayer,260,265,525,52,9,JointPQPlayer
5177,JointPQPlayer,257,252,509,42,11,Player A
5178,JointPQPlayer,155,160,315,4,63,JointPQPlayer
5179,JointPQPlayer,270,265,535,56,7,Player A
5180,JointPQPlayer,239,244,483,37,18,JointPQPlayer
5181,JointPQPlayer,277,272,549,61,4,Player A
5182,JointPQPlayer,197,202,399,19,40,JointPQPlayer
5183,JointPQPlayer,265,260,525,58,11,Player A
5184,JointPQPlayer,254,259,513,46,11,JointPQPlayer
5185,JointPQPlayer,254,254,508,44,12,Tie
5186,JointPQPlayer,248,243,491,42,17,Player A
5187,JointPQPlayer,260,260,520,44,8,Tie
5188,JointPQPlayer,163,163,326,6,60,Tie
5189,JointPQPlayer,236,236,472,41,23,Tie
5190,JointPQPlayer,258,258,516,49,11,Tie
5191,JointPQPlayer,189,189,378,10,44,Tie
5192,JointPQPlayer,186,191,377,6,43,JointPQPlayer
5193,JointPQPlayer,176,171,347,18,57,Player A
5194,JointPQPlayer,219,219,438,34,32,Tie
5195,JointPQPlayer,273,273,546,55,3,Tie
5196,JointPQPlayer,248,253,501,34,11,JointPQPlayer
5197,JointPQPlayer,264,259,523,50,9,Player A
5198,JointPQPlayer,271,271,542,57,5,Tie
5199,JointPQPlayer,243,248,491,42,17,JointPQPlayer
5200,JointPQPlayer,247,247,494,36,14,Tie
5201,JointPQPlayer,266,266,532,53,7,Tie
5202,JointPQPlayer,249,244,493,53,20,Player A
5203,JointPQPlayer,263,263,526,50,8,Tie
5204,JointPQPlayer,192,192,384,19,45,Tie
5205,JointPQPlayer,242,247,489,43,18,JointPQPlayer
5206,JointPQPlayer,261,256,517,50,11,Player A
5207,JointPQPlayer,261,266,527,51,8,JointPQPlayer
5208,JointPQPlayer,248,243,491,39,16,Player A
5209,JointPQPlayer,243,243,486,37,17,Tie
5210,JointPQPlayer,242,247,489,43,18,JointPQPlayer
5211,JointPQPlayer,236,236,472,29,19,Tie
5212,JointPQPlayer,256,251,507,43,12,Player A
5213,JointPQPlayer,258,263,521,45,8,JointPQPlayer
5214,JointPQPlayer,260,255,515,39,8,Player A
5215,JointPQPlayer,236,241,477,34,19,JointPQPlayer
5216,JointPQPlayer,248,248,496,44,16,Tie
5217,JointPQPlayer,272,267,539,51,4,Player A
5218,JointPQPlayer,193,198,391,11,40,JointPQPlayer
5219,JointPQPlayer,178,178,356,6,50,Tie
5220,JointPQPlayer,259,254,513,46,11,Player A
5221,JointPQPlayer,257,257,514,44,10,Tie
5222,JointPQPlayer,261,266,527,54,9,JointPQPlayer
5223,JointPQPlayer,272,267,539,51,4,Player A
5224,JointPQPlayer,258,263,521,45,8,JointPQPlayer
5225,JointPQPlayer,267,267,534,46,4,Tie
5226,JointPQPlayer,266,261,527,51,8,Player A
5227,JointPQPlayer,264,264,528,49,7,Tie
5228,JointPQPlayer,179,179,358,5,49,Tie
5229,JointPQPlayer,251,256,507,43,12,JointPQPlayer
5230,JointPQPlayer,254,254,508,53,15,Tie
5231,JointPQPlayer,245,240,485,36,17,Player A
5232,JointPQPlayer,257,262,519,55,12,JointPQPlayer
5233,JointPQPlayer,174,174,348,10,54,Tie
5234,JointPQPlayer,275,270,545,60,5,Player A
5235,JointPQPlayer,264,264,528,52,8,Tie
5236,JointPQPlayer,277,277,554,60,2,Tie
5237,JointPQPlayer,261,261,522,46,8,Tie
5238,JointPQPlayer,266,271,537,49,4,JointPQPlayer
5239,JointPQPlayer,251,251,502,44,14,Tie
5240,JointPQPlayer,271,266,537,52,5,Player A
5241,JointPQPlayer,255,255,510,49,13,Tie
5242,JointPQPlayer,251,256,507,49,14,JointPQPlayer
5243,JointPQPlayer,254,249,503,39,12,Player A
5244,JointPQPlayer,260,260,520,50,10,Tie
5245,JointPQPlayer,254,259,513,46,11,JointPQPlayer
5246,JointPQPlayer,237,232,469,41,24,Player A
5247,JointPQPlayer,260,260,520,50,10,Tie
5248,JointPQPlayer,246,251,497,42,15,JointPQPlayer
5249,JointPQPlayer,179,179,358,8,50,Tie
5250,JointPQPlayer,280,275,555,61,2,Player A
5251,JointPQPlayer,237,237,474,37,21,Tie
5252,JointPQPlayer,177,182,359,6,49,JointPQPlayer
5253,JointPQPlayer,265,260,525,43,6,Player A
5254,JointPQPlayer,241,241,482,42,20,Tie
5255,JointPQPlayer,263,263,526,53,9,Tie
5256,JointPQPlayer,255,255,510,46,12,Tie
5257,JointPQPlayer,248,248,496,35,13,Tie
5258,JointPQPlayer,261,261,522,46,8,Tie
5259,JointPQPlayer,184,189,373,14,47,JointPQPlayer
5260,JointPQPlayer,249,244,493,44,17,Player A
5261,JointPQPlayer,243,248,491,48,19,JointPQPlayer
5262,JointPQPlayer,261,256,517,50,11,Player A
5263,JointPQPlayer,266,266,532,53,7,Tie
5264,JointPQPlayer,222,222,444,37,31,Tie
5265,JointPQPlayer,270,270,540,49,3,Tie
5266,JointPQPlayer,201,201,402,16,38,Tie
5267,JointPQPlayer,264,264,528,52,8,Tie
5268,JointPQPlayer,234,239,473,39,22,JointPQPlayer
5269,JointPQPlayer,255,250,505,41,12,Player A
5270,JointPQPlayer,254,254,508,44,12,Tie
5271,JointPQPlayer,235,235,470,33,21,Tie
5272,JointPQPlayer,261,261,522,55,11,Tie
5273,JointPQPlayer,180,185,365,9,48,JointPQPlayer
5274,JointPQPlayer,199,199,398,21,41,Tie
5275,JointPQPlayer,261,256,517,44,9,Player A
5276,JointPQPlayer,193,193,386,12,42,Tie
5277,JointPQPlayer,264,269,533,60,9,JointPQPlayer
5278,JointPQPlayer,261,256,517,56,13,Player A
5279,JointPQPlayer,261,266,527,48,7,JointPQPlayer
5280,JointPQPlayer,256,256,512,45,11,Tie
5281,JointPQPlayer,243,238,481,44,21,Player A
5282,JointPQPlayer,258,258,516,49,11,Tie
5283,JointPQPlayer,231,231,462,40,26,Tie
5284,JointPQPlayer,252,252,504,43,13,Tie
5285,JointPQPlayer,264,264,528,46,6,Tie
5286,JointPQPlayer,226,226,452,27,25,Tie
5287,JointPQPlayer,253,253,506,42,12,Tie
5288,JointPQPlayer,247,247,494,45,17,Tie
5289,JointPQPlayer,261,261,522,43,7,Tie
5290,JointPQPlayer,270,270,540,61,7,Tie
5291,JointPQPlayer,204,204,408,19,37,Tie
5292,JointPQPlayer,268,268,536,66,10,Tie
5293,JointPQPlayer,226,231,457,35,26,JointPQPlayer
5294,JointPQPlayer,277,272,549,58,3,Player A
5295,JointPQPlayer,258,258,516,46,10,Tie
5296,JointPQPlayer,178,183,361,8,49,JointPQPlayer
5297,JointPQPlayer,268,263,531,52,7,Player A
5298,JointPQPlayer,255,255,510,52,14,Tie
5299,JointPQPlayer,260,260,520,47,9,Tie
5300,JointPQPlayer,244,249,493,44,17,JointPQPlayer
5301,JointPQPlayer,186,186,372,7,45,Tie
5302,JointPQPlayer,263,258,521,54,11,Player A
5303,JointPQPlayer,268,268,536,57,7,Tie
5304,JointPQPlayer,261,266,527,48,7,JointPQPlayer
5305,JointPQPlayer,209,204,413,24,37,Player A
5306,JointPQPlayer,252,252,504,43,13,Tie
5307,JointPQPlayer,238,238,476,30,18,Tie
5308,JointPQPlayer,264,264,528,49,7,Tie
5309,JointPQPlayer,255,255,510,52,14,Tie
5310,JointPQPlayer,266,266,532,56,8,Tie
5311,JointPQPlayer,265,265,530,54,8,Tie
5312,JointPQPlayer,253,258,511,47,12,JointPQPlayer
5313,JointPQPlayer,269,264,533,57,8,Player A
5314,JointPQPlayer,195,195,390,13,41,Tie
5315,JointPQPlayer,252,252,504,46,14,Tie
5316,JointPQPlayer,263,263,526,47,7,Tie
5317,JointPQPlayer,253,253,506,42,12,Tie
5318,JointPQPlayer,268,268,536,51,5,Tie
5319,JointPQPlayer,251,251,502,44,14,Tie
5320,JointPQPlayer,264,264,528,49,7,Tie
5321,JointPQPlayer,261,261,522,52,10,Tie
5322,JointPQPlayer,234,234,468,43,25,Tie
5323,JointPQPlayer,270,275,545,54,3,JointPQPlayer
5324,JointPQPlayer,278,273,551,60,3,Player A
5325,JointPQPlayer,168,173,341,6,55,JointPQPlayer
5326,JointPQPlayer,238,233,471,43,24,Player A
5327,JointPQPlayer,263,268,531,43,4,JointPQPlayer
5328,JointPQPlayer,266,261,527,51,8,Player A
5329,JointPQPlayer,264,264,528,49,7,Tie
5330,JointPQPlayer,245,250,495,37,14,JointPQPlayer
5331,JointPQPlayer,234,229,463,32,23,Player A
5332,JointPQPlayer,262,267,529,50,7,JointPQPlayer
5333,JointPQPlayer,180,180,360,10,50,Tie
5334,JointPQPlayer,254,254,508,50,14,Tie
5335,JointPQPlayer,258,253,511,50,13,Player A
5336,JointPQPlayer,263,263,526,47,7,Tie
5337,JointPQPlayer,244,249,493,41,16,JointPQPlayer
5338,JointPQPlayer,165,160,325,2,59,Player A
5339,JointPQPlayer,237,242,479,45,22,JointPQPlayer
5340,JointPQPlayer,247,247,494,45,17,Tie
5341,JointPQPlayer,171,166,337,5,56,Player A
5342,JointPQPlayer,197,197,394,17,41,Tie
5343,JointPQPlayer,228,228,456,40,28,Tie
5344,JointPQPlayer,258,258,516,40,8,Tie
5345,JointPQPlayer,242,242,484,29,15,Tie
5346,JointPQPlayer,267,267,534,52,6,Tie
5347,JointPQPlayer,262,262,524,51,9,Tie
5348,JointPQPlayer,254,259,513,52,13,JointPQPlayer
5349,JointPQPlayer,231,231,462,37,25,Tie
5350,JointPQPlayer,239,239,478,41,21,Tie
5351,JointPQPlayer,258,253,511,47,12,Player A
5352,JointPQPlayer,245,245,490,41,17,Tie
5353,JointPQPlayer,181,186,367,8,47,JointPQPlayer
5354,JointPQPlayer,262,262,524,57,11,Tie
5355,JointPQPlayer,237,237,474,40,22,Tie
5356,JointPQPlayer,173,173,346,8,54,Tie
5357,JointPQPlayer,261,256,517,50,11,Player A
5358,JointPQPlayer,262,262,524,45,7,Tie
5359,JointPQPlayer,179,179,358,5,49,Tie
5360,JointPQPlayer,276,276,552,67,5,Tie
5361,JointPQPlayer,261,261,522,49,9,Tie
5362,JointPQPlayer,263,263,526,59,11,Tie
5363,JointPQPlayer,242,242,484,38,18,Tie
5364,JointPQPlayer,266,266,532,53,7,Tie
5365,JointPQPlayer,238,243,481,41,20,JointPQPlayer
5366,JointPQPlayer,258,258,516,43,9,Tie
5367,JointPQPlayer,247,242,489,43,18,Player A
5368,JointPQPlayer,262,262,524,51,9,Tie
5369,JointPQPlayer,260,260,520,53,11,Tie
5370,JointPQPlayer,213,213,426,28,34,Tie
5371,JointPQPlayer,259,259,518,48,10,Tie
5372,JointPQPlayer,243,248,491,36,15,JointPQPlayer
5373,JointPQPlayer,265,260,525,52,9,Player A
5374,JointPQPlayer,232,232,464,33,23,Tie
5375,JointPQPlayer,261,266,527,48,7,JointPQPlayer
5376,JointPQPlayer,176,176,352,17,55,Tie
5377,JointPQPlayer,259,254,513,46,11,Player A
5378,JointPQPlayer,183,183,366,13,49,Tie
5379,JointPQPlayer,253,258,511,47,12,JointPQPlayer
5380,JointPQPlayer,258,258,516,46,10,Tie
5381,JointPQPlayer,175,175,350,9,53,Tie
5382,JointPQPlayer,242,237,479,30,17,Player A
5383,JointPQPlayer,244,244,488,30,14,Tie
5384,JointPQPlayer,215,215,430,35,35,Tie
5385,JointPQPlayer,266,266,532,47,5,Tie
5386,JointPQPlayer,240,240,480,40,20,Tie
5387,JointPQPlayer,266,266,532,53,7,Tie
5388,JointPQPlayer,265,265,530,48,6,Tie
5389,JointPQPlayer,188,188,376,17,47,Tie
5390,JointPQPlayer,255,255,510,46,12,Tie
5391,JointPQPlayer,272,272,544,56,4,Tie
5392,JointPQPlayer,235,235,470,42,24,Tie
5393,JointPQPlayer,211,216,427,29,34,JointPQPlayer
5394,JointPQPlayer,253,248,501,37,12,Player A
5395,JointPQPlayer,221,226,447,28,27,JointPQPlayer
5396,JointPQPlayer,182,182,364,8,48,Tie
5397,JointPQPlayer,257,257,514,50,12,Tie
5398,JointPQPlayer,274,269,543,49,2,Player A
5399,JointPQPlayer,269,269,538,53,5,Tie
5400,JointPQPlayer,255,260,515,45,10,JointPQPlayer
5401,JointPQPlayer,240,240,480,37,19,Tie
5402,JointPQPlayer,259,259,518,48,10,Tie
5403,JointPQPlayer,252,252,504,34,10,Tie
5404,JointPQPlayer,218,218,436,20,28,Tie
5405,JointPQPlayer,272,267,539,60,7,Player A
5406,JointPQPlayer,192,192,384,13,43,Tie
5407,JointPQPlayer,255,260,515,45,10,JointPQPlayer
5408,JointPQPlayer,268,263,531,52,7,Player A
5409,JointPQPlayer,177,182,359,12,51,JointPQPlayer
5410,JointPQPlayer,231,226,457,32,25,Player A
5411,JointPQPlayer,240,240,480,37,19,Tie
5412,JointPQPlayer,266,266,532,53,7,Tie
5413,JointPQPlayer,163,163,326,6,60,Tie
5414,JointPQPlayer,245,245,490,38,16,Tie
5415,JointPQPlayer,270,275,545,57,4,JointPQPlayer
5416,JointPQPlayer,240,235,475,35,20,Player A
5417,JointPQPlayer,231,231,462,34,24,Tie
5418,JointPQPlayer,253,258,511,44,11,JointPQPlayer
5419,JointPQPlayer,276,276,552,61,3,Tie
5420,JointPQPlayer,255,250,505,44,13,Player A
5421,JointPQPlayer,253,258,511,56,15,JointPQPlayer
5422,JointPQPlayer,255,255,510,43,11,Tie
5423,JointPQPlayer,185,180,365,9,48,Player A
5424,JointPQPlayer,232,232,464,42,26,Tie
5425,JointPQPlayer,257,257,514,44,10,Tie
5426,JointPQPlayer,266,271,537,55,6,JointPQPlayer
5427,JointPQPlayer,217,212,429,28,33,Player A
5428,JointPQPlayer,244,244,488,39,17,Tie
5429,JointPQPlayer,257,257,514,47,11,Tie
5430,JointPQPlayer,221,221,442,29,29,Tie
5431,JointPQPlayer,264,264,528,49,7,Tie
5432,JointPQPlayer,263,268,531,49,6,JointPQPlayer
5433,JointPQPlayer,239,234,473,42,23,Player A
5434,JointPQPlayer,242,247,489,37,16,JointPQPlayer
5435,JointPQPlayer,245,240,485,42,19,Player A
5436,JointPQPlayer,165,170,335,0,55,JointPQPlayer
5437,JointPQPlayer,258,253,511,47,12,Player A
5438,JointPQPlayer,265,270,535,53,6,JointPQPlayer
5439,JointPQPlayer,243,243,486,37,17,Tie
5440,JointPQPlayer,185,185,370,5,45,Tie
5441,JointPQPlayer,246,246,492,37,15,Tie
5442,JointPQPlayer,172,172,344,6,54,Tie
5443,JointPQPlayer,258,253,511,44,11,Player A
5444,JointPQPlayer,207,207,414,19,35,Tie
5445,JointPQPlayer,190,190,380,9,43,Tie
5446,JointPQPlayer,266,266,532,56,8,Tie
5447,JointPQPlayer,249,249,498,43,15,Tie
5448,JointPQPlayer,262,262,524,48,8,Tie
5449,JointPQPlayer,256,256,512,45,11,Tie
5450,JointPQPlayer,218,218,436,26,30,Tie
5451,JointPQPlayer,244,244,488,39,17,Tie
5452,JointPQPlayer,243,243,486,43,19,Tie
5453,JointPQPlayer,255,255,510,49,13,Tie
5454,JointPQPlayer,267,272,539,54,5,JointPQPlayer
5455,JointPQPlayer,242,242,484,44,20,Tie
5456,JointPQPlayer,245,245,490,35,15,Tie
5457,JointPQPlayer,265,260,525,46,7,Player A
5458,JointPQPlayer,269,269,538,56,6,Tie
5459,JointPQPlayer,245,250,495,43,16,JointPQPlayer
5460,JointPQPlayer,271,271,542,60,6,Tie
5461,JointPQPlayer,265,265,530,45,5,Tie
5462,JointPQPlayer,182,177,359,6,49,Player A
5463,JointPQPlayer,237,237,474,40,22,Tie
5464,JointPQPlayer,248,248,496,35,13,Tie
5465,JointPQPlayer,258,258,516,43,9,Tie
5466,JointPQPlayer,264,264,528,52,8,Tie
5467,JointPQPlayer,268,268,536,57,7,Tie
5468,JointPQPlayer,164,169,333,4,57,JointPQPlayer
5469,JointPQPlayer,256,256,512,48,12,Tie
5470,JointPQPlayer,206,206,412,23,37,Tie
5471,JointPQPlayer,273,268,541,56,5,Player A
5472,JointPQPlayer,251,251,502,47,15,Tie
5473,JointPQPlayer,273,278,551,66,5,JointPQPlayer
5474,JointPQPlayer,222,217,439,26,29,Player A
5475,JointPQPlayer,237,242,479,36,19,JointPQPlayer
5476,JointPQPlayer,245,240,485,39,18,Player A
5477,JointPQPlayer,262,262,524,48,8,Tie
5478,JointPQPlayer,236,241,477,34,19,JointPQPlayer
5479,JointPQPlayer,235,230,465,37,24,Player A
5480,JointPQPlayer,233,233,466,38,24,Tie
5481,JointPQPlayer,258,258,516,46,10,Tie
5482,JointPQPlayer,237,237,474,40,22,Tie
5483,JointPQPlayer,252,257,509,48,13,JointPQPlayer
5484,JointPQPlayer,253,253,506,48,14,Tie
5485,JointPQPlayer,246,241,487,41,18,Player A
5486,JointPQPlayer,240,240,480,40,20,Tie
5487,JointPQPlayer,170,175,345,7,54,JointPQPlayer
5488,JointPQPlayer,255,250,505,38,11,Player A
5489,JointPQPlayer,211,211,422,33,37,Tie
5490,JointPQPlayer,252,252,504,43,13,Tie
5491,JointPQPlayer,253,253,506,51,15,Tie
5492,JointPQPlayer,251,251,502,44,14,Tie
5493,JointPQPlayer,274,274,548,57,3,Tie
5494,JointPQPlayer,172,177,349,8,53,JointPQPlayer
5495,JointPQPlayer,252,252,504,37,11,Tie
5496,JointPQPlayer,241,241,482,39,19,Tie
5497,JointPQPlayer,171,171,342,4,54,Tie
5498,JointPQPlayer,256,251,507,46,13,Player A
5499,JointPQPlayer,269,269,538,56,6,Tie
5500,JointPQPlayer,249,249,498,40,14,Tie
5501,JointPQPlayer,165,170,335,6,57,JointPQPlayer
5502,JointPQPlayer,165,165,330,4,58,Tie
5503,JointPQPlayer,257,252,509,36,9,Player A
5504,JointPQPlayer,273,273,546,58,4,Tie
5505,JointPQPlayer,270,270,540,58,6,Tie
5506,JointPQPlayer,261,261,522,49,9,Tie
5507,JointPQPlayer,186,186,372,13,47,Tie
5508,JointPQPlayer,244,244,488,48,20,Tie
5509,JointPQPlayer,269,269,538,56,6,Tie
5510,JointPQPlayer,237,237,474,43,23,Tie
5511,JointPQPlayer,260,265,525,52,9,JointPQPlayer
5512,JointPQPlayer,222,222,444,34,30,Tie
5513,JointPQPlayer,262,257,519,55,12,Player A
5514,JointPQPlayer,219,219,438,34,32,Tie
5515,JointPQPlayer,252,252,504,49,15,Tie
5516,JointPQPlayer,243,243,486,31,15,Tie
5517,JointPQPlayer,261,261,522,52,10,Tie
5518,JointPQPlayer,260,260,520,53,11,Tie
5519,JointPQPlayer,260,265,525,46,7,JointPQPlayer
5520,JointPQPlayer,266,261,527,54,9,Player A
5521,JointPQPlayer,206,211,417,25,36,JointPQPlayer
5522,JointPQPlayer,259,254,513,46,11,Player A
5523,JointPQPlayer,240,240,480,43,21,Tie
5524,JointPQPlayer,198,198,396,19,41,Tie
5525,JointPQPlayer,215,215,430,26,32,Tie
5526,JointPQPlayer,242,247,489,46,19,JointPQPlayer
5527,JointPQPlayer,206,206,412,32,40,Tie
5528,JointPQPlayer,274,269,543,55,4,Player A
5529,JointPQPlayer,265,265,530,48,6,Tie
5530,JointPQPlayer,182,187,369,10,47,JointPQPlayer
5531,JointPQPlayer,271,266,537,55,6,Player A
5532,JointPQPlayer,269,269,538,56,6,Tie
5533,JointPQPlayer,230,235,465,34,23,JointPQPlayer
5534,JointPQPlayer,229,224,453,37,28,Player A
5535,JointPQPlayer,173,178,351,7,52,JointPQPlayer
5536,JointPQPlayer,272,267,539,54,5,Player A
5537,JointPQPlayer,199,199,398,15,39,Tie
5538,JointPQPlayer,238,238,476,36,20,Tie
5539,JointPQPlayer,247,247,494,45,17,Tie
5540,JointPQPlayer,164,169,333,10,59,JointPQPlayer
5541,JointPQPlayer,254,254,508,44,12,Tie
5542,JointPQPlayer,263,263,526,47,7,Tie
5543,JointPQPlayer,267,267,534,55,7,Tie
5544,JointPQPlayer,221,221,442,32,30,Tie
5545,JointPQPlayer,236,231,467,39,24,Player A
5546,JointPQPlayer,255,255,510,46,12,Tie
5547,JointPQPlayer,233,238,471,31,20,JointPQPlayer
5548,JointPQPlayer,222,222,444,37,31,Tie
5549,JointPQPlayer,218,218,436,23,29,Tie
5550,JointPQPlayer,251,251,502,50,16,Tie
5551,JointPQPlayer,163,163,326,6,60,Tie
5552,JointPQPlayer,255,250,505,47,14,Player A
5553,JointPQPlayer,254,254,508,47,13,Tie
5554,JointPQPlayer,260,260,520,47,9,Tie
5555,JointPQPlayer,259,259,518,54,12,Tie
5556,JointPQPlayer,187,187,374,15,47,Tie
5557,JointPQPlayer,250,255,505,44,13,JointPQPlayer
5558,JointPQPlayer,265,260,525,52,9,Player A
5559,JointPQPlayer,245,245,490,41,17,Tie
5560,JointPQPlayer,261,261,522,43,7,Tie
5561,JointPQPlayer,187,187,374,18,48,Tie
5562,JointPQPlayer,234,234,468,37,23,Tie
5563,JointPQPlayer,182,182,364,5,47,Tie
5564,JointPQPlayer,260,260,520,50,10,Tie
5565,JointPQPlayer,248,248,496,41,15,Tie
5566,JointPQPlayer,225,225,450,37,29,Tie
5567,JointPQPlayer,262,262,524,57,11,Tie
5568,JointPQPlayer,269,269,538,56,6,Tie
5569,JointPQPlayer,256,261,517,44,9,JointPQPlayer
5570,JointPQPlayer,201,196,397,26,43,Player A
5571,JointPQPlayer,248,253,501,46,15,JointPQPlayer
5572,JointPQPlayer,260,255,515,42,9,Player A
5573,JointPQPlayer,252,252,504,37,11,Tie
5574,JointPQPlayer,222,222,444,25,27,Tie
5575,JointPQPlayer,269,269,538,56,6,Tie
5576,JointPQPlayer,185,185,370,17,49,Tie
5577,JointPQPlayer,269,269,538,62,8,Tie
5578,JointPQPlayer,236,241,477,40,21,JointPQPlayer
5579,JointPQPlayer,160,160,320,3,61,Tie
5580,JointPQPlayer,237,232,469,41,24,Player A
5581,JointPQPlayer,197,197,394,23,43,Tie
5582,JointPQPlayer,246,251,497,45,16,JointPQPlayer
5583,JointPQPlayer,263,263,526,50,8,Tie
5584,JointPQPlayer,255,250,505,44,13,Player A
5585,JointPQPlayer,220,225,445,32,29,JointPQPlayer
5586,JointPQPlayer,258,253,511,41,10,Player A
5587,JointPQPlayer,239,239,478,35,19,Tie
5588,JointPQPlayer,257,257,514,38,8,Tie
5589,JointPQPlayer,268,268,536,54,6,Tie
5590,JointPQPlayer,234,234,468,28,20,Tie
5591,JointPQPlayer,231,231,462,37,25,Tie
5592,JointPQPlayer,244,249,493,47,18,JointPQPlayer
5593,JointPQPlayer,247,247,494,48,18,Tie
5594,JointPQPlayer,214,209,423,31,36,Player A
5595,JointPQPlayer,260,260,520,53,11,Tie
5596,JointPQPlayer,249,249,498,43,15,Tie
5597,JointPQPlayer,249,249,498,43,15,Tie
5598,JointPQPlayer,268,268,536,48,4,Tie
5599,JointPQPlayer,250,250,500,48,16,Tie
5600,JointPQPlayer,247,247,494,39,15,Tie
5601,JointPQPlayer,238,238,476,36,20,Tie
5602,JointPQPlayer,257,257,514,44,10,Tie
5603,JointPQPlayer,251,256,507,37,10,JointPQPlayer
5604,JointPQPlayer,248,243,491,42,17,Player A
5605,JointPQPlayer,263,263,526,50,8,Tie
5606,JointPQPlayer,256,256,512,42,10,Tie
5607,JointPQPlayer,244,244,488,36,16,Tie
5608,JointPQPlayer,267,267,534,49,5,Tie
5609,JointPQPlayer,250,250,500,39,13,Tie
5610,JointPQPlayer,255,260,515,48,11,JointPQPlayer
5611,JointPQPlayer,246,246,492,43,17,Tie
5612,JointPQPlayer,261,261,522,49,9,Tie
5613,JointPQPlayer,264,264,528,61,11,Tie
5614,JointPQPlayer,234,234,468,34,22,Tie
5615,JointPQPlayer,200,200,400,14,38,Tie
5616,JointPQPlayer,258,253,511,50,13,Player A
5617,JointPQPlayer,252,257,509,48,13,JointPQPlayer
5618,JointPQPlayer,245,240,485,42,19,Player A
5619,JointPQPlayer,268,268,536,51,5,Tie
5620,JointPQPlayer,217,217,434,24,30,Tie
5621,JointPQPlayer,168,173,341,9,56,JointPQPlayer
5622,JointPQPlayer,233,228,461,30,23,Player A
5623,JointPQPlayer,227,227,454,32,26,Tie
5624,JointPQPlayer,169,169,338,6,56,Tie
5625,JointPQPlayer,256,261,517,50,11,JointPQPlayer
5626,JointPQPlayer,252,247,499,44,15,Player A
5627,JointPQPlayer,162,167,329,9,60,JointPQPlayer
5628,JointPQPlayer,272,272,544,59,5,Tie
5629,JointPQPlayer,233,228,461,39,26,Player A
5630,JointPQPlayer,249,249,498,37,13,Tie
5631,JointPQPlayer,257,257,514,44,10,Tie
5632,JointPQPlayer,254,254,508,41,11,Tie
5633,JointPQPlayer,218,218,436,35,33,Tie
5634,JointPQPlayer,223,223,446,33,29,Tie
5635,JointPQPlayer,247,247,494,48,18,Tie
5636,JointPQPlayer,249,249,498,46,16,Tie
5637,JointPQPlayer,259,264,523,44,7,JointPQPlayer
5638,JointPQPlayer,265,260,525,49,8,Player A
5639,JointPQPlayer,265,270,535,53,6,JointPQPlayer
5640,JointPQPlayer,273,268,541,56,5,Player A
5641,JointPQPlayer,255,255,510,52,14,Tie
5642,JointPQPlayer,229,229,458,36,26,Tie
5643,JointPQPlayer,259,259,518,51,11,Tie
5644,JointPQPlayer,248,248,496,38,14,Tie
5645,JointPQPlayer,209,209,418,20,34,Tie
5646,JointPQPlayer,256,261,517,50,11,JointPQPlayer
5647,JointPQPlayer,238,233,471,43,24,Player A
5648,JointPQPlayer,196,201,397,14,39,JointPQPlayer
5649,JointPQPlayer,261,256,517,50,11,Player A
5650,JointPQPlayer,265,270,535,56,7,JointPQPlayer
5651,JointPQPlayer,251,246,497,51,18,Player A
5652,JointPQPlayer,259,264,523,50,9,JointPQPlayer
5653,JointPQPlayer,259,254,513,46,11,Player A
5654,JointPQPlayer,246,251,497,39,14,JointPQPlayer
5655,JointPQPlayer,192,192,384,22,46,Tie
5656,JointPQPlayer,254,249,503,51,16,Player A
5657,JointPQPlayer,268,273,541,56,5,JointPQPlayer
5658,JointPQPlayer,230,225,455,36,27,Player A
5659,JointPQPlayer,261,261,522,52,10,Tie
5660,JointPQPlayer,239,244,483,37,18,JointPQPlayer
5661,JointPQPlayer,260,260,520,53,11,Tie
5662,JointPQPlayer,257,252,509,51,14,Player A
5663,JointPQPlayer,178,183,361,11,50,JointPQPlayer
5664,JointPQPlayer,166,161,327,7,60,Player A
5665,JointPQPlayer,203,203,406,29,41,Tie
5666,JointPQPlayer,172,172,344,9,55,Tie
5667,JointPQPlayer,257,262,519,43,8,JointPQPlayer
5668,JointPQPlayer,174,169,343,14,57,Player A
5669,JointPQPlayer,222,227,449,30,27,JointPQPlayer
5670,JointPQPlayer,232,227,459,34,25,Player A
5671,JointPQPlayer,201,206,407,15,36,JointPQPlayer
5672,JointPQPlayer,250,245,495,40,15,Player A
5673,JointPQPlayer,257,257,514,47,11,Tie
5674,JointPQPlayer,252,252,504,40,12,Tie
5675,JointPQPlayer,247,252,499,47,16,JointPQPlayer
5676,JointPQPlayer,244,244,488,45,19,Tie
5677,JointPQPlayer,253,248,501,49,16,Player A
5678,JointPQPlayer,245,245,490,41,17,Tie
5679,JointPQPlayer,161,161,322,5,61,Tie
5680,JointPQPlayer,232,232,464,30,22,Tie
5681,JointPQPlayer,233,233,466,32,22,Tie
5682,JointPQPlayer,270,270,540,55,5,Tie
5683,JointPQPlayer,245,245,490,38,16,Tie
5684,JointPQPlayer,275,275,550,65,5,Tie
5685,JointPQPlayer,258,258,516,46,10,Tie
5686,JointPQPlayer,260,265,525,46,7,JointPQPlayer
5687,JointPQPlayer,248,243,491,33,14,Player A
5688,JointPQPlayer,256,261,517,50,11,JointPQPlayer
5689,JointPQPlayer,256,256,512,54,14,Tie
5690,JointPQPlayer,259,254,513,52,13,Player A
5691,JointPQPlayer,266,266,532,53,7,Tie
5692,JointPQPlayer,251,251,502,41,13,Tie
5693,JointPQPlayer,252,257,509,48,13,JointPQPlayer
5694,JointPQPlayer,248,248,496,44,16,Tie
5695,JointPQPlayer,261,256,517,47,10,Player A
5696,JointPQPlayer,251,256,507,37,10,JointPQPlayer
5697,JointPQPlayer,232,227,459,31,24,Player A
5698,JointPQPlayer,267,267,534,52,6,Tie
5699,JointPQPlayer,264,264,528,49,7,Tie
5700,JointPQPlayer,194,199,393,25,44,JointPQPlayer
5701,JointPQPlayer,264,259,523,53,10,Player A
5702,JointPQPlayer,273,273,546,58,4,Tie
5703,JointPQPlayer,259,259,518,45,9,Tie
5704,JointPQPlayer,263,268,531,52,7,JointPQPlayer
5705,JointPQPlayer,250,250,500,42,14,Tie
5706,JointPQPlayer,237,237,474,40,22,Tie
5707,JointPQPlayer,263,263,526,47,7,Tie
5708,JointPQPlayer,257,252,509,42,11,Player A
5709,JointPQPlayer,244,244,488,39,17,Tie
5710,JointPQPlayer,239,244,483,40,19,JointPQPlayer
5711,JointPQPlayer,230,230,460,32,24,Tie
5712,JointPQPlayer,244,239,483,49,22,Player A
5713,JointPQPlayer,260,260,520,47,9,Tie
5714,JointPQPlayer,249,249,498,46,16,Tie
5715,JointPQPlayer,250,250,500,45,15,Tie
5716,JointPQPlayer,234,234,468,34,22,Tie
5717,JointPQPlayer,257,257,514,44,10,Tie
5718,JointPQPlayer,209,209,418,29,37,Tie
5719,JointPQPlayer,271,271,542,51,3,Tie
5720,JointPQPlayer,179,184,363,10,49,JointPQPlayer
5721,JointPQPlayer,262,262,524,51,9,Tie
5722,JointPQPlayer,269,264,533,57,8,Player A
5723,JointPQPlayer,259,259,518,45,9,Tie
5724,JointPQPlayer,268,268,536,54,6,Tie
5725,JointPQPlayer,221,226,447,31,28,JointPQPlayer
5726,JointPQPlayer,232,227,459,37,26,Player A
5727,JointPQPlayer,259,259,518,42,8,Tie
5728,JointPQPlayer,251,251,502,53,17,Tie
5729,JointPQPlayer,262,262,524,39,5,Tie
5730,JointPQPlayer,267,267,534,52,6,Tie
5731,JointPQPlayer,183,188,371,15,48,JointPQPlayer
5732,JointPQPlayer,177,177,354,1,49,Tie
5733,JointPQPlayer,274,269,543,58,5,Player A
5734,JointPQPlayer,247,247,494,42,16,Tie
5735,JointPQPlayer,248,253,501,43,14,JointPQPlayer
5736,JointPQPlayer,189,184,373,17,48,Player A
5737,JointPQPlayer,263,263,526,47,7,Tie
5738,JointPQPlayer,263,263,526,50,8,Tie
5739,JointPQPlayer,241,246,487,41,18,JointPQPlayer
5740,JointPQPlayer,261,261,522,49,9,Tie
5741,JointPQPlayer,253,248,501,37,12,Player A
5742,JointPQPlayer,228,228,456,28,24,Tie
5743,JointPQPlayer,201,206,407,15,36,JointPQPlayer
5744,JointPQPlayer,235,230,465,37,24,Player A
5745,JointPQPlayer,260,265,525,55,10,JointPQPlayer
5746,JointPQPlayer,258,258,516,46,10,Tie
5747,JointPQPlayer,219,214,433,29,32,Player A
5748,JointPQPlayer,249,254,503,48,15,JointPQPlayer
5749,JointPQPlayer,261,261,522,55,11,Tie
5750,JointPQPlayer,272,267,539,54,5,Player A
5751,JointPQPlayer,178,183,361,8,49,JointPQPlayer
5752,JointPQPlayer,260,255,515,45,10,Player A
5753,JointPQPlayer,228,233,461,33,24,JointPQPlayer
5754,JointPQPlayer,249,249,498,46,16,Tie
5755,JointPQPlayer,252,247,499,44,15,Player A
5756,JointPQPlayer,188,193,381,7,42,JointPQPlayer
5757,JointPQPlayer,264,259,523,50,9,Player A
5758,JointPQPlayer,212,212,424,26,34,Tie
5759,JointPQPlayer,182,182,364,8,48,Tie
5760,JointPQPlayer,265,265,530,54,8,Tie
5761,JointPQPlayer,253,253,506,36,10,Tie
5762,JointPQPlayer,244,244,488,39,17,Tie
5763,JointPQPlayer,257,257,514,44,10,Tie
5764,JointPQPlayer,161,166,327,4,59,JointPQPlayer
5765,JointPQPlayer,254,249,503,42,13,Player A
5766,JointPQPlayer,168,173,341,6,55,JointPQPlayer
5767,JointPQPlayer,267,262,529,50,7,Player A
5768,JointPQPlayer,196,196,392,21,43,Tie
5769,JointPQPlayer,259,264,523,50,9,JointPQPlayer
5770,JointPQPlayer,259,259,518,45,9,Tie
5771,JointPQPlayer,259,254,513,46,11,Player A
5772,JointPQPlayer,199,199,398,21,41,Tie
5773,JointPQPlayer,260,265,525,49,8,JointPQPlayer
5774,JointPQPlayer,244,239,483,46,21,Player A
5775,JointPQPlayer,248,248,496,44,16,Tie
5776,JointPQPlayer,235,235,470,39,23,Tie
5777,JointPQPlayer,219,219,438,31,31,Tie
5778,JointPQPlayer,188,188,376,11,45,Tie
5779,JointPQPlayer,249,249,498,40,14,Tie
5780,JointPQPlayer,259,264,523,44,7,JointPQPlayer
5781,JointPQPlayer,255,255,510,49,13,Tie
5782,JointPQPlayer,180,180,360,10,50,Tie
5783,JointPQPlayer,239,234,473,48,25,Player A
5784,JointPQPlayer,240,240,480,37,19,Tie
5785,JointPQPlayer,263,263,526,50,8,Tie
5786,JointPQPlayer,234,239,473,36,21,JointPQPlayer
5787,JointPQPlayer,272,267,539,54,5,Player A
5788,JointPQPlayer,233,233,466,35,23,Tie
5789,JointPQPlayer,272,277,549,58,3,JointPQPlayer
5790,JointPQPlayer,229,229,458,33,25,Tie
5791,JointPQPlayer,231,231,462,34,24,Tie
5792,JointPQPlayer,175,170,345,7,54,Player A
5793,JointPQPlayer,244,249,493,44,17,JointPQPlayer
5794,JointPQPlayer,265,260,525,46,7,Player A
5795,JointPQPlayer,235,240,475,41,22,JointPQPlayer
5796,JointPQPlayer,243,238,481,35,18,Player A
5797,JointPQPlayer,162,162,324,4,60,Tie
5798,JointPQPlayer,253,258,511,47,12,JointPQPlayer
5799,JointPQPlayer,262,257,519,52,11,Player A
5800,JointPQPlayer,259,259,518,48,10,Tie
5801,JointPQPlayer,232,237,469,38,23,JointPQPlayer
5802,JointPQPlayer,267,262,529,56,9,Player A
5803,JointPQPlayer,180,185,365,12,49,JointPQPlayer
5804,JointPQPlayer,255,255,510,49,13,Tie
5805,JointPQPlayer,261,256,517,53,12,Player A
5806,JointPQPlayer,147,152,299,3,68,JointPQPlayer
5807,JointPQPlayer,249,249,498,43,15,Tie
5808,JointPQPlayer,253,253,506,42,12,Tie
5809,JointPQPlayer,270,265,535,50,5,Player A
5810,JointPQPlayer,244,249,493,38,15,JointPQPlayer
5811,JointPQPlayer,176,171,347,12,55,Player A
5812,JointPQPlayer,237,242,479,33,18,JointPQPlayer
5813,JointPQPlayer,258,258,516,49,11,Tie
5814,JointPQPlayer,253,248,501,34,11,Player A
5815,JointPQPlayer,231,231,462,37,25,Tie
5816,JointPQPlayer,251,256,507,46,13,JointPQPlayer
5817,JointPQPlayer,162,162,324,7,61,Tie
5818,JointPQPlayer,257,257,514,50,12,Tie
5819,JointPQPlayer,244,239,483,46,21,Player A
5820,JointPQPlayer,169,174,343,8,55,JointPQPlayer
5821,JointPQPlayer,253,248,501,46,15,Player A
5822,JointPQPlayer,256,261,517,50,11,JointPQPlayer
5823,JointPQPlayer,252,247,499,44,15,Player A
5824,JointPQPlayer,247,247,494,42,16,Tie
5825,JointPQPlayer,269,269,538,56,6,Tie
5826,JointPQPlayer,223,228,451,29,26,JointPQPlayer
5827,JointPQPlayer,222,217,439,29,30,Player A
5828,JointPQPlayer,247,252,499,47,16,JointPQPlayer
5829,JointPQPlayer,255,250,505,47,14,Player A
5830,JointPQPlayer,267,267,534,52,6,Tie
5831,JointPQPlayer,271,271,542,54,4,Tie
5832,JointPQPlayer,266,266,532,47,5,Tie
5833,JointPQPlayer,242,242,484,44,20,Tie
5834,JointPQPlayer,269,269,538,56,6,Tie
5835,JointPQPlayer,165,170,335,3,56,JointPQPlayer
5836,JointPQPlayer,264,259,523,47,8,Player A
5837,JointPQPlayer,271,271,542,60,6,Tie
5838,JointPQPlayer,262,262,524,42,6,Tie
5839,JointPQPlayer,251,251,502,41,13,Tie
5840,JointPQPlayer,186,191,377,9,44,JointPQPlayer
5841,JointPQPlayer,274,269,543,55,4,Player A
5842,JointPQPlayer,259,259,518,42,8,Tie
5843,JointPQPlayer,156,161,317,6,63,JointPQPlayer
5844,JointPQPlayer,240,240,480,43,21,Tie
5845,JointPQPlayer,254,254,508,47,13,Tie
5846,JointPQPlayer,270,265,535,47,4,Player A
5847,JointPQPlayer,246,251,497,39,14,JointPQPlayer
5848,JointPQPlayer,264,259,523,53,10,Player A
5849,JointPQPlayer,262,267,529,53,8,JointPQPlayer
5850,JointPQPlayer,248,248,496,44,16,Tie
5851,JointPQPlayer,173,168,341,6,55,Player A
5852,JointPQPlayer,161,166,327,4,59,JointPQPlayer
5853,JointPQPlayer,265,260,525,52,9,Player A
5854,JointPQPlayer,184,189,373,17,48,JointPQPlayer
5855,JointPQPlayer,238,233,471,46,25,Player A
5856,JointPQPlayer,252,257,509,42,11,JointPQPlayer
5857,JointPQPlayer,163,163,326,9,61,Tie
5858,JointPQPlayer,275,270,545,57,4,Player A
5859,JointPQPlayer,258,258,516,46,10,Tie
5860,JointPQPlayer,220,220,440,39,33,Tie
5861,JointPQPlayer,248,248,496,41,15,Tie
5862,JointPQPlayer,184,189,373,8,45,JointPQPlayer
5863,JointPQPlayer,264,264,528,49,7,Tie
5864,JointPQPlayer,163,163,326,3,59,Tie
5865,JointPQPlayer,182,177,359,9,50,Player A
5866,JointPQPlayer,270,270,540,58,6,Tie
5867,JointPQPlayer,195,200,395,24,43,JointPQPlayer
5868,JointPQPlayer,257,252,509,45,12,Player A
5869,JointPQPlayer,180,185,365,9,48,JointPQPlayer
5870,JointPQPlayer,256,256,512,48,12,Tie
5871,JointPQPlayer,254,249,503,39,12,Player A
5872,JointPQPlayer,256,261,517,44,9,JointPQPlayer
5873,JointPQPlayer,184,179,363,10,49,Player A
5874,JointPQPlayer,263,268,531,52,7,JointPQPlayer
5875,JointPQPlayer,258,253,511,47,12,Player A
5876,JointPQPlayer,223,223,446,27,27,Tie
5877,JointPQPlayer,245,250,495,46,17,JointPQPlayer
5878,JointPQPlayer,254,254,508,44,12,Tie
5879,JointPQPlayer,225,220,445,29,28,Player A
5880,JointPQPlayer,255,255,510,49,13,Tie
5881,JointPQPlayer,253,258,511,44,11,JointPQPlayer
5882,JointPQPlayer,279,274,553,56,1,Player A
5883,JointPQPlayer,178,183,361,8,49,JointPQPlayer
5884,JointPQPlayer,243,238,481,35,18,Player A
5885,JointPQPlayer,230,235,465,34,23,JointPQPlayer
5886,JointPQPlayer,251,251,502,32,10,Tie
5887,JointPQPlayer,260,260,520,56,12,Tie
5888,JointPQPlayer,263,258,521,45,8,Player A
5889,JointPQPlayer,255,260,515,45,10,JointPQPlayer
5890,JointPQPlayer,245,245,490,41,17,Tie
5891,JointPQPlayer,180,180,360,10,50,Tie
5892,JointPQPlayer,258,258,516,52,12,Tie
5893,JointPQPlayer,248,243,491,42,17,Player A
5894,JointPQPlayer,250,255,505,47,14,JointPQPlayer
5895,JointPQPlayer,269,264,533,51,6,Player A
5896,JointPQPlayer,252,257,509,42,11,JointPQPlayer
5897,JointPQPlayer,237,237,474,43,23,Tie
5898,JointPQPlayer,184,179,363,19,52,Player A
5899,JointPQPlayer,264,264,528,55,9,Tie
5900,JointPQPlayer,209,209,418,26,36,Tie
5901,JointPQPlayer,263,263,526,47,7,Tie
5902,JointPQPlayer,220,225,445,35,30,JointPQPlayer
5903,JointPQPlayer,272,267,539,57,6,Player A
5904,JointPQPlayer,182,182,364,11,49,Tie
5905,JointPQPlayer,178,183,361,8,49,JointPQPlayer
5906,JointPQPlayer,241,241,482,39,19,Tie
5907,JointPQPlayer,246,241,487,38,17,Player A
5908,JointPQPlayer,182,187,369,10,47,JointPQPlayer
5909,JointPQPlayer,253,248,501,46,15,Player A
5910,JointPQPlayer,238,238,476,42,22,Tie
5911,JointPQPlayer,183,188,371,15,48,JointPQPlayer
5912,JointPQPlayer,246,246,492,40,16,Tie
5913,JointPQPlayer,166,161,327,4,59,Player A
5914,JointPQPlayer,259,259,518,39,7,Tie
5915,JointPQPlayer,248,248,496,53,19,Tie
5916,JointPQPlayer,242,247,489,37,16,JointPQPlayer
5917,JointPQPlayer,245,240,485,42,19,Player A
5918,JointPQPlayer,262,267,529,56,9,JointPQPlayer
5919,JointPQPlayer,260,255,515,51,12,Player A
5920,JointPQPlayer,210,210,420,31,37,Tie
5921,JointPQPlayer,234,239,473,39,22,JointPQPlayer
5922,JointPQPlayer,170,170,340,8,56,Tie
5923,JointPQPlayer,248,243,491,42,17,Player A
5924,JointPQPlayer,220,220,440,27,29,Tie
5925,JointPQPlayer,263,263,526,50,8,Tie
5926,JointPQPlayer,169,174,343,14,57,JointPQPlayer
5927,JointPQPlayer,185,180,365,12,49,Player A
5928,JointPQPlayer,166,171,337,5,56,JointPQPlayer
5929,JointPQPlayer,194,189,383,9,42,Player A
5930,JointPQPlayer,243,243,486,43,19,Tie
5931,JointPQPlayer,259,264,523,62,13,JointPQPlayer
5932,JointPQPlayer,250,245,495,43,16,Player A
5933,JointPQPlayer,274,274,548,63,5,Tie
5934,JointPQPlayer,239,239,478,35,19,Tie
5935,JointPQPlayer,234,234,468,31,21,Tie
5936,JointPQPlayer,244,244,488,45,19,Tie
5937,JointPQPlayer,261,261,522,43,7,Tie
5938,JointPQPlayer,240,240,480,43,21,Tie
5939,JointPQPlayer,227,227,454,35,27,Tie
5940,JointPQPlayer,233,233,466,35,23,Tie
5941,JointPQPlayer,266,266,532,53,7,Tie
5942,JointPQPlayer,266,266,532,56,8,Tie
5943,JointPQPlayer,262,262,524,51,9,Tie
5944,JointPQPlayer,247,247,494,45,17,Tie
5945,JointPQPlayer,189,189,378,13,45,Tie
5946,JointPQPlayer,257,262,519,52,11,JointPQPlayer
5947,JointPQPlayer,260,260,520,47,9,Tie
5948,JointPQPlayer,243,243,486,46,20,Tie
5949,JointPQPlayer,264,264,528,58,10,Tie
5950,JointPQPlayer,238,233,471,40,23,Player A
5951,JointPQPlayer,261,261,522,49,9,Tie
5952,JointPQPlayer,258,258,516,52,12,Tie
5953,JointPQPlayer,223,223,446,33,29,Tie
5954,JointPQPlayer,261,266,527,51,8,JointPQPlayer
5955,JointPQPlayer,275,270,545,54,3,Player A
5956,JointPQPlayer,274,274,548,57,3,Tie
5957,JointPQPlayer,251,251,502,47,15,Tie
5958,JointPQPlayer,245,245,490,38,16,Tie
5959,JointPQPlayer,263,263,526,53,9,Tie
5960,JointPQPlayer,253,258,511,44,11,JointPQPlayer
5961,JointPQPlayer,254,249,503,42,13,Player A
5962,JointPQPlayer,224,224,448,32,28,Tie
5963,JointPQPlayer,252,252,504,46,14,Tie
5964,JointPQPlayer,203,208,411,19,36,JointPQPlayer
5965,JointPQPlayer,262,262,524,54,10,Tie
5966,JointPQPlayer,254,254,508,47,13,Tie
5967,JointPQPlayer,161,161,322,5,61,Tie
5968,JointPQPlayer,254,249,503,42,13,Player A
5969,JointPQPlayer,172,177,349,8,53,JointPQPlayer
5970,JointPQPlayer,277,277,554,60,2,Tie
5971,JointPQPlayer,176,176,352,5,51,Tie
5972,JointPQPlayer,183,183,366,16,50,Tie
5973,JointPQPlayer,266,266,532,56,8,Tie
5974,JointPQPlayer,259,259,518,39,7,Tie
5975,JointPQPlayer,256,251,507,49,14,Player A
5976,JointPQPlayer,261,261,522,52,10,Tie
5977,JointPQPlayer,240,240,480,34,18,Tie
5978,JointPQPlayer,253,253,506,42,12,Tie
5979,JointPQPlayer,192,197,389,9,40,JointPQPlayer
5980,JointPQPlayer,230,225,455,36,27,Player A
5981,JointPQPlayer,247,252,499,41,14,JointPQPlayer
5982,JointPQPlayer,269,269,538,59,7,Tie
5983,JointPQPlayer,269,264,533,57,8,Player A
5984,JointPQPlayer,150,155,305,3,66,JointPQPlayer
5985,JointPQPlayer,256,256,512,45,11,Tie
5986,JointPQPlayer,273,273,546,52,2,Tie
5987,JointPQPlayer,213,208,421,29,36,Player A
5988,JointPQPlayer,238,238,476,36,20,Tie
5989,JointPQPlayer,260,260,520,50,10,Tie
5990,JointPQPlayer,208,208,416,30,38,Tie
5991,JointPQPlayer,277,277,554,63,3,Tie
5992,JointPQPlayer,260,265,525,55,10,JointPQPlayer
5993,JointPQPlayer,237,232,469,41,24,Player A
5994,JointPQPlayer,212,212,424,32,36,Tie
5995,JointPQPlayer,264,269,533,51,6,JointPQPlayer
5996,JointPQPlayer,270,265,535,59,8,Player A
5997,JointPQPlayer,227,227,454,35,27,Tie
5998,JointPQPlayer,269,269,538,56,6,Tie
5999,JointPQPlayer,216,216,432,34,34,Tie
6000,JointPQPlayer,246,246,492,37,15,Tie
6001,JointPQPlayer,251,256,507,43,12,JointPQPlayer
6002,JointPQPlayer,247,247,494,42,16,Tie
6003,JointPQPlayer,193,193,386,9,41,Tie
6004,JointPQPlayer,251,246,497,42,15,Player A
6005,JointPQPlayer,258,258,516,52,12,Tie
6006,JointPQPlayer,262,262,524,51,9,Tie
6007,JointPQPlayer,260,260,520,50,10,Tie
6008,JointPQPlayer,227,227,454,38,28,Tie
6009,JointPQPlayer,272,272,544,59,5,Tie
6010,JointPQPlayer,258,258,516,55,13,Tie
6011,JointPQPlayer,254,254,508,47,13,Tie
6012,JointPQPlayer,200,200,400,23,41,Tie
6013,JointPQPlayer,162,167,329,6,59,JointPQPlayer
6014,JointPQPlayer,242,242,484,41,19,Tie
6015,JointPQPlayer,267,262,529,47,6,Player A
6016,JointPQPlayer,273,273,546,61,5,Tie
6017,JointPQPlayer,263,263,526,59,11,Tie
6018,JointPQPlayer,258,263,521,48,9,JointPQPlayer
6019,JointPQPlayer,251,246,497,39,14,Player A
6020,JointPQPlayer,213,218,431,27,32,JointPQPlayer
6021,JointPQPlayer,256,256,512,45,11,Tie
6022,JointPQPlayer,271,271,542,60,6,Tie
6023,JointPQPlayer,273,273,546,58,4,Tie
6024,JointPQPlayer,258,253,511,47,12,Player A
6025,JointPQPlayer,260,265,525,49,8,JointPQPlayer
6026,JointPQPlayer,273,268,541,56,5,Player A
6027,JointPQPlayer,185,190,375,10,45,JointPQPlayer
6028,JointPQPlayer,274,269,543,58,5,Player A
6029,JointPQPlayer,258,258,516,52,12,Tie
6030,JointPQPlayer,252,252,504,46,14,Tie
6031,JointPQPlayer,264,264,528,52,8,Tie
6032,JointPQPlayer,180,185,365,12,49,JointPQPlayer
6033,JointPQPlayer,259,254,513,40,9,Player A
6034,JointPQPlayer,251,251,502,44,14,Tie
6035,JointPQPlayer,205,205,410,18,36,Tie
6036,JointPQPlayer,171,176,347,9,54,JointPQPlayer
6037,JointPQPlayer,275,270,545,63,6,Player A
6038,JointPQPlayer,248,248,496,44,16,Tie
6039,JointPQPlayer,252,252,504,58,18,Tie
6040,JointPQPlayer,224,229,453,22,23,JointPQPlayer
6041,JointPQPlayer,253,253,506,42,12,Tie
6042,JointPQPlayer,242,242,484,41,19,Tie
6043,JointPQPlayer,257,252,509,48,13,Player A
6044,JointPQPlayer,266,271,537,55,6,JointPQPlayer
6045,JointPQPlayer,242,242,484,44,20,Tie
6046,JointPQPlayer,276,271,547,59,4,Player A
6047,JointPQPlayer,264,264,528,52,8,Tie
6048,JointPQPlayer,250,250,500,42,14,Tie
6049,JointPQPlayer,242,242,484,44,20,Tie
6050,JointPQPlayer,234,234,468,28,20,Tie
6051,JointPQPlayer,256,256,512,48,12,Tie
6052,JointPQPlayer,161,161,322,8,62,Tie
6053,JointPQPlayer,256,256,512,48,12,Tie
6054,JointPQPlayer,258,258,516,46,10,Tie
6055,JointPQPlayer,244,249,493,47,18,JointPQPlayer
6056,JointPQPlayer,190,190,380,12,44,Tie
6057,JointPQPlayer,214,209,423,28,35,Player A
6058,JointPQPlayer,198,198,396,16,40,Tie
6059,JointPQPlayer,241,246,487,44,19,JointPQPlayer
6060,JointPQPlayer,172,167,339,13,58,Player A
6061,JointPQPlayer,170,170,340,8,56,Tie
6062,JointPQPlayer,275,275,550,62,4,Tie
6063,JointPQPlayer,189,194,383,12,43,JointPQPlayer
6064,JointPQPlayer,243,243,486,43,19,Tie
6065,JointPQPlayer,272,267,539,54,5,Player A
6066,JointPQPlayer,265,270,535,50,5,JointPQPlayer
6067,JointPQPlayer,270,265,535,47,4,Player A
6068,JointPQPlayer,250,255,505,41,12,JointPQPlayer
6069,JointPQPlayer,262,257,519,52,11,Player A
6070,JointPQPlayer,258,263,521,54,11,JointPQPlayer
6071,JointPQPlayer,272,267,539,57,6,Player A
6072,JointPQPlayer,260,265,525,52,9,JointPQPlayer
6073,JointPQPlayer,237,237,474,34,20,Tie
6074,JointPQPlayer,260,255,515,48,11,Player A
6075,JointPQPlayer,255,255,510,43,11,Tie
6076,JointPQPlayer,265,265,530,57,9,Tie
6077,JointPQPlayer,186,186,372,10,46,Tie
6078,JointPQPlayer,260,260,520,50,10,Tie
6079,JointPQPlayer,231,231,462,37,25,Tie
6080,JointPQPlayer,238,243,481,35,18,JointPQPlayer
6081,JointPQPlayer,262,257,519,58,13,Player A
6082,JointPQPlayer,199,199,398,21,41,Tie
6083,JointPQPlayer,214,214,428,36,36,Tie
6084,JointPQPlayer,246,251,497,48,17,JointPQPlayer
6085,JointPQPlayer,176,176,352,8,52,Tie
6086,JointPQPlayer,257,257,514,44,10,Tie
6087,JointPQPlayer,196,191,387,19,44,Player A
6088,JointPQPlayer,264,264,528,52,8,Tie
6089,JointPQPlayer,244,249,493,44,17,JointPQPlayer
6090,JointPQPlayer,166,166,332,6,58,Tie
6091,JointPQPlayer,232,232,464,42,26,Tie
6092,JointPQPlayer,247,242,489,40,17,Player A
6093,JointPQPlayer,246,246,492,34,14,Tie
6094,JointPQPlayer,179,184,363,7,48,JointPQPlayer
6095,JointPQPlayer,260,260,520,53,11,Tie
6096,JointPQPlayer,276,271,547,56,3,Player A
6097,JointPQPlayer,246,246,492,40,16,Tie
6098,JointPQPlayer,265,270,535,53,6,JointPQPlayer
6099,JointPQPlayer,259,259,518,48,10,Tie
6100,JointPQPlayer,194,189,383,21,46,Player A
6101,JointPQPlayer,260,265,525,49,8,JointPQPlayer
6102,JointPQPlayer,195,190,385,11,42,Player A
6103,JointPQPlayer,185,190,375,13,46,JointPQPlayer
6104,JointPQPlayer,254,249,503,39,12,Player A
6105,JointPQPlayer,270,270,540,61,7,Tie
6106,JointPQPlayer,164,169,333,7,58,JointPQPlayer
6107,JointPQPlayer,251,246,497,39,14,Player A
6108,JointPQPlayer,176,176,352,8,52,Tie
6109,JointPQPlayer,281,281,562,65,1,Tie
6110,JointPQPlayer,187,187,374,15,47,Tie
6111,JointPQPlayer,257,257,514,50,12,Tie
6112,JointPQPlayer,222,222,444,34,30,Tie
6113,JointPQPlayer,226,231,457,29,24,JointPQPlayer
6114,JointPQPlayer,272,267,539,54,5,Player A
6115,JointPQPlayer,221,226,447,34,29,JointPQPlayer
6116,JointPQPlayer,250,245,495,46,17,Player A
6117,JointPQPlayer,233,233,466,35,23,Tie
6118,JointPQPlayer,255,260,515,42,9,JointPQPlayer
6119,JointPQPlayer,201,201,402,16,38,Tie
6120,JointPQPlayer,269,264,533,51,6,Player A
6121,JointPQPlayer,260,265,525,46,7,JointPQPlayer
6122,JointPQPlayer,266,266,532,50,6,Tie
6123,JointPQPlayer,251,246,497,48,17,Player A
6124,JointPQPlayer,255,260,515,45,10,JointPQPlayer
6125,JointPQPlayer,264,259,523,47,8,Player A
6126,JointPQPlayer,184,189,373,14,47,JointPQPlayer
6127,JointPQPlayer,271,266,537,58,7,Player A
6128,JointPQPlayer,269,274,543,58,5,JointPQPlayer
6129,JointPQPlayer,165,165,330,7,59,Tie
6130,JointPQPlayer,258,253,511,47,12,Player A
6131,JointPQPlayer,201,201,402,16,38,Tie
6132,JointPQPlayer,258,258,516,43,9,Tie
6133,JointPQPlayer,263,263,526,56,10,Tie
6134,JointPQPlayer,268,268,536,54,6,Tie
6135,JointPQPlayer,268,268,536,51,5,Tie
6136,JointPQPlayer,181,186,367,17,50,JointPQPlayer
6137,JointPQPlayer,209,204,413,21,36,Player A
6138,JointPQPlayer,169,174,343,8,55,JointPQPlayer
6139,JointPQPlayer,255,255,510,43,11,Tie
6140,JointPQPlayer,249,244,493,44,17,Player A
6141,JointPQPlayer,210,215,425,30,35,JointPQPlayer
6142,JointPQPlayer,207,202,409,23,38,Player A
6143,JointPQPlayer,266,266,532,53,7,Tie
6144,JointPQPlayer,245,245,490,44,18,Tie
6145,JointPQPlayer,246,251,497,45,16,JointPQPlayer
6146,JointPQPlayer,255,250,505,44,13,Player A
6147,JointPQPlayer,251,251,502,41,13,Tie
6148,JointPQPlayer,198,198,396,13,39,Tie
6149,JointPQPlayer,183,188,371,6,45,JointPQPlayer
6150,JointPQPlayer,252,247,499,44,15,Player A
6151,JointPQPlayer,179,184,363,7,48,JointPQPlayer
6152,JointPQPlayer,248,243,491,42,17,Player A
6153,JointPQPlayer,254,259,513,43,10,JointPQPlayer
6154,JointPQPlayer,250,245,495,43,16,Player A
6155,JointPQPlayer,269,269,538,59,7,Tie
6156,JointPQPlayer,222,222,444,37,31,Tie
6157,JointPQPlayer,178,183,361,11,50,JointPQPlayer
6158,JointPQPlayer,263,258,521,51,10,Player A
6159,JointPQPlayer,269,269,538,59,7,Tie
6160,JointPQPlayer,244,249,493,47,18,JointPQPlayer
6161,JointPQPlayer,206,201,407,21,38,Player A
6162,JointPQPlayer,172,172,344,9,55,Tie
6163,JointPQPlayer,263,263,526,53,9,Tie
6164,JointPQPlayer,249,249,498,40,14,Tie
6165,JointPQPlayer,242,242,484,35,17,Tie
6166,JointPQPlayer,198,198,396,16,40,Tie
6167,JointPQPlayer,258,258,516,46,10,Tie
6168,JointPQPlayer,260,260,520,47,9,Tie
6169,JointPQPlayer,261,266,527,45,6,JointPQPlayer
6170,JointPQPlayer,230,225,455,39,28,Player A
6171,JointPQPlayer,259,264,523,50,9,JointPQPlayer
6172,JointPQPlayer,232,232,464,33,23,Tie
6173,JointPQPlayer,264,259,523,47,8,Player A
6174,JointPQPlayer,243,248,491,45,18,JointPQPlayer
6175,JointPQPlayer,268,263,531,52,7,Player A
6176,JointPQPlayer,282,282,564,70,2,Tie
6177,JointPQPlayer,198,198,396,16,40,Tie
6178,JointPQPlayer,207,207,414,25,37,Tie
6179,JointPQPlayer,258,258,516,49,11,Tie
6180,JointPQPlayer,262,262,524,51,9,Tie
6181,JointPQPlayer,178,183,361,5,48,JointPQPlayer
6182,JointPQPlayer,262,262,524,48,8,Tie
6183,JointPQPlayer,259,254,513,46,11,Player A
6184,JointPQPlayer,174,179,353,6,51,JointPQPlayer
6185,JointPQPlayer,166,166,332,6,58,Tie
6186,JointPQPlayer,186,186,372,13,47,Tie
6187,JointPQPlayer,266,261,527,48,7,Player A
6188,JointPQPlayer,257,262,519,46,9,JointPQPlayer
6189,JointPQPlayer,261,261,522,49,9,Tie
6190,JointPQPlayer,243,238,481,41,20,Player A
6191,JointPQPlayer,258,258,516,46,10,Tie
6192,JointPQPlayer,197,197,394,17,41,Tie
6193,JointPQPlayer,239,239,478,41,21,Tie
6194,JointPQPlayer,252,257,509,48,13,JointPQPlayer
6195,JointPQPlayer,259,254,513,43,10,Player A
6196,JointPQPlayer,169,174,343,8,55,JointPQPlayer
6197,JointPQPlayer,165,165,330,7,59,Tie
6198,JointPQPlayer,262,262,524,54,10,Tie
6199,JointPQPlayer,231,226,457,26,23,Player A
6200,JointPQPlayer,267,267,534,55,7,Tie
6201,JointPQPlayer,263,263,526,47,7,Tie
6202,JointPQPlayer,269,269,538,53,5,Tie
6203,JointPQPlayer,254,254,508,41,11,Tie
6204,JointPQPlayer,270,275,545,57,4,JointPQPlayer
6205,JointPQPlayer,260,255,515,42,9,Player A
6206,JointPQPlayer,220,225,445,32,29,JointPQPlayer
6207,JointPQPlayer,269,264,533,48,5,Player A
6208,JointPQPlayer,249,249,498,46,16,Tie
6209,JointPQPlayer,167,172,339,4,55,JointPQPlayer
6210,JointPQPlayer,253,253,506,39,11,Tie
6211,JointPQPlayer,268,263,531,58,9,Player A
6212,JointPQPlayer,266,266,532,44,4,Tie
6213,JointPQPlayer,259,264,523,50,9,JointPQPlayer
6214,JointPQPlayer,248,248,496,41,15,Tie
6215,JointPQPlayer,197,197,394,26,44,Tie
6216,JointPQPlayer,200,200,400,17,39,Tie
6217,JointPQPlayer,223,218,441,22,27,Player A
6218,JointPQPlayer,251,256,507,40,11,JointPQPlayer
6219,JointPQPlayer,240,235,475,35,20,Player A
6220,JointPQPlayer,256,261,517,50,11,JointPQPlayer
6221,JointPQPlayer,176,176,352,5,51,Tie
6222,JointPQPlayer,165,160,325,8,61,Player A
6223,JointPQPlayer,235,235,470,30,20,Tie
6224,JointPQPlayer,202,207,409,32,41,JointPQPlayer
6225,JointPQPlayer,267,262,529,53,8,Player A
6226,JointPQPlayer,192,197,389,15,42,JointPQPlayer
6227,JointPQPlayer,269,264,533,45,4,Player A
6228,JointPQPlayer,256,256,512,39,9,Tie
6229,JointPQPlayer,153,158,311,6,65,JointPQPlayer
6230,JointPQPlayer,253,248,501,46,15,Player A
6231,JointPQPlayer,221,221,442,26,28,Tie
6232,JointPQPlayer,256,256,512,48,12,Tie
6233,JointPQPlayer,253,253,506,42,12,Tie
6234,JointPQPlayer,237,242,479,33,18,JointPQPlayer
6235,JointPQPlayer,220,220,440,27,29,Tie
6236,JointPQPlayer,261,256,517,41,8,Player A
6237,JointPQPlayer,222,222,444,28,28,Tie
6238,JointPQPlayer,250,250,500,39,13,Tie
6239,JointPQPlayer,262,262,524,54,10,Tie
6240,JointPQPlayer,238,243,481,35,18,JointPQPlayer
6241,JointPQPlayer,202,197,399,10,37,Player A
6242,JointPQPlayer,220,220,440,30,30,Tie
6243,JointPQPlayer,259,259,518,48,10,Tie
6244,JointPQPlayer,223,223,446,27,27,Tie
6245,JointPQPlayer,261,266,527,57,10,JointPQPlayer
6246,JointPQPlayer,263,258,521,48,9,Player A
6247,JointPQPlayer,245,245,490,44,18,Tie
6248,JointPQPlayer,236,236,472,35,21,Tie
6249,JointPQPlayer,228,228,456,37,27,Tie
6250,JointPQPlayer,261,261,522,49,9,Tie
6251,JointPQPlayer,259,259,518,45,9,Tie
6252,JointPQPlayer,216,216,432,31,33,Tie
6253,JointPQPlayer,197,197,394,26,44,Tie
6254,JointPQPlayer,189,194,383,6,41,JointPQPlayer
6255,JointPQPlayer,257,257,514,47,11,Tie
6256,JointPQPlayer,180,175,355,5,50,Player A
6257,JointPQPlayer,255,260,515,48,11,JointPQPlayer
6258,JointPQPlayer,261,256,517,47,10,Player A
6259,JointPQPlayer,265,265,530,51,7,Tie
6260,JointPQPlayer,249,249,498,43,15,Tie
6261,JointPQPlayer,235,240,475,38,21,JointPQPlayer
6262,JointPQPlayer,259,254,513,46,11,Player A
6263,JointPQPlayer,255,260,515,45,10,JointPQPlayer
6264,JointPQPlayer,175,170,345,4,53,Player A
6265,JointPQPlayer,261,261,522,52,10,Tie
6266,JointPQPlayer,242,242,484,41,19,Tie
6267,JointPQPlayer,247,252,499,44,15,JointPQPlayer
6268,JointPQPlayer,254,249,503,45,14,Player A
6269,JointPQPlayer,271,271,542,63,7,Tie
6270,JointPQPlayer,271,271,542,54,4,Tie
6271,JointPQPlayer,266,266,532,59,9,Tie
6272,JointPQPlayer,260,260,520,47,9,Tie
6273,JointPQPlayer,245,245,490,41,17,Tie
6274,JointPQPlayer,252,252,504,40,12,Tie
6275,JointPQPlayer,186,191,377,18,47,JointPQPlayer
6276,JointPQPlayer,224,224,448,35,29,Tie
6277,JointPQPlayer,161,161,322,8,62,Tie
6278,JointPQPlayer,191,186,377,18,47,Player A
6279,JointPQPlayer,261,261,522,52,10,Tie
6280,JointPQPlayer,261,261,522,46,8,Tie
6281,JointPQPlayer,235,240,475,38,21,JointPQPlayer
6282,JointPQPlayer,267,262,529,53,8,Player A
6283,JointPQPlayer,267,267,534,52,6,Tie
6284,JointPQPlayer,274,274,548,63,5,Tie
6285,JointPQPlayer,213,213,426,34,36,Tie
6286,JointPQPlayer,267,267,534,49,5,Tie
6287,JointPQPlayer,248,253,501,34,11,JointPQPlayer
6288,JointPQPlayer,270,265,535,59,8,Player A
6289,JointPQPlayer,248,248,496,47,17,Tie
6290,JointPQPlayer,225,225,450,37,29,Tie
6291,JointPQPlayer,235,235,470,39,23,Tie
6292,JointPQPlayer,247,252,499,44,15,JointPQPlayer
6293,JointPQPlayer,272,267,539,60,7,Player A
6294,JointPQPlayer,223,228,451,32,27,JointPQPlayer
6295,JointPQPlayer,242,237,479,42,21,Player A
6296,JointPQPlayer,215,215,430,29,33,Tie
6297,JointPQPlayer,266,266,532,56,8,Tie
6298,JointPQPlayer,266,266,532,50,6,Tie
6299,JointPQPlayer,260,260,520,50,10,Tie
6300,JointPQPlayer,250,250,500,45,15,Tie
6301,JointPQPlayer,181,181,362,6,48,Tie
6302,JointPQPlayer,256,261,517,47,10,JointPQPlayer
6303,JointPQPlayer,251,246,497,42,15,Player A
6304,JointPQPlayer,165,165,330,7,59,Tie
6305,JointPQPlayer,261,261,522,55,11,Tie
6306,JointPQPlayer,253,258,511,47,12,JointPQPlayer
6307,JointPQPlayer,209,209,418,26,36,Tie
6308,JointPQPlayer,245,245,490,44,18,Tie
6309,JointPQPlayer,219,219,438,31,31,Tie
6310,JointPQPlayer,243,243,486,34,16,Tie
6311,JointPQPlayer,255,250,505,47,14,Player A
6312,JointPQPlayer,267,267,534,55,7,Tie
6313,JointPQPlayer,185,190,375,4,43,JointPQPlayer
6314,JointPQPlayer,178,173,351,7,52,Player A
6315,JointPQPlayer,243,243,486,43,19,Tie
6316,JointPQPlayer,262,262,524,48,8,Tie
6317,JointPQPlayer,262,262,524,54,10,Tie
6318,JointPQPlayer,258,258,516,43,9,Tie
6319,JointPQPlayer,191,191,382,17,45,Tie
6320,JointPQPlayer,246,246,492,34,14,Tie
6321,JointPQPlayer,272,272,544,56,4,Tie
6322,JointPQPlayer,261,266,527,48,7,JointPQPlayer
6323,JointPQPlayer,280,275,555,67,4,Player A
6324,JointPQPlayer,263,268,531,55,8,JointPQPlayer
6325,JointPQPlayer,246,241,487,38,17,Player A
6326,JointPQPlayer,260,260,520,50,10,Tie
6327,JointPQPlayer,185,190,375,13,46,JointPQPlayer
6328,JointPQPlayer,251,246,497,42,15,Player A
6329,JointPQPlayer,256,256,512,42,10,Tie
6330,JointPQPlayer,273,273,546,67,7,Tie
6331,JointPQPlayer,275,275,550,59,3,Tie
6332,JointPQPlayer,235,240,475,47,24,JointPQPlayer
6333,JointPQPlayer,260,260,520,47,9,Tie
6334,JointPQPlayer,263,258,521,48,9,Player A
6335,JointPQPlayer,247,247,494,45,17,Tie
6336,JointPQPlayer,253,258,511,44,11,JointPQPlayer
6337,JointPQPlayer,248,243,491,42,17,Player A
6338,JointPQPlayer,185,190,375,13,46,JointPQPlayer
6339,JointPQPlayer,266,261,527,48,7,Player A
6340,JointPQPlayer,212,212,424,29,35,Tie
6341,JointPQPlayer,254,254,508,47,13,Tie
6342,JointPQPlayer,254,259,513,49,12,JointPQPlayer
6343,JointPQPlayer,262,257,519,49,10,Player A
6344,JointPQPlayer,261,261,522,46,8,Tie
6345,JointPQPlayer,267,267,534,52,6,Tie
6346,JointPQPlayer,249,249,498,46,16,Tie
6347,JointPQPlayer,227,232,459,34,25,JointPQPlayer
6348,JointPQPlayer,265,260,525,52,9,Player A
6349,JointPQPlayer,185,190,375,19,48,JointPQPlayer
6350,JointPQPlayer,236,231,467,39,24,Player A
6351,JointPQPlayer,192,197,389,15,42,JointPQPlayer
6352,JointPQPlayer,270,265,535,50,5,Player A
6353,JointPQPlayer,169,174,343,8,55,JointPQPlayer
6354,JointPQPlayer,248,243,491,48,19,Player A
6355,JointPQPlayer,263,268,531,52,7,JointPQPlayer
6356,JointPQPlayer,221,221,442,35,31,Tie
6357,JointPQPlayer,250,245,495,46,17,Player A
6358,JointPQPlayer,186,191,377,12,45,JointPQPlayer
6359,JointPQPlayer,262,257,519,46,9,Player A
6360,JointPQPlayer,260,260,520,56,12,Tie
6361,JointPQPlayer,262,267,529,50,7,JointPQPlayer
6362,JointPQPlayer,261,261,522,46,8,Tie
6363,JointPQPlayer,276,271,547,59,4,Player A
6364,JointPQPlayer,174,174,348,10,54,Tie
6365,JointPQPlayer,267,267,534,55,7,Tie
6366,JointPQPlayer,261,261,522,52,10,Tie
6367,JointPQPlayer,190,190,380,21,47,Tie
6368,JointPQPlayer,255,260,515,45,10,JointPQPlayer
6369,JointPQPlayer,197,197,394,17,41,Tie
6370,JointPQPlayer,247,242,489,43,18,Player A
6371,JointPQPlayer,251,251,502,44,14,Tie
6372,JointPQPlayer,199,204,403,17,38,JointPQPlayer
6373,JointPQPlayer,240,240,480,37,19,Tie
6374,JointPQPlayer,231,226,457,41,28,Player A
6375,JointPQPlayer,265,265,530,54,8,Tie
6376,JointPQPlayer,258,258,516,40,8,Tie
6377,JointPQPlayer,210,210,420,28,36,Tie
6378,JointPQPlayer,241,241,482,39,19,Tie
6379,JointPQPlayer,260,260,520,59,13,Tie
6380,JointPQPlayer,243,243,486,40,18,Tie
6381,JointPQPlayer,237,242,479,36,19,JointPQPlayer
6382,JointPQPlayer,253,248,501,49,16,Player A
6383,JointPQPlayer,224,224,448,41,31,Tie
6384,JointPQPlayer,257,257,514,47,11,Tie
6385,JointPQPlayer,189,194,383,6,41,JointPQPlayer
6386,JointPQPlayer,186,181,367,14,49,Player A
6387,JointPQPlayer,208,208,416,30,38,Tie
6388,JointPQPlayer,266,266,532,56,8,Tie
6389,JointPQPlayer,169,174,343,5,54,JointPQPlayer
6390,JointPQPlayer,205,200,405,16,37,Player A
6391,JointPQPlayer,164,169,333,4,57,JointPQPlayer
6392,JointPQPlayer,250,245,495,52,19,Player A
6393,JointPQPlayer,252,252,504,46,14,Tie
6394,JointPQPlayer,244,244,488,39,17,Tie
6395,JointPQPlayer,174,179,353,6,51,JointPQPlayer
6396,JointPQPlayer,276,271,547,56,3,Player A
6397,JointPQPlayer,274,279,553,65,4,JointPQPlayer
6398,JointPQPlayer,265,260,525,55,10,Player A
6399,JointPQPlayer,257,257,514,47,11,Tie
6400,JointPQPlayer,238,243,481,41,20,JointPQPlayer
6401,JointPQPlayer,211,206,417,22,35,Player A
6402,JointPQPlayer,233,238,471,37,22,JointPQPlayer
6403,JointPQPlayer,263,263,526,47,7,Tie
6404,JointPQPlayer,271,266,537,58,7,Player A
6405,JointPQPlayer,253,253,506,48,14,Tie
6406,JointPQPlayer,271,271,542,57,5,Tie
6407,JointPQPlayer,270,275,545,57,4,JointPQPlayer
6408,JointPQPlayer,206,206,412,29,39,Tie
6409,JointPQPlayer,238,233,471,34,21,Player A
6410,JointPQPlayer,245,245,490,47,19,Tie
6411,JointPQPlayer,260,260,520,44,8,Tie
6412,JointPQPlayer,259,259,518,51,11,Tie
6413,JointPQPlayer,258,263,521,45,8,JointPQPlayer
6414,JointPQPlayer,237,232,469,32,21,Player A
6415,JointPQPlayer,255,260,515,45,10,JointPQPlayer
6416,JointPQPlayer,201,201,402,13,37,Tie
6417,JointPQPlayer,181,176,357,7,50,Player A
6418,JointPQPlayer,258,258,516,43,9,Tie
6419,JointPQPlayer,205,205,410,21,37,Tie
6420,JointPQPlayer,259,259,518,39,7,Tie
6421,JointPQPlayer,170,170,340,8,56,Tie
6422,JointPQPlayer,173,173,346,5,53,Tie
6423,JointPQPlayer,270,270,540,55,5,Tie
6424,JointPQPlayer,272,272,544,53,3,Tie
6425,JointPQPlayer,220,220,440,24,28,Tie
6426,JointPQPlayer,268,268,536,57,7,Tie
6427,JointPQPlayer,265,265,530,54,8,Tie
6428,JointPQPlayer,261,261,522,46,8,Tie
6429,JointPQPlayer,261,261,522,49,9,Tie
6430,JointPQPlayer,249,249,498,52,18,Tie
6431,JointPQPlayer,258,263,521,48,9,JointPQPlayer
6432,JointPQPlayer,188,188,376,14,46,Tie
6433,JointPQPlayer,244,239,483,34,17,Player A
6434,JointPQPlayer,260,265,525,49,8,JointPQPlayer
6435,JointPQPlayer,174,174,348,4,52,Tie
6436,JointPQPlayer,253,248,501,40,13,Player A
6437,JointPQPlayer,207,212,419,30,37,JointPQPlayer
6438,JointPQPlayer,248,248,496,47,17,Tie
6439,JointPQPlayer,182,177,359,12,51,Player A
6440,JointPQPlayer,240,245,485,45,20,JointPQPlayer
6441,JointPQPlayer,252,247,499,41,14,Player A
6442,JointPQPlayer,271,271,542,51,3,Tie
6443,JointPQPlayer,265,265,530,48,6,Tie
6444,JointPQPlayer,247,247,494,42,16,Tie
6445,JointPQPlayer,264,269,533,57,8,JointPQPlayer
6446,JointPQPlayer,248,243,491,51,20,Player A
6447,JointPQPlayer,252,252,504,40,12,Tie
6448,JointPQPlayer,258,258,516,43,9,Tie
6449,JointPQPlayer,273,273,546,58,4,Tie
6450,JointPQPlayer,261,266,527,54,9,JointPQPlayer
6451,JointPQPlayer,259,254,513,43,10,Player A
6452,JointPQPlayer,255,255,510,49,13,Tie
6453,JointPQPlayer,199,204,403,26,41,JointPQPlayer
6454,JointPQPlayer,159,159,318,4,62,Tie
6455,JointPQPlayer,241,236,477,37,20,Player A
6456,JointPQPlayer,170,175,345,7,54,JointPQPlayer
6457,JointPQPlayer,242,242,484,44,20,Tie
6458,JointPQPlayer,268,268,536,57,7,Tie
6459,JointPQPlayer,235,230,465,31,22,Player A
6460,JointPQPlayer,267,267,534,49,5,Tie
6461,JointPQPlayer,264,264,528,49,7,Tie
6462,JointPQPlayer,245,245,490,47,19,Tie
6463,JointPQPlayer,238,238,476,39,21,Tie
6464,JointPQPlayer,179,184,363,16,51,JointPQPlayer
6465,JointPQPlayer,264,264,528,55,9,Tie
6466,JointPQPlayer,208,208,416,18,34,Tie
6467,JointPQPlayer,186,186,372,10,46,Tie
6468,JointPQPlayer,250,245,495,43,16,Player A
6469,JointPQPlayer,259,264,523,47,8,JointPQPlayer
6470,JointPQPlayer,228,223,451,29,26,Player A
6471,JointPQPlayer,264,264,528,52,8,Tie
6472,JointPQPlayer,207,207,414,28,38,Tie
6473,JointPQPlayer,252,252,504,49,15,Tie
6474,JointPQPlayer,268,268,536,54,6,Tie
6475,JointPQPlayer,265,270,535,56,7,JointPQPlayer
6476,JointPQPlayer,200,200,400,23,41,Tie
6477,JointPQPlayer,251,246,497,51,18,Player A
6478,JointPQPlayer,267,272,539,48,3,JointPQPlayer
6479,JointPQPlayer,260,255,515,45,10,Player A
6480,JointPQPlayer,260,265,525,52,9,JointPQPlayer
6481,JointPQPlayer,242,237,479,36,19,Player A
6482,JointPQPlayer,245,250,495,46,17,JointPQPlayer
6483,JointPQPlayer,185,185,370,17,49,Tie
6484,JointPQPlayer,266,261,527,45,6,Player A
6485,JointPQPlayer,219,224,443,33,30,JointPQPlayer
6486,JointPQPlayer,246,241,487,38,17,Player A
6487,JointPQPlayer,246,251,497,45,16,JointPQPlayer
6488,JointPQPlayer,158,153,311,0,63,Player A
6489,JointPQPlayer,258,263,521,48,9,JointPQPlayer
6490,JointPQPlayer,223,223,446,33,29,Tie
6491,JointPQPlayer,265,265,530,54,8,Tie
6492,JointPQPlayer,203,203,406,20,38,Tie
6493,JointPQPlayer,245,240,485,42,19,Player A
6494,JointPQPlayer,261,261,522,43,7,Tie
6495,JointPQPlayer,263,263,526,50,8,Tie
6496,JointPQPlayer,193,193,386,12,42,Tie
6497,JointPQPlayer,252,252,504,43,13,Tie
6498,JointPQPlayer,202,202,404,24,40,Tie
6499,JointPQPlayer,230,230,460,35,25,Tie
6500,JointPQPlayer,250,250,500,45,15,Tie
6501,JointPQPlayer,275,275,550,56,2,Tie
6502,JointPQPlayer,188,193,381,19,46,JointPQPlayer
6503,JointPQPlayer,205,205,410,21,37,Tie
6504,JointPQPlayer,262,257,519,52,11,Player A
6505,JointPQPlayer,250,250,500,39,13,Tie
6506,JointPQPlayer,183,183,366,10,48,Tie
6507,JointPQPlayer,261,261,522,52,10,Tie
6508,JointPQPlayer,267,267,534,49,5,Tie
6509,JointPQPlayer,240,240,480,46,22,Tie
6510,JointPQPlayer,264,269,533,57,8,JointPQPlayer
6511,JointPQPlayer,186,186,372,10,46,Tie
6512,JointPQPlayer,261,256,517,41,8,Player A
6513,JointPQPlayer,226,231,457,47,30,JointPQPlayer
6514,JointPQPlayer,228,228,456,28,24,Tie
6515,JointPQPlayer,260,255,515,48,11,Player A
6516,JointPQPlayer,249,249,498,40,14,Tie
6517,JointPQPlayer,186,191,377,9,44,JointPQPlayer
6518,JointPQPlayer,247,247,494,48,18,Tie
6519,JointPQPlayer,185,185,370,11,47,Tie
6520,JointPQPlayer,246,246,492,37,15,Tie
6521,JointPQPlayer,162,162,324,4,60,Tie
6522,JointPQPlayer,207,202,409,20,37,Player A
6523,JointPQPlayer,242,247,489,49,20,JointPQPlayer
6524,JointPQPlayer,184,184,368,9,47,Tie
6525,JointPQPlayer,260,255,515,48,11,Player A
6526,JointPQPlayer,246,251,497,45,16,JointPQPlayer
6527,JointPQPlayer,213,208,421,29,36,Player A
6528,JointPQPlayer,259,259,518,42,8,Tie
6529,JointPQPlayer,156,156,312,4,64,Tie
6530,JointPQPlayer,181,186,367,14,49,JointPQPlayer
6531,JointPQPlayer,248,243,491,45,18,Player A
6532,JointPQPlayer,259,259,518,45,9,Tie
6533,JointPQPlayer,258,263,521,45,8,JointPQPlayer
6534,JointPQPlayer,268,263,531,55,8,Player A
6535,JointPQPlayer,261,261,522,52,10,Tie
6536,JointPQPlayer,247,247,494,39,15,Tie
6537,JointPQPlayer,258,258,516,46,10,Tie
6538,JointPQPlayer,248,248,496,50,18,Tie
6539,JointPQPlayer,273,273,546,64,6,Tie
6540,JointPQPlayer,261,266,527,48,7,JointPQPlayer
6541,JointPQPlayer,245,245,490,41,17,Tie
6542,JointPQPlayer,268,263,531,55,8,Player A
6543,JointPQPlayer,252,257,509,48,13,JointPQPlayer
6544,JointPQPlayer,256,251,507,37,10,Player A
6545,JointPQPlayer,274,279,553,59,2,JointPQPlayer
6546,JointPQPlayer,260,260,520,44,8,Tie
6547,JointPQPlayer,202,197,399,28,43,Player A
6548,JointPQPlayer,263,268,531,52,7,JointPQPlayer
6549,JointPQPlayer,238,233,471,34,21,Player A
6550,JointPQPlayer,261,266,527,60,11,JointPQPlayer
6551,JointPQPlayer,249,244,493,35,14,Player A
6552,JointPQPlayer,259,259,518,51,11,Tie
6553,JointPQPlayer,233,233,466,44,26,Tie
6554,JointPQPlayer,167,167,334,5,57,Tie
6555,JointPQPlayer,264,264,528,58,10,Tie
6556,JointPQPlayer,242,247,489,43,18,JointPQPlayer
6557,JointPQPlayer,254,249,503,51,16,Player A
6558,JointPQPlayer,256,261,517,44,9,JointPQPlayer
6559,JointPQPlayer,274,269,543,55,4,Player A
6560,JointPQPlayer,256,261,517,44,9,JointPQPlayer
6561,JointPQPlayer,271,266,537,52,5,Player A
6562,JointPQPlayer,262,262,524,51,9,Tie
6563,JointPQPlayer,166,171,337,5,56,JointPQPlayer
6564,JointPQPlayer,250,245,495,49,18,Player A
6565,JointPQPlayer,171,171,342,7,55,Tie
6566,JointPQPlayer,264,264,528,52,8,Tie
6567,JointPQPlayer,230,230,460,29,23,Tie
6568,JointPQPlayer,262,262,524,48,8,Tie
6569,JointPQPlayer,209,214,423,25,34,JointPQPlayer
6570,JointPQPlayer,215,210,425,27,34,Player A
6571,JointPQPlayer,170,175,345,13,56,JointPQPlayer
6572,JointPQPlayer,245,240,485,33,16,Player A
6573,JointPQPlayer,240,240,480,46,22,Tie
6574,JointPQPlayer,240,240,480,40,20,Tie
6575,JointPQPlayer,252,257,509,42,11,JointPQPlayer
6576,JointPQPlayer,256,251,507,40,11,Player A
6577,JointPQPlayer,258,263,521,48,9,JointPQPlayer
6578,JointPQPlayer,264,259,523,47,8,Player A
6579,JointPQPlayer,165,165,330,10,60,Tie
6580,JointPQPlayer,274,274,548,60,4,Tie
6581,JointPQPlayer,162,167,329,12,61,JointPQPlayer
6582,JointPQPlayer,181,181,362,9,49,Tie
6583,JointPQPlayer,255,255,510,40,10,Tie
6584,JointPQPlayer,256,256,512,54,14,Tie
6585,JointPQPlayer,254,254,508,47,13,Tie
6586,JointPQPlayer,222,217,439,32,31,Player A
6587,JointPQPlayer,240,240,480,43,21,Tie
6588,JointPQPlayer,241,241,482,39,19,Tie
6589,JointPQPlayer,250,250,500,45,15,Tie
6590,JointPQPlayer,217,217,434,33,33,Tie
6591,JointPQPlayer,260,265,525,49,8,JointPQPlayer
6592,JointPQPlayer,264,259,523,50,9,Player A
6593,JointPQPlayer,259,259,518,48,10,Tie
6594,JointPQPlayer,186,191,377,15,46,JointPQPlayer
6595,JointPQPlayer,164,164,328,5,59,Tie
6596,JointPQPlayer,184,184,368,9,47,Tie
6597,JointPQPlayer,258,253,511,44,11,Player A
6598,JointPQPlayer,247,247,494,36,14,Tie
6599,JointPQPlayer,176,176,352,11,53,Tie
6600,JointPQPlayer,254,259,513,43,10,JointPQPlayer
6601,JointPQPlayer,244,239,483,37,18,Player A
6602,JointPQPlayer,230,230,460,38,26,Tie
6603,JointPQPlayer,253,258,511,47,12,JointPQPlayer
6604,JointPQPlayer,247,242,489,37,16,Player A
6605,JointPQPlayer,254,254,508,47,13,Tie
6606,JointPQPlayer,241,246,487,38,17,JointPQPlayer
6607,JointPQPlayer,239,234,473,39,22,Player A
6608,JointPQPlayer,271,271,542,51,3,Tie
6609,JointPQPlayer,256,256,512,45,11,Tie
6610,JointPQPlayer,246,246,492,46,18,Tie
6611,JointPQPlayer,268,268,536,60,8,Tie
6612,JointPQPlayer,249,254,503,45,14,JointPQPlayer
6613,JointPQPlayer,236,231,467,45,26,Player A
6614,JointPQPlayer,230,235,465,34,23,JointPQPlayer
6615,JointPQPlayer,271,266,537,58,7,Player A
6616,JointPQPlayer,240,245,485,45,20,JointPQPlayer
6617,JointPQPlayer,251,251,502,38,12,Tie
6618,JointPQPlayer,267,262,529,50,7,Player A
6619,JointPQPlayer,166,171,337,17,60,JointPQPlayer
6620,JointPQPlayer,199,199,398,9,37,Tie
6621,JointPQPlayer,235,235,470,30,20,Tie
6622,JointPQPlayer,264,259,523,41,6,Player A
6623,JointPQPlayer,263,263,526,50,8,Tie
6624,JointPQPlayer,257,262,519,43,8,JointPQPlayer
6625,JointPQPlayer,276,271,547,68,7,Player A
6626,JointPQPlayer,186,191,377,15,46,JointPQPlayer
6627,JointPQPlayer,268,263,531,52,7,Player A
6628,JointPQPlayer,177,177,354,7,51,Tie
6629,JointPQPlayer,251,251,502,47,15,Tie
6630,JointPQPlayer,272,272,544,59,5,Tie
6631,JointPQPlayer,267,267,534,52,6,Tie
6632,JointPQPlayer,227,227,454,29,25,Tie
6633,JointPQPlayer,232,237,469,38,23,JointPQPlayer
6634,JointPQPlayer,236,231,467,33,22,Player A
6635,JointPQPlayer,256,261,517,47,10,JointPQPlayer
6636,JointPQPlayer,196,191,387,16,43,Player A
6637,JointPQPlayer,180,185,365,15,50,JointPQPlayer
6638,JointPQPlayer,246,241,487,38,17,Player A
6639,JointPQPlayer,267,267,534,52,6,Tie
6640,JointPQPlayer,168,168,336,10,58,Tie
6641,JointPQPlayer,232,237,469,35,22,JointPQPlayer
6642,JointPQPlayer,265,260,525,58,11,Player A
6643,JointPQPlayer,250,250,500,42,14,Tie
6644,JointPQPlayer,222,222,444,34,30,Tie
6645,JointPQPlayer,167,172,339,4,55,JointPQPlayer
6646,JointPQPlayer,150,150,300,4,68,Tie
6647,JointPQPlayer,258,253,511,44,11,Player A
6648,JointPQPlayer,263,263,526,47,7,Tie
6649,JointPQPlayer,182,182,364,11,49,Tie
6650,JointPQPlayer,251,256,507,49,14,JointPQPlayer
6651,JointPQPlayer,247,242,489,37,16,Player A
6652,JointPQPlayer,243,248,491,42,17,JointPQPlayer
6653,JointPQPlayer,215,210,425,30,35,Player A
6654,JointPQPlayer,255,255,510,46,12,Tie
6655,JointPQPlayer,263,268,531,49,6,JointPQPlayer
6656,JointPQPlayer,245,245,490,29,13,Tie
6657,JointPQPlayer,261,256,517,56,13,Player A
6658,JointPQPlayer,269,269,538,56,6,Tie
6659,JointPQPlayer,239,244,483,37,18,JointPQPlayer
6660,JointPQPlayer,265,260,525,52,9,Player A
6661,JointPQPlayer,178,183,361,14,51,JointPQPlayer
6662,JointPQPlayer,257,252,509,39,10,Player A
6663,JointPQPlayer,245,250,495,46,17,JointPQPlayer
6664,JointPQPlayer,273,268,541,56,5,Player A
6665,JointPQPlayer,185,190,375,4,43,JointPQPlayer
6666,JointPQPlayer,237,237,474,37,21,Tie
6667,JointPQPlayer,246,241,487,38,17,Player A
6668,JointPQPlayer,256,256,512,42,10,Tie
6669,JointPQPlayer,263,263,526,47,7,Tie
6670,JointPQPlayer,168,168,336,7,57,Tie
6671,JointPQPlayer,224,224,448,26,26,Tie
6672,JointPQPlayer,253,253,506,45,13,Tie
6673,JointPQPlayer,162,162,324,7,61,Tie
6674,JointPQPlayer,220,225,445,32,29,JointPQPlayer
6675,JointPQPlayer,205,200,405,16,37,Player A
6676,JointPQPlayer,248,253,501,43,14,JointPQPlayer
6677,JointPQPlayer,253,248,501,49,16,Player A
6678,JointPQPlayer,256,261,517,56,13,JointPQPlayer
6679,JointPQPlayer,263,258,521,54,11,Player A
6680,JointPQPlayer,274,274,548,60,4,Tie
6681,JointPQPlayer,267,267,534,52,6,Tie
6682,JointPQPlayer,242,242,484,38,18,Tie
6683,JointPQPlayer,253,253,506,48,14,Tie
6684,JointPQPlayer,251,256,507,46,13,JointPQPlayer
6685,JointPQPlayer,249,244,493,41,16,Player A
6686,JointPQPlayer,262,262,524,54,10,Tie
6687,JointPQPlayer,252,257,509,48,13,JointPQPlayer
6688,JointPQPlayer,189,189,378,10,44,Tie
6689,JointPQPlayer,255,250,505,47,14,Player A
6690,JointPQPlayer,255,255,510,43,11,Tie
6691,JointPQPlayer,263,263,526,53,9,Tie
6692,JointPQPlayer,166,166,332,6,58,Tie
6693,JointPQPlayer,272,272,544,59,5,Tie
6694,JointPQPlayer,223,223,446,30,28,Tie
6695,JointPQPlayer,192,192,384,13,43,Tie
6696,JointPQPlayer,265,265,530,45,5,Tie
6697,JointPQPlayer,254,254,508,44,12,Tie
6698,JointPQPlayer,173,178,351,7,52,JointPQPlayer
6699,JointPQPlayer,252,247,499,53,18,Player A
6700,JointPQPlayer,213,213,426,34,36,Tie
6701,JointPQPlayer,258,263,521,57,12,JointPQPlayer
6702,JointPQPlayer,255,250,505,41,12,Player A
6703,JointPQPlayer,260,260,520,59,13,Tie
6704,JointPQPlayer,272,272,544,56,4,Tie
6705,JointPQPlayer,276,276,552,61,3,Tie
6706,JointPQPlayer,258,258,516,43,9,Tie
6707,JointPQPlayer,253,253,506,45,13,Tie
6708,JointPQPlayer,271,276,547,62,5,JointPQPlayer
6709,JointPQPlayer,234,229,463,32,23,Player A
6710,JointPQPlayer,255,260,515,48,11,JointPQPlayer
6711,JointPQPlayer,247,247,494,39,15,Tie
6712,JointPQPlayer,261,261,522,49,9,Tie
6713,JointPQPlayer,179,174,353,6,51,Player A
6714,JointPQPlayer,243,243,486,43,19,Tie
6715,JointPQPlayer,263,268,531,52,7,JointPQPlayer
6716,JointPQPlayer,249,244,493,44,17,Player A
6717,JointPQPlayer,230,230,460,38,26,Tie
6718,JointPQPlayer,192,192,384,19,45,Tie
6719,JointPQPlayer,278,278,556,68,4,Tie
6720,JointPQPlayer,181,186,367,11,48,JointPQPlayer
6721,JointPQPlayer,240,240,480,31,17,Tie
6722,JointPQPlayer,262,262,524,51,9,Tie
6723,JointPQPlayer,260,255,515,54,13,Player A
6724,JointPQPlayer,253,253,506,45,13,Tie
6725,JointPQPlayer,170,170,340,8,56,Tie
6726,JointPQPlayer,172,177,349,14,55,JointPQPlayer
6727,JointPQPlayer,273,268,541,50,3,Player A
6728,JointPQPlayer,270,275,545,54,3,JointPQPlayer
6729,JointPQPlayer,257,257,514,41,9,Tie
6730,JointPQPlayer,189,184,373,17,48,Player A
6731,JointPQPlayer,179,184,363,13,50,JointPQPlayer
6732,JointPQPlayer,265,265,530,51,7,Tie
6733,JointPQPlayer,234,229,463,32,23,Player A
6734,JointPQPlayer,246,246,492,49,19,Tie
6735,JointPQPlayer,251,251,502,41,13,Tie
6736,JointPQPlayer,262,262,524,48,8,Tie
6737,JointPQPlayer,247,252,499,44,15,JointPQPlayer
6738,JointPQPlayer,255,250,505,47,14,Player A
6739,JointPQPlayer,185,190,375,10,45,JointPQPlayer
6740,JointPQPlayer,259,254,513,49,12,Player A
6741,JointPQPlayer,259,264,523,44,7,JointPQPlayer
6742,JointPQPlayer,274,269,543,52,3,Player A
6743,JointPQPlayer,257,257,514,50,12,Tie
6744,JointPQPlayer,252,252,504,43,13,Tie
6745,JointPQPlayer,270,270,540,55,5,Tie
6746,JointPQPlayer,269,269,538,59,7,Tie
6747,JointPQPlayer,253,253,506,48,14,Tie
6748,JointPQPlayer,195,195,390,13,41,Tie
6749,JointPQPlayer,180,185,365,6,47,JointPQPlayer
6750,JointPQPlayer,228,228,456,37,27,Tie
6751,JointPQPlayer,198,193,391,20,43,Player A
6752,JointPQPlayer,249,249,498,40,14,Tie
6753,JointPQPlayer,234,234,468,37,23,Tie
6754,JointPQPlayer,211,216,427,29,34,JointPQPlayer
6755,JointPQPlayer,266,261,527,63,12,Player A
6756,JointPQPlayer,255,260,515,48,11,JointPQPlayer
6757,JointPQPlayer,269,264,533,57,8,Player A
6758,JointPQPlayer,231,231,462,31,23,Tie
6759,JointPQPlayer,264,264,528,46,6,Tie
6760,JointPQPlayer,260,260,520,56,12,Tie
6761,JointPQPlayer,256,256,512,45,11,Tie
6762,JointPQPlayer,263,263,526,56,10,Tie
6763,JointPQPlayer,209,214,423,28,35,JointPQPlayer
6764,JointPQPlayer,221,216,437,30,31,Player A
6765,JointPQPlayer,267,267,534,52,6,Tie
6766,JointPQPlayer,215,220,435,22,29,JointPQPlayer
6767,JointPQPlayer,219,219,438,28,30,Tie
6768,JointPQPlayer,265,260,525,58,11,Player A
6769,JointPQPlayer,277,282,559,71,4,JointPQPlayer
6770,JointPQPlayer,269,264,533,54,7,Player A
6771,JointPQPlayer,220,225,445,32,29,JointPQPlayer
6772,JointPQPlayer,249,244,493,38,15,Player A
6773,JointPQPlayer,232,232,464,30,22,Tie
6774,JointPQPlayer,250,250,500,45,15,Tie
6775,JointPQPlayer,256,256,512,42,10,Tie
6776,JointPQPlayer,268,268,536,51,5,Tie
6777,JointPQPlayer,245,245,490,44,18,Tie
6778,JointPQPlayer,255,260,515,57,14,JointPQPlayer
6779,JointPQPlayer,260,255,515,48,11,Player A
6780,JointPQPlayer,267,267,534,55,7,Tie
6781,JointPQPlayer,262,267,529,53,8,JointPQPlayer
6782,JointPQPlayer,242,237,479,36,19,Player A
6783,JointPQPlayer,269,269,538,56,6,Tie
6784,JointPQPlayer,225,225,450,34,28,Tie
6785,JointPQPlayer,251,251,502,47,15,Tie
6786,JointPQPlayer,269,274,543,61,6,JointPQPlayer
6787,JointPQPlayer,255,250,505,44,13,Player A
6788,JointPQPlayer,242,242,484,41,19,Tie
6789,JointPQPlayer,180,180,360,7,49,Tie
6790,JointPQPlayer,267,267,534,52,6,Tie
6791,JointPQPlayer,254,254,508,38,10,Tie
6792,JointPQPlayer,264,264,528,49,7,Tie
6793,JointPQPlayer,204,204,408,19,37,Tie
6794,JointPQPlayer,215,220,435,25,30,JointPQPlayer
6795,JointPQPlayer,257,252,509,48,13,Player A
6796,JointPQPlayer,258,258,516,49,11,Tie
6797,JointPQPlayer,263,263,526,41,5,Tie
6798,JointPQPlayer,165,165,330,4,58,Tie
6799,JointPQPlayer,263,263,526,53,9,Tie
6800,JointPQPlayer,228,228,456,31,25,Tie
6801,JointPQPlayer,178,183,361,8,49,JointPQPlayer
6802,JointPQPlayer,226,226,452,30,26,Tie
6803,JointPQPlayer,160,160,320,6,62,Tie
6804,JointPQPlayer,265,260,525,49,8,Player A
6805,JointPQPlayer,169,169,338,9,57,Tie
6806,JointPQPlayer,238,238,476,42,22,Tie
6807,JointPQPlayer,255,260,515,45,10,JointPQPlayer
6808,JointPQPlayer,259,259,518,48,10,Tie
6809,JointPQPlayer,251,246,497,36,13,Player A
6810,JointPQPlayer,251,251,502,47,15,Tie
6811,JointPQPlayer,242,247,489,40,17,JointPQPlayer
6812,JointPQPlayer,264,264,528,49,7,Tie
6813,JointPQPlayer,246,241,487,53,22,Player A
6814,JointPQPlayer,218,218,436,23,29,Tie
6815,JointPQPlayer,267,267,534,52,6,Tie
6816,JointPQPlayer,221,221,442,26,28,Tie
6817,JointPQPlayer,193,198,391,14,41,JointPQPlayer
6818,JointPQPlayer,271,266,537,58,7,Player A
6819,JointPQPlayer,175,180,355,5,50,JointPQPlayer
6820,JointPQPlayer,258,253,511,47,12,Player A
6821,JointPQPlayer,258,258,516,37,7,Tie
6822,JointPQPlayer,266,266,532,53,7,Tie
6823,JointPQPlayer,255,255,510,49,13,Tie
6824,JointPQPlayer,263,263,526,53,9,Tie
6825,JointPQPlayer,238,238,476,42,22,Tie
6826,JointPQPlayer,254,259,513,46,11,JointPQPlayer
6827,JointPQPlayer,266,261,527,48,7,Player A
6828,JointPQPlayer,270,270,540,55,5,Tie
6829,JointPQPlayer,194,199,393,13,40,JointPQPlayer
6830,JointPQPlayer,256,256,512,42,10,Tie
6831,JointPQPlayer,246,241,487,47,20,Player A
6832,JointPQPlayer,274,279,553,62,3,JointPQPlayer
6833,JointPQPlayer,258,258,516,49,11,Tie
6834,JointPQPlayer,274,269,543,58,5,Player A
6835,JointPQPlayer,182,187,369,4,45,JointPQPlayer
6836,JointPQPlayer,252,252,504,43,13,Tie
6837,JointPQPlayer,254,249,503,39,12,Player A
6838,JointPQPlayer,254,259,513,49,12,JointPQPlayer
6839,JointPQPlayer,249,244,493,44,17,Player A
6840,JointPQPlayer,253,253,506,48,14,Tie
6841,JointPQPlayer,244,244,488,36,16,Tie
6842,JointPQPlayer,210,210,420,31,37,Tie
6843,JointPQPlayer,237,242,479,33,18,JointPQPlayer
6844,JointPQPlayer,261,256,517,47,10,Player A
6845,JointPQPlayer,241,246,487,44,19,JointPQPlayer
6846,JointPQPlayer,269,269,538,56,6,Tie
6847,JointPQPlayer,258,258,516,49,11,Tie
6848,JointPQPlayer,275,270,545,66,7,Player A
6849,JointPQPlayer,257,257,514,47,11,Tie
6850,JointPQPlayer,226,226,452,33,27,Tie
6851,JointPQPlayer,215,220,435,31,32,JointPQPlayer
6852,JointPQPlayer,257,257,514,41,9,Tie
6853,JointPQPlayer,249,244,493,41,16,Player A
6854,JointPQPlayer,257,257,514,50,12,Tie
6855,JointPQPlayer,278,278,556,65,3,Tie
6856,JointPQPlayer,262,262,524,48,8,Tie
6857,JointPQPlayer,281,281,562,71,3,Tie
6858,JointPQPlayer,262,262,524,45,7,Tie
6859,JointPQPlayer,250,250,500,45,15,Tie
6860,JointPQPlayer,175,180,355,5,50,JointPQPlayer
6861,JointPQPlayer,190,185,375,4,43,Player A
6862,JointPQPlayer,174,179,353,9,52,JointPQPlayer
6863,JointPQPlayer,261,256,517,53,12,Player A
6864,JointPQPlayer,262,262,524,51,9,Tie
6865,JointPQPlayer,259,264,523,47,8,JointPQPlayer
6866,JointPQPlayer,251,246,497,48,17,Player A
6867,JointPQPlayer,264,264,528,49,7,Tie
6868,JointPQPlayer,268,268,536,48,4,Tie
6869,JointPQPlayer,237,237,474,31,19,Tie
6870,JointPQPlayer,232,237,469,38,23,JointPQPlayer
6871,JointPQPlayer,244,239,483,43,20,Player A
6872,JointPQPlayer,234,239,473,42,23,JointPQPlayer
6873,JointPQPlayer,248,243,491,42,17,Player A
6874,JointPQPlayer,275,275,550,59,3,Tie
6875,JointPQPlayer,221,226,447,34,29,JointPQPlayer
6876,JointPQPlayer,256,256,512,51,13,Tie
6877,JointPQPlayer,247,242,489,40,17,Player A
6878,JointPQPlayer,194,199,393,19,42,JointPQPlayer
6879,JointPQPlayer,238,238,476,42,22,Tie
6880,JointPQPlayer,259,259,518,48,10,Tie
6881,JointPQPlayer,261,261,522,46,8,Tie
6882,JointPQPlayer,263,258,521,48,9,Player A
6883,JointPQPlayer,255,255,510,46,12,Tie
6884,JointPQPlayer,219,224,443,27,28,JointPQPlayer
6885,JointPQPlayer,257,252,509,42,11,Player A
6886,JointPQPlayer,204,204,408,25,39,Tie
6887,JointPQPlayer,180,185,365,6,47,JointPQPlayer
6888,JointPQPlayer,195,195,390,19,43,Tie
6889,JointPQPlayer,259,259,518,54,12,Tie
6890,JointPQPlayer,179,174,353,9,52,Player A
6891,JointPQPlayer,261,266,527,51,8,JointPQPlayer
6892,JointPQPlayer,259,254,513,52,13,Player A
6893,JointPQPlayer,164,169,333,7,58,JointPQPlayer
6894,JointPQPlayer,254,249,503,42,13,Player A
6895,JointPQPlayer,238,238,476,42,22,Tie
6896,JointPQPlayer,167,172,339,7,56,JointPQPlayer
6897,JointPQPlayer,264,259,523,41,6,Player A
6898,JointPQPlayer,252,252,504,43,13,Tie
6899,JointPQPlayer,267,267,534,55,7,Tie
6900,JointPQPlayer,253,253,506,45,13,Tie
6901,JointPQPlayer,213,218,431,24,31,JointPQPlayer
6902,JointPQPlayer,271,266,537,52,5,Player A
6903,JointPQPlayer,244,244,488,39,17,Tie
6904,JointPQPlayer,257,257,514,47,11,Tie
6905,JointPQPlayer,218,218,436,32,32,Tie
6906,JointPQPlayer,223,223,446,27,27,Tie
6907,JointPQPlayer,179,184,363,16,51,JointPQPlayer
6908,JointPQPlayer,262,257,519,49,10,Player A
6909,JointPQPlayer,160,165,325,5,60,JointPQPlayer
6910,JointPQPlayer,197,197,394,20,42,Tie
6911,JointPQPlayer,170,165,335,3,56,Player A
6912,JointPQPlayer,261,261,522,46,8,Tie
6913,JointPQPlayer,262,262,524,45,7,Tie
6914,JointPQPlayer,222,227,449,30,27,JointPQPlayer
6915,JointPQPlayer,229,229,458,42,28,Tie
6916,JointPQPlayer,264,264,528,52,8,Tie
6917,JointPQPlayer,272,267,539,54,5,Player A
6918,JointPQPlayer,237,237,474,43,23,Tie
6919,JointPQPlayer,237,237,474,40,22,Tie
6920,JointPQPlayer,189,189,378,16,46,Tie
6921,JointPQPlayer,236,241,477,37,20,JointPQPlayer
6922,JointPQPlayer,204,199,403,23,40,Player A
6923,JointPQPlayer,269,269,538,56,6,Tie
6924,JointPQPlayer,250,250,500,54,18,Tie
6925,JointPQPlayer,256,256,512,48,12,Tie
6926,JointPQPlayer,175,180,355,8,51,JointPQPlayer
6927,JointPQPlayer,266,261,527,51,8,Player A
6928,JointPQPlayer,254,254,508,56,16,Tie
6929,JointPQPlayer,241,246,487,41,18,JointPQPlayer
6930,JointPQPlayer,242,237,479,54,25,Player A
6931,JointPQPlayer,195,200,395,18,41,JointPQPlayer
6932,JointPQPlayer,242,242,484,32,16,Tie
6933,JointPQPlayer,166,161,327,4,59,Player A
6934,JointPQPlayer,230,235,465,40,25,JointPQPlayer
6935,JointPQPlayer,184,184,368,6,46,Tie
6936,JointPQPlayer,246,246,492,46,18,Tie
6937,JointPQPlayer,254,254,508,50,14,Tie
6938,JointPQPlayer,172,172,344,6,54,Tie
6939,JointPQPlayer,251,246,497,39,14,Player A
6940,JointPQPlayer,217,222,439,26,29,JointPQPlayer
6941,JointPQPlayer,274,269,543,58,5,Player A
6942,JointPQPlayer,259,259,518,48,10,Tie
6943,JointPQPlayer,262,262,524,54,10,Tie
6944,JointPQPlayer,266,266,532,41,3,Tie
6945,JointPQPlayer,260,265,525,49,8,JointPQPlayer
6946,JointPQPlayer,268,263,531,52,7,Player A
6947,JointPQPlayer,262,262,524,51,9,Tie
6948,JointPQPlayer,266,266,532,50,6,Tie
6949,JointPQPlayer,271,271,542,57,5,Tie
6950,JointPQPlayer,268,268,536,60,8,Tie
6951,JointPQPlayer,249,254,503,42,13,JointPQPlayer
6952,JointPQPlayer,266,266,532,53,7,Tie
6953,JointPQPlayer,265,260,525,52,9,Player A
6954,JointPQPlayer,249,254,503,45,14,JointPQPlayer
6955,JointPQPlayer,169,169,338,9,57,Tie
6956,JointPQPlayer,252,247,499,56,19,Player A
6957,JointPQPlayer,173,178,351,7,52,JointPQPlayer
6958,JointPQPlayer,248,243,491,39,16,Player A
6959,JointPQPlayer,152,157,309,7,66,JointPQPlayer
6960,JointPQPlayer,252,252,504,46,14,Tie
6961,JointPQPlayer,263,258,521,51,10,Player A
6962,JointPQPlayer,255,255,510,43,11,Tie
6963,JointPQPlayer,254,254,508,47,13,Tie
6964,JointPQPlayer,266,266,532,68,12,Tie
6965,JointPQPlayer,231,236,467,30,21,JointPQPlayer
6966,JointPQPlayer,271,266,537,52,5,Player A
6967,JointPQPlayer,261,261,522,40,6,Tie
6968,JointPQPlayer,247,247,494,42,16,Tie
6969,JointPQPlayer,251,256,507,46,13,JointPQPlayer
6970,JointPQPlayer,255,255,510,49,13,Tie
6971,JointPQPlayer,244,239,483,40,19,Player A
6972,JointPQPlayer,258,263,521,54,11,JointPQPlayer
6973,JointPQPlayer,190,190,380,18,46,Tie
6974,JointPQPlayer,259,254,513,49,12,Player A
6975,JointPQPlayer,242,242,484,44,20,Tie
6976,JointPQPlayer,270,275,545,60,5,JointPQPlayer
6977,JointPQPlayer,192,187,379,11,44,Player A
6978,JointPQPlayer,256,261,517,50,11,JointPQPlayer
6979,JointPQPlayer,255,250,505,35,10,Player A
6980,JointPQPlayer,258,258,516,49,11,Tie
6981,JointPQPlayer,243,248,491,39,16,JointPQPlayer
6982,JointPQPlayer,184,184,368,9,47,Tie
6983,JointPQPlayer,252,247,499,38,13,Player A
6984,JointPQPlayer,258,263,521,39,6,JointPQPlayer
6985,JointPQPlayer,269,269,538,56,6,Tie
6986,JointPQPlayer,193,193,386,9,41,Tie
6987,JointPQPlayer,253,248,501,40,13,Player A
6988,JointPQPlayer,255,255,510,46,12,Tie
6989,JointPQPlayer,241,246,487,44,19,JointPQPlayer
6990,JointPQPlayer,171,171,342,4,54,Tie
6991,JointPQPlayer,239,234,473,36,21,Player A
6992,JointPQPlayer,259,264,523,53,10,JointPQPlayer
6993,JointPQPlayer,248,243,491,42,17,Player A
6994,JointPQPlayer,248,248,496,47,17,Tie
6995,JointPQPlayer,266,266,532,56,8,Tie
6996,JointPQPlayer,215,215,430,23,31,Tie
6997,JointPQPlayer,242,242,484,38,18,Tie
6998,JointPQPlayer,254,254,508,50,14,Tie
6999,JointPQPlayer,167,172,339,4,55,JointPQPlayer
7000,JointPQPlayer,206,206,412,26,38,Tie
7001,JointPQPlayer,245,245,490,38,16,Tie
7002,JointPQPlayer,258,253,511,47,12,Player A
7003,JointPQPlayer,255,255,510,49,13,Tie
7004,JointPQPlayer,248,248,496,44,16,Tie
7005,JointPQPlayer,256,256,512,42,10,Tie
7006,JointPQPlayer,245,250,495,37,14,JointPQPlayer
7007,JointPQPlayer,225,220,445,35,30,Player A
7008,JointPQPlayer,255,255,510,40,10,Tie
7009,JointPQPlayer,248,248,496,47,17,Tie
7010,JointPQPlayer,249,249,498,46,16,Tie
7011,JointPQPlayer,265,265,530,51,7,Tie
7012,JointPQPlayer,201,206,407,21,38,JointPQPlayer
7013,JointPQPlayer,190,185,375,7,44,Player A
7014,JointPQPlayer,245,245,490,41,17,Tie
7015,JointPQPlayer,234,239,473,36,21,JointPQPlayer
7016,JointPQPlayer,252,247,499,50,17,Player A
7017,JointPQPlayer,263,263,526,56,10,Tie
7018,JointPQPlayer,250,255,505,44,13,JointPQPlayer
7019,JointPQPlayer,245,245,490,41,17,Tie
7020,JointPQPlayer,261,261,522,49,9,Tie
7021,JointPQPlayer,264,259,523,50,9,Player A
7022,JointPQPlayer,266,266,532,47,5,Tie
7023,JointPQPlayer,164,169,333,7,58,JointPQPlayer
7024,JointPQPlayer,234,229,463,38,25,Player A
7025,JointPQPlayer,246,246,492,40,16,Tie
7026,JointPQPlayer,248,253,501,34,11,JointPQPlayer
7027,JointPQPlayer,252,247,499,47,16,Player A
7028,JointPQPlayer,229,229,458,36,26,Tie
7029,JointPQPlayer,266,266,532,56,8,Tie
7030,JointPQPlayer,269,269,538,50,4,Tie
7031,JointPQPlayer,240,240,480,40,20,Tie
7032,JointPQPlayer,233,233,466,41,25,Tie
7033,JointPQPlayer,161,161,322,5,61,Tie
7034,JointPQPlayer,263,268,531,58,9,JointPQPlayer
7035,JointPQPlayer,263,258,521,54,11,Player A
7036,JointPQPlayer,237,237,474,37,21,Tie
7037,JointPQPlayer,265,265,530,57,9,Tie
7038,JointPQPlayer,263,268,531,49,6,JointPQPlayer
7039,JointPQPlayer,176,171,347,9,54,Player A
7040,JointPQPlayer,168,173,341,6,55,JointPQPlayer
7041,JointPQPlayer,253,248,501,43,14,Player A
7042,JointPQPlayer,166,171,337,2,55,JointPQPlayer
7043,JointPQPlayer,168,168,336,7,57,Tie
7044,JointPQPlayer,236,236,472,32,20,Tie
7045,JointPQPlayer,236,231,467,30,21,Player A
7046,JointPQPlayer,244,244,488,39,17,Tie
7047,JointPQPlayer,252,257,509,48,13,JointPQPlayer
7048,JointPQPlayer,262,257,519,49,10,Player A
7049,JointPQPlayer,262,262,524,48,8,Tie
7050,JointPQPlayer,236,241,477,37,20,JointPQPlayer
7051,JointPQPlayer,261,256,517,44,9,Player A
7052,JointPQPlayer,195,195,390,16,42,Tie
7053,JointPQPlayer,242,242,484,38,18,Tie
7054,JointPQPlayer,263,263,526,50,8,Tie
7055,JointPQPlayer,173,173,346,8,54,Tie
7056,JointPQPlayer,151,156,307,5,66,JointPQPlayer
7057,JointPQPlayer,177,172,349,8,53,Player A
7058,JointPQPlayer,243,248,491,42,17,JointPQPlayer
7059,JointPQPlayer,244,239,483,43,20,Player A
7060,JointPQPlayer,247,247,494,45,17,Tie
7061,JointPQPlayer,238,243,481,47,22,JointPQPlayer
7062,JointPQPlayer,264,259,523,50,9,Player A
7063,JointPQPlayer,223,223,446,30,28,Tie
7064,JointPQPlayer,262,262,524,51,9,Tie
7065,JointPQPlayer,240,245,485,39,18,JointPQPlayer
7066,JointPQPlayer,241,236,477,34,19,Player A
7067,JointPQPlayer,263,263,526,50,8,Tie
7068,JointPQPlayer,198,203,401,15,38,JointPQPlayer
7069,JointPQPlayer,257,252,509,45,12,Player A
7070,JointPQPlayer,222,227,449,30,27,JointPQPlayer
7071,JointPQPlayer,222,217,439,29,30,Player A
7072,JointPQPlayer,264,264,528,52,8,Tie
7073,JointPQPlayer,177,182,359,9,50,JointPQPlayer
7074,JointPQPlayer,266,266,532,53,7,Tie
7075,JointPQPlayer,265,260,525,49,8,Player A
7076,JointPQPlayer,249,249,498,40,14,Tie
7077,JointPQPlayer,264,264,528,55,9,Tie
7078,JointPQPlayer,188,188,376,11,45,Tie
7079,JointPQPlayer,249,249,498,43,15,Tie
7080,JointPQPlayer,239,244,483,40,19,JointPQPlayer
7081,JointPQPlayer,254,249,503,48,15,Player A
7082,JointPQPlayer,169,174,343,5,54,JointPQPlayer
7083,JointPQPlayer,247,242,489,46,19,Player A
7084,JointPQPlayer,253,253,506,39,11,Tie
7085,JointPQPlayer,166,171,337,14,59,JointPQPlayer
7086,JointPQPlayer,275,270,545,54,3,Player A
7087,JointPQPlayer,253,253,506,39,11,Tie
7088,JointPQPlayer,240,240,480,34,18,Tie
7089,JointPQPlayer,250,250,500,48,16,Tie
7090,JointPQPlayer,268,268,536,57,7,Tie
7091,JointPQPlayer,246,246,492,37,15,Tie
7092,JointPQPlayer,198,203,401,21,40,JointPQPlayer
7093,JointPQPlayer,273,273,546,55,3,Tie
7094,JointPQPlayer,250,245,495,40,15,Player A
7095,JointPQPlayer,250,250,500,42,14,Tie
7096,JointPQPlayer,171,171,342,7,55,Tie
7097,JointPQPlayer,257,262,519,46,9,JointPQPlayer
7098,JointPQPlayer,222,217,439,29,30,Player A
7099,JointPQPlayer,254,254,508,53,15,Tie
7100,JointPQPlayer,256,261,517,44,9,JointPQPlayer
7101,JointPQPlayer,236,236,472,32,20,Tie
7102,JointPQPlayer,257,257,514,50,12,Tie
7103,JointPQPlayer,266,266,532,56,8,Tie
7104,JointPQPlayer,276,271,547,62,5,Player A
7105,JointPQPlayer,206,206,412,29,39,Tie
7106,JointPQPlayer,241,241,482,36,18,Tie
7107,JointPQPlayer,247,252,499,44,15,JointPQPlayer
7108,JointPQPlayer,253,253,506,42,12,Tie
7109,JointPQPlayer,260,255,515,45,10,Player A
7110,JointPQPlayer,211,216,427,32,35,JointPQPlayer
7111,JointPQPlayer,247,247,494,42,16,Tie
7112,JointPQPlayer,252,247,499,50,17,Player A
7113,JointPQPlayer,206,206,412,26,38,Tie
7114,JointPQPlayer,214,219,433,29,32,JointPQPlayer
7115,JointPQPlayer,265,265,530,54,8,Tie
7116,JointPQPlayer,230,225,455,30,25,Player A
7117,JointPQPlayer,242,242,484,44,20,Tie
7118,JointPQPlayer,241,246,487,38,17,JointPQPlayer
7119,JointPQPlayer,257,257,514,41,9,Tie
7120,JointPQPlayer,259,254,513,43,10,Player A
7121,JointPQPlayer,241,241,482,39,19,Tie
7122,JointPQPlayer,248,248,496,47,17,Tie
7123,JointPQPlayer,229,229,458,30,24,Tie
7124,JointPQPlayer,182,187,369,7,46,JointPQPlayer
7125,JointPQPlayer,274,269,543,61,6,Player A
7126,JointPQPlayer,266,266,532,50,6,Tie
7127,JointPQPlayer,259,259,518,42,8,Tie
7128,JointPQPlayer,261,261,522,37,5,Tie
7129,JointPQPlayer,262,262,524,54,10,Tie
7130,JointPQPlayer,273,273,546,55,3,Tie
7131,JointPQPlayer,186,191,377,15,46,JointPQPlayer
7132,JointPQPlayer,262,257,519,52,11,Player A
7133,JointPQPlayer,230,230,460,38,26,Tie
7134,JointPQPlayer,236,241,477,40,21,JointPQPlayer
7135,JointPQPlayer,263,263,526,44,6,Tie
7136,JointPQPlayer,264,259,523,53,10,Player A
7137,JointPQPlayer,254,254,508,44,12,Tie
7138,JointPQPlayer,255,255,510,46,12,Tie
7139,JointPQPlayer,262,267,529,41,4,JointPQPlayer
7140,JointPQPlayer,239,234,473,36,21,Player A
7141,JointPQPlayer,267,272,539,48,3,JointPQPlayer
7142,JointPQPlayer,175,170,345,7,54,Player A
7143,JointPQPlayer,200,200,400,26,42,Tie
7144,JointPQPlayer,257,257,514,47,11,Tie
7145,JointPQPlayer,260,260,520,47,9,Tie
7146,JointPQPlayer,244,244,488,39,17,Tie
7147,JointPQPlayer,227,232,459,40,27,JointPQPlayer
7148,JointPQPlayer,265,260,525,46,7,Player A
7149,JointPQPlayer,237,242,479,30,17,JointPQPlayer
7150,JointPQPlayer,242,237,479,45,22,Player A
7151,JointPQPlayer,263,263,526,53,9,Tie
7152,JointPQPlayer,278,278,556,62,2,Tie
7153,JointPQPlayer,264,264,528,46,6,Tie
7154,JointPQPlayer,272,277,549,55,2,JointPQPlayer
7155,JointPQPlayer,257,252,509,48,13,Player A
7156,JointPQPlayer,235,235,470,33,21,Tie
7157,JointPQPlayer,168,173,341,9,56,JointPQPlayer
7158,JointPQPlayer,253,248,501,43,14,Player A
7159,JointPQPlayer,248,248,496,38,14,Tie
7160,JointPQPlayer,265,265,530,48,6,Tie
7161,JointPQPlayer,255,260,515,42,9,JointPQPlayer
7162,JointPQPlayer,242,242,484,44,20,Tie
7163,JointPQPlayer,183,183,366,13,49,Tie
7164,JointPQPlayer,262,257,519,52,11,Player A
7165,JointPQPlayer,250,250,500,36,12,Tie
7166,JointPQPlayer,194,199,393,19,42,JointPQPlayer
7167,JointPQPlayer,258,253,511,47,12,Player A
7168,JointPQPlayer,173,178,351,10,53,JointPQPlayer
7169,JointPQPlayer,270,265,535,53,6,Player A
7170,JointPQPlayer,194,194,388,17,43,Tie
7171,JointPQPlayer,244,244,488,36,16,Tie
7172,JointPQPlayer,271,271,542,51,3,Tie
7173,JointPQPlayer,259,259,518,51,11,Tie
7174,JointPQPlayer,195,195,390,22,44,Tie
7175,JointPQPlayer,242,242,484,41,19,Tie
7176,JointPQPlayer,251,251,502,47,15,Tie
7177,JointPQPlayer,177,177,354,13,53,Tie
7178,JointPQPlayer,259,259,518,45,9,Tie
7179,JointPQPlayer,255,260,515,45,10,JointPQPlayer
7180,JointPQPlayer,183,183,366,10,48,Tie
7181,JointPQPlayer,264,264,528,49,7,Tie
7182,JointPQPlayer,215,210,425,27,34,Player A
7183,JointPQPlayer,228,228,456,40,28,Tie
7184,JointPQPlayer,253,258,511,41,10,JointPQPlayer
7185,JointPQPlayer,259,254,513,52,13,Player A
7186,JointPQPlayer,261,261,522,46,8,Tie
7187,JointPQPlayer,268,268,536,54,6,Tie
7188,JointPQPlayer,251,256,507,40,11,JointPQPlayer
7189,JointPQPlayer,204,199,403,17,38,Player A
7190,JointPQPlayer,255,260,515,51,12,JointPQPlayer
7191,JointPQPlayer,259,254,513,43,10,Player A
7192,JointPQPlayer,254,259,513,46,11,JointPQPlayer
7193,JointPQPlayer,245,240,485,42,19,Player A
7194,JointPQPlayer,255,255,510,40,10,Tie
7195,JointPQPlayer,247,247,494,39,15,Tie
7196,JointPQPlayer,249,254,503,36,11,JointPQPlayer
7197,JointPQPlayer,162,162,324,7,61,Tie
7198,JointPQPlayer,182,177,359,9,50,Player A
7199,JointPQPlayer,260,260,520,44,8,Tie
7200,JointPQPlayer,256,261,517,47,10,JointPQPlayer
7201,JointPQPlayer,235,235,470,33,21,Tie
7202,JointPQPlayer,192,187,379,14,45,Player A
7203,JointPQPlayer,237,237,474,43,23,Tie
7204,JointPQPlayer,267,272,539,54,5,JointPQPlayer
7205,JointPQPlayer,246,241,487,38,17,Player A
7206,JointPQPlayer,240,245,485,39,18,JointPQPlayer
7207,JointPQPlayer,245,245,490,41,17,Tie
7208,JointPQPlayer,235,235,470,39,23,Tie
7209,JointPQPlayer,245,245,490,41,17,Tie
7210,JointPQPlayer,262,257,519,52,11,Player A
7211,JointPQPlayer,254,254,508,44,12,Tie
7212,JointPQPlayer,266,266,532,47,5,Tie
7213,JointPQPlayer,249,249,498,46,16,Tie
7214,JointPQPlayer,246,251,497,39,14,JointPQPlayer
7215,JointPQPlayer,250,245,495,40,15,Player A
7216,JointPQPlayer,231,236,467,39,24,JointPQPlayer
7217,JointPQPlayer,173,173,346,11,55,Tie
7218,JointPQPlayer,252,247,499,32,11,Player A
7219,JointPQPlayer,262,262,524,51,9,Tie
7220,JointPQPlayer,224,229,453,31,26,JointPQPlayer
7221,JointPQPlayer,159,159,318,7,63,Tie
7222,JointPQPlayer,241,241,482,39,19,Tie
7223,JointPQPlayer,173,173,346,5,53,Tie
7224,JointPQPlayer,173,168,341,6,55,Player A
7225,JointPQPlayer,256,261,517,56,13,JointPQPlayer
7226,JointPQPlayer,267,267,534,61,9,Tie
7227,JointPQPlayer,269,264,533,54,7,Player A
7228,JointPQPlayer,159,164,323,6,61,JointPQPlayer
7229,JointPQPlayer,255,250,505,50,15,Player A
7230,JointPQPlayer,241,246,487,41,18,JointPQPlayer
7231,JointPQPlayer,218,213,431,27,32,Player A
7232,JointPQPlayer,206,206,412,20,36,Tie
7233,JointPQPlayer,258,263,521,48,9,JointPQPlayer
7234,JointPQPlayer,188,188,376,17,47,Tie
7235,JointPQPlayer,250,250,500,36,12,Tie
7236,JointPQPlayer,179,179,358,5,49,Tie
7237,JointPQPlayer,254,249,503,45,14,Player A
7238,JointPQPlayer,237,242,479,36,19,JointPQPlayer
7239,JointPQPlayer,171,171,342,7,55,Tie
7240,JointPQPlayer,172,167,339,4,55,Player A
7241,JointPQPlayer,248,248,496,44,16,Tie
7242,JointPQPlayer,207,212,419,30,37,JointPQPlayer
7243,JointPQPlayer,247,242,489,34,15,Player A
7244,JointPQPlayer,231,231,462,43,27,Tie
7245,JointPQPlayer,269,269,538,56,6,Tie
7246,JointPQPlayer,266,271,537,55,6,JointPQPlayer
7247,JointPQPlayer,169,169,338,3,55,Tie
7248,JointPQPlayer,262,257,519,46,9,Player A
7249,JointPQPlayer,214,214,428,24,32,Tie
7250,JointPQPlayer,216,216,432,22,30,Tie
7251,JointPQPlayer,257,257,514,50,12,Tie
7252,JointPQPlayer,245,250,495,40,15,JointPQPlayer
7253,JointPQPlayer,255,250,505,47,14,Player A
7254,JointPQPlayer,226,226,452,30,26,Tie
7255,JointPQPlayer,255,260,515,48,11,JointPQPlayer
7256,JointPQPlayer,265,265,530,54,8,Tie
7257,JointPQPlayer,236,231,467,39,24,Player A
7258,JointPQPlayer,246,246,492,43,17,Tie
7259,JointPQPlayer,266,266,532,56,8,Tie
7260,JointPQPlayer,241,241,482,33,17,Tie
7261,JointPQPlayer,266,266,532,50,6,Tie
7262,JointPQPlayer,188,193,381,7,42,JointPQPlayer
7263,JointPQPlayer,186,181,367,8,47,Player A
7264,JointPQPlayer,254,259,513,52,13,JointPQPlayer
7265,JointPQPlayer,253,248,501,46,15,Player A
7266,JointPQPlayer,252,257,509,45,12,JointPQPlayer
7267,JointPQPlayer,222,222,444,31,29,Tie
7268,JointPQPlayer,253,248,501,37,12,Player A
7269,JointPQPlayer,267,267,534,52,6,Tie
7270,JointPQPlayer,259,259,518,48,10,Tie
7271,JointPQPlayer,172,177,349,5,52,JointPQPlayer
7272,JointPQPlayer,246,241,487,38,17,Player A
7273,JointPQPlayer,238,243,481,47,22,JointPQPlayer
7274,JointPQPlayer,264,259,523,47,8,Player A
7275,JointPQPlayer,246,246,492,34,14,Tie
7276,JointPQPlayer,259,259,518,42,8,Tie
7277,JointPQPlayer,265,265,530,51,7,Tie
7278,JointPQPlayer,199,204,403,23,40,JointPQPlayer
7279,JointPQPlayer,200,200,400,14,38,Tie
7280,JointPQPlayer,213,213,426,31,35,Tie
7281,JointPQPlayer,267,267,534,58,8,Tie
7282,JointPQPlayer,247,242,489,49,20,Player A
7283,JointPQPlayer,275,275,550,53,1,Tie
7284,JointPQPlayer,236,236,472,35,21,Tie
7285,JointPQPlayer,260,260,520,47,9,Tie
7286,JointPQPlayer,210,210,420,19,33,Tie
7287,JointPQPlayer,253,258,511,38,9,JointPQPlayer
7288,JointPQPlayer,219,219,438,28,30,Tie
7289,JointPQPlayer,251,251,502,47,15,Tie
7290,JointPQPlayer,261,256,517,47,10,Player A
7291,JointPQPlayer,245,245,490,47,19,Tie
7292,JointPQPlayer,252,257,509,42,11,JointPQPlayer
7293,JointPQPlayer,253,248,501,46,15,Player A
7294,JointPQPlayer,254,254,508,47,13,Tie
7295,JointPQPlayer,255,260,515,45,10,JointPQPlayer
7296,JointPQPlayer,180,180,360,10,50,Tie
7297,JointPQPlayer,259,254,513,46,11,Player A
7298,JointPQPlayer,179,184,363,10,49,JointPQPlayer
7299,JointPQPlayer,261,256,517,38,7,Player A
7300,JointPQPlayer,267,267,534,49,5,Tie
7301,JointPQPlayer,251,256,507,40,11,JointPQPlayer
7302,JointPQPlayer,248,248,496,41,15,Tie
7303,JointPQPlayer,264,259,523,47,8,Player A
7304,JointPQPlayer,250,250,500,42,14,Tie
7305,JointPQPlayer,262,262,524,54,10,Tie
7306,JointPQPlayer,256,261,517,44,9,JointPQPlayer
7307,JointPQPlayer,228,228,456,34,26,Tie
7308,JointPQPlayer,263,258,521,48,9,Player A
7309,JointPQPlayer,237,237,474,37,21,Tie
7310,JointPQPlayer,259,259,518,48,10,Tie
7311,JointPQPlayer,261,266,527,51,8,JointPQPlayer
7312,JointPQPlayer,195,190,385,14,43,Player A
7313,JointPQPlayer,236,236,472,32,20,Tie
7314,JointPQPlayer,183,188,371,9,46,JointPQPlayer
7315,JointPQPlayer,256,256,512,39,9,Tie
7316,JointPQPlayer,249,249,498,40,14,Tie
7317,JointPQPlayer,239,234,473,42,23,Player A
7318,JointPQPlayer,263,263,526,53,9,Tie
7319,JointPQPlayer,182,187,369,7,46,JointPQPlayer
7320,JointPQPlayer,239,239,478,41,21,Tie
7321,JointPQPlayer,246,241,487,38,17,Player A
7322,JointPQPlayer,267,267,534,49,5,Tie
7323,JointPQPlayer,180,185,365,21,52,JointPQPlayer
7324,JointPQPlayer,177,177,354,7,51,Tie
7325,JointPQPlayer,256,256,512,48,12,Tie
7326,JointPQPlayer,260,255,515,45,10,Player A
7327,JointPQPlayer,257,257,514,47,11,Tie
7328,JointPQPlayer,265,265,530,54,8,Tie
7329,JointPQPlayer,253,258,511,44,11,JointPQPlayer
7330,JointPQPlayer,265,265,530,54,8,Tie
7331,JointPQPlayer,247,242,489,46,19,Player A
7332,JointPQPlayer,275,275,550,59,3,Tie
7333,JointPQPlayer,221,221,442,32,30,Tie
7334,JointPQPlayer,268,268,536,54,6,Tie
7335,JointPQPlayer,194,194,388,8,40,Tie
7336,JointPQPlayer,185,185,370,14,48,Tie
7337,JointPQPlayer,250,250,500,45,15,Tie
7338,JointPQPlayer,252,252,504,46,14,Tie
7339,JointPQPlayer,257,262,519,43,8,JointPQPlayer
7340,JointPQPlayer,174,174,348,7,53,Tie
7341,JointPQPlayer,172,172,344,12,56,Tie
7342,JointPQPlayer,235,230,465,37,24,Player A
7343,JointPQPlayer,268,268,536,54,6,Tie
7344,JointPQPlayer,174,179,353,12,53,JointPQPlayer
7345,JointPQPlayer,253,248,501,43,14,Player A
7346,JointPQPlayer,259,259,518,48,10,Tie
7347,JointPQPlayer,265,265,530,45,5,Tie
7348,JointPQPlayer,185,190,375,16,47,JointPQPlayer
7349,JointPQPlayer,240,240,480,43,21,Tie
7350,JointPQPlayer,238,233,471,34,21,Player A
7351,JointPQPlayer,248,248,496,47,17,Tie
7352,JointPQPlayer,162,167,329,6,59,JointPQPlayer
7353,JointPQPlayer,261,256,517,47,10,Player A
7354,JointPQPlayer,163,168,331,5,58,JointPQPlayer
7355,JointPQPlayer,260,255,515,48,11,Player A
7356,JointPQPlayer,167,172,339,4,55,JointPQPlayer
7357,JointPQPlayer,269,264,533,57,8,Player A
7358,JointPQPlayer,259,259,518,45,9,Tie
7359,JointPQPlayer,260,260,520,53,11,Tie
7360,JointPQPlayer,244,249,493,32,13,JointPQPlayer
7361,JointPQPlayer,268,268,536,51,5,Tie
7362,JointPQPlayer,263,258,521,54,11,Player A
7363,JointPQPlayer,263,263,526,56,10,Tie
7364,JointPQPlayer,167,172,339,4,55,JointPQPlayer
7365,JointPQPlayer,220,220,440,30,30,Tie
7366,JointPQPlayer,262,262,524,42,6,Tie
7367,JointPQPlayer,274,274,548,60,4,Tie
7368,JointPQPlayer,263,258,521,48,9,Player A
7369,JointPQPlayer,257,257,514,50,12,Tie
7370,JointPQPlayer,222,227,449,27,26,JointPQPlayer
7371,JointPQPlayer,189,189,378,4,42,Tie
7372,JointPQPlayer,245,240,485,39,18,Player A
7373,JointPQPlayer,256,256,512,42,10,Tie
7374,JointPQPlayer,242,247,489,46,19,JointPQPlayer
7375,JointPQPlayer,254,249,503,36,11,Player A
7376,JointPQPlayer,246,251,497,42,15,JointPQPlayer
7377,JointPQPlayer,274,269,543,52,3,Player A
7378,JointPQPlayer,261,261,522,49,9,Tie
7379,JointPQPlayer,247,247,494,51,19,Tie
7380,JointPQPlayer,165,170,335,9,58,JointPQPlayer
7381,JointPQPlayer,247,247,494,42,16,Tie
7382,JointPQPlayer,225,225,450,28,26,Tie
7383,JointPQPlayer,160,160,320,3,61,Tie
7384,JointPQPlayer,263,258,521,42,7,Player A
7385,JointPQPlayer,173,178,351,7,52,JointPQPlayer
7386,JointPQPlayer,229,229,458,42,28,Tie
7387,JointPQPlayer,258,258,516,46,10,Tie
7388,JointPQPlayer,266,261,527,51,8,Player A
7389,JointPQPlayer,161,161,322,5,61,Tie
7390,JointPQPlayer,266,266,532,47,5,Tie
7391,JointPQPlayer,234,239,473,36,21,JointPQPlayer
7392,JointPQPlayer,254,254,508,53,15,Tie
7393,JointPQPlayer,246,241,487,35,16,Player A
7394,JointPQPlayer,250,250,500,42,14,Tie
7395,JointPQPlayer,242,247,489,46,19,JointPQPlayer
7396,JointPQPlayer,216,211,427,26,33,Player A
7397,JointPQPlayer,257,262,519,43,8,JointPQPlayer
7398,JointPQPlayer,193,188,381,16,45,Player A
7399,JointPQPlayer,166,171,337,2,55,JointPQPlayer
7400,JointPQPlayer,255,255,510,46,12,Tie
7401,JointPQPlayer,261,261,522,49,9,Tie
7402,JointPQPlayer,263,258,521,51,10,Player A
7403,JointPQPlayer,189,194,383,9,42,JointPQPlayer
7404,JointPQPlayer,168,168,336,4,56,Tie
7405,JointPQPlayer,259,254,513,43,10,Player A
7406,JointPQPlayer,165,165,330,4,58,Tie
7407,JointPQPlayer,257,262,519,52,11,JointPQPlayer
7408,JointPQPlayer,264,259,523,47,8,Player A
7409,JointPQPlayer,254,254,508,44,12,Tie
7410,JointPQPlayer,171,176,347,12,55,JointPQPlayer
7411,JointPQPlayer,259,254,513,46,11,Player A
7412,JointPQPlayer,267,267,534,52,6,Tie
7413,JointPQPlayer,250,250,500,42,14,Tie
7414,JointPQPlayer,264,269,533,63,10,JointPQPlayer
7415,JointPQPlayer,271,266,537,52,5,Player A
7416,JointPQPlayer,220,220,440,24,28,Tie
7417,JointPQPlayer,256,256,512,45,11,Tie
7418,JointPQPlayer,251,256,507,46,13,JointPQPlayer
7419,JointPQPlayer,254,249,503,45,14,Player A
7420,JointPQPlayer,193,193,386,15,43,Tie
7421,JointPQPlayer,255,255,510,52,14,Tie
7422,JointPQPlayer,219,219,438,19,27,Tie
7423,JointPQPlayer,229,229,458,33,25,Tie
7424,JointPQPlayer,231,231,462,31,23,Tie
7425,JointPQPlayer,263,263,526,53,9,Tie
7426,JointPQPlayer,255,260,515,45,10,JointPQPlayer
7427,JointPQPlayer,241,236,477,40,21,Player A
7428,JointPQPlayer,256,256,512,45,11,Tie
7429,JointPQPlayer,236,236,472,38,22,Tie
7430,JointPQPlayer,186,186,372,16,48,Tie
7431,JointPQPlayer,257,257,514,44,10,Tie
7432,JointPQPlayer,260,260,520,50,10,Tie
7433,JointPQPlayer,257,262,519,37,6,JointPQPlayer
7434,JointPQPlayer,236,236,472,41,23,Tie
7435,JointPQPlayer,252,252,504,46,14,Tie
7436,JointPQPlayer,170,170,340,8,56,Tie
7437,JointPQPlayer,248,243,491,33,14,Player A
7438,JointPQPlayer,242,247,489,37,16,JointPQPlayer
7439,JointPQPlayer,183,183,366,7,47,Tie
7440,JointPQPlayer,249,244,493,44,17,Player A
7441,JointPQPlayer,274,274,548,57,3,Tie
7442,JointPQPlayer,180,180,360,13,51,Tie
7443,JointPQPlayer,258,258,516,55,13,Tie
7444,JointPQPlayer,258,258,516,43,9,Tie
7445,JointPQPlayer,259,259,518,45,9,Tie
7446,JointPQPlayer,249,254,503,42,13,JointPQPlayer
7447,JointPQPlayer,271,266,537,52,5,Player A
7448,JointPQPlayer,177,182,359,9,50,JointPQPlayer
7449,JointPQPlayer,256,251,507,49,14,Player A
7450,JointPQPlayer,249,254,503,36,11,JointPQPlayer
7451,JointPQPlayer,271,266,537,52,5,Player A
7452,JointPQPlayer,244,244,488,48,20,Tie
7453,JointPQPlayer,258,258,516,46,10,Tie
7454,JointPQPlayer,263,268,531,55,8,JointPQPlayer
7455,JointPQPlayer,227,227,454,29,25,Tie
7456,JointPQPlayer,255,250,505,38,11,Player A
7457,JointPQPlayer,247,252,499,35,12,JointPQPlayer
7458,JointPQPlayer,197,192,389,18,43,Player A
7459,JointPQPlayer,261,261,522,49,9,Tie
7460,JointPQPlayer,249,249,498,46,16,Tie
7461,JointPQPlayer,264,264,528,49,7,Tie
7462,JointPQPlayer,198,198,396,16,40,Tie
7463,JointPQPlayer,182,187,369,10,47,JointPQPlayer
7464,JointPQPlayer,232,227,459,34,25,Player A
7465,JointPQPlayer,258,258,516,40,8,Tie
7466,JointPQPlayer,258,258,516,49,11,Tie
7467,JointPQPlayer,164,164,328,5,59,Tie
7468,JointPQPlayer,261,261,522,43,7,Tie
7469,JointPQPlayer,252,252,504,37,11,Tie
7470,JointPQPlayer,259,264,523,44,7,JointPQPlayer
7471,JointPQPlayer,210,210,420,25,35,Tie
7472,JointPQPlayer,251,246,497,42,15,Player A
7473,JointPQPlayer,248,248,496,41,15,Tie
7474,JointPQPlayer,249,249,498,46,16,Tie
7475,JointPQPlayer,236,236,472,38,22,Tie
7476,JointPQPlayer,245,245,490,41,17,Tie
7477,JointPQPlayer,264,264,528,52,8,Tie
7478,JointPQPlayer,221,221,442,23,27,Tie
7479,JointPQPlayer,254,254,508,47,13,Tie
7480,JointPQPlayer,255,255,510,43,11,Tie
7481,JointPQPlayer,241,246,487,41,18,JointPQPlayer
7482,JointPQPlayer,243,243,486,43,19,Tie
7483,JointPQPlayer,224,224,448,35,29,Tie
7484,JointPQPlayer,246,241,487,38,17,Player A
7485,JointPQPlayer,159,164,323,3,60,JointPQPlayer
7486,JointPQPlayer,258,253,511,47,12,Player A
7487,JointPQPlayer,247,252,499,44,15,JointPQPlayer
7488,JointPQPlayer,262,257,519,52,11,Player A
7489,JointPQPlayer,253,258,511,41,10,JointPQPlayer
7490,JointPQPlayer,252,247,499,35,12,Player A
7491,JointPQPlayer,254,254,508,50,14,Tie
7492,JointPQPlayer,214,219,433,29,32,JointPQPlayer
7493,JointPQPlayer,264,264,528,58,10,Tie
7494,JointPQPlayer,261,256,517,41,8,Player A
7495,JointPQPlayer,273,273,546,64,6,Tie
7496,JointPQPlayer,171,176,347,9,54,JointPQPlayer
7497,JointPQPlayer,248,248,496,44,16,Tie
7498,JointPQPlayer,249,249,498,46,16,Tie
7499,JointPQPlayer,170,170,340,2,54,Tie
7500,JointPQPlayer,250,245,495,43,16,Player A
7501,JointPQPlayer,246,246,492,40,16,Tie
7502,JointPQPlayer,234,239,473,36,21,JointPQPlayer
7503,JointPQPlayer,262,262,524,45,7,Tie
7504,JointPQPlayer,268,263,531,52,7,Player A
7505,JointPQPlayer,262,262,524,54,10,Tie
7506,JointPQPlayer,260,260,520,41,7,Tie
7507,JointPQPlayer,263,263,526,38,4,Tie
7508,JointPQPlayer,261,261,522,52,10,Tie
7509,JointPQPlayer,255,260,515,42,9,JointPQPlayer
7510,JointPQPlayer,273,268,541,56,5,Player A
7511,JointPQPlayer,257,257,514,47,11,Tie
7512,JointPQPlayer,250,250,500,45,15,Tie
7513,JointPQPlayer,178,183,361,5,48,JointPQPlayer
7514,JointPQPlayer,252,247,499,44,15,Player A
7515,JointPQPlayer,266,266,532,53,7,Tie
7516,JointPQPlayer,234,234,468,37,23,Tie
7517,JointPQPlayer,256,261,517,56,13,JointPQPlayer
7518,JointPQPlayer,264,259,523,47,8,Player A
7519,JointPQPlayer,246,246,492,37,15,Tie
7520,JointPQPlayer,269,269,538,47,3,Tie
7521,JointPQPlayer,266,271,537,52,5,JointPQPlayer
7522,JointPQPlayer,249,244,493,41,16,Player A
7523,JointPQPlayer,248,248,496,44,16,Tie
7524,JointPQPlayer,248,253,501,40,13,JointPQPlayer
7525,JointPQPlayer,223,218,441,31,30,Player A
7526,JointPQPlayer,269,269,538,53,5,Tie
7527,JointPQPlayer,264,269,533,54,7,JointPQPlayer
7528,JointPQPlayer,263,258,521,54,11,Player A
7529,JointPQPlayer,240,240,480,31,17,Tie
7530,JointPQPlayer,263,263,526,47,7,Tie
7531,JointPQPlayer,251,256,507,43,12,JointPQPlayer
7532,JointPQPlayer,253,248,501,43,14,Player A
7533,JointPQPlayer,255,255,510,46,12,Tie
7534,JointPQPlayer,192,197,389,6,39,JointPQPlayer
7535,JointPQPlayer,271,266,537,52,5,Player A
7536,JointPQPlayer,267,267,534,52,6,Tie
7537,JointPQPlayer,247,252,499,50,17,JointPQPlayer
7538,JointPQPlayer,163,163,326,6,60,Tie
7539,JointPQPlayer,263,263,526,47,7,Tie
7540,JointPQPlayer,261,256,517,47,10,Player A
7541,JointPQPlayer,240,240,480,46,22,Tie
7542,JointPQPlayer,267,267,534,55,7,Tie
7543,JointPQPlayer,256,256,512,48,12,Tie
7544,JointPQPlayer,244,249,493,44,17,JointPQPlayer
7545,JointPQPlayer,272,267,539,54,5,Player A
7546,JointPQPlayer,252,252,504,40,12,Tie
7547,JointPQPlayer,265,265,530,54,8,Tie
7548,JointPQPlayer,255,255,510,49,13,Tie
7549,JointPQPlayer,181,181,362,6,48,Tie
7550,JointPQPlayer,266,266,532,50,6,Tie
7551,JointPQPlayer,220,220,440,24,28,Tie
7552,JointPQPlayer,197,202,399,22,41,JointPQPlayer
7553,JointPQPlayer,220,215,435,28,31,Player A
7554,JointPQPlayer,167,172,339,7,56,JointPQPlayer
7555,JointPQPlayer,160,160,320,3,61,Tie
7556,JointPQPlayer,250,250,500,48,16,Tie
7557,JointPQPlayer,242,237,479,33,18,Player A
7558,JointPQPlayer,224,224,448,35,29,Tie
7559,JointPQPlayer,265,265,530,54,8,Tie
7560,JointPQPlayer,178,183,361,11,50,JointPQPlayer
7561,JointPQPlayer,271,266,537,55,6,Player A
7562,JointPQPlayer,209,209,418,23,35,Tie
7563,JointPQPlayer,268,273,541,53,4,JointPQPlayer
7564,JointPQPlayer,264,259,523,56,11,Player A
7565,JointPQPlayer,220,225,445,32,29,JointPQPlayer
7566,JointPQPlayer,256,251,507,46,13,Player A
7567,JointPQPlayer,270,270,540,49,3,Tie
7568,JointPQPlayer,237,237,474,34,20,Tie
7569,JointPQPlayer,262,262,524,45,7,Tie
7570,JointPQPlayer,258,258,516,52,12,Tie
7571,JointPQPlayer,258,258,516,46,10,Tie
7572,JointPQPlayer,272,272,544,50,2,Tie
7573,JointPQPlayer,265,265,530,51,7,Tie
7574,JointPQPlayer,248,248,496,41,15,Tie
7575,JointPQPlayer,254,254,508,50,14,Tie
7576,JointPQPlayer,241,246,487,41,18,JointPQPlayer
7577,JointPQPlayer,188,188,376,14,46,Tie
7578,JointPQPlayer,249,244,493,41,16,Player A
7579,JointPQPlayer,180,180,360,7,49,Tie
7580,JointPQPlayer,250,250,500,39,13,Tie
7581,JointPQPlayer,184,184,368,12,48,Tie
7582,JointPQPlayer,273,273,546,55,3,Tie
7583,JointPQPlayer,275,275,550,65,5,Tie
7584,JointPQPlayer,237,242,479,42,21,JointPQPlayer
7585,JointPQPlayer,251,246,497,33,12,Player A
7586,JointPQPlayer,252,252,504,52,16,Tie
7587,JointPQPlayer,260,265,525,46,7,JointPQPlayer
7588,JointPQPlayer,186,186,372,10,46,Tie
7589,JointPQPlayer,263,263,526,50,8,Tie
7590,JointPQPlayer,259,259,518,45,9,Tie
7591,JointPQPlayer,240,240,480,31,17,Tie
7592,JointPQPlayer,261,256,517,53,12,Player A
7593,JointPQPlayer,219,224,443,27,28,JointPQPlayer
7594,JointPQPlayer,243,238,481,38,19,Player A
7595,JointPQPlayer,264,269,533,57,8,JointPQPlayer
7596,JointPQPlayer,249,249,498,46,16,Tie
7597,JointPQPlayer,227,227,454,44,30,Tie
7598,JointPQPlayer,272,267,539,57,6,Player A
7599,JointPQPlayer,262,262,524,51,9,Tie
7600,JointPQPlayer,232,232,464,36,24,Tie
7601,JointPQPlayer,252,252,504,46,14,Tie
7602,JointPQPlayer,168,168,336,4,56,Tie
7603,JointPQPlayer,264,269,533,54,7,JointPQPlayer
7604,JointPQPlayer,267,262,529,50,7,Player A
7605,JointPQPlayer,268,268,536,54,6,Tie
7606,JointPQPlayer,259,259,518,48,10,Tie
7607,JointPQPlayer,175,180,355,11,52,JointPQPlayer
7608,JointPQPlayer,196,191,387,19,44,Player A
7609,JointPQPlayer,252,252,504,49,15,Tie
7610,JointPQPlayer,269,269,538,56,6,Tie
7611,JointPQPlayer,267,272,539,54,5,JointPQPlayer
7612,JointPQPlayer,234,234,468,37,23,Tie
7613,JointPQPlayer,258,253,511,44,11,Player A
7614,JointPQPlayer,164,169,333,10,59,JointPQPlayer
7615,JointPQPlayer,248,248,496,41,15,Tie
7616,JointPQPlayer,233,233,466,41,25,Tie
7617,JointPQPlayer,261,256,517,41,8,Player A
7618,JointPQPlayer,242,247,489,46,19,JointPQPlayer
7619,JointPQPlayer,244,239,483,43,20,Player A
7620,JointPQPlayer,266,271,537,55,6,JointPQPlayer
7621,JointPQPlayer,262,257,519,46,9,Player A
7622,JointPQPlayer,221,221,442,35,31,Tie
7623,JointPQPlayer,217,217,434,27,31,Tie
7624,JointPQPlayer,160,160,320,3,61,Tie
7625,JointPQPlayer,255,255,510,55,15,Tie
7626,JointPQPlayer,271,271,542,54,4,Tie
7627,JointPQPlayer,194,194,388,5,39,Tie
7628,JointPQPlayer,238,243,481,35,18,JointPQPlayer
7629,JointPQPlayer,215,215,430,26,32,Tie
7630,JointPQPlayer,261,261,522,52,10,Tie
7631,JointPQPlayer,204,199,403,20,39,Player A
7632,JointPQPlayer,187,187,374,12,46,Tie
7633,JointPQPlayer,251,256,507,40,11,JointPQPlayer
7634,JointPQPlayer,264,264,528,55,9,Tie
7635,JointPQPlayer,256,251,507,49,14,Player A
7636,JointPQPlayer,274,274,548,63,5,Tie
7637,JointPQPlayer,172,172,344,6,54,Tie
7638,JointPQPlayer,255,255,510,49,13,Tie
7639,JointPQPlayer,251,251,502,44,14,Tie
7640,JointPQPlayer,227,227,454,35,27,Tie
7641,JointPQPlayer,243,243,486,40,18,Tie
7642,JointPQPlayer,256,256,512,39,9,Tie
7643,JointPQPlayer,269,274,543,55,4,JointPQPlayer
7644,JointPQPlayer,179,179,358,11,51,Tie
7645,JointPQPlayer,265,260,525,43,6,Player A
7646,JointPQPlayer,262,262,524,51,9,Tie
7647,JointPQPlayer,190,190,380,9,43,Tie
7648,JointPQPlayer,231,236,467,36,23,JointPQPlayer
7649,JointPQPlayer,253,248,501,37,12,Player A
7650,JointPQPlayer,259,259,518,51,11,Tie
7651,JointPQPlayer,238,243,481,47,22,JointPQPlayer
7652,JointPQPlayer,273,268,541,53,4,Player A
7653,JointPQPlayer,238,238,476,33,19,Tie
7654,JointPQPlayer,192,197,389,27,46,JointPQPlayer
7655,JointPQPlayer,237,237,474,40,22,Tie
7656,JointPQPlayer,251,246,497,45,16,Player A
7657,JointPQPlayer,248,248,496,35,13,Tie
7658,JointPQPlayer,274,274,548,66,6,Tie
7659,JointPQPlayer,264,264,528,49,7,Tie
7660,JointPQPlayer,245,245,490,47,19,Tie
7661,JointPQPlayer,268,273,541,56,5,JointPQPlayer
7662,JointPQPlayer,259,254,513,46,11,Player A
7663,JointPQPlayer,173,178,351,4,51,JointPQPlayer
7664,JointPQPlayer,216,211,427,23,32,Player A
7665,JointPQPlayer,230,235,465,43,26,JointPQPlayer
7666,JointPQPlayer,249,244,493,44,17,Player A
7667,JointPQPlayer,225,230,455,36,27,JointPQPlayer
7668,JointPQPlayer,266,266,532,50,6,Tie
7669,JointPQPlayer,258,253,511,47,12,Player A
7670,JointPQPlayer,259,259,518,51,11,Tie
7671,JointPQPlayer,255,260,515,48,11,JointPQPlayer
7672,JointPQPlayer,261,256,517,47,10,Player A
7673,JointPQPlayer,257,257,514,53,13,Tie
7674,JointPQPlayer,229,234,463,29,22,JointPQPlayer
7675,JointPQPlayer,256,251,507,40,11,Player A
7676,JointPQPlayer,188,193,381,22,47,JointPQPlayer
7677,JointPQPlayer,265,260,525,52,9,Player A
7678,JointPQPlayer,256,261,517,47,10,JointPQPlayer
7679,JointPQPlayer,214,214,428,30,34,Tie
7680,JointPQPlayer,250,245,495,46,17,Player A
7681,JointPQPlayer,257,262,519,49,10,JointPQPlayer
7682,JointPQPlayer,262,262,524,51,9,Tie
7683,JointPQPlayer,270,265,535,56,7,Player A
7684,JointPQPlayer,259,259,518,45,9,Tie
7685,JointPQPlayer,259,259,518,54,12,Tie
7686,JointPQPlayer,174,179,353,12,53,JointPQPlayer
7687,JointPQPlayer,253,253,506,45,13,Tie
7688,JointPQPlayer,189,189,378,10,44,Tie
7689,JointPQPlayer,257,257,514,44,10,Tie
7690,JointPQPlayer,261,261,522,46,8,Tie
7691,JointPQPlayer,174,169,343,11,56,Player A
7692,JointPQPlayer,252,252,504,43,13,Tie
7693,JointPQPlayer,166,171,337,8,57,JointPQPlayer
7694,JointPQPlayer,271,266,537,52,5,Player A
7695,JointPQPlayer,213,218,431,24,31,JointPQPlayer
7696,JointPQPlayer,248,243,491,42,17,Player A
7697,JointPQPlayer,239,239,478,38,20,Tie
7698,JointPQPlayer,171,176,347,9,54,JointPQPlayer
7699,JointPQPlayer,274,269,543,55,4,Player A
7700,JointPQPlayer,269,274,543,55,4,JointPQPlayer
7701,JointPQPlayer,259,259,518,48,10,Tie
7702,JointPQPlayer,245,245,490,41,17,Tie
7703,JointPQPlayer,249,244,493,38,15,Player A
7704,JointPQPlayer,254,254,508,38,10,Tie
7705,JointPQPlayer,246,246,492,43,17,Tie
7706,JointPQPlayer,256,256,512,48,12,Tie
7707,JointPQPlayer,256,256,512,45,11,Tie
7708,JointPQPlayer,257,257,514,47,11,Tie
7709,JointPQPlayer,256,261,517,41,8,JointPQPlayer
7710,JointPQPlayer,236,231,467,39,24,Player A
7711,JointPQPlayer,265,270,535,56,7,JointPQPlayer
7712,JointPQPlayer,248,243,491,45,18,Player A
7713,JointPQPlayer,260,260,520,47,9,Tie
7714,JointPQPlayer,247,252,499,38,13,JointPQPlayer
7715,JointPQPlayer,260,255,515,48,11,Player A
7716,JointPQPlayer,197,197,394,23,43,Tie
7717,JointPQPlayer,263,268,531,58,9,JointPQPlayer
7718,JointPQPlayer,265,260,525,52,9,Player A
7719,JointPQPlayer,231,236,467,36,23,JointPQPlayer
7720,JointPQPlayer,200,195,395,24,43,Player A
7721,JointPQPlayer,211,211,422,30,36,Tie
7722,JointPQPlayer,217,222,439,20,27,JointPQPlayer
7723,JointPQPlayer,261,261,522,49,9,Tie
7724,JointPQPlayer,186,186,372,13,47,Tie
7725,JointPQPlayer,266,261,527,54,9,Player A
7726,JointPQPlayer,243,243,486,40,18,Tie
7727,JointPQPlayer,249,254,503,48,15,JointPQPlayer
7728,JointPQPlayer,220,215,435,22,29,Player A
7729,JointPQPlayer,189,194,383,6,41,JointPQPlayer
7730,JointPQPlayer,244,239,483,43,20,Player A
7731,JointPQPlayer,260,260,520,53,11,Tie
7732,JointPQPlayer,182,182,364,8,48,Tie
7733,JointPQPlayer,268,268,536,57,7,Tie
7734,JointPQPlayer,180,185,365,9,48,JointPQPlayer
7735,JointPQPlayer,247,242,489,43,18,Player A
7736,JointPQPlayer,250,255,505,44,13,JointPQPlayer
7737,JointPQPlayer,165,165,330,7,59,Tie
7738,JointPQPlayer,263,258,521,39,6,Player A
7739,JointPQPlayer,262,267,529,50,7,JointPQPlayer
7740,JointPQPlayer,270,265,535,53,6,Player A
7741,JointPQPlayer,259,259,518,39,7,Tie
7742,JointPQPlayer,183,188,371,9,46,JointPQPlayer
7743,JointPQPlayer,266,261,527,51,8,Player A
7744,JointPQPlayer,267,267,534,58,8,Tie
7745,JointPQPlayer,247,247,494,39,15,Tie
7746,JointPQPlayer,243,243,486,37,17,Tie
7747,JointPQPlayer,253,253,506,39,11,Tie
7748,JointPQPlayer,246,246,492,49,19,Tie
7749,JointPQPlayer,264,264,528,52,8,Tie
7750,JointPQPlayer,260,265,525,55,10,JointPQPlayer
7751,JointPQPlayer,175,175,350,9,53,Tie
7752,JointPQPlayer,179,179,358,14,52,Tie
7753,JointPQPlayer,259,259,518,51,11,Tie
7754,JointPQPlayer,249,244,493,44,17,Player A
7755,JointPQPlayer,256,256,512,39,9,Tie
7756,JointPQPlayer,245,245,490,41,17,Tie
7757,JointPQPlayer,270,270,540,52,4,Tie
7758,JointPQPlayer,264,269,533,51,6,JointPQPlayer
7759,JointPQPlayer,272,267,539,57,6,Player A
7760,JointPQPlayer,253,258,511,47,12,JointPQPlayer
7761,JointPQPlayer,270,265,535,53,6,Player A
7762,JointPQPlayer,252,252,504,49,15,Tie
7763,JointPQPlayer,248,248,496,44,16,Tie
7764,JointPQPlayer,159,164,323,6,61,JointPQPlayer
7765,JointPQPlayer,265,265,530,51,7,Tie
7766,JointPQPlayer,263,258,521,48,9,Player A
7767,JointPQPlayer,259,259,518,45,9,Tie
7768,JointPQPlayer,260,260,520,44,8,Tie
7769,JointPQPlayer,162,167,329,3,58,JointPQPlayer
7770,JointPQPlayer,266,261,527,51,8,Player A
7771,JointPQPlayer,250,250,500,45,15,Tie
7772,JointPQPlayer,255,260,515,42,9,JointPQPlayer
7773,JointPQPlayer,181,181,362,6,48,Tie
7774,JointPQPlayer,274,269,543,58,5,Player A
7775,JointPQPlayer,241,241,482,39,19,Tie
7776,JointPQPlayer,251,251,502,41,13,Tie
7777,JointPQPlayer,256,256,512,45,11,Tie
7778,JointPQPlayer,248,248,496,38,14,Tie
7779,JointPQPlayer,251,251,502,38,12,Tie
7780,JointPQPlayer,229,234,463,38,25,JointPQPlayer
7781,JointPQPlayer,267,262,529,59,10,Player A
7782,JointPQPlayer,254,259,513,37,8,JointPQPlayer
7783,JointPQPlayer,244,239,483,34,17,Player A
7784,JointPQPlayer,257,257,514,44,10,Tie
7785,JointPQPlayer,239,244,483,46,21,JointPQPlayer
7786,JointPQPlayer,171,171,342,7,55,Tie
7787,JointPQPlayer,197,192,389,12,41,Player A
7788,JointPQPlayer,254,254,508,50,14,Tie
7789,JointPQPlayer,270,270,540,52,4,Tie
7790,JointPQPlayer,243,243,486,46,20,Tie
7791,JointPQPlayer,172,177,349,8,53,JointPQPlayer
7792,JointPQPlayer,221,221,442,35,31,Tie
7793,JointPQPlayer,218,213,431,24,31,Player A
7794,JointPQPlayer,243,243,486,46,20,Tie
7795,JointPQPlayer,272,272,544,59,5,Tie
7796,JointPQPlayer,243,248,491,36,15,JointPQPlayer
7797,JointPQPlayer,263,258,521,45,8,Player A
7798,JointPQPlayer,270,270,540,55,5,Tie
7799,JointPQPlayer,161,166,327,7,60,JointPQPlayer
7800,JointPQPlayer,170,170,340,5,55,Tie
7801,JointPQPlayer,189,189,378,10,44,Tie
7802,JointPQPlayer,254,249,503,48,15,Player A
7803,JointPQPlayer,251,251,502,44,14,Tie
7804,JointPQPlayer,222,227,449,33,28,JointPQPlayer
7805,JointPQPlayer,262,262,524,51,9,Tie
7806,JointPQPlayer,277,272,549,58,3,Player A
7807,JointPQPlayer,214,214,428,33,35,Tie
7808,JointPQPlayer,267,267,534,52,6,Tie
7809,JointPQPlayer,226,226,452,39,29,Tie
7810,JointPQPlayer,261,266,527,51,8,JointPQPlayer
7811,JointPQPlayer,260,255,515,45,10,Player A
7812,JointPQPlayer,280,280,560,66,2,Tie
7813,JointPQPlayer,268,268,536,48,4,Tie
7814,JointPQPlayer,249,254,503,39,12,JointPQPlayer
7815,JointPQPlayer,230,230,460,38,26,Tie
7816,JointPQPlayer,259,259,518,54,12,Tie
7817,JointPQPlayer,254,249,503,45,14,Player A
7818,JointPQPlayer,267,267,534,49,5,Tie
7819,JointPQPlayer,208,208,416,24,36,Tie
7820,JointPQPlayer,258,263,521,48,9,JointPQPlayer
7821,JointPQPlayer,260,255,515,48,11,Player A
7822,JointPQPlayer,246,246,492,43,17,Tie
7823,JointPQPlayer,256,256,512,45,11,Tie
7824,JointPQPlayer,266,271,537,52,5,JointPQPlayer
7825,JointPQPlayer,231,231,462,37,25,Tie
7826,JointPQPlayer,249,244,493,41,16,Player A
7827,JointPQPlayer,190,195,385,14,43,JointPQPlayer
7828,JointPQPlayer,266,261,527,54,9,Player A
7829,JointPQPlayer,268,268,536,51,5,Tie
7830,JointPQPlayer,268,268,536,51,5,Tie
7831,JointPQPlayer,259,264,523,53,10,JointPQPlayer
7832,JointPQPlayer,214,214,428,30,34,Tie
7833,JointPQPlayer,266,266,532,59,9,Tie
7834,JointPQPlayer,241,236,477,37,20,Player A
7835,JointPQPlayer,226,226,452,36,28,Tie
7836,JointPQPlayer,255,255,510,46,12,Tie
7837,JointPQPlayer,271,271,542,57,5,Tie
7838,JointPQPlayer,251,251,502,47,15,Tie
7839,JointPQPlayer,150,150,300,4,68,Tie
7840,JointPQPlayer,254,254,508,41,11,Tie
7841,JointPQPlayer,176,181,357,1,48,JointPQPlayer
7842,JointPQPlayer,260,255,515,39,8,Player A
7843,JointPQPlayer,243,243,486,43,19,Tie
7844,JointPQPlayer,266,266,532,56,8,Tie
7845,JointPQPlayer,249,254,503,39,12,JointPQPlayer
7846,JointPQPlayer,263,258,521,45,8,Player A
7847,JointPQPlayer,200,200,400,14,38,Tie
7848,JointPQPlayer,230,230,460,35,25,Tie
7849,JointPQPlayer,273,273,546,49,1,Tie
7850,JointPQPlayer,228,228,456,28,24,Tie
7851,JointPQPlayer,244,244,488,39,17,Tie
7852,JointPQPlayer,193,198,391,20,43,JointPQPlayer
7853,JointPQPlayer,219,219,438,34,32,Tie
7854,JointPQPlayer,196,191,387,16,43,Player A
7855,JointPQPlayer,227,227,454,32,26,Tie
7856,JointPQPlayer,175,180,355,11,52,JointPQPlayer
7857,JointPQPlayer,268,263,531,55,8,Player A
7858,JointPQPlayer,251,251,502,41,13,Tie
7859,JointPQPlayer,257,257,514,50,12,Tie
7860,JointPQPlayer,260,260,520,44,8,Tie
7861,JointPQPlayer,160,165,325,11,62,JointPQPlayer
7862,JointPQPlayer,274,274,548,60,4,Tie
7863,JointPQPlayer,261,256,517,47,10,Player A
7864,JointPQPlayer,205,210,415,20,35,JointPQPlayer
7865,JointPQPlayer,263,263,526,47,7,Tie
7866,JointPQPlayer,215,210,425,27,34,Player A
7867,JointPQPlayer,214,214,428,24,32,Tie
7868,JointPQPlayer,200,200,400,29,43,Tie
7869,JointPQPlayer,243,243,486,37,17,Tie
7870,JointPQPlayer,210,215,425,21,32,JointPQPlayer
7871,JointPQPlayer,175,175,350,6,52,Tie
7872,JointPQPlayer,201,196,397,23,42,Player A
7873,JointPQPlayer,273,278,551,60,3,JointPQPlayer
7874,JointPQPlayer,246,246,492,40,16,Tie
7875,JointPQPlayer,218,213,431,30,33,Player A
7876,JointPQPlayer,241,241,482,42,20,Tie
7877,JointPQPlayer,257,257,514,44,10,Tie
7878,JointPQPlayer,263,263,526,53,9,Tie
7879,JointPQPlayer,262,262,524,51,9,Tie
7880,JointPQPlayer,274,274,548,57,3,Tie
7881,JointPQPlayer,263,263,526,47,7,Tie
7882,JointPQPlayer,264,264,528,55,9,Tie
7883,JointPQPlayer,255,255,510,49,13,Tie
7884,JointPQPlayer,247,247,494,45,17,Tie
7885,JointPQPlayer,230,230,460,29,23,Tie
7886,JointPQPlayer,232,237,469,38,23,JointPQPlayer
7887,JointPQPlayer,258,253,511,47,12,Player A
7888,JointPQPlayer,169,169,338,6,56,Tie
7889,JointPQPlayer,269,274,543,58,5,JointPQPlayer
7890,JointPQPlayer,235,230,465,37,24,Player A
7891,JointPQPlayer,262,262,524,51,9,Tie
7892,JointPQPlayer,246,246,492,43,17,Tie
7893,JointPQPlayer,266,271,537,52,5,JointPQPlayer
7894,JointPQPlayer,242,237,479,45,22,Player A
7895,JointPQPlayer,169,169,338,9,57,Tie
7896,JointPQPlayer,229,229,458,36,26,Tie
7897,JointPQPlayer,181,186,367,11,48,JointPQPlayer
7898,JointPQPlayer,206,206,412,17,35,Tie
7899,JointPQPlayer,258,258,516,46,10,Tie
7900,JointPQPlayer,259,254,513,52,13,Player A
7901,JointPQPlayer,180,185,365,9,48,JointPQPlayer
7902,JointPQPlayer,184,179,363,13,50,Player A
7903,JointPQPlayer,254,259,513,49,12,JointPQPlayer
7904,JointPQPlayer,202,202,404,18,38,Tie
7905,JointPQPlayer,261,256,517,44,9,Player A
7906,JointPQPlayer,252,257,509,45,12,JointPQPlayer
7907,JointPQPlayer,189,189,378,19,47,Tie
7908,JointPQPlayer,220,215,435,34,33,Player A
7909,JointPQPlayer,267,272,539,54,5,JointPQPlayer
7910,JointPQPlayer,262,262,524,51,9,Tie
7911,JointPQPlayer,243,238,481,38,19,Player A
7912,JointPQPlayer,247,247,494,48,18,Tie
7913,JointPQPlayer,264,264,528,49,7,Tie
7914,JointPQPlayer,249,249,498,43,15,Tie
7915,JointPQPlayer,249,249,498,46,16,Tie
7916,JointPQPlayer,250,250,500,42,14,Tie
7917,JointPQPlayer,220,220,440,30,30,Tie
7918,JointPQPlayer,232,232,464,33,23,Tie
7919,JointPQPlayer,256,256,512,48,12,Tie
7920,JointPQPlayer,191,196,387,16,43,JointPQPlayer
7921,JointPQPlayer,239,234,473,39,22,Player A
7922,JointPQPlayer,267,272,539,54,5,JointPQPlayer
7923,JointPQPlayer,238,233,471,43,24,Player A
7924,JointPQPlayer,186,186,372,16,48,Tie
7925,JointPQPlayer,171,171,342,7,55,Tie
7926,JointPQPlayer,240,240,480,40,20,Tie
7927,JointPQPlayer,222,222,444,28,28,Tie
7928,JointPQPlayer,267,267,534,49,5,Tie
7929,JointPQPlayer,250,250,500,39,13,Tie
7930,JointPQPlayer,261,261,522,58,12,Tie
7931,JointPQPlayer,252,252,504,43,13,Tie
7932,JointPQPlayer,191,196,387,25,46,JointPQPlayer
7933,JointPQPlayer,265,260,525,55,10,Player A
7934,JointPQPlayer,209,209,418,20,34,Tie
7935,JointPQPlayer,258,258,516,55,13,Tie
7936,JointPQPlayer,266,271,537,52,5,JointPQPlayer
7937,JointPQPlayer,257,257,514,44,10,Tie
7938,JointPQPlayer,259,254,513,43,10,Player A
7939,JointPQPlayer,256,256,512,48,12,Tie
7940,JointPQPlayer,264,264,528,43,5,Tie
7941,JointPQPlayer,263,263,526,50,8,Tie
7942,JointPQPlayer,248,248,496,41,15,Tie
7943,JointPQPlayer,228,228,456,28,24,Tie
7944,JointPQPlayer,222,222,444,37,31,Tie
7945,JointPQPlayer,260,260,520,47,9,Tie
7946,JointPQPlayer,267,267,534,52,6,Tie
7947,JointPQPlayer,241,241,482,48,22,Tie
7948,JointPQPlayer,231,231,462,34,24,Tie
7949,JointPQPlayer,237,237,474,43,23,Tie
7950,JointPQPlayer,255,255,510,49,13,Tie
7951,JointPQPlayer,256,261,517,53,12,JointPQPlayer
7952,JointPQPlayer,244,239,483,49,22,Player A
7953,JointPQPlayer,259,259,518,42,8,Tie
7954,JointPQPlayer,260,260,520,41,7,Tie
7955,JointPQPlayer,255,255,510,43,11,Tie
7956,JointPQPlayer,254,254,508,47,13,Tie
7957,JointPQPlayer,216,221,437,27,30,JointPQPlayer
7958,JointPQPlayer,251,251,502,47,15,Tie
7959,JointPQPlayer,254,249,503,45,14,Player A
7960,JointPQPlayer,271,276,547,59,4,JointPQPlayer
7961,JointPQPlayer,270,270,540,61,7,Tie
7962,JointPQPlayer,228,223,451,32,27,Player A
7963,JointPQPlayer,261,261,522,46,8,Tie
7964,JointPQPlayer,277,277,554,60,2,Tie
7965,JointPQPlayer,252,252,504,43,13,Tie
7966,JointPQPlayer,256,256,512,51,13,Tie
7967,JointPQPlayer,253,253,506,51,15,Tie
7968,JointPQPlayer,267,267,534,52,6,Tie
7969,JointPQPlayer,267,267,534,52,6,Tie
7970,JointPQPlayer,260,260,520,50,10,Tie
7971,JointPQPlayer,244,249,493,38,15,JointPQPlayer
7972,JointPQPlayer,243,238,481,38,19,Player A
7973,JointPQPlayer,258,258,516,43,9,Tie
7974,JointPQPlayer,239,239,478,47,23,Tie
7975,JointPQPlayer,251,251,502,38,12,Tie
7976,JointPQPlayer,256,256,512,45,11,Tie
7977,JointPQPlayer,218,218,436,17,27,Tie
7978,JointPQPlayer,216,221,437,39,34,JointPQPlayer
7979,JointPQPlayer,207,207,414,22,36,Tie
7980,JointPQPlayer,255,250,505,38,11,Player A
7981,JointPQPlayer,265,265,530,51,7,Tie
7982,JointPQPlayer,253,258,511,41,10,JointPQPlayer
7983,JointPQPlayer,201,201,402,22,40,Tie
7984,JointPQPlayer,263,258,521,45,8,Player A
7985,JointPQPlayer,257,262,519,49,10,JointPQPlayer
7986,JointPQPlayer,240,240,480,37,19,Tie
7987,JointPQPlayer,260,255,515,48,11,Player A
7988,JointPQPlayer,262,267,529,47,6,JointPQPlayer
7989,JointPQPlayer,269,269,538,56,6,Tie
7990,JointPQPlayer,180,180,360,13,51,Tie
7991,JointPQPlayer,241,236,477,31,18,Player A
7992,JointPQPlayer,261,266,527,51,8,JointPQPlayer
7993,JointPQPlayer,219,214,433,38,35,Player A
7994,JointPQPlayer,161,166,327,7,60,JointPQPlayer
7995,JointPQPlayer,257,252,509,48,13,Player A
7996,JointPQPlayer,265,270,535,50,5,JointPQPlayer
7997,JointPQPlayer,245,240,485,42,19,Player A
7998,JointPQPlayer,241,241,482,42,20,Tie
7999,JointPQPlayer,239,239,478,38,20,Tie
8000,JointPQPlayer,251,251,502,53,17,Tie
8001,JointPQPlayer,218,218,436,20,28,Tie
8002,JointPQPlayer,177,182,359,9,50,JointPQPlayer
8003,JointPQPlayer,242,237,479,39,20,Player A
8004,JointPQPlayer,174,179,353,9,52,JointPQPlayer
8005,JointPQPlayer,192,187,379,14,45,Player A
8006,JointPQPlayer,249,249,498,37,13,Tie
8007,JointPQPlayer,255,260,515,45,10,JointPQPlayer
8008,JointPQPlayer,250,250,500,42,14,Tie
8009,JointPQPlayer,217,212,429,22,31,Player A
8010,JointPQPlayer,199,204,403,23,40,JointPQPlayer
8011,JointPQPlayer,264,259,523,50,9,Player A
8012,JointPQPlayer,177,177,354,7,51,Tie
8013,JointPQPlayer,177,182,359,9,50,JointPQPlayer
8014,JointPQPlayer,189,189,378,13,45,Tie
8015,JointPQPlayer,254,254,508,47,13,Tie
8016,JointPQPlayer,264,264,528,52,8,Tie
8017,JointPQPlayer,261,261,522,49,9,Tie
8018,JointPQPlayer,242,242,484,35,17,Tie
8019,JointPQPlayer,270,265,535,59,8,Player A
8020,JointPQPlayer,247,247,494,48,18,Tie
8021,JointPQPlayer,227,232,459,34,25,JointPQPlayer
8022,JointPQPlayer,265,265,530,51,7,Tie
8023,JointPQPlayer,247,242,489,40,17,Player A
8024,JointPQPlayer,263,268,531,55,8,JointPQPlayer
8025,JointPQPlayer,197,197,394,17,41,Tie
8026,JointPQPlayer,267,262,529,56,9,Player A
8027,JointPQPlayer,259,259,518,48,10,Tie
8028,JointPQPlayer,263,268,531,52,7,JointPQPlayer
8029,JointPQPlayer,265,260,525,46,7,Player A
8030,JointPQPlayer,210,215,425,27,34,JointPQPlayer
8031,JointPQPlayer,240,235,475,41,22,Player A
8032,JointPQPlayer,265,265,530,57,9,Tie
8033,JointPQPlayer,243,243,486,46,20,Tie
8034,JointPQPlayer,263,268,531,55,8,JointPQPlayer
8035,JointPQPlayer,243,243,486,40,18,Tie
8036,JointPQPlayer,258,253,511,41,10,Player A
8037,JointPQPlayer,181,186,367,8,47,JointPQPlayer
8038,JointPQPlayer,241,236,477,34,19,Player A
8039,JointPQPlayer,228,228,456,31,25,Tie
8040,JointPQPlayer,249,254,503,45,14,JointPQPlayer
8041,JointPQPlayer,266,261,527,54,9,Player A
8042,JointPQPlayer,248,248,496,56,20,Tie
8043,JointPQPlayer,182,187,369,13,48,JointPQPlayer
8044,JointPQPlayer,261,256,517,41,8,Player A
8045,JointPQPlayer,264,264,528,58,10,Tie
8046,JointPQPlayer,263,268,531,49,6,JointPQPlayer
8047,JointPQPlayer,270,265,535,53,6,Player A
8048,JointPQPlayer,275,275,550,59,3,Tie
8049,JointPQPlayer,252,252,504,46,14,Tie
8050,JointPQPlayer,258,258,516,52,12,Tie
8051,JointPQPlayer,266,266,532,50,6,Tie
8052,JointPQPlayer,264,269,533,54,7,JointPQPlayer
8053,JointPQPlayer,265,260,525,49,8,Player A
8054,JointPQPlayer,189,189,378,19,47,Tie
8055,JointPQPlayer,169,174,343,8,55,JointPQPlayer
8056,JointPQPlayer,267,267,534,55,7,Tie
8057,JointPQPlayer,248,248,496,44,16,Tie
8058,JointPQPlayer,194,194,388,20,44,Tie
8059,JointPQPlayer,241,236,477,43,22,Player A
8060,JointPQPlayer,229,229,458,33,25,Tie
8061,JointPQPlayer,258,258,516,46,10,Tie
8062,JointPQPlayer,175,180,355,8,51,JointPQPlayer
8063,JointPQPlayer,228,228,456,34,26,Tie
8064,JointPQPlayer,235,230,465,37,24,Player A
8065,JointPQPlayer,259,264,523,50,9,JointPQPlayer
8066,JointPQPlayer,230,230,460,35,25,Tie
8067,JointPQPlayer,260,255,515,45,10,Player A
8068,JointPQPlayer,224,224,448,23,25,Tie
8069,JointPQPlayer,252,252,504,52,16,Tie
8070,JointPQPlayer,178,178,356,9,51,Tie
8071,JointPQPlayer,181,181,362,15,51,Tie
8072,JointPQPlayer,250,250,500,42,14,Tie
8073,JointPQPlayer,264,269,533,42,3,JointPQPlayer
8074,JointPQPlayer,234,229,463,38,25,Player A
8075,JointPQPlayer,226,226,452,33,27,Tie
8076,JointPQPlayer,221,226,447,28,27,JointPQPlayer
8077,JointPQPlayer,255,250,505,44,13,Player A
8078,JointPQPlayer,263,263,526,47,7,Tie
8079,JointPQPlayer,200,205,405,19,38,JointPQPlayer
8080,JointPQPlayer,243,238,481,44,21,Player A
8081,JointPQPlayer,187,192,379,8,43,JointPQPlayer
8082,JointPQPlayer,248,243,491,39,16,Player A
8083,JointPQPlayer,176,176,352,8,52,Tie
8084,JointPQPlayer,241,246,487,44,19,JointPQPlayer
8085,JointPQPlayer,263,263,526,53,9,Tie
8086,JointPQPlayer,185,185,370,8,46,Tie
8087,JointPQPlayer,238,233,471,34,21,Player A
8088,JointPQPlayer,255,255,510,43,11,Tie
8089,JointPQPlayer,270,270,540,55,5,Tie
8090,JointPQPlayer,249,249,498,46,16,Tie
8091,JointPQPlayer,240,245,485,42,19,JointPQPlayer
8092,JointPQPlayer,239,239,478,41,21,Tie
8093,JointPQPlayer,164,164,328,5,59,Tie
8094,JointPQPlayer,219,219,438,37,33,Tie
8095,JointPQPlayer,272,267,539,60,7,Player A
8096,JointPQPlayer,195,195,390,10,40,Tie
8097,JointPQPlayer,184,184,368,9,47,Tie
8098,JointPQPlayer,265,265,530,54,8,Tie
8099,JointPQPlayer,255,255,510,40,10,Tie
8100,JointPQPlayer,260,260,520,53,11,Tie
8101,JointPQPlayer,219,224,443,30,29,JointPQPlayer
8102,JointPQPlayer,253,248,501,43,14,Player A
8103,JointPQPlayer,262,262,524,51,9,Tie
8104,JointPQPlayer,245,250,495,43,16,JointPQPlayer
8105,JointPQPlayer,183,183,366,13,49,Tie
8106,JointPQPlayer,160,155,315,4,63,Player A
8107,JointPQPlayer,245,245,490,41,17,Tie
8108,JointPQPlayer,185,190,375,7,44,JointPQPlayer
8109,JointPQPlayer,264,259,523,53,10,Player A
8110,JointPQPlayer,265,265,530,48,6,Tie
8111,JointPQPlayer,258,258,516,43,9,Tie
8112,JointPQPlayer,245,250,495,40,15,JointPQPlayer
8113,JointPQPlayer,240,235,475,35,20,Player A
8114,JointPQPlayer,191,196,387,22,45,JointPQPlayer
8115,JointPQPlayer,256,256,512,45,11,Tie
8116,JointPQPlayer,270,270,540,58,6,Tie
8117,JointPQPlayer,256,251,507,46,13,Player A
8118,JointPQPlayer,268,268,536,51,5,Tie
8119,JointPQPlayer,254,254,508,47,13,Tie
8120,JointPQPlayer,230,235,465,31,22,JointPQPlayer
8121,JointPQPlayer,259,254,513,43,10,Player A
8122,JointPQPlayer,265,265,530,54,8,Tie
8123,JointPQPlayer,258,263,521,51,10,JointPQPlayer
8124,JointPQPlayer,246,241,487,35,16,Player A
8125,JointPQPlayer,183,188,371,12,47,JointPQPlayer
8126,JointPQPlayer,243,243,486,46,20,Tie
8127,JointPQPlayer,191,186,377,12,45,Player A
8128,JointPQPlayer,247,247,494,39,15,Tie
8129,JointPQPlayer,254,254,508,47,13,Tie
8130,JointPQPlayer,253,253,506,42,12,Tie
8131,JointPQPlayer,262,262,524,48,8,Tie
8132,JointPQPlayer,238,243,481,38,19,JointPQPlayer
8133,JointPQPlayer,260,255,515,48,11,Player A
8134,JointPQPlayer,255,255,510,43,11,Tie
8135,JointPQPlayer,233,233,466,41,25,Tie
8136,JointPQPlayer,267,272,539,51,4,JointPQPlayer
8137,JointPQPlayer,174,169,343,8,55,Player A
8138,JointPQPlayer,235,235,470,39,23,Tie
8139,JointPQPlayer,268,268,536,54,6,Tie
8140,JointPQPlayer,235,240,475,41,22,JointPQPlayer
8141,JointPQPlayer,176,171,347,9,54,Player A
8142,JointPQPlayer,254,259,513,46,11,JointPQPlayer
8143,JointPQPlayer,268,263,531,52,7,Player A
8144,JointPQPlayer,267,267,534,61,9,Tie
8145,JointPQPlayer,184,189,373,5,44,JointPQPlayer
8146,JointPQPlayer,276,271,547,56,3,Player A
8147,JointPQPlayer,232,232,464,27,21,Tie
8148,JointPQPlayer,236,236,472,41,23,Tie
8149,JointPQPlayer,263,263,526,53,9,Tie
8150,JointPQPlayer,246,246,492,43,17,Tie
8151,JointPQPlayer,239,239,478,47,23,Tie
8152,JointPQPlayer,253,253,506,42,12,Tie
8153,JointPQPlayer,235,240,475,38,21,JointPQPlayer
8154,JointPQPlayer,245,240,485,39,18,Player A
8155,JointPQPlayer,225,225,450,28,26,Tie
8156,JointPQPlayer,256,261,517,41,8,JointPQPlayer
8157,JointPQPlayer,259,259,518,45,9,Tie
8158,JointPQPlayer,259,254,513,46,11,Player A
8159,JointPQPlayer,222,222,444,34,30,Tie
8160,JointPQPlayer,266,266,532,53,7,Tie
8161,JointPQPlayer,177,182,359,9,50,JointPQPlayer
8162,JointPQPlayer,265,260,525,55,10,Player A
8163,JointPQPlayer,234,234,468,40,24,Tie
8164,JointPQPlayer,245,245,490,35,15,Tie
8165,JointPQPlayer,242,242,484,44,20,Tie
8166,JointPQPlayer,267,267,534,43,3,Tie
8167,JointPQPlayer,225,225,450,34,28,Tie
8168,JointPQPlayer,256,256,512,39,9,Tie
8169,JointPQPlayer,268,268,536,57,7,Tie
8170,JointPQPlayer,236,236,472,44,24,Tie
8171,JointPQPlayer,243,243,486,46,20,Tie
8172,JointPQPlayer,165,170,335,9,58,JointPQPlayer
8173,JointPQPlayer,252,252,504,52,16,Tie
8174,JointPQPlayer,217,217,434,27,31,Tie
8175,JointPQPlayer,270,270,540,55,5,Tie
8176,JointPQPlayer,269,264,533,45,4,Player A
8177,JointPQPlayer,262,262,524,54,10,Tie
8178,JointPQPlayer,222,227,449,33,28,JointPQPlayer
8179,JointPQPlayer,269,264,533,54,7,Player A
8180,JointPQPlayer,163,168,331,5,58,JointPQPlayer
8181,JointPQPlayer,175,175,350,9,53,Tie
8182,JointPQPlayer,269,264,533,54,7,Player A
8183,JointPQPlayer,252,252,504,46,14,Tie
8184,JointPQPlayer,217,217,434,21,29,Tie
8185,JointPQPlayer,158,163,321,7,62,JointPQPlayer
8186,JointPQPlayer,273,268,541,53,4,Player A
8187,JointPQPlayer,271,271,542,57,5,Tie
8188,JointPQPlayer,245,245,490,38,16,Tie
8189,JointPQPlayer,273,273,546,55,3,Tie
8190,JointPQPlayer,204,204,408,25,39,Tie
8191,JointPQPlayer,172,172,344,6,54,Tie
8192,JointPQPlayer,245,245,490,50,20,Tie
8193,JointPQPlayer,178,178,356,9,51,Tie
8194,JointPQPlayer,245,245,490,44,18,Tie
8195,JointPQPlayer,245,245,490,41,17,Tie
8196,JointPQPlayer,239,239,478,47,23,Tie
8197,JointPQPlayer,239,239,478,35,19,Tie
8198,JointPQPlayer,244,244,488,39,17,Tie
8199,JointPQPlayer,263,263,526,56,10,Tie
8200,JointPQPlayer,256,256,512,39,9,Tie
8201,JointPQPlayer,243,248,491,39,16,JointPQPlayer
8202,JointPQPlayer,256,256,512,42,10,Tie
8203,JointPQPlayer,163,158,321,7,62,Player A
8204,JointPQPlayer,210,215,425,27,34,JointPQPlayer
8205,JointPQPlayer,186,186,372,10,46,Tie
8206,JointPQPlayer,234,234,468,34,22,Tie
8207,JointPQPlayer,263,258,521,45,8,Player A
8208,JointPQPlayer,262,262,524,54,10,Tie
8209,JointPQPlayer,221,221,442,29,29,Tie
8210,JointPQPlayer,267,267,534,49,5,Tie
8211,JointPQPlayer,259,259,518,51,11,Tie
8212,JointPQPlayer,222,227,449,33,28,JointPQPlayer
8213,JointPQPlayer,261,256,517,47,10,Player A
8214,JointPQPlayer,192,197,389,24,45,JointPQPlayer
8215,JointPQPlayer,250,245,495,43,16,Player A
8216,JointPQPlayer,242,242,484,41,19,Tie
8217,JointPQPlayer,275,280,555,64,3,JointPQPlayer
8218,JointPQPlayer,211,211,422,33,37,Tie
8219,JointPQPlayer,263,263,526,56,10,Tie
8220,JointPQPlayer,164,159,323,6,61,Player A
8221,JointPQPlayer,256,256,512,42,10,Tie
8222,JointPQPlayer,272,277,549,64,5,JointPQPlayer
8223,JointPQPlayer,267,262,529,50,7,Player A
8224,JointPQPlayer,252,252,504,43,13,Tie
8225,JointPQPlayer,250,255,505,53,16,JointPQPlayer
8226,JointPQPlayer,241,236,477,40,21,Player A
8227,JointPQPlayer,266,266,532,38,2,Tie
8228,JointPQPlayer,258,263,521,42,7,JointPQPlayer
8229,JointPQPlayer,172,172,344,6,54,Tie
8230,JointPQPlayer,250,245,495,43,16,Player A
8231,JointPQPlayer,241,241,482,39,19,Tie
8232,JointPQPlayer,239,244,483,37,18,JointPQPlayer
8233,JointPQPlayer,248,243,491,42,17,Player A
8234,JointPQPlayer,251,251,502,47,15,Tie
8235,JointPQPlayer,258,258,516,46,10,Tie
8236,JointPQPlayer,172,177,349,5,52,JointPQPlayer
8237,JointPQPlayer,248,243,491,36,15,Player A
8238,JointPQPlayer,257,257,514,50,12,Tie
8239,JointPQPlayer,265,270,535,50,5,JointPQPlayer
8240,JointPQPlayer,244,239,483,34,17,Player A
8241,JointPQPlayer,244,249,493,38,15,JointPQPlayer
8242,JointPQPlayer,196,196,392,21,43,Tie
8243,JointPQPlayer,223,223,446,24,26,Tie
8244,JointPQPlayer,243,243,486,37,17,Tie
8245,JointPQPlayer,257,252,509,39,10,Player A
8246,JointPQPlayer,240,240,480,37,19,Tie
8247,JointPQPlayer,261,266,527,54,9,JointPQPlayer
8248,JointPQPlayer,236,231,467,27,20,Player A
8249,JointPQPlayer,274,274,548,60,4,Tie
8250,JointPQPlayer,263,268,531,58,9,JointPQPlayer
8251,JointPQPlayer,267,262,529,50,7,Player A
8252,JointPQPlayer,271,271,542,54,4,Tie
8253,JointPQPlayer,256,261,517,41,8,JointPQPlayer
8254,JointPQPlayer,259,259,518,48,10,Tie
8255,JointPQPlayer,259,254,513,43,10,Player A
8256,JointPQPlayer,273,273,546,58,4,Tie
8257,JointPQPlayer,195,200,395,18,41,JointPQPlayer
8258,JointPQPlayer,268,263,531,55,8,Player A
8259,JointPQPlayer,257,257,514,53,13,Tie
8260,JointPQPlayer,266,266,532,53,7,Tie
8261,JointPQPlayer,226,226,452,33,27,Tie
8262,JointPQPlayer,245,250,495,40,15,JointPQPlayer
8263,JointPQPlayer,174,174,348,10,54,Tie
8264,JointPQPlayer,254,249,503,48,15,Player A
8265,JointPQPlayer,218,218,436,32,32,Tie
8266,JointPQPlayer,265,270,535,53,6,JointPQPlayer
8267,JointPQPlayer,162,157,319,5,62,Player A
8268,JointPQPlayer,272,277,549,58,3,JointPQPlayer
8269,JointPQPlayer,231,231,462,40,26,Tie
8270,JointPQPlayer,253,253,506,48,14,Tie
8271,JointPQPlayer,255,255,510,46,12,Tie
8272,JointPQPlayer,264,259,523,53,10,Player A
8273,JointPQPlayer,200,205,405,25,40,JointPQPlayer
8274,JointPQPlayer,261,256,517,50,11,Player A
8275,JointPQPlayer,254,254,508,44,12,Tie
8276,JointPQPlayer,263,263,526,53,9,Tie
8277,JointPQPlayer,263,263,526,47,7,Tie
8278,JointPQPlayer,153,158,311,6,65,JointPQPlayer
8279,JointPQPlayer,227,222,449,39,30,Player A
8280,JointPQPlayer,235,235,470,36,22,Tie
8281,JointPQPlayer,233,233,466,38,24,Tie
8282,JointPQPlayer,256,256,512,45,11,Tie
8283,JointPQPlayer,247,252,499,41,14,JointPQPlayer
8284,JointPQPlayer,172,167,339,4,55,Player A
8285,JointPQPlayer,246,246,492,46,18,Tie
8286,JointPQPlayer,228,228,456,34,26,Tie
8287,JointPQPlayer,254,259,513,43,10,JointPQPlayer
8288,JointPQPlayer,264,264,528,55,9,Tie
8289,JointPQPlayer,280,275,555,67,4,Player A
8290,JointPQPlayer,266,271,537,52,5,JointPQPlayer
8291,JointPQPlayer,259,254,513,49,12,Player A
8292,JointPQPlayer,216,221,437,27,30,JointPQPlayer
8293,JointPQPlayer,220,215,435,31,32,Player A
8294,JointPQPlayer,256,261,517,50,11,JointPQPlayer
8295,JointPQPlayer,235,230,465,43,26,Player A
8296,JointPQPlayer,272,272,544,59,5,Tie
8297,JointPQPlayer,265,265,530,51,7,Tie
8298,JointPQPlayer,170,170,340,5,55,Tie
8299,JointPQPlayer,234,234,468,40,24,Tie
8300,JointPQPlayer,209,214,423,31,36,JointPQPlayer
8301,JointPQPlayer,232,232,464,36,24,Tie
8302,JointPQPlayer,252,247,499,44,15,Player A
8303,JointPQPlayer,258,263,521,51,10,JointPQPlayer
8304,JointPQPlayer,201,196,397,23,42,Player A
8305,JointPQPlayer,203,203,406,20,38,Tie
8306,JointPQPlayer,261,261,522,46,8,Tie
8307,JointPQPlayer,257,257,514,47,11,Tie
8308,JointPQPlayer,267,267,534,49,5,Tie
8309,JointPQPlayer,259,259,518,51,11,Tie
8310,JointPQPlayer,221,221,442,29,29,Tie
8311,JointPQPlayer,263,268,531,49,6,JointPQPlayer
8312,JointPQPlayer,274,269,543,67,8,Player A
8313,JointPQPlayer,220,225,445,38,31,JointPQPlayer
8314,JointPQPlayer,184,179,363,4,47,Player A
8315,JointPQPlayer,247,247,494,42,16,Tie
8316,JointPQPlayer,239,239,478,35,19,Tie
8317,JointPQPlayer,259,264,523,59,12,JointPQPlayer
8318,JointPQPlayer,240,235,475,41,22,Player A
8319,JointPQPlayer,253,253,506,48,14,Tie
8320,JointPQPlayer,234,234,468,43,25,Tie
8321,JointPQPlayer,222,227,449,33,28,JointPQPlayer
8322,JointPQPlayer,259,254,513,49,12,Player A
8323,JointPQPlayer,211,211,422,24,34,Tie
8324,JointPQPlayer,266,266,532,53,7,Tie
8325,JointPQPlayer,255,255,510,46,12,Tie
8326,JointPQPlayer,178,178,356,9,51,Tie
8327,JointPQPlayer,230,230,460,29,23,Tie
8328,JointPQPlayer,184,189,373,11,46,JointPQPlayer
8329,JointPQPlayer,250,245,495,49,18,Player A
8330,JointPQPlayer,240,245,485,42,19,JointPQPlayer
8331,JointPQPlayer,212,207,419,27,36,Player A
8332,JointPQPlayer,232,232,464,33,23,Tie
8333,JointPQPlayer,261,261,522,52,10,Tie
8334,JointPQPlayer,263,263,526,47,7,Tie
8335,JointPQPlayer,272,272,544,65,7,Tie
8336,JointPQPlayer,263,263,526,50,8,Tie
8337,JointPQPlayer,266,266,532,50,6,Tie
8338,JointPQPlayer,210,210,420,22,34,Tie
8339,JointPQPlayer,172,172,344,9,55,Tie
8340,JointPQPlayer,268,268,536,54,6,Tie
8341,JointPQPlayer,245,245,490,32,14,Tie
8342,JointPQPlayer,247,247,494,42,16,Tie
8343,JointPQPlayer,174,179,353,6,51,JointPQPlayer
8344,JointPQPlayer,234,234,468,37,23,Tie
8345,JointPQPlayer,260,260,520,38,6,Tie
8346,JointPQPlayer,264,259,523,50,9,Player A
8347,JointPQPlayer,265,265,530,54,8,Tie
8348,JointPQPlayer,258,258,516,43,9,Tie
8349,JointPQPlayer,271,271,542,57,5,Tie
8350,JointPQPlayer,231,231,462,34,24,Tie
8351,JointPQPlayer,171,171,342,13,57,Tie
8352,JointPQPlayer,246,246,492,49,19,Tie
8353,JointPQPlayer,253,258,511,47,12,JointPQPlayer
8354,JointPQPlayer,173,173,346,8,54,Tie
8355,JointPQPlayer,205,200,405,16,37,Player A
8356,JointPQPlayer,212,212,424,32,36,Tie
8357,JointPQPlayer,262,262,524,45,7,Tie
8358,JointPQPlayer,250,255,505,47,14,JointPQPlayer
8359,JointPQPlayer,198,193,391,23,44,Player A
8360,JointPQPlayer,266,266,532,50,6,Tie
8361,JointPQPlayer,269,269,538,56,6,Tie
8362,JointPQPlayer,255,255,510,49,13,Tie
8363,JointPQPlayer,223,223,446,30,28,Tie
8364,JointPQPlayer,265,265,530,54,8,Tie
8365,JointPQPlayer,268,268,536,60,8,Tie
8366,JointPQPlayer,241,241,482,39,19,Tie
8367,JointPQPlayer,187,192,379,11,44,JointPQPlayer
8368,JointPQPlayer,244,244,488,39,17,Tie
8369,JointPQPlayer,237,232,469,38,23,Player A
8370,JointPQPlayer,227,232,459,34,25,JointPQPlayer
8371,JointPQPlayer,241,236,477,34,19,Player A
8372,JointPQPlayer,210,215,425,27,34,JointPQPlayer
8373,JointPQPlayer,266,266,532,50,6,Tie
8374,JointPQPlayer,261,261,522,46,8,Tie
8375,JointPQPlayer,256,251,507,52,15,Player A
8376,JointPQPlayer,247,247,494,45,17,Tie
8377,JointPQPlayer,193,198,391,8,39,JointPQPlayer
8378,JointPQPlayer,265,260,525,43,6,Player A
8379,JointPQPlayer,262,262,524,48,8,Tie
8380,JointPQPlayer,238,238,476,39,21,Tie
8381,JointPQPlayer,209,209,418,23,35,Tie
8382,JointPQPlayer,256,256,512,48,12,Tie
8383,JointPQPlayer,256,256,512,36,8,Tie
8384,JointPQPlayer,270,270,540,58,6,Tie
8385,JointPQPlayer,171,176,347,9,54,JointPQPlayer
8386,JointPQPlayer,239,234,473,33,20,Player A
8387,JointPQPlayer,241,241,482,39,19,Tie
8388,JointPQPlayer,253,253,506,42,12,Tie
8389,JointPQPlayer,196,196,392,12,40,Tie
8390,JointPQPlayer,257,257,514,47,11,Tie
8391,JointPQPlayer,266,266,532,56,8,Tie
8392,JointPQPlayer,263,263,526,47,7,Tie
8393,JointPQPlayer,257,257,514,47,11,Tie
8394,JointPQPlayer,244,244,488,39,17,Tie
8395,JointPQPlayer,241,241,482,42,20,Tie
8396,JointPQPlayer,263,263,526,56,10,Tie
8397,JointPQPlayer,234,234,468,43,25,Tie
8398,JointPQPlayer,260,265,525,46,7,JointPQPlayer
8399,JointPQPlayer,238,233,471,37,22,Player A
8400,JointPQPlayer,259,259,518,48,10,Tie
8401,JointPQPlayer,202,202,404,30,42,Tie
8402,JointPQPlayer,265,265,530,48,6,Tie
8403,JointPQPlayer,269,269,538,50,4,Tie
8404,JointPQPlayer,218,223,441,28,29,JointPQPlayer
8405,JointPQPlayer,222,222,444,22,26,Tie
8406,JointPQPlayer,262,257,519,49,10,Player A
8407,JointPQPlayer,193,198,391,23,44,JointPQPlayer
8408,JointPQPlayer,262,257,519,46,9,Player A
8409,JointPQPlayer,217,222,439,26,29,JointPQPlayer
8410,JointPQPlayer,255,250,505,47,14,Player A
8411,JointPQPlayer,242,247,489,43,18,JointPQPlayer
8412,JointPQPlayer,271,266,537,61,8,Player A
8413,JointPQPlayer,253,253,506,54,16,Tie
8414,JointPQPlayer,255,260,515,45,10,JointPQPlayer
8415,JointPQPlayer,252,247,499,44,15,Player A
8416,JointPQPlayer,249,254,503,36,11,JointPQPlayer
8417,JointPQPlayer,203,203,406,23,39,Tie
8418,JointPQPlayer,172,167,339,7,56,Player A
8419,JointPQPlayer,243,243,486,34,16,Tie
8420,JointPQPlayer,189,189,378,7,43,Tie
8421,JointPQPlayer,264,264,528,52,8,Tie
8422,JointPQPlayer,226,226,452,36,28,Tie
8423,JointPQPlayer,181,181,362,15,51,Tie
8424,JointPQPlayer,270,275,545,60,5,JointPQPlayer
8425,JointPQPlayer,243,243,486,46,20,Tie
8426,JointPQPlayer,257,257,514,50,12,Tie
8427,JointPQPlayer,192,187,379,8,43,Player A
8428,JointPQPlayer,267,272,539,54,5,JointPQPlayer
8429,JointPQPlayer,239,239,478,35,19,Tie
8430,JointPQPlayer,267,267,534,52,6,Tie
8431,JointPQPlayer,250,245,495,46,17,Player A
8432,JointPQPlayer,257,257,514,53,13,Tie
8433,JointPQPlayer,249,254,503,36,11,JointPQPlayer
8434,JointPQPlayer,249,249,498,37,13,Tie
8435,JointPQPlayer,232,227,459,43,28,Player A
8436,JointPQPlayer,235,240,475,35,20,JointPQPlayer
8437,JointPQPlayer,194,194,388,8,40,Tie
8438,JointPQPlayer,270,265,535,53,6,Player A
8439,JointPQPlayer,249,249,498,37,13,Tie
8440,JointPQPlayer,261,261,522,49,9,Tie
8441,JointPQPlayer,237,237,474,40,22,Tie
8442,JointPQPlayer,218,223,441,25,28,JointPQPlayer
8443,JointPQPlayer,239,234,473,33,20,Player A
8444,JointPQPlayer,261,261,522,49,9,Tie
8445,JointPQPlayer,244,249,493,38,15,JointPQPlayer
8446,JointPQPlayer,235,235,470,42,24,Tie
8447,JointPQPlayer,251,246,497,36,13,Player A
8448,JointPQPlayer,272,277,549,55,2,JointPQPlayer
8449,JointPQPlayer,253,248,501,43,14,Player A
8450,JointPQPlayer,256,256,512,42,10,Tie
8451,JointPQPlayer,268,268,536,54,6,Tie
8452,JointPQPlayer,166,166,332,15,61,Tie
8453,JointPQPlayer,250,250,500,42,14,Tie
8454,JointPQPlayer,214,219,433,29,32,JointPQPlayer
8455,JointPQPlayer,260,255,515,48,11,Player A
8456,JointPQPlayer,255,260,515,45,10,JointPQPlayer
8457,JointPQPlayer,164,159,323,3,60,Player A
8458,JointPQPlayer,263,268,531,52,7,JointPQPlayer
8459,JointPQPlayer,272,267,539,57,6,Player A
8460,JointPQPlayer,205,210,415,32,39,JointPQPlayer
8461,JointPQPlayer,187,182,369,13,48,Player A
8462,JointPQPlayer,242,242,484,38,18,Tie
8463,JointPQPlayer,269,269,538,62,8,Tie
8464,JointPQPlayer,247,247,494,39,15,Tie
8465,JointPQPlayer,239,244,483,37,18,JointPQPlayer
8466,JointPQPlayer,255,250,505,47,14,Player A
8467,JointPQPlayer,226,226,452,42,30,Tie
8468,JointPQPlayer,240,245,485,48,21,JointPQPlayer
8469,JointPQPlayer,265,260,525,55,10,Player A
8470,JointPQPlayer,256,256,512,51,13,Tie
8471,JointPQPlayer,264,264,528,52,8,Tie
8472,JointPQPlayer,247,247,494,42,16,Tie
8473,JointPQPlayer,267,272,539,48,3,JointPQPlayer
8474,JointPQPlayer,257,252,509,54,15,Player A
8475,JointPQPlayer,255,260,515,48,11,JointPQPlayer
8476,JointPQPlayer,253,253,506,45,13,Tie
8477,JointPQPlayer,273,268,541,56,5,Player A
8478,JointPQPlayer,275,275,550,62,4,Tie
8479,JointPQPlayer,197,202,399,19,40,JointPQPlayer
8480,JointPQPlayer,252,247,499,50,17,Player A
8481,JointPQPlayer,261,261,522,49,9,Tie
8482,JointPQPlayer,258,258,516,52,12,Tie
8483,JointPQPlayer,238,238,476,45,23,Tie
8484,JointPQPlayer,166,166,332,3,57,Tie
8485,JointPQPlayer,268,268,536,51,5,Tie
8486,JointPQPlayer,259,259,518,39,7,Tie
8487,JointPQPlayer,264,264,528,46,6,Tie
8488,JointPQPlayer,171,171,342,7,55,Tie
8489,JointPQPlayer,237,237,474,37,21,Tie
8490,JointPQPlayer,241,246,487,47,20,JointPQPlayer
8491,JointPQPlayer,263,258,521,39,6,Player A
8492,JointPQPlayer,262,267,529,56,9,JointPQPlayer
8493,JointPQPlayer,269,269,538,53,5,Tie
8494,JointPQPlayer,262,257,519,49,10,Player A
8495,JointPQPlayer,169,169,338,3,55,Tie
8496,JointPQPlayer,203,203,406,29,41,Tie
8497,JointPQPlayer,242,242,484,44,20,Tie
8498,JointPQPlayer,269,269,538,59,7,Tie
8499,JointPQPlayer,265,265,530,51,7,Tie
8500,JointPQPlayer,231,231,462,34,24,Tie
8501,JointPQPlayer,217,217,434,30,32,Tie
8502,JointPQPlayer,268,268,536,51,5,Tie
8503,JointPQPlayer,188,188,376,11,45,Tie
8504,JointPQPlayer,266,266,532,53,7,Tie
8505,JointPQPlayer,176,181,357,7,50,JointPQPlayer
8506,JointPQPlayer,249,244,493,47,18,Player A
8507,JointPQPlayer,270,270,540,55,5,Tie
8508,JointPQPlayer,256,261,517,47,10,JointPQPlayer
8509,JointPQPlayer,251,246,497,51,18,Player A
8510,JointPQPlayer,230,230,460,35,25,Tie
8511,JointPQPlayer,241,246,487,35,16,JointPQPlayer
8512,JointPQPlayer,237,232,469,38,23,Player A
8513,JointPQPlayer,252,257,509,45,12,JointPQPlayer
8514,JointPQPlayer,174,174,348,10,54,Tie
8515,JointPQPlayer,253,248,501,43,14,Player A
8516,JointPQPlayer,267,267,534,55,7,Tie
8517,JointPQPlayer,240,245,485,39,18,JointPQPlayer
8518,JointPQPlayer,273,268,541,50,3,Player A
8519,JointPQPlayer,251,256,507,40,11,JointPQPlayer
8520,JointPQPlayer,249,244,493,44,17,Player A
8521,JointPQPlayer,262,262,524,51,9,Tie
8522,JointPQPlayer,255,255,510,55,15,Tie
8523,JointPQPlayer,261,261,522,49,9,Tie
8524,JointPQPlayer,248,248,496,38,14,Tie
8525,JointPQPlayer,250,255,505,44,13,JointPQPlayer
8526,JointPQPlayer,229,229,458,30,24,Tie
8527,JointPQPlayer,255,255,510,46,12,Tie
8528,JointPQPlayer,186,181,367,20,51,Player A
8529,JointPQPlayer,260,265,525,43,6,JointPQPlayer
8530,JointPQPlayer,255,255,510,55,15,Tie
8531,JointPQPlayer,268,263,531,49,6,Player A
8532,JointPQPlayer,200,205,405,22,39,JointPQPlayer
8533,JointPQPlayer,265,260,525,49,8,Player A
8534,JointPQPlayer,157,162,319,5,62,JointPQPlayer
8535,JointPQPlayer,229,229,458,36,26,Tie
8536,JointPQPlayer,271,266,537,58,7,Player A
8537,JointPQPlayer,268,268,536,54,6,Tie
8538,JointPQPlayer,255,260,515,45,10,JointPQPlayer
8539,JointPQPlayer,234,234,468,34,22,Tie
8540,JointPQPlayer,254,254,508,47,13,Tie
8541,JointPQPlayer,178,178,356,6,50,Tie
8542,JointPQPlayer,235,230,465,37,24,Player A
8543,JointPQPlayer,260,260,520,47,9,Tie
8544,JointPQPlayer,266,266,532,53,7,Tie
8545,JointPQPlayer,176,181,357,7,50,JointPQPlayer
8546,JointPQPlayer,257,257,514,53,13,Tie
8547,JointPQPlayer,193,193,386,18,44,Tie
8548,JointPQPlayer,188,188,376,11,45,Tie
8549,JointPQPlayer,266,266,532,50,6,Tie
8550,JointPQPlayer,262,257,519,58,13,Player A
8551,JointPQPlayer,203,208,411,10,33,JointPQPlayer
8552,JointPQPlayer,254,254,508,47,13,Tie
8553,JointPQPlayer,252,247,499,41,14,Player A
8554,JointPQPlayer,205,205,410,24,38,Tie
8555,JointPQPlayer,206,206,412,23,37,Tie
8556,JointPQPlayer,186,186,372,10,46,Tie
8557,JointPQPlayer,203,203,406,26,40,Tie
8558,JointPQPlayer,267,267,534,52,6,Tie
8559,JointPQPlayer,263,263,526,50,8,Tie
8560,JointPQPlayer,171,176,347,9,54,JointPQPlayer
8561,JointPQPlayer,248,248,496,47,17,Tie
8562,JointPQPlayer,238,233,471,40,23,Player A
8563,JointPQPlayer,231,236,467,36,23,JointPQPlayer
8564,JointPQPlayer,261,256,517,47,10,Player A
8565,JointPQPlayer,251,251,502,53,17,Tie
8566,JointPQPlayer,263,263,526,44,6,Tie
8567,JointPQPlayer,268,268,536,54,6,Tie
8568,JointPQPlayer,227,227,454,38,28,Tie
8569,JointPQPlayer,185,190,375,13,46,JointPQPlayer
8570,JointPQPlayer,244,239,483,46,21,Player A
8571,JointPQPlayer,259,264,523,47,8,JointPQPlayer
8572,JointPQPlayer,161,161,322,2,60,Tie
8573,JointPQPlayer,216,216,432,28,32,Tie
8574,JointPQPlayer,250,245,495,40,15,Player A
8575,JointPQPlayer,253,253,506,48,14,Tie
8576,JointPQPlayer,231,236,467,39,24,JointPQPlayer
8577,JointPQPlayer,269,264,533,54,7,Player A
8578,JointPQPlayer,194,194,388,17,43,Tie
8579,JointPQPlayer,189,189,378,16,46,Tie
8580,JointPQPlayer,215,215,430,23,31,Tie
8581,JointPQPlayer,229,229,458,39,27,Tie
8582,JointPQPlayer,179,184,363,13,50,JointPQPlayer
8583,JointPQPlayer,263,258,521,51,10,Player A
8584,JointPQPlayer,231,236,467,36,23,JointPQPlayer
8585,JointPQPlayer,266,261,527,54,9,Player A
8586,JointPQPlayer,259,259,518,48,10,Tie
8587,JointPQPlayer,218,218,436,35,33,Tie
8588,JointPQPlayer,252,257,509,54,15,JointPQPlayer
8589,JointPQPlayer,211,206,417,25,36,Player A
8590,JointPQPlayer,251,251,502,50,16,Tie
8591,JointPQPlayer,198,203,401,27,42,JointPQPlayer
8592,JointPQPlayer,251,251,502,44,14,Tie
8593,JointPQPlayer,246,246,492,37,15,Tie
8594,JointPQPlayer,241,236,477,43,22,Player A
8595,JointPQPlayer,262,262,524,45,7,Tie
8596,JointPQPlayer,242,242,484,35,17,Tie
8597,JointPQPlayer,233,233,466,44,26,Tie
8598,JointPQPlayer,276,276,552,61,3,Tie
8599,JointPQPlayer,257,257,514,50,12,Tie
8600,JointPQPlayer,181,186,367,11,48,JointPQPlayer
8601,JointPQPlayer,270,265,535,56,7,Player A
8602,JointPQPlayer,273,273,546,58,4,Tie
8603,JointPQPlayer,206,206,412,20,36,Tie
8604,JointPQPlayer,221,221,442,26,28,Tie
8605,JointPQPlayer,249,254,503,42,13,JointPQPlayer
8606,JointPQPlayer,257,252,509,39,10,Player A
8607,JointPQPlayer,266,271,537,55,6,JointPQPlayer
8608,JointPQPlayer,242,242,484,44,20,Tie
8609,JointPQPlayer,243,243,486,46,20,Tie
8610,JointPQPlayer,263,258,521,54,11,Player A
8611,JointPQPlayer,253,258,511,44,11,JointPQPlayer
8612,JointPQPlayer,234,234,468,43,25,Tie
8613,JointPQPlayer,266,261,527,54,9,Player A
8614,JointPQPlayer,244,249,493,35,14,JointPQPlayer
8615,JointPQPlayer,179,179,358,2,48,Tie
8616,JointPQPlayer,252,252,504,49,15,Tie
8617,JointPQPlayer,261,256,517,50,11,Player A
8618,JointPQPlayer,181,181,362,12,50,Tie
8619,JointPQPlayer,236,236,472,41,23,Tie
8620,JointPQPlayer,253,253,506,42,12,Tie
8621,JointPQPlayer,202,207,409,23,38,JointPQPlayer
8622,JointPQPlayer,251,246,497,42,15,Player A
8623,JointPQPlayer,267,272,539,51,4,JointPQPlayer
8624,JointPQPlayer,252,252,504,46,14,Tie
8625,JointPQPlayer,258,253,511,50,13,Player A
8626,JointPQPlayer,272,277,549,61,4,JointPQPlayer
8627,JointPQPlayer,257,257,514,41,9,Tie
8628,JointPQPlayer,250,250,500,42,14,Tie
8629,JointPQPlayer,248,243,491,36,15,Player A
8630,JointPQPlayer,233,238,471,31,20,JointPQPlayer
8631,JointPQPlayer,216,216,432,25,31,Tie
8632,JointPQPlayer,218,213,431,24,31,Player A
8633,JointPQPlayer,256,256,512,51,13,Tie
8634,JointPQPlayer,252,252,504,43,13,Tie
8635,JointPQPlayer,260,265,525,46,7,JointPQPlayer
8636,JointPQPlayer,218,218,436,35,33,Tie
8637,JointPQPlayer,259,254,513,46,11,Player A
8638,JointPQPlayer,249,249,498,43,15,Tie
8639,JointPQPlayer,214,214,428,21,31,Tie
8640,JointPQPlayer,267,267,534,46,4,Tie
8641,JointPQPlayer,208,208,416,30,38,Tie
8642,JointPQPlayer,258,263,521,51,10,JointPQPlayer
8643,JointPQPlayer,191,191,382,17,45,Tie
8644,JointPQPlayer,220,220,440,33,31,Tie
8645,JointPQPlayer,240,235,475,38,21,Player A
8646,JointPQPlayer,248,253,501,40,13,JointPQPlayer
8647,JointPQPlayer,261,256,517,47,10,Player A
8648,JointPQPlayer,279,279,558,61,1,Tie
8649,JointPQPlayer,248,248,496,41,15,Tie
8650,JointPQPlayer,197,202,399,16,39,JointPQPlayer
8651,JointPQPlayer,175,170,345,7,54,Player A
8652,JointPQPlayer,202,207,409,17,36,JointPQPlayer
8653,JointPQPlayer,256,251,507,46,13,Player A
8654,JointPQPlayer,271,271,542,54,4,Tie
8655,JointPQPlayer,245,245,490,35,15,Tie
8656,JointPQPlayer,250,250,500,36,12,Tie
8657,JointPQPlayer,253,258,511,44,11,JointPQPlayer
8658,JointPQPlayer,252,247,499,41,14,Player A
8659,JointPQPlayer,258,258,516,49,11,Tie
8660,JointPQPlayer,253,253,506,45,13,Tie
8661,JointPQPlayer,263,268,531,58,9,JointPQPlayer
8662,JointPQPlayer,272,267,539,57,6,Player A
8663,JointPQPlayer,274,274,548,66,6,Tie
8664,JointPQPlayer,274,274,548,63,5,Tie
8665,JointPQPlayer,261,261,522,49,9,Tie
8666,JointPQPlayer,171,176,347,9,54,JointPQPlayer
8667,JointPQPlayer,235,230,465,31,22,Player A
8668,JointPQPlayer,190,190,380,6,42,Tie
8669,JointPQPlayer,238,238,476,36,20,Tie
8670,JointPQPlayer,246,246,492,43,17,Tie
8671,JointPQPlayer,251,251,502,44,14,Tie
8672,JointPQPlayer,185,190,375,13,46,JointPQPlayer
8673,JointPQPlayer,244,239,483,46,21,Player A
8674,JointPQPlayer,239,239,478,38,20,Tie
8675,JointPQPlayer,213,218,431,24,31,JointPQPlayer
8676,JointPQPlayer,264,259,523,50,9,Player A
8677,JointPQPlayer,236,236,472,32,20,Tie
8678,JointPQPlayer,156,161,317,9,64,JointPQPlayer
8679,JointPQPlayer,224,219,443,30,29,Player A
8680,JointPQPlayer,252,257,509,51,14,JointPQPlayer
8681,JointPQPlayer,261,261,522,49,9,Tie
8682,JointPQPlayer,254,254,508,41,11,Tie
8683,JointPQPlayer,270,265,535,53,6,Player A
8684,JointPQPlayer,251,251,502,44,14,Tie
8685,JointPQPlayer,247,247,494,42,16,Tie
8686,JointPQPlayer,257,257,514,47,11,Tie
8687,JointPQPlayer,241,241,482,42,20,Tie
8688,JointPQPlayer,223,228,451,32,27,JointPQPlayer
8689,JointPQPlayer,260,255,515,42,9,Player A
8690,JointPQPlayer,174,179,353,9,52,JointPQPlayer
8691,JointPQPlayer,260,255,515,48,11,Player A
8692,JointPQPlayer,175,175,350,6,52,Tie
8693,JointPQPlayer,176,181,357,7,50,JointPQPlayer
8694,JointPQPlayer,249,244,493,41,16,Player A
8695,JointPQPlayer,250,250,500,39,13,Tie
8696,JointPQPlayer,211,216,427,26,33,JointPQPlayer
8697,JointPQPlayer,255,255,510,52,14,Tie
8698,JointPQPlayer,251,251,502,38,12,Tie
8699,JointPQPlayer,244,239,483,43,20,Player A
8700,JointPQPlayer,228,233,461,33,24,JointPQPlayer
8701,JointPQPlayer,277,272,549,58,3,Player A
8702,JointPQPlayer,240,245,485,33,16,JointPQPlayer
8703,JointPQPlayer,193,188,381,10,43,Player A
8704,JointPQPlayer,217,217,434,27,31,Tie
8705,JointPQPlayer,255,260,515,57,14,JointPQPlayer
8706,JointPQPlayer,239,239,478,41,21,Tie
8707,JointPQPlayer,250,245,495,55,20,Player A
8708,JointPQPlayer,168,173,341,3,54,JointPQPlayer
8709,JointPQPlayer,262,262,524,51,9,Tie
8710,JointPQPlayer,228,223,451,41,30,Player A
8711,JointPQPlayer,269,269,538,53,5,Tie
8712,JointPQPlayer,260,260,520,47,9,Tie
8713,JointPQPlayer,203,208,411,28,39,JointPQPlayer
8714,JointPQPlayer,251,246,497,39,14,Player A
8715,JointPQPlayer,184,184,368,9,47,Tie
8716,JointPQPlayer,247,252,499,44,15,JointPQPlayer
8717,JointPQPlayer,241,236,477,46,23,Player A
8718,JointPQPlayer,250,255,505,44,13,JointPQPlayer
8719,JointPQPlayer,180,180,360,16,52,Tie
8720,JointPQPlayer,261,261,522,46,8,Tie
8721,JointPQPlayer,245,240,485,45,20,Player A
8722,JointPQPlayer,261,261,522,46,8,Tie
8723,JointPQPlayer,249,249,498,46,16,Tie
8724,JointPQPlayer,266,266,532,56,8,Tie
8725,JointPQPlayer,261,261,522,55,11,Tie
8726,JointPQPlayer,223,228,451,26,25,JointPQPlayer
8727,JointPQPlayer,254,249,503,48,15,Player A
8728,JointPQPlayer,262,267,529,53,8,JointPQPlayer
8729,JointPQPlayer,239,234,473,42,23,Player A
8730,JointPQPlayer,233,233,466,29,21,Tie
8731,JointPQPlayer,182,187,369,10,47,JointPQPlayer
8732,JointPQPlayer,262,257,519,52,11,Player A
8733,JointPQPlayer,268,268,536,54,6,Tie
8734,JointPQPlayer,254,254,508,47,13,Tie
8735,JointPQPlayer,244,249,493,41,16,JointPQPlayer
8736,JointPQPlayer,249,244,493,44,17,Player A
8737,JointPQPlayer,249,254,503,54,17,JointPQPlayer
8738,JointPQPlayer,271,266,537,49,4,Player A
8739,JointPQPlayer,253,253,506,45,13,Tie
8740,JointPQPlayer,273,273,546,58,4,Tie
8741,JointPQPlayer,244,249,493,44,17,JointPQPlayer
8742,JointPQPlayer,268,268,536,54,6,Tie
8743,JointPQPlayer,265,265,530,51,7,Tie
8744,JointPQPlayer,253,248,501,40,13,Player A
8745,JointPQPlayer,249,254,503,48,15,JointPQPlayer
8746,JointPQPlayer,264,264,528,49,7,Tie
8747,JointPQPlayer,243,238,481,41,20,Player A
8748,JointPQPlayer,251,251,502,44,14,Tie
8749,JointPQPlayer,269,269,538,47,3,Tie
8750,JointPQPlayer,262,267,529,50,7,JointPQPlayer
8751,JointPQPlayer,247,242,489,40,17,Player A
8752,JointPQPlayer,262,262,524,48,8,Tie
8753,JointPQPlayer,251,256,507,49,14,JointPQPlayer
8754,JointPQPlayer,268,263,531,52,7,Player A
8755,JointPQPlayer,272,272,544,53,3,Tie
8756,JointPQPlayer,255,255,510,49,13,Tie
8757,JointPQPlayer,190,190,380,6,42,Tie
8758,JointPQPlayer,271,271,542,57,5,Tie
8759,JointPQPlayer,265,265,530,57,9,Tie
8760,JointPQPlayer,179,179,358,11,51,Tie
8761,JointPQPlayer,244,244,488,39,17,Tie
8762,JointPQPlayer,235,235,470,36,22,Tie
8763,JointPQPlayer,242,242,484,38,18,Tie
8764,JointPQPlayer,246,246,492,43,17,Tie
8765,JointPQPlayer,196,201,397,26,43,JointPQPlayer
8766,JointPQPlayer,176,176,352,5,51,Tie
8767,JointPQPlayer,247,247,494,39,15,Tie
8768,JointPQPlayer,253,253,506,45,13,Tie
8769,JointPQPlayer,203,203,406,23,39,Tie
8770,JointPQPlayer,254,249,503,42,13,Player A
8771,JointPQPlayer,249,254,503,45,14,JointPQPlayer
8772,JointPQPlayer,256,251,507,43,12,Player A
8773,JointPQPlayer,268,273,541,59,6,JointPQPlayer
8774,JointPQPlayer,267,267,534,52,6,Tie
8775,JointPQPlayer,163,163,326,3,59,Tie
8776,JointPQPlayer,260,260,520,53,11,Tie
8777,JointPQPlayer,248,243,491,42,17,Player A
8778,JointPQPlayer,241,246,487,41,18,JointPQPlayer
8779,JointPQPlayer,194,194,388,14,42,Tie
8780,JointPQPlayer,249,249,498,46,16,Tie
8781,JointPQPlayer,185,185,370,8,46,Tie
8782,JointPQPlayer,258,258,516,52,12,Tie
8783,JointPQPlayer,252,247,499,44,15,Player A
8784,JointPQPlayer,251,251,502,44,14,Tie
8785,JointPQPlayer,239,239,478,44,22,Tie
8786,JointPQPlayer,241,241,482,36,18,Tie
8787,JointPQPlayer,237,237,474,40,22,Tie
8788,JointPQPlayer,255,255,510,55,15,Tie
8789,JointPQPlayer,225,225,450,34,28,Tie
8790,JointPQPlayer,242,242,484,38,18,Tie
8791,JointPQPlayer,265,265,530,45,5,Tie
8792,JointPQPlayer,261,261,522,43,7,Tie
8793,JointPQPlayer,264,264,528,55,9,Tie
8794,JointPQPlayer,180,180,360,10,50,Tie
8795,JointPQPlayer,269,269,538,56,6,Tie
8796,JointPQPlayer,244,244,488,39,17,Tie
8797,JointPQPlayer,248,253,501,49,16,JointPQPlayer
8798,JointPQPlayer,173,173,346,5,53,Tie
8799,JointPQPlayer,242,237,479,45,22,Player A
8800,JointPQPlayer,258,258,516,49,11,Tie
8801,JointPQPlayer,267,267,534,58,8,Tie
8802,JointPQPlayer,256,256,512,51,13,Tie
8803,JointPQPlayer,235,235,470,36,22,Tie
8804,JointPQPlayer,239,239,478,38,20,Tie
8805,JointPQPlayer,272,277,549,64,5,JointPQPlayer
8806,JointPQPlayer,260,255,515,51,12,Player A
8807,JointPQPlayer,272,277,549,58,3,JointPQPlayer
8808,JointPQPlayer,262,257,519,49,10,Player A
8809,JointPQPlayer,258,258,516,46,10,Tie
8810,JointPQPlayer,260,260,520,47,9,Tie
8811,JointPQPlayer,264,264,528,52,8,Tie
8812,JointPQPlayer,264,264,528,49,7,Tie
8813,JointPQPlayer,226,226,452,33,27,Tie
8814,JointPQPlayer,256,256,512,51,13,Tie
8815,JointPQPlayer,258,258,516,49,11,Tie
8816,JointPQPlayer,241,246,487,44,19,JointPQPlayer
8817,JointPQPlayer,201,196,397,14,39,Player A
8818,JointPQPlayer,157,162,319,5,62,JointPQPlayer
8819,JointPQPlayer,262,257,519,52,11,Player A
8820,JointPQPlayer,239,244,483,46,21,JointPQPlayer
8821,JointPQPlayer,234,234,468,37,23,Tie
8822,JointPQPlayer,265,265,530,48,6,Tie
8823,JointPQPlayer,253,248,501,40,13,Player A
8824,JointPQPlayer,240,245,485,42,19,JointPQPlayer
8825,JointPQPlayer,238,238,476,30,18,Tie
8826,JointPQPlayer,268,263,531,52,7,Player A
8827,JointPQPlayer,180,185,365,12,49,JointPQPlayer
8828,JointPQPlayer,254,249,503,45,14,Player A
8829,JointPQPlayer,256,256,512,51,13,Tie
8830,JointPQPlayer,271,271,542,51,3,Tie
8831,JointPQPlayer,259,264,523,56,11,JointPQPlayer
8832,JointPQPlayer,249,244,493,47,18,Player A
8833,JointPQPlayer,175,180,355,8,51,JointPQPlayer
8834,JointPQPlayer,172,172,344,6,54,Tie
8835,JointPQPlayer,257,257,514,47,11,Tie
8836,JointPQPlayer,242,237,479,42,21,Player A
8837,JointPQPlayer,204,209,413,24,37,JointPQPlayer
8838,JointPQPlayer,252,247,499,41,14,Player A
8839,JointPQPlayer,256,256,512,51,13,Tie
8840,JointPQPlayer,257,257,514,50,12,Tie
8841,JointPQPlayer,258,258,516,43,9,Tie
8842,JointPQPlayer,244,249,493,41,16,JointPQPlayer
8843,JointPQPlayer,200,200,400,14,38,Tie
8844,JointPQPlayer,219,214,433,26,31,Player A
8845,JointPQPlayer,260,260,520,50,10,Tie
8846,JointPQPlayer,147,152,299,6,69,JointPQPlayer
8847,JointPQPlayer,239,239,478,35,19,Tie
8848,JointPQPlayer,248,243,491,42,17,Player A
8849,JointPQPlayer,253,253,506,45,13,Tie
8850,JointPQPlayer,245,250,495,37,14,JointPQPlayer
8851,JointPQPlayer,254,249,503,42,13,Player A
8852,JointPQPlayer,243,243,486,40,18,Tie
8853,JointPQPlayer,242,247,489,43,18,JointPQPlayer
8854,JointPQPlayer,265,260,525,52,9,Player A
8855,JointPQPlayer,237,237,474,34,20,Tie
8856,JointPQPlayer,239,244,483,46,21,JointPQPlayer
8857,JointPQPlayer,247,242,489,37,16,Player A
8858,JointPQPlayer,229,234,463,29,22,JointPQPlayer
8859,JointPQPlayer,267,262,529,50,7,Player A
8860,JointPQPlayer,224,229,453,31,26,JointPQPlayer
8861,JointPQPlayer,241,236,477,43,22,Player A
8862,JointPQPlayer,242,242,484,44,20,Tie
8863,JointPQPlayer,247,247,494,45,17,Tie
8864,JointPQPlayer,159,164,323,6,61,JointPQPlayer
8865,JointPQPlayer,242,237,479,39,20,Player A
8866,JointPQPlayer,252,252,504,43,13,Tie
8867,JointPQPlayer,271,271,542,51,3,Tie
8868,JointPQPlayer,232,237,469,29,20,JointPQPlayer
8869,JointPQPlayer,175,175,350,12,54,Tie
8870,JointPQPlayer,275,270,545,60,5,Player A
8871,JointPQPlayer,242,242,484,38,18,Tie
8872,JointPQPlayer,193,198,391,11,40,JointPQPlayer
8873,JointPQPlayer,175,170,345,7,54,Player A
8874,JointPQPlayer,266,266,532,56,8,Tie
8875,JointPQPlayer,252,257,509,48,13,JointPQPlayer
8876,JointPQPlayer,242,237,479,39,20,Player A
8877,JointPQPlayer,243,243,486,43,19,Tie
8878,JointPQPlayer,219,219,438,28,30,Tie
8879,JointPQPlayer,168,173,341,6,55,JointPQPlayer
8880,JointPQPlayer,173,173,346,5,53,Tie
8881,JointPQPlayer,248,243,491,45,18,Player A
8882,JointPQPlayer,262,262,524,54,10,Tie
8883,JointPQPlayer,278,278,556,59,1,Tie
8884,JointPQPlayer,257,257,514,47,11,Tie
8885,JointPQPlayer,274,274,548,54,2,Tie
8886,JointPQPlayer,255,255,510,49,13,Tie
8887,JointPQPlayer,236,236,472,38,22,Tie
8888,JointPQPlayer,179,179,358,8,50,Tie
8889,JointPQPlayer,256,261,517,47,10,JointPQPlayer
8890,JointPQPlayer,223,223,446,30,28,Tie
8891,JointPQPlayer,269,264,533,60,9,Player A
8892,JointPQPlayer,174,179,353,6,51,JointPQPlayer
8893,JointPQPlayer,257,252,509,51,14,Player A
8894,JointPQPlayer,257,257,514,50,12,Tie
8895,JointPQPlayer,250,250,500,42,14,Tie
8896,JointPQPlayer,262,262,524,45,7,Tie
8897,JointPQPlayer,171,171,342,7,55,Tie
8898,JointPQPlayer,236,241,477,37,20,JointPQPlayer
8899,JointPQPlayer,268,263,531,46,5,Player A
8900,JointPQPlayer,244,244,488,33,15,Tie
8901,JointPQPlayer,251,251,502,41,13,Tie
8902,JointPQPlayer,266,266,532,47,5,Tie
8903,JointPQPlayer,157,162,319,5,62,JointPQPlayer
8904,JointPQPlayer,268,263,531,52,7,Player A
8905,JointPQPlayer,255,255,510,49,13,Tie
8906,JointPQPlayer,169,174,343,8,55,JointPQPlayer
8907,JointPQPlayer,262,262,524,51,9,Tie
8908,JointPQPlayer,265,265,530,51,7,Tie
8909,JointPQPlayer,224,219,443,30,29,Player A
8910,JointPQPlayer,224,229,453,34,27,JointPQPlayer
8911,JointPQPlayer,246,246,492,49,19,Tie
8912,JointPQPlayer,226,226,452,33,27,Tie
8913,JointPQPlayer,251,251,502,44,14,Tie
8914,JointPQPlayer,238,238,476,45,23,Tie
8915,JointPQPlayer,241,241,482,48,22,Tie
8916,JointPQPlayer,261,256,517,44,9,Player A
8917,JointPQPlayer,170,175,345,4,53,JointPQPlayer
8918,JointPQPlayer,229,229,458,33,25,Tie
8919,JointPQPlayer,261,256,517,47,10,Player A
8920,JointPQPlayer,234,239,473,33,20,JointPQPlayer
8921,JointPQPlayer,265,260,525,46,7,Player A
8922,JointPQPlayer,267,267,534,61,9,Tie
8923,JointPQPlayer,266,271,537,55,6,JointPQPlayer
8924,JointPQPlayer,224,224,448,32,28,Tie
8925,JointPQPlayer,187,187,374,12,46,Tie
8926,JointPQPlayer,257,252,509,48,13,Player A
8927,JointPQPlayer,182,187,369,7,46,JointPQPlayer
8928,JointPQPlayer,245,240,485,42,19,Player A
8929,JointPQPlayer,257,257,514,47,11,Tie
8930,JointPQPlayer,276,276,552,64,4,Tie
8931,JointPQPlayer,255,255,510,52,14,Tie
8932,JointPQPlayer,218,218,436,26,30,Tie
8933,JointPQPlayer,178,178,356,3,49,Tie
8934,JointPQPlayer,189,189,378,10,44,Tie
8935,JointPQPlayer,248,253,501,49,16,JointPQPlayer
8936,JointPQPlayer,269,264,533,51,6,Player A
8937,JointPQPlayer,270,270,540,58,6,Tie
8938,JointPQPlayer,174,179,353,9,52,JointPQPlayer
8939,JointPQPlayer,253,253,506,48,14,Tie
8940,JointPQPlayer,275,270,545,57,4,Player A
8941,JointPQPlayer,203,208,411,16,35,JointPQPlayer
8942,JointPQPlayer,250,250,500,45,15,Tie
8943,JointPQPlayer,221,216,437,27,30,Player A
8944,JointPQPlayer,247,252,499,35,12,JointPQPlayer
8945,JointPQPlayer,242,237,479,45,22,Player A
8946,JointPQPlayer,263,263,526,53,9,Tie
8947,JointPQPlayer,178,178,356,9,51,Tie
8948,JointPQPlayer,248,253,501,43,14,JointPQPlayer
8949,JointPQPlayer,252,247,499,41,14,Player A
8950,JointPQPlayer,258,258,516,46,10,Tie
8951,JointPQPlayer,247,247,494,36,14,Tie
8952,JointPQPlayer,228,233,461,30,23,JointPQPlayer
8953,JointPQPlayer,235,230,465,37,24,Player A
8954,JointPQPlayer,253,258,511,44,11,JointPQPlayer
8955,JointPQPlayer,257,252,509,51,14,Player A
8956,JointPQPlayer,267,272,539,51,4,JointPQPlayer
8957,JointPQPlayer,272,267,539,54,5,Player A
8958,JointPQPlayer,251,256,507,37,10,JointPQPlayer
8959,JointPQPlayer,197,192,389,24,45,Player A
8960,JointPQPlayer,227,232,459,34,25,JointPQPlayer
8961,JointPQPlayer,245,240,485,39,18,Player A
8962,JointPQPlayer,249,254,503,36,11,JointPQPlayer
8963,JointPQPlayer,255,250,505,50,15,Player A
8964,JointPQPlayer,257,257,514,47,11,Tie
8965,JointPQPlayer,232,232,464,39,25,Tie
8966,JointPQPlayer,248,248,496,47,17,Tie
8967,JointPQPlayer,177,177,354,7,51,Tie
8968,JointPQPlayer,245,245,490,38,16,Tie
8969,JointPQPlayer,241,246,487,41,18,JointPQPlayer
8970,JointPQPlayer,260,255,515,51,12,Player A
8971,JointPQPlayer,235,235,470,42,24,Tie
8972,JointPQPlayer,251,251,502,44,14,Tie
8973,JointPQPlayer,179,184,363,10,49,JointPQPlayer
8974,JointPQPlayer,234,229,463,41,26,Player A
8975,JointPQPlayer,190,190,380,18,46,Tie
8976,JointPQPlayer,169,174,343,5,54,JointPQPlayer
8977,JointPQPlayer,267,262,529,47,6,Player A
8978,JointPQPlayer,181,181,362,21,53,Tie
8979,JointPQPlayer,254,254,508,47,13,Tie
8980,JointPQPlayer,262,262,524,60,12,Tie
8981,JointPQPlayer,268,268,536,51,5,Tie
8982,JointPQPlayer,259,259,518,54,12,Tie
8983,JointPQPlayer,262,262,524,54,10,Tie
8984,JointPQPlayer,262,262,524,51,9,Tie
8985,JointPQPlayer,248,248,496,38,14,Tie
8986,JointPQPlayer,263,263,526,47,7,Tie
8987,JointPQPlayer,226,226,452,36,28,Tie
8988,JointPQPlayer,248,248,496,41,15,Tie
8989,JointPQPlayer,195,200,395,12,39,JointPQPlayer
8990,JointPQPlayer,254,249,503,42,13,Player A
8991,JointPQPlayer,245,245,490,29,13,Tie
8992,JointPQPlayer,264,264,528,46,6,Tie
8993,JointPQPlayer,202,202,404,24,40,Tie
8994,JointPQPlayer,191,191,382,14,44,Tie
8995,JointPQPlayer,239,239,478,38,20,Tie
8996,JointPQPlayer,230,230,460,32,24,Tie
8997,JointPQPlayer,137,142,279,1,74,JointPQPlayer
8998,JointPQPlayer,270,265,535,56,7,Player A
8999,JointPQPlayer,248,253,501,49,16,JointPQPlayer
9000,JointPQPlayer,274,269,543,61,6,Player A
9001,JointPQPlayer,186,191,377,18,47,JointPQPlayer
9002,JointPQPlayer,243,238,481,44,21,Player A
9003,JointPQPlayer,261,261,522,49,9,Tie
9004,JointPQPlayer,215,215,430,32,34,Tie
9005,JointPQPlayer,256,261,517,50,11,JointPQPlayer
9006,JointPQPlayer,259,259,518,48,10,Tie
9007,JointPQPlayer,255,255,510,40,10,Tie
9008,JointPQPlayer,184,184,368,6,46,Tie
9009,JointPQPlayer,267,262,529,50,7,Player A
9010,JointPQPlayer,246,251,497,42,15,JointPQPlayer
9011,JointPQPlayer,207,207,414,25,37,Tie
9012,JointPQPlayer,160,160,320,3,61,Tie
9013,JointPQPlayer,261,256,517,47,10,Player A
9014,JointPQPlayer,257,262,519,55,12,JointPQPlayer
9015,JointPQPlayer,261,256,517,53,12,Player A
9016,JointPQPlayer,240,245,485,36,17,JointPQPlayer
9017,JointPQPlayer,247,247,494,48,18,Tie
9018,JointPQPlayer,274,269,543,58,5,Player A
9019,JointPQPlayer,198,203,401,21,40,JointPQPlayer
9020,JointPQPlayer,249,244,493,35,14,Player A
9021,JointPQPlayer,240,240,480,43,21,Tie
9022,JointPQPlayer,224,229,453,28,25,JointPQPlayer
9023,JointPQPlayer,224,219,443,24,27,Player A
9024,JointPQPlayer,237,237,474,37,21,Tie
9025,JointPQPlayer,274,274,548,60,4,Tie
9026,JointPQPlayer,254,259,513,40,9,JointPQPlayer
9027,JointPQPlayer,241,236,477,40,21,Player A
9028,JointPQPlayer,240,240,480,40,20,Tie
9029,JointPQPlayer,221,221,442,32,30,Tie
9030,JointPQPlayer,233,238,471,37,22,JointPQPlayer
9031,JointPQPlayer,270,265,535,50,5,Player A
9032,JointPQPlayer,163,168,331,8,59,JointPQPlayer
9033,JointPQPlayer,233,228,461,45,28,Player A
9034,JointPQPlayer,264,264,528,52,8,Tie
9035,JointPQPlayer,235,240,475,35,20,JointPQPlayer
9036,JointPQPlayer,268,263,531,55,8,Player A
9037,JointPQPlayer,263,268,531,55,8,JointPQPlayer
9038,JointPQPlayer,247,242,489,46,19,Player A
9039,JointPQPlayer,253,258,511,44,11,JointPQPlayer
9040,JointPQPlayer,264,259,523,47,8,Player A
9041,JointPQPlayer,220,220,440,33,31,Tie
9042,JointPQPlayer,226,231,457,35,26,JointPQPlayer
9043,JointPQPlayer,237,237,474,34,20,Tie
9044,JointPQPlayer,183,183,366,10,48,Tie
9045,JointPQPlayer,255,255,510,46,12,Tie
9046,JointPQPlayer,254,254,508,44,12,Tie
9047,JointPQPlayer,217,212,429,28,33,Player A
9048,JointPQPlayer,252,252,504,49,15,Tie
9049,JointPQPlayer,179,179,358,8,50,Tie
9050,JointPQPlayer,200,205,405,22,39,JointPQPlayer
9051,JointPQPlayer,272,267,539,54,5,Player A
9052,JointPQPlayer,263,268,531,46,5,JointPQPlayer
9053,JointPQPlayer,164,164,328,2,58,Tie
9054,JointPQPlayer,242,237,479,42,21,Player A
9055,JointPQPlayer,250,255,505,47,14,JointPQPlayer
9056,JointPQPlayer,268,263,531,58,9,Player A
9057,JointPQPlayer,260,260,520,47,9,Tie
9058,JointPQPlayer,241,241,482,45,21,Tie
9059,JointPQPlayer,231,231,462,34,24,Tie
9060,JointPQPlayer,247,252,499,47,16,JointPQPlayer
9061,JointPQPlayer,254,249,503,51,16,Player A
9062,JointPQPlayer,191,196,387,13,42,JointPQPlayer
9063,JointPQPlayer,264,259,523,50,9,Player A
9064,JointPQPlayer,165,170,335,9,58,JointPQPlayer
9065,JointPQPlayer,209,209,418,26,36,Tie
9066,JointPQPlayer,268,263,531,58,9,Player A
9067,JointPQPlayer,219,224,443,33,30,JointPQPlayer
9068,JointPQPlayer,263,258,521,51,10,Player A
9069,JointPQPlayer,249,249,498,49,17,Tie
9070,JointPQPlayer,259,259,518,54,12,Tie
9071,JointPQPlayer,271,271,542,57,5,Tie
9072,JointPQPlayer,257,257,514,41,9,Tie
9073,JointPQPlayer,250,255,505,47,14,JointPQPlayer
9074,JointPQPlayer,209,204,413,27,38,Player A
9075,JointPQPlayer,255,260,515,48,11,JointPQPlayer
9076,JointPQPlayer,228,223,451,29,26,Player A
9077,JointPQPlayer,254,259,513,43,10,JointPQPlayer
9078,JointPQPlayer,181,176,357,19,54,Player A
9079,JointPQPlayer,233,233,466,44,26,Tie
9080,JointPQPlayer,243,243,486,31,15,Tie
9081,JointPQPlayer,266,266,532,53,7,Tie
9082,JointPQPlayer,265,265,530,57,9,Tie
9083,JointPQPlayer,252,252,504,49,15,Tie
9084,JointPQPlayer,249,254,503,36,11,JointPQPlayer
9085,JointPQPlayer,255,255,510,52,14,Tie
9086,JointPQPlayer,224,219,443,30,29,Player A
9087,JointPQPlayer,183,188,371,15,48,JointPQPlayer
9088,JointPQPlayer,190,185,375,16,47,Player A
9089,JointPQPlayer,242,242,484,35,17,Tie
9090,JointPQPlayer,260,260,520,47,9,Tie
9091,JointPQPlayer,249,254,503,39,12,JointPQPlayer
9092,JointPQPlayer,269,264,533,57,8,Player A
9093,JointPQPlayer,264,264,528,49,7,Tie
9094,JointPQPlayer,235,235,470,39,23,Tie
9095,JointPQPlayer,251,256,507,40,11,JointPQPlayer
9096,JointPQPlayer,231,231,462,37,25,Tie
9097,JointPQPlayer,260,260,520,47,9,Tie
9098,JointPQPlayer,258,253,511,50,13,Player A
9099,JointPQPlayer,265,265,530,48,6,Tie
9100,JointPQPlayer,249,249,498,40,14,Tie
9101,JointPQPlayer,265,265,530,51,7,Tie
9102,JointPQPlayer,239,244,483,37,18,JointPQPlayer
9103,JointPQPlayer,236,236,472,38,22,Tie
9104,JointPQPlayer,267,267,534,49,5,Tie
9105,JointPQPlayer,264,259,523,50,9,Player A
9106,JointPQPlayer,242,242,484,38,18,Tie
9107,JointPQPlayer,232,237,469,32,21,JointPQPlayer
9108,JointPQPlayer,250,245,495,49,18,Player A
9109,JointPQPlayer,245,250,495,34,13,JointPQPlayer
9110,JointPQPlayer,254,254,508,44,12,Tie
9111,JointPQPlayer,278,273,551,60,3,Player A
9112,JointPQPlayer,237,237,474,37,21,Tie
9113,JointPQPlayer,265,265,530,51,7,Tie
9114,JointPQPlayer,231,231,462,43,27,Tie
9115,JointPQPlayer,259,264,523,47,8,JointPQPlayer
9116,JointPQPlayer,255,250,505,35,10,Player A
9117,JointPQPlayer,261,261,522,49,9,Tie
9118,JointPQPlayer,265,270,535,53,6,JointPQPlayer
9119,JointPQPlayer,173,173,346,11,55,Tie
9120,JointPQPlayer,200,195,395,21,42,Player A
9121,JointPQPlayer,223,223,446,33,29,Tie
9122,JointPQPlayer,254,254,508,41,11,Tie
9123,JointPQPlayer,267,267,534,52,6,Tie
9124,JointPQPlayer,168,168,336,10,58,Tie
9125,JointPQPlayer,195,195,390,22,44,Tie
9126,JointPQPlayer,262,262,524,48,8,Tie
9127,JointPQPlayer,237,237,474,46,24,Tie
9128,JointPQPlayer,249,249,498,43,15,Tie
9129,JointPQPlayer,268,268,536,57,7,Tie
9130,JointPQPlayer,185,190,375,10,45,JointPQPlayer
9131,JointPQPlayer,251,251,502,47,15,Tie
9132,JointPQPlayer,185,180,365,6,47,Player A
9133,JointPQPlayer,263,263,526,53,9,Tie
9134,JointPQPlayer,173,178,351,7,52,JointPQPlayer
9135,JointPQPlayer,195,195,390,16,42,Tie
9136,JointPQPlayer,186,186,372,7,45,Tie
9137,JointPQPlayer,271,271,542,57,5,Tie
9138,JointPQPlayer,260,260,520,47,9,Tie
9139,JointPQPlayer,188,188,376,11,45,Tie
9140,JointPQPlayer,174,174,348,7,53,Tie
9141,JointPQPlayer,185,185,370,8,46,Tie
9142,JointPQPlayer,176,176,352,8,52,Tie
9143,JointPQPlayer,268,268,536,51,5,Tie
9144,JointPQPlayer,193,188,381,16,45,Player A
9145,JointPQPlayer,223,223,446,39,31,Tie
9146,JointPQPlayer,264,264,528,46,6,Tie
9147,JointPQPlayer,255,260,515,36,7,JointPQPlayer
9148,JointPQPlayer,272,267,539,54,5,Player A
9149,JointPQPlayer,245,245,490,41,17,Tie
9150,JointPQPlayer,245,250,495,40,15,JointPQPlayer
9151,JointPQPlayer,261,256,517,47,10,Player A
9152,JointPQPlayer,255,260,515,48,11,JointPQPlayer
9153,JointPQPlayer,256,251,507,43,12,Player A
9154,JointPQPlayer,225,230,455,33,26,JointPQPlayer
9155,JointPQPlayer,227,222,449,39,30,Player A
9156,JointPQPlayer,249,249,498,40,14,Tie
9157,JointPQPlayer,227,232,459,31,24,JointPQPlayer
9158,JointPQPlayer,262,257,519,52,11,Player A
9159,JointPQPlayer,247,247,494,39,15,Tie
9160,JointPQPlayer,266,266,532,50,6,Tie
9161,JointPQPlayer,229,234,463,32,23,JointPQPlayer
9162,JointPQPlayer,262,262,524,48,8,Tie
9163,JointPQPlayer,241,236,477,43,22,Player A
9164,JointPQPlayer,220,220,440,30,30,Tie
9165,JointPQPlayer,267,267,534,55,7,Tie
9166,JointPQPlayer,225,225,450,37,29,Tie
9167,JointPQPlayer,253,258,511,41,10,JointPQPlayer
9168,JointPQPlayer,175,175,350,6,52,Tie
9169,JointPQPlayer,231,226,457,35,26,Player A
9170,JointPQPlayer,256,256,512,48,12,Tie
9171,JointPQPlayer,244,249,493,41,16,JointPQPlayer
9172,JointPQPlayer,228,228,456,31,25,Tie
9173,JointPQPlayer,269,264,533,57,8,Player A
9174,JointPQPlayer,270,270,540,61,7,Tie
9175,JointPQPlayer,262,262,524,45,7,Tie
9176,JointPQPlayer,260,260,520,50,10,Tie
9177,JointPQPlayer,264,269,533,51,6,JointPQPlayer
9178,JointPQPlayer,206,201,407,27,40,Player A
9179,JointPQPlayer,267,272,539,51,4,JointPQPlayer
9180,JointPQPlayer,255,250,505,44,13,Player A
9181,JointPQPlayer,261,261,522,49,9,Tie
9182,JointPQPlayer,254,259,513,46,11,JointPQPlayer
9183,JointPQPlayer,159,159,318,1,61,Tie
9184,JointPQPlayer,251,251,502,44,14,Tie
9185,JointPQPlayer,261,261,522,55,11,Tie
9186,JointPQPlayer,230,225,455,33,26,Player A
9187,JointPQPlayer,253,253,506,45,13,Tie
9188,JointPQPlayer,261,261,522,46,8,Tie
9189,JointPQPlayer,235,240,475,44,23,JointPQPlayer
9190,JointPQPlayer,217,212,429,28,33,Player A
9191,JointPQPlayer,264,264,528,55,9,Tie
9192,JointPQPlayer,250,250,500,42,14,Tie
9193,JointPQPlayer,245,245,490,41,17,Tie
9194,JointPQPlayer,249,254,503,39,12,JointPQPlayer
9195,JointPQPlayer,194,189,383,12,43,Player A
9196,JointPQPlayer,235,235,470,33,21,Tie
9197,JointPQPlayer,220,225,445,29,28,JointPQPlayer
9198,JointPQPlayer,270,265,535,56,7,Player A
9199,JointPQPlayer,257,257,514,44,10,Tie
9200,JointPQPlayer,253,258,511,50,13,JointPQPlayer
9201,JointPQPlayer,218,213,431,27,32,Player A
9202,JointPQPlayer,255,260,515,48,11,JointPQPlayer
9203,JointPQPlayer,245,245,490,47,19,Tie
9204,JointPQPlayer,252,247,499,44,15,Player A
9205,JointPQPlayer,229,234,463,35,24,JointPQPlayer
9206,JointPQPlayer,260,255,515,42,9,Player A
9207,JointPQPlayer,224,229,453,37,28,JointPQPlayer
9208,JointPQPlayer,253,248,501,40,13,Player A
9209,JointPQPlayer,255,255,510,46,12,Tie
9210,JointPQPlayer,237,237,474,40,22,Tie
9211,JointPQPlayer,247,252,499,47,16,JointPQPlayer
9212,JointPQPlayer,264,259,523,59,12,Player A
9213,JointPQPlayer,232,232,464,36,24,Tie
9214,JointPQPlayer,242,242,484,38,18,Tie
9215,JointPQPlayer,173,173,346,8,54,Tie
9216,JointPQPlayer,246,246,492,52,20,Tie
9217,JointPQPlayer,262,262,524,48,8,Tie
9218,JointPQPlayer,246,251,497,45,16,JointPQPlayer
9219,JointPQPlayer,234,229,463,38,25,Player A
9220,JointPQPlayer,170,175,345,10,55,JointPQPlayer
9221,JointPQPlayer,207,202,409,29,40,Player A
9222,JointPQPlayer,267,267,534,58,8,Tie
9223,JointPQPlayer,200,205,405,22,39,JointPQPlayer
9224,JointPQPlayer,240,235,475,32,19,Player A
9225,JointPQPlayer,199,204,403,26,41,JointPQPlayer
9226,JointPQPlayer,169,169,338,6,56,Tie
9227,JointPQPlayer,245,240,485,36,17,Player A
9228,JointPQPlayer,259,259,518,45,9,Tie
9229,JointPQPlayer,270,275,545,57,4,JointPQPlayer
9230,JointPQPlayer,261,261,522,40,6,Tie
9231,JointPQPlayer,239,239,478,35,19,Tie
9232,JointPQPlayer,275,270,545,60,5,Player A
9233,JointPQPlayer,231,236,467,42,25,JointPQPlayer
9234,JointPQPlayer,202,197,399,16,39,Player A
9235,JointPQPlayer,219,219,438,31,31,Tie
9236,JointPQPlayer,189,189,378,16,46,Tie
9237,JointPQPlayer,254,254,508,44,12,Tie
9238,JointPQPlayer,248,248,496,41,15,Tie
9239,JointPQPlayer,246,251,497,48,17,JointPQPlayer
9240,JointPQPlayer,239,239,478,47,23,Tie
9241,JointPQPlayer,267,267,534,52,6,Tie
9242,JointPQPlayer,241,236,477,40,21,Player A
9243,JointPQPlayer,276,276,552,64,4,Tie
9244,JointPQPlayer,240,240,480,40,20,Tie
9245,JointPQPlayer,223,223,446,27,27,Tie
9246,JointPQPlayer,250,250,500,48,16,Tie
9247,JointPQPlayer,239,239,478,35,19,Tie
9248,JointPQPlayer,178,183,361,8,49,JointPQPlayer
9249,JointPQPlayer,248,243,491,30,13,Player A
9250,JointPQPlayer,263,268,531,55,8,JointPQPlayer
9251,JointPQPlayer,173,173,346,11,55,Tie
9252,JointPQPlayer,225,220,445,35,30,Player A
9253,JointPQPlayer,249,249,498,40,14,Tie
9254,JointPQPlayer,239,239,478,41,21,Tie
9255,JointPQPlayer,220,220,440,33,31,Tie
9256,JointPQPlayer,227,232,459,37,26,JointPQPlayer
9257,JointPQPlayer,265,265,530,51,7,Tie
9258,JointPQPlayer,229,224,453,37,28,Player A
9259,JointPQPlayer,263,263,526,56,10,Tie
9260,JointPQPlayer,253,258,511,47,12,JointPQPlayer
9261,JointPQPlayer,261,256,517,53,12,Player A
9262,JointPQPlayer,247,247,494,39,15,Tie
9263,JointPQPlayer,222,227,449,33,28,JointPQPlayer
9264,JointPQPlayer,257,257,514,50,12,Tie
9265,JointPQPlayer,268,263,531,49,6,Player A
9266,JointPQPlayer,259,259,518,45,9,Tie
9267,JointPQPlayer,242,242,484,41,19,Tie
9268,JointPQPlayer,176,176,352,8,52,Tie
9269,JointPQPlayer,249,249,498,43,15,Tie
9270,JointPQPlayer,254,254,508,38,10,Tie
9271,JointPQPlayer,245,245,490,44,18,Tie
9272,JointPQPlayer,266,266,532,47,5,Tie
9273,JointPQPlayer,190,195,385,14,43,JointPQPlayer
9274,JointPQPlayer,247,242,489,37,16,Player A
9275,JointPQPlayer,261,261,522,49,9,Tie
9276,JointPQPlayer,241,246,487,38,17,JointPQPlayer
9277,JointPQPlayer,268,263,531,52,7,Player A
9278,JointPQPlayer,244,244,488,48,20,Tie
9279,JointPQPlayer,242,242,484,38,18,Tie
9280,JointPQPlayer,262,267,529,50,7,JointPQPlayer
9281,JointPQPlayer,185,185,370,11,47,Tie
9282,JointPQPlayer,246,241,487,38,17,Player A
9283,JointPQPlayer,273,273,546,58,4,Tie
9284,JointPQPlayer,232,237,469,38,23,JointPQPlayer
9285,JointPQPlayer,249,244,493,44,17,Player A
9286,JointPQPlayer,260,260,520,50,10,Tie
9287,JointPQPlayer,255,260,515,60,15,JointPQPlayer
9288,JointPQPlayer,247,247,494,45,17,Tie
9289,JointPQPlayer,270,265,535,53,6,Player A
9290,JointPQPlayer,261,261,522,55,11,Tie
9291,JointPQPlayer,162,167,329,3,58,JointPQPlayer
9292,JointPQPlayer,256,256,512,48,12,Tie
9293,JointPQPlayer,225,225,450,34,28,Tie
9294,JointPQPlayer,255,250,505,44,13,Player A
9295,JointPQPlayer,242,242,484,44,20,Tie
9296,JointPQPlayer,167,167,334,5,57,Tie
9297,JointPQPlayer,262,262,524,54,10,Tie
9298,JointPQPlayer,254,254,508,47,13,Tie
9299,JointPQPlayer,265,265,530,51,7,Tie
9300,JointPQPlayer,268,268,536,57,7,Tie
9301,JointPQPlayer,269,269,538,50,4,Tie
9302,JointPQPlayer,263,263,526,50,8,Tie
9303,JointPQPlayer,266,266,532,53,7,Tie
9304,JointPQPlayer,188,193,381,16,45,JointPQPlayer
9305,JointPQPlayer,262,257,519,49,10,Player A
9306,JointPQPlayer,190,195,385,11,42,JointPQPlayer
9307,JointPQPlayer,248,243,491,45,18,Player A
9308,JointPQPlayer,230,235,465,34,23,JointPQPlayer
9309,JointPQPlayer,242,237,479,36,19,Player A
9310,JointPQPlayer,206,211,417,28,37,JointPQPlayer
9311,JointPQPlayer,263,258,521,45,8,Player A
9312,JointPQPlayer,172,172,344,12,56,Tie
9313,JointPQPlayer,262,262,524,54,10,Tie
9314,JointPQPlayer,241,241,482,33,17,Tie
9315,JointPQPlayer,251,251,502,44,14,Tie
9316,JointPQPlayer,234,239,473,39,22,JointPQPlayer
9317,JointPQPlayer,264,264,528,52,8,Tie
9318,JointPQPlayer,249,249,498,40,14,Tie
9319,JointPQPlayer,245,240,485,39,18,Player A
9320,JointPQPlayer,268,268,536,57,7,Tie
9321,JointPQPlayer,187,187,374,12,46,Tie
9322,JointPQPlayer,259,259,518,48,10,Tie
9323,JointPQPlayer,265,265,530,48,6,Tie
9324,JointPQPlayer,178,178,356,12,52,Tie
9325,JointPQPlayer,184,189,373,11,46,JointPQPlayer
9326,JointPQPlayer,245,240,485,42,19,Player A
9327,JointPQPlayer,260,260,520,47,9,Tie
9328,JointPQPlayer,253,258,511,50,13,JointPQPlayer
9329,JointPQPlayer,263,258,521,45,8,Player A
9330,JointPQPlayer,174,174,348,4,52,Tie
9331,JointPQPlayer,253,253,506,42,12,Tie
9332,JointPQPlayer,200,200,400,20,40,Tie
9333,JointPQPlayer,236,241,477,43,22,JointPQPlayer
9334,JointPQPlayer,262,262,524,48,8,Tie
9335,JointPQPlayer,192,192,384,16,44,Tie
9336,JointPQPlayer,246,241,487,47,20,Player A
9337,JointPQPlayer,267,272,539,57,6,JointPQPlayer
9338,JointPQPlayer,187,187,374,6,44,Tie
9339,JointPQPlayer,242,237,479,39,20,Player A
9340,JointPQPlayer,168,173,341,6,55,JointPQPlayer
9341,JointPQPlayer,254,249,503,42,13,Player A
9342,JointPQPlayer,186,191,377,9,44,JointPQPlayer
9343,JointPQPlayer,267,262,529,50,7,Player A
9344,JointPQPlayer,171,171,342,7,55,Tie
9345,JointPQPlayer,270,270,540,55,5,Tie
9346,JointPQPlayer,246,246,492,46,18,Tie
9347,JointPQPlayer,249,249,498,43,15,Tie
9348,JointPQPlayer,172,177,349,11,54,JointPQPlayer
9349,JointPQPlayer,273,273,546,58,4,Tie
9350,JointPQPlayer,208,203,411,22,37,Player A
9351,JointPQPlayer,263,263,526,47,7,Tie
9352,JointPQPlayer,256,256,512,51,13,Tie
9353,JointPQPlayer,255,255,510,43,11,Tie
9354,JointPQPlayer,258,258,516,52,12,Tie
9355,JointPQPlayer,239,244,483,43,20,JointPQPlayer
9356,JointPQPlayer,273,268,541,59,6,Player A
9357,JointPQPlayer,274,274,548,63,5,Tie
9358,JointPQPlayer,243,243,486,43,19,Tie
9359,JointPQPlayer,256,256,512,48,12,Tie
9360,JointPQPlayer,254,254,508,47,13,Tie
9361,JointPQPlayer,218,223,441,28,29,JointPQPlayer
9362,JointPQPlayer,264,259,523,50,9,Player A
9363,JointPQPlayer,253,253,506,48,14,Tie
9364,JointPQPlayer,260,260,520,47,9,Tie
9365,JointPQPlayer,255,255,510,49,13,Tie
9366,JointPQPlayer,201,201,402,28,42,Tie
9367,JointPQPlayer,200,200,400,17,39,Tie
9368,JointPQPlayer,262,262,524,48,8,Tie
9369,JointPQPlayer,256,261,517,56,13,JointPQPlayer
9370,JointPQPlayer,179,179,358,5,49,Tie
9371,JointPQPlayer,276,276,552,61,3,Tie
9372,JointPQPlayer,259,259,518,45,9,Tie
9373,JointPQPlayer,247,242,489,40,17,Player A
9374,JointPQPlayer,231,236,467,39,24,JointPQPlayer
9375,JointPQPlayer,255,250,505,44,13,Player A
9376,JointPQPlayer,274,274,548,60,4,Tie
9377,JointPQPlayer,254,254,508,41,11,Tie
9378,JointPQPlayer,242,247,489,40,17,JointPQPlayer
9379,JointPQPlayer,203,198,401,27,42,Player A
9380,JointPQPlayer,240,240,480,46,22,Tie
9381,JointPQPlayer,261,266,527,54,9,JointPQPlayer
9382,JointPQPlayer,238,233,471,40,23,Player A
9383,JointPQPlayer,234,234,468,37,23,Tie
9384,JointPQPlayer,255,260,515,45,10,JointPQPlayer
9385,JointPQPlayer,252,247,499,41,14,Player A
9386,JointPQPlayer,271,271,542,54,4,Tie
9387,JointPQPlayer,258,258,516,46,10,Tie
9388,JointPQPlayer,260,260,520,50,10,Tie
9389,JointPQPlayer,263,263,526,44,6,Tie
9390,JointPQPlayer,269,269,538,62,8,Tie
9391,JointPQPlayer,255,255,510,49,13,Tie
9392,JointPQPlayer,246,246,492,43,17,Tie
9393,JointPQPlayer,262,262,524,48,8,Tie
9394,JointPQPlayer,249,254,503,42,13,JointPQPlayer
9395,JointPQPlayer,267,267,534,49,5,Tie
9396,JointPQPlayer,160,160,320,6,62,Tie
9397,JointPQPlayer,258,253,511,50,13,Player A
9398,JointPQPlayer,258,258,516,52,12,Tie
9399,JointPQPlayer,234,234,468,40,24,Tie
9400,JointPQPlayer,266,266,532,47,5,Tie
9401,JointPQPlayer,197,197,394,23,43,Tie
9402,JointPQPlayer,252,252,504,40,12,Tie
9403,JointPQPlayer,267,267,534,49,5,Tie
9404,JointPQPlayer,192,192,384,16,44,Tie
9405,JointPQPlayer,238,238,476,33,19,Tie
9406,JointPQPlayer,265,265,530,51,7,Tie
9407,JointPQPlayer,259,264,523,47,8,JointPQPlayer
9408,JointPQPlayer,252,247,499,38,13,Player A
9409,JointPQPlayer,255,255,510,40,10,Tie
9410,JointPQPlayer,269,269,538,53,5,Tie
9411,JointPQPlayer,281,281,562,68,2,Tie
9412,JointPQPlayer,236,236,472,44,24,Tie
9413,JointPQPlayer,212,212,424,35,37,Tie
9414,JointPQPlayer,247,252,499,44,15,JointPQPlayer
9415,JointPQPlayer,235,235,470,39,23,Tie
9416,JointPQPlayer,173,173,346,5,53,Tie
9417,JointPQPlayer,174,169,343,8,55,Player A
9418,JointPQPlayer,193,193,386,27,47,Tie
9419,JointPQPlayer,260,265,525,49,8,JointPQPlayer
9420,JointPQPlayer,236,231,467,30,21,Player A
9421,JointPQPlayer,262,267,529,50,7,JointPQPlayer
9422,JointPQPlayer,246,246,492,40,16,Tie
9423,JointPQPlayer,248,243,491,42,17,Player A
9424,JointPQPlayer,271,271,542,63,7,Tie
9425,JointPQPlayer,257,262,519,49,10,JointPQPlayer
9426,JointPQPlayer,271,266,537,55,6,Player A
9427,JointPQPlayer,273,278,551,60,3,JointPQPlayer
9428,JointPQPlayer,266,261,527,48,7,Player A
9429,JointPQPlayer,232,232,464,39,25,Tie
9430,JointPQPlayer,205,205,410,24,38,Tie
9431,JointPQPlayer,264,264,528,55,9,Tie
9432,JointPQPlayer,250,255,505,38,11,JointPQPlayer
9433,JointPQPlayer,256,256,512,51,13,Tie
9434,JointPQPlayer,272,267,539,57,6,Player A
9435,JointPQPlayer,258,258,516,52,12,Tie
9436,JointPQPlayer,254,254,508,41,11,Tie
9437,JointPQPlayer,178,183,361,8,49,JointPQPlayer
9438,JointPQPlayer,218,213,431,27,32,Player A
9439,JointPQPlayer,193,193,386,24,46,Tie
9440,JointPQPlayer,178,183,361,11,50,JointPQPlayer
9441,JointPQPlayer,246,241,487,32,15,Player A
9442,JointPQPlayer,262,262,524,48,8,Tie
9443,JointPQPlayer,246,246,492,40,16,Tie
9444,JointPQPlayer,253,253,506,42,12,Tie
9445,JointPQPlayer,193,198,391,11,40,JointPQPlayer
9446,JointPQPlayer,277,272,549,61,4,Player A
9447,JointPQPlayer,264,269,533,54,7,JointPQPlayer
9448,JointPQPlayer,182,182,364,8,48,Tie
9449,JointPQPlayer,193,193,386,9,41,Tie
9450,JointPQPlayer,228,223,451,35,28,Player A
9451,JointPQPlayer,172,172,344,3,53,Tie
9452,JointPQPlayer,262,262,524,51,9,Tie
9453,JointPQPlayer,194,199,393,16,41,JointPQPlayer
9454,JointPQPlayer,263,258,521,48,9,Player A
9455,JointPQPlayer,264,264,528,49,7,Tie
9456,JointPQPlayer,246,251,497,36,13,JointPQPlayer
9457,JointPQPlayer,187,187,374,6,44,Tie
9458,JointPQPlayer,240,240,480,43,21,Tie
9459,JointPQPlayer,266,261,527,51,8,Player A
9460,JointPQPlayer,259,264,523,47,8,JointPQPlayer
9461,JointPQPlayer,263,263,526,56,10,Tie
9462,JointPQPlayer,257,257,514,53,13,Tie
9463,JointPQPlayer,261,261,522,49,9,Tie
9464,JointPQPlayer,221,221,442,29,29,Tie
9465,JointPQPlayer,260,255,515,51,12,Player A
9466,JointPQPlayer,187,192,379,11,44,JointPQPlayer
9467,JointPQPlayer,267,267,534,52,6,Tie
9468,JointPQPlayer,210,205,415,23,36,Player A
9469,JointPQPlayer,244,249,493,38,15,JointPQPlayer
9470,JointPQPlayer,266,261,527,57,10,Player A
9471,JointPQPlayer,243,243,486,43,19,Tie
9472,JointPQPlayer,259,264,523,56,11,JointPQPlayer
9473,JointPQPlayer,176,176,352,5,51,Tie
9474,JointPQPlayer,259,259,518,45,9,Tie
9475,JointPQPlayer,256,251,507,37,10,Player A
9476,JointPQPlayer,258,263,521,48,9,JointPQPlayer
9477,JointPQPlayer,248,243,491,39,16,Player A
9478,JointPQPlayer,268,268,536,54,6,Tie
9479,JointPQPlayer,264,264,528,55,9,Tie
9480,JointPQPlayer,252,257,509,48,13,JointPQPlayer
9481,JointPQPlayer,273,268,541,53,4,Player A
9482,JointPQPlayer,270,270,540,52,4,Tie
9483,JointPQPlayer,269,269,538,56,6,Tie
9484,JointPQPlayer,260,260,520,41,7,Tie
9485,JointPQPlayer,167,172,339,7,56,JointPQPlayer
9486,JointPQPlayer,272,272,544,53,3,Tie
9487,JointPQPlayer,165,165,330,4,58,Tie
9488,JointPQPlayer,253,248,501,43,14,Player A
9489,JointPQPlayer,256,256,512,45,11,Tie
9490,JointPQPlayer,256,256,512,48,12,Tie
9491,JointPQPlayer,262,262,524,54,10,Tie
9492,JointPQPlayer,166,171,337,8,57,JointPQPlayer
9493,JointPQPlayer,257,257,514,47,11,Tie
9494,JointPQPlayer,250,250,500,42,14,Tie
9495,JointPQPlayer,249,244,493,38,15,Player A
9496,JointPQPlayer,244,249,493,50,19,JointPQPlayer
9497,JointPQPlayer,270,270,540,58,6,Tie
9498,JointPQPlayer,254,249,503,45,14,Player A
9499,JointPQPlayer,248,248,496,38,14,Tie
9500,JointPQPlayer,256,261,517,47,10,JointPQPlayer
9501,JointPQPlayer,250,245,495,49,18,Player A
9502,JointPQPlayer,269,274,543,55,4,JointPQPlayer
9503,JointPQPlayer,253,253,506,45,13,Tie
9504,JointPQPlayer,251,246,497,51,18,Player A
9505,JointPQPlayer,241,246,487,44,19,JointPQPlayer
9506,JointPQPlayer,179,174,353,9,52,Player A
9507,JointPQPlayer,253,253,506,48,14,Tie
9508,JointPQPlayer,176,176,352,5,51,Tie
9509,JointPQPlayer,241,246,487,38,17,JointPQPlayer
9510,JointPQPlayer,221,221,442,29,29,Tie
9511,JointPQPlayer,221,216,437,21,28,Player A
9512,JointPQPlayer,246,251,497,48,17,JointPQPlayer
9513,JointPQPlayer,263,258,521,54,11,Player A
9514,JointPQPlayer,221,226,447,34,29,JointPQPlayer
9515,JointPQPlayer,177,177,354,10,52,Tie
9516,JointPQPlayer,180,175,355,11,52,Player A
9517,JointPQPlayer,239,244,483,43,20,JointPQPlayer
9518,JointPQPlayer,265,260,525,61,12,Player A
9519,JointPQPlayer,250,250,500,48,16,Tie
9520,JointPQPlayer,261,261,522,55,11,Tie
9521,JointPQPlayer,264,264,528,52,8,Tie
9522,JointPQPlayer,241,241,482,36,18,Tie
9523,JointPQPlayer,257,257,514,44,10,Tie
9524,JointPQPlayer,273,278,551,60,3,JointPQPlayer
9525,JointPQPlayer,181,181,362,9,49,Tie
9526,JointPQPlayer,252,247,499,44,15,Player A
9527,JointPQPlayer,254,259,513,46,11,JointPQPlayer
9528,JointPQPlayer,274,269,543,58,5,Player A
9529,JointPQPlayer,241,241,482,45,21,Tie
9530,JointPQPlayer,243,243,486,43,19,Tie
9531,JointPQPlayer,259,259,518,48,10,Tie
9532,JointPQPlayer,255,255,510,40,10,Tie
9533,JointPQPlayer,246,246,492,46,18,Tie
9534,JointPQPlayer,152,157,309,4,65,JointPQPlayer
9535,JointPQPlayer,250,245,495,49,18,Player A
9536,JointPQPlayer,259,259,518,48,10,Tie
9537,JointPQPlayer,237,237,474,40,22,Tie
9538,JointPQPlayer,223,223,446,33,29,Tie
9539,JointPQPlayer,266,266,532,50,6,Tie
9540,JointPQPlayer,257,257,514,47,11,Tie
9541,JointPQPlayer,245,250,495,43,16,JointPQPlayer
9542,JointPQPlayer,255,250,505,44,13,Player A
9543,JointPQPlayer,178,178,356,6,50,Tie
9544,JointPQPlayer,247,247,494,45,17,Tie
9545,JointPQPlayer,250,255,505,50,15,JointPQPlayer
9546,JointPQPlayer,241,241,482,30,16,Tie
9547,JointPQPlayer,259,254,513,49,12,Player A
9548,JointPQPlayer,199,204,403,32,43,JointPQPlayer
9549,JointPQPlayer,269,264,533,48,5,Player A
9550,JointPQPlayer,264,264,528,52,8,Tie
9551,JointPQPlayer,247,247,494,45,17,Tie
9552,JointPQPlayer,172,172,344,9,55,Tie
9553,JointPQPlayer,248,248,496,47,17,Tie
9554,JointPQPlayer,239,239,478,38,20,Tie
9555,JointPQPlayer,192,197,389,12,41,JointPQPlayer
9556,JointPQPlayer,270,265,535,53,6,Player A
9557,JointPQPlayer,188,188,376,14,46,Tie
9558,JointPQPlayer,240,240,480,40,20,Tie
9559,JointPQPlayer,174,179,353,3,50,JointPQPlayer
9560,JointPQPlayer,265,265,530,48,6,Tie
9561,JointPQPlayer,264,259,523,50,9,Player A
9562,JointPQPlayer,190,195,385,26,47,JointPQPlayer
9563,JointPQPlayer,185,180,365,6,47,Player A
9564,JointPQPlayer,272,272,544,50,2,Tie
9565,JointPQPlayer,263,263,526,50,8,Tie
9566,JointPQPlayer,250,255,505,38,11,JointPQPlayer
9567,JointPQPlayer,266,261,527,51,8,Player A
9568,JointPQPlayer,221,226,447,25,26,JointPQPlayer
9569,JointPQPlayer,245,245,490,41,17,Tie
9570,JointPQPlayer,253,253,506,45,13,Tie
9571,JointPQPlayer,173,173,346,5,53,Tie
9572,JointPQPlayer,265,260,525,52,9,Player A
9573,JointPQPlayer,252,257,509,42,11,JointPQPlayer
9574,JointPQPlayer,239,234,473,30,19,Player A
9575,JointPQPlayer,244,244,488,42,18,Tie
9576,JointPQPlayer,252,252,504,46,14,Tie
9577,JointPQPlayer,168,173,341,9,56,JointPQPlayer
9578,JointPQPlayer,245,245,490,50,20,Tie
9579,JointPQPlayer,259,254,513,46,11,Player A
9580,JointPQPlayer,250,255,505,44,13,JointPQPlayer
9581,JointPQPlayer,241,236,477,49,24,Player A
9582,JointPQPlayer,248,248,496,41,15,Tie
9583,JointPQPlayer,182,187,369,13,48,JointPQPlayer
9584,JointPQPlayer,264,264,528,49,7,Tie
9585,JointPQPlayer,244,244,488,36,16,Tie
9586,JointPQPlayer,248,243,491,45,18,Player A
9587,JointPQPlayer,259,264,523,50,9,JointPQPlayer
9588,JointPQPlayer,187,187,374,6,44,Tie
9589,JointPQPlayer,263,258,521,51,10,Player A
9590,JointPQPlayer,253,258,511,44,11,JointPQPlayer
9591,JointPQPlayer,255,255,510,49,13,Tie
9592,JointPQPlayer,234,234,468,31,21,Tie
9593,JointPQPlayer,170,165,335,6,57,Player A
9594,JointPQPlayer,252,252,504,52,16,Tie
9595,JointPQPlayer,257,262,519,49,10,JointPQPlayer
9596,JointPQPlayer,182,182,364,5,47,Tie
9597,JointPQPlayer,176,176,352,11,53,Tie
9598,JointPQPlayer,253,248,501,37,12,Player A
9599,JointPQPlayer,170,175,345,4,53,JointPQPlayer
9600,JointPQPlayer,176,176,352,11,53,Tie
9601,JointPQPlayer,250,245,495,40,15,Player A
9602,JointPQPlayer,250,250,500,45,15,Tie
9603,JointPQPlayer,258,258,516,40,8,Tie
9604,JointPQPlayer,265,265,530,51,7,Tie
9605,JointPQPlayer,169,174,343,11,56,JointPQPlayer
9606,JointPQPlayer,206,206,412,26,38,Tie
9607,JointPQPlayer,257,252,509,42,11,Player A
9608,JointPQPlayer,262,267,529,50,7,JointPQPlayer
9609,JointPQPlayer,227,227,454,32,26,Tie
9610,JointPQPlayer,154,149,303,7,68,Player A
9611,JointPQPlayer,260,260,520,47,9,Tie
9612,JointPQPlayer,259,259,518,48,10,Tie
9613,JointPQPlayer,195,200,395,21,42,JointPQPlayer
9614,JointPQPlayer,255,255,510,52,14,Tie
9615,JointPQPlayer,254,249,503,51,16,Player A
9616,JointPQPlayer,248,248,496,38,14,Tie
9617,JointPQPlayer,269,274,543,58,5,JointPQPlayer
9618,JointPQPlayer,179,179,358,11,51,Tie
9619,JointPQPlayer,178,178,356,21,55,Tie
9620,JointPQPlayer,260,255,515,45,10,Player A
9621,JointPQPlayer,190,195,385,20,45,JointPQPlayer
9622,JointPQPlayer,259,254,513,46,11,Player A
9623,JointPQPlayer,250,250,500,36,12,Tie
9624,JointPQPlayer,177,177,354,13,53,Tie
9625,JointPQPlayer,172,177,349,11,54,JointPQPlayer
9626,JointPQPlayer,263,258,521,45,8,Player A
9627,JointPQPlayer,222,227,449,33,28,JointPQPlayer
9628,JointPQPlayer,246,246,492,49,19,Tie
9629,JointPQPlayer,190,190,380,12,44,Tie
9630,JointPQPlayer,279,274,553,65,4,Player A
9631,JointPQPlayer,223,228,451,26,25,JointPQPlayer
9632,JointPQPlayer,255,250,505,41,12,Player A
9633,JointPQPlayer,227,232,459,28,23,JointPQPlayer
9634,JointPQPlayer,165,165,330,1,57,Tie
9635,JointPQPlayer,263,258,521,42,7,Player A
9636,JointPQPlayer,212,212,424,20,32,Tie
9637,JointPQPlayer,241,241,482,33,17,Tie
9638,JointPQPlayer,260,260,520,50,10,Tie
9639,JointPQPlayer,198,198,396,13,39,Tie
9640,JointPQPlayer,264,264,528,52,8,Tie
9641,JointPQPlayer,255,255,510,49,13,Tie
9642,JointPQPlayer,228,228,456,34,26,Tie
9643,JointPQPlayer,267,267,534,49,5,Tie
9644,JointPQPlayer,247,247,494,39,15,Tie
9645,JointPQPlayer,247,252,499,44,15,JointPQPlayer
9646,JointPQPlayer,259,259,518,42,8,Tie
9647,JointPQPlayer,177,172,349,8,53,Player A
9648,JointPQPlayer,260,260,520,47,9,Tie
9649,JointPQPlayer,242,242,484,38,18,Tie
9650,JointPQPlayer,270,270,540,49,3,Tie
9651,JointPQPlayer,277,282,559,65,2,JointPQPlayer
9652,JointPQPlayer,262,262,524,54,10,Tie
9653,JointPQPlayer,168,168,336,7,57,Tie
9654,JointPQPlayer,259,259,518,48,10,Tie
9655,JointPQPlayer,237,232,469,41,24,Player A
9656,JointPQPlayer,237,237,474,37,21,Tie
9657,JointPQPlayer,242,242,484,41,19,Tie
9658,JointPQPlayer,264,264,528,55,9,Tie
9659,JointPQPlayer,263,263,526,47,7,Tie
9660,JointPQPlayer,228,228,456,28,24,Tie
9661,JointPQPlayer,257,257,514,47,11,Tie
9662,JointPQPlayer,181,186,367,8,47,JointPQPlayer
9663,JointPQPlayer,251,246,497,48,17,Player A
9664,JointPQPlayer,215,220,435,31,32,JointPQPlayer
9665,JointPQPlayer,265,260,525,58,11,Player A
9666,JointPQPlayer,245,245,490,38,16,Tie
9667,JointPQPlayer,269,269,538,56,6,Tie
9668,JointPQPlayer,266,271,537,64,9,JointPQPlayer
9669,JointPQPlayer,260,255,515,51,12,Player A
9670,JointPQPlayer,267,267,534,52,6,Tie
9671,JointPQPlayer,182,182,364,11,49,Tie
9672,JointPQPlayer,269,269,538,56,6,Tie
9673,JointPQPlayer,278,283,561,64,1,JointPQPlayer
9674,JointPQPlayer,201,196,397,17,40,Player A
9675,JointPQPlayer,248,248,496,38,14,Tie
9676,JointPQPlayer,267,267,534,52,6,Tie
9677,JointPQPlayer,259,259,518,45,9,Tie
9678,JointPQPlayer,268,268,536,51,5,Tie
9679,JointPQPlayer,156,161,317,6,63,JointPQPlayer
9680,JointPQPlayer,209,204,413,24,37,Player A
9681,JointPQPlayer,237,242,479,45,22,JointPQPlayer
9682,JointPQPlayer,251,246,497,45,16,Player A
9683,JointPQPlayer,231,231,462,28,22,Tie
9684,JointPQPlayer,265,265,530,48,6,Tie
9685,JointPQPlayer,251,251,502,47,15,Tie
9686,JointPQPlayer,268,268,536,54,6,Tie
9687,JointPQPlayer,266,266,532,50,6,Tie
9688,JointPQPlayer,270,275,545,57,4,JointPQPlayer
9689,JointPQPlayer,223,223,446,27,27,Tie
9690,JointPQPlayer,254,249,503,45,14,Player A
9691,JointPQPlayer,212,217,429,19,30,JointPQPlayer
9692,JointPQPlayer,265,260,525,52,9,Player A
9693,JointPQPlayer,275,275,550,59,3,Tie
9694,JointPQPlayer,260,260,520,47,9,Tie
9695,JointPQPlayer,232,237,469,38,23,JointPQPlayer
9696,JointPQPlayer,250,250,500,39,13,Tie
9697,JointPQPlayer,253,248,501,49,16,Player A
9698,JointPQPlayer,253,253,506,48,14,Tie
9699,JointPQPlayer,256,256,512,45,11,Tie
9700,JointPQPlayer,239,239,478,29,17,Tie
9701,JointPQPlayer,257,262,519,46,9,JointPQPlayer
9702,JointPQPlayer,233,228,461,33,24,Player A
9703,JointPQPlayer,268,268,536,54,6,Tie
9704,JointPQPlayer,231,236,467,36,23,JointPQPlayer
9705,JointPQPlayer,275,275,550,59,3,Tie
9706,JointPQPlayer,261,256,517,41,8,Player A
9707,JointPQPlayer,260,265,525,52,9,JointPQPlayer
9708,JointPQPlayer,261,256,517,53,12,Player A
9709,JointPQPlayer,262,267,529,53,8,JointPQPlayer
9710,JointPQPlayer,249,249,498,43,15,Tie
9711,JointPQPlayer,236,236,472,41,23,Tie
9712,JointPQPlayer,214,209,423,19,32,Player A
9713,JointPQPlayer,164,169,333,4,57,JointPQPlayer
9714,JointPQPlayer,258,253,511,53,14,Player A
9715,JointPQPlayer,267,267,534,58,8,Tie
9716,JointPQPlayer,236,241,477,34,19,JointPQPlayer
9717,JointPQPlayer,247,242,489,37,16,Player A
9718,JointPQPlayer,227,232,459,37,26,JointPQPlayer
9719,JointPQPlayer,176,176,352,8,52,Tie
9720,JointPQPlayer,197,197,394,17,41,Tie
9721,JointPQPlayer,267,262,529,56,9,Player A
9722,JointPQPlayer,245,245,490,35,15,Tie
9723,JointPQPlayer,254,254,508,47,13,Tie
9724,JointPQPlayer,272,272,544,56,4,Tie
9725,JointPQPlayer,235,235,470,39,23,Tie
9726,JointPQPlayer,261,266,527,48,7,JointPQPlayer
9727,JointPQPlayer,275,270,545,66,7,Player A
9728,JointPQPlayer,280,280,560,75,5,Tie
9729,JointPQPlayer,261,261,522,46,8,Tie
9730,JointPQPlayer,204,209,413,21,36,JointPQPlayer
9731,JointPQPlayer,226,221,447,28,27,Player A
9732,JointPQPlayer,265,265,530,48,6,Tie
9733,JointPQPlayer,252,257,509,51,14,JointPQPlayer
9734,JointPQPlayer,255,250,505,50,15,Player A
9735,JointPQPlayer,256,256,512,45,11,Tie
9736,JointPQPlayer,253,253,506,48,14,Tie
9737,JointPQPlayer,276,276,552,58,2,Tie
9738,JointPQPlayer,260,260,520,44,8,Tie
9739,JointPQPlayer,203,203,406,20,38,Tie
9740,JointPQPlayer,243,243,486,40,18,Tie
9741,JointPQPlayer,261,261,522,40,6,Tie
9742,JointPQPlayer,262,267,529,50,7,JointPQPlayer
9743,JointPQPlayer,212,207,419,27,36,Player A
9744,JointPQPlayer,256,256,512,54,14,Tie
9745,JointPQPlayer,213,213,426,28,34,Tie
9746,JointPQPlayer,237,237,474,40,22,Tie
9747,JointPQPlayer,174,179,353,6,51,JointPQPlayer
9748,JointPQPlayer,238,233,471,37,22,Player A
9749,JointPQPlayer,238,238,476,39,21,Tie
9750,JointPQPlayer,262,262,524,57,11,Tie
9751,JointPQPlayer,247,252,499,41,14,JointPQPlayer
9752,JointPQPlayer,229,229,458,33,25,Tie
9753,JointPQPlayer,264,259,523,47,8,Player A
9754,JointPQPlayer,277,277,554,66,4,Tie
9755,JointPQPlayer,248,253,501,37,12,JointPQPlayer
9756,JointPQPlayer,192,187,379,11,44,Player A
9757,JointPQPlayer,256,256,512,42,10,Tie
9758,JointPQPlayer,226,226,452,30,26,Tie
9759,JointPQPlayer,213,218,431,21,30,JointPQPlayer
9760,JointPQPlayer,255,255,510,46,12,Tie
9761,JointPQPlayer,259,259,518,48,10,Tie
9762,JointPQPlayer,268,263,531,58,9,Player A
9763,JointPQPlayer,178,178,356,9,51,Tie
9764,JointPQPlayer,204,204,408,25,39,Tie
9765,JointPQPlayer,180,180,360,10,50,Tie
9766,JointPQPlayer,167,172,339,7,56,JointPQPlayer
9767,JointPQPlayer,271,266,537,55,6,Player A
9768,JointPQPlayer,172,177,349,2,51,JointPQPlayer
9769,JointPQPlayer,247,247,494,36,14,Tie
9770,JointPQPlayer,278,273,551,60,3,Player A
9771,JointPQPlayer,268,268,536,48,4,Tie
9772,JointPQPlayer,245,245,490,41,17,Tie
9773,JointPQPlayer,241,241,482,33,17,Tie
9774,JointPQPlayer,248,248,496,41,15,Tie
9775,JointPQPlayer,261,261,522,58,12,Tie
9776,JointPQPlayer,238,238,476,42,22,Tie
9777,JointPQPlayer,229,229,458,36,26,Tie
9778,JointPQPlayer,261,261,522,49,9,Tie
9779,JointPQPlayer,255,255,510,43,11,Tie
9780,JointPQPlayer,231,231,462,31,23,Tie
9781,JointPQPlayer,188,188,376,8,44,Tie
9782,JointPQPlayer,253,258,511,53,14,JointPQPlayer
9783,JointPQPlayer,166,166,332,6,58,Tie
9784,JointPQPlayer,262,262,524,51,9,Tie
9785,JointPQPlayer,193,188,381,19,46,Player A
9786,JointPQPlayer,250,250,500,48,16,Tie
9787,JointPQPlayer,251,251,502,41,13,Tie
9788,JointPQPlayer,264,264,528,49,7,Tie
9789,JointPQPlayer,261,261,522,49,9,Tie
9790,JointPQPlayer,254,254,508,47,13,Tie
9791,JointPQPlayer,254,254,508,47,13,Tie
9792,JointPQPlayer,247,247,494,42,16,Tie
9793,JointPQPlayer,248,253,501,52,17,JointPQPlayer
9794,JointPQPlayer,149,144,293,3,70,Player A
9795,JointPQPlayer,263,263,526,53,9,Tie
9796,JointPQPlayer,270,270,540,61,7,Tie
9797,JointPQPlayer,252,257,509,51,14,JointPQPlayer
9798,JointPQPlayer,228,223,451,35,28,Player A
9799,JointPQPlayer,255,255,510,43,11,Tie
9800,JointPQPlayer,261,261,522,52,10,Tie
9801,JointPQPlayer,260,260,520,50,10,Tie
9802,JointPQPlayer,179,179,358,5,49,Tie
9803,JointPQPlayer,198,203,401,18,39,JointPQPlayer
9804,JointPQPlayer,249,249,498,43,15,Tie
9805,JointPQPlayer,246,246,492,46,18,Tie
9806,JointPQPlayer,164,164,328,8,60,Tie
9807,JointPQPlayer,196,191,387,19,44,Player A
9808,JointPQPlayer,247,247,494,45,17,Tie
9809,JointPQPlayer,261,261,522,49,9,Tie
9810,JointPQPlayer,238,238,476,48,24,Tie
9811,JointPQPlayer,264,264,528,52,8,Tie
9812,JointPQPlayer,262,262,524,45,7,Tie
9813,JointPQPlayer,249,249,498,52,18,Tie
9814,JointPQPlayer,253,258,511,50,13,JointPQPlayer
9815,JointPQPlayer,243,243,486,43,19,Tie
9816,JointPQPlayer,260,255,515,42,9,Player A
9817,JointPQPlayer,254,254,508,41,11,Tie
9818,JointPQPlayer,186,186,372,13,47,Tie
9819,JointPQPlayer,238,238,476,39,21,Tie
9820,JointPQPlayer,254,259,513,49,12,JointPQPlayer
9821,JointPQPlayer,264,259,523,47,8,Player A
9822,JointPQPlayer,277,277,554,69,5,Tie
9823,JointPQPlayer,273,273,546,55,3,Tie
9824,JointPQPlayer,260,265,525,46,7,JointPQPlayer
9825,JointPQPlayer,263,263,526,47,7,Tie
9826,JointPQPlayer,245,240,485,39,18,Player A
9827,JointPQPlayer,245,250,495,46,17,JointPQPlayer
9828,JointPQPlayer,170,170,340,8,56,Tie
9829,JointPQPlayer,211,206,417,25,36,Player A
9830,JointPQPlayer,263,263,526,53,9,Tie
9831,JointPQPlayer,168,173,341,3,54,JointPQPlayer
9832,JointPQPlayer,261,256,517,59,14,Player A
9833,JointPQPlayer,237,242,479,36,19,JointPQPlayer
9834,JointPQPlayer,269,269,538,56,6,Tie
9835,JointPQPlayer,164,164,328,2,58,Tie
9836,JointPQPlayer,243,238,481,38,19,Player A
9837,JointPQPlayer,252,252,504,40,12,Tie
9838,JointPQPlayer,257,262,519,46,9,JointPQPlayer
9839,JointPQPlayer,176,176,352,5,51,Tie
9840,JointPQPlayer,233,233,466,41,25,Tie
9841,JointPQPlayer,181,181,362,3,47,Tie
9842,JointPQPlayer,164,164,328,5,59,Tie
9843,JointPQPlayer,184,179,363,10,49,Player A
9844,JointPQPlayer,183,188,371,21,50,JointPQPlayer
9845,JointPQPlayer,264,259,523,47,8,Player A
9846,JointPQPlayer,232,237,469,41,24,JointPQPlayer
9847,JointPQPlayer,256,251,507,52,15,Player A
9848,JointPQPlayer,229,229,458,33,25,Tie
9849,JointPQPlayer,272,272,544,53,3,Tie
9850,JointPQPlayer,271,271,542,54,4,Tie
9851,JointPQPlayer,263,263,526,41,5,Tie
9852,JointPQPlayer,190,195,385,17,44,JointPQPlayer
9853,JointPQPlayer,171,171,342,4,54,Tie
9854,JointPQPlayer,259,254,513,40,9,Player A
9855,JointPQPlayer,184,184,368,12,48,Tie
9856,JointPQPlayer,208,208,416,15,33,Tie
9857,JointPQPlayer,251,256,507,40,11,JointPQPlayer
9858,JointPQPlayer,183,178,361,11,50,Player A
9859,JointPQPlayer,271,271,542,54,4,Tie
9860,JointPQPlayer,246,251,497,39,14,JointPQPlayer
9861,JointPQPlayer,213,208,421,32,37,Player A
9862,JointPQPlayer,229,229,458,27,23,Tie
9863,JointPQPlayer,246,251,497,48,17,JointPQPlayer
9864,JointPQPlayer,229,224,453,34,27,Player A
9865,JointPQPlayer,253,253,506,54,16,Tie
9866,JointPQPlayer,176,181,357,7,50,JointPQPlayer
9867,JointPQPlayer,247,242,489,46,19,Player A
9868,JointPQPlayer,192,192,384,22,46,Tie
9869,JointPQPlayer,250,255,505,50,15,JointPQPlayer
9870,JointPQPlayer,228,223,451,32,27,Player A
9871,JointPQPlayer,266,266,532,50,6,Tie
9872,JointPQPlayer,234,234,468,37,23,Tie
9873,JointPQPlayer,252,252,504,46,14,Tie
9874,JointPQPlayer,260,260,520,53,11,Tie
9875,JointPQPlayer,225,225,450,28,26,Tie
9876,JointPQPlayer,209,209,418,20,34,Tie
9877,JointPQPlayer,186,191,377,9,44,JointPQPlayer
9878,JointPQPlayer,259,254,513,46,11,Player A
9879,JointPQPlayer,246,246,492,40,16,Tie
9880,JointPQPlayer,234,234,468,34,22,Tie
9881,JointPQPlayer,190,195,385,14,43,JointPQPlayer
9882,JointPQPlayer,217,212,429,22,31,Player A
9883,JointPQPlayer,164,169,333,1,56,JointPQPlayer
9884,JointPQPlayer,245,240,485,42,19,Player A
9885,JointPQPlayer,247,247,494,36,14,Tie
9886,JointPQPlayer,187,192,379,14,45,JointPQPlayer
9887,JointPQPlayer,252,247,499,44,15,Player A
9888,JointPQPlayer,264,264,528,46,6,Tie
9889,JointPQPlayer,209,214,423,22,33,JointPQPlayer
9890,JointPQPlayer,245,240,485,33,16,Player A
9891,JointPQPlayer,227,232,459,34,25,JointPQPlayer
9892,JointPQPlayer,238,233,471,37,22,Player A
9893,JointPQPlayer,265,265,530,51,7,Tie
9894,JointPQPlayer,265,265,530,54,8,Tie
9895,JointPQPlayer,180,180,360,10,50,Tie
9896,JointPQPlayer,193,193,386,24,46,Tie
9897,JointPQPlayer,258,258,516,49,11,Tie
9898,JointPQPlayer,220,225,445,32,29,JointPQPlayer
9899,JointPQPlayer,268,263,531,52,7,Player A
9900,JointPQPlayer,260,260,520,50,10,Tie
9901,JointPQPlayer,260,265,525,49,8,JointPQPlayer
9902,JointPQPlayer,236,231,467,42,25,Player A
9903,JointPQPlayer,245,245,490,38,16,Tie
9904,JointPQPlayer,260,260,520,53,11,Tie
9905,JointPQPlayer,259,264,523,50,9,JointPQPlayer
9906,JointPQPlayer,260,255,515,45,10,Player A
9907,JointPQPlayer,263,263,526,53,9,Tie
9908,JointPQPlayer,257,257,514,44,10,Tie
9909,JointPQPlayer,271,271,542,54,4,Tie
9910,JointPQPlayer,244,249,493,41,16,JointPQPlayer
9911,JointPQPlayer,260,255,515,39,8,Player A
9912,JointPQPlayer,270,275,545,57,4,JointPQPlayer
9913,JointPQPlayer,240,235,475,32,19,Player A
9914,JointPQPlayer,265,265,530,54,8,Tie
9915,JointPQPlayer,230,230,460,41,27,Tie
9916,JointPQPlayer,183,188,371,12,47,JointPQPlayer
9917,JointPQPlayer,258,253,511,41,10,Player A
9918,JointPQPlayer,221,221,442,38,32,Tie
9919,JointPQPlayer,260,265,525,58,11,JointPQPlayer
9920,JointPQPlayer,179,179,358,5,49,Tie
9921,JointPQPlayer,251,251,502,50,16,Tie
9922,JointPQPlayer,250,250,500,45,15,Tie
9923,JointPQPlayer,167,162,329,3,58,Player A
9924,JointPQPlayer,251,256,507,46,13,JointPQPlayer
9925,JointPQPlayer,259,259,518,51,11,Tie
9926,JointPQPlayer,255,250,505,44,13,Player A
9927,JointPQPlayer,224,229,453,25,24,JointPQPlayer
9928,JointPQPlayer,265,260,525,55,10,Player A
9929,JointPQPlayer,245,250,495,46,17,JointPQPlayer
9930,JointPQPlayer,242,242,484,41,19,Tie
9931,JointPQPlayer,265,265,530,48,6,Tie
9932,JointPQPlayer,254,254,508,41,11,Tie
9933,JointPQPlayer,251,246,497,45,16,Player A
9934,JointPQPlayer,236,236,472,44,24,Tie
9935,JointPQPlayer,181,186,367,5,46,JointPQPlayer
9936,JointPQPlayer,182,182,364,14,50,Tie
9937,JointPQPlayer,264,264,528,52,8,Tie
9938,JointPQPlayer,231,231,462,40,26,Tie
9939,JointPQPlayer,252,247,499,38,13,Player A
9940,JointPQPlayer,248,248,496,41,15,Tie
9941,JointPQPlayer,256,256,512,45,11,Tie
9942,JointPQPlayer,273,273,546,61,5,Tie
9943,JointPQPlayer,260,265,525,58,11,JointPQPlayer
9944,JointPQPlayer,199,194,393,19,42,Player A
9945,JointPQPlayer,156,161,317,6,63,JointPQPlayer
9946,JointPQPlayer,256,256,512,45,11,Tie
9947,JointPQPlayer,249,244,493,41,16,Player A
9948,JointPQPlayer,245,250,495,43,16,JointPQPlayer
9949,JointPQPlayer,229,224,453,43,30,Player A
9950,JointPQPlayer,267,272,539,51,4,JointPQPlayer
9951,JointPQPlayer,257,257,514,50,12,Tie
9952,JointPQPlayer,259,254,513,52,13,Player A
9953,JointPQPlayer,258,263,521,51,10,JointPQPlayer
9954,JointPQPlayer,253,253,506,51,15,Tie
9955,JointPQPlayer,203,198,401,24,41,Player A
9956,JointPQPlayer,257,262,519,46,9,JointPQPlayer
9957,JointPQPlayer,197,192,389,18,43,Player A
9958,JointPQPlayer,241,246,487,41,18,JointPQPlayer
9959,JointPQPlayer,180,175,355,17,54,Player A
9960,JointPQPlayer,255,255,510,40,10,Tie
9961,JointPQPlayer,247,252,499,44,15,JointPQPlayer
9962,JointPQPlayer,213,213,426,25,33,Tie
9963,JointPQPlayer,243,243,486,40,18,Tie
9964,JointPQPlayer,252,247,499,44,15,Player A
9965,JointPQPlayer,222,222,444,31,29,Tie
9966,JointPQPlayer,177,182,359,6,49,JointPQPlayer
9967,JointPQPlayer,269,264,533,57,8,Player A
9968,JointPQPlayer,247,247,494,48,18,Tie
9969,JointPQPlayer,247,252,499,32,11,JointPQPlayer
9970,JointPQPlayer,256,251,507,49,14,Player A
9971,JointPQPlayer,269,269,538,53,5,Tie
9972,JointPQPlayer,194,194,388,20,44,Tie
9973,JointPQPlayer,198,203,401,18,39,JointPQPlayer
9974,JointPQPlayer,264,264,528,43,5,Tie
9975,JointPQPlayer,268,263,531,49,6,Player A
9976,JointPQPlayer,172,172,344,6,54,Tie
9977,JointPQPlayer,229,234,463,32,23,JointPQPlayer
9978,JointPQPlayer,194,194,388,23,45,Tie
9979,JointPQPlayer,230,230,460,32,24,Tie
9980,JointPQPlayer,258,258,516,46,10,Tie
9981,JointPQPlayer,251,246,497,48,17,Player A
9982,JointPQPlayer,224,229,453,34,27,JointPQPlayer
9983,JointPQPlayer,183,183,366,7,47,Tie
9984,JointPQPlayer,177,172,349,5,52,Player A
9985,JointPQPlayer,255,260,515,48,11,JointPQPlayer
9986,JointPQPlayer,250,245,495,43,16,Player A
9987,JointPQPlayer,269,274,543,52,3,JointPQPlayer
9988,JointPQPlayer,250,250,500,45,15,Tie
9989,JointPQPlayer,275,270,545,66,7,Player A
9990,JointPQPlayer,225,230,455,30,25,JointPQPlayer
9991,JointPQPlayer,246,246,492,40,16,Tie
9992,JointPQPlayer,244,239,483,40,19,Player A
9993,JointPQPlayer,216,216,432,31,33,Tie
9994,JointPQPlayer,245,245,490,44,18,Tie
9995,JointPQPlayer,247,252,499,50,17,JointPQPlayer
9996,JointPQPlayer,258,253,511,44,11,Player A
9997,JointPQPlayer,229,229,458,36,26,Tie
9998,JointPQPlayer,241,246,487,47,20,JointPQPlayer
9999,JointPQPlayer,242,242,484,41,19,Tie
10000,JointPQPlayer,262,262,524,54,10,Tie
10001,JointPQPlayer,184,184,368,9,47,Tie
10002,JointPQPlayer,224,219,443,33,30,Player A
10003,JointPQPlayer,174,179,353,12,53,JointPQPlayer
10004,JointPQPlayer,231,231,462,40,26,Tie
10005,JointPQPlayer,259,254,513,52,13,Player A
10006,JointPQPlayer,256,261,517,47,10,JointPQPlayer
10007,JointPQPlayer,247,247,494,36,14,Tie
10008,JointPQPlayer,268,268,536,63,9,Tie
10009,JointPQPlayer,238,238,476,42,22,Tie
10010,JointPQPlayer,169,169,338,9,57,Tie
10011,JointPQPlayer,148,148,296,6,70,Tie
10012,JointPQPlayer,262,257,519,43,8,Player A
10013,JointPQPlayer,197,197,394,11,39,Tie
10014,JointPQPlayer,248,248,496,47,17,Tie
10015,JointPQPlayer,180,185,365,6,47,JointPQPlayer
10016,JointPQPlayer,236,231,467,51,28,Player A
10017,JointPQPlayer,260,260,520,44,8,Tie
10018,JointPQPlayer,223,228,451,38,29,JointPQPlayer
10019,JointPQPlayer,258,253,511,47,12,Player A
10020,JointPQPlayer,190,195,385,17,44,JointPQPlayer
10021,JointPQPlayer,193,193,386,6,40,Tie
10022,JointPQPlayer,235,235,470,39,23,Tie
10023,JointPQPlayer,266,261,527,51,8,Player A
10024,JointPQPlayer,254,254,508,44,12,Tie
10025,JointPQPlayer,198,198,396,16,40,Tie
10026,JointPQPlayer,280,280,560,66,2,Tie
10027,JointPQPlayer,192,192,384,13,43,Tie
10028,JointPQPlayer,252,252,504,46,14,Tie
10029,JointPQPlayer,210,210,420,19,33,Tie
10030,JointPQPlayer,241,241,482,39,19,Tie
10031,JointPQPlayer,252,257,509,51,14,JointPQPlayer
10032,JointPQPlayer,244,239,483,34,17,Player A
10033,JointPQPlayer,172,172,344,12,56,Tie
10034,JointPQPlayer,219,219,438,34,32,Tie
10035,JointPQPlayer,168,173,341,6,55,JointPQPlayer
10036,JointPQPlayer,227,227,454,29,25,Tie
10037,JointPQPlayer,209,204,413,24,37,Player A
10038,JointPQPlayer,268,273,541,56,5,JointPQPlayer
10039,JointPQPlayer,255,255,510,46,12,Tie
10040,JointPQPlayer,257,257,514,44,10,Tie
10041,JointPQPlayer,190,185,375,10,45,Player A
10042,JointPQPlayer,257,257,514,44,10,Tie
10043,JointPQPlayer,234,234,468,28,20,Tie
10044,JointPQPlayer,184,184,368,9,47,Tie
10045,JointPQPlayer,197,197,394,26,44,Tie
10046,JointPQPlayer,212,212,424,23,33,Tie
10047,JointPQPlayer,196,196,392,18,42,Tie
10048,JointPQPlayer,263,263,526,50,8,Tie
10049,JointPQPlayer,252,257,509,45,12,JointPQPlayer
10050,JointPQPlayer,223,218,441,25,28,Player A
10051,JointPQPlayer,246,246,492,43,17,Tie
10052,JointPQPlayer,251,251,502,53,17,Tie
10053,JointPQPlayer,257,257,514,44,10,Tie
10054,JointPQPlayer,198,198,396,16,40,Tie
10055,JointPQPlayer,263,263,526,53,9,Tie
10056,JointPQPlayer,183,188,371,9,46,JointPQPlayer
10057,JointPQPlayer,267,267,534,55,7,Tie
10058,JointPQPlayer,258,258,516,49,11,Tie
10059,JointPQPlayer,271,266,537,55,6,Player A
10060,JointPQPlayer,201,206,407,33,42,JointPQPlayer
10061,JointPQPlayer,260,255,515,48,11,Player A
10062,JointPQPlayer,257,262,519,49,10,JointPQPlayer
10063,JointPQPlayer,240,240,480,40,20,Tie
10064,JointPQPlayer,266,261,527,51,8,Player A
10065,JointPQPlayer,226,226,452,39,29,Tie
10066,JointPQPlayer,257,257,514,44,10,Tie
10067,JointPQPlayer,269,274,543,58,5,JointPQPlayer
10068,JointPQPlayer,263,258,521,54,11,Player A
10069,JointPQPlayer,183,188,371,9,46,JointPQPlayer
10070,JointPQPlayer,267,262,529,50,7,Player A
10071,JointPQPlayer,243,248,491,42,17,JointPQPlayer
10072,JointPQPlayer,259,254,513,46,11,Player A
10073,JointPQPlayer,181,186,367,11,48,JointPQPlayer
10074,JointPQPlayer,175,175,350,9,53,Tie
10075,JointPQPlayer,173,173,346,5,53,Tie
10076,JointPQPlayer,265,260,525,46,7,Player A
10077,JointPQPlayer,181,181,362,15,51,Tie
10078,JointPQPlayer,262,267,529,50,7,JointPQPlayer
10079,JointPQPlayer,264,259,523,47,8,Player A
10080,JointPQPlayer,255,255,510,46,12,Tie
10081,JointPQPlayer,191,196,387,19,44,JointPQPlayer
10082,JointPQPlayer,224,219,443,27,28,Player A
10083,JointPQPlayer,189,194,383,15,44,JointPQPlayer
10084,JointPQPlayer,253,248,501,40,13,Player A
10085,JointPQPlayer,263,263,526,53,9,Tie
10086,JointPQPlayer,263,263,526,47,7,Tie
10087,JointPQPlayer,249,249,498,37,13,Tie
10088,JointPQPlayer,230,235,465,31,22,JointPQPlayer
10089,JointPQPlayer,182,182,364,2,46,Tie
10090,JointPQPlayer,261,261,522,46,8,Tie
10091,JointPQPlayer,264,259,523,41,6,Player A
10092,JointPQPlayer,272,272,544,53,3,Tie
10093,JointPQPlayer,255,255,510,43,11,Tie
10094,JointPQPlayer,247,247,494,45,17,Tie
10095,JointPQPlayer,172,177,349,11,54,JointPQPlayer
10096,JointPQPlayer,164,159,323,9,62,Player A
10097,JointPQPlayer,255,255,510,52,14,Tie
10098,JointPQPlayer,174,174,348,10,54,Tie
10099,JointPQPlayer,252,252,504,43,13,Tie
10100,JointPQPlayer,254,254,508,41,11,Tie
10101,JointPQPlayer,204,204,408,19,37,Tie
10102,JointPQPlayer,162,162,324,1,59,Tie
10103,JointPQPlayer,201,201,402,25,41,Tie
10104,JointPQPlayer,257,262,519,43,8,JointPQPlayer
10105,JointPQPlayer,244,239,483,34,17,Player A
10106,JointPQPlayer,247,247,494,54,20,Tie
10107,JointPQPlayer,260,260,520,47,9,Tie
10108,JointPQPlayer,263,263,526,44,6,Tie
10109,JointPQPlayer,197,197,394,17,41,Tie
10110,JointPQPlayer,243,243,486,37,17,Tie
10111,JointPQPlayer,264,269,533,51,6,JointPQPlayer
10112,JointPQPlayer,246,241,487,38,17,Player A
10113,JointPQPlayer,263,263,526,50,8,Tie
10114,JointPQPlayer,219,219,438,37,33,Tie
10115,JointPQPlayer,202,207,409,17,36,JointPQPlayer
10116,JointPQPlayer,156,156,312,4,64,Tie
10117,JointPQPlayer,194,194,388,14,42,Tie
10118,JointPQPlayer,231,226,457,32,25,Player A
10119,JointPQPlayer,262,267,529,53,8,JointPQPlayer
10120,JointPQPlayer,257,257,514,56,14,Tie
10121,JointPQPlayer,271,266,537,55,6,Player A
10122,JointPQPlayer,235,235,470,42,24,Tie
10123,JointPQPlayer,246,251,497,45,16,JointPQPlayer
10124,JointPQPlayer,244,239,483,40,19,Player A
10125,JointPQPlayer,261,261,522,43,7,Tie
10126,JointPQPlayer,189,189,378,13,45,Tie
10127,JointPQPlayer,253,253,506,48,14,Tie
10128,JointPQPlayer,237,237,474,37,21,Tie
10129,JointPQPlayer,176,176,352,5,51,Tie
10130,JointPQPlayer,252,252,504,37,11,Tie
10131,JointPQPlayer,240,240,480,37,19,Tie
10132,JointPQPlayer,239,239,478,41,21,Tie
10133,JointPQPlayer,204,204,408,22,38,Tie
10134,JointPQPlayer,262,262,524,48,8,Tie
10135,JointPQPlayer,222,222,444,34,30,Tie
10136,JointPQPlayer,259,259,518,51,11,Tie
10137,JointPQPlayer,230,230,460,29,23,Tie
10138,JointPQPlayer,212,217,429,34,35,JointPQPlayer
10139,JointPQPlayer,266,266,532,50,6,Tie
10140,JointPQPlayer,238,233,471,43,24,Player A
10141,JointPQPlayer,222,227,449,30,27,JointPQPlayer
10142,JointPQPlayer,265,265,530,48,6,Tie
10143,JointPQPlayer,250,245,495,46,17,Player A
10144,JointPQPlayer,253,258,511,47,12,JointPQPlayer
10145,JointPQPlayer,270,265,535,53,6,Player A
10146,JointPQPlayer,254,254,508,47,13,Tie
10147,JointPQPlayer,173,178,351,7,52,JointPQPlayer
10148,JointPQPlayer,261,256,517,53,12,Player A
10149,JointPQPlayer,230,235,465,40,25,JointPQPlayer
10150,JointPQPlayer,253,253,506,45,13,Tie
10151,JointPQPlayer,263,263,526,62,12,Tie
10152,JointPQPlayer,235,230,465,31,22,Player A
10153,JointPQPlayer,192,192,384,13,43,Tie
10154,JointPQPlayer,197,197,394,11,39,Tie
10155,JointPQPlayer,155,160,315,7,64,JointPQPlayer
10156,JointPQPlayer,168,163,331,8,59,Player A
10157,JointPQPlayer,216,221,437,27,30,JointPQPlayer
10158,JointPQPlayer,260,255,515,54,13,Player A
10159,JointPQPlayer,234,234,468,31,21,Tie
10160,JointPQPlayer,249,249,498,40,14,Tie
10161,JointPQPlayer,259,259,518,51,11,Tie
10162,JointPQPlayer,279,279,558,67,3,Tie
10163,JointPQPlayer,173,178,351,16,55,JointPQPlayer
10164,JointPQPlayer,252,252,504,46,14,Tie
10165,JointPQPlayer,262,257,519,43,8,Player A
10166,JointPQPlayer,262,267,529,59,10,JointPQPlayer
10167,JointPQPlayer,223,218,441,28,29,Player A
10168,JointPQPlayer,255,255,510,43,11,Tie
10169,JointPQPlayer,260,260,520,47,9,Tie
10170,JointPQPlayer,251,251,502,44,14,Tie
10171,JointPQPlayer,245,245,490,41,17,Tie
10172,JointPQPlayer,261,261,522,61,13,Tie
10173,JointPQPlayer,241,241,482,42,20,Tie
10174,JointPQPlayer,245,245,490,38,16,Tie
10175,JointPQPlayer,190,190,380,15,45,Tie
10176,JointPQPlayer,221,226,447,34,29,JointPQPlayer
10177,JointPQPlayer,245,245,490,35,15,Tie
10178,JointPQPlayer,274,269,543,58,5,Player A
10179,JointPQPlayer,276,276,552,61,3,Tie
10180,JointPQPlayer,181,186,367,11,48,JointPQPlayer
10181,JointPQPlayer,242,237,479,42,21,Player A
10182,JointPQPlayer,267,267,534,52,6,Tie
10183,JointPQPlayer,272,272,544,59,5,Tie
10184,JointPQPlayer,237,242,479,36,19,JointPQPlayer
10185,JointPQPlayer,229,229,458,33,25,Tie
10186,JointPQPlayer,268,268,536,57,7,Tie
10187,JointPQPlayer,257,252,509,33,8,Player A
10188,JointPQPlayer,230,230,460,38,26,Tie
10189,JointPQPlayer,263,263,526,47,7,Tie
10190,JointPQPlayer,267,267,534,52,6,Tie
10191,JointPQPlayer,169,174,343,5,54,JointPQPlayer
10192,JointPQPlayer,236,236,472,29,19,Tie
10193,JointPQPlayer,275,270,545,66,7,Player A
10194,JointPQPlayer,253,258,511,47,12,JointPQPlayer
10195,JointPQPlayer,174,174,348,13,55,Tie
10196,JointPQPlayer,165,165,330,7,59,Tie
10197,JointPQPlayer,275,270,545,57,4,Player A
10198,JointPQPlayer,229,234,463,32,23,JointPQPlayer
10199,JointPQPlayer,259,254,513,46,11,Player A
10200,JointPQPlayer,256,256,512,48,12,Tie
10201,JointPQPlayer,238,238,476,36,20,Tie
10202,JointPQPlayer,267,267,534,49,5,Tie
10203,JointPQPlayer,239,239,478,47,23,Tie
10204,JointPQPlayer,271,271,542,51,3,Tie
10205,JointPQPlayer,260,265,525,52,9,JointPQPlayer
10206,JointPQPlayer,252,247,499,53,18,Player A
10207,JointPQPlayer,263,263,526,50,8,Tie
10208,JointPQPlayer,263,263,526,44,6,Tie
10209,JointPQPlayer,256,256,512,45,11,Tie
10210,JointPQPlayer,231,231,462,34,24,Tie
10211,JointPQPlayer,247,247,494,42,16,Tie
10212,JointPQPlayer,247,247,494,36,14,Tie
10213,JointPQPlayer,265,265,530,54,8,Tie
10214,JointPQPlayer,249,249,498,43,15,Tie
10215,JointPQPlayer,167,167,334,5,57,Tie
10216,JointPQPlayer,268,268,536,54,6,Tie
10217,JointPQPlayer,254,259,513,49,12,JointPQPlayer
10218,JointPQPlayer,248,243,491,36,15,Player A
10219,JointPQPlayer,188,193,381,4,41,JointPQPlayer
10220,JointPQPlayer,183,183,366,10,48,Tie
10221,JointPQPlayer,180,175,355,5,50,Player A
10222,JointPQPlayer,250,250,500,39,13,Tie
10223,JointPQPlayer,178,183,361,14,51,JointPQPlayer
10224,JointPQPlayer,264,259,523,44,7,Player A
10225,JointPQPlayer,228,228,456,31,25,Tie
10226,JointPQPlayer,242,242,484,38,18,Tie
10227,JointPQPlayer,190,195,385,5,40,JointPQPlayer
10228,JointPQPlayer,192,187,379,17,46,Player A
10229,JointPQPlayer,253,258,511,47,12,JointPQPlayer
10230,JointPQPlayer,238,233,471,34,21,Player A
10231,JointPQPlayer,219,224,443,36,31,JointPQPlayer
10232,JointPQPlayer,254,254,508,53,15,Tie
10233,JointPQPlayer,258,253,511,47,12,Player A
10234,JointPQPlayer,236,236,472,41,23,Tie
10235,JointPQPlayer,243,243,486,43,19,Tie
10236,JointPQPlayer,263,263,526,56,10,Tie
10237,JointPQPlayer,263,263,526,53,9,Tie
10238,JointPQPlayer,256,256,512,42,10,Tie
10239,JointPQPlayer,265,270,535,50,5,JointPQPlayer
10240,JointPQPlayer,262,262,524,48,8,Tie
10241,JointPQPlayer,261,256,517,47,10,Player A
10242,JointPQPlayer,231,231,462,43,27,Tie
10243,JointPQPlayer,255,255,510,43,11,Tie
10244,JointPQPlayer,267,267,534,52,6,Tie
10245,JointPQPlayer,250,255,505,47,14,JointPQPlayer
10246,JointPQPlayer,267,262,529,53,8,Player A
10247,JointPQPlayer,165,165,330,4,58,Tie
10248,JointPQPlayer,213,218,431,24,31,JointPQPlayer
10249,JointPQPlayer,233,233,466,53,29,Tie
10250,JointPQPlayer,188,188,376,11,45,Tie
10251,JointPQPlayer,268,263,531,52,7,Player A
10252,JointPQPlayer,243,243,486,49,21,Tie
10253,JointPQPlayer,253,258,511,41,10,JointPQPlayer
10254,JointPQPlayer,259,259,518,54,12,Tie
10255,JointPQPlayer,241,241,482,36,18,Tie
10256,JointPQPlayer,214,214,428,27,33,Tie
10257,JointPQPlayer,254,249,503,48,15,Player A
10258,JointPQPlayer,191,196,387,19,44,JointPQPlayer
10259,JointPQPlayer,260,255,515,36,7,Player A
10260,JointPQPlayer,189,189,378,13,45,Tie
10261,JointPQPlayer,239,239,478,41,21,Tie
10262,JointPQPlayer,206,206,412,26,38,Tie
10263,JointPQPlayer,209,209,418,26,36,Tie
10264,JointPQPlayer,173,178,351,7,52,JointPQPlayer
10265,JointPQPlayer,243,238,481,29,16,Player A
10266,JointPQPlayer,250,255,505,41,12,JointPQPlayer
10267,JointPQPlayer,260,255,515,48,11,Player A
10268,JointPQPlayer,161,166,327,4,59,JointPQPlayer
10269,JointPQPlayer,259,254,513,43,10,Player A
10270,JointPQPlayer,191,196,387,19,44,JointPQPlayer
10271,JointPQPlayer,162,162,324,4,60,Tie
10272,JointPQPlayer,266,261,527,48,7,Player A
10273,JointPQPlayer,256,261,517,50,11,JointPQPlayer
10274,JointPQPlayer,184,179,363,10,49,Player A
10275,JointPQPlayer,163,168,331,5,58,JointPQPlayer
10276,JointPQPlayer,258,258,516,49,11,Tie
10277,JointPQPlayer,247,242,489,46,19,Player A
10278,JointPQPlayer,183,183,366,19,51,Tie
10279,JointPQPlayer,268,268,536,57,7,Tie
10280,JointPQPlayer,267,267,534,46,4,Tie
10281,JointPQPlayer,238,238,476,42,22,Tie
10282,JointPQPlayer,257,257,514,47,11,Tie
10283,JointPQPlayer,172,177,349,5,52,JointPQPlayer
10284,JointPQPlayer,267,262,529,50,7,Player A
10285,JointPQPlayer,278,278,556,65,3,Tie
10286,JointPQPlayer,181,186,367,20,51,JointPQPlayer
10287,JointPQPlayer,261,261,522,49,9,Tie
10288,JointPQPlayer,257,252,509,48,13,Player A
10289,JointPQPlayer,241,241,482,48,22,Tie
10290,JointPQPlayer,257,257,514,47,11,Tie
10291,JointPQPlayer,261,261,522,49,9,Tie
10292,JointPQPlayer,181,186,367,8,47,JointPQPlayer
10293,JointPQPlayer,176,176,352,8,52,Tie
10294,JointPQPlayer,276,271,547,59,4,Player A
10295,JointPQPlayer,262,262,524,45,7,Tie
10296,JointPQPlayer,170,175,345,7,54,JointPQPlayer
10297,JointPQPlayer,190,190,380,12,44,Tie
10298,JointPQPlayer,257,257,514,41,9,Tie
10299,JointPQPlayer,191,191,382,11,43,Tie
10300,JointPQPlayer,189,184,373,11,46,Player A
10301,JointPQPlayer,165,170,335,6,57,JointPQPlayer
10302,JointPQPlayer,245,240,485,36,17,Player A
10303,JointPQPlayer,239,239,478,32,18,Tie
10304,JointPQPlayer,266,266,532,50,6,Tie
10305,JointPQPlayer,229,229,458,30,24,Tie
10306,JointPQPlayer,232,237,469,41,24,JointPQPlayer
10307,JointPQPlayer,249,244,493,38,15,Player A
10308,JointPQPlayer,183,188,371,9,46,JointPQPlayer
10309,JointPQPlayer,267,262,529,53,8,Player A
10310,JointPQPlayer,239,239,478,38,20,Tie
10311,JointPQPlayer,244,249,493,35,14,JointPQPlayer
10312,JointPQPlayer,251,251,502,35,11,Tie
10313,JointPQPlayer,246,246,492,46,18,Tie
10314,JointPQPlayer,247,242,489,34,15,Player A
10315,JointPQPlayer,266,266,532,53,7,Tie
10316,JointPQPlayer,253,253,506,48,14,Tie
10317,JointPQPlayer,167,172,339,4,55,JointPQPlayer
10318,JointPQPlayer,278,273,551,63,4,Player A
10319,JointPQPlayer,264,269,533,48,5,JointPQPlayer
10320,JointPQPlayer,255,255,510,46,12,Tie
10321,JointPQPlayer,170,165,335,6,57,Player A
10322,JointPQPlayer,269,269,538,50,4,Tie
10323,JointPQPlayer,248,253,501,43,14,JointPQPlayer
10324,JointPQPlayer,244,239,483,40,19,Player A
10325,JointPQPlayer,189,194,383,15,44,JointPQPlayer
10326,JointPQPlayer,257,252,509,39,10,Player A
10327,JointPQPlayer,173,173,346,8,54,Tie
10328,JointPQPlayer,179,179,358,14,52,Tie
10329,JointPQPlayer,257,257,514,44,10,Tie
10330,JointPQPlayer,177,182,359,6,49,JointPQPlayer
10331,JointPQPlayer,191,191,382,11,43,Tie
10332,JointPQPlayer,253,248,501,46,15,Player A
10333,JointPQPlayer,240,240,480,40,20,Tie
10334,JointPQPlayer,176,181,357,7,50,JointPQPlayer
10335,JointPQPlayer,263,258,521,51,10,Player A
10336,JointPQPlayer,194,199,393,13,40,JointPQPlayer
10337,JointPQPlayer,231,231,462,40,26,Tie
10338,JointPQPlayer,263,258,521,42,7,Player A
10339,JointPQPlayer,262,267,529,53,8,JointPQPlayer
10340,JointPQPlayer,253,253,506,42,12,Tie
10341,JointPQPlayer,257,252,509,45,12,Player A
10342,JointPQPlayer,245,245,490,47,19,Tie
10343,JointPQPlayer,251,251,502,38,12,Tie
10344,JointPQPlayer,238,243,481,38,19,JointPQPlayer
10345,JointPQPlayer,274,269,543,58,5,Player A
10346,JointPQPlayer,257,257,514,47,11,Tie
10347,JointPQPlayer,211,211,422,27,35,Tie
10348,JointPQPlayer,193,193,386,9,41,Tie
10349,JointPQPlayer,169,174,343,5,54,JointPQPlayer
10350,JointPQPlayer,248,243,491,39,16,Player A
10351,JointPQPlayer,165,170,335,6,57,JointPQPlayer
10352,JointPQPlayer,174,169,343,8,55,Player A
10353,JointPQPlayer,263,263,526,56,10,Tie
10354,JointPQPlayer,210,210,420,22,34,Tie
10355,JointPQPlayer,255,260,515,48,11,JointPQPlayer
10356,JointPQPlayer,266,261,527,51,8,Player A
10357,JointPQPlayer,219,219,438,34,32,Tie
10358,JointPQPlayer,257,257,514,50,12,Tie
10359,JointPQPlayer,255,255,510,43,11,Tie
10360,JointPQPlayer,202,202,404,24,40,Tie
10361,JointPQPlayer,250,250,500,45,15,Tie
10362,JointPQPlayer,259,264,523,41,6,JointPQPlayer
10363,JointPQPlayer,247,242,489,43,18,Player A
10364,JointPQPlayer,245,250,495,40,15,JointPQPlayer
10365,JointPQPlayer,253,253,506,48,14,Tie
10366,JointPQPlayer,247,242,489,34,15,Player A
10367,JointPQPlayer,168,168,336,7,57,Tie
10368,JointPQPlayer,245,245,490,44,18,Tie
10369,JointPQPlayer,253,253,506,48,14,Tie
10370,JointPQPlayer,270,270,540,61,7,Tie
10371,JointPQPlayer,264,264,528,49,7,Tie
10372,JointPQPlayer,258,258,516,52,12,Tie
10373,JointPQPlayer,264,264,528,49,7,Tie
10374,JointPQPlayer,251,251,502,47,15,Tie
10375,JointPQPlayer,275,275,550,56,2,Tie
10376,JointPQPlayer,168,168,336,7,57,Tie
10377,JointPQPlayer,250,255,505,50,15,JointPQPlayer
10378,JointPQPlayer,256,251,507,43,12,Player A
10379,JointPQPlayer,259,264,523,53,10,JointPQPlayer
10380,JointPQPlayer,267,267,534,46,4,Tie
10381,JointPQPlayer,246,241,487,47,20,Player A
10382,JointPQPlayer,181,186,367,5,46,JointPQPlayer
10383,JointPQPlayer,228,228,456,34,26,Tie
10384,JointPQPlayer,241,241,482,39,19,Tie
10385,JointPQPlayer,235,235,470,36,22,Tie
10386,JointPQPlayer,233,228,461,33,24,Player A
10387,JointPQPlayer,170,170,340,5,55,Tie
10388,JointPQPlayer,230,235,465,34,23,JointPQPlayer
10389,JointPQPlayer,265,265,530,48,6,Tie
10390,JointPQPlayer,164,159,323,6,61,Player A
10391,JointPQPlayer,248,253,501,40,13,JointPQPlayer
10392,JointPQPlayer,257,252,509,51,14,Player A
10393,JointPQPlayer,259,264,523,47,8,JointPQPlayer
10394,JointPQPlayer,164,164,328,5,59,Tie
10395,JointPQPlayer,251,246,497,42,15,Player A
10396,JointPQPlayer,200,200,400,17,39,Tie
10397,JointPQPlayer,256,256,512,45,11,Tie
10398,JointPQPlayer,254,254,508,50,14,Tie
10399,JointPQPlayer,262,262,524,57,11,Tie
10400,JointPQPlayer,251,256,507,40,11,JointPQPlayer
10401,JointPQPlayer,150,150,300,1,67,Tie
10402,JointPQPlayer,245,245,490,38,16,Tie
10403,JointPQPlayer,195,195,390,22,44,Tie
10404,JointPQPlayer,238,238,476,42,22,Tie
10405,JointPQPlayer,256,251,507,43,12,Player A
10406,JointPQPlayer,226,226,452,33,27,Tie
10407,JointPQPlayer,191,196,387,13,42,JointPQPlayer
10408,JointPQPlayer,226,221,447,34,29,Player A
10409,JointPQPlayer,252,257,509,39,10,JointPQPlayer
10410,JointPQPlayer,258,258,516,40,8,Tie
10411,JointPQPlayer,259,259,518,57,13,Tie
10412,JointPQPlayer,233,228,461,33,24,Player A
10413,JointPQPlayer,233,238,471,37,22,JointPQPlayer
10414,JointPQPlayer,199,194,393,13,40,Player A
10415,JointPQPlayer,270,270,540,49,3,Tie
10416,JointPQPlayer,240,240,480,31,17,Tie
10417,JointPQPlayer,178,178,356,9,51,Tie
10418,JointPQPlayer,272,272,544,53,3,Tie
10419,JointPQPlayer,247,252,499,47,16,JointPQPlayer
10420,JointPQPlayer,180,175,355,11,52,Player A
10421,JointPQPlayer,247,252,499,38,13,JointPQPlayer
10422,JointPQPlayer,263,258,521,48,9,Player A
10423,JointPQPlayer,244,244,488,39,17,Tie
10424,JointPQPlayer,176,176,352,11,53,Tie
10425,JointPQPlayer,258,263,521,45,8,JointPQPlayer
10426,JointPQPlayer,257,252,509,48,13,Player A
10427,JointPQPlayer,178,178,356,3,49,Tie
10428,JointPQPlayer,175,180,355,17,54,JointPQPlayer
10429,JointPQPlayer,279,279,558,64,2,Tie
10430,JointPQPlayer,187,182,369,16,49,Player A
10431,JointPQPlayer,172,177,349,5,52,JointPQPlayer
10432,JointPQPlayer,200,195,395,18,41,Player A
10433,JointPQPlayer,238,243,481,41,20,JointPQPlayer
10434,JointPQPlayer,262,257,519,52,11,Player A
10435,JointPQPlayer,259,259,518,45,9,Tie
10436,JointPQPlayer,262,267,529,53,8,JointPQPlayer
10437,JointPQPlayer,250,250,500,45,15,Tie
10438,JointPQPlayer,179,179,358,2,48,Tie
10439,JointPQPlayer,273,273,546,61,5,Tie
10440,JointPQPlayer,227,227,454,38,28,Tie
10441,JointPQPlayer,185,180,365,12,49,Player A
10442,JointPQPlayer,258,263,521,48,9,JointPQPlayer
10443,JointPQPlayer,257,252,509,51,14,Player A
10444,JointPQPlayer,252,252,504,49,15,Tie
10445,JointPQPlayer,228,233,461,36,25,JointPQPlayer
10446,JointPQPlayer,246,241,487,35,16,Player A
10447,JointPQPlayer,204,209,413,24,37,JointPQPlayer
10448,JointPQPlayer,211,211,422,27,35,Tie
10449,JointPQPlayer,177,177,354,10,52,Tie
10450,JointPQPlayer,254,249,503,48,15,Player A
10451,JointPQPlayer,160,160,320,0,60,Tie
10452,JointPQPlayer,279,279,558,61,1,Tie
10453,JointPQPlayer,203,208,411,19,36,JointPQPlayer
10454,JointPQPlayer,251,246,497,48,17,Player A
10455,JointPQPlayer,262,262,524,42,6,Tie
10456,JointPQPlayer,256,261,517,41,8,JointPQPlayer
10457,JointPQPlayer,257,252,509,42,11,Player A
10458,JointPQPlayer,261,261,522,58,12,Tie
10459,JointPQPlayer,243,243,486,43,19,Tie
10460,JointPQPlayer,265,265,530,51,7,Tie
10461,JointPQPlayer,259,259,518,45,9,Tie
10462,JointPQPlayer,254,254,508,44,12,Tie
10463,JointPQPlayer,262,262,524,48,8,Tie
10464,JointPQPlayer,264,264,528,52,8,Tie
10465,JointPQPlayer,252,252,504,49,15,Tie
10466,JointPQPlayer,231,231,462,34,24,Tie
10467,JointPQPlayer,249,249,498,43,15,Tie
10468,JointPQPlayer,179,179,358,11,51,Tie
10469,JointPQPlayer,262,262,524,51,9,Tie
10470,JointPQPlayer,239,239,478,35,19,Tie
10471,JointPQPlayer,253,253,506,48,14,Tie
10472,JointPQPlayer,268,268,536,54,6,Tie
10473,JointPQPlayer,245,250,495,40,15,JointPQPlayer
10474,JointPQPlayer,222,217,439,32,31,Player A
10475,JointPQPlayer,165,165,330,4,58,Tie
10476,JointPQPlayer,263,263,526,53,9,Tie
10477,JointPQPlayer,167,172,339,4,55,JointPQPlayer
10478,JointPQPlayer,261,256,517,47,10,Player A
10479,JointPQPlayer,234,234,468,43,25,Tie
10480,JointPQPlayer,264,269,533,54,7,JointPQPlayer
10481,JointPQPlayer,246,246,492,43,17,Tie
10482,JointPQPlayer,233,233,466,41,25,Tie
10483,JointPQPlayer,255,250,505,41,12,Player A
10484,JointPQPlayer,258,258,516,40,8,Tie
10485,JointPQPlayer,184,184,368,12,48,Tie
10486,JointPQPlayer,250,255,505,47,14,JointPQPlayer
10487,JointPQPlayer,240,235,475,35,20,Player A
10488,JointPQPlayer,241,241,482,36,18,Tie
10489,JointPQPlayer,245,250,495,43,16,JointPQPlayer
10490,JointPQPlayer,258,253,511,47,12,Player A
10491,JointPQPlayer,278,278,556,62,2,Tie
10492,JointPQPlayer,252,257,509,48,13,JointPQPlayer
10493,JointPQPlayer,234,229,463,29,22,Player A
10494,JointPQPlayer,260,260,520,47,9,Tie
10495,JointPQPlayer,261,261,522,52,10,Tie
10496,JointPQPlayer,228,228,456,34,26,Tie
10497,JointPQPlayer,252,252,504,46,14,Tie
10498,JointPQPlayer,262,262,524,51,9,Tie
10499,JointPQPlayer,219,219,438,28,30,Tie
10500,JointPQPlayer,163,168,331,2,57,JointPQPlayer
10501,JointPQPlayer,195,190,385,14,43,Player A
10502,JointPQPlayer,271,271,542,54,4,Tie
10503,JointPQPlayer,240,240,480,37,19,Tie
10504,JointPQPlayer,229,229,458,30,24,Tie
10505,JointPQPlayer,247,252,499,38,13,JointPQPlayer
10506,JointPQPlayer,260,260,520,47,9,Tie
10507,JointPQPlayer,254,254,508,44,12,Tie
10508,JointPQPlayer,273,268,541,56,5,Player A
10509,JointPQPlayer,226,226,452,27,25,Tie
10510,JointPQPlayer,164,164,328,8,60,Tie
10511,JointPQPlayer,211,211,422,21,33,Tie
10512,JointPQPlayer,248,248,496,44,16,Tie
10513,JointPQPlayer,262,262,524,60,12,Tie
10514,JointPQPlayer,248,248,496,35,13,Tie
10515,JointPQPlayer,234,234,468,31,21,Tie
10516,JointPQPlayer,268,268,536,54,6,Tie
10517,JointPQPlayer,238,243,481,29,16,JointPQPlayer
10518,JointPQPlayer,270,265,535,56,7,Player A
10519,JointPQPlayer,233,233,466,38,24,Tie
10520,JointPQPlayer,258,258,516,52,12,Tie
10521,JointPQPlayer,161,166,327,4,59,JointPQPlayer
10522,JointPQPlayer,215,215,430,32,34,Tie
10523,JointPQPlayer,195,190,385,11,42,Player A
10524,JointPQPlayer,260,265,525,46,7,JointPQPlayer
10525,JointPQPlayer,260,260,520,41,7,Tie
10526,JointPQPlayer,188,188,376,8,44,Tie
10527,JointPQPlayer,263,258,521,42,7,Player A
10528,JointPQPlayer,222,222,444,31,29,Tie
10529,JointPQPlayer,255,255,510,49,13,Tie
10530,JointPQPlayer,261,261,522,52,10,Tie
10531,JointPQPlayer,213,218,431,30,33,JointPQPlayer
10532,JointPQPlayer,214,209,423,22,33,Player A
10533,JointPQPlayer,256,256,512,45,11,Tie
10534,JointPQPlayer,262,262,524,51,9,Tie
10535,JointPQPlayer,179,184,363,13,50,JointPQPlayer
10536,JointPQPlayer,222,217,439,35,32,Player A
10537,JointPQPlayer,249,249,498,55,19,Tie
10538,JointPQPlayer,229,229,458,33,25,Tie
10539,JointPQPlayer,247,247,494,51,19,Tie
10540,JointPQPlayer,275,275,550,59,3,Tie
10541,JointPQPlayer,255,260,515,48,11,JointPQPlayer
10542,JointPQPlayer,264,259,523,53,10,Player A
10543,JointPQPlayer,244,244,488,39,17,Tie
10544,JointPQPlayer,241,241,482,36,18,Tie
10545,JointPQPlayer,148,153,301,2,67,JointPQPlayer
10546,JointPQPlayer,218,213,431,24,31,Player A
10547,JointPQPlayer,272,272,544,59,5,Tie
10548,JointPQPlayer,266,266,532,53,7,Tie
10549,JointPQPlayer,252,252,504,37,11,Tie
10550,JointPQPlayer,240,240,480,37,19,Tie
10551,JointPQPlayer,249,249,498,46,16,Tie
10552,JointPQPlayer,269,269,538,50,4,Tie
10553,JointPQPlayer,248,248,496,41,15,Tie
10554,JointPQPlayer,250,250,500,42,14,Tie
10555,JointPQPlayer,256,256,512,48,12,Tie
10556,JointPQPlayer,173,178,351,7,52,JointPQPlayer
10557,JointPQPlayer,234,229,463,41,26,Player A
10558,JointPQPlayer,171,176,347,9,54,JointPQPlayer
10559,JointPQPlayer,250,245,495,43,16,Player A
10560,JointPQPlayer,180,185,365,6,47,JointPQPlayer
10561,JointPQPlayer,229,224,453,28,25,Player A
10562,JointPQPlayer,240,240,480,40,20,Tie
10563,JointPQPlayer,272,272,544,59,5,Tie
10564,JointPQPlayer,268,268,536,57,7,Tie
10565,JointPQPlayer,264,264,528,58,10,Tie
10566,JointPQPlayer,227,227,454,35,27,Tie
10567,JointPQPlayer,264,264,528,49,7,Tie
10568,JointPQPlayer,257,257,514,50,12,Tie
10569,JointPQPlayer,250,250,500,39,13,Tie
10570,JointPQPlayer,254,259,513,40,9,JointPQPlayer
10571,JointPQPlayer,172,167,339,4,55,Player A
10572,JointPQPlayer,229,234,463,38,25,JointPQPlayer
10573,JointPQPlayer,193,193,386,15,43,Tie
10574,JointPQPlayer,273,268,541,53,4,Player A
10575,JointPQPlayer,185,185,370,11,47,Tie
10576,JointPQPlayer,243,243,486,37,17,Tie
10577,JointPQPlayer,236,241,477,37,20,JointPQPlayer
10578,JointPQPlayer,219,214,433,32,33,Player A
10579,JointPQPlayer,164,169,333,10,59,JointPQPlayer
10580,JointPQPlayer,183,183,366,10,48,Tie
10581,JointPQPlayer,232,227,459,43,28,Player A
10582,JointPQPlayer,263,263,526,47,7,Tie
10583,JointPQPlayer,270,270,540,55,5,Tie
10584,JointPQPlayer,179,184,363,7,48,JointPQPlayer
10585,JointPQPlayer,263,263,526,47,7,Tie
10586,JointPQPlayer,261,256,517,56,13,Player A
10587,JointPQPlayer,256,261,517,41,8,JointPQPlayer
10588,JointPQPlayer,248,243,491,39,16,Player A
10589,JointPQPlayer,260,265,525,52,9,JointPQPlayer
10590,JointPQPlayer,194,194,388,26,46,Tie
10591,JointPQPlayer,245,240,485,39,18,Player A
10592,JointPQPlayer,258,263,521,51,10,JointPQPlayer
10593,JointPQPlayer,254,249,503,45,14,Player A
10594,JointPQPlayer,191,191,382,14,44,Tie
10595,JointPQPlayer,252,252,504,40,12,Tie
10596,JointPQPlayer,262,262,524,51,9,Tie
10597,JointPQPlayer,249,249,498,43,15,Tie
10598,JointPQPlayer,272,277,549,64,5,JointPQPlayer
10599,JointPQPlayer,253,248,501,49,16,Player A
10600,JointPQPlayer,265,265,530,54,8,Tie
10601,JointPQPlayer,270,270,540,58,6,Tie
10602,JointPQPlayer,181,186,367,5,46,JointPQPlayer
10603,JointPQPlayer,247,242,489,40,17,Player A
10604,JointPQPlayer,272,272,544,62,6,Tie
10605,JointPQPlayer,215,220,435,31,32,JointPQPlayer
10606,JointPQPlayer,272,267,539,54,5,Player A
10607,JointPQPlayer,243,243,486,37,17,Tie
10608,JointPQPlayer,250,250,500,42,14,Tie
10609,JointPQPlayer,244,244,488,36,16,Tie
10610,JointPQPlayer,215,220,435,19,28,JointPQPlayer
10611,JointPQPlayer,265,260,525,49,8,Player A
10612,JointPQPlayer,181,181,362,15,51,Tie
10613,JointPQPlayer,256,261,517,44,9,JointPQPlayer
10614,JointPQPlayer,185,185,370,20,50,Tie
10615,JointPQPlayer,267,262,529,53,8,Player A
10616,JointPQPlayer,232,232,464,39,25,Tie
10617,JointPQPlayer,225,230,455,30,25,JointPQPlayer
10618,JointPQPlayer,268,268,536,54,6,Tie
10619,JointPQPlayer,257,252,509,42,11,Player A
10620,JointPQPlayer,234,234,468,40,24,Tie
10621,JointPQPlayer,264,264,528,55,9,Tie
10622,JointPQPlayer,250,250,500,45,15,Tie
10623,JointPQPlayer,267,267,534,52,6,Tie
10624,JointPQPlayer,243,248,491,45,18,JointPQPlayer
10625,JointPQPlayer,271,266,537,55,6,Player A
10626,JointPQPlayer,253,253,506,42,12,Tie
10627,JointPQPlayer,171,176,347,9,54,JointPQPlayer
10628,JointPQPlayer,270,270,540,52,4,Tie
10629,JointPQPlayer,266,266,532,53,7,Tie
10630,JointPQPlayer,274,274,548,57,3,Tie
10631,JointPQPlayer,267,262,529,53,8,Player A
10632,JointPQPlayer,260,265,525,55,10,JointPQPlayer
10633,JointPQPlayer,240,235,475,35,20,Player A
10634,JointPQPlayer,259,259,518,45,9,Tie
10635,JointPQPlayer,266,266,532,47,5,Tie
10636,JointPQPlayer,252,257,509,45,12,JointPQPlayer
10637,JointPQPlayer,254,249,503,42,13,Player A
10638,JointPQPlayer,176,181,357,10,51,JointPQPlayer
10639,JointPQPlayer,237,232,469,29,20,Player A
10640,JointPQPlayer,259,259,518,45,9,Tie
10641,JointPQPlayer,231,236,467,39,24,JointPQPlayer
10642,JointPQPlayer,263,258,521,54,11,Player A
10643,JointPQPlayer,245,250,495,37,14,JointPQPlayer
10644,JointPQPlayer,200,195,395,30,45,Player A
10645,JointPQPlayer,250,255,505,50,15,JointPQPlayer
10646,JointPQPlayer,249,249,498,46,16,Tie
10647,JointPQPlayer,238,233,471,43,24,Player A
10648,JointPQPlayer,244,249,493,44,17,JointPQPlayer
10649,JointPQPlayer,177,177,354,4,50,Tie
10650,JointPQPlayer,260,255,515,48,11,Player A
10651,JointPQPlayer,261,261,522,49,9,Tie
10652,JointPQPlayer,260,265,525,49,8,JointPQPlayer
10653,JointPQPlayer,271,266,537,52,5,Player A
10654,JointPQPlayer,201,206,407,18,37,JointPQPlayer
10655,JointPQPlayer,263,258,521,48,9,Player A
10656,JointPQPlayer,258,258,516,43,9,Tie
10657,JointPQPlayer,173,178,351,4,51,JointPQPlayer
10658,JointPQPlayer,241,241,482,48,22,Tie
10659,JointPQPlayer,240,235,475,35,20,Player A
10660,JointPQPlayer,275,275,550,56,2,Tie
10661,JointPQPlayer,271,271,542,57,5,Tie
10662,JointPQPlayer,260,265,525,43,6,JointPQPlayer
10663,JointPQPlayer,222,222,444,37,31,Tie
10664,JointPQPlayer,201,201,402,16,38,Tie
10665,JointPQPlayer,258,253,511,44,11,Player A
10666,JointPQPlayer,253,253,506,42,12,Tie
10667,JointPQPlayer,164,164,328,8,60,Tie
10668,JointPQPlayer,235,235,470,33,21,Tie
10669,JointPQPlayer,269,269,538,59,7,Tie
10670,JointPQPlayer,254,254,508,41,11,Tie
10671,JointPQPlayer,221,221,442,26,28,Tie
10672,JointPQPlayer,250,250,500,39,13,Tie
10673,JointPQPlayer,249,249,498,43,15,Tie
10674,JointPQPlayer,258,258,516,58,14,Tie
10675,JointPQPlayer,259,259,518,51,11,Tie
10676,JointPQPlayer,237,242,479,39,20,JointPQPlayer
10677,JointPQPlayer,171,171,342,13,57,Tie
10678,JointPQPlayer,257,257,514,47,11,Tie
10679,JointPQPlayer,198,193,391,23,44,Player A
10680,JointPQPlayer,262,262,524,45,7,Tie
10681,JointPQPlayer,261,261,522,52,10,Tie
10682,JointPQPlayer,220,220,440,30,30,Tie
10683,JointPQPlayer,242,242,484,38,18,Tie
10684,JointPQPlayer,260,260,520,56,12,Tie
10685,JointPQPlayer,262,262,524,57,11,Tie
10686,JointPQPlayer,256,256,512,39,9,Tie
10687,JointPQPlayer,199,199,398,15,39,Tie
10688,JointPQPlayer,250,250,500,45,15,Tie
10689,JointPQPlayer,240,240,480,37,19,Tie
10690,JointPQPlayer,235,235,470,39,23,Tie
10691,JointPQPlayer,255,255,510,40,10,Tie
10692,JointPQPlayer,270,270,540,55,5,Tie
10693,JointPQPlayer,181,181,362,15,51,Tie
10694,JointPQPlayer,261,261,522,52,10,Tie
10695,JointPQPlayer,240,245,485,36,17,JointPQPlayer
10696,JointPQPlayer,247,242,489,40,17,Player A
10697,JointPQPlayer,211,216,427,32,35,JointPQPlayer
10698,JointPQPlayer,223,218,441,31,30,Player A
10699,JointPQPlayer,254,254,508,38,10,Tie
10700,JointPQPlayer,270,270,540,55,5,Tie
10701,JointPQPlayer,261,261,522,49,9,Tie
10702,JointPQPlayer,264,269,533,51,6,JointPQPlayer
10703,JointPQPlayer,171,171,342,4,54,Tie
10704,JointPQPlayer,256,251,507,43,12,Player A
10705,JointPQPlayer,170,175,345,7,54,JointPQPlayer
10706,JointPQPlayer,257,252,509,45,12,Player A
10707,JointPQPlayer,186,186,372,13,47,Tie
10708,JointPQPlayer,249,249,498,49,17,Tie
10709,JointPQPlayer,256,256,512,45,11,Tie
10710,JointPQPlayer,244,244,488,36,16,Tie
10711,JointPQPlayer,244,244,488,45,19,Tie
10712,JointPQPlayer,198,203,401,24,41,JointPQPlayer
10713,JointPQPlayer,139,139,278,3,75,Tie
10714,JointPQPlayer,218,213,431,27,32,Player A
10715,JointPQPlayer,261,261,522,49,9,Tie
10716,JointPQPlayer,247,247,494,45,17,Tie
10717,JointPQPlayer,257,257,514,44,10,Tie
10718,JointPQPlayer,231,236,467,33,22,JointPQPlayer
10719,JointPQPlayer,245,240,485,30,15,Player A
10720,JointPQPlayer,268,268,536,51,5,Tie
10721,JointPQPlayer,185,190,375,13,46,JointPQPlayer
10722,JointPQPlayer,251,246,497,42,15,Player A
10723,JointPQPlayer,167,172,339,4,55,JointPQPlayer
10724,JointPQPlayer,258,258,516,43,9,Tie
10725,JointPQPlayer,205,200,405,28,41,Player A
10726,JointPQPlayer,227,232,459,34,25,JointPQPlayer
10727,JointPQPlayer,257,257,514,47,11,Tie
10728,JointPQPlayer,259,254,513,46,11,Player A
10729,JointPQPlayer,250,255,505,41,12,JointPQPlayer
10730,JointPQPlayer,262,257,519,46,9,Player A
10731,JointPQPlayer,246,246,492,34,14,Tie
10732,JointPQPlayer,244,244,488,42,18,Tie
10733,JointPQPlayer,237,237,474,40,22,Tie
10734,JointPQPlayer,258,258,516,46,10,Tie
10735,JointPQPlayer,192,192,384,13,43,Tie
10736,JointPQPlayer,260,265,525,49,8,JointPQPlayer
10737,JointPQPlayer,177,177,354,7,51,Tie
10738,JointPQPlayer,187,187,374,9,45,Tie
10739,JointPQPlayer,207,207,414,28,38,Tie
10740,JointPQPlayer,215,210,425,21,32,Player A
10741,JointPQPlayer,204,204,408,25,39,Tie
10742,JointPQPlayer,267,272,539,57,6,JointPQPlayer
10743,JointPQPlayer,250,245,495,34,13,Player A
10744,JointPQPlayer,264,264,528,49,7,Tie
10745,JointPQPlayer,217,222,439,35,32,JointPQPlayer
10746,JointPQPlayer,255,255,510,43,11,Tie
10747,JointPQPlayer,244,239,483,40,19,Player A
10748,JointPQPlayer,226,226,452,36,28,Tie
10749,JointPQPlayer,253,253,506,39,11,Tie
10750,JointPQPlayer,255,260,515,45,10,JointPQPlayer
10751,JointPQPlayer,231,231,462,34,24,Tie
10752,JointPQPlayer,260,255,515,42,9,Player A
10753,JointPQPlayer,219,219,438,31,31,Tie
10754,JointPQPlayer,192,197,389,24,45,JointPQPlayer
10755,JointPQPlayer,162,157,319,5,62,Player A
10756,JointPQPlayer,220,225,445,32,29,JointPQPlayer
10757,JointPQPlayer,250,250,500,48,16,Tie
10758,JointPQPlayer,266,261,527,48,7,Player A
10759,JointPQPlayer,169,174,343,5,54,JointPQPlayer
10760,JointPQPlayer,253,248,501,46,15,Player A
10761,JointPQPlayer,268,268,536,54,6,Tie
10762,JointPQPlayer,251,251,502,35,11,Tie
10763,JointPQPlayer,256,256,512,42,10,Tie
10764,JointPQPlayer,271,271,542,54,4,Tie
10765,JointPQPlayer,225,230,455,39,28,JointPQPlayer
10766,JointPQPlayer,253,248,501,37,12,Player A
10767,JointPQPlayer,274,274,548,57,3,Tie
10768,JointPQPlayer,193,193,386,15,43,Tie
10769,JointPQPlayer,246,251,497,42,15,JointPQPlayer
10770,JointPQPlayer,168,163,331,5,58,Player A
10771,JointPQPlayer,239,244,483,40,19,JointPQPlayer
10772,JointPQPlayer,194,189,383,18,45,Player A
10773,JointPQPlayer,267,267,534,52,6,Tie
10774,JointPQPlayer,267,267,534,46,4,Tie
10775,JointPQPlayer,166,171,337,2,55,JointPQPlayer
10776,JointPQPlayer,263,258,521,54,11,Player A
10777,JointPQPlayer,175,180,355,17,54,JointPQPlayer
10778,JointPQPlayer,220,220,440,30,30,Tie
10779,JointPQPlayer,259,254,513,46,11,Player A
10780,JointPQPlayer,245,245,490,44,18,Tie
10781,JointPQPlayer,264,264,528,58,10,Tie
10782,JointPQPlayer,270,270,540,49,3,Tie
10783,JointPQPlayer,215,215,430,26,32,Tie
10784,JointPQPlayer,236,241,477,46,23,JointPQPlayer
10785,JointPQPlayer,240,240,480,34,18,Tie
10786,JointPQPlayer,271,266,537,49,4,Player A
10787,JointPQPlayer,263,268,531,55,8,JointPQPlayer
10788,JointPQPlayer,204,204,408,25,39,Tie
10789,JointPQPlayer,195,195,390,25,45,Tie
10790,JointPQPlayer,251,246,497,48,17,Player A
10791,JointPQPlayer,268,273,541,56,5,JointPQPlayer
10792,JointPQPlayer,259,254,513,46,11,Player A
10793,JointPQPlayer,250,250,500,39,13,Tie
10794,JointPQPlayer,190,195,385,17,44,JointPQPlayer
10795,JointPQPlayer,247,242,489,37,16,Player A
10796,JointPQPlayer,173,178,351,4,51,JointPQPlayer
10797,JointPQPlayer,264,259,523,50,9,Player A
10798,JointPQPlayer,243,248,491,42,17,JointPQPlayer
10799,JointPQPlayer,209,204,413,15,34,Player A
10800,JointPQPlayer,220,220,440,24,28,Tie
10801,JointPQPlayer,261,266,527,57,10,JointPQPlayer
10802,JointPQPlayer,178,178,356,9,51,Tie
10803,JointPQPlayer,266,261,527,54,9,Player A
10804,JointPQPlayer,254,254,508,44,12,Tie
10805,JointPQPlayer,258,263,521,45,8,JointPQPlayer
10806,JointPQPlayer,195,195,390,16,42,Tie
10807,JointPQPlayer,221,216,437,27,30,Player A
10808,JointPQPlayer,162,167,329,6,59,JointPQPlayer
10809,JointPQPlayer,257,252,509,51,14,Player A
10810,JointPQPlayer,262,262,524,45,7,Tie
10811,JointPQPlayer,223,228,451,26,25,JointPQPlayer
10812,JointPQPlayer,256,256,512,54,14,Tie
10813,JointPQPlayer,245,240,485,42,19,Player A
10814,JointPQPlayer,272,277,549,61,4,JointPQPlayer
10815,JointPQPlayer,262,262,524,48,8,Tie
10816,JointPQPlayer,247,242,489,40,17,Player A
10817,JointPQPlayer,181,186,367,11,48,JointPQPlayer
10818,JointPQPlayer,259,254,513,46,11,Player A
10819,JointPQPlayer,243,248,491,42,17,JointPQPlayer
10820,JointPQPlayer,245,245,490,38,16,Tie
10821,JointPQPlayer,253,248,501,43,14,Player A
10822,JointPQPlayer,205,210,415,23,36,JointPQPlayer
10823,JointPQPlayer,254,254,508,47,13,Tie
10824,JointPQPlayer,168,168,336,7,57,Tie
10825,JointPQPlayer,276,271,547,68,7,Player A
10826,JointPQPlayer,254,259,513,49,12,JointPQPlayer
10827,JointPQPlayer,271,271,542,57,5,Tie
10828,JointPQPlayer,263,258,521,45,8,Player A
10829,JointPQPlayer,206,211,417,28,37,JointPQPlayer
10830,JointPQPlayer,249,249,498,43,15,Tie
10831,JointPQPlayer,210,205,415,23,36,Player A
10832,JointPQPlayer,261,266,527,48,7,JointPQPlayer
10833,JointPQPlayer,279,274,553,62,3,Player A
10834,JointPQPlayer,231,231,462,34,24,Tie
10835,JointPQPlayer,264,264,528,52,8,Tie
10836,JointPQPlayer,248,248,496,47,17,Tie
10837,JointPQPlayer,250,250,500,42,14,Tie
10838,JointPQPlayer,230,235,465,43,26,JointPQPlayer
10839,JointPQPlayer,269,264,533,51,6,Player A
10840,JointPQPlayer,223,228,451,41,30,JointPQPlayer
10841,JointPQPlayer,180,175,355,11,52,Player A
10842,JointPQPlayer,264,264,528,55,9,Tie
10843,JointPQPlayer,177,177,354,10,52,Tie
10844,JointPQPlayer,250,250,500,48,16,Tie
10845,JointPQPlayer,262,262,524,51,9,Tie
10846,JointPQPlayer,254,254,508,38,10,Tie
10847,JointPQPlayer,269,269,538,56,6,Tie
10848,JointPQPlayer,263,268,531,46,5,JointPQPlayer
10849,JointPQPlayer,193,188,381,16,45,Player A
10850,JointPQPlayer,269,269,538,53,5,Tie
10851,JointPQPlayer,179,179,358,11,51,Tie
10852,JointPQPlayer,253,253,506,36,10,Tie
10853,JointPQPlayer,267,272,539,54,5,JointPQPlayer
10854,JointPQPlayer,181,176,357,7,50,Player A
10855,JointPQPlayer,199,204,403,11,36,JointPQPlayer
10856,JointPQPlayer,271,266,537,52,5,Player A
10857,JointPQPlayer,257,257,514,44,10,Tie
10858,JointPQPlayer,246,251,497,36,13,JointPQPlayer
10859,JointPQPlayer,233,228,461,42,27,Player A
10860,JointPQPlayer,258,263,521,48,9,JointPQPlayer
10861,JointPQPlayer,256,256,512,48,12,Tie
10862,JointPQPlayer,242,237,479,36,19,Player A
10863,JointPQPlayer,228,228,456,34,26,Tie
10864,JointPQPlayer,231,236,467,45,26,JointPQPlayer
10865,JointPQPlayer,261,256,517,41,8,Player A
10866,JointPQPlayer,157,157,314,3,63,Tie
10867,JointPQPlayer,237,237,474,34,20,Tie
10868,JointPQPlayer,211,216,427,23,32,JointPQPlayer
10869,JointPQPlayer,227,222,449,36,29,Player A
10870,JointPQPlayer,236,236,472,35,21,Tie
10871,JointPQPlayer,164,169,333,4,57,JointPQPlayer
10872,JointPQPlayer,194,194,388,17,43,Tie
10873,JointPQPlayer,204,199,403,23,40,Player A
10874,JointPQPlayer,252,252,504,46,14,Tie
10875,JointPQPlayer,242,242,484,38,18,Tie
10876,JointPQPlayer,271,271,542,57,5,Tie
10877,JointPQPlayer,261,266,527,54,9,JointPQPlayer
10878,JointPQPlayer,181,176,357,7,50,Player A
10879,JointPQPlayer,185,185,370,8,46,Tie
10880,JointPQPlayer,251,251,502,44,14,Tie
10881,JointPQPlayer,231,231,462,34,24,Tie
10882,JointPQPlayer,248,253,501,40,13,JointPQPlayer
10883,JointPQPlayer,237,232,469,35,22,Player A
10884,JointPQPlayer,266,266,532,53,7,Tie
10885,JointPQPlayer,266,266,532,53,7,Tie
10886,JointPQPlayer,199,204,403,20,39,JointPQPlayer
10887,JointPQPlayer,229,229,458,27,23,Tie
10888,JointPQPlayer,268,263,531,61,10,Player A
10889,JointPQPlayer,253,253,506,42,12,Tie
10890,JointPQPlayer,200,205,405,28,41,JointPQPlayer
10891,JointPQPlayer,265,265,530,51,7,Tie
10892,JointPQPlayer,267,262,529,56,9,Player A
10893,JointPQPlayer,265,265,530,57,9,Tie
10894,JointPQPlayer,248,248,496,44,16,Tie
10895,JointPQPlayer,256,256,512,48,12,Tie
10896,JointPQPlayer,219,219,438,25,29,Tie
10897,JointPQPlayer,251,251,502,35,11,Tie
10898,JointPQPlayer,260,265,525,52,9,JointPQPlayer
10899,JointPQPlayer,268,263,531,52,7,Player A
10900,JointPQPlayer,254,259,513,43,10,JointPQPlayer
10901,JointPQPlayer,269,264,533,54,7,Player A
10902,JointPQPlayer,250,250,500,39,13,Tie
10903,JointPQPlayer,243,243,486,40,18,Tie
10904,JointPQPlayer,259,259,518,48,10,Tie
10905,JointPQPlayer,254,254,508,41,11,Tie
10906,JointPQPlayer,164,169,333,4,57,JointPQPlayer
10907,JointPQPlayer,266,266,532,53,7,Tie
10908,JointPQPlayer,242,242,484,38,18,Tie
10909,JointPQPlayer,194,194,388,23,45,Tie
10910,JointPQPlayer,264,259,523,47,8,Player A
10911,JointPQPlayer,261,266,527,51,8,JointPQPlayer
10912,JointPQPlayer,268,263,531,52,7,Player A
10913,JointPQPlayer,264,269,533,51,6,JointPQPlayer
10914,JointPQPlayer,198,193,391,20,43,Player A
10915,JointPQPlayer,191,191,382,20,46,Tie
10916,JointPQPlayer,253,253,506,33,9,Tie
10917,JointPQPlayer,181,186,367,11,48,JointPQPlayer
10918,JointPQPlayer,184,184,368,12,48,Tie
10919,JointPQPlayer,243,243,486,37,17,Tie
10920,JointPQPlayer,259,254,513,49,12,Player A
10921,JointPQPlayer,179,179,358,5,49,Tie
10922,JointPQPlayer,186,191,377,12,45,JointPQPlayer
10923,JointPQPlayer,269,264,533,51,6,Player A
10924,JointPQPlayer,253,253,506,42,12,Tie
10925,JointPQPlayer,256,256,512,51,13,Tie
10926,JointPQPlayer,265,265,530,57,9,Tie
10927,JointPQPlayer,203,203,406,20,38,Tie
10928,JointPQPlayer,259,259,518,48,10,Tie
10929,JointPQPlayer,244,244,488,42,18,Tie
10930,JointPQPlayer,251,251,502,44,14,Tie
10931,JointPQPlayer,240,240,480,40,20,Tie
10932,JointPQPlayer,273,273,546,64,6,Tie
10933,JointPQPlayer,262,262,524,51,9,Tie
10934,JointPQPlayer,242,242,484,35,17,Tie
10935,JointPQPlayer,243,243,486,34,16,Tie
10936,JointPQPlayer,239,239,478,38,20,Tie
10937,JointPQPlayer,256,256,512,45,11,Tie
10938,JointPQPlayer,256,261,517,50,11,JointPQPlayer
10939,JointPQPlayer,269,264,533,48,5,Player A
10940,JointPQPlayer,277,277,554,60,2,Tie
10941,JointPQPlayer,227,232,459,31,24,JointPQPlayer
10942,JointPQPlayer,227,222,449,36,29,Player A
10943,JointPQPlayer,178,183,361,8,49,JointPQPlayer
10944,JointPQPlayer,250,245,495,40,15,Player A
10945,JointPQPlayer,243,243,486,43,19,Tie
10946,JointPQPlayer,263,263,526,47,7,Tie
10947,JointPQPlayer,226,226,452,42,30,Tie
10948,JointPQPlayer,246,246,492,43,17,Tie
10949,JointPQPlayer,261,266,527,57,10,JointPQPlayer
10950,JointPQPlayer,254,249,503,51,16,Player A
10951,JointPQPlayer,182,182,364,11,49,Tie
10952,JointPQPlayer,256,256,512,45,11,Tie
10953,JointPQPlayer,205,205,410,24,38,Tie
10954,JointPQPlayer,183,188,371,21,50,JointPQPlayer
10955,JointPQPlayer,262,257,519,52,11,Player A
10956,JointPQPlayer,267,267,534,55,7,Tie
10957,JointPQPlayer,241,241,482,36,18,Tie
10958,JointPQPlayer,221,221,442,26,28,Tie
10959,JointPQPlayer,245,245,490,41,17,Tie
10960,JointPQPlayer,267,267,534,58,8,Tie
10961,JointPQPlayer,251,251,502,47,15,Tie
10962,JointPQPlayer,173,173,346,8,54,Tie
10963,JointPQPlayer,179,179,358,17,53,Tie
10964,JointPQPlayer,181,181,362,12,50,Tie
10965,JointPQPlayer,178,183,361,11,50,JointPQPlayer
10966,JointPQPlayer,223,223,446,36,30,Tie
10967,JointPQPlayer,233,233,466,35,23,Tie
10968,JointPQPlayer,270,265,535,59,8,Player A
10969,JointPQPlayer,270,270,540,52,4,Tie
10970,JointPQPlayer,232,237,469,41,24,JointPQPlayer
10971,JointPQPlayer,217,212,429,25,32,Player A
10972,JointPQPlayer,245,245,490,50,20,Tie
10973,JointPQPlayer,227,232,459,40,27,JointPQPlayer
10974,JointPQPlayer,237,232,469,38,23,Player A
10975,JointPQPlayer,162,167,329,6,59,JointPQPlayer
10976,JointPQPlayer,249,244,493,38,15,Player A
10977,JointPQPlayer,232,232,464,36,24,Tie
10978,JointPQPlayer,229,229,458,33,25,Tie
10979,JointPQPlayer,239,239,478,41,21,Tie
10980,JointPQPlayer,259,264,523,44,7,JointPQPlayer
10981,JointPQPlayer,266,261,527,54,9,Player A
10982,JointPQPlayer,253,253,506,42,12,Tie
10983,JointPQPlayer,258,258,516,40,8,Tie
10984,JointPQPlayer,231,231,462,34,24,Tie
10985,JointPQPlayer,250,250,500,39,13,Tie
10986,JointPQPlayer,255,255,510,40,10,Tie
10987,JointPQPlayer,262,262,524,51,9,Tie
10988,JointPQPlayer,261,261,522,52,10,Tie
10989,JointPQPlayer,202,202,404,30,42,Tie
10990,JointPQPlayer,179,184,363,10,49,JointPQPlayer
10991,JointPQPlayer,223,223,446,42,32,Tie
10992,JointPQPlayer,278,273,551,63,4,Player A
10993,JointPQPlayer,249,249,498,37,13,Tie
10994,JointPQPlayer,255,260,515,51,12,JointPQPlayer
10995,JointPQPlayer,171,171,342,7,55,Tie
10996,JointPQPlayer,191,186,377,18,47,Player A
10997,JointPQPlayer,254,259,513,49,12,JointPQPlayer
10998,JointPQPlayer,175,175,350,9,53,Tie
10999,JointPQPlayer,267,262,529,47,6,Player A
11000,JointPQPlayer,270,270,540,49,3,Tie
11001,JointPQPlayer,202,207,409,23,38,JointPQPlayer
11002,JointPQPlayer,253,253,506,48,14,Tie
11003,JointPQPlayer,184,184,368,9,47,Tie
11004,JointPQPlayer,262,257,519,49,10,Player A
11005,JointPQPlayer,242,247,489,37,16,JointPQPlayer
11006,JointPQPlayer,266,261,527,54,9,Player A
11007,JointPQPlayer,256,261,517,50,11,JointPQPlayer
11008,JointPQPlayer,267,262,529,56,9,Player A
11009,JointPQPlayer,259,259,518,54,12,Tie
11010,JointPQPlayer,176,181,357,7,50,JointPQPlayer
11011,JointPQPlayer,224,219,443,39,32,Player A
11012,JointPQPlayer,180,185,365,21,52,JointPQPlayer
11013,JointPQPlayer,212,212,424,26,34,Tie
11014,JointPQPlayer,251,246,497,39,14,Player A
11015,JointPQPlayer,265,265,530,54,8,Tie
11016,JointPQPlayer,263,268,531,55,8,JointPQPlayer
11017,JointPQPlayer,255,250,505,47,14,Player A
11018,JointPQPlayer,246,251,497,39,14,JointPQPlayer
11019,JointPQPlayer,232,227,459,34,25,Player A
11020,JointPQPlayer,283,283,566,69,1,Tie
11021,JointPQPlayer,242,242,484,50,22,Tie
11022,JointPQPlayer,254,259,513,46,11,JointPQPlayer
11023,JointPQPlayer,259,254,513,46,11,Player A
11024,JointPQPlayer,249,254,503,42,13,JointPQPlayer
11025,JointPQPlayer,252,252,504,46,14,Tie
11026,JointPQPlayer,252,247,499,41,14,Player A
11027,JointPQPlayer,252,252,504,43,13,Tie
11028,JointPQPlayer,180,180,360,10,50,Tie
11029,JointPQPlayer,213,218,431,27,32,JointPQPlayer
11030,JointPQPlayer,218,213,431,21,30,Player A
11031,JointPQPlayer,265,270,535,53,6,JointPQPlayer
11032,JointPQPlayer,262,262,524,51,9,Tie
11033,JointPQPlayer,260,260,520,47,9,Tie
11034,JointPQPlayer,232,227,459,34,25,Player A
11035,JointPQPlayer,260,260,520,50,10,Tie
11036,JointPQPlayer,218,218,436,26,30,Tie
11037,JointPQPlayer,281,281,562,71,3,Tie
11038,JointPQPlayer,259,259,518,45,9,Tie
11039,JointPQPlayer,189,194,383,6,41,JointPQPlayer
11040,JointPQPlayer,246,241,487,41,18,Player A
11041,JointPQPlayer,255,255,510,49,13,Tie
11042,JointPQPlayer,246,246,492,43,17,Tie
11043,JointPQPlayer,169,169,338,9,57,Tie
11044,JointPQPlayer,159,164,323,9,62,JointPQPlayer
11045,JointPQPlayer,212,207,419,27,36,Player A
11046,JointPQPlayer,209,214,423,28,35,JointPQPlayer
11047,JointPQPlayer,249,244,493,41,16,Player A
11048,JointPQPlayer,249,254,503,48,15,JointPQPlayer
11049,JointPQPlayer,277,272,549,58,3,Player A
11050,JointPQPlayer,220,220,440,30,30,Tie
11051,JointPQPlayer,266,266,532,50,6,Tie
11052,JointPQPlayer,246,251,497,42,15,JointPQPlayer
11053,JointPQPlayer,183,178,361,8,49,Player A
11054,JointPQPlayer,261,261,522,58,12,Tie
11055,JointPQPlayer,257,257,514,50,12,Tie
11056,JointPQPlayer,211,216,427,23,32,JointPQPlayer
11057,JointPQPlayer,258,253,511,41,10,Player A
11058,JointPQPlayer,239,239,478,44,22,Tie
11059,JointPQPlayer,261,261,522,46,8,Tie
11060,JointPQPlayer,219,224,443,33,30,JointPQPlayer
11061,JointPQPlayer,244,239,483,43,20,Player A
11062,JointPQPlayer,186,191,377,6,43,JointPQPlayer
11063,JointPQPlayer,264,264,528,55,9,Tie
11064,JointPQPlayer,253,248,501,46,15,Player A
11065,JointPQPlayer,257,257,514,50,12,Tie
11066,JointPQPlayer,272,272,544,56,4,Tie
11067,JointPQPlayer,263,263,526,47,7,Tie
11068,JointPQPlayer,182,187,369,7,46,JointPQPlayer
11069,JointPQPlayer,241,236,477,40,21,Player A
11070,JointPQPlayer,226,226,452,36,28,Tie
11071,JointPQPlayer,264,264,528,52,8,Tie
11072,JointPQPlayer,250,250,500,36,12,Tie
11073,JointPQPlayer,232,232,464,39,25,Tie
11074,JointPQPlayer,274,274,548,60,4,Tie
11075,JointPQPlayer,230,235,465,37,24,JointPQPlayer
11076,JointPQPlayer,247,242,489,43,18,Player A
11077,JointPQPlayer,254,259,513,43,10,JointPQPlayer
11078,JointPQPlayer,240,240,480,31,17,Tie
11079,JointPQPlayer,250,245,495,40,15,Player A
11080,JointPQPlayer,265,265,530,54,8,Tie
11081,JointPQPlayer,225,230,455,33,26,JointPQPlayer
11082,JointPQPlayer,221,216,437,27,30,Player A
11083,JointPQPlayer,262,267,529,53,8,JointPQPlayer
11084,JointPQPlayer,274,269,543,61,6,Player A
11085,JointPQPlayer,199,199,398,21,41,Tie
11086,JointPQPlayer,231,231,462,31,23,Tie
11087,JointPQPlayer,258,258,516,43,9,Tie
11088,JointPQPlayer,269,274,543,58,5,JointPQPlayer
11089,JointPQPlayer,185,185,370,5,45,Tie
11090,JointPQPlayer,179,179,358,8,50,Tie
11091,JointPQPlayer,247,247,494,45,17,Tie
11092,JointPQPlayer,167,167,334,8,58,Tie
11093,JointPQPlayer,263,258,521,45,8,Player A
11094,JointPQPlayer,266,266,532,47,5,Tie
11095,JointPQPlayer,262,262,524,51,9,Tie
11096,JointPQPlayer,241,241,482,36,18,Tie
11097,JointPQPlayer,253,253,506,36,10,Tie
11098,JointPQPlayer,247,247,494,39,15,Tie
11099,JointPQPlayer,248,248,496,44,16,Tie
11100,JointPQPlayer,228,228,456,31,25,Tie
11101,JointPQPlayer,265,265,530,51,7,Tie
11102,JointPQPlayer,234,234,468,40,24,Tie
11103,JointPQPlayer,210,210,420,25,35,Tie
11104,JointPQPlayer,183,188,371,9,46,JointPQPlayer
11105,JointPQPlayer,172,167,339,7,56,Player A
11106,JointPQPlayer,268,268,536,54,6,Tie
11107,JointPQPlayer,244,244,488,48,20,Tie
11108,JointPQPlayer,223,228,451,29,26,JointPQPlayer
11109,JointPQPlayer,257,252,509,45,12,Player A
11110,JointPQPlayer,205,205,410,24,38,Tie
11111,JointPQPlayer,260,260,520,56,12,Tie
11112,JointPQPlayer,267,267,534,55,7,Tie
11113,JointPQPlayer,270,270,540,58,6,Tie
11114,JointPQPlayer,239,244,483,43,20,JointPQPlayer
11115,JointPQPlayer,254,249,503,51,16,Player A
11116,JointPQPlayer,260,260,520,62,14,Tie
11117,JointPQPlayer,252,257,509,42,11,JointPQPlayer
11118,JointPQPlayer,190,190,380,9,43,Tie
11119,JointPQPlayer,264,264,528,49,7,Tie
11120,JointPQPlayer,248,243,491,42,17,Player A
11121,JointPQPlayer,252,257,509,45,12,JointPQPlayer
11122,JointPQPlayer,180,175,355,11,52,Player A
11123,JointPQPlayer,170,170,340,8,56,Tie
11124,JointPQPlayer,202,202,404,18,38,Tie
11125,JointPQPlayer,266,266,532,50,6,Tie
11126,JointPQPlayer,248,253,501,43,14,JointPQPlayer
11127,JointPQPlayer,254,249,503,45,14,Player A
11128,JointPQPlayer,264,264,528,52,8,Tie
11129,JointPQPlayer,149,154,303,1,66,JointPQPlayer
11130,JointPQPlayer,184,179,363,13,50,Player A
11131,JointPQPlayer,263,263,526,44,6,Tie
11132,JointPQPlayer,234,234,468,43,25,Tie
11133,JointPQPlayer,256,256,512,45,11,Tie
11134,JointPQPlayer,270,275,545,60,5,JointPQPlayer
11135,JointPQPlayer,266,261,527,57,10,Player A
11136,JointPQPlayer,239,244,483,37,18,JointPQPlayer
11137,JointPQPlayer,240,235,475,41,22,Player A
11138,JointPQPlayer,246,251,497,48,17,JointPQPlayer
11139,JointPQPlayer,266,261,527,54,9,Player A
11140,JointPQPlayer,203,203,406,17,37,Tie
11141,JointPQPlayer,195,195,390,10,40,Tie
11142,JointPQPlayer,221,226,447,31,28,JointPQPlayer
11143,JointPQPlayer,265,260,525,49,8,Player A
11144,JointPQPlayer,250,255,505,47,14,JointPQPlayer
11145,JointPQPlayer,250,245,495,40,15,Player A
11146,JointPQPlayer,228,228,456,37,27,Tie
11147,JointPQPlayer,252,257,509,51,14,JointPQPlayer
11148,JointPQPlayer,257,252,509,45,12,Player A
11149,JointPQPlayer,261,261,522,46,8,Tie
11150,JointPQPlayer,181,186,367,14,49,JointPQPlayer
11151,JointPQPlayer,228,223,451,41,30,Player A
11152,JointPQPlayer,236,236,472,35,21,Tie
11153,JointPQPlayer,262,262,524,51,9,Tie
11154,JointPQPlayer,256,261,517,47,10,JointPQPlayer
11155,JointPQPlayer,192,187,379,8,43,Player A
11156,JointPQPlayer,248,248,496,44,16,Tie
11157,JointPQPlayer,174,174,348,4,52,Tie
11158,JointPQPlayer,266,266,532,50,6,Tie
11159,JointPQPlayer,217,222,439,35,32,JointPQPlayer
11160,JointPQPlayer,265,265,530,54,8,Tie
11161,JointPQPlayer,250,245,495,40,15,Player A
11162,JointPQPlayer,264,264,528,46,6,Tie
11163,JointPQPlayer,254,259,513,49,12,JointPQPlayer
11164,JointPQPlayer,253,248,501,46,15,Player A
11165,JointPQPlayer,248,248,496,35,13,Tie
11166,JointPQPlayer,184,184,368,9,47,Tie
11167,JointPQPlayer,212,212,424,23,33,Tie
11168,JointPQPlayer,212,217,429,28,33,JointPQPlayer
11169,JointPQPlayer,256,256,512,45,11,Tie
11170,JointPQPlayer,181,181,362,6,48,Tie
11171,JointPQPlayer,239,239,478,38,20,Tie
11172,JointPQPlayer,261,256,517,47,10,Player A
11173,JointPQPlayer,170,170,340,8,56,Tie
11174,JointPQPlayer,254,259,513,40,9,JointPQPlayer
11175,JointPQPlayer,257,257,514,50,12,Tie
11176,JointPQPlayer,268,263,531,55,8,Player A
11177,JointPQPlayer,268,273,541,53,4,JointPQPlayer
11178,JointPQPlayer,167,167,334,5,57,Tie
11179,JointPQPlayer,222,217,439,26,29,Player A
11180,JointPQPlayer,211,211,422,30,36,Tie
11181,JointPQPlayer,194,194,388,17,43,Tie
11182,JointPQPlayer,258,258,516,52,12,Tie
11183,JointPQPlayer,266,266,532,53,7,Tie
11184,JointPQPlayer,258,258,516,43,9,Tie
11185,JointPQPlayer,260,265,525,52,9,JointPQPlayer
11186,JointPQPlayer,155,155,310,2,64,Tie
11187,JointPQPlayer,272,267,539,57,6,Player A
11188,JointPQPlayer,256,256,512,51,13,Tie
11189,JointPQPlayer,240,240,480,46,22,Tie
11190,JointPQPlayer,212,217,429,19,30,JointPQPlayer
11191,JointPQPlayer,159,154,313,5,64,Player A
11192,JointPQPlayer,232,237,469,41,24,JointPQPlayer
11193,JointPQPlayer,274,269,543,64,7,Player A
11194,JointPQPlayer,202,202,404,27,41,Tie
11195,JointPQPlayer,219,219,438,34,32,Tie
11196,JointPQPlayer,253,258,511,44,11,JointPQPlayer
11197,JointPQPlayer,240,240,480,40,20,Tie
11198,JointPQPlayer,232,227,459,37,26,Player A
11199,JointPQPlayer,228,233,461,42,27,JointPQPlayer
11200,JointPQPlayer,261,256,517,50,11,Player A
11201,JointPQPlayer,261,261,522,49,9,Tie
11202,JointPQPlayer,168,173,341,6,55,JointPQPlayer
11203,JointPQPlayer,243,238,481,44,21,Player A
11204,JointPQPlayer,177,182,359,9,50,JointPQPlayer
11205,JointPQPlayer,174,174,348,10,54,Tie
11206,JointPQPlayer,231,226,457,32,25,Player A
11207,JointPQPlayer,250,250,500,39,13,Tie
11208,JointPQPlayer,250,250,500,45,15,Tie
11209,JointPQPlayer,260,260,520,50,10,Tie
11210,JointPQPlayer,253,253,506,54,16,Tie
11211,JointPQPlayer,196,196,392,18,42,Tie
11212,JointPQPlayer,242,247,489,43,18,JointPQPlayer
11213,JointPQPlayer,262,262,524,54,10,Tie
11214,JointPQPlayer,177,177,354,7,51,Tie
11215,JointPQPlayer,177,177,354,1,49,Tie
11216,JointPQPlayer,185,185,370,11,47,Tie
11217,JointPQPlayer,242,237,479,36,19,Player A
11218,JointPQPlayer,267,267,534,61,9,Tie
11219,JointPQPlayer,263,263,526,47,7,Tie
11220,JointPQPlayer,232,237,469,44,25,JointPQPlayer
11221,JointPQPlayer,265,260,525,52,9,Player A
11222,JointPQPlayer,180,180,360,10,50,Tie
11223,JointPQPlayer,244,249,493,35,14,JointPQPlayer
11224,JointPQPlayer,264,259,523,50,9,Player A
11225,JointPQPlayer,252,252,504,52,16,Tie
11226,JointPQPlayer,267,272,539,48,3,JointPQPlayer
11227,JointPQPlayer,278,273,551,60,3,Player A
11228,JointPQPlayer,270,270,540,52,4,Tie
11229,JointPQPlayer,176,176,352,11,53,Tie
11230,JointPQPlayer,209,214,423,22,33,JointPQPlayer
11231,JointPQPlayer,262,262,524,42,6,Tie
11232,JointPQPlayer,168,168,336,7,57,Tie
11233,JointPQPlayer,181,181,362,15,51,Tie
11234,JointPQPlayer,245,240,485,45,20,Player A
11235,JointPQPlayer,264,264,528,55,9,Tie
11236,JointPQPlayer,176,181,357,7,50,JointPQPlayer
11237,JointPQPlayer,235,230,465,34,23,Player A
11238,JointPQPlayer,194,199,393,10,39,JointPQPlayer
11239,JointPQPlayer,213,213,426,28,34,Tie
11240,JointPQPlayer,263,258,521,48,9,Player A
11241,JointPQPlayer,263,268,531,52,7,JointPQPlayer
11242,JointPQPlayer,239,234,473,39,22,Player A
11243,JointPQPlayer,247,247,494,42,16,Tie
11244,JointPQPlayer,257,257,514,47,11,Tie
11245,JointPQPlayer,259,264,523,44,7,JointPQPlayer
11246,JointPQPlayer,247,242,489,43,18,Player A
11247,JointPQPlayer,245,245,490,41,17,Tie
11248,JointPQPlayer,173,178,351,4,51,JointPQPlayer
11249,JointPQPlayer,250,250,500,42,14,Tie
11250,JointPQPlayer,161,156,317,6,63,Player A
11251,JointPQPlayer,262,267,529,53,8,JointPQPlayer
11252,JointPQPlayer,261,256,517,50,11,Player A
11253,JointPQPlayer,245,250,495,34,13,JointPQPlayer
11254,JointPQPlayer,269,264,533,57,8,Player A
11255,JointPQPlayer,251,251,502,47,15,Tie
11256,JointPQPlayer,268,268,536,48,4,Tie
11257,JointPQPlayer,254,254,508,50,14,Tie
11258,JointPQPlayer,256,261,517,47,10,JointPQPlayer
11259,JointPQPlayer,269,264,533,60,9,Player A
11260,JointPQPlayer,256,261,517,47,10,JointPQPlayer
11261,JointPQPlayer,265,260,525,52,9,Player A
11262,JointPQPlayer,268,268,536,48,4,Tie
11263,JointPQPlayer,242,247,489,46,19,JointPQPlayer
11264,JointPQPlayer,254,249,503,48,15,Player A
11265,JointPQPlayer,241,241,482,39,19,Tie
11266,JointPQPlayer,256,256,512,45,11,Tie
11267,JointPQPlayer,263,268,531,52,7,JointPQPlayer
11268,JointPQPlayer,271,266,537,58,7,Player A
11269,JointPQPlayer,263,263,526,44,6,Tie
11270,JointPQPlayer,253,253,506,42,12,Tie
11271,JointPQPlayer,244,249,493,38,15,JointPQPlayer
11272,JointPQPlayer,246,246,492,43,17,Tie
11273,JointPQPlayer,250,250,500,45,15,Tie
11274,JointPQPlayer,266,261,527,57,10,Player A
11275,JointPQPlayer,207,207,414,25,37,Tie
11276,JointPQPlayer,269,269,538,53,5,Tie
11277,JointPQPlayer,256,256,512,42,10,Tie
11278,JointPQPlayer,246,251,497,36,13,JointPQPlayer
11279,JointPQPlayer,254,254,508,50,14,Tie
11280,JointPQPlayer,253,248,501,43,14,Player A
11281,JointPQPlayer,244,244,488,39,17,Tie
11282,JointPQPlayer,269,269,538,53,5,Tie
11283,JointPQPlayer,251,256,507,43,12,JointPQPlayer
11284,JointPQPlayer,249,249,498,37,13,Tie
11285,JointPQPlayer,218,213,431,36,35,Player A
11286,JointPQPlayer,203,203,406,20,38,Tie
11287,JointPQPlayer,238,238,476,36,20,Tie
11288,JointPQPlayer,254,259,513,49,12,JointPQPlayer
11289,JointPQPlayer,217,212,429,28,33,Player A
11290,JointPQPlayer,245,250,495,40,15,JointPQPlayer
11291,JointPQPlayer,263,258,521,51,10,Player A
11292,JointPQPlayer,262,262,524,45,7,Tie
11293,JointPQPlayer,258,258,516,49,11,Tie
11294,JointPQPlayer,256,256,512,39,9,Tie
11295,JointPQPlayer,272,272,544,56,4,Tie
11296,JointPQPlayer,264,264,528,52,8,Tie
11297,JointPQPlayer,176,176,352,14,54,Tie
11298,JointPQPlayer,259,259,518,51,11,Tie
11299,JointPQPlayer,240,240,480,37,19,Tie
11300,JointPQPlayer,240,240,480,49,23,Tie
11301,JointPQPlayer,271,271,542,57,5,Tie
11302,JointPQPlayer,266,266,532,47,5,Tie
11303,JointPQPlayer,187,187,374,12,46,Tie
11304,JointPQPlayer,262,262,524,45,7,Tie
11305,JointPQPlayer,184,184,368,6,46,Tie
11306,JointPQPlayer,194,199,393,19,42,JointPQPlayer
11307,JointPQPlayer,266,261,527,51,8,Player A
11308,JointPQPlayer,246,246,492,40,16,Tie
11309,JointPQPlayer,201,201,402,22,40,Tie
11310,JointPQPlayer,247,247,494,42,16,Tie
11311,JointPQPlayer,255,255,510,40,10,Tie
11312,JointPQPlayer,218,218,436,32,32,Tie
11313,JointPQPlayer,182,182,364,11,49,Tie
11314,JointPQPlayer,266,266,532,56,8,Tie
11315,JointPQPlayer,240,245,485,45,20,JointPQPlayer
11316,JointPQPlayer,261,256,517,53,12,Player A
11317,JointPQPlayer,244,249,493,44,17,JointPQPlayer
11318,JointPQPlayer,241,236,477,34,19,Player A
11319,JointPQPlayer,265,265,530,51,7,Tie
11320,JointPQPlayer,238,238,476,42,22,Tie
11321,JointPQPlayer,221,226,447,28,27,JointPQPlayer
11322,JointPQPlayer,251,251,502,44,14,Tie
11323,JointPQPlayer,204,204,408,22,38,Tie
11324,JointPQPlayer,266,261,527,48,7,Player A
11325,JointPQPlayer,243,243,486,37,17,Tie
11326,JointPQPlayer,261,261,522,49,9,Tie
11327,JointPQPlayer,212,212,424,29,35,Tie
11328,JointPQPlayer,265,265,530,54,8,Tie
11329,JointPQPlayer,258,263,521,51,10,JointPQPlayer
11330,JointPQPlayer,267,262,529,59,10,Player A
11331,JointPQPlayer,271,271,542,60,6,Tie
11332,JointPQPlayer,257,257,514,47,11,Tie
11333,JointPQPlayer,253,253,506,51,15,Tie
11334,JointPQPlayer,251,251,502,44,14,Tie
11335,JointPQPlayer,212,212,424,23,33,Tie
11336,JointPQPlayer,198,198,396,16,40,Tie
11337,JointPQPlayer,238,238,476,42,22,Tie
11338,JointPQPlayer,248,253,501,40,13,JointPQPlayer
11339,JointPQPlayer,275,275,550,62,4,Tie
11340,JointPQPlayer,253,248,501,43,14,Player A
11341,JointPQPlayer,241,246,487,47,20,JointPQPlayer
11342,JointPQPlayer,219,214,433,26,31,Player A
11343,JointPQPlayer,201,201,402,16,38,Tie
11344,JointPQPlayer,242,242,484,44,20,Tie
11345,JointPQPlayer,174,179,353,12,53,JointPQPlayer
11346,JointPQPlayer,244,239,483,37,18,Player A
11347,JointPQPlayer,264,264,528,43,5,Tie
11348,JointPQPlayer,278,278,556,62,2,Tie
11349,JointPQPlayer,264,264,528,58,10,Tie
11350,JointPQPlayer,187,192,379,14,45,JointPQPlayer
11351,JointPQPlayer,251,246,497,39,14,Player A
11352,JointPQPlayer,260,260,520,47,9,Tie
11353,JointPQPlayer,261,261,522,40,6,Tie
11354,JointPQPlayer,265,265,530,45,5,Tie
11355,JointPQPlayer,252,257,509,42,11,JointPQPlayer
11356,JointPQPlayer,255,250,505,50,15,Player A
11357,JointPQPlayer,191,191,382,17,45,Tie
11358,JointPQPlayer,188,188,376,14,46,Tie
11359,JointPQPlayer,258,258,516,46,10,Tie
11360,JointPQPlayer,255,255,510,43,11,Tie
11361,JointPQPlayer,250,255,505,41,12,JointPQPlayer
11362,JointPQPlayer,260,255,515,42,9,Player A
11363,JointPQPlayer,254,254,508,41,11,Tie
11364,JointPQPlayer,248,248,496,44,16,Tie
11365,JointPQPlayer,258,263,521,48,9,JointPQPlayer
11366,JointPQPlayer,265,260,525,52,9,Player A
11367,JointPQPlayer,171,176,347,6,53,JointPQPlayer
11368,JointPQPlayer,266,261,527,57,10,Player A
11369,JointPQPlayer,238,238,476,42,22,Tie
11370,JointPQPlayer,220,220,440,33,31,Tie
11371,JointPQPlayer,256,261,517,47,10,JointPQPlayer
11372,JointPQPlayer,255,250,505,44,13,Player A
11373,JointPQPlayer,182,182,364,5,47,Tie
11374,JointPQPlayer,168,173,341,6,55,JointPQPlayer
11375,JointPQPlayer,251,246,497,45,16,Player A
11376,JointPQPlayer,231,236,467,33,22,JointPQPlayer
11377,JointPQPlayer,245,245,490,41,17,Tie
11378,JointPQPlayer,243,243,486,40,18,Tie
11379,JointPQPlayer,243,238,481,35,18,Player A
11380,JointPQPlayer,260,260,520,50,10,Tie
11381,JointPQPlayer,259,264,523,47,8,JointPQPlayer
11382,JointPQPlayer,248,243,491,45,18,Player A
11383,JointPQPlayer,233,233,466,35,23,Tie
11384,JointPQPlayer,225,225,450,28,26,Tie
11385,JointPQPlayer,255,255,510,46,12,Tie
11386,JointPQPlayer,260,260,520,50,10,Tie
11387,JointPQPlayer,182,187,369,10,47,JointPQPlayer
11388,JointPQPlayer,245,240,485,36,17,Player A
11389,JointPQPlayer,253,253,506,45,13,Tie
11390,JointPQPlayer,272,272,544,59,5,Tie
11391,JointPQPlayer,257,257,514,41,9,Tie
11392,JointPQPlayer,214,214,428,30,34,Tie
11393,JointPQPlayer,256,256,512,42,10,Tie
11394,JointPQPlayer,227,227,454,29,25,Tie
11395,JointPQPlayer,258,258,516,55,13,Tie
11396,JointPQPlayer,260,260,520,44,8,Tie
11397,JointPQPlayer,167,172,339,7,56,JointPQPlayer
11398,JointPQPlayer,256,251,507,49,14,Player A
11399,JointPQPlayer,187,192,379,20,47,JointPQPlayer
11400,JointPQPlayer,241,236,477,43,22,Player A
11401,JointPQPlayer,258,263,521,42,7,JointPQPlayer
11402,JointPQPlayer,261,261,522,46,8,Tie
11403,JointPQPlayer,256,251,507,58,17,Player A
11404,JointPQPlayer,247,247,494,45,17,Tie
11405,JointPQPlayer,194,194,388,8,40,Tie
11406,JointPQPlayer,191,196,387,16,43,JointPQPlayer
11407,JointPQPlayer,240,235,475,38,21,Player A
11408,JointPQPlayer,269,274,543,55,4,JointPQPlayer
11409,JointPQPlayer,247,242,489,43,18,Player A
11410,JointPQPlayer,222,227,449,39,30,JointPQPlayer
11411,JointPQPlayer,234,234,468,34,22,Tie
11412,JointPQPlayer,217,217,434,27,31,Tie
11413,JointPQPlayer,268,268,536,60,8,Tie
11414,JointPQPlayer,221,221,442,32,30,Tie
11415,JointPQPlayer,257,257,514,50,12,Tie
11416,JointPQPlayer,189,189,378,10,44,Tie
11417,JointPQPlayer,229,224,453,40,29,Player A
11418,JointPQPlayer,261,266,527,54,9,JointPQPlayer
11419,JointPQPlayer,235,230,465,37,24,Player A
11420,JointPQPlayer,236,236,472,41,23,Tie
11421,JointPQPlayer,257,262,519,49,10,JointPQPlayer
11422,JointPQPlayer,252,247,499,47,16,Player A
11423,JointPQPlayer,260,260,520,44,8,Tie
11424,JointPQPlayer,255,255,510,49,13,Tie
11425,JointPQPlayer,258,258,516,46,10,Tie
11426,JointPQPlayer,267,272,539,54,5,JointPQPlayer
11427,JointPQPlayer,275,275,550,56,2,Tie
11428,JointPQPlayer,252,252,504,43,13,Tie
11429,JointPQPlayer,236,231,467,33,22,Player A
11430,JointPQPlayer,169,174,343,5,54,JointPQPlayer
11431,JointPQPlayer,180,175,355,8,51,Player A
11432,JointPQPlayer,260,260,520,47,9,Tie
11433,JointPQPlayer,252,252,504,43,13,Tie
11434,JointPQPlayer,240,240,480,43,21,Tie
11435,JointPQPlayer,227,232,459,34,25,JointPQPlayer
11436,JointPQPlayer,261,256,517,53,12,Player A
11437,JointPQPlayer,265,265,530,45,5,Tie
11438,JointPQPlayer,216,216,432,34,34,Tie
11439,JointPQPlayer,193,193,386,15,43,Tie
11440,JointPQPlayer,247,252,499,50,17,JointPQPlayer
11441,JointPQPlayer,235,235,470,45,25,Tie
11442,JointPQPlayer,252,252,504,49,15,Tie
11443,JointPQPlayer,262,257,519,52,11,Player A
11444,JointPQPlayer,206,206,412,26,38,Tie
11445,JointPQPlayer,237,237,474,37,21,Tie
11446,JointPQPlayer,183,183,366,10,48,Tie
11447,JointPQPlayer,261,266,527,45,6,JointPQPlayer
11448,JointPQPlayer,192,192,384,10,42,Tie
11449,JointPQPlayer,255,250,505,44,13,Player A
11450,JointPQPlayer,249,254,503,39,12,JointPQPlayer
11451,JointPQPlayer,179,179,358,8,50,Tie
11452,JointPQPlayer,261,256,517,47,10,Player A
11453,JointPQPlayer,243,243,486,43,19,Tie
11454,JointPQPlayer,220,220,440,27,29,Tie
11455,JointPQPlayer,267,267,534,49,5,Tie
11456,JointPQPlayer,247,247,494,45,17,Tie
11457,JointPQPlayer,251,251,502,47,15,Tie
11458,JointPQPlayer,258,263,521,48,9,JointPQPlayer
11459,JointPQPlayer,267,262,529,50,7,Player A
11460,JointPQPlayer,264,264,528,55,9,Tie
11461,JointPQPlayer,236,236,472,38,22,Tie
11462,JointPQPlayer,226,226,452,33,27,Tie
11463,JointPQPlayer,180,185,365,12,49,JointPQPlayer
11464,JointPQPlayer,267,262,529,56,9,Player A
11465,JointPQPlayer,187,192,379,23,48,JointPQPlayer
11466,JointPQPlayer,177,177,354,7,51,Tie
11467,JointPQPlayer,194,189,383,21,46,Player A
11468,JointPQPlayer,190,190,380,18,46,Tie
11469,JointPQPlayer,248,248,496,50,18,Tie
11470,JointPQPlayer,264,264,528,58,10,Tie
11471,JointPQPlayer,183,188,371,9,46,JointPQPlayer
11472,JointPQPlayer,248,243,491,42,17,Player A
11473,JointPQPlayer,217,217,434,36,34,Tie
11474,JointPQPlayer,259,264,523,50,9,JointPQPlayer
11475,JointPQPlayer,273,273,546,55,3,Tie
11476,JointPQPlayer,276,271,547,62,5,Player A
11477,JointPQPlayer,229,229,458,33,25,Tie
11478,JointPQPlayer,235,240,475,38,21,JointPQPlayer
11479,JointPQPlayer,251,246,497,39,14,Player A
11480,JointPQPlayer,235,240,475,41,22,JointPQPlayer
11481,JointPQPlayer,243,238,481,38,19,Player A
11482,JointPQPlayer,255,260,515,39,8,JointPQPlayer
11483,JointPQPlayer,247,247,494,48,18,Tie
11484,JointPQPlayer,256,251,507,40,11,Player A
11485,JointPQPlayer,258,258,516,52,12,Tie
11486,JointPQPlayer,206,206,412,23,37,Tie
11487,JointPQPlayer,274,279,553,59,2,JointPQPlayer
11488,JointPQPlayer,183,183,366,10,48,Tie
11489,JointPQPlayer,263,258,521,48,9,Player A
11490,JointPQPlayer,256,256,512,36,8,Tie
11491,JointPQPlayer,259,264,523,50,9,JointPQPlayer
11492,JointPQPlayer,266,261,527,54,9,Player A
11493,JointPQPlayer,196,201,397,17,40,JointPQPlayer
11494,JointPQPlayer,245,245,490,41,17,Tie
11495,JointPQPlayer,247,247,494,39,15,Tie
11496,JointPQPlayer,238,233,471,49,26,Player A
11497,JointPQPlayer,242,247,489,40,17,JointPQPlayer
11498,JointPQPlayer,253,248,501,43,14,Player A
11499,JointPQPlayer,244,249,493,38,15,JointPQPlayer
11500,JointPQPlayer,246,246,492,43,17,Tie
11501,JointPQPlayer,259,254,513,52,13,Player A
11502,JointPQPlayer,251,251,502,53,17,Tie
11503,JointPQPlayer,178,183,361,5,48,JointPQPlayer
11504,JointPQPlayer,252,247,499,47,16,Player A
11505,JointPQPlayer,260,260,520,50,10,Tie
11506,JointPQPlayer,269,269,538,56,6,Tie
11507,JointPQPlayer,186,186,372,10,46,Tie
11508,JointPQPlayer,162,167,329,3,58,JointPQPlayer
11509,JointPQPlayer,267,267,534,55,7,Tie
11510,JointPQPlayer,275,270,545,57,4,Player A
11511,JointPQPlayer,261,266,527,45,6,JointPQPlayer
11512,JointPQPlayer,262,257,519,49,10,Player A
11513,JointPQPlayer,262,262,524,48,8,Tie
11514,JointPQPlayer,257,257,514,41,9,Tie
11515,JointPQPlayer,238,238,476,39,21,Tie
11516,JointPQPlayer,265,265,530,48,6,Tie
11517,JointPQPlayer,259,259,518,45,9,Tie
11518,JointPQPlayer,265,265,530,54,8,Tie
11519,JointPQPlayer,260,260,520,50,10,Tie
11520,JointPQPlayer,248,248,496,47,17,Tie
11521,JointPQPlayer,178,183,361,8,49,JointPQPlayer
11522,JointPQPlayer,261,261,522,49,9,Tie
11523,JointPQPlayer,253,253,506,48,14,Tie
11524,JointPQPlayer,255,250,505,50,15,Player A
11525,JointPQPlayer,258,258,516,43,9,Tie
11526,JointPQPlayer,267,267,534,61,9,Tie
11527,JointPQPlayer,211,211,422,21,33,Tie
11528,JointPQPlayer,263,263,526,47,7,Tie
11529,JointPQPlayer,185,185,370,8,46,Tie
11530,JointPQPlayer,249,254,503,45,14,JointPQPlayer
11531,JointPQPlayer,247,242,489,40,17,Player A
11532,JointPQPlayer,248,253,501,46,15,JointPQPlayer
11533,JointPQPlayer,246,241,487,38,17,Player A
11534,JointPQPlayer,253,253,506,45,13,Tie
11535,JointPQPlayer,256,256,512,42,10,Tie
11536,JointPQPlayer,264,264,528,43,5,Tie
11537,JointPQPlayer,260,260,520,56,12,Tie
11538,JointPQPlayer,260,260,520,50,10,Tie
11539,JointPQPlayer,260,260,520,53,11,Tie
11540,JointPQPlayer,224,224,448,26,26,Tie
11541,JointPQPlayer,253,258,511,41,10,JointPQPlayer
11542,JointPQPlayer,255,255,510,49,13,Tie
11543,JointPQPlayer,261,256,517,50,11,Player A
11544,JointPQPlayer,262,262,524,42,6,Tie
11545,JointPQPlayer,185,185,370,8,46,Tie
11546,JointPQPlayer,237,242,479,39,20,JointPQPlayer
11547,JointPQPlayer,239,234,473,36,21,Player A
11548,JointPQPlayer,171,176,347,9,54,JointPQPlayer
11549,JointPQPlayer,260,255,515,48,11,Player A
11550,JointPQPlayer,250,250,500,48,16,Tie
11551,JointPQPlayer,264,264,528,55,9,Tie
11552,JointPQPlayer,232,237,469,29,20,JointPQPlayer
11553,JointPQPlayer,185,185,370,14,48,Tie
11554,JointPQPlayer,179,179,358,5,49,Tie
11555,JointPQPlayer,273,268,541,50,3,Player A
11556,JointPQPlayer,271,271,542,57,5,Tie
11557,JointPQPlayer,252,252,504,49,15,Tie
11558,JointPQPlayer,248,253,501,46,15,JointPQPlayer
11559,JointPQPlayer,257,252,509,51,14,Player A
11560,JointPQPlayer,268,268,536,54,6,Tie
11561,JointPQPlayer,262,267,529,50,7,JointPQPlayer
11562,JointPQPlayer,260,255,515,45,10,Player A
11563,JointPQPlayer,262,262,524,48,8,Tie
11564,JointPQPlayer,212,212,424,32,36,Tie
11565,JointPQPlayer,262,262,524,48,8,Tie
11566,JointPQPlayer,194,199,393,13,40,JointPQPlayer
11567,JointPQPlayer,268,263,531,52,7,Player A
11568,JointPQPlayer,257,257,514,47,11,Tie
11569,JointPQPlayer,226,226,452,39,29,Tie
11570,JointPQPlayer,251,251,502,50,16,Tie
11571,JointPQPlayer,190,190,380,18,46,Tie
11572,JointPQPlayer,265,270,535,53,6,JointPQPlayer
11573,JointPQPlayer,263,258,521,51,10,Player A
11574,JointPQPlayer,250,250,500,42,14,Tie
11575,JointPQPlayer,201,206,407,18,37,JointPQPlayer
11576,JointPQPlayer,206,201,407,15,36,Player A
11577,JointPQPlayer,237,237,474,34,20,Tie
11578,JointPQPlayer,251,251,502,47,15,Tie
11579,JointPQPlayer,259,264,523,56,11,JointPQPlayer
11580,JointPQPlayer,242,237,479,45,22,Player A
11581,JointPQPlayer,191,191,382,14,44,Tie
11582,JointPQPlayer,253,258,511,47,12,JointPQPlayer
11583,JointPQPlayer,265,260,525,49,8,Player A
11584,JointPQPlayer,252,252,504,43,13,Tie
11585,JointPQPlayer,273,273,546,58,4,Tie
11586,JointPQPlayer,265,265,530,51,7,Tie
11587,JointPQPlayer,235,235,470,39,23,Tie
11588,JointPQPlayer,237,237,474,31,19,Tie
11589,JointPQPlayer,229,229,458,39,27,Tie
11590,JointPQPlayer,250,250,500,39,13,Tie
11591,JointPQPlayer,272,272,544,56,4,Tie
11592,JointPQPlayer,260,260,520,50,10,Tie
11593,JointPQPlayer,226,226,452,36,28,Tie
11594,JointPQPlayer,174,174,348,4,52,Tie
11595,JointPQPlayer,273,273,546,58,4,Tie
11596,JointPQPlayer,257,262,519,46,9,JointPQPlayer
11597,JointPQPlayer,263,263,526,53,9,Tie
11598,JointPQPlayer,183,183,366,13,49,Tie
11599,JointPQPlayer,253,253,506,48,14,Tie
11600,JointPQPlayer,186,186,372,7,45,Tie
11601,JointPQPlayer,271,266,537,55,6,Player A
11602,JointPQPlayer,203,208,411,19,36,JointPQPlayer
11603,JointPQPlayer,251,246,497,42,15,Player A
11604,JointPQPlayer,266,271,537,58,7,JointPQPlayer
11605,JointPQPlayer,254,249,503,45,14,Player A
11606,JointPQPlayer,248,248,496,47,17,Tie
11607,JointPQPlayer,266,266,532,50,6,Tie
11608,JointPQPlayer,166,171,337,8,57,JointPQPlayer
11609,JointPQPlayer,230,230,460,29,23,Tie
11610,JointPQPlayer,174,174,348,4,52,Tie
11611,JointPQPlayer,266,261,527,57,10,Player A
11612,JointPQPlayer,234,239,473,42,23,JointPQPlayer
11613,JointPQPlayer,216,216,432,37,35,Tie
11614,JointPQPlayer,259,254,513,46,11,Player A
11615,JointPQPlayer,211,211,422,27,35,Tie
11616,JointPQPlayer,268,273,541,62,7,JointPQPlayer
11617,JointPQPlayer,242,242,484,38,18,Tie
11618,JointPQPlayer,242,242,484,41,19,Tie
11619,JointPQPlayer,260,255,515,48,11,Player A
11620,JointPQPlayer,250,255,505,41,12,JointPQPlayer
11621,JointPQPlayer,233,228,461,36,25,Player A
11622,JointPQPlayer,250,250,500,36,12,Tie
11623,JointPQPlayer,217,217,434,27,31,Tie
11624,JointPQPlayer,263,263,526,56,10,Tie
11625,JointPQPlayer,262,267,529,62,11,JointPQPlayer
11626,JointPQPlayer,275,270,545,54,3,Player A
11627,JointPQPlayer,161,161,322,2,60,Tie
11628,JointPQPlayer,269,269,538,56,6,Tie
11629,JointPQPlayer,242,247,489,46,19,JointPQPlayer
11630,JointPQPlayer,260,260,520,53,11,Tie
11631,JointPQPlayer,166,166,332,12,60,Tie
11632,JointPQPlayer,170,165,335,3,56,Player A
11633,JointPQPlayer,263,263,526,50,8,Tie
11634,JointPQPlayer,261,266,527,54,9,JointPQPlayer
11635,JointPQPlayer,247,242,489,43,18,Player A
11636,JointPQPlayer,184,184,368,12,48,Tie
11637,JointPQPlayer,256,256,512,42,10,Tie
11638,JointPQPlayer,267,272,539,51,4,JointPQPlayer
11639,JointPQPlayer,261,256,517,50,11,Player A
11640,JointPQPlayer,240,240,480,40,20,Tie
11641,JointPQPlayer,206,206,412,20,36,Tie
11642,JointPQPlayer,240,240,480,34,18,Tie
11643,JointPQPlayer,270,270,540,58,6,Tie
11644,JointPQPlayer,169,169,338,9,57,Tie
11645,JointPQPlayer,261,266,527,57,10,JointPQPlayer
11646,JointPQPlayer,157,157,314,3,63,Tie
11647,JointPQPlayer,267,262,529,44,5,Player A
11648,JointPQPlayer,245,245,490,41,17,Tie
11649,JointPQPlayer,258,258,516,46,10,Tie
11650,JointPQPlayer,231,236,467,42,25,JointPQPlayer
11651,JointPQPlayer,181,181,362,6,48,Tie
11652,JointPQPlayer,251,251,502,44,14,Tie
11653,JointPQPlayer,194,194,388,14,42,Tie
11654,JointPQPlayer,269,264,533,57,8,Player A
11655,JointPQPlayer,241,246,487,38,17,JointPQPlayer
11656,JointPQPlayer,245,240,485,42,19,Player A
11657,JointPQPlayer,254,259,513,52,13,JointPQPlayer
11658,JointPQPlayer,168,168,336,4,56,Tie
11659,JointPQPlayer,236,231,467,30,21,Player A
11660,JointPQPlayer,263,268,531,52,7,JointPQPlayer
11661,JointPQPlayer,207,202,409,20,37,Player A
11662,JointPQPlayer,266,266,532,47,5,Tie
11663,JointPQPlayer,224,224,448,32,28,Tie
11664,JointPQPlayer,272,277,549,61,4,JointPQPlayer
11665,JointPQPlayer,244,244,488,36,16,Tie
11666,JointPQPlayer,230,225,455,30,25,Player A
11667,JointPQPlayer,211,216,427,26,33,JointPQPlayer
11668,JointPQPlayer,218,213,431,24,31,Player A
11669,JointPQPlayer,255,255,510,43,11,Tie
11670,JointPQPlayer,252,257,509,39,10,JointPQPlayer
11671,JointPQPlayer,267,262,529,56,9,Player A
11672,JointPQPlayer,232,237,469,47,26,JointPQPlayer
11673,JointPQPlayer,257,252,509,51,14,Player A
11674,JointPQPlayer,210,210,420,22,34,Tie
11675,JointPQPlayer,212,217,429,25,32,JointPQPlayer
11676,JointPQPlayer,217,212,429,28,33,Player A
11677,JointPQPlayer,252,252,504,40,12,Tie
11678,JointPQPlayer,195,195,390,10,40,Tie
11679,JointPQPlayer,265,265,530,45,5,Tie
11680,JointPQPlayer,256,256,512,48,12,Tie
11681,JointPQPlayer,273,273,546,58,4,Tie
11682,JointPQPlayer,184,189,373,14,47,JointPQPlayer
11683,JointPQPlayer,246,241,487,35,16,Player A
11684,JointPQPlayer,167,172,339,10,57,JointPQPlayer
11685,JointPQPlayer,172,172,344,9,55,Tie
11686,JointPQPlayer,237,232,469,35,22,Player A
11687,JointPQPlayer,256,256,512,48,12,Tie
11688,JointPQPlayer,264,264,528,49,7,Tie
11689,JointPQPlayer,272,272,544,56,4,Tie
11690,JointPQPlayer,250,250,500,36,12,Tie
11691,JointPQPlayer,257,257,514,50,12,Tie
11692,JointPQPlayer,181,186,367,8,47,JointPQPlayer
11693,JointPQPlayer,181,181,362,9,49,Tie
11694,JointPQPlayer,162,162,324,7,61,Tie
11695,JointPQPlayer,187,187,374,15,47,Tie
11696,JointPQPlayer,257,252,509,42,11,Player A
11697,JointPQPlayer,257,257,514,47,11,Tie
11698,JointPQPlayer,239,244,483,37,18,JointPQPlayer
11699,JointPQPlayer,241,236,477,37,20,Player A
11700,JointPQPlayer,257,257,514,56,14,Tie
11701,JointPQPlayer,266,266,532,50,6,Tie
11702,JointPQPlayer,268,273,541,59,6,JointPQPlayer
11703,JointPQPlayer,204,204,408,22,38,Tie
11704,JointPQPlayer,211,206,417,22,35,Player A
11705,JointPQPlayer,244,249,493,35,14,JointPQPlayer
11706,JointPQPlayer,264,259,523,44,7,Player A
11707,JointPQPlayer,222,222,444,31,29,Tie
11708,JointPQPlayer,246,246,492,43,17,Tie
11709,JointPQPlayer,171,176,347,9,54,JointPQPlayer
11710,JointPQPlayer,180,180,360,10,50,Tie
11711,JointPQPlayer,270,265,535,53,6,Player A
11712,JointPQPlayer,276,276,552,64,4,Tie
11713,JointPQPlayer,261,261,522,49,9,Tie
11714,JointPQPlayer,181,186,367,14,49,JointPQPlayer
11715,JointPQPlayer,254,249,503,36,11,Player A
11716,JointPQPlayer,254,259,513,49,12,JointPQPlayer
11717,JointPQPlayer,246,246,492,52,20,Tie
11718,JointPQPlayer,237,237,474,34,20,Tie
11719,JointPQPlayer,246,241,487,41,18,Player A
11720,JointPQPlayer,247,247,494,42,16,Tie
11721,JointPQPlayer,244,244,488,39,17,Tie
11722,JointPQPlayer,241,241,482,45,21,Tie
11723,JointPQPlayer,253,253,506,45,13,Tie
11724,JointPQPlayer,198,203,401,15,38,JointPQPlayer
11725,JointPQPlayer,259,254,513,46,11,Player A
11726,JointPQPlayer,186,186,372,16,48,Tie
11727,JointPQPlayer,191,196,387,4,39,JointPQPlayer
11728,JointPQPlayer,248,243,491,42,17,Player A
11729,JointPQPlayer,254,254,508,50,14,Tie
11730,JointPQPlayer,222,227,449,27,26,JointPQPlayer
11731,JointPQPlayer,268,263,531,55,8,Player A
11732,JointPQPlayer,258,258,516,43,9,Tie
11733,JointPQPlayer,243,248,491,45,18,JointPQPlayer
11734,JointPQPlayer,198,193,391,17,42,Player A
11735,JointPQPlayer,226,226,452,36,28,Tie
11736,JointPQPlayer,170,175,345,7,54,JointPQPlayer
11737,JointPQPlayer,228,223,451,32,27,Player A
11738,JointPQPlayer,252,252,504,40,12,Tie
11739,JointPQPlayer,229,234,463,32,23,JointPQPlayer
11740,JointPQPlayer,251,246,497,42,15,Player A
11741,JointPQPlayer,204,204,408,16,36,Tie
11742,JointPQPlayer,235,240,475,41,22,JointPQPlayer
11743,JointPQPlayer,259,254,513,40,9,Player A
11744,JointPQPlayer,252,252,504,46,14,Tie
11745,JointPQPlayer,267,267,534,55,7,Tie
11746,JointPQPlayer,257,257,514,44,10,Tie
11747,JointPQPlayer,256,256,512,48,12,Tie
11748,JointPQPlayer,229,229,458,33,25,Tie
11749,JointPQPlayer,177,177,354,10,52,Tie
11750,JointPQPlayer,234,234,468,43,25,Tie
11751,JointPQPlayer,177,177,354,10,52,Tie
11752,JointPQPlayer,263,263,526,50,8,Tie
11753,JointPQPlayer,250,250,500,48,16,Tie
11754,JointPQPlayer,267,267,534,58,8,Tie
11755,JointPQPlayer,266,266,532,50,6,Tie
11756,JointPQPlayer,213,218,431,27,32,JointPQPlayer
11757,JointPQPlayer,217,212,429,22,31,Player A
11758,JointPQPlayer,271,271,542,60,6,Tie
11759,JointPQPlayer,247,247,494,45,17,Tie
11760,JointPQPlayer,255,255,510,46,12,Tie
11761,JointPQPlayer,243,243,486,43,19,Tie
11762,JointPQPlayer,266,271,537,55,6,JointPQPlayer
11763,JointPQPlayer,231,226,457,32,25,Player A
11764,JointPQPlayer,254,259,513,46,11,JointPQPlayer
11765,JointPQPlayer,210,205,415,20,35,Player A
11766,JointPQPlayer,264,269,533,51,6,JointPQPlayer
11767,JointPQPlayer,241,236,477,37,20,Player A
11768,JointPQPlayer,258,263,521,54,11,JointPQPlayer
11769,JointPQPlayer,271,266,537,55,6,Player A
11770,JointPQPlayer,254,259,513,43,10,JointPQPlayer
11771,JointPQPlayer,181,181,362,9,49,Tie
11772,JointPQPlayer,261,256,517,47,10,Player A
11773,JointPQPlayer,253,253,506,42,12,Tie
11774,JointPQPlayer,212,212,424,29,35,Tie
11775,JointPQPlayer,237,237,474,43,23,Tie
11776,JointPQPlayer,251,256,507,46,13,JointPQPlayer
11777,JointPQPlayer,226,226,452,33,27,Tie
11778,JointPQPlayer,273,268,541,50,3,Player A
11779,JointPQPlayer,198,198,396,19,41,Tie
11780,JointPQPlayer,221,221,442,26,28,Tie
11781,JointPQPlayer,274,274,548,66,6,Tie
11782,JointPQPlayer,263,263,526,50,8,Tie
11783,JointPQPlayer,265,265,530,51,7,Tie
11784,JointPQPlayer,259,259,518,48,10,Tie
11785,JointPQPlayer,229,229,458,36,26,Tie
11786,JointPQPlayer,264,264,528,49,7,Tie
11787,JointPQPlayer,251,251,502,44,14,Tie
11788,JointPQPlayer,155,155,310,2,64,Tie
11789,JointPQPlayer,246,246,492,40,16,Tie
11790,JointPQPlayer,248,248,496,38,14,Tie
11791,JointPQPlayer,185,190,375,19,48,JointPQPlayer
11792,JointPQPlayer,261,256,517,47,10,Player A
11793,JointPQPlayer,262,262,524,42,6,Tie
11794,JointPQPlayer,181,186,367,20,51,JointPQPlayer
11795,JointPQPlayer,255,250,505,44,13,Player A
11796,JointPQPlayer,162,162,324,7,61,Tie
11797,JointPQPlayer,256,256,512,54,14,Tie
11798,JointPQPlayer,264,264,528,43,5,Tie
11799,JointPQPlayer,161,166,327,4,59,JointPQPlayer
11800,JointPQPlayer,207,202,409,23,38,Player A
11801,JointPQPlayer,247,252,499,47,16,JointPQPlayer
11802,JointPQPlayer,265,265,530,48,6,Tie
11803,JointPQPlayer,269,264,533,51,6,Player A
11804,JointPQPlayer,258,258,516,46,10,Tie
11805,JointPQPlayer,268,273,541,53,4,JointPQPlayer
11806,JointPQPlayer,246,246,492,43,17,Tie
11807,JointPQPlayer,235,230,465,31,22,Player A
11808,JointPQPlayer,200,205,405,25,40,JointPQPlayer
11809,JointPQPlayer,250,250,500,51,17,Tie
11810,JointPQPlayer,243,238,481,38,19,Player A
11811,JointPQPlayer,263,263,526,44,6,Tie
11812,JointPQPlayer,237,242,479,45,22,JointPQPlayer
11813,JointPQPlayer,265,265,530,54,8,Tie
11814,JointPQPlayer,217,212,429,25,32,Player A
11815,JointPQPlayer,253,253,506,39,11,Tie
11816,JointPQPlayer,186,191,377,15,46,JointPQPlayer
11817,JointPQPlayer,173,173,346,11,55,Tie
11818,JointPQPlayer,257,252,509,51,14,Player A
11819,JointPQPlayer,151,156,307,2,65,JointPQPlayer
11820,JointPQPlayer,239,234,473,39,22,Player A
11821,JointPQPlayer,266,266,532,53,7,Tie
11822,JointPQPlayer,213,213,426,31,35,Tie
11823,JointPQPlayer,228,233,461,33,24,JointPQPlayer
11824,JointPQPlayer,251,246,497,51,18,Player A
11825,JointPQPlayer,197,197,394,8,38,Tie
11826,JointPQPlayer,174,179,353,6,51,JointPQPlayer
11827,JointPQPlayer,218,218,436,35,33,Tie
11828,JointPQPlayer,178,178,356,9,51,Tie
11829,JointPQPlayer,270,265,535,56,7,Player A
11830,JointPQPlayer,266,271,537,49,4,JointPQPlayer
11831,JointPQPlayer,262,257,519,49,10,Player A
11832,JointPQPlayer,239,239,478,38,20,Tie
11833,JointPQPlayer,243,243,486,43,19,Tie
11834,JointPQPlayer,247,247,494,36,14,Tie
11835,JointPQPlayer,265,270,535,56,7,JointPQPlayer
11836,JointPQPlayer,225,220,445,35,30,Player A
11837,JointPQPlayer,160,165,325,5,60,JointPQPlayer
11838,JointPQPlayer,240,240,480,37,19,Tie
11839,JointPQPlayer,218,213,431,24,31,Player A
11840,JointPQPlayer,239,239,478,35,19,Tie
11841,JointPQPlayer,277,277,554,60,2,Tie
11842,JointPQPlayer,266,271,537,49,4,JointPQPlayer
11843,JointPQPlayer,175,175,350,3,51,Tie
11844,JointPQPlayer,268,263,531,49,6,Player A
11845,JointPQPlayer,239,239,478,41,21,Tie
11846,JointPQPlayer,177,182,359,6,49,JointPQPlayer
11847,JointPQPlayer,215,210,425,18,31,Player A
11848,JointPQPlayer,208,213,421,32,37,JointPQPlayer
11849,JointPQPlayer,255,250,505,47,14,Player A
11850,JointPQPlayer,187,192,379,17,46,JointPQPlayer
11851,JointPQPlayer,219,219,438,28,30,Tie
11852,JointPQPlayer,274,269,543,52,3,Player A
11853,JointPQPlayer,267,267,534,46,4,Tie
11854,JointPQPlayer,211,211,422,27,35,Tie
11855,JointPQPlayer,269,269,538,53,5,Tie
11856,JointPQPlayer,270,270,540,52,4,Tie
11857,JointPQPlayer,228,233,461,33,24,JointPQPlayer
11858,JointPQPlayer,170,170,340,5,55,Tie
11859,JointPQPlayer,177,177,354,7,51,Tie
11860,JointPQPlayer,189,184,373,11,46,Player A
11861,JointPQPlayer,210,215,425,27,34,JointPQPlayer
11862,JointPQPlayer,232,232,464,36,24,Tie
11863,JointPQPlayer,240,235,475,41,22,Player A
11864,JointPQPlayer,267,267,534,52,6,Tie
11865,JointPQPlayer,260,265,525,40,5,JointPQPlayer
11866,JointPQPlayer,206,201,407,24,39,Player A
11867,JointPQPlayer,248,248,496,44,16,Tie
11868,JointPQPlayer,261,261,522,46,8,Tie
11869,JointPQPlayer,258,258,516,43,9,Tie
11870,JointPQPlayer,260,260,520,50,10,Tie
11871,JointPQPlayer,184,189,373,14,47,JointPQPlayer
11872,JointPQPlayer,262,257,519,49,10,Player A
11873,JointPQPlayer,217,217,434,30,32,Tie
11874,JointPQPlayer,251,256,507,34,9,JointPQPlayer
11875,JointPQPlayer,268,263,531,49,6,Player A
11876,JointPQPlayer,172,172,344,6,54,Tie
11877,JointPQPlayer,234,234,468,31,21,Tie
11878,JointPQPlayer,244,244,488,42,18,Tie
11879,JointPQPlayer,236,241,477,37,20,JointPQPlayer
11880,JointPQPlayer,270,265,535,59,8,Player A
11881,JointPQPlayer,236,236,472,38,22,Tie
11882,JointPQPlayer,177,182,359,9,50,JointPQPlayer
11883,JointPQPlayer,252,247,499,41,14,Player A
11884,JointPQPlayer,249,249,498,40,14,Tie
11885,JointPQPlayer,250,250,500,45,15,Tie
11886,JointPQPlayer,198,198,396,13,39,Tie
11887,JointPQPlayer,271,271,542,54,4,Tie
11888,JointPQPlayer,262,262,524,54,10,Tie
11889,JointPQPlayer,207,207,414,25,37,Tie
11890,JointPQPlayer,233,233,466,32,22,Tie
11891,JointPQPlayer,264,264,528,55,9,Tie
11892,JointPQPlayer,159,164,323,3,60,JointPQPlayer
11893,JointPQPlayer,174,174,348,7,53,Tie
11894,JointPQPlayer,246,241,487,47,20,Player A
11895,JointPQPlayer,202,202,404,18,38,Tie
11896,JointPQPlayer,262,262,524,51,9,Tie
11897,JointPQPlayer,266,266,532,53,7,Tie
11898,JointPQPlayer,254,254,508,38,10,Tie
11899,JointPQPlayer,183,183,366,16,50,Tie
11900,JointPQPlayer,263,263,526,53,9,Tie
11901,JointPQPlayer,243,243,486,43,19,Tie
11902,JointPQPlayer,237,237,474,40,22,Tie
11903,JointPQPlayer,256,261,517,44,9,JointPQPlayer
11904,JointPQPlayer,267,262,529,53,8,Player A
11905,JointPQPlayer,264,269,533,57,8,JointPQPlayer
11906,JointPQPlayer,256,251,507,49,14,Player A
11907,JointPQPlayer,229,229,458,39,27,Tie
11908,JointPQPlayer,273,273,546,64,6,Tie
11909,JointPQPlayer,253,258,511,38,9,JointPQPlayer
11910,JointPQPlayer,166,166,332,6,58,Tie
11911,JointPQPlayer,259,254,513,43,10,Player A
11912,JointPQPlayer,219,219,438,28,30,Tie
11913,JointPQPlayer,166,171,337,5,56,JointPQPlayer
11914,JointPQPlayer,235,235,470,33,21,Tie
11915,JointPQPlayer,264,264,528,49,7,Tie
11916,JointPQPlayer,270,265,535,53,6,Player A
11917,JointPQPlayer,253,253,506,45,13,Tie
11918,JointPQPlayer,247,247,494,42,16,Tie
11919,JointPQPlayer,182,182,364,8,48,Tie
11920,JointPQPlayer,232,232,464,30,22,Tie
11921,JointPQPlayer,228,228,456,34,26,Tie
11922,JointPQPlayer,227,227,454,32,26,Tie
11923,JointPQPlayer,217,222,439,23,28,JointPQPlayer
11924,JointPQPlayer,178,178,356,9,51,Tie
11925,JointPQPlayer,247,247,494,42,16,Tie
11926,JointPQPlayer,258,253,511,41,10,Player A
11927,JointPQPlayer,253,258,511,41,10,JointPQPlayer
11928,JointPQPlayer,272,267,539,63,8,Player A
11929,JointPQPlayer,276,276,552,61,3,Tie
11930,JointPQPlayer,171,171,342,4,54,Tie
11931,JointPQPlayer,264,264,528,55,9,Tie
11932,JointPQPlayer,260,260,520,53,11,Tie
11933,JointPQPlayer,222,222,444,28,28,Tie
11934,JointPQPlayer,264,269,533,60,9,JointPQPlayer
11935,JointPQPlayer,227,222,449,30,27,Player A
11936,JointPQPlayer,266,266,532,53,7,Tie
11937,JointPQPlayer,260,260,520,47,9,Tie
11938,JointPQPlayer,198,203,401,15,38,JointPQPlayer
11939,JointPQPlayer,208,208,416,27,37,Tie
11940,JointPQPlayer,169,169,338,6,56,Tie
11941,JointPQPlayer,244,239,483,28,15,Player A
11942,JointPQPlayer,180,185,365,9,48,JointPQPlayer
11943,JointPQPlayer,160,160,320,6,62,Tie
11944,JointPQPlayer,251,251,502,44,14,Tie
11945,JointPQPlayer,257,257,514,53,13,Tie
11946,JointPQPlayer,230,225,455,36,27,Player A
11947,JointPQPlayer,234,234,468,31,21,Tie
11948,JointPQPlayer,264,264,528,55,9,Tie
11949,JointPQPlayer,255,260,515,42,9,JointPQPlayer
11950,JointPQPlayer,237,232,469,41,24,Player A
11951,JointPQPlayer,260,260,520,56,12,Tie
11952,JointPQPlayer,242,242,484,35,17,Tie
11953,JointPQPlayer,253,258,511,47,12,JointPQPlayer
11954,JointPQPlayer,172,172,344,6,54,Tie
11955,JointPQPlayer,197,192,389,12,41,Player A
11956,JointPQPlayer,265,265,530,48,6,Tie
11957,JointPQPlayer,257,257,514,50,12,Tie
11958,JointPQPlayer,262,262,524,54,10,Tie
11959,JointPQPlayer,267,267,534,55,7,Tie
11960,JointPQPlayer,270,270,540,52,4,Tie
11961,JointPQPlayer,251,256,507,40,11,JointPQPlayer
11962,JointPQPlayer,277,272,549,58,3,Player A
11963,JointPQPlayer,181,186,367,11,48,JointPQPlayer
11964,JointPQPlayer,271,266,537,58,7,Player A
11965,JointPQPlayer,263,263,526,53,9,Tie
11966,JointPQPlayer,264,264,528,52,8,Tie
11967,JointPQPlayer,174,174,348,10,54,Tie
11968,JointPQPlayer,269,274,543,58,5,JointPQPlayer
11969,JointPQPlayer,223,218,441,28,29,Player A
11970,JointPQPlayer,266,271,537,55,6,JointPQPlayer
11971,JointPQPlayer,267,262,529,53,8,Player A
11972,JointPQPlayer,255,260,515,48,11,JointPQPlayer
11973,JointPQPlayer,258,253,511,53,14,Player A
11974,JointPQPlayer,227,227,454,35,27,Tie
11975,JointPQPlayer,252,252,504,40,12,Tie
11976,JointPQPlayer,198,198,396,25,43,Tie
11977,JointPQPlayer,261,261,522,52,10,Tie
11978,JointPQPlayer,263,263,526,56,10,Tie
11979,JointPQPlayer,262,267,529,53,8,JointPQPlayer
11980,JointPQPlayer,273,268,541,53,4,Player A
11981,JointPQPlayer,260,260,520,50,10,Tie
11982,JointPQPlayer,267,267,534,55,7,Tie
11983,JointPQPlayer,241,241,482,42,20,Tie
11984,JointPQPlayer,237,237,474,43,23,Tie
11985,JointPQPlayer,269,269,538,50,4,Tie
11986,JointPQPlayer,264,264,528,61,11,Tie
11987,JointPQPlayer,198,198,396,19,41,Tie
11988,JointPQPlayer,242,242,484,41,19,Tie
11989,JointPQPlayer,237,237,474,43,23,Tie
11990,JointPQPlayer,251,251,502,44,14,Tie
11991,JointPQPlayer,261,261,522,52,10,Tie
11992,JointPQPlayer,255,255,510,46,12,Tie
11993,JointPQPlayer,259,264,523,44,7,JointPQPlayer
11994,JointPQPlayer,267,262,529,50,7,Player A
11995,JointPQPlayer,260,260,520,47,9,Tie
11996,JointPQPlayer,254,254,508,41,11,Tie
11997,JointPQPlayer,238,238,476,45,23,Tie
11998,JointPQPlayer,160,165,325,5,60,JointPQPlayer
11999,JointPQPlayer,237,232,469,38,23,Player A
12000,JointPQPlayer,253,253,506,48,14,Tie
12001,JointPQPlayer,264,264,528,55,9,Tie
12002,JointPQPlayer,215,215,430,23,31,Tie
12003,JointPQPlayer,259,259,518,57,13,Tie
12004,JointPQPlayer,262,267,529,53,8,JointPQPlayer
12005,JointPQPlayer,175,175,350,6,52,Tie
12006,JointPQPlayer,241,241,482,42,20,Tie
12007,JointPQPlayer,275,275,550,56,2,Tie
12008,JointPQPlayer,182,177,359,12,51,Player A
12009,JointPQPlayer,261,261,522,52,10,Tie
12010,JointPQPlayer,266,266,532,56,8,Tie
12011,JointPQPlayer,264,264,528,52,8,Tie
12012,JointPQPlayer,246,251,497,42,15,JointPQPlayer
12013,JointPQPlayer,263,258,521,48,9,Player A
12014,JointPQPlayer,196,196,392,15,41,Tie
12015,JointPQPlayer,242,242,484,38,18,Tie
12016,JointPQPlayer,231,231,462,31,23,Tie
12017,JointPQPlayer,187,192,379,14,45,JointPQPlayer
12018,JointPQPlayer,260,255,515,48,11,Player A
12019,JointPQPlayer,260,260,520,44,8,Tie
12020,JointPQPlayer,254,254,508,41,11,Tie
12021,JointPQPlayer,264,269,533,51,6,JointPQPlayer
12022,JointPQPlayer,252,247,499,47,16,Player A
12023,JointPQPlayer,266,266,532,50,6,Tie
12024,JointPQPlayer,218,218,436,26,30,Tie
12025,JointPQPlayer,206,206,412,20,36,Tie
12026,JointPQPlayer,206,206,412,23,37,Tie
12027,JointPQPlayer,256,256,512,42,10,Tie
12028,JointPQPlayer,245,250,495,37,14,JointPQPlayer
12029,JointPQPlayer,260,260,520,47,9,Tie
12030,JointPQPlayer,252,247,499,44,15,Player A
12031,JointPQPlayer,186,191,377,12,45,JointPQPlayer
12032,JointPQPlayer,244,239,483,37,18,Player A
12033,JointPQPlayer,258,263,521,51,10,JointPQPlayer
12034,JointPQPlayer,265,265,530,48,6,Tie
12035,JointPQPlayer,251,246,497,39,14,Player A
12036,JointPQPlayer,246,251,497,45,16,JointPQPlayer
12037,JointPQPlayer,244,239,483,43,20,Player A
12038,JointPQPlayer,186,186,372,13,47,Tie
12039,JointPQPlayer,211,211,422,21,33,Tie
12040,JointPQPlayer,249,254,503,39,12,JointPQPlayer
12041,JointPQPlayer,265,265,530,51,7,Tie
12042,JointPQPlayer,248,243,491,42,17,Player A
12043,JointPQPlayer,177,177,354,13,53,Tie
12044,JointPQPlayer,168,173,341,9,56,JointPQPlayer
12045,JointPQPlayer,261,261,522,49,9,Tie
12046,JointPQPlayer,207,202,409,23,38,Player A
12047,JointPQPlayer,251,256,507,52,15,JointPQPlayer
12048,JointPQPlayer,248,243,491,39,16,Player A
12049,JointPQPlayer,270,270,540,49,3,Tie
12050,JointPQPlayer,172,177,349,17,56,JointPQPlayer
12051,JointPQPlayer,262,257,519,52,11,Player A
12052,JointPQPlayer,270,275,545,63,6,JointPQPlayer
12053,JointPQPlayer,257,257,514,47,11,Tie
12054,JointPQPlayer,259,254,513,43,10,Player A
12055,JointPQPlayer,260,260,520,50,10,Tie
12056,JointPQPlayer,268,268,536,54,6,Tie
12057,JointPQPlayer,160,165,325,5,60,JointPQPlayer
12058,JointPQPlayer,189,189,378,13,45,Tie
12059,JointPQPlayer,237,232,469,32,21,Player A
12060,JointPQPlayer,195,200,395,21,42,JointPQPlayer
12061,JointPQPlayer,182,177,359,12,51,Player A
12062,JointPQPlayer,253,253,506,48,14,Tie
12063,JointPQPlayer,255,260,515,42,9,JointPQPlayer
12064,JointPQPlayer,256,251,507,43,12,Player A
12065,JointPQPlayer,251,251,502,44,14,Tie
12066,JointPQPlayer,261,261,522,49,9,Tie
12067,JointPQPlayer,258,258,516,49,11,Tie
12068,JointPQPlayer,193,193,386,18,44,Tie
12069,JointPQPlayer,258,258,516,49,11,Tie
12070,JointPQPlayer,244,244,488,33,15,Tie
12071,JointPQPlayer,217,222,439,35,32,JointPQPlayer
12072,JointPQPlayer,264,259,523,56,11,Player A
12073,JointPQPlayer,266,266,532,53,7,Tie
12074,JointPQPlayer,248,253,501,40,13,JointPQPlayer
12075,JointPQPlayer,252,247,499,47,16,Player A
12076,JointPQPlayer,252,257,509,45,12,JointPQPlayer
12077,JointPQPlayer,264,264,528,52,8,Tie
12078,JointPQPlayer,244,244,488,42,18,Tie
12079,JointPQPlayer,255,255,510,49,13,Tie
12080,JointPQPlayer,179,174,353,3,50,Player A
12081,JointPQPlayer,173,178,351,10,53,JointPQPlayer
12082,JointPQPlayer,269,264,533,54,7,Player A
12083,JointPQPlayer,263,263,526,50,8,Tie
12084,JointPQPlayer,250,255,505,38,11,JointPQPlayer
12085,JointPQPlayer,254,254,508,44,12,Tie
12086,JointPQPlayer,256,251,507,49,14,Player A
12087,JointPQPlayer,254,254,508,47,13,Tie
12088,JointPQPlayer,266,271,537,58,7,JointPQPlayer
12089,JointPQPlayer,243,243,486,43,19,Tie
12090,JointPQPlayer,191,191,382,17,45,Tie
12091,JointPQPlayer,259,254,513,46,11,Player A
12092,JointPQPlayer,191,196,387,16,43,JointPQPlayer
12093,JointPQPlayer,249,249,498,43,15,Tie
12094,JointPQPlayer,244,239,483,34,17,Player A
12095,JointPQPlayer,159,164,323,6,61,JointPQPlayer
12096,JointPQPlayer,209,204,413,24,37,Player A
12097,JointPQPlayer,266,271,537,58,7,JointPQPlayer
12098,JointPQPlayer,228,223,451,32,27,Player A
12099,JointPQPlayer,219,219,438,28,30,Tie
12100,JointPQPlayer,244,244,488,48,20,Tie
12101,JointPQPlayer,257,262,519,46,9,JointPQPlayer
12102,JointPQPlayer,230,225,455,39,28,Player A
12103,JointPQPlayer,237,242,479,33,18,JointPQPlayer
12104,JointPQPlayer,213,213,426,22,32,Tie
12105,JointPQPlayer,266,261,527,45,6,Player A
12106,JointPQPlayer,185,185,370,8,46,Tie
12107,JointPQPlayer,252,252,504,55,17,Tie
12108,JointPQPlayer,204,204,408,22,38,Tie
12109,JointPQPlayer,167,172,339,10,57,JointPQPlayer
12110,JointPQPlayer,255,250,505,44,13,Player A
12111,JointPQPlayer,246,246,492,43,17,Tie
12112,JointPQPlayer,250,255,505,56,17,JointPQPlayer
12113,JointPQPlayer,242,237,479,39,20,Player A
12114,JointPQPlayer,258,258,516,46,10,Tie
12115,JointPQPlayer,230,230,460,38,26,Tie
12116,JointPQPlayer,247,247,494,51,19,Tie
12117,JointPQPlayer,238,243,481,41,20,JointPQPlayer
12118,JointPQPlayer,254,249,503,48,15,Player A
12119,JointPQPlayer,219,219,438,34,32,Tie
12120,JointPQPlayer,250,255,505,47,14,JointPQPlayer
12121,JointPQPlayer,179,179,358,5,49,Tie
12122,JointPQPlayer,230,225,455,33,26,Player A
12123,JointPQPlayer,174,174,348,10,54,Tie
12124,JointPQPlayer,262,262,524,45,7,Tie
12125,JointPQPlayer,235,240,475,38,21,JointPQPlayer
12126,JointPQPlayer,194,194,388,11,41,Tie
12127,JointPQPlayer,258,258,516,49,11,Tie
12128,JointPQPlayer,266,261,527,54,9,Player A
12129,JointPQPlayer,173,178,351,10,53,JointPQPlayer
12130,JointPQPlayer,259,254,513,49,12,Player A
12131,JointPQPlayer,258,258,516,49,11,Tie
12132,JointPQPlayer,270,270,540,58,6,Tie
12133,JointPQPlayer,261,261,522,49,9,Tie
12134,JointPQPlayer,267,267,534,52,6,Tie
12135,JointPQPlayer,275,275,550,56,2,Tie
12136,JointPQPlayer,228,233,461,30,23,JointPQPlayer
12137,JointPQPlayer,206,206,412,26,38,Tie
12138,JointPQPlayer,266,261,527,48,7,Player A
12139,JointPQPlayer,185,190,375,10,45,JointPQPlayer
12140,JointPQPlayer,243,238,481,38,19,Player A
12141,JointPQPlayer,204,209,413,24,37,JointPQPlayer
12142,JointPQPlayer,271,266,537,58,7,Player A
12143,JointPQPlayer,175,180,355,8,51,JointPQPlayer
12144,JointPQPlayer,261,256,517,44,9,Player A
12145,JointPQPlayer,169,169,338,15,59,Tie
12146,JointPQPlayer,242,242,484,38,18,Tie
12147,JointPQPlayer,224,224,448,35,29,Tie
12148,JointPQPlayer,264,264,528,49,7,Tie
12149,JointPQPlayer,265,270,535,53,6,JointPQPlayer
12150,JointPQPlayer,272,267,539,54,5,Player A
12151,JointPQPlayer,239,239,478,41,21,Tie
12152,JointPQPlayer,264,264,528,52,8,Tie
12153,JointPQPlayer,228,228,456,40,28,Tie
12154,JointPQPlayer,269,269,538,47,3,Tie
12155,JointPQPlayer,250,250,500,48,16,Tie
12156,JointPQPlayer,191,196,387,16,43,JointPQPlayer
12157,JointPQPlayer,270,265,535,56,7,Player A
12158,JointPQPlayer,217,217,434,24,30,Tie
12159,JointPQPlayer,242,247,489,43,18,JointPQPlayer
12160,JointPQPlayer,256,256,512,51,13,Tie
12161,JointPQPlayer,255,250,505,44,13,Player A
12162,JointPQPlayer,263,263,526,56,10,Tie
12163,JointPQPlayer,193,198,391,11,40,JointPQPlayer
12164,JointPQPlayer,267,262,529,59,10,Player A
12165,JointPQPlayer,250,250,500,39,13,Tie
12166,JointPQPlayer,265,265,530,51,7,Tie
12167,JointPQPlayer,218,218,436,32,32,Tie
12168,JointPQPlayer,236,241,477,43,22,JointPQPlayer
12169,JointPQPlayer,259,254,513,49,12,Player A
12170,JointPQPlayer,229,229,458,42,28,Tie
12171,JointPQPlayer,257,257,514,50,12,Tie
12172,JointPQPlayer,225,225,450,31,27,Tie
12173,JointPQPlayer,191,191,382,8,42,Tie
12174,JointPQPlayer,248,248,496,35,13,Tie
12175,JointPQPlayer,243,243,486,40,18,Tie
12176,JointPQPlayer,253,253,506,48,14,Tie
12177,JointPQPlayer,253,258,511,41,10,JointPQPlayer
12178,JointPQPlayer,248,243,491,36,15,Player A
12179,JointPQPlayer,217,222,439,38,33,JointPQPlayer
12180,JointPQPlayer,167,167,334,8,58,Tie
12181,JointPQPlayer,173,168,341,6,55,Player A
12182,JointPQPlayer,259,259,518,42,8,Tie
12183,JointPQPlayer,195,195,390,22,44,Tie
12184,JointPQPlayer,260,265,525,49,8,JointPQPlayer
12185,JointPQPlayer,248,248,496,44,16,Tie
12186,JointPQPlayer,220,215,435,28,31,Player A
12187,JointPQPlayer,252,257,509,36,9,JointPQPlayer
12188,JointPQPlayer,258,253,511,47,12,Player A
12189,JointPQPlayer,241,246,487,50,21,JointPQPlayer
12190,JointPQPlayer,256,251,507,43,12,Player A
12191,JointPQPlayer,253,258,511,41,10,JointPQPlayer
12192,JointPQPlayer,174,174,348,7,53,Tie
12193,JointPQPlayer,242,237,479,51,24,Player A
12194,JointPQPlayer,238,238,476,39,21,Tie
12195,JointPQPlayer,280,280,560,66,2,Tie
12196,JointPQPlayer,270,270,540,55,5,Tie
12197,JointPQPlayer,262,262,524,54,10,Tie
12198,JointPQPlayer,260,265,525,52,9,JointPQPlayer
12199,JointPQPlayer,177,177,354,13,53,Tie
12200,JointPQPlayer,261,256,517,44,9,Player A
12201,JointPQPlayer,247,247,494,36,14,Tie
12202,JointPQPlayer,158,158,316,5,63,Tie
12203,JointPQPlayer,231,231,462,34,24,Tie
12204,JointPQPlayer,166,171,337,2,55,JointPQPlayer
12205,JointPQPlayer,266,261,527,42,5,Player A
12206,JointPQPlayer,177,182,359,12,51,JointPQPlayer
12207,JointPQPlayer,264,259,523,47,8,Player A
12208,JointPQPlayer,243,243,486,37,17,Tie
12209,JointPQPlayer,278,278,556,65,3,Tie
12210,JointPQPlayer,260,265,525,49,8,JointPQPlayer
12211,JointPQPlayer,255,250,505,47,14,Player A
12212,JointPQPlayer,246,246,492,40,16,Tie
12213,JointPQPlayer,268,268,536,54,6,Tie
12214,JointPQPlayer,255,255,510,40,10,Tie
12215,JointPQPlayer,266,266,532,53,7,Tie
12216,JointPQPlayer,270,275,545,54,3,JointPQPlayer
12217,JointPQPlayer,253,248,501,40,13,Player A
12218,JointPQPlayer,269,269,538,59,7,Tie
12219,JointPQPlayer,171,176,347,6,53,JointPQPlayer
12220,JointPQPlayer,266,261,527,48,7,Player A
12221,JointPQPlayer,275,275,550,62,4,Tie
12222,JointPQPlayer,250,250,500,42,14,Tie
12223,JointPQPlayer,274,279,553,59,2,JointPQPlayer
12224,JointPQPlayer,222,217,439,26,29,Player A
12225,JointPQPlayer,263,263,526,50,8,Tie
12226,JointPQPlayer,248,248,496,38,14,Tie
12227,JointPQPlayer,218,218,436,29,31,Tie
12228,JointPQPlayer,251,251,502,44,14,Tie
12229,JointPQPlayer,249,254,503,39,12,JointPQPlayer
12230,JointPQPlayer,226,226,452,33,27,Tie
12231,JointPQPlayer,262,257,519,46,9,Player A
12232,JointPQPlayer,262,262,524,54,10,Tie
12233,JointPQPlayer,261,266,527,51,8,JointPQPlayer
12234,JointPQPlayer,206,206,412,20,36,Tie
12235,JointPQPlayer,211,211,422,24,34,Tie
12236,JointPQPlayer,268,263,531,58,9,Player A
12237,JointPQPlayer,245,250,495,49,18,JointPQPlayer
12238,JointPQPlayer,252,247,499,38,13,Player A
12239,JointPQPlayer,262,267,529,56,9,JointPQPlayer
12240,JointPQPlayer,269,264,533,57,8,Player A
12241,JointPQPlayer,265,265,530,45,5,Tie
12242,JointPQPlayer,240,240,480,37,19,Tie
12243,JointPQPlayer,252,252,504,46,14,Tie
12244,JointPQPlayer,241,246,487,41,18,JointPQPlayer
12245,JointPQPlayer,273,268,541,53,4,Player A
12246,JointPQPlayer,251,251,502,47,15,Tie
12247,JointPQPlayer,245,245,490,32,14,Tie
12248,JointPQPlayer,258,258,516,46,10,Tie
12249,JointPQPlayer,254,254,508,44,12,Tie
12250,JointPQPlayer,252,252,504,37,11,Tie
12251,JointPQPlayer,263,268,531,49,6,JointPQPlayer
12252,JointPQPlayer,270,270,540,58,6,Tie
12253,JointPQPlayer,253,253,506,42,12,Tie
12254,JointPQPlayer,240,235,475,32,19,Player A
12255,JointPQPlayer,163,168,331,11,60,JointPQPlayer
12256,JointPQPlayer,239,234,473,36,21,Player A
12257,JointPQPlayer,270,270,540,58,6,Tie
12258,JointPQPlayer,261,261,522,49,9,Tie
12259,JointPQPlayer,248,248,496,35,13,Tie
12260,JointPQPlayer,253,258,511,44,11,JointPQPlayer
12261,JointPQPlayer,257,252,509,45,12,Player A
12262,JointPQPlayer,257,262,519,46,9,JointPQPlayer
12263,JointPQPlayer,260,255,515,48,11,Player A
12264,JointPQPlayer,258,258,516,52,12,Tie
12265,JointPQPlayer,237,237,474,37,21,Tie
12266,JointPQPlayer,254,254,508,50,14,Tie
12267,JointPQPlayer,241,241,482,36,18,Tie
12268,JointPQPlayer,171,176,347,9,54,JointPQPlayer
12269,JointPQPlayer,211,206,417,19,34,Player A
12270,JointPQPlayer,257,262,519,49,10,JointPQPlayer
12271,JointPQPlayer,254,249,503,45,14,Player A
12272,JointPQPlayer,246,246,492,43,17,Tie
12273,JointPQPlayer,158,163,321,4,61,JointPQPlayer
12274,JointPQPlayer,264,259,523,44,7,Player A
12275,JointPQPlayer,265,265,530,60,10,Tie
12276,JointPQPlayer,261,261,522,52,10,Tie
12277,JointPQPlayer,257,257,514,50,12,Tie
12278,JointPQPlayer,178,178,356,15,53,Tie
12279,JointPQPlayer,237,237,474,40,22,Tie
12280,JointPQPlayer,258,263,521,51,10,JointPQPlayer
12281,JointPQPlayer,229,224,453,28,25,Player A
12282,JointPQPlayer,245,245,490,38,16,Tie
12283,JointPQPlayer,267,267,534,49,5,Tie
12284,JointPQPlayer,259,259,518,48,10,Tie
12285,JointPQPlayer,247,247,494,42,16,Tie
12286,JointPQPlayer,258,258,516,46,10,Tie
12287,JointPQPlayer,267,267,534,43,3,Tie
12288,JointPQPlayer,229,229,458,36,26,Tie
12289,JointPQPlayer,190,195,385,14,43,JointPQPlayer
12290,JointPQPlayer,157,157,314,6,64,Tie
12291,JointPQPlayer,272,267,539,54,5,Player A
12292,JointPQPlayer,242,247,489,43,18,JointPQPlayer
12293,JointPQPlayer,244,239,483,34,17,Player A
12294,JointPQPlayer,264,264,528,55,9,Tie
12295,JointPQPlayer,241,246,487,44,19,JointPQPlayer
12296,JointPQPlayer,247,247,494,39,15,Tie
12297,JointPQPlayer,259,254,513,46,11,Player A
12298,JointPQPlayer,230,235,465,43,26,JointPQPlayer
12299,JointPQPlayer,225,225,450,28,26,Tie
12300,JointPQPlayer,225,225,450,25,25,Tie
12301,JointPQPlayer,268,263,531,61,10,Player A
12302,JointPQPlayer,250,250,500,42,14,Tie
12303,JointPQPlayer,248,253,501,43,14,JointPQPlayer
12304,JointPQPlayer,248,248,496,41,15,Tie
12305,JointPQPlayer,265,260,525,52,9,Player A
12306,JointPQPlayer,253,258,511,44,11,JointPQPlayer
12307,JointPQPlayer,230,225,455,42,29,Player A
12308,JointPQPlayer,261,261,522,49,9,Tie
12309,JointPQPlayer,227,227,454,32,26,Tie
12310,JointPQPlayer,238,238,476,42,22,Tie
12311,JointPQPlayer,203,208,411,16,35,JointPQPlayer
12312,JointPQPlayer,253,253,506,42,12,Tie
12313,JointPQPlayer,236,231,467,36,23,Player A
12314,JointPQPlayer,271,271,542,57,5,Tie
12315,JointPQPlayer,269,269,538,59,7,Tie
12316,JointPQPlayer,161,166,327,4,59,JointPQPlayer
12317,JointPQPlayer,225,220,445,23,26,Player A
12318,JointPQPlayer,166,171,337,5,56,JointPQPlayer
12319,JointPQPlayer,175,175,350,9,53,Tie
12320,JointPQPlayer,244,239,483,37,18,Player A
12321,JointPQPlayer,271,271,542,60,6,Tie
12322,JointPQPlayer,194,199,393,16,41,JointPQPlayer
12323,JointPQPlayer,269,264,533,48,5,Player A
12324,JointPQPlayer,257,257,514,38,8,Tie
12325,JointPQPlayer,269,269,538,50,4,Tie
12326,JointPQPlayer,277,277,554,63,3,Tie
12327,JointPQPlayer,236,236,472,41,23,Tie
12328,JointPQPlayer,245,245,490,41,17,Tie
12329,JointPQPlayer,263,263,526,50,8,Tie
12330,JointPQPlayer,239,239,478,41,21,Tie
12331,JointPQPlayer,267,272,539,54,5,JointPQPlayer
12332,JointPQPlayer,217,217,434,30,32,Tie
12333,JointPQPlayer,259,254,513,49,12,Player A
12334,JointPQPlayer,250,255,505,41,12,JointPQPlayer
12335,JointPQPlayer,225,220,445,38,31,Player A
12336,JointPQPlayer,269,269,538,50,4,Tie
12337,JointPQPlayer,262,267,529,47,6,JointPQPlayer
12338,JointPQPlayer,237,232,469,38,23,Player A
12339,JointPQPlayer,174,179,353,6,51,JointPQPlayer
12340,JointPQPlayer,266,261,527,51,8,Player A
12341,JointPQPlayer,256,256,512,45,11,Tie
12342,JointPQPlayer,259,259,518,45,9,Tie
12343,JointPQPlayer,166,171,337,2,55,JointPQPlayer
12344,JointPQPlayer,244,244,488,39,17,Tie
12345,JointPQPlayer,221,216,437,24,29,Player A
12346,JointPQPlayer,260,265,525,46,7,JointPQPlayer
12347,JointPQPlayer,182,182,364,8,48,Tie
12348,JointPQPlayer,252,247,499,41,14,Player A
12349,JointPQPlayer,260,265,525,49,8,JointPQPlayer
12350,JointPQPlayer,248,243,491,45,18,Player A
12351,JointPQPlayer,254,254,508,53,15,Tie
12352,JointPQPlayer,248,248,496,38,14,Tie
12353,JointPQPlayer,272,272,544,59,5,Tie
12354,JointPQPlayer,244,244,488,36,16,Tie
12355,JointPQPlayer,231,236,467,39,24,JointPQPlayer
12356,JointPQPlayer,166,166,332,9,59,Tie
12357,JointPQPlayer,205,200,405,22,39,Player A
12358,JointPQPlayer,203,203,406,23,39,Tie
12359,JointPQPlayer,250,250,500,45,15,Tie
12360,JointPQPlayer,237,242,479,39,20,JointPQPlayer
12361,JointPQPlayer,265,265,530,51,7,Tie
12362,JointPQPlayer,263,258,521,45,8,Player A
12363,JointPQPlayer,223,223,446,30,28,Tie
12364,JointPQPlayer,270,270,540,52,4,Tie
12365,JointPQPlayer,209,209,418,23,35,Tie
12366,JointPQPlayer,252,252,504,43,13,Tie
12367,JointPQPlayer,253,253,506,45,13,Tie
12368,JointPQPlayer,223,223,446,36,30,Tie
12369,JointPQPlayer,266,266,532,59,9,Tie
12370,JointPQPlayer,227,232,459,37,26,JointPQPlayer
12371,JointPQPlayer,259,259,518,42,8,Tie
12372,JointPQPlayer,260,255,515,45,10,Player A
12373,JointPQPlayer,273,273,546,58,4,Tie
12374,JointPQPlayer,218,223,441,22,27,JointPQPlayer
12375,JointPQPlayer,220,215,435,34,33,Player A
12376,JointPQPlayer,223,228,451,38,29,JointPQPlayer
12377,JointPQPlayer,206,201,407,18,37,Player A
12378,JointPQPlayer,261,261,522,43,7,Tie
12379,JointPQPlayer,250,250,500,42,14,Tie
12380,JointPQPlayer,268,273,541,56,5,JointPQPlayer
12381,JointPQPlayer,177,177,354,10,52,Tie
12382,JointPQPlayer,213,208,421,29,36,Player A
12383,JointPQPlayer,258,258,516,49,11,Tie
12384,JointPQPlayer,270,275,545,57,4,JointPQPlayer
12385,JointPQPlayer,262,257,519,43,8,Player A
12386,JointPQPlayer,191,196,387,19,44,JointPQPlayer
12387,JointPQPlayer,255,255,510,49,13,Tie
12388,JointPQPlayer,222,217,439,26,29,Player A
12389,JointPQPlayer,267,272,539,57,6,JointPQPlayer
12390,JointPQPlayer,214,209,423,25,34,Player A
12391,JointPQPlayer,231,231,462,43,27,Tie
12392,JointPQPlayer,260,265,525,52,9,JointPQPlayer
12393,JointPQPlayer,192,187,379,14,45,Player A
12394,JointPQPlayer,262,262,524,45,7,Tie
12395,JointPQPlayer,262,262,524,45,7,Tie
12396,JointPQPlayer,218,218,436,29,31,Tie
12397,JointPQPlayer,255,260,515,42,9,JointPQPlayer
12398,JointPQPlayer,240,235,475,44,23,Player A
12399,JointPQPlayer,267,267,534,55,7,Tie
12400,JointPQPlayer,269,269,538,53,5,Tie
12401,JointPQPlayer,258,263,521,51,10,JointPQPlayer
12402,JointPQPlayer,261,256,517,47,10,Player A
12403,JointPQPlayer,168,173,341,6,55,JointPQPlayer
12404,JointPQPlayer,192,187,379,11,44,Player A
12405,JointPQPlayer,259,264,523,53,10,JointPQPlayer
12406,JointPQPlayer,260,255,515,60,15,Player A
12407,JointPQPlayer,259,264,523,47,8,JointPQPlayer
12408,JointPQPlayer,164,164,328,8,60,Tie
12409,JointPQPlayer,233,228,461,39,26,Player A
12410,JointPQPlayer,193,198,391,14,41,JointPQPlayer
12411,JointPQPlayer,260,255,515,51,12,Player A
12412,JointPQPlayer,246,251,497,42,15,JointPQPlayer
12413,JointPQPlayer,181,181,362,6,48,Tie
12414,JointPQPlayer,265,260,525,49,8,Player A
12415,JointPQPlayer,259,264,523,50,9,JointPQPlayer
12416,JointPQPlayer,166,166,332,6,58,Tie
12417,JointPQPlayer,181,181,362,6,48,Tie
12418,JointPQPlayer,265,260,525,40,5,Player A
12419,JointPQPlayer,184,189,373,8,45,JointPQPlayer
12420,JointPQPlayer,182,182,364,5,47,Tie
12421,JointPQPlayer,266,266,532,53,7,Tie
12422,JointPQPlayer,189,184,373,11,46,Player A
12423,JointPQPlayer,245,250,495,43,16,JointPQPlayer
12424,JointPQPlayer,179,179,358,11,51,Tie
12425,JointPQPlayer,258,253,511,41,10,Player A
12426,JointPQPlayer,273,273,546,58,4,Tie
12427,JointPQPlayer,249,249,498,49,17,Tie
12428,JointPQPlayer,255,255,510,52,14,Tie
12429,JointPQPlayer,254,259,513,49,12,JointPQPlayer
12430,JointPQPlayer,259,254,513,37,8,Player A
12431,JointPQPlayer,264,264,528,49,7,Tie
12432,JointPQPlayer,273,273,546,61,5,Tie
12433,JointPQPlayer,179,184,363,7,48,JointPQPlayer
12434,JointPQPlayer,253,248,501,46,15,Player A
12435,JointPQPlayer,276,276,552,58,2,Tie
12436,JointPQPlayer,251,256,507,46,13,JointPQPlayer
12437,JointPQPlayer,275,275,550,59,3,Tie
12438,JointPQPlayer,234,229,463,38,25,Player A
12439,JointPQPlayer,214,214,428,33,35,Tie
12440,JointPQPlayer,264,264,528,55,9,Tie
12441,JointPQPlayer,174,174,348,7,53,Tie
12442,JointPQPlayer,268,268,536,57,7,Tie
12443,JointPQPlayer,258,258,516,52,12,Tie
12444,JointPQPlayer,261,261,522,52,10,Tie
12445,JointPQPlayer,160,165,325,5,60,JointPQPlayer
12446,JointPQPlayer,196,191,387,10,41,Player A
12447,JointPQPlayer,239,239,478,26,16,Tie
12448,JointPQPlayer,231,231,462,28,22,Tie
12449,JointPQPlayer,184,184,368,15,49,Tie
12450,JointPQPlayer,217,217,434,30,32,Tie
12451,JointPQPlayer,254,259,513,46,11,JointPQPlayer
12452,JointPQPlayer,246,241,487,41,18,Player A
12453,JointPQPlayer,279,284,563,69,2,JointPQPlayer
12454,JointPQPlayer,264,259,523,53,10,Player A
12455,JointPQPlayer,257,257,514,53,13,Tie
12456,JointPQPlayer,174,179,353,6,51,JointPQPlayer
12457,JointPQPlayer,250,245,495,46,17,Player A
12458,JointPQPlayer,247,252,499,44,15,JointPQPlayer
12459,JointPQPlayer,248,243,491,33,14,Player A
12460,JointPQPlayer,248,253,501,52,17,JointPQPlayer
12461,JointPQPlayer,270,265,535,53,6,Player A
12462,JointPQPlayer,150,155,305,3,66,JointPQPlayer
12463,JointPQPlayer,244,244,488,39,17,Tie
12464,JointPQPlayer,230,225,455,36,27,Player A
12465,JointPQPlayer,191,196,387,13,42,JointPQPlayer
12466,JointPQPlayer,249,244,493,47,18,Player A
12467,JointPQPlayer,251,251,502,44,14,Tie
12468,JointPQPlayer,163,168,331,5,58,JointPQPlayer
12469,JointPQPlayer,244,239,483,40,19,Player A
12470,JointPQPlayer,228,233,461,33,24,JointPQPlayer
12471,JointPQPlayer,257,257,514,47,11,Tie
12472,JointPQPlayer,231,226,457,35,26,Player A
12473,JointPQPlayer,259,259,518,51,11,Tie
12474,JointPQPlayer,171,176,347,6,53,JointPQPlayer
12475,JointPQPlayer,171,171,342,7,55,Tie
12476,JointPQPlayer,251,246,497,51,18,Player A
12477,JointPQPlayer,166,171,337,5,56,JointPQPlayer
12478,JointPQPlayer,243,238,481,35,18,Player A
12479,JointPQPlayer,262,262,524,54,10,Tie
12480,JointPQPlayer,267,267,534,52,6,Tie
12481,JointPQPlayer,238,238,476,39,21,Tie
12482,JointPQPlayer,228,228,456,34,26,Tie
12483,JointPQPlayer,177,182,359,6,49,JointPQPlayer
12484,JointPQPlayer,256,251,507,49,14,Player A
12485,JointPQPlayer,201,201,402,16,38,Tie
12486,JointPQPlayer,271,271,542,66,8,Tie
12487,JointPQPlayer,249,254,503,42,13,JointPQPlayer
12488,JointPQPlayer,242,237,479,36,19,Player A
12489,JointPQPlayer,235,235,470,36,22,Tie
12490,JointPQPlayer,185,185,370,8,46,Tie
12491,JointPQPlayer,240,240,480,34,18,Tie
12492,JointPQPlayer,224,224,448,38,30,Tie
12493,JointPQPlayer,255,255,510,49,13,Tie
12494,JointPQPlayer,258,258,516,43,9,Tie
12495,JointPQPlayer,267,267,534,49,5,Tie
12496,JointPQPlayer,261,266,527,45,6,JointPQPlayer
12497,JointPQPlayer,243,238,481,35,18,Player A
12498,JointPQPlayer,266,271,537,55,6,JointPQPlayer
12499,JointPQPlayer,266,261,527,54,9,Player A
12500,JointPQPlayer,273,273,546,55,3,Tie
12501,JointPQPlayer,257,257,514,47,11,Tie
12502,JointPQPlayer,237,237,474,31,19,Tie
12503,JointPQPlayer,256,261,517,50,11,JointPQPlayer
12504,JointPQPlayer,271,271,542,54,4,Tie
12505,JointPQPlayer,177,177,354,10,52,Tie
12506,JointPQPlayer,168,168,336,7,57,Tie
12507,JointPQPlayer,167,167,334,5,57,Tie
12508,JointPQPlayer,214,214,428,24,32,Tie
12509,JointPQPlayer,251,246,497,39,14,Player A
12510,JointPQPlayer,254,254,508,35,9,Tie
12511,JointPQPlayer,258,263,521,54,11,JointPQPlayer
12512,JointPQPlayer,261,261,522,46,8,Tie
12513,JointPQPlayer,253,253,506,39,11,Tie
12514,JointPQPlayer,172,167,339,10,57,Player A
12515,JointPQPlayer,182,182,364,14,50,Tie
12516,JointPQPlayer,261,266,527,54,9,JointPQPlayer
12517,JointPQPlayer,158,158,316,5,63,Tie
12518,JointPQPlayer,220,215,435,28,31,Player A
12519,JointPQPlayer,256,256,512,39,9,Tie
12520,JointPQPlayer,254,254,508,44,12,Tie
12521,JointPQPlayer,222,222,444,31,29,Tie
12522,JointPQPlayer,255,255,510,52,14,Tie
12523,JointPQPlayer,176,181,357,4,49,JointPQPlayer
12524,JointPQPlayer,258,253,511,50,13,Player A
12525,JointPQPlayer,177,182,359,12,51,JointPQPlayer
12526,JointPQPlayer,259,259,518,48,10,Tie
12527,JointPQPlayer,182,182,364,11,49,Tie
12528,JointPQPlayer,246,246,492,37,15,Tie
12529,JointPQPlayer,196,191,387,25,46,Player A
12530,JointPQPlayer,241,246,487,44,19,JointPQPlayer
12531,JointPQPlayer,193,193,386,18,44,Tie
12532,JointPQPlayer,158,158,316,5,63,Tie
12533,JointPQPlayer,193,193,386,21,45,Tie
12534,JointPQPlayer,240,235,475,38,21,Player A
12535,JointPQPlayer,270,270,540,58,6,Tie
12536,JointPQPlayer,264,264,528,49,7,Tie
12537,JointPQPlayer,216,216,432,25,31,Tie
12538,JointPQPlayer,211,216,427,26,33,JointPQPlayer
12539,JointPQPlayer,199,199,398,18,40,Tie
12540,JointPQPlayer,184,179,363,10,49,Player A
12541,JointPQPlayer,233,238,471,34,21,JointPQPlayer
12542,JointPQPlayer,251,246,497,45,16,Player A
12543,JointPQPlayer,266,266,532,41,3,Tie
12544,JointPQPlayer,271,276,547,62,5,JointPQPlayer
12545,JointPQPlayer,217,217,434,30,32,Tie
12546,JointPQPlayer,242,242,484,35,17,Tie
12547,JointPQPlayer,168,163,331,5,58,Player A
12548,JointPQPlayer,253,253,506,48,14,Tie
12549,JointPQPlayer,246,251,497,36,13,JointPQPlayer
12550,JointPQPlayer,252,252,504,46,14,Tie
12551,JointPQPlayer,252,252,504,52,16,Tie
12552,JointPQPlayer,249,244,493,44,17,Player A
12553,JointPQPlayer,269,274,543,55,4,JointPQPlayer
12554,JointPQPlayer,270,265,535,53,6,Player A
12555,JointPQPlayer,176,181,357,10,51,JointPQPlayer
12556,JointPQPlayer,247,242,489,34,15,Player A
12557,JointPQPlayer,180,185,365,9,48,JointPQPlayer
12558,JointPQPlayer,271,266,537,55,6,Player A
12559,JointPQPlayer,254,254,508,50,14,Tie
12560,JointPQPlayer,229,234,463,32,23,JointPQPlayer
12561,JointPQPlayer,243,243,486,43,19,Tie
12562,JointPQPlayer,269,264,533,57,8,Player A
12563,JointPQPlayer,266,271,537,58,7,JointPQPlayer
12564,JointPQPlayer,256,256,512,48,12,Tie
12565,JointPQPlayer,267,262,529,53,8,Player A
12566,JointPQPlayer,253,253,506,39,11,Tie
12567,JointPQPlayer,211,211,422,27,35,Tie
12568,JointPQPlayer,246,246,492,37,15,Tie
12569,JointPQPlayer,239,244,483,49,22,JointPQPlayer
12570,JointPQPlayer,245,240,485,45,20,Player A
12571,JointPQPlayer,183,183,366,7,47,Tie
12572,JointPQPlayer,255,255,510,43,11,Tie
12573,JointPQPlayer,258,258,516,43,9,Tie
12574,JointPQPlayer,274,274,548,57,3,Tie
12575,JointPQPlayer,266,271,537,58,7,JointPQPlayer
12576,JointPQPlayer,246,241,487,44,19,Player A
12577,JointPQPlayer,227,232,459,34,25,JointPQPlayer
12578,JointPQPlayer,233,233,466,41,25,Tie
12579,JointPQPlayer,162,157,319,5,62,Player A
12580,JointPQPlayer,268,268,536,60,8,Tie
12581,JointPQPlayer,243,243,486,46,20,Tie
12582,JointPQPlayer,259,259,518,45,9,Tie
12583,JointPQPlayer,272,272,544,53,3,Tie
12584,JointPQPlayer,232,237,469,38,23,JointPQPlayer
12585,JointPQPlayer,250,245,495,43,16,Player A
12586,JointPQPlayer,244,244,488,33,15,Tie
12587,JointPQPlayer,254,254,508,47,13,Tie
12588,JointPQPlayer,230,235,465,34,23,JointPQPlayer
12589,JointPQPlayer,266,261,527,54,9,Player A
12590,JointPQPlayer,263,263,526,47,7,Tie
12591,JointPQPlayer,270,270,540,58,6,Tie
12592,JointPQPlayer,261,266,527,48,7,JointPQPlayer
12593,JointPQPlayer,205,200,405,25,40,Player A
12594,JointPQPlayer,223,228,451,32,27,JointPQPlayer
12595,JointPQPlayer,259,254,513,49,12,Player A
12596,JointPQPlayer,242,242,484,41,19,Tie
12597,JointPQPlayer,260,265,525,43,6,JointPQPlayer
12598,JointPQPlayer,163,163,326,6,60,Tie
12599,JointPQPlayer,253,248,501,34,11,Player A
12600,JointPQPlayer,221,221,442,32,30,Tie
12601,JointPQPlayer,242,242,484,38,18,Tie
12602,JointPQPlayer,202,202,404,30,42,Tie
12603,JointPQPlayer,250,255,505,50,15,JointPQPlayer
12604,JointPQPlayer,180,175,355,8,51,Player A
12605,JointPQPlayer,271,271,542,57,5,Tie
12606,JointPQPlayer,181,181,362,6,48,Tie
12607,JointPQPlayer,263,263,526,56,10,Tie
12608,JointPQPlayer,245,245,490,38,16,Tie
12609,JointPQPlayer,251,251,502,47,15,Tie
12610,JointPQPlayer,228,233,461,42,27,JointPQPlayer
12611,JointPQPlayer,270,265,535,53,6,Player A
12612,JointPQPlayer,270,270,540,55,5,Tie
12613,JointPQPlayer,260,265,525,49,8,JointPQPlayer
12614,JointPQPlayer,265,260,525,46,7,Player A
12615,JointPQPlayer,269,269,538,47,3,Tie
12616,JointPQPlayer,265,265,530,45,5,Tie
12617,JointPQPlayer,261,261,522,46,8,Tie
12618,JointPQPlayer,242,242,484,44,20,Tie
12619,JointPQPlayer,275,275,550,59,3,Tie
12620,JointPQPlayer,269,269,538,53,5,Tie
12621,JointPQPlayer,241,241,482,36,18,Tie
12622,JointPQPlayer,176,181,357,10,51,JointPQPlayer
12623,JointPQPlayer,256,251,507,46,13,Player A
12624,JointPQPlayer,244,244,488,48,20,Tie
12625,JointPQPlayer,230,230,460,32,24,Tie
12626,JointPQPlayer,242,242,484,47,21,Tie
12627,JointPQPlayer,269,269,538,56,6,Tie
12628,JointPQPlayer,259,259,518,42,8,Tie
12629,JointPQPlayer,245,245,490,47,19,Tie
12630,JointPQPlayer,240,245,485,39,18,JointPQPlayer
12631,JointPQPlayer,241,241,482,39,19,Tie
12632,JointPQPlayer,264,259,523,50,9,Player A
12633,JointPQPlayer,228,228,456,28,24,Tie
12634,JointPQPlayer,252,252,504,46,14,Tie
12635,JointPQPlayer,273,273,546,61,5,Tie
12636,JointPQPlayer,269,269,538,59,7,Tie
12637,JointPQPlayer,252,257,509,45,12,JointPQPlayer
12638,JointPQPlayer,271,271,542,54,4,Tie
12639,JointPQPlayer,249,244,493,38,15,Player A
12640,JointPQPlayer,247,252,499,47,16,JointPQPlayer
12641,JointPQPlayer,273,268,541,50,3,Player A
12642,JointPQPlayer,221,221,442,29,29,Tie
12643,JointPQPlayer,272,272,544,50,2,Tie
12644,JointPQPlayer,240,240,480,37,19,Tie
12645,JointPQPlayer,255,255,510,43,11,Tie
12646,JointPQPlayer,261,261,522,49,9,Tie
12647,JointPQPlayer,187,187,374,12,46,Tie
12648,JointPQPlayer,241,241,482,33,17,Tie
12649,JointPQPlayer,255,260,515,45,10,JointPQPlayer
12650,JointPQPlayer,272,267,539,54,5,Player A
12651,JointPQPlayer,246,251,497,51,18,JointPQPlayer
12652,JointPQPlayer,229,224,453,34,27,Player A
12653,JointPQPlayer,254,259,513,46,11,JointPQPlayer
12654,JointPQPlayer,248,243,491,39,16,Player A
12655,JointPQPlayer,216,216,432,25,31,Tie
12656,JointPQPlayer,249,249,498,37,13,Tie
12657,JointPQPlayer,212,217,429,34,35,JointPQPlayer
12658,JointPQPlayer,227,222,449,30,27,Player A
12659,JointPQPlayer,247,252,499,41,14,JointPQPlayer
12660,JointPQPlayer,268,263,531,49,6,Player A
12661,JointPQPlayer,262,267,529,44,5,JointPQPlayer
12662,JointPQPlayer,227,227,454,38,28,Tie
12663,JointPQPlayer,244,244,488,45,19,Tie
12664,JointPQPlayer,248,243,491,42,17,Player A
12665,JointPQPlayer,242,247,489,40,17,JointPQPlayer
12666,JointPQPlayer,183,178,361,5,48,Player A
12667,JointPQPlayer,223,223,446,33,29,Tie
12668,JointPQPlayer,182,187,369,4,45,JointPQPlayer
12669,JointPQPlayer,262,257,519,46,9,Player A
12670,JointPQPlayer,244,244,488,54,22,Tie
12671,JointPQPlayer,244,249,493,35,14,JointPQPlayer
12672,JointPQPlayer,271,266,537,55,6,Player A
12673,JointPQPlayer,262,267,529,47,6,JointPQPlayer
12674,JointPQPlayer,247,242,489,46,19,Player A
12675,JointPQPlayer,258,258,516,43,9,Tie
12676,JointPQPlayer,234,239,473,39,22,JointPQPlayer
12677,JointPQPlayer,180,180,360,4,48,Tie
12678,JointPQPlayer,181,181,362,6,48,Tie
12679,JointPQPlayer,259,254,513,52,13,Player A
12680,JointPQPlayer,160,165,325,5,60,JointPQPlayer
12681,JointPQPlayer,250,245,495,37,14,Player A
12682,JointPQPlayer,261,266,527,48,7,JointPQPlayer
12683,JointPQPlayer,243,243,486,40,18,Tie
12684,JointPQPlayer,264,259,523,50,9,Player A
12685,JointPQPlayer,178,183,361,14,51,JointPQPlayer
12686,JointPQPlayer,174,169,343,5,54,Player A
12687,JointPQPlayer,254,259,513,52,13,JointPQPlayer
12688,JointPQPlayer,236,236,472,35,21,Tie
12689,JointPQPlayer,265,260,525,49,8,Player A
12690,JointPQPlayer,260,260,520,47,9,Tie
12691,JointPQPlayer,247,247,494,39,15,Tie
12692,JointPQPlayer,169,174,343,5,54,JointPQPlayer
12693,JointPQPlayer,222,217,439,26,29,Player A
12694,JointPQPlayer,181,186,367,14,49,JointPQPlayer
12695,JointPQPlayer,188,183,371,9,46,Player A
12696,JointPQPlayer,258,258,516,43,9,Tie
12697,JointPQPlayer,268,268,536,57,7,Tie
12698,JointPQPlayer,157,162,319,8,63,JointPQPlayer
12699,JointPQPlayer,241,241,482,45,21,Tie
12700,JointPQPlayer,240,240,480,40,20,Tie
12701,JointPQPlayer,267,262,529,50,7,Player A
12702,JointPQPlayer,241,246,487,38,17,JointPQPlayer
12703,JointPQPlayer,277,277,554,63,3,Tie
12704,JointPQPlayer,252,247,499,44,15,Player A
12705,JointPQPlayer,267,272,539,57,6,JointPQPlayer
12706,JointPQPlayer,240,235,475,38,21,Player A
12707,JointPQPlayer,214,219,433,26,31,JointPQPlayer
12708,JointPQPlayer,264,259,523,50,9,Player A
12709,JointPQPlayer,246,251,497,48,17,JointPQPlayer
12710,JointPQPlayer,178,173,351,4,51,Player A
12711,JointPQPlayer,255,260,515,45,10,JointPQPlayer
12712,JointPQPlayer,264,264,528,52,8,Tie
12713,JointPQPlayer,261,256,517,50,11,Player A
12714,JointPQPlayer,265,265,530,51,7,Tie
12715,JointPQPlayer,215,215,430,29,33,Tie
12716,JointPQPlayer,270,270,540,55,5,Tie
12717,JointPQPlayer,187,192,379,14,45,JointPQPlayer
12718,JointPQPlayer,239,239,478,41,21,Tie
12719,JointPQPlayer,223,218,441,31,30,Player A
12720,JointPQPlayer,257,257,514,53,13,Tie
12721,JointPQPlayer,249,249,498,37,13,Tie
12722,JointPQPlayer,253,258,511,41,10,JointPQPlayer
12723,JointPQPlayer,258,253,511,47,12,Player A
12724,JointPQPlayer,235,235,470,36,22,Tie
12725,JointPQPlayer,271,271,542,60,6,Tie
12726,JointPQPlayer,257,257,514,41,9,Tie
12727,JointPQPlayer,243,248,491,45,18,JointPQPlayer
12728,JointPQPlayer,240,240,480,40,20,Tie
12729,JointPQPlayer,238,233,471,40,23,Player A
12730,JointPQPlayer,199,199,398,24,42,Tie
12731,JointPQPlayer,230,230,460,38,26,Tie
12732,JointPQPlayer,190,190,380,9,43,Tie
12733,JointPQPlayer,234,234,468,37,23,Tie
12734,JointPQPlayer,256,261,517,47,10,JointPQPlayer
12735,JointPQPlayer,248,243,491,39,16,Player A
12736,JointPQPlayer,161,166,327,7,60,JointPQPlayer
12737,JointPQPlayer,264,259,523,50,9,Player A
12738,JointPQPlayer,198,203,401,24,41,JointPQPlayer
12739,JointPQPlayer,256,256,512,48,12,Tie
12740,JointPQPlayer,255,250,505,38,11,Player A
12741,JointPQPlayer,250,255,505,44,13,JointPQPlayer
12742,JointPQPlayer,233,233,466,38,24,Tie
12743,JointPQPlayer,248,243,491,42,17,Player A
12744,JointPQPlayer,247,247,494,42,16,Tie
12745,JointPQPlayer,261,261,522,55,11,Tie
12746,JointPQPlayer,246,246,492,49,19,Tie
12747,JointPQPlayer,166,171,337,8,57,JointPQPlayer
12748,JointPQPlayer,253,253,506,42,12,Tie
12749,JointPQPlayer,247,247,494,45,17,Tie
12750,JointPQPlayer,269,264,533,48,5,Player A
12751,JointPQPlayer,257,262,519,52,11,JointPQPlayer
12752,JointPQPlayer,208,203,411,22,37,Player A
12753,JointPQPlayer,226,231,457,29,24,JointPQPlayer
12754,JointPQPlayer,246,241,487,44,19,Player A
12755,JointPQPlayer,259,264,523,50,9,JointPQPlayer
12756,JointPQPlayer,240,235,475,35,20,Player A
12757,JointPQPlayer,171,176,347,9,54,JointPQPlayer
12758,JointPQPlayer,203,198,401,18,39,Player A
12759,JointPQPlayer,185,190,375,10,45,JointPQPlayer
12760,JointPQPlayer,237,237,474,43,23,Tie
12761,JointPQPlayer,254,254,508,44,12,Tie
12762,JointPQPlayer,260,260,520,44,8,Tie
12763,JointPQPlayer,260,260,520,44,8,Tie
12764,JointPQPlayer,264,259,523,53,10,Player A
12765,JointPQPlayer,264,264,528,52,8,Tie
12766,JointPQPlayer,175,180,355,8,51,JointPQPlayer
12767,JointPQPlayer,265,260,525,55,10,Player A
12768,JointPQPlayer,246,251,497,45,16,JointPQPlayer
12769,JointPQPlayer,238,233,471,34,21,Player A
12770,JointPQPlayer,236,236,472,38,22,Tie
12771,JointPQPlayer,230,235,465,28,21,JointPQPlayer
12772,JointPQPlayer,253,248,501,40,13,Player A
12773,JointPQPlayer,255,260,515,48,11,JointPQPlayer
12774,JointPQPlayer,211,211,422,30,36,Tie
12775,JointPQPlayer,233,233,466,38,24,Tie
12776,JointPQPlayer,268,263,531,52,7,Player A
12777,JointPQPlayer,249,254,503,39,12,JointPQPlayer
12778,JointPQPlayer,248,243,491,42,17,Player A
12779,JointPQPlayer,272,272,544,56,4,Tie
12780,JointPQPlayer,255,260,515,51,12,JointPQPlayer
12781,JointPQPlayer,173,168,341,12,57,Player A
12782,JointPQPlayer,250,255,505,44,13,JointPQPlayer
12783,JointPQPlayer,275,270,545,54,3,Player A
12784,JointPQPlayer,178,183,361,8,49,JointPQPlayer
12785,JointPQPlayer,192,192,384,10,42,Tie
12786,JointPQPlayer,257,252,509,45,12,Player A
12787,JointPQPlayer,264,264,528,52,8,Tie
12788,JointPQPlayer,250,255,505,47,14,JointPQPlayer
12789,JointPQPlayer,260,255,515,45,10,Player A
12790,JointPQPlayer,264,269,533,54,7,JointPQPlayer
12791,JointPQPlayer,261,256,517,44,9,Player A
12792,JointPQPlayer,174,174,348,7,53,Tie
12793,JointPQPlayer,207,207,414,19,35,Tie
12794,JointPQPlayer,240,240,480,40,20,Tie
12795,JointPQPlayer,177,182,359,6,49,JointPQPlayer
12796,JointPQPlayer,248,243,491,39,16,Player A
12797,JointPQPlayer,262,262,524,54,10,Tie
12798,JointPQPlayer,260,260,520,50,10,Tie
12799,JointPQPlayer,255,255,510,43,11,Tie
12800,JointPQPlayer,251,251,502,41,13,Tie
12801,JointPQPlayer,246,251,497,42,15,JointPQPlayer
12802,JointPQPlayer,259,254,513,46,11,Player A
12803,JointPQPlayer,241,241,482,39,19,Tie
12804,JointPQPlayer,176,181,357,7,50,JointPQPlayer
12805,JointPQPlayer,265,260,525,46,7,Player A
12806,JointPQPlayer,276,276,552,58,2,Tie
12807,JointPQPlayer,261,266,527,48,7,JointPQPlayer
12808,JointPQPlayer,210,205,415,17,34,Player A
12809,JointPQPlayer,245,250,495,43,16,JointPQPlayer
12810,JointPQPlayer,269,264,533,54,7,Player A
12811,JointPQPlayer,254,259,513,46,11,JointPQPlayer
12812,JointPQPlayer,209,209,418,32,38,Tie
12813,JointPQPlayer,263,258,521,57,12,Player A
12814,JointPQPlayer,266,266,532,44,4,Tie
12815,JointPQPlayer,265,265,530,51,7,Tie
12816,JointPQPlayer,273,273,546,58,4,Tie
12817,JointPQPlayer,235,235,470,33,21,Tie
12818,JointPQPlayer,195,195,390,13,41,Tie
12819,JointPQPlayer,251,251,502,44,14,Tie
12820,JointPQPlayer,256,256,512,48,12,Tie
12821,JointPQPlayer,265,265,530,51,7,Tie
12822,JointPQPlayer,214,219,433,29,32,JointPQPlayer
12823,JointPQPlayer,261,261,522,52,10,Tie
12824,JointPQPlayer,192,192,384,19,45,Tie
12825,JointPQPlayer,240,235,475,41,22,Player A
12826,JointPQPlayer,224,224,448,35,29,Tie
12827,JointPQPlayer,256,256,512,45,11,Tie
12828,JointPQPlayer,258,258,516,46,10,Tie
12829,JointPQPlayer,172,172,344,15,57,Tie
12830,JointPQPlayer,263,263,526,47,7,Tie
12831,JointPQPlayer,208,213,421,23,34,JointPQPlayer
12832,JointPQPlayer,239,234,473,39,22,Player A
12833,JointPQPlayer,270,270,540,55,5,Tie
12834,JointPQPlayer,250,250,500,48,16,Tie
12835,JointPQPlayer,248,253,501,43,14,JointPQPlayer
12836,JointPQPlayer,270,265,535,56,7,Player A
12837,JointPQPlayer,253,253,506,42,12,Tie
12838,JointPQPlayer,263,263,526,50,8,Tie
12839,JointPQPlayer,237,237,474,34,20,Tie
12840,JointPQPlayer,168,168,336,10,58,Tie
12841,JointPQPlayer,267,267,534,52,6,Tie
12842,JointPQPlayer,203,203,406,8,34,Tie
12843,JointPQPlayer,244,244,488,42,18,Tie
12844,JointPQPlayer,236,241,477,37,20,JointPQPlayer
12845,JointPQPlayer,254,249,503,45,14,Player A
12846,JointPQPlayer,251,251,502,41,13,Tie
12847,JointPQPlayer,261,261,522,52,10,Tie
12848,JointPQPlayer,187,192,379,11,44,JointPQPlayer
12849,JointPQPlayer,194,189,383,21,46,Player A
12850,JointPQPlayer,251,256,507,49,14,JointPQPlayer
12851,JointPQPlayer,243,243,486,46,20,Tie
12852,JointPQPlayer,244,244,488,36,16,Tie
12853,JointPQPlayer,256,251,507,40,11,Player A
12854,JointPQPlayer,257,257,514,44,10,Tie
12855,JointPQPlayer,251,251,502,44,14,Tie
12856,JointPQPlayer,240,240,480,43,21,Tie
12857,JointPQPlayer,247,247,494,42,16,Tie
12858,JointPQPlayer,261,266,527,51,8,JointPQPlayer
12859,JointPQPlayer,264,259,523,50,9,Player A
12860,JointPQPlayer,225,225,450,25,25,Tie
12861,JointPQPlayer,244,249,493,41,16,JointPQPlayer
12862,JointPQPlayer,254,254,508,53,15,Tie
12863,JointPQPlayer,268,263,531,58,9,Player A
12864,JointPQPlayer,232,232,464,30,22,Tie
12865,JointPQPlayer,271,271,542,54,4,Tie
12866,JointPQPlayer,225,225,450,31,27,Tie
12867,JointPQPlayer,193,198,391,14,41,JointPQPlayer
12868,JointPQPlayer,246,241,487,41,18,Player A
12869,JointPQPlayer,257,257,514,47,11,Tie
12870,JointPQPlayer,265,265,530,60,10,Tie
12871,JointPQPlayer,266,271,537,52,5,JointPQPlayer
12872,JointPQPlayer,273,268,541,59,6,Player A
12873,JointPQPlayer,276,276,552,64,4,Tie
12874,JointPQPlayer,262,262,524,63,13,Tie
12875,JointPQPlayer,237,237,474,34,20,Tie
12876,JointPQPlayer,154,159,313,5,64,JointPQPlayer
12877,JointPQPlayer,270,265,535,56,7,Player A
12878,JointPQPlayer,167,172,339,4,55,JointPQPlayer
12879,JointPQPlayer,248,248,496,44,16,Tie
12880,JointPQPlayer,177,177,354,7,51,Tie
12881,JointPQPlayer,205,200,405,13,36,Player A
12882,JointPQPlayer,197,197,394,23,43,Tie
12883,JointPQPlayer,265,265,530,54,8,Tie
12884,JointPQPlayer,245,245,490,41,17,Tie
12885,JointPQPlayer,236,241,477,31,18,JointPQPlayer
12886,JointPQPlayer,227,222,449,30,27,Player A
12887,JointPQPlayer,258,258,516,40,8,Tie
12888,JointPQPlayer,244,244,488,36,16,Tie
12889,JointPQPlayer,255,255,510,49,13,Tie
12890,JointPQPlayer,224,224,448,29,27,Tie
12891,JointPQPlayer,259,259,518,42,8,Tie
12892,JointPQPlayer,170,175,345,4,53,JointPQPlayer
12893,JointPQPlayer,283,278,561,70,3,Player A
12894,JointPQPlayer,270,270,540,52,4,Tie
12895,JointPQPlayer,270,270,540,61,7,Tie
12896,JointPQPlayer,269,269,538,56,6,Tie
12897,JointPQPlayer,229,229,458,33,25,Tie
12898,JointPQPlayer,177,182,359,9,50,JointPQPlayer
12899,JointPQPlayer,251,251,502,47,15,Tie
12900,JointPQPlayer,203,198,401,21,40,Player A
12901,JointPQPlayer,274,274,548,57,3,Tie
12902,JointPQPlayer,228,233,461,36,25,JointPQPlayer
12903,JointPQPlayer,178,178,356,12,52,Tie
12904,JointPQPlayer,270,265,535,50,5,Player A
12905,JointPQPlayer,206,206,412,29,39,Tie
12906,JointPQPlayer,267,267,534,55,7,Tie
12907,JointPQPlayer,246,246,492,46,18,Tie
12908,JointPQPlayer,259,264,523,47,8,JointPQPlayer
12909,JointPQPlayer,269,264,533,54,7,Player A
12910,JointPQPlayer,256,256,512,42,10,Tie
12911,JointPQPlayer,269,269,538,53,5,Tie
12912,JointPQPlayer,272,277,549,61,4,JointPQPlayer
12913,JointPQPlayer,252,247,499,44,15,Player A
12914,JointPQPlayer,257,257,514,41,9,Tie
12915,JointPQPlayer,252,252,504,40,12,Tie
12916,JointPQPlayer,167,172,339,1,54,JointPQPlayer
12917,JointPQPlayer,246,241,487,41,18,Player A
12918,JointPQPlayer,177,177,354,13,53,Tie
12919,JointPQPlayer,171,176,347,6,53,JointPQPlayer
12920,JointPQPlayer,179,179,358,5,49,Tie
12921,JointPQPlayer,223,223,446,33,29,Tie
12922,JointPQPlayer,228,228,456,34,26,Tie
12923,JointPQPlayer,269,264,533,60,9,Player A
12924,JointPQPlayer,239,244,483,40,19,JointPQPlayer
12925,JointPQPlayer,264,264,528,58,10,Tie
12926,JointPQPlayer,174,174,348,7,53,Tie
12927,JointPQPlayer,250,245,495,37,14,Player A
12928,JointPQPlayer,181,186,367,8,47,JointPQPlayer
12929,JointPQPlayer,260,255,515,42,9,Player A
12930,JointPQPlayer,264,264,528,55,9,Tie
12931,JointPQPlayer,228,233,461,30,23,JointPQPlayer
12932,JointPQPlayer,277,272,549,55,2,Player A
12933,JointPQPlayer,159,164,323,3,60,JointPQPlayer
12934,JointPQPlayer,255,250,505,44,13,Player A
12935,JointPQPlayer,271,271,542,54,4,Tie
12936,JointPQPlayer,273,273,546,58,4,Tie
12937,JointPQPlayer,263,268,531,61,10,JointPQPlayer
12938,JointPQPlayer,259,254,513,52,13,Player A
12939,JointPQPlayer,247,247,494,42,16,Tie
12940,JointPQPlayer,245,245,490,41,17,Tie
12941,JointPQPlayer,252,252,504,40,12,Tie
12942,JointPQPlayer,210,210,420,22,34,Tie
12943,JointPQPlayer,257,257,514,50,12,Tie
12944,JointPQPlayer,223,223,446,36,30,Tie
12945,JointPQPlayer,175,180,355,8,51,JointPQPlayer
12946,JointPQPlayer,234,229,463,32,23,Player A
12947,JointPQPlayer,253,258,511,38,9,JointPQPlayer
12948,JointPQPlayer,208,208,416,30,38,Tie
12949,JointPQPlayer,251,246,497,42,15,Player A
12950,JointPQPlayer,249,249,498,49,17,Tie
12951,JointPQPlayer,266,266,532,47,5,Tie
12952,JointPQPlayer,255,260,515,48,11,JointPQPlayer
12953,JointPQPlayer,175,175,350,9,53,Tie
12954,JointPQPlayer,253,248,501,40,13,Player A
12955,JointPQPlayer,215,215,430,26,32,Tie
12956,JointPQPlayer,169,174,343,5,54,JointPQPlayer
12957,JointPQPlayer,261,256,517,44,9,Player A
12958,JointPQPlayer,239,239,478,35,19,Tie
12959,JointPQPlayer,275,275,550,56,2,Tie
12960,JointPQPlayer,224,224,448,38,30,Tie
12961,JointPQPlayer,261,261,522,46,8,Tie
12962,JointPQPlayer,234,234,468,31,21,Tie
12963,JointPQPlayer,262,262,524,45,7,Tie
12964,JointPQPlayer,274,274,548,60,4,Tie
12965,JointPQPlayer,215,215,430,26,32,Tie
12966,JointPQPlayer,183,188,371,9,46,JointPQPlayer
12967,JointPQPlayer,269,269,538,59,7,Tie
12968,JointPQPlayer,263,263,526,50,8,Tie
12969,JointPQPlayer,224,224,448,38,30,Tie
12970,JointPQPlayer,211,211,422,27,35,Tie
12971,JointPQPlayer,243,243,486,43,19,Tie
12972,JointPQPlayer,250,245,495,40,15,Player A
12973,JointPQPlayer,251,256,507,40,11,JointPQPlayer
12974,JointPQPlayer,266,261,527,54,9,Player A
12975,JointPQPlayer,258,258,516,49,11,Tie
12976,JointPQPlayer,259,259,518,45,9,Tie
12977,JointPQPlayer,267,267,534,49,5,Tie
12978,JointPQPlayer,245,245,490,41,17,Tie
12979,JointPQPlayer,270,270,540,58,6,Tie
12980,JointPQPlayer,179,179,358,8,50,Tie
12981,JointPQPlayer,205,205,410,18,36,Tie
12982,JointPQPlayer,257,257,514,50,12,Tie
12983,JointPQPlayer,180,185,365,12,49,JointPQPlayer
12984,JointPQPlayer,270,265,535,53,6,Player A
12985,JointPQPlayer,223,228,451,38,29,JointPQPlayer
12986,JointPQPlayer,273,268,541,59,6,Player A
12987,JointPQPlayer,173,178,351,13,54,JointPQPlayer
12988,JointPQPlayer,216,216,432,28,32,Tie
12989,JointPQPlayer,187,187,374,6,44,Tie
12990,JointPQPlayer,245,240,485,39,18,Player A
12991,JointPQPlayer,257,257,514,44,10,Tie
12992,JointPQPlayer,256,256,512,45,11,Tie
12993,JointPQPlayer,269,269,538,59,7,Tie
12994,JointPQPlayer,239,239,478,38,20,Tie
12995,JointPQPlayer,261,261,522,43,7,Tie
12996,JointPQPlayer,238,238,476,36,20,Tie
12997,JointPQPlayer,258,263,521,48,9,JointPQPlayer
12998,JointPQPlayer,238,233,471,31,20,Player A
12999,JointPQPlayer,177,182,359,12,51,JointPQPlayer
13000,JointPQPlayer,268,263,531,49,6,Player A
13001,JointPQPlayer,181,181,362,9,49,Tie
13002,JointPQPlayer,272,272,544,56,4,Tie
13003,JointPQPlayer,195,195,390,13,41,Tie
13004,JointPQPlayer,253,253,506,42,12,Tie
13005,JointPQPlayer,184,189,373,5,44,JointPQPlayer
13006,JointPQPlayer,224,219,443,30,29,Player A
13007,JointPQPlayer,248,248,496,44,16,Tie
13008,JointPQPlayer,153,158,311,3,64,JointPQPlayer
13009,JointPQPlayer,248,243,491,33,14,Player A
13010,JointPQPlayer,270,270,540,52,4,Tie
13011,JointPQPlayer,237,242,479,42,21,JointPQPlayer
13012,JointPQPlayer,244,239,483,49,22,Player A
13013,JointPQPlayer,247,247,494,48,18,Tie
13014,JointPQPlayer,235,240,475,44,23,JointPQPlayer
13015,JointPQPlayer,179,179,358,11,51,Tie
13016,JointPQPlayer,196,191,387,19,44,Player A
13017,JointPQPlayer,241,241,482,33,17,Tie
13018,JointPQPlayer,180,180,360,10,50,Tie
13019,JointPQPlayer,249,249,498,49,17,Tie
13020,JointPQPlayer,256,256,512,54,14,Tie
13021,JointPQPlayer,244,244,488,45,19,Tie
13022,JointPQPlayer,249,249,498,37,13,Tie
13023,JointPQPlayer,273,273,546,52,2,Tie
13024,JointPQPlayer,173,178,351,10,53,JointPQPlayer
13025,JointPQPlayer,235,230,465,28,21,Player A
13026,JointPQPlayer,272,277,549,61,4,JointPQPlayer
13027,JointPQPlayer,186,186,372,10,46,Tie
13028,JointPQPlayer,256,251,507,46,13,Player A
13029,JointPQPlayer,259,264,523,47,8,JointPQPlayer
13030,JointPQPlayer,277,272,549,55,2,Player A
13031,JointPQPlayer,265,265,530,57,9,Tie
13032,JointPQPlayer,221,221,442,29,29,Tie
13033,JointPQPlayer,227,227,454,35,27,Tie
13034,JointPQPlayer,257,257,514,50,12,Tie
13035,JointPQPlayer,221,221,442,32,30,Tie
13036,JointPQPlayer,238,238,476,39,21,Tie
13037,JointPQPlayer,220,225,445,23,26,JointPQPlayer
13038,JointPQPlayer,262,257,519,52,11,Player A
13039,JointPQPlayer,166,171,337,11,58,JointPQPlayer
13040,JointPQPlayer,234,229,463,38,25,Player A
13041,JointPQPlayer,262,262,524,42,6,Tie
13042,JointPQPlayer,256,256,512,42,10,Tie
13043,JointPQPlayer,262,262,524,51,9,Tie
13044,JointPQPlayer,265,265,530,54,8,Tie
13045,JointPQPlayer,219,224,443,30,29,JointPQPlayer
13046,JointPQPlayer,254,249,503,42,13,Player A
13047,JointPQPlayer,236,236,472,32,20,Tie
13048,JointPQPlayer,271,271,542,66,8,Tie
13049,JointPQPlayer,251,251,502,44,14,Tie
13050,JointPQPlayer,256,256,512,48,12,Tie
13051,JointPQPlayer,229,229,458,39,27,Tie
13052,JointPQPlayer,231,231,462,34,24,Tie
13053,JointPQPlayer,260,265,525,43,6,JointPQPlayer
13054,JointPQPlayer,179,179,358,11,51,Tie
13055,JointPQPlayer,251,251,502,38,12,Tie
13056,JointPQPlayer,242,242,484,35,17,Tie
13057,JointPQPlayer,239,234,473,42,23,Player A
13058,JointPQPlayer,173,178,351,4,51,JointPQPlayer
13059,JointPQPlayer,263,258,521,57,12,Player A
13060,JointPQPlayer,263,268,531,58,9,JointPQPlayer
13061,JointPQPlayer,268,268,536,60,8,Tie
13062,JointPQPlayer,264,264,528,46,6,Tie
13063,JointPQPlayer,260,255,515,42,9,Player A
13064,JointPQPlayer,272,272,544,62,6,Tie
13065,JointPQPlayer,255,260,515,45,10,JointPQPlayer
13066,JointPQPlayer,266,261,527,45,6,Player A
13067,JointPQPlayer,249,254,503,45,14,JointPQPlayer
13068,JointPQPlayer,245,245,490,38,16,Tie
13069,JointPQPlayer,170,170,340,5,55,Tie
13070,JointPQPlayer,265,260,525,37,4,Player A
13071,JointPQPlayer,250,250,500,36,12,Tie
13072,JointPQPlayer,219,224,443,39,32,JointPQPlayer
13073,JointPQPlayer,269,269,538,56,6,Tie
13074,JointPQPlayer,264,259,523,47,8,Player A
13075,JointPQPlayer,255,255,510,46,12,Tie
13076,JointPQPlayer,238,238,476,36,20,Tie
13077,JointPQPlayer,182,187,369,7,46,JointPQPlayer
13078,JointPQPlayer,202,197,399,13,38,Player A
13079,JointPQPlayer,242,242,484,44,20,Tie
13080,JointPQPlayer,253,258,511,50,13,JointPQPlayer
13081,JointPQPlayer,159,159,318,4,62,Tie
13082,JointPQPlayer,206,201,407,18,37,Player A
13083,JointPQPlayer,263,268,531,52,7,JointPQPlayer
13084,JointPQPlayer,269,264,533,54,7,Player A
13085,JointPQPlayer,257,257,514,41,9,Tie
13086,JointPQPlayer,251,251,502,50,16,Tie
13087,JointPQPlayer,257,257,514,41,9,Tie
13088,JointPQPlayer,197,197,394,20,42,Tie
13089,JointPQPlayer,266,266,532,50,6,Tie
13090,JointPQPlayer,223,223,446,24,26,Tie
13091,JointPQPlayer,242,247,489,40,17,JointPQPlayer
13092,JointPQPlayer,259,254,513,46,11,Player A
13093,JointPQPlayer,236,236,472,35,21,Tie
13094,JointPQPlayer,269,269,538,53,5,Tie
13095,JointPQPlayer,170,175,345,7,54,JointPQPlayer
13096,JointPQPlayer,227,222,449,36,29,Player A
13097,JointPQPlayer,185,190,375,7,44,JointPQPlayer
13098,JointPQPlayer,252,247,499,41,14,Player A
13099,JointPQPlayer,227,232,459,37,26,JointPQPlayer
13100,JointPQPlayer,235,230,465,34,23,Player A
13101,JointPQPlayer,204,204,408,22,38,Tie
13102,JointPQPlayer,191,191,382,14,44,Tie
13103,JointPQPlayer,263,268,531,55,8,JointPQPlayer
13104,JointPQPlayer,190,185,375,16,47,Player A
13105,JointPQPlayer,241,241,482,42,20,Tie
13106,JointPQPlayer,243,248,491,36,15,JointPQPlayer
13107,JointPQPlayer,180,180,360,7,49,Tie
13108,JointPQPlayer,233,233,466,35,23,Tie
13109,JointPQPlayer,236,236,472,44,24,Tie
13110,JointPQPlayer,210,205,415,23,36,Player A
13111,JointPQPlayer,187,192,379,11,44,JointPQPlayer
13112,JointPQPlayer,206,206,412,20,36,Tie
13113,JointPQPlayer,272,267,539,54,5,Player A
13114,JointPQPlayer,251,251,502,50,16,Tie
13115,JointPQPlayer,267,267,534,49,5,Tie
13116,JointPQPlayer,256,261,517,50,11,JointPQPlayer
13117,JointPQPlayer,262,257,519,49,10,Player A
13118,JointPQPlayer,273,273,546,61,5,Tie
13119,JointPQPlayer,211,211,422,18,32,Tie
13120,JointPQPlayer,257,257,514,47,11,Tie
13121,JointPQPlayer,224,224,448,32,28,Tie
13122,JointPQPlayer,242,242,484,38,18,Tie
13123,JointPQPlayer,258,258,516,49,11,Tie
13124,JointPQPlayer,248,248,496,38,14,Tie
13125,JointPQPlayer,255,260,515,51,12,JointPQPlayer
13126,JointPQPlayer,260,260,520,47,9,Tie
13127,JointPQPlayer,167,162,329,9,60,Player A
13128,JointPQPlayer,271,271,542,54,4,Tie
13129,JointPQPlayer,256,256,512,42,10,Tie
13130,JointPQPlayer,229,234,463,38,25,JointPQPlayer
13131,JointPQPlayer,261,256,517,47,10,Player A
13132,JointPQPlayer,241,241,482,33,17,Tie
13133,JointPQPlayer,221,221,442,35,31,Tie
13134,JointPQPlayer,228,233,461,36,25,JointPQPlayer
13135,JointPQPlayer,224,224,448,35,29,Tie
13136,JointPQPlayer,231,226,457,44,29,Player A
13137,JointPQPlayer,263,263,526,53,9,Tie
13138,JointPQPlayer,257,262,519,46,9,JointPQPlayer
13139,JointPQPlayer,266,261,527,51,8,Player A
13140,JointPQPlayer,182,187,369,4,45,JointPQPlayer
13141,JointPQPlayer,265,265,530,51,7,Tie
13142,JointPQPlayer,265,260,525,52,9,Player A
13143,JointPQPlayer,222,222,444,28,28,Tie
13144,JointPQPlayer,218,218,436,29,31,Tie
13145,JointPQPlayer,216,216,432,31,33,Tie
13146,JointPQPlayer,240,240,480,40,20,Tie
13147,JointPQPlayer,230,230,460,35,25,Tie
13148,JointPQPlayer,258,258,516,40,8,Tie
13149,JointPQPlayer,252,252,504,46,14,Tie
13150,JointPQPlayer,250,255,505,50,15,JointPQPlayer
13151,JointPQPlayer,180,175,355,11,52,Player A
13152,JointPQPlayer,212,212,424,26,34,Tie
13153,JointPQPlayer,221,221,442,32,30,Tie
13154,JointPQPlayer,232,237,469,41,24,JointPQPlayer
13155,JointPQPlayer,267,262,529,56,9,Player A
13156,JointPQPlayer,256,256,512,45,11,Tie
13157,JointPQPlayer,206,206,412,26,38,Tie
13158,JointPQPlayer,206,206,412,20,36,Tie
13159,JointPQPlayer,266,266,532,56,8,Tie
13160,JointPQPlayer,265,265,530,54,8,Tie
13161,JointPQPlayer,238,238,476,39,21,Tie
13162,JointPQPlayer,259,264,523,56,11,JointPQPlayer
13163,JointPQPlayer,260,255,515,42,9,Player A
13164,JointPQPlayer,175,180,355,8,51,JointPQPlayer
13165,JointPQPlayer,269,264,533,54,7,Player A
13166,JointPQPlayer,198,198,396,13,39,Tie
13167,JointPQPlayer,267,272,539,54,5,JointPQPlayer
13168,JointPQPlayer,265,260,525,49,8,Player A
13169,JointPQPlayer,253,253,506,45,13,Tie
13170,JointPQPlayer,274,274,548,57,3,Tie
13171,JointPQPlayer,258,258,516,52,12,Tie
13172,JointPQPlayer,262,262,524,51,9,Tie
13173,JointPQPlayer,199,204,403,26,41,JointPQPlayer
13174,JointPQPlayer,253,248,501,46,15,Player A
13175,JointPQPlayer,255,255,510,46,12,Tie
13176,JointPQPlayer,227,227,454,29,25,Tie
13177,JointPQPlayer,248,248,496,44,16,Tie
13178,JointPQPlayer,262,262,524,48,8,Tie
13179,JointPQPlayer,260,260,520,38,6,Tie
13180,JointPQPlayer,242,242,484,32,16,Tie
13181,JointPQPlayer,267,267,534,55,7,Tie
13182,JointPQPlayer,250,250,500,45,15,Tie
13183,JointPQPlayer,234,234,468,46,26,Tie
13184,JointPQPlayer,189,194,383,12,43,JointPQPlayer
13185,JointPQPlayer,262,257,519,55,12,Player A
13186,JointPQPlayer,247,247,494,36,14,Tie
13187,JointPQPlayer,270,270,540,61,7,Tie
13188,JointPQPlayer,278,278,556,62,2,Tie
13189,JointPQPlayer,255,255,510,37,9,Tie
13190,JointPQPlayer,266,271,537,58,7,JointPQPlayer
13191,JointPQPlayer,223,223,446,33,29,Tie
13192,JointPQPlayer,257,252,509,51,14,Player A
13193,JointPQPlayer,260,260,520,47,9,Tie
13194,JointPQPlayer,246,246,492,43,17,Tie
13195,JointPQPlayer,243,243,486,40,18,Tie
13196,JointPQPlayer,259,259,518,42,8,Tie
13197,JointPQPlayer,256,261,517,50,11,JointPQPlayer
13198,JointPQPlayer,245,240,485,48,21,Player A
13199,JointPQPlayer,179,184,363,7,48,JointPQPlayer
13200,JointPQPlayer,275,270,545,57,4,Player A
13201,JointPQPlayer,247,247,494,36,14,Tie
13202,JointPQPlayer,262,262,524,48,8,Tie
13203,JointPQPlayer,181,186,367,8,47,JointPQPlayer
13204,JointPQPlayer,258,253,511,44,11,Player A
13205,JointPQPlayer,245,245,490,38,16,Tie
13206,JointPQPlayer,265,265,530,57,9,Tie
13207,JointPQPlayer,259,259,518,48,10,Tie
13208,JointPQPlayer,260,260,520,41,7,Tie
13209,JointPQPlayer,252,257,509,39,10,JointPQPlayer
13210,JointPQPlayer,163,163,326,3,59,Tie
13211,JointPQPlayer,256,256,512,42,10,Tie
13212,JointPQPlayer,255,250,505,38,11,Player A
13213,JointPQPlayer,247,252,499,44,15,JointPQPlayer
13214,JointPQPlayer,262,257,519,46,9,Player A
13215,JointPQPlayer,237,237,474,34,20,Tie
13216,JointPQPlayer,165,170,335,9,58,JointPQPlayer
13217,JointPQPlayer,188,188,376,5,43,Tie
13218,JointPQPlayer,266,261,527,51,8,Player A
13219,JointPQPlayer,263,263,526,56,10,Tie
13220,JointPQPlayer,244,249,493,38,15,JointPQPlayer
13221,JointPQPlayer,252,247,499,47,16,Player A
13222,JointPQPlayer,255,260,515,39,8,JointPQPlayer
13223,JointPQPlayer,265,260,525,52,9,Player A
13224,JointPQPlayer,271,271,542,57,5,Tie
13225,JointPQPlayer,198,198,396,22,42,Tie
13226,JointPQPlayer,261,261,522,49,9,Tie
13227,JointPQPlayer,271,271,542,57,5,Tie
13228,JointPQPlayer,250,255,505,44,13,JointPQPlayer
13229,JointPQPlayer,261,256,517,44,9,Player A
13230,JointPQPlayer,229,234,463,44,27,JointPQPlayer
13231,JointPQPlayer,248,243,491,36,15,Player A
13232,JointPQPlayer,242,242,484,32,16,Tie
13233,JointPQPlayer,256,256,512,45,11,Tie
13234,JointPQPlayer,253,253,506,33,9,Tie
13235,JointPQPlayer,241,241,482,39,19,Tie
13236,JointPQPlayer,264,264,528,46,6,Tie
13237,JointPQPlayer,164,169,333,7,58,JointPQPlayer
13238,JointPQPlayer,248,243,491,42,17,Player A
13239,JointPQPlayer,273,273,546,58,4,Tie
13240,JointPQPlayer,222,222,444,31,29,Tie
13241,JointPQPlayer,262,262,524,54,10,Tie
13242,JointPQPlayer,260,260,520,44,8,Tie
13243,JointPQPlayer,230,230,460,32,24,Tie
13244,JointPQPlayer,268,268,536,57,7,Tie
13245,JointPQPlayer,254,254,508,44,12,Tie
13246,JointPQPlayer,252,257,509,48,13,JointPQPlayer
13247,JointPQPlayer,247,247,494,42,16,Tie
13248,JointPQPlayer,267,262,529,50,7,Player A
13249,JointPQPlayer,258,258,516,49,11,Tie
13250,JointPQPlayer,274,274,548,63,5,Tie
13251,JointPQPlayer,276,276,552,61,3,Tie
13252,JointPQPlayer,194,194,388,17,43,Tie
13253,JointPQPlayer,198,203,401,18,39,JointPQPlayer
13254,JointPQPlayer,274,269,543,58,5,Player A
13255,JointPQPlayer,204,204,408,19,37,Tie
13256,JointPQPlayer,182,182,364,8,48,Tie
13257,JointPQPlayer,187,187,374,18,48,Tie
13258,JointPQPlayer,264,264,528,49,7,Tie
13259,JointPQPlayer,250,255,505,38,11,JointPQPlayer
13260,JointPQPlayer,260,255,515,48,11,Player A
13261,JointPQPlayer,259,264,523,41,6,JointPQPlayer
13262,JointPQPlayer,242,237,479,36,19,Player A
13263,JointPQPlayer,264,269,533,51,6,JointPQPlayer
13264,JointPQPlayer,215,215,430,26,32,Tie
13265,JointPQPlayer,247,247,494,42,16,Tie
13266,JointPQPlayer,181,181,362,6,48,Tie
13267,JointPQPlayer,162,157,319,5,62,Player A
13268,JointPQPlayer,247,247,494,39,15,Tie
13269,JointPQPlayer,265,265,530,54,8,Tie
13270,JointPQPlayer,233,233,466,38,24,Tie
13271,JointPQPlayer,256,256,512,54,14,Tie
13272,JointPQPlayer,252,257,509,51,14,JointPQPlayer
13273,JointPQPlayer,253,253,506,42,12,Tie
13274,JointPQPlayer,255,250,505,47,14,Player A
13275,JointPQPlayer,245,250,495,49,18,JointPQPlayer
13276,JointPQPlayer,204,199,403,26,41,Player A
13277,JointPQPlayer,192,192,384,22,46,Tie
13278,JointPQPlayer,242,247,489,43,18,JointPQPlayer
13279,JointPQPlayer,258,253,511,50,13,Player A
13280,JointPQPlayer,268,268,536,51,5,Tie
13281,JointPQPlayer,222,222,444,34,30,Tie
13282,JointPQPlayer,223,223,446,30,28,Tie
13283,JointPQPlayer,242,247,489,43,18,JointPQPlayer
13284,JointPQPlayer,247,247,494,42,16,Tie
13285,JointPQPlayer,262,257,519,52,11,Player A
13286,JointPQPlayer,223,228,451,41,30,JointPQPlayer
13287,JointPQPlayer,196,196,392,18,42,Tie
13288,JointPQPlayer,264,264,528,52,8,Tie
13289,JointPQPlayer,270,270,540,52,4,Tie
13290,JointPQPlayer,272,267,539,54,5,Player A
13291,JointPQPlayer,213,213,426,22,32,Tie
13292,JointPQPlayer,268,268,536,51,5,Tie
13293,JointPQPlayer,171,176,347,12,55,JointPQPlayer
13294,JointPQPlayer,257,257,514,44,10,Tie
13295,JointPQPlayer,264,259,523,53,10,Player A
13296,JointPQPlayer,263,263,526,50,8,Tie
13297,JointPQPlayer,255,255,510,43,11,Tie
13298,JointPQPlayer,261,261,522,46,8,Tie
13299,JointPQPlayer,185,190,375,7,44,JointPQPlayer
13300,JointPQPlayer,237,232,469,29,20,Player A
13301,JointPQPlayer,249,254,503,45,14,JointPQPlayer
13302,JointPQPlayer,239,234,473,39,22,Player A
13303,JointPQPlayer,258,258,516,49,11,Tie
13304,JointPQPlayer,258,258,516,46,10,Tie
13305,JointPQPlayer,249,249,498,46,16,Tie
13306,JointPQPlayer,221,226,447,28,27,JointPQPlayer
13307,JointPQPlayer,260,260,520,50,10,Tie
13308,JointPQPlayer,244,239,483,34,17,Player A
13309,JointPQPlayer,258,258,516,52,12,Tie
13310,JointPQPlayer,227,232,459,34,25,JointPQPlayer
13311,JointPQPlayer,157,157,314,3,63,Tie
13312,JointPQPlayer,229,224,453,25,24,Player A
13313,JointPQPlayer,255,255,510,40,10,Tie
13314,JointPQPlayer,168,168,336,10,58,Tie
13315,JointPQPlayer,178,183,361,11,50,JointPQPlayer
13316,JointPQPlayer,260,255,515,45,10,Player A
13317,JointPQPlayer,238,243,481,41,20,JointPQPlayer
13318,JointPQPlayer,254,249,503,45,14,Player A
13319,JointPQPlayer,247,247,494,39,15,Tie
13320,JointPQPlayer,255,255,510,49,13,Tie
13321,JointPQPlayer,174,179,353,6,51,JointPQPlayer
13322,JointPQPlayer,260,255,515,42,9,Player A
13323,JointPQPlayer,255,255,510,43,11,Tie
13324,JointPQPlayer,205,210,415,23,36,JointPQPlayer
13325,JointPQPlayer,230,225,455,36,27,Player A
13326,JointPQPlayer,190,190,380,9,43,Tie
13327,JointPQPlayer,197,202,399,16,39,JointPQPlayer
13328,JointPQPlayer,265,260,525,55,10,Player A
13329,JointPQPlayer,271,271,542,54,4,Tie
13330,JointPQPlayer,255,255,510,49,13,Tie
13331,JointPQPlayer,263,263,526,53,9,Tie
13332,JointPQPlayer,260,265,525,52,9,JointPQPlayer
13333,JointPQPlayer,249,249,498,40,14,Tie
13334,JointPQPlayer,199,194,393,19,42,Player A
13335,JointPQPlayer,244,244,488,42,18,Tie
13336,JointPQPlayer,253,258,511,47,12,JointPQPlayer
13337,JointPQPlayer,254,254,508,44,12,Tie
13338,JointPQPlayer,253,248,501,49,16,Player A
13339,JointPQPlayer,170,170,340,8,56,Tie
13340,JointPQPlayer,265,270,535,56,7,JointPQPlayer
13341,JointPQPlayer,259,259,518,42,8,Tie
13342,JointPQPlayer,269,264,533,54,7,Player A
13343,JointPQPlayer,250,250,500,45,15,Tie
13344,JointPQPlayer,179,179,358,11,51,Tie
13345,JointPQPlayer,236,241,477,34,19,JointPQPlayer
13346,JointPQPlayer,251,246,497,48,17,Player A
13347,JointPQPlayer,245,250,495,46,17,JointPQPlayer
13348,JointPQPlayer,230,225,455,27,24,Player A
13349,JointPQPlayer,252,257,509,42,11,JointPQPlayer
13350,JointPQPlayer,235,235,470,48,26,Tie
13351,JointPQPlayer,254,254,508,41,11,Tie
13352,JointPQPlayer,262,257,519,46,9,Player A
13353,JointPQPlayer,262,262,524,51,9,Tie
13354,JointPQPlayer,232,232,464,30,22,Tie
13355,JointPQPlayer,269,269,538,53,5,Tie
13356,JointPQPlayer,201,206,407,21,38,JointPQPlayer
13357,JointPQPlayer,213,213,426,22,32,Tie
13358,JointPQPlayer,252,247,499,47,16,Player A
13359,JointPQPlayer,244,249,493,35,14,JointPQPlayer
13360,JointPQPlayer,273,268,541,59,6,Player A
13361,JointPQPlayer,172,177,349,5,52,JointPQPlayer
13362,JointPQPlayer,260,255,515,39,8,Player A
13363,JointPQPlayer,255,255,510,43,11,Tie
13364,JointPQPlayer,249,249,498,40,14,Tie
13365,JointPQPlayer,255,260,515,51,12,JointPQPlayer
13366,JointPQPlayer,203,198,401,24,41,Player A
13367,JointPQPlayer,229,234,463,35,24,JointPQPlayer
13368,JointPQPlayer,251,246,497,39,14,Player A
13369,JointPQPlayer,262,262,524,48,8,Tie
13370,JointPQPlayer,208,213,421,26,35,JointPQPlayer
13371,JointPQPlayer,248,243,491,42,17,Player A
13372,JointPQPlayer,268,268,536,57,7,Tie
13373,JointPQPlayer,263,263,526,50,8,Tie
13374,JointPQPlayer,164,164,328,5,59,Tie
13375,JointPQPlayer,196,201,397,14,39,JointPQPlayer
13376,JointPQPlayer,261,256,517,47,10,Player A
13377,JointPQPlayer,244,244,488,33,15,Tie
13378,JointPQPlayer,261,261,522,52,10,Tie
13379,JointPQPlayer,234,234,468,34,22,Tie
13380,JointPQPlayer,252,257,509,48,13,JointPQPlayer
13381,JointPQPlayer,228,223,451,35,28,Player A
13382,JointPQPlayer,256,261,517,53,12,JointPQPlayer
13383,JointPQPlayer,249,244,493,35,14,Player A
13384,JointPQPlayer,263,268,531,52,7,JointPQPlayer
13385,JointPQPlayer,192,187,379,11,44,Player A
13386,JointPQPlayer,209,209,418,20,34,Tie
13387,JointPQPlayer,258,263,521,45,8,JointPQPlayer
13388,JointPQPlayer,234,229,463,32,23,Player A
13389,JointPQPlayer,268,268,536,57,7,Tie
13390,JointPQPlayer,263,263,526,56,10,Tie
13391,JointPQPlayer,266,266,532,62,10,Tie
13392,JointPQPlayer,251,256,507,43,12,JointPQPlayer
13393,JointPQPlayer,262,262,524,51,9,Tie
13394,JointPQPlayer,219,214,433,32,33,Player A
13395,JointPQPlayer,261,266,527,51,8,JointPQPlayer
13396,JointPQPlayer,213,213,426,25,33,Tie
13397,JointPQPlayer,250,245,495,49,18,Player A
13398,JointPQPlayer,213,218,431,24,31,JointPQPlayer
13399,JointPQPlayer,258,253,511,41,10,Player A
13400,JointPQPlayer,176,181,357,10,51,JointPQPlayer
13401,JointPQPlayer,267,267,534,52,6,Tie
13402,JointPQPlayer,261,256,517,47,10,Player A
13403,JointPQPlayer,272,272,544,62,6,Tie
13404,JointPQPlayer,263,268,531,52,7,JointPQPlayer
13405,JointPQPlayer,247,242,489,43,18,Player A
13406,JointPQPlayer,262,262,524,48,8,Tie
13407,JointPQPlayer,266,266,532,56,8,Tie
13408,JointPQPlayer,262,262,524,54,10,Tie
13409,JointPQPlayer,275,275,550,59,3,Tie
13410,JointPQPlayer,258,258,516,49,11,Tie
13411,JointPQPlayer,171,176,347,9,54,JointPQPlayer
13412,JointPQPlayer,254,249,503,45,14,Player A
13413,JointPQPlayer,194,199,393,13,40,JointPQPlayer
13414,JointPQPlayer,270,265,535,50,5,Player A
13415,JointPQPlayer,188,193,381,7,42,JointPQPlayer
13416,JointPQPlayer,141,141,282,1,73,Tie
13417,JointPQPlayer,260,255,515,54,13,Player A
13418,JointPQPlayer,236,241,477,40,21,JointPQPlayer
13419,JointPQPlayer,178,173,351,13,54,Player A
13420,JointPQPlayer,262,262,524,54,10,Tie
13421,JointPQPlayer,248,248,496,41,15,Tie
13422,JointPQPlayer,250,255,505,41,12,JointPQPlayer
13423,JointPQPlayer,183,178,361,14,51,Player A
13424,JointPQPlayer,246,246,492,43,17,Tie
13425,JointPQPlayer,239,239,478,41,21,Tie
13426,JointPQPlayer,251,251,502,41,13,Tie
13427,JointPQPlayer,262,262,524,48,8,Tie
13428,JointPQPlayer,269,269,538,53,5,Tie
13429,JointPQPlayer,251,251,502,41,13,Tie
13430,JointPQPlayer,257,257,514,44,10,Tie
13431,JointPQPlayer,254,259,513,46,11,JointPQPlayer
13432,JointPQPlayer,252,247,499,41,14,Player A
13433,JointPQPlayer,236,241,477,34,19,JointPQPlayer
13434,JointPQPlayer,254,249,503,45,14,Player A
13435,JointPQPlayer,267,267,534,46,4,Tie
13436,JointPQPlayer,245,250,495,43,16,JointPQPlayer
13437,JointPQPlayer,178,178,356,9,51,Tie
13438,JointPQPlayer,260,260,520,59,13,Tie
13439,JointPQPlayer,184,179,363,7,48,Player A
13440,JointPQPlayer,257,262,519,43,8,JointPQPlayer
13441,JointPQPlayer,238,238,476,36,20,Tie
13442,JointPQPlayer,173,168,341,6,55,Player A
13443,JointPQPlayer,267,267,534,58,8,Tie
13444,JointPQPlayer,225,230,455,33,26,JointPQPlayer
13445,JointPQPlayer,252,252,504,49,15,Tie
13446,JointPQPlayer,253,253,506,45,13,Tie
13447,JointPQPlayer,230,225,455,39,28,Player A
13448,JointPQPlayer,224,229,453,40,29,JointPQPlayer
13449,JointPQPlayer,266,261,527,48,7,Player A
13450,JointPQPlayer,254,254,508,44,12,Tie
13451,JointPQPlayer,183,188,371,6,45,JointPQPlayer
13452,JointPQPlayer,258,253,511,47,12,Player A
13453,JointPQPlayer,230,230,460,38,26,Tie
13454,JointPQPlayer,257,257,514,50,12,Tie
13455,JointPQPlayer,263,263,526,53,9,Tie
13456,JointPQPlayer,254,254,508,50,14,Tie
13457,JointPQPlayer,248,253,501,46,15,JointPQPlayer
13458,JointPQPlayer,175,175,350,9,53,Tie
13459,JointPQPlayer,251,251,502,41,13,Tie
13460,JointPQPlayer,265,260,525,49,8,Player A
13461,JointPQPlayer,249,254,503,39,12,JointPQPlayer
13462,JointPQPlayer,261,256,517,50,11,Player A
13463,JointPQPlayer,240,240,480,40,20,Tie
13464,JointPQPlayer,225,225,450,37,29,Tie
13465,JointPQPlayer,206,211,417,19,34,JointPQPlayer
13466,JointPQPlayer,255,255,510,46,12,Tie
13467,JointPQPlayer,248,243,491,45,18,Player A
13468,JointPQPlayer,187,187,374,9,45,Tie
13469,JointPQPlayer,165,165,330,7,59,Tie
13470,JointPQPlayer,177,177,354,13,53,Tie
13471,JointPQPlayer,245,250,495,46,17,JointPQPlayer
13472,JointPQPlayer,259,254,513,52,13,Player A
13473,JointPQPlayer,233,238,471,40,23,JointPQPlayer
13474,JointPQPlayer,232,232,464,42,26,Tie
13475,JointPQPlayer,264,259,523,47,8,Player A
13476,JointPQPlayer,227,232,459,31,24,JointPQPlayer
13477,JointPQPlayer,244,239,483,37,18,Player A
13478,JointPQPlayer,244,244,488,42,18,Tie
13479,JointPQPlayer,253,253,506,45,13,Tie
13480,JointPQPlayer,254,254,508,41,11,Tie
13481,JointPQPlayer,236,241,477,34,19,JointPQPlayer
13482,JointPQPlayer,256,251,507,46,13,Player A
13483,JointPQPlayer,243,243,486,43,19,Tie
13484,JointPQPlayer,245,250,495,43,16,JointPQPlayer
13485,JointPQPlayer,241,236,477,34,19,Player A
13486,JointPQPlayer,234,234,468,37,23,Tie
13487,JointPQPlayer,254,259,513,40,9,JointPQPlayer
13488,JointPQPlayer,253,248,501,52,17,Player A
13489,JointPQPlayer,177,177,354,10,52,Tie
13490,JointPQPlayer,253,253,506,45,13,Tie
13491,JointPQPlayer,251,251,502,38,12,Tie
13492,JointPQPlayer,237,237,474,37,21,Tie
13493,JointPQPlayer,170,175,345,4,53,JointPQPlayer
13494,JointPQPlayer,248,243,491,45,18,Player A
13495,JointPQPlayer,267,267,534,49,5,Tie
13496,JointPQPlayer,158,163,321,13,64,JointPQPlayer
13497,JointPQPlayer,226,221,447,34,29,Player A
13498,JointPQPlayer,178,183,361,8,49,JointPQPlayer
13499,JointPQPlayer,232,227,459,28,23,Player A
13500,JointPQPlayer,243,243,486,37,17,Tie
13501,JointPQPlayer,248,253,501,49,16,JointPQPlayer
13502,JointPQPlayer,170,170,340,5,55,Tie
13503,JointPQPlayer,248,243,491,45,18,Player A
13504,JointPQPlayer,252,252,504,43,13,Tie
13505,JointPQPlayer,158,163,321,4,61,JointPQPlayer
13506,JointPQPlayer,233,233,466,29,21,Tie
13507,JointPQPlayer,179,179,358,8,50,Tie
13508,JointPQPlayer,180,180,360,7,49,Tie
13509,JointPQPlayer,233,228,461,33,24,Player A
13510,JointPQPlayer,237,242,479,36,19,JointPQPlayer
13511,JointPQPlayer,257,257,514,50,12,Tie
13512,JointPQPlayer,191,186,377,15,46,Player A
13513,JointPQPlayer,260,260,520,44,8,Tie
13514,JointPQPlayer,265,265,530,48,6,Tie
13515,JointPQPlayer,267,267,534,52,6,Tie
13516,JointPQPlayer,262,262,524,45,7,Tie
13517,JointPQPlayer,262,262,524,51,9,Tie
13518,JointPQPlayer,264,269,533,48,5,JointPQPlayer
13519,JointPQPlayer,264,259,523,50,9,Player A
13520,JointPQPlayer,254,254,508,47,13,Tie
13521,JointPQPlayer,260,260,520,53,11,Tie
13522,JointPQPlayer,253,253,506,45,13,Tie
13523,JointPQPlayer,248,253,501,40,13,JointPQPlayer
13524,JointPQPlayer,257,252,509,45,12,Player A
13525,JointPQPlayer,178,183,361,8,49,JointPQPlayer
13526,JointPQPlayer,253,253,506,45,13,Tie
13527,JointPQPlayer,253,253,506,45,13,Tie
13528,JointPQPlayer,262,262,524,48,8,Tie
13529,JointPQPlayer,260,255,515,51,12,Player A
13530,JointPQPlayer,250,250,500,45,15,Tie
13531,JointPQPlayer,274,274,548,60,4,Tie
13532,JointPQPlayer,254,259,513,49,12,JointPQPlayer
13533,JointPQPlayer,183,178,361,14,51,Player A
13534,JointPQPlayer,232,237,469,38,23,JointPQPlayer
13535,JointPQPlayer,206,206,412,14,34,Tie
13536,JointPQPlayer,245,245,490,38,16,Tie
13537,JointPQPlayer,257,252,509,42,11,Player A
13538,JointPQPlayer,240,240,480,34,18,Tie
13539,JointPQPlayer,275,275,550,65,5,Tie
13540,JointPQPlayer,232,232,464,27,21,Tie
13541,JointPQPlayer,251,251,502,47,15,Tie
13542,JointPQPlayer,197,197,394,23,43,Tie
13543,JointPQPlayer,237,237,474,46,24,Tie
13544,JointPQPlayer,274,274,548,57,3,Tie
13545,JointPQPlayer,178,178,356,6,50,Tie
13546,JointPQPlayer,223,223,446,30,28,Tie
13547,JointPQPlayer,237,237,474,37,21,Tie
13548,JointPQPlayer,179,184,363,4,47,JointPQPlayer
13549,JointPQPlayer,232,227,459,37,26,Player A
13550,JointPQPlayer,230,230,460,29,23,Tie
13551,JointPQPlayer,188,188,376,11,45,Tie
13552,JointPQPlayer,256,261,517,44,9,JointPQPlayer
13553,JointPQPlayer,246,241,487,47,20,Player A
13554,JointPQPlayer,256,256,512,45,11,Tie
13555,JointPQPlayer,191,191,382,11,43,Tie
13556,JointPQPlayer,251,251,502,47,15,Tie
13557,JointPQPlayer,236,241,477,43,22,JointPQPlayer
13558,JointPQPlayer,255,250,505,44,13,Player A
13559,JointPQPlayer,256,261,517,50,11,JointPQPlayer
13560,JointPQPlayer,238,238,476,45,23,Tie
13561,JointPQPlayer,190,190,380,9,43,Tie
13562,JointPQPlayer,200,200,400,23,41,Tie
13563,JointPQPlayer,260,255,515,48,11,Player A
13564,JointPQPlayer,267,267,534,52,6,Tie
13565,JointPQPlayer,190,190,380,12,44,Tie
13566,JointPQPlayer,263,263,526,53,9,Tie
13567,JointPQPlayer,260,265,525,52,9,JointPQPlayer
13568,JointPQPlayer,269,269,538,65,9,Tie
13569,JointPQPlayer,268,268,536,54,6,Tie
13570,JointPQPlayer,195,190,385,17,44,Player A
13571,JointPQPlayer,246,246,492,43,17,Tie
13572,JointPQPlayer,259,259,518,45,9,Tie
13573,JointPQPlayer,255,255,510,43,11,Tie
13574,JointPQPlayer,187,192,379,14,45,JointPQPlayer
13575,JointPQPlayer,261,256,517,50,11,Player A
13576,JointPQPlayer,266,266,532,53,7,Tie
13577,JointPQPlayer,176,181,357,4,49,JointPQPlayer
13578,JointPQPlayer,220,215,435,22,29,Player A
13579,JointPQPlayer,186,191,377,18,47,JointPQPlayer
13580,JointPQPlayer,246,241,487,47,20,Player A
13581,JointPQPlayer,224,224,448,35,29,Tie
13582,JointPQPlayer,252,257,509,54,15,JointPQPlayer
13583,JointPQPlayer,252,252,504,46,14,Tie
13584,JointPQPlayer,254,249,503,42,13,Player A
13585,JointPQPlayer,273,273,546,58,4,Tie
13586,JointPQPlayer,258,258,516,55,13,Tie
13587,JointPQPlayer,257,257,514,38,8,Tie
13588,JointPQPlayer,254,259,513,43,10,JointPQPlayer
13589,JointPQPlayer,230,225,455,36,27,Player A
13590,JointPQPlayer,183,188,371,12,47,JointPQPlayer
13591,JointPQPlayer,255,255,510,46,12,Tie
13592,JointPQPlayer,190,185,375,10,45,Player A
13593,JointPQPlayer,258,258,516,52,12,Tie
13594,JointPQPlayer,248,253,501,43,14,JointPQPlayer
13595,JointPQPlayer,264,259,523,53,10,Player A
13596,JointPQPlayer,250,250,500,42,14,Tie
13597,JointPQPlayer,234,234,468,37,23,Tie
13598,JointPQPlayer,255,255,510,43,11,Tie
13599,JointPQPlayer,186,186,372,7,45,Tie
13600,JointPQPlayer,255,260,515,48,11,JointPQPlayer
13601,JointPQPlayer,228,223,451,32,27,Player A
13602,JointPQPlayer,229,229,458,39,27,Tie
13603,JointPQPlayer,241,241,482,36,18,Tie
13604,JointPQPlayer,264,264,528,49,7,Tie
13605,JointPQPlayer,252,257,509,42,11,JointPQPlayer
13606,JointPQPlayer,261,256,517,47,10,Player A
13607,JointPQPlayer,202,207,409,23,38,JointPQPlayer
13608,JointPQPlayer,275,275,550,65,5,Tie
13609,JointPQPlayer,257,257,514,44,10,Tie
13610,JointPQPlayer,266,261,527,48,7,Player A
13611,JointPQPlayer,251,251,502,44,14,Tie
13612,JointPQPlayer,241,241,482,42,20,Tie
13613,JointPQPlayer,211,216,427,32,35,JointPQPlayer
13614,JointPQPlayer,219,214,433,35,34,Player A
13615,JointPQPlayer,186,191,377,9,44,JointPQPlayer
13616,JointPQPlayer,249,244,493,41,16,Player A
13617,JointPQPlayer,249,254,503,39,12,JointPQPlayer
13618,JointPQPlayer,240,235,475,35,20,Player A
13619,JointPQPlayer,182,182,364,5,47,Tie
13620,JointPQPlayer,246,246,492,43,17,Tie
13621,JointPQPlayer,250,250,500,39,13,Tie
13622,JointPQPlayer,200,205,405,22,39,JointPQPlayer
13623,JointPQPlayer,174,174,348,4,52,Tie
13624,JointPQPlayer,258,253,511,47,12,Player A
13625,JointPQPlayer,233,233,466,38,24,Tie
13626,JointPQPlayer,255,260,515,51,12,JointPQPlayer
13627,JointPQPlayer,246,246,492,55,21,Tie
13628,JointPQPlayer,266,261,527,48,7,Player A
13629,JointPQPlayer,234,239,473,36,21,JointPQPlayer
13630,JointPQPlayer,193,188,381,13,44,Player A
13631,JointPQPlayer,248,248,496,41,15,Tie
13632,JointPQPlayer,250,250,500,45,15,Tie
13633,JointPQPlayer,265,265,530,48,6,Tie
13634,JointPQPlayer,250,250,500,45,15,Tie
13635,JointPQPlayer,271,271,542,54,4,Tie
13636,JointPQPlayer,259,259,518,48,10,Tie
13637,JointPQPlayer,269,269,538,56,6,Tie
13638,JointPQPlayer,262,262,524,48,8,Tie
13639,JointPQPlayer,177,182,359,6,49,JointPQPlayer
13640,JointPQPlayer,257,257,514,41,9,Tie
13641,JointPQPlayer,261,256,517,53,12,Player A
13642,JointPQPlayer,259,264,523,50,9,JointPQPlayer
13643,JointPQPlayer,202,197,399,22,41,Player A
13644,JointPQPlayer,254,259,513,43,10,JointPQPlayer
13645,JointPQPlayer,243,238,481,44,21,Player A
13646,JointPQPlayer,272,272,544,53,3,Tie
13647,JointPQPlayer,281,281,562,65,1,Tie
13648,JointPQPlayer,250,255,505,47,14,JointPQPlayer
13649,JointPQPlayer,252,247,499,44,15,Player A
13650,JointPQPlayer,234,234,468,34,22,Tie
13651,JointPQPlayer,265,265,530,51,7,Tie
13652,JointPQPlayer,258,258,516,43,9,Tie
13653,JointPQPlayer,226,226,452,27,25,Tie
13654,JointPQPlayer,168,173,341,12,57,JointPQPlayer
13655,JointPQPlayer,256,251,507,37,10,Player A
13656,JointPQPlayer,171,176,347,6,53,JointPQPlayer
13657,JointPQPlayer,186,186,372,10,46,Tie
13658,JointPQPlayer,259,259,518,39,7,Tie
13659,JointPQPlayer,196,196,392,21,43,Tie
13660,JointPQPlayer,256,256,512,45,11,Tie
13661,JointPQPlayer,167,167,334,2,56,Tie
13662,JointPQPlayer,258,253,511,47,12,Player A
13663,JointPQPlayer,259,264,523,53,10,JointPQPlayer
13664,JointPQPlayer,226,226,452,33,27,Tie
13665,JointPQPlayer,265,265,530,57,9,Tie
13666,JointPQPlayer,264,264,528,55,9,Tie
13667,JointPQPlayer,240,235,475,32,19,Player A
13668,JointPQPlayer,260,260,520,47,9,Tie
13669,JointPQPlayer,187,192,379,8,43,JointPQPlayer
13670,JointPQPlayer,247,242,489,46,19,Player A
13671,JointPQPlayer,248,248,496,47,17,Tie
13672,JointPQPlayer,181,181,362,6,48,Tie
13673,JointPQPlayer,246,246,492,37,15,Tie
13674,JointPQPlayer,258,263,521,48,9,JointPQPlayer
13675,JointPQPlayer,199,199,398,21,41,Tie
13676,JointPQPlayer,172,172,344,9,55,Tie
13677,JointPQPlayer,246,241,487,41,18,Player A
13678,JointPQPlayer,262,262,524,51,9,Tie
13679,JointPQPlayer,230,235,465,46,27,JointPQPlayer
13680,JointPQPlayer,173,173,346,2,52,Tie
13681,JointPQPlayer,262,257,519,49,10,Player A
13682,JointPQPlayer,172,177,349,5,52,JointPQPlayer
13683,JointPQPlayer,267,267,534,52,6,Tie
13684,JointPQPlayer,245,245,490,44,18,Tie
13685,JointPQPlayer,253,248,501,43,14,Player A
13686,JointPQPlayer,230,235,465,40,25,JointPQPlayer
13687,JointPQPlayer,253,253,506,51,15,Tie
13688,JointPQPlayer,250,250,500,48,16,Tie
13689,JointPQPlayer,177,172,349,8,53,Player A
13690,JointPQPlayer,231,231,462,34,24,Tie
13691,JointPQPlayer,223,223,446,30,28,Tie
13692,JointPQPlayer,239,239,478,35,19,Tie
13693,JointPQPlayer,223,223,446,33,29,Tie
13694,JointPQPlayer,242,247,489,40,17,JointPQPlayer
13695,JointPQPlayer,260,260,520,50,10,Tie
13696,JointPQPlayer,246,241,487,44,19,Player A
13697,JointPQPlayer,270,270,540,55,5,Tie
13698,JointPQPlayer,222,227,449,30,27,JointPQPlayer
13699,JointPQPlayer,270,265,535,53,6,Player A
13700,JointPQPlayer,250,250,500,39,13,Tie
13701,JointPQPlayer,256,256,512,45,11,Tie
13702,JointPQPlayer,251,251,502,32,10,Tie
13703,JointPQPlayer,262,267,529,47,6,JointPQPlayer
13704,JointPQPlayer,247,247,494,42,16,Tie
13705,JointPQPlayer,262,262,524,51,9,Tie
13706,JointPQPlayer,153,153,306,4,66,Tie
13707,JointPQPlayer,181,181,362,9,49,Tie
13708,JointPQPlayer,181,181,362,12,50,Tie
13709,JointPQPlayer,269,264,533,51,6,Player A
13710,JointPQPlayer,239,239,478,50,24,Tie
13711,JointPQPlayer,266,266,532,50,6,Tie
13712,JointPQPlayer,193,193,386,21,45,Tie
13713,JointPQPlayer,241,246,487,35,16,JointPQPlayer
13714,JointPQPlayer,164,164,328,2,58,Tie
13715,JointPQPlayer,196,196,392,24,44,Tie
13716,JointPQPlayer,213,213,426,22,32,Tie
13717,JointPQPlayer,185,185,370,8,46,Tie
13718,JointPQPlayer,256,251,507,40,11,Player A
13719,JointPQPlayer,177,182,359,15,52,JointPQPlayer
13720,JointPQPlayer,159,154,313,5,64,Player A
13721,JointPQPlayer,255,255,510,43,11,Tie
13722,JointPQPlayer,232,232,464,30,22,Tie
13723,JointPQPlayer,162,167,329,6,59,JointPQPlayer
13724,JointPQPlayer,200,195,395,12,39,Player A
13725,JointPQPlayer,255,255,510,49,13,Tie
13726,JointPQPlayer,253,253,506,51,15,Tie
13727,JointPQPlayer,182,187,369,13,48,JointPQPlayer
13728,JointPQPlayer,249,244,493,44,17,Player A
13729,JointPQPlayer,185,185,370,8,46,Tie
13730,JointPQPlayer,263,268,531,46,5,JointPQPlayer
13731,JointPQPlayer,245,240,485,42,19,Player A
13732,JointPQPlayer,233,238,471,40,23,JointPQPlayer
13733,JointPQPlayer,252,252,504,40,12,Tie
13734,JointPQPlayer,260,260,520,56,12,Tie
13735,JointPQPlayer,242,237,479,36,19,Player A
13736,JointPQPlayer,257,257,514,41,9,Tie
13737,JointPQPlayer,250,250,500,42,14,Tie
13738,JointPQPlayer,236,236,472,41,23,Tie
13739,JointPQPlayer,266,271,537,55,6,JointPQPlayer
13740,JointPQPlayer,265,265,530,54,8,Tie
13741,JointPQPlayer,268,263,531,49,6,Player A
13742,JointPQPlayer,229,229,458,36,26,Tie
13743,JointPQPlayer,249,254,503,42,13,JointPQPlayer
13744,JointPQPlayer,259,254,513,43,10,Player A
13745,JointPQPlayer,171,171,342,7,55,Tie
13746,JointPQPlayer,254,259,513,55,14,JointPQPlayer
13747,JointPQPlayer,276,276,552,55,1,Tie
13748,JointPQPlayer,265,260,525,46,7,Player A
13749,JointPQPlayer,243,243,486,34,16,Tie
13750,JointPQPlayer,184,184,368,9,47,Tie
13751,JointPQPlayer,240,245,485,36,17,JointPQPlayer
13752,JointPQPlayer,255,250,505,44,13,Player A
13753,JointPQPlayer,153,158,311,6,65,JointPQPlayer
13754,JointPQPlayer,237,237,474,40,22,Tie
13755,JointPQPlayer,250,245,495,40,15,Player A
13756,JointPQPlayer,255,260,515,51,12,JointPQPlayer
13757,JointPQPlayer,239,234,473,36,21,Player A
13758,JointPQPlayer,270,275,545,57,4,JointPQPlayer
13759,JointPQPlayer,279,274,553,65,4,Player A
13760,JointPQPlayer,257,262,519,52,11,JointPQPlayer
13761,JointPQPlayer,267,262,529,59,10,Player A
13762,JointPQPlayer,245,245,490,41,17,Tie
13763,JointPQPlayer,244,244,488,36,16,Tie
13764,JointPQPlayer,202,207,409,26,39,JointPQPlayer
13765,JointPQPlayer,245,245,490,44,18,Tie
13766,JointPQPlayer,259,254,513,46,11,Player A
13767,JointPQPlayer,250,255,505,44,13,JointPQPlayer
13768,JointPQPlayer,271,266,537,52,5,Player A
13769,JointPQPlayer,197,197,394,23,43,Tie
13770,JointPQPlayer,253,253,506,48,14,Tie
13771,JointPQPlayer,251,256,507,40,11,JointPQPlayer
13772,JointPQPlayer,270,265,535,53,6,Player A
13773,JointPQPlayer,189,189,378,16,46,Tie
13774,JointPQPlayer,257,257,514,50,12,Tie
13775,JointPQPlayer,283,283,566,69,1,Tie
13776,JointPQPlayer,266,266,532,56,8,Tie
13777,JointPQPlayer,259,259,518,45,9,Tie
13778,JointPQPlayer,236,236,472,38,22,Tie
13779,JointPQPlayer,275,275,550,71,7,Tie
13780,JointPQPlayer,241,241,482,33,17,Tie
13781,JointPQPlayer,223,228,451,29,26,JointPQPlayer
13782,JointPQPlayer,246,246,492,46,18,Tie
13783,JointPQPlayer,204,199,403,8,35,Player A
13784,JointPQPlayer,172,177,349,8,53,JointPQPlayer
13785,JointPQPlayer,282,277,559,68,3,Player A
13786,JointPQPlayer,263,268,531,52,7,JointPQPlayer
13787,JointPQPlayer,259,254,513,46,11,Player A
13788,JointPQPlayer,241,241,482,45,21,Tie
13789,JointPQPlayer,263,263,526,47,7,Tie
13790,JointPQPlayer,258,258,516,49,11,Tie
13791,JointPQPlayer,265,265,530,48,6,Tie
13792,JointPQPlayer,270,270,540,55,5,Tie
13793,JointPQPlayer,236,241,477,43,22,JointPQPlayer
13794,JointPQPlayer,231,231,462,34,24,Tie
13795,JointPQPlayer,206,201,407,18,37,Player A
13796,JointPQPlayer,249,254,503,51,16,JointPQPlayer
13797,JointPQPlayer,252,247,499,44,15,Player A
13798,JointPQPlayer,261,261,522,40,6,Tie
13799,JointPQPlayer,252,252,504,43,13,Tie
13800,JointPQPlayer,161,166,327,4,59,JointPQPlayer
13801,JointPQPlayer,246,246,492,43,17,Tie
13802,JointPQPlayer,259,254,513,46,11,Player A
13803,JointPQPlayer,283,283,566,69,1,Tie
13804,JointPQPlayer,228,228,456,25,23,Tie
13805,JointPQPlayer,185,190,375,13,46,JointPQPlayer
13806,JointPQPlayer,258,253,511,47,12,Player A
13807,JointPQPlayer,256,256,512,45,11,Tie
13808,JointPQPlayer,268,268,536,51,5,Tie
13809,JointPQPlayer,250,255,505,44,13,JointPQPlayer
13810,JointPQPlayer,257,257,514,41,9,Tie
13811,JointPQPlayer,269,264,533,57,8,Player A
13812,JointPQPlayer,256,256,512,48,12,Tie
13813,JointPQPlayer,212,212,424,29,35,Tie
13814,JointPQPlayer,262,262,524,51,9,Tie
13815,JointPQPlayer,266,266,532,50,6,Tie
13816,JointPQPlayer,226,231,457,32,25,JointPQPlayer
13817,JointPQPlayer,263,258,521,51,10,Player A
13818,JointPQPlayer,270,270,540,58,6,Tie
13819,JointPQPlayer,255,255,510,43,11,Tie
13820,JointPQPlayer,276,276,552,58,2,Tie
13821,JointPQPlayer,258,258,516,43,9,Tie
13822,JointPQPlayer,254,254,508,41,11,Tie
13823,JointPQPlayer,270,270,540,58,6,Tie
13824,JointPQPlayer,273,273,546,52,2,Tie
13825,JointPQPlayer,167,172,339,4,55,JointPQPlayer
13826,JointPQPlayer,247,247,494,36,14,Tie
13827,JointPQPlayer,252,252,504,46,14,Tie
13828,JointPQPlayer,224,219,443,33,30,Player A
13829,JointPQPlayer,256,256,512,48,12,Tie
13830,JointPQPlayer,173,173,346,11,55,Tie
13831,JointPQPlayer,174,174,348,10,54,Tie
13832,JointPQPlayer,265,270,535,53,6,JointPQPlayer
13833,JointPQPlayer,219,214,433,35,34,Player A
13834,JointPQPlayer,241,246,487,35,16,JointPQPlayer
13835,JointPQPlayer,247,242,489,37,16,Player A
13836,JointPQPlayer,241,241,482,42,20,Tie
13837,JointPQPlayer,190,190,380,15,45,Tie
13838,JointPQPlayer,179,184,363,10,49,JointPQPlayer
13839,JointPQPlayer,264,259,523,50,9,Player A
13840,JointPQPlayer,263,263,526,44,6,Tie
13841,JointPQPlayer,175,180,355,8,51,JointPQPlayer
13842,JointPQPlayer,261,256,517,50,11,Player A
13843,JointPQPlayer,184,184,368,6,46,Tie
13844,JointPQPlayer,196,201,397,14,39,JointPQPlayer
13845,JointPQPlayer,186,181,367,14,49,Player A
13846,JointPQPlayer,224,229,453,28,25,JointPQPlayer
13847,JointPQPlayer,243,238,481,38,19,Player A
13848,JointPQPlayer,249,249,498,40,14,Tie
13849,JointPQPlayer,267,272,539,51,4,JointPQPlayer
13850,JointPQPlayer,255,255,510,43,11,Tie
13851,JointPQPlayer,187,187,374,18,48,Tie
13852,JointPQPlayer,260,260,520,47,9,Tie
13853,JointPQPlayer,255,250,505,47,14,Player A
13854,JointPQPlayer,245,245,490,35,15,Tie
13855,JointPQPlayer,194,199,393,19,42,JointPQPlayer
13856,JointPQPlayer,256,251,507,49,14,Player A
13857,JointPQPlayer,262,267,529,47,6,JointPQPlayer
13858,JointPQPlayer,246,246,492,46,18,Tie
13859,JointPQPlayer,239,234,473,36,21,Player A
13860,JointPQPlayer,247,247,494,36,14,Tie
13861,JointPQPlayer,251,251,502,47,15,Tie
13862,JointPQPlayer,261,266,527,45,6,JointPQPlayer
13863,JointPQPlayer,213,208,421,20,33,Player A
13864,JointPQPlayer,226,226,452,39,29,Tie
13865,JointPQPlayer,264,264,528,55,9,Tie
13866,JointPQPlayer,272,272,544,53,3,Tie
13867,JointPQPlayer,254,254,508,47,13,Tie
13868,JointPQPlayer,173,173,346,11,55,Tie
13869,JointPQPlayer,248,248,496,41,15,Tie
13870,JointPQPlayer,246,246,492,34,14,Tie
13871,JointPQPlayer,258,263,521,60,13,JointPQPlayer
13872,JointPQPlayer,256,251,507,49,14,Player A
13873,JointPQPlayer,168,173,341,9,56,JointPQPlayer
13874,JointPQPlayer,231,231,462,37,25,Tie
13875,JointPQPlayer,257,257,514,44,10,Tie
13876,JointPQPlayer,266,261,527,48,7,Player A
13877,JointPQPlayer,249,254,503,48,15,JointPQPlayer
13878,JointPQPlayer,260,255,515,48,11,Player A
13879,JointPQPlayer,274,279,553,65,4,JointPQPlayer
13880,JointPQPlayer,225,220,445,26,27,Player A
13881,JointPQPlayer,259,259,518,60,14,Tie
13882,JointPQPlayer,258,258,516,49,11,Tie
13883,JointPQPlayer,247,247,494,45,17,Tie
13884,JointPQPlayer,225,225,450,31,27,Tie
13885,JointPQPlayer,247,247,494,39,15,Tie
13886,JointPQPlayer,266,271,537,43,2,JointPQPlayer
13887,JointPQPlayer,259,259,518,42,8,Tie
13888,JointPQPlayer,243,238,481,41,20,Player A
13889,JointPQPlayer,240,240,480,37,19,Tie
13890,JointPQPlayer,251,256,507,40,11,JointPQPlayer
13891,JointPQPlayer,182,182,364,14,50,Tie
13892,JointPQPlayer,265,265,530,51,7,Tie
13893,JointPQPlayer,261,261,522,49,9,Tie
13894,JointPQPlayer,253,248,501,40,13,Player A
13895,JointPQPlayer,258,258,516,46,10,Tie
13896,JointPQPlayer,245,245,490,41,17,Tie
13897,JointPQPlayer,249,254,503,42,13,JointPQPlayer
13898,JointPQPlayer,266,266,532,62,10,Tie
13899,JointPQPlayer,210,210,420,19,33,Tie
13900,JointPQPlayer,278,273,551,63,4,Player A
13901,JointPQPlayer,268,268,536,57,7,Tie
13902,JointPQPlayer,259,259,518,45,9,Tie
13903,JointPQPlayer,205,205,410,27,39,Tie
13904,JointPQPlayer,266,266,532,56,8,Tie
13905,JointPQPlayer,265,265,530,48,6,Tie
13906,JointPQPlayer,200,200,400,23,41,Tie
13907,JointPQPlayer,175,175,350,9,53,Tie
13908,JointPQPlayer,254,254,508,41,11,Tie
13909,JointPQPlayer,227,232,459,28,23,JointPQPlayer
13910,JointPQPlayer,256,256,512,45,11,Tie
13911,JointPQPlayer,188,183,371,9,46,Player A
13912,JointPQPlayer,212,217,429,28,33,JointPQPlayer
13913,JointPQPlayer,255,255,510,52,14,Tie
13914,JointPQPlayer,266,261,527,51,8,Player A
13915,JointPQPlayer,254,254,508,41,11,Tie
13916,JointPQPlayer,258,263,521,45,8,JointPQPlayer
13917,JointPQPlayer,234,229,463,41,26,Player A
13918,JointPQPlayer,243,243,486,40,18,Tie
13919,JointPQPlayer,270,270,540,58,6,Tie
13920,JointPQPlayer,255,255,510,46,12,Tie
13921,JointPQPlayer,264,264,528,55,9,Tie
13922,JointPQPlayer,261,261,522,49,9,Tie
13923,JointPQPlayer,269,269,538,53,5,Tie
13924,JointPQPlayer,260,260,520,50,10,Tie
13925,JointPQPlayer,230,235,465,37,24,JointPQPlayer
13926,JointPQPlayer,266,266,532,56,8,Tie
13927,JointPQPlayer,172,172,344,9,55,Tie
13928,JointPQPlayer,176,176,352,8,52,Tie
13929,JointPQPlayer,264,259,523,47,8,Player A
13930,JointPQPlayer,175,180,355,5,50,JointPQPlayer
13931,JointPQPlayer,255,255,510,46,12,Tie
13932,JointPQPlayer,248,248,496,44,16,Tie
13933,JointPQPlayer,267,262,529,50,7,Player A
13934,JointPQPlayer,258,263,521,45,8,JointPQPlayer
13935,JointPQPlayer,256,256,512,51,13,Tie
13936,JointPQPlayer,256,251,507,43,12,Player A
13937,JointPQPlayer,243,248,491,48,19,JointPQPlayer
13938,JointPQPlayer,255,250,505,47,14,Player A
13939,JointPQPlayer,189,194,383,15,44,JointPQPlayer
13940,JointPQPlayer,269,269,538,53,5,Tie
13941,JointPQPlayer,267,262,529,53,8,Player A
13942,JointPQPlayer,241,246,487,41,18,JointPQPlayer
13943,JointPQPlayer,245,240,485,45,20,Player A
13944,JointPQPlayer,225,225,450,37,29,Tie
13945,JointPQPlayer,265,265,530,51,7,Tie
13946,JointPQPlayer,262,262,524,45,7,Tie
13947,JointPQPlayer,267,267,534,55,7,Tie
13948,JointPQPlayer,254,259,513,49,12,JointPQPlayer
13949,JointPQPlayer,260,255,515,51,12,Player A
13950,JointPQPlayer,260,260,520,56,12,Tie
13951,JointPQPlayer,255,255,510,46,12,Tie
13952,JointPQPlayer,239,244,483,43,20,JointPQPlayer
13953,JointPQPlayer,228,223,451,29,26,Player A
13954,JointPQPlayer,169,174,343,5,54,JointPQPlayer
13955,JointPQPlayer,202,202,404,18,38,Tie
13956,JointPQPlayer,272,267,539,51,4,Player A
13957,JointPQPlayer,252,252,504,46,14,Tie
13958,JointPQPlayer,194,194,388,17,43,Tie
13959,JointPQPlayer,203,208,411,31,40,JointPQPlayer
13960,JointPQPlayer,263,258,521,48,9,Player A
13961,JointPQPlayer,183,183,366,13,49,Tie
13962,JointPQPlayer,254,254,508,50,14,Tie
13963,JointPQPlayer,254,254,508,41,11,Tie
13964,JointPQPlayer,267,272,539,57,6,JointPQPlayer
13965,JointPQPlayer,187,182,369,13,48,Player A
13966,JointPQPlayer,269,274,543,64,7,JointPQPlayer
13967,JointPQPlayer,236,231,467,51,28,Player A
13968,JointPQPlayer,270,270,540,61,7,Tie
13969,JointPQPlayer,261,266,527,45,6,JointPQPlayer
13970,JointPQPlayer,248,243,491,42,17,Player A
13971,JointPQPlayer,237,237,474,37,21,Tie
13972,JointPQPlayer,234,239,473,39,22,JointPQPlayer
13973,JointPQPlayer,271,266,537,55,6,Player A
13974,JointPQPlayer,248,248,496,38,14,Tie
13975,JointPQPlayer,194,194,388,17,43,Tie
13976,JointPQPlayer,253,258,511,50,13,JointPQPlayer
13977,JointPQPlayer,254,249,503,45,14,Player A
13978,JointPQPlayer,254,259,513,43,10,JointPQPlayer
13979,JointPQPlayer,264,264,528,55,9,Tie
13980,JointPQPlayer,189,189,378,16,46,Tie
13981,JointPQPlayer,274,274,548,60,4,Tie
13982,JointPQPlayer,205,205,410,24,38,Tie
13983,JointPQPlayer,203,198,401,24,41,Player A
13984,JointPQPlayer,230,230,460,29,23,Tie
13985,JointPQPlayer,240,245,485,48,21,JointPQPlayer
13986,JointPQPlayer,220,220,440,27,29,Tie
13987,JointPQPlayer,260,255,515,51,12,Player A
13988,JointPQPlayer,223,228,451,29,26,JointPQPlayer
13989,JointPQPlayer,265,260,525,46,7,Player A
13990,JointPQPlayer,245,250,495,40,15,JointPQPlayer
13991,JointPQPlayer,247,242,489,43,18,Player A
13992,JointPQPlayer,281,281,562,68,2,Tie
13993,JointPQPlayer,252,252,504,40,12,Tie
13994,JointPQPlayer,187,187,374,9,45,Tie
13995,JointPQPlayer,181,186,367,5,46,JointPQPlayer
13996,JointPQPlayer,211,211,422,21,33,Tie
13997,JointPQPlayer,264,259,523,53,10,Player A
13998,JointPQPlayer,181,181,362,15,51,Tie
13999,JointPQPlayer,243,243,486,34,16,Tie
14000,JointPQPlayer,235,240,475,41,22,JointPQPlayer
14001,JointPQPlayer,253,248,501,46,15,Player A
14002,JointPQPlayer,264,264,528,49,7,Tie
14003,JointPQPlayer,261,261,522,49,9,Tie
14004,JointPQPlayer,168,173,341,6,55,JointPQPlayer
14005,JointPQPlayer,262,257,519,49,10,Player A
14006,JointPQPlayer,179,184,363,10,49,JointPQPlayer
14007,JointPQPlayer,261,256,517,47,10,Player A
14008,JointPQPlayer,256,261,517,53,12,JointPQPlayer
14009,JointPQPlayer,243,243,486,37,17,Tie
14010,JointPQPlayer,260,255,515,48,11,Player A
14011,JointPQPlayer,167,172,339,10,57,JointPQPlayer
14012,JointPQPlayer,256,256,512,54,14,Tie
14013,JointPQPlayer,250,250,500,42,14,Tie
14014,JointPQPlayer,260,255,515,42,9,Player A
14015,JointPQPlayer,240,240,480,40,20,Tie
14016,JointPQPlayer,160,160,320,6,62,Tie
14017,JointPQPlayer,190,195,385,14,43,JointPQPlayer
14018,JointPQPlayer,252,252,504,40,12,Tie
14019,JointPQPlayer,196,196,392,15,41,Tie
14020,JointPQPlayer,260,255,515,45,10,Player A
14021,JointPQPlayer,220,220,440,27,29,Tie
14022,JointPQPlayer,165,170,335,6,57,JointPQPlayer
14023,JointPQPlayer,260,260,520,44,8,Tie
14024,JointPQPlayer,260,260,520,47,9,Tie
14025,JointPQPlayer,161,161,322,5,61,Tie
14026,JointPQPlayer,273,268,541,56,5,Player A
14027,JointPQPlayer,171,176,347,12,55,JointPQPlayer
14028,JointPQPlayer,250,245,495,37,14,Player A
14029,JointPQPlayer,267,272,539,51,4,JointPQPlayer
14030,JointPQPlayer,262,262,524,51,9,Tie
14031,JointPQPlayer,190,185,375,13,46,Player A
14032,JointPQPlayer,253,258,511,47,12,JointPQPlayer
14033,JointPQPlayer,274,269,543,55,4,Player A
14034,JointPQPlayer,263,263,526,50,8,Tie
14035,JointPQPlayer,250,250,500,39,13,Tie
14036,JointPQPlayer,249,249,498,37,13,Tie
14037,JointPQPlayer,253,253,506,51,15,Tie
14038,JointPQPlayer,262,262,524,51,9,Tie
14039,JointPQPlayer,190,190,380,15,45,Tie
14040,JointPQPlayer,252,252,504,49,15,Tie
14041,JointPQPlayer,238,238,476,45,23,Tie
14042,JointPQPlayer,261,261,522,46,8,Tie
14043,JointPQPlayer,248,248,496,41,15,Tie
14044,JointPQPlayer,261,261,522,55,11,Tie
14045,JointPQPlayer,258,258,516,49,11,Tie
14046,JointPQPlayer,250,250,500,45,15,Tie
14047,JointPQPlayer,206,206,412,23,37,Tie
14048,JointPQPlayer,252,252,504,43,13,Tie
14049,JointPQPlayer,249,249,498,46,16,Tie
14050,JointPQPlayer,250,250,500,42,14,Tie
14051,JointPQPlayer,193,198,391,11,40,JointPQPlayer
14052,JointPQPlayer,175,175,350,6,52,Tie
14053,JointPQPlayer,182,182,364,11,49,Tie
14054,JointPQPlayer,249,249,498,34,12,Tie
14055,JointPQPlayer,271,266,537,58,7,Player A
14056,JointPQPlayer,251,251,502,35,11,Tie
14057,JointPQPlayer,215,215,430,23,31,Tie
14058,JointPQPlayer,264,269,533,51,6,JointPQPlayer
14059,JointPQPlayer,265,260,525,49,8,Player A
14060,JointPQPlayer,226,226,452,30,26,Tie
14061,JointPQPlayer,266,266,532,50,6,Tie
14062,JointPQPlayer,263,268,531,55,8,JointPQPlayer
14063,JointPQPlayer,243,238,481,35,18,Player A
14064,JointPQPlayer,251,256,507,46,13,JointPQPlayer
14065,JointPQPlayer,262,262,524,51,9,Tie
14066,JointPQPlayer,231,231,462,40,26,Tie
14067,JointPQPlayer,259,254,513,43,10,Player A
14068,JointPQPlayer,260,260,520,50,10,Tie
14069,JointPQPlayer,243,243,486,46,20,Tie
14070,JointPQPlayer,207,212,419,24,35,JointPQPlayer
14071,JointPQPlayer,237,232,469,44,25,Player A
14072,JointPQPlayer,253,253,506,48,14,Tie
14073,JointPQPlayer,247,247,494,36,14,Tie
14074,JointPQPlayer,239,239,478,35,19,Tie
14075,JointPQPlayer,236,241,477,31,18,JointPQPlayer
14076,JointPQPlayer,256,256,512,42,10,Tie
14077,JointPQPlayer,185,185,370,11,47,Tie
14078,JointPQPlayer,254,249,503,45,14,Player A
14079,JointPQPlayer,226,226,452,30,26,Tie
14080,JointPQPlayer,230,230,460,38,26,Tie
14081,JointPQPlayer,218,223,441,37,32,JointPQPlayer
14082,JointPQPlayer,277,272,549,55,2,Player A
14083,JointPQPlayer,256,261,517,38,7,JointPQPlayer
14084,JointPQPlayer,245,240,485,42,19,Player A
14085,JointPQPlayer,251,251,502,41,13,Tie
14086,JointPQPlayer,256,261,517,47,10,JointPQPlayer
14087,JointPQPlayer,168,168,336,10,58,Tie
14088,JointPQPlayer,168,168,336,7,57,Tie
14089,JointPQPlayer,223,218,441,22,27,Player A
14090,JointPQPlayer,165,170,335,12,59,JointPQPlayer
14091,JointPQPlayer,259,254,513,46,11,Player A
14092,JointPQPlayer,219,219,438,34,32,Tie
14093,JointPQPlayer,182,187,369,16,49,JointPQPlayer
14094,JointPQPlayer,181,176,357,16,53,Player A
14095,JointPQPlayer,262,262,524,45,7,Tie
14096,JointPQPlayer,264,264,528,46,6,Tie
14097,JointPQPlayer,225,225,450,40,30,Tie
14098,JointPQPlayer,226,226,452,45,31,Tie
14099,JointPQPlayer,242,242,484,44,20,Tie
14100,JointPQPlayer,171,176,347,12,55,JointPQPlayer
14101,JointPQPlayer,265,265,530,54,8,Tie
14102,JointPQPlayer,257,252,509,48,13,Player A
14103,JointPQPlayer,190,190,380,18,46,Tie
14104,JointPQPlayer,262,262,524,48,8,Tie
14105,JointPQPlayer,268,268,536,51,5,Tie
14106,JointPQPlayer,248,253,501,40,13,JointPQPlayer
14107,JointPQPlayer,263,258,521,48,9,Player A
14108,JointPQPlayer,244,249,493,41,16,JointPQPlayer
14109,JointPQPlayer,238,233,471,43,24,Player A
14110,JointPQPlayer,173,178,351,4,51,JointPQPlayer
14111,JointPQPlayer,174,169,343,8,55,Player A
14112,JointPQPlayer,263,263,526,47,7,Tie
14113,JointPQPlayer,267,272,539,57,6,JointPQPlayer
14114,JointPQPlayer,239,234,473,45,24,Player A
14115,JointPQPlayer,245,245,490,44,18,Tie
14116,JointPQPlayer,184,189,373,14,47,JointPQPlayer
14117,JointPQPlayer,200,195,395,15,40,Player A
14118,JointPQPlayer,257,262,519,49,10,JointPQPlayer
14119,JointPQPlayer,273,268,541,56,5,Player A
14120,JointPQPlayer,191,196,387,16,43,JointPQPlayer
14121,JointPQPlayer,243,243,486,43,19,Tie
14122,JointPQPlayer,273,268,541,53,4,Player A
14123,JointPQPlayer,206,206,412,20,36,Tie
14124,JointPQPlayer,178,183,361,5,48,JointPQPlayer
14125,JointPQPlayer,257,252,509,39,10,Player A
14126,JointPQPlayer,167,172,339,4,55,JointPQPlayer
14127,JointPQPlayer,248,248,496,41,15,Tie
14128,JointPQPlayer,267,262,529,56,9,Player A
14129,JointPQPlayer,268,273,541,56,5,JointPQPlayer
14130,JointPQPlayer,259,254,513,49,12,Player A
14131,JointPQPlayer,229,229,458,36,26,Tie
14132,JointPQPlayer,213,218,431,27,32,JointPQPlayer
14133,JointPQPlayer,259,254,513,40,9,Player A
14134,JointPQPlayer,270,270,540,52,4,Tie
14135,JointPQPlayer,251,251,502,44,14,Tie
14136,JointPQPlayer,196,201,397,14,39,JointPQPlayer
14137,JointPQPlayer,247,242,489,40,17,Player A
14138,JointPQPlayer,243,248,491,45,18,JointPQPlayer
14139,JointPQPlayer,192,192,384,10,42,Tie
14140,JointPQPlayer,190,190,380,15,45,Tie
14141,JointPQPlayer,262,257,519,55,12,Player A
14142,JointPQPlayer,252,257,509,51,14,JointPQPlayer
14143,JointPQPlayer,233,233,466,44,26,Tie
14144,JointPQPlayer,265,265,530,48,6,Tie
14145,JointPQPlayer,260,255,515,54,13,Player A
14146,JointPQPlayer,166,171,337,11,58,JointPQPlayer
14147,JointPQPlayer,241,236,477,43,22,Player A
14148,JointPQPlayer,259,259,518,48,10,Tie
14149,JointPQPlayer,207,207,414,13,33,Tie
14150,JointPQPlayer,255,260,515,42,9,JointPQPlayer
14151,JointPQPlayer,260,255,515,45,10,Player A
14152,JointPQPlayer,255,260,515,48,11,JointPQPlayer
14153,JointPQPlayer,183,178,361,11,50,Player A
14154,JointPQPlayer,177,177,354,4,50,Tie
14155,JointPQPlayer,267,267,534,49,5,Tie
14156,JointPQPlayer,209,209,418,32,38,Tie
14157,JointPQPlayer,224,229,453,40,29,JointPQPlayer
14158,JointPQPlayer,268,268,536,51,5,Tie
14159,JointPQPlayer,249,249,498,43,15,Tie
14160,JointPQPlayer,253,248,501,40,13,Player A
14161,JointPQPlayer,254,259,513,46,11,JointPQPlayer
14162,JointPQPlayer,270,265,535,50,5,Player A
14163,JointPQPlayer,253,253,506,48,14,Tie
14164,JointPQPlayer,253,253,506,51,15,Tie
14165,JointPQPlayer,252,252,504,46,14,Tie
14166,JointPQPlayer,241,241,482,42,20,Tie
14167,JointPQPlayer,250,250,500,54,18,Tie
14168,JointPQPlayer,261,261,522,40,6,Tie
14169,JointPQPlayer,244,249,493,38,15,JointPQPlayer
14170,JointPQPlayer,265,260,525,46,7,Player A
14171,JointPQPlayer,262,267,529,47,6,JointPQPlayer
14172,JointPQPlayer,258,253,511,50,13,Player A
14173,JointPQPlayer,205,205,410,27,39,Tie
14174,JointPQPlayer,255,255,510,46,12,Tie
14175,JointPQPlayer,241,241,482,39,19,Tie
14176,JointPQPlayer,193,193,386,30,48,Tie
14177,JointPQPlayer,256,256,512,45,11,Tie
14178,JointPQPlayer,215,215,430,26,32,Tie
14179,JointPQPlayer,230,230,460,38,26,Tie
14180,JointPQPlayer,257,257,514,41,9,Tie
14181,JointPQPlayer,169,169,338,3,55,Tie
14182,JointPQPlayer,279,279,558,67,3,Tie
14183,JointPQPlayer,245,250,495,43,16,JointPQPlayer
14184,JointPQPlayer,267,262,529,53,8,Player A
14185,JointPQPlayer,262,262,524,51,9,Tie
14186,JointPQPlayer,267,267,534,49,5,Tie
14187,JointPQPlayer,258,258,516,49,11,Tie
14188,JointPQPlayer,190,190,380,12,44,Tie
14189,JointPQPlayer,248,248,496,44,16,Tie
14190,JointPQPlayer,249,249,498,43,15,Tie
14191,JointPQPlayer,252,252,504,43,13,Tie
14192,JointPQPlayer,250,255,505,47,14,JointPQPlayer
14193,JointPQPlayer,268,263,531,52,7,Player A
14194,JointPQPlayer,192,192,384,10,42,Tie
14195,JointPQPlayer,203,203,406,26,40,Tie
14196,JointPQPlayer,224,229,453,34,27,JointPQPlayer
14197,JointPQPlayer,207,207,414,19,35,Tie
14198,JointPQPlayer,166,166,332,3,57,Tie
14199,JointPQPlayer,264,264,528,49,7,Tie
14200,JointPQPlayer,243,243,486,37,17,Tie
14201,JointPQPlayer,196,196,392,18,42,Tie
14202,JointPQPlayer,250,245,495,43,16,Player A
14203,JointPQPlayer,243,248,491,45,18,JointPQPlayer
14204,JointPQPlayer,264,259,523,44,7,Player A
14205,JointPQPlayer,240,245,485,33,16,JointPQPlayer
14206,JointPQPlayer,265,260,525,55,10,Player A
14207,JointPQPlayer,227,232,459,34,25,JointPQPlayer
14208,JointPQPlayer,251,246,497,39,14,Player A
14209,JointPQPlayer,266,266,532,56,8,Tie
14210,JointPQPlayer,275,275,550,62,4,Tie
14211,JointPQPlayer,254,254,508,41,11,Tie
14212,JointPQPlayer,275,275,550,62,4,Tie
14213,JointPQPlayer,246,246,492,49,19,Tie
14214,JointPQPlayer,250,250,500,42,14,Tie
14215,JointPQPlayer,258,263,521,54,11,JointPQPlayer
14216,JointPQPlayer,219,214,433,23,30,Player A
14217,JointPQPlayer,272,272,544,56,4,Tie
14218,JointPQPlayer,202,202,404,21,39,Tie
14219,JointPQPlayer,248,253,501,40,13,JointPQPlayer
14220,JointPQPlayer,275,270,545,51,2,Player A
14221,JointPQPlayer,235,235,470,30,20,Tie
14222,JointPQPlayer,212,212,424,29,35,Tie
14223,JointPQPlayer,199,204,403,20,39,JointPQPlayer
14224,JointPQPlayer,272,267,539,54,5,Player A
14225,JointPQPlayer,271,276,547,59,4,JointPQPlayer
14226,JointPQPlayer,258,253,511,50,13,Player A
14227,JointPQPlayer,249,249,498,37,13,Tie
14228,JointPQPlayer,253,258,511,47,12,JointPQPlayer
14229,JointPQPlayer,267,262,529,53,8,Player A
14230,JointPQPlayer,260,265,525,52,9,JointPQPlayer
14231,JointPQPlayer,176,176,352,2,50,Tie
14232,JointPQPlayer,228,228,456,34,26,Tie
14233,JointPQPlayer,245,240,485,45,20,Player A
14234,JointPQPlayer,234,234,468,34,22,Tie
14235,JointPQPlayer,254,254,508,47,13,Tie
14236,JointPQPlayer,180,185,365,9,48,JointPQPlayer
14237,JointPQPlayer,176,171,347,6,53,Player A
14238,JointPQPlayer,250,250,500,42,14,Tie
14239,JointPQPlayer,158,163,321,4,61,JointPQPlayer
14240,JointPQPlayer,258,253,511,47,12,Player A
14241,JointPQPlayer,267,267,534,58,8,Tie
14242,JointPQPlayer,170,175,345,4,53,JointPQPlayer
14243,JointPQPlayer,268,263,531,49,6,Player A
14244,JointPQPlayer,240,245,485,42,19,JointPQPlayer
14245,JointPQPlayer,260,255,515,45,10,Player A
14246,JointPQPlayer,258,258,516,46,10,Tie
14247,JointPQPlayer,255,255,510,46,12,Tie
14248,JointPQPlayer,176,181,357,10,51,JointPQPlayer
14249,JointPQPlayer,255,250,505,44,13,Player A
14250,JointPQPlayer,263,268,531,46,5,JointPQPlayer
14251,JointPQPlayer,245,245,490,35,15,Tie
14252,JointPQPlayer,259,254,513,49,12,Player A
14253,JointPQPlayer,212,217,429,31,34,JointPQPlayer
14254,JointPQPlayer,254,249,503,48,15,Player A
14255,JointPQPlayer,241,241,482,36,18,Tie
14256,JointPQPlayer,172,177,349,5,52,JointPQPlayer
14257,JointPQPlayer,239,234,473,42,23,Player A
14258,JointPQPlayer,259,259,518,48,10,Tie
14259,JointPQPlayer,243,243,486,46,20,Tie
14260,JointPQPlayer,191,196,387,25,46,JointPQPlayer
14261,JointPQPlayer,262,257,519,49,10,Player A
14262,JointPQPlayer,252,252,504,37,11,Tie
14263,JointPQPlayer,261,261,522,52,10,Tie
14264,JointPQPlayer,256,261,517,44,9,JointPQPlayer
14265,JointPQPlayer,259,254,513,46,11,Player A
14266,JointPQPlayer,251,251,502,47,15,Tie
14267,JointPQPlayer,252,257,509,45,12,JointPQPlayer
14268,JointPQPlayer,233,228,461,33,24,Player A
14269,JointPQPlayer,235,240,475,32,19,JointPQPlayer
14270,JointPQPlayer,264,259,523,50,9,Player A
14271,JointPQPlayer,258,263,521,42,7,JointPQPlayer
14272,JointPQPlayer,256,251,507,49,14,Player A
14273,JointPQPlayer,258,263,521,54,11,JointPQPlayer
14274,JointPQPlayer,270,265,535,53,6,Player A
14275,JointPQPlayer,247,247,494,36,14,Tie
14276,JointPQPlayer,226,231,457,32,25,JointPQPlayer
14277,JointPQPlayer,230,230,460,32,24,Tie
14278,JointPQPlayer,247,242,489,40,17,Player A
14279,JointPQPlayer,234,234,468,46,26,Tie
14280,JointPQPlayer,264,264,528,55,9,Tie
14281,JointPQPlayer,232,232,464,33,23,Tie
14282,JointPQPlayer,246,251,497,42,15,JointPQPlayer
14283,JointPQPlayer,259,254,513,40,9,Player A
14284,JointPQPlayer,190,190,380,15,45,Tie
14285,JointPQPlayer,181,186,367,11,48,JointPQPlayer
14286,JointPQPlayer,258,253,511,47,12,Player A
14287,JointPQPlayer,177,182,359,15,52,JointPQPlayer
14288,JointPQPlayer,268,263,531,49,6,Player A
14289,JointPQPlayer,239,244,483,40,19,JointPQPlayer
14290,JointPQPlayer,259,254,513,49,12,Player A
14291,JointPQPlayer,235,240,475,29,18,JointPQPlayer
14292,JointPQPlayer,271,266,537,61,8,Player A
14293,JointPQPlayer,241,241,482,39,19,Tie
14294,JointPQPlayer,174,179,353,6,51,JointPQPlayer
14295,JointPQPlayer,258,258,516,52,12,Tie
14296,JointPQPlayer,197,197,394,11,39,Tie
14297,JointPQPlayer,247,247,494,36,14,Tie
14298,JointPQPlayer,227,227,454,32,26,Tie
14299,JointPQPlayer,262,257,519,46,9,Player A
14300,JointPQPlayer,275,275,550,68,6,Tie
14301,JointPQPlayer,262,267,529,47,6,JointPQPlayer
14302,JointPQPlayer,245,240,485,45,20,Player A
14303,JointPQPlayer,247,247,494,36,14,Tie
14304,JointPQPlayer,239,239,478,35,19,Tie
14305,JointPQPlayer,223,223,446,27,27,Tie
14306,JointPQPlayer,258,258,516,46,10,Tie
14307,JointPQPlayer,245,250,495,49,18,JointPQPlayer
14308,JointPQPlayer,274,269,543,55,4,Player A
14309,JointPQPlayer,253,253,506,42,12,Tie
14310,JointPQPlayer,259,259,518,45,9,Tie
14311,JointPQPlayer,270,270,540,55,5,Tie
14312,JointPQPlayer,220,225,445,32,29,JointPQPlayer
14313,JointPQPlayer,215,215,430,23,31,Tie
14314,JointPQPlayer,184,184,368,9,47,Tie
14315,JointPQPlayer,244,244,488,45,19,Tie
14316,JointPQPlayer,166,166,332,6,58,Tie
14317,JointPQPlayer,184,179,363,4,47,Player A
14318,JointPQPlayer,257,257,514,53,13,Tie
14319,JointPQPlayer,211,211,422,24,34,Tie
14320,JointPQPlayer,266,266,532,53,7,Tie
14321,JointPQPlayer,255,255,510,46,12,Tie
14322,JointPQPlayer,223,223,446,30,28,Tie
14323,JointPQPlayer,179,184,363,7,48,JointPQPlayer
14324,JointPQPlayer,261,261,522,46,8,Tie
14325,JointPQPlayer,250,250,500,48,16,Tie
14326,JointPQPlayer,261,256,517,53,12,Player A
14327,JointPQPlayer,178,183,361,5,48,JointPQPlayer
14328,JointPQPlayer,257,257,514,47,11,Tie
14329,JointPQPlayer,257,252,509,48,13,Player A
14330,JointPQPlayer,261,261,522,52,10,Tie
14331,JointPQPlayer,260,265,525,49,8,JointPQPlayer
14332,JointPQPlayer,238,238,476,36,20,Tie
14333,JointPQPlayer,222,222,444,31,29,Tie
14334,JointPQPlayer,248,243,491,42,17,Player A
14335,JointPQPlayer,224,224,448,35,29,Tie
14336,JointPQPlayer,268,273,541,56,5,JointPQPlayer
14337,JointPQPlayer,256,251,507,46,13,Player A
14338,JointPQPlayer,216,216,432,28,32,Tie
14339,JointPQPlayer,245,250,495,37,14,JointPQPlayer
14340,JointPQPlayer,262,257,519,49,10,Player A
14341,JointPQPlayer,181,181,362,12,50,Tie
14342,JointPQPlayer,260,265,525,49,8,JointPQPlayer
14343,JointPQPlayer,247,247,494,51,19,Tie
14344,JointPQPlayer,223,218,441,34,31,Player A
14345,JointPQPlayer,235,235,470,39,23,Tie
14346,JointPQPlayer,267,267,534,49,5,Tie
14347,JointPQPlayer,272,272,544,53,3,Tie
14348,JointPQPlayer,249,249,498,43,15,Tie
14349,JointPQPlayer,263,263,526,47,7,Tie
14350,JointPQPlayer,203,208,411,22,37,JointPQPlayer
14351,JointPQPlayer,265,265,530,51,7,Tie
14352,JointPQPlayer,254,249,503,45,14,Player A
14353,JointPQPlayer,260,260,520,47,9,Tie
14354,JointPQPlayer,238,243,481,41,20,JointPQPlayer
14355,JointPQPlayer,255,255,510,46,12,Tie
14356,JointPQPlayer,267,262,529,47,6,Player A
14357,JointPQPlayer,274,274,548,60,4,Tie
14358,JointPQPlayer,243,243,486,34,16,Tie
14359,JointPQPlayer,265,265,530,48,6,Tie
14360,JointPQPlayer,218,218,436,32,32,Tie
14361,JointPQPlayer,249,249,498,46,16,Tie
14362,JointPQPlayer,192,197,389,15,42,JointPQPlayer
14363,JointPQPlayer,182,177,359,9,50,Player A
14364,JointPQPlayer,256,256,512,45,11,Tie
14365,JointPQPlayer,257,257,514,56,14,Tie
14366,JointPQPlayer,232,237,469,35,22,JointPQPlayer
14367,JointPQPlayer,265,260,525,52,9,Player A
14368,JointPQPlayer,245,245,490,41,17,Tie
14369,JointPQPlayer,251,256,507,49,14,JointPQPlayer
14370,JointPQPlayer,243,238,481,41,20,Player A
14371,JointPQPlayer,251,256,507,43,12,JointPQPlayer
14372,JointPQPlayer,267,262,529,53,8,Player A
14373,JointPQPlayer,259,259,518,51,11,Tie
14374,JointPQPlayer,178,183,361,8,49,JointPQPlayer
14375,JointPQPlayer,199,194,393,16,41,Player A
14376,JointPQPlayer,232,232,464,36,24,Tie
14377,JointPQPlayer,258,258,516,52,12,Tie
14378,JointPQPlayer,246,251,497,42,15,JointPQPlayer
14379,JointPQPlayer,248,243,491,42,17,Player A
14380,JointPQPlayer,232,232,464,36,24,Tie
14381,JointPQPlayer,248,248,496,41,15,Tie
14382,JointPQPlayer,258,263,521,48,9,JointPQPlayer
14383,JointPQPlayer,268,263,531,52,7,Player A
14384,JointPQPlayer,258,263,521,45,8,JointPQPlayer
14385,JointPQPlayer,243,243,486,43,19,Tie
14386,JointPQPlayer,247,247,494,36,14,Tie
14387,JointPQPlayer,223,218,441,31,30,Player A
14388,JointPQPlayer,191,191,382,17,45,Tie
14389,JointPQPlayer,179,179,358,17,53,Tie
14390,JointPQPlayer,263,263,526,44,6,Tie
14391,JointPQPlayer,278,278,556,59,1,Tie
14392,JointPQPlayer,277,277,554,63,3,Tie
14393,JointPQPlayer,252,252,504,40,12,Tie
14394,JointPQPlayer,164,164,328,8,60,Tie
14395,JointPQPlayer,263,268,531,55,8,JointPQPlayer
14396,JointPQPlayer,263,258,521,51,10,Player A
14397,JointPQPlayer,177,182,359,9,50,JointPQPlayer
14398,JointPQPlayer,254,254,508,44,12,Tie
14399,JointPQPlayer,260,260,520,47,9,Tie
14400,JointPQPlayer,175,175,350,12,54,Tie
14401,JointPQPlayer,212,212,424,23,33,Tie
14402,JointPQPlayer,259,259,518,45,9,Tie
14403,JointPQPlayer,256,251,507,49,14,Player A
14404,JointPQPlayer,267,272,539,57,6,JointPQPlayer
14405,JointPQPlayer,227,222,449,36,29,Player A
14406,JointPQPlayer,269,269,538,59,7,Tie
14407,JointPQPlayer,263,268,531,52,7,JointPQPlayer
14408,JointPQPlayer,217,212,429,34,35,Player A
14409,JointPQPlayer,267,272,539,60,7,JointPQPlayer
14410,JointPQPlayer,179,179,358,14,52,Tie
14411,JointPQPlayer,235,235,470,33,21,Tie
14412,JointPQPlayer,254,249,503,45,14,Player A
14413,JointPQPlayer,241,246,487,44,19,JointPQPlayer
14414,JointPQPlayer,250,245,495,46,17,Player A
14415,JointPQPlayer,255,255,510,37,9,Tie
14416,JointPQPlayer,255,260,515,51,12,JointPQPlayer
14417,JointPQPlayer,268,268,536,57,7,Tie
14418,JointPQPlayer,270,265,535,56,7,Player A
14419,JointPQPlayer,163,168,331,11,60,JointPQPlayer
14420,JointPQPlayer,264,259,523,50,9,Player A
14421,JointPQPlayer,271,271,542,60,6,Tie
14422,JointPQPlayer,232,237,469,44,25,JointPQPlayer
14423,JointPQPlayer,269,264,533,54,7,Player A
14424,JointPQPlayer,190,190,380,21,47,Tie
14425,JointPQPlayer,220,225,445,32,29,JointPQPlayer
14426,JointPQPlayer,250,245,495,43,16,Player A
14427,JointPQPlayer,220,225,445,29,28,JointPQPlayer
14428,JointPQPlayer,262,257,519,52,11,Player A
14429,JointPQPlayer,256,256,512,48,12,Tie
14430,JointPQPlayer,197,202,399,28,43,JointPQPlayer
14431,JointPQPlayer,252,247,499,41,14,Player A
14432,JointPQPlayer,256,256,512,48,12,Tie
14433,JointPQPlayer,263,263,526,56,10,Tie
14434,JointPQPlayer,235,235,470,36,22,Tie
14435,JointPQPlayer,257,257,514,41,9,Tie
14436,JointPQPlayer,257,257,514,44,10,Tie
14437,JointPQPlayer,254,254,508,38,10,Tie
14438,JointPQPlayer,266,266,532,59,9,Tie
14439,JointPQPlayer,253,258,511,50,13,JointPQPlayer
14440,JointPQPlayer,263,258,521,51,10,Player A
14441,JointPQPlayer,164,169,333,7,58,JointPQPlayer
14442,JointPQPlayer,272,267,539,54,5,Player A
14443,JointPQPlayer,249,249,498,43,15,Tie
14444,JointPQPlayer,258,263,521,48,9,JointPQPlayer
14445,JointPQPlayer,230,225,455,36,27,Player A
14446,JointPQPlayer,244,244,488,42,18,Tie
14447,JointPQPlayer,245,250,495,43,16,JointPQPlayer
14448,JointPQPlayer,266,261,527,48,7,Player A
14449,JointPQPlayer,256,256,512,45,11,Tie
14450,JointPQPlayer,161,161,322,2,60,Tie
14451,JointPQPlayer,256,261,517,53,12,JointPQPlayer
14452,JointPQPlayer,168,163,331,5,58,Player A
14453,JointPQPlayer,178,178,356,15,53,Tie
14454,JointPQPlayer,243,243,486,40,18,Tie
14455,JointPQPlayer,247,247,494,39,15,Tie
14456,JointPQPlayer,262,262,524,45,7,Tie
14457,JointPQPlayer,263,268,531,49,6,JointPQPlayer
14458,JointPQPlayer,191,191,382,17,45,Tie
14459,JointPQPlayer,241,236,477,37,20,Player A
14460,JointPQPlayer,209,209,418,23,35,Tie
14461,JointPQPlayer,251,251,502,47,15,Tie
14462,JointPQPlayer,236,241,477,34,19,JointPQPlayer
14463,JointPQPlayer,256,251,507,46,13,Player A
14464,JointPQPlayer,259,264,523,50,9,JointPQPlayer
14465,JointPQPlayer,250,245,495,46,17,Player A
14466,JointPQPlayer,252,257,509,54,15,JointPQPlayer
14467,JointPQPlayer,258,253,511,53,14,Player A
14468,JointPQPlayer,267,267,534,61,9,Tie
14469,JointPQPlayer,254,254,508,50,14,Tie
14470,JointPQPlayer,247,247,494,42,16,Tie
14471,JointPQPlayer,259,259,518,45,9,Tie
14472,JointPQPlayer,228,233,461,33,24,JointPQPlayer
14473,JointPQPlayer,214,214,428,24,32,Tie
14474,JointPQPlayer,252,247,499,41,14,Player A
14475,JointPQPlayer,244,244,488,51,21,Tie
14476,JointPQPlayer,236,241,477,46,23,JointPQPlayer
14477,JointPQPlayer,271,266,537,49,4,Player A
14478,JointPQPlayer,186,186,372,7,45,Tie
14479,JointPQPlayer,235,235,470,36,22,Tie
14480,JointPQPlayer,258,258,516,52,12,Tie
14481,JointPQPlayer,240,245,485,45,20,JointPQPlayer
14482,JointPQPlayer,270,265,535,56,7,Player A
14483,JointPQPlayer,257,262,519,43,8,JointPQPlayer
14484,JointPQPlayer,156,156,312,4,64,Tie
14485,JointPQPlayer,251,251,502,47,15,Tie
14486,JointPQPlayer,265,260,525,46,7,Player A
14487,JointPQPlayer,209,214,423,22,33,JointPQPlayer
14488,JointPQPlayer,260,255,515,48,11,Player A
14489,JointPQPlayer,255,260,515,48,11,JointPQPlayer
14490,JointPQPlayer,276,271,547,56,3,Player A
14491,JointPQPlayer,272,272,544,59,5,Tie
14492,JointPQPlayer,255,255,510,49,13,Tie
14493,JointPQPlayer,245,245,490,41,17,Tie
14494,JointPQPlayer,193,193,386,15,43,Tie
14495,JointPQPlayer,179,179,358,8,50,Tie
14496,JointPQPlayer,162,167,329,9,60,JointPQPlayer
14497,JointPQPlayer,233,228,461,33,24,Player A
14498,JointPQPlayer,263,268,531,52,7,JointPQPlayer
14499,JointPQPlayer,260,255,515,48,11,Player A
14500,JointPQPlayer,234,239,473,45,24,JointPQPlayer
14501,JointPQPlayer,236,236,472,35,21,Tie
14502,JointPQPlayer,257,252,509,45,12,Player A
14503,JointPQPlayer,272,272,544,59,5,Tie
14504,JointPQPlayer,242,242,484,35,17,Tie
14505,JointPQPlayer,262,262,524,48,8,Tie
14506,JointPQPlayer,219,219,438,31,31,Tie
14507,JointPQPlayer,218,218,436,26,30,Tie
14508,JointPQPlayer,252,252,504,43,13,Tie
14509,JointPQPlayer,264,264,528,58,10,Tie
14510,JointPQPlayer,259,259,518,48,10,Tie
14511,JointPQPlayer,260,260,520,53,11,Tie
14512,JointPQPlayer,273,273,546,58,4,Tie
14513,JointPQPlayer,259,264,523,50,9,JointPQPlayer
14514,JointPQPlayer,255,255,510,43,11,Tie
14515,JointPQPlayer,262,262,524,48,8,Tie
14516,JointPQPlayer,192,192,384,19,45,Tie
14517,JointPQPlayer,252,247,499,41,14,Player A
14518,JointPQPlayer,233,238,471,40,23,JointPQPlayer
14519,JointPQPlayer,229,224,453,43,30,Player A
14520,JointPQPlayer,177,177,354,7,51,Tie
14521,JointPQPlayer,226,226,452,30,26,Tie
14522,JointPQPlayer,275,275,550,56,2,Tie
14523,JointPQPlayer,254,259,513,40,9,JointPQPlayer
14524,JointPQPlayer,259,259,518,45,9,Tie
14525,JointPQPlayer,252,247,499,44,15,Player A
14526,JointPQPlayer,257,257,514,50,12,Tie
14527,JointPQPlayer,272,272,544,62,6,Tie
14528,JointPQPlayer,265,265,530,45,5,Tie
14529,JointPQPlayer,260,265,525,46,7,JointPQPlayer
14530,JointPQPlayer,254,249,503,42,13,Player A
14531,JointPQPlayer,250,250,500,45,15,Tie
14532,JointPQPlayer,269,269,538,56,6,Tie
14533,JointPQPlayer,183,183,366,7,47,Tie
14534,JointPQPlayer,264,264,528,55,9,Tie
14535,JointPQPlayer,258,258,516,46,10,Tie
14536,JointPQPlayer,237,242,479,36,19,JointPQPlayer
14537,JointPQPlayer,256,251,507,46,13,Player A
14538,JointPQPlayer,244,249,493,38,15,JointPQPlayer
14539,JointPQPlayer,259,254,513,46,11,Player A
14540,JointPQPlayer,262,262,524,48,8,Tie
14541,JointPQPlayer,253,258,511,53,14,JointPQPlayer
14542,JointPQPlayer,271,271,542,57,5,Tie
14543,JointPQPlayer,161,161,322,5,61,Tie
14544,JointPQPlayer,266,261,527,51,8,Player A
14545,JointPQPlayer,205,205,410,18,36,Tie
14546,JointPQPlayer,260,260,520,50,10,Tie
14547,JointPQPlayer,253,258,511,50,13,JointPQPlayer
14548,JointPQPlayer,245,240,485,36,17,Player A
14549,JointPQPlayer,251,251,502,35,11,Tie
14550,JointPQPlayer,253,253,506,45,13,Tie
14551,JointPQPlayer,245,245,490,41,17,Tie
14552,JointPQPlayer,181,186,367,8,47,JointPQPlayer
14553,JointPQPlayer,248,243,491,36,15,Player A
14554,JointPQPlayer,239,239,478,47,23,Tie
14555,JointPQPlayer,243,243,486,46,20,Tie
14556,JointPQPlayer,241,241,482,42,20,Tie
14557,JointPQPlayer,192,192,384,16,44,Tie
14558,JointPQPlayer,245,245,490,35,15,Tie
14559,JointPQPlayer,239,244,483,40,19,JointPQPlayer
14560,JointPQPlayer,272,267,539,57,6,Player A
14561,JointPQPlayer,240,240,480,40,20,Tie
14562,JointPQPlayer,250,250,500,36,12,Tie
14563,JointPQPlayer,224,229,453,34,27,JointPQPlayer
14564,JointPQPlayer,256,251,507,49,14,Player A
14565,JointPQPlayer,192,192,384,16,44,Tie
14566,JointPQPlayer,263,263,526,56,10,Tie
14567,JointPQPlayer,238,238,476,39,21,Tie
14568,JointPQPlayer,268,268,536,54,6,Tie
14569,JointPQPlayer,269,274,543,58,5,JointPQPlayer
14570,JointPQPlayer,258,253,511,47,12,Player A
14571,JointPQPlayer,193,198,391,14,41,JointPQPlayer
14572,JointPQPlayer,245,245,490,41,17,Tie
14573,JointPQPlayer,232,232,464,33,23,Tie
14574,JointPQPlayer,274,269,543,58,5,Player A
14575,JointPQPlayer,241,241,482,36,18,Tie
14576,JointPQPlayer,212,212,424,23,33,Tie
14577,JointPQPlayer,203,203,406,20,38,Tie
14578,JointPQPlayer,213,213,426,28,34,Tie
14579,JointPQPlayer,248,253,501,43,14,JointPQPlayer
14580,JointPQPlayer,250,250,500,48,16,Tie
14581,JointPQPlayer,241,236,477,40,21,Player A
14582,JointPQPlayer,269,274,543,52,3,JointPQPlayer
14583,JointPQPlayer,259,254,513,46,11,Player A
14584,JointPQPlayer,262,262,524,48,8,Tie
14585,JointPQPlayer,241,246,487,41,18,JointPQPlayer
14586,JointPQPlayer,247,242,489,46,19,Player A
14587,JointPQPlayer,181,186,367,8,47,JointPQPlayer
14588,JointPQPlayer,258,253,511,44,11,Player A
14589,JointPQPlayer,271,271,542,57,5,Tie
14590,JointPQPlayer,275,275,550,59,3,Tie
14591,JointPQPlayer,257,257,514,50,12,Tie
14592,JointPQPlayer,243,243,486,40,18,Tie
14593,JointPQPlayer,240,240,480,46,22,Tie
14594,JointPQPlayer,245,250,495,40,15,JointPQPlayer
14595,JointPQPlayer,215,215,430,35,35,Tie
14596,JointPQPlayer,246,241,487,38,17,Player A
14597,JointPQPlayer,261,261,522,46,8,Tie
14598,JointPQPlayer,174,174,348,4,52,Tie
14599,JointPQPlayer,256,256,512,51,13,Tie
14600,JointPQPlayer,176,181,357,13,52,JointPQPlayer
14601,JointPQPlayer,229,224,453,37,28,Player A
14602,JointPQPlayer,258,258,516,40,8,Tie
14603,JointPQPlayer,258,263,521,48,9,JointPQPlayer
14604,JointPQPlayer,266,261,527,54,9,Player A
14605,JointPQPlayer,237,242,479,42,21,JointPQPlayer
14606,JointPQPlayer,179,179,358,5,49,Tie
14607,JointPQPlayer,256,251,507,46,13,Player A
14608,JointPQPlayer,266,266,532,50,6,Tie
14609,JointPQPlayer,244,244,488,45,19,Tie
14610,JointPQPlayer,215,215,430,32,34,Tie
14611,JointPQPlayer,236,241,477,37,20,JointPQPlayer
14612,JointPQPlayer,163,158,321,4,61,Player A
14613,JointPQPlayer,232,232,464,36,24,Tie
14614,JointPQPlayer,219,224,443,33,30,JointPQPlayer
14615,JointPQPlayer,262,257,519,49,10,Player A
14616,JointPQPlayer,167,172,339,7,56,JointPQPlayer
14617,JointPQPlayer,247,247,494,33,13,Tie
14618,JointPQPlayer,265,265,530,48,6,Tie
14619,JointPQPlayer,191,186,377,12,45,Player A
14620,JointPQPlayer,249,249,498,40,14,Tie
14621,JointPQPlayer,194,199,393,16,41,JointPQPlayer
14622,JointPQPlayer,253,248,501,46,15,Player A
14623,JointPQPlayer,187,187,374,18,48,Tie
14624,JointPQPlayer,254,254,508,38,10,Tie
14625,JointPQPlayer,259,259,518,45,9,Tie
14626,JointPQPlayer,268,273,541,56,5,JointPQPlayer
14627,JointPQPlayer,260,255,515,51,12,Player A
14628,JointPQPlayer,267,267,534,52,6,Tie
14629,JointPQPlayer,258,258,516,55,13,Tie
14630,JointPQPlayer,256,256,512,45,11,Tie
14631,JointPQPlayer,235,240,475,38,21,JointPQPlayer
14632,JointPQPlayer,164,164,328,2,58,Tie
14633,JointPQPlayer,260,260,520,56,12,Tie
14634,JointPQPlayer,260,255,515,48,11,Player A
14635,JointPQPlayer,174,179,353,9,52,JointPQPlayer
14636,JointPQPlayer,265,260,525,46,7,Player A
14637,JointPQPlayer,257,262,519,37,6,JointPQPlayer
14638,JointPQPlayer,236,231,467,36,23,Player A
14639,JointPQPlayer,260,265,525,43,6,JointPQPlayer
14640,JointPQPlayer,260,260,520,44,8,Tie
14641,JointPQPlayer,240,235,475,41,22,Player A
14642,JointPQPlayer,178,183,361,14,51,JointPQPlayer
14643,JointPQPlayer,261,261,522,46,8,Tie
14644,JointPQPlayer,269,264,533,57,8,Player A
14645,JointPQPlayer,231,231,462,31,23,Tie
14646,JointPQPlayer,231,236,467,39,24,JointPQPlayer
14647,JointPQPlayer,252,247,499,44,15,Player A
14648,JointPQPlayer,255,255,510,43,11,Tie
14649,JointPQPlayer,261,261,522,49,9,Tie
14650,JointPQPlayer,178,178,356,6,50,Tie
14651,JointPQPlayer,241,241,482,36,18,Tie
14652,JointPQPlayer,268,273,541,53,4,JointPQPlayer
14653,JointPQPlayer,259,259,518,51,11,Tie
14654,JointPQPlayer,240,235,475,38,21,Player A
14655,JointPQPlayer,243,248,491,39,16,JointPQPlayer
14656,JointPQPlayer,170,165,335,3,56,Player A
14657,JointPQPlayer,246,246,492,40,16,Tie
14658,JointPQPlayer,260,265,525,52,9,JointPQPlayer
14659,JointPQPlayer,252,247,499,47,16,Player A
14660,JointPQPlayer,263,263,526,50,8,Tie
14661,JointPQPlayer,261,261,522,49,9,Tie
14662,JointPQPlayer,256,256,512,42,10,Tie
14663,JointPQPlayer,238,243,481,35,18,JointPQPlayer
14664,JointPQPlayer,255,250,505,47,14,Player A
14665,JointPQPlayer,269,269,538,56,6,Tie
14666,JointPQPlayer,268,273,541,56,5,JointPQPlayer
14667,JointPQPlayer,246,246,492,40,16,Tie
14668,JointPQPlayer,266,266,532,56,8,Tie
14669,JointPQPlayer,262,257,519,46,9,Player A
14670,JointPQPlayer,237,242,479,30,17,JointPQPlayer
14671,JointPQPlayer,270,265,535,53,6,Player A
14672,JointPQPlayer,195,200,395,21,42,JointPQPlayer
14673,JointPQPlayer,264,264,528,46,6,Tie
14674,JointPQPlayer,254,249,503,39,12,Player A
14675,JointPQPlayer,255,255,510,43,11,Tie
14676,JointPQPlayer,211,211,422,21,33,Tie
14677,JointPQPlayer,181,186,367,11,48,JointPQPlayer
14678,JointPQPlayer,244,239,483,31,16,Player A
14679,JointPQPlayer,242,247,489,34,15,JointPQPlayer
14680,JointPQPlayer,244,239,483,40,19,Player A
14681,JointPQPlayer,275,275,550,62,4,Tie
14682,JointPQPlayer,250,250,500,45,15,Tie
14683,JointPQPlayer,268,268,536,48,4,Tie
14684,JointPQPlayer,249,254,503,48,15,JointPQPlayer
14685,JointPQPlayer,195,195,390,22,44,Tie
14686,JointPQPlayer,260,255,515,48,11,Player A
14687,JointPQPlayer,161,166,327,4,59,JointPQPlayer
14688,JointPQPlayer,250,250,500,45,15,Tie
14689,JointPQPlayer,183,178,361,8,49,Player A
14690,JointPQPlayer,252,257,509,51,14,JointPQPlayer
14691,JointPQPlayer,240,240,480,46,22,Tie
14692,JointPQPlayer,247,247,494,36,14,Tie
14693,JointPQPlayer,247,242,489,46,19,Player A
14694,JointPQPlayer,243,243,486,34,16,Tie
14695,JointPQPlayer,272,272,544,62,6,Tie
14696,JointPQPlayer,247,247,494,39,15,Tie
14697,JointPQPlayer,227,227,454,41,29,Tie
14698,JointPQPlayer,265,270,535,53,6,JointPQPlayer
14699,JointPQPlayer,256,256,512,39,9,Tie
14700,JointPQPlayer,213,208,421,29,36,Player A
14701,JointPQPlayer,261,261,522,52,10,Tie
14702,JointPQPlayer,236,236,472,35,21,Tie
14703,JointPQPlayer,182,187,369,7,46,JointPQPlayer
14704,JointPQPlayer,255,250,505,47,14,Player A
14705,JointPQPlayer,266,271,537,55,6,JointPQPlayer
14706,JointPQPlayer,247,247,494,39,15,Tie
14707,JointPQPlayer,220,220,440,33,31,Tie
14708,JointPQPlayer,250,245,495,37,14,Player A
14709,JointPQPlayer,268,268,536,51,5,Tie
14710,JointPQPlayer,262,267,529,47,6,JointPQPlayer
14711,JointPQPlayer,164,159,323,3,60,Player A
14712,JointPQPlayer,273,273,546,61,5,Tie
14713,JointPQPlayer,275,275,550,56,2,Tie
14714,JointPQPlayer,232,232,464,36,24,Tie
14715,JointPQPlayer,252,252,504,49,15,Tie
14716,JointPQPlayer,245,245,490,44,18,Tie
14717,JointPQPlayer,254,254,508,44,12,Tie
14718,JointPQPlayer,254,254,508,47,13,Tie
14719,JointPQPlayer,229,229,458,39,27,Tie
14720,JointPQPlayer,164,169,333,4,57,JointPQPlayer
14721,JointPQPlayer,268,268,536,48,4,Tie
14722,JointPQPlayer,229,229,458,36,26,Tie
14723,JointPQPlayer,182,182,364,11,49,Tie
14724,JointPQPlayer,265,260,525,55,10,Player A
14725,JointPQPlayer,252,257,509,51,14,JointPQPlayer
14726,JointPQPlayer,239,239,478,32,18,Tie
14727,JointPQPlayer,158,158,316,8,64,Tie
14728,JointPQPlayer,268,263,531,58,9,Player A
14729,JointPQPlayer,252,257,509,45,12,JointPQPlayer
14730,JointPQPlayer,264,264,528,52,8,Tie
14731,JointPQPlayer,241,241,482,39,19,Tie
14732,JointPQPlayer,220,215,435,34,33,Player A
14733,JointPQPlayer,253,253,506,45,13,Tie
14734,JointPQPlayer,177,182,359,6,49,JointPQPlayer
14735,JointPQPlayer,245,245,490,41,17,Tie
14736,JointPQPlayer,237,232,469,32,21,Player A
14737,JointPQPlayer,164,164,328,2,58,Tie
14738,JointPQPlayer,272,272,544,53,3,Tie
14739,JointPQPlayer,250,250,500,45,15,Tie
14740,JointPQPlayer,233,233,466,38,24,Tie
14741,JointPQPlayer,178,183,361,11,50,JointPQPlayer
14742,JointPQPlayer,250,250,500,39,13,Tie
14743,JointPQPlayer,258,258,516,52,12,Tie
14744,JointPQPlayer,259,254,513,43,10,Player A
14745,JointPQPlayer,245,245,490,35,15,Tie
14746,JointPQPlayer,254,259,513,52,13,JointPQPlayer
14747,JointPQPlayer,210,210,420,25,35,Tie
14748,JointPQPlayer,279,274,553,62,3,Player A
14749,JointPQPlayer,263,263,526,50,8,Tie
14750,JointPQPlayer,260,260,520,50,10,Tie
14751,JointPQPlayer,263,268,531,58,9,JointPQPlayer
14752,JointPQPlayer,254,249,503,42,13,Player A
14753,JointPQPlayer,260,260,520,47,9,Tie
14754,JointPQPlayer,260,265,525,55,10,JointPQPlayer
14755,JointPQPlayer,245,245,490,41,17,Tie
14756,JointPQPlayer,238,233,471,31,20,Player A
14757,JointPQPlayer,239,244,483,37,18,JointPQPlayer
14758,JointPQPlayer,267,262,529,47,6,Player A
14759,JointPQPlayer,228,233,461,30,23,JointPQPlayer
14760,JointPQPlayer,260,255,515,51,12,Player A
14761,JointPQPlayer,246,246,492,46,18,Tie
14762,JointPQPlayer,195,200,395,12,39,JointPQPlayer
14763,JointPQPlayer,240,235,475,41,22,Player A
14764,JointPQPlayer,251,256,507,46,13,JointPQPlayer
14765,JointPQPlayer,259,254,513,49,12,Player A
14766,JointPQPlayer,244,244,488,33,15,Tie
14767,JointPQPlayer,257,257,514,44,10,Tie
14768,JointPQPlayer,270,270,540,58,6,Tie
14769,JointPQPlayer,234,234,468,34,22,Tie
14770,JointPQPlayer,212,212,424,23,33,Tie
14771,JointPQPlayer,220,225,445,32,29,JointPQPlayer
14772,JointPQPlayer,262,257,519,43,8,Player A
14773,JointPQPlayer,171,176,347,12,55,JointPQPlayer
14774,JointPQPlayer,263,263,526,44,6,Tie
14775,JointPQPlayer,180,175,355,11,52,Player A
14776,JointPQPlayer,253,253,506,48,14,Tie
14777,JointPQPlayer,248,253,501,40,13,JointPQPlayer
14778,JointPQPlayer,253,248,501,43,14,Player A
14779,JointPQPlayer,243,243,486,37,17,Tie
14780,JointPQPlayer,243,248,491,45,18,JointPQPlayer
14781,JointPQPlayer,261,261,522,49,9,Tie
14782,JointPQPlayer,257,252,509,45,12,Player A
14783,JointPQPlayer,251,251,502,50,16,Tie
14784,JointPQPlayer,193,198,391,23,44,JointPQPlayer
14785,JointPQPlayer,246,241,487,38,17,Player A
14786,JointPQPlayer,258,263,521,51,10,JointPQPlayer
14787,JointPQPlayer,243,243,486,40,18,Tie
14788,JointPQPlayer,178,178,356,9,51,Tie
14789,JointPQPlayer,196,191,387,16,43,Player A
14790,JointPQPlayer,222,222,444,28,28,Tie
14791,JointPQPlayer,211,211,422,33,37,Tie
14792,JointPQPlayer,201,201,402,10,36,Tie
14793,JointPQPlayer,255,260,515,48,11,JointPQPlayer
14794,JointPQPlayer,251,246,497,48,17,Player A
14795,JointPQPlayer,255,255,510,46,12,Tie
14796,JointPQPlayer,265,265,530,51,7,Tie
14797,JointPQPlayer,253,258,511,44,11,JointPQPlayer
14798,JointPQPlayer,213,208,421,29,36,Player A
14799,JointPQPlayer,211,211,422,27,35,Tie
14800,JointPQPlayer,271,271,542,57,5,Tie
14801,JointPQPlayer,262,267,529,50,7,JointPQPlayer
14802,JointPQPlayer,259,254,513,52,13,Player A
14803,JointPQPlayer,258,258,516,46,10,Tie
14804,JointPQPlayer,172,177,349,5,52,JointPQPlayer
14805,JointPQPlayer,254,249,503,45,14,Player A
14806,JointPQPlayer,244,244,488,39,17,Tie
14807,JointPQPlayer,253,253,506,51,15,Tie
14808,JointPQPlayer,242,242,484,38,18,Tie
14809,JointPQPlayer,195,195,390,13,41,Tie
14810,JointPQPlayer,204,204,408,25,39,Tie
14811,JointPQPlayer,256,261,517,44,9,JointPQPlayer
14812,JointPQPlayer,217,212,429,34,35,Player A
14813,JointPQPlayer,256,256,512,45,11,Tie
14814,JointPQPlayer,160,160,320,6,62,Tie
14815,JointPQPlayer,186,191,377,9,44,JointPQPlayer
14816,JointPQPlayer,258,258,516,49,11,Tie
14817,JointPQPlayer,226,226,452,30,26,Tie
14818,JointPQPlayer,163,158,321,4,61,Player A
14819,JointPQPlayer,253,253,506,45,13,Tie
14820,JointPQPlayer,239,239,478,38,20,Tie
14821,JointPQPlayer,263,263,526,41,5,Tie
14822,JointPQPlayer,228,228,456,34,26,Tie
14823,JointPQPlayer,255,255,510,43,11,Tie
14824,JointPQPlayer,247,252,499,44,15,JointPQPlayer
14825,JointPQPlayer,269,269,538,59,7,Tie
14826,JointPQPlayer,265,265,530,51,7,Tie
14827,JointPQPlayer,245,245,490,44,18,Tie
14828,JointPQPlayer,251,246,497,42,15,Player A
14829,JointPQPlayer,241,241,482,39,19,Tie
14830,JointPQPlayer,258,258,516,40,8,Tie
14831,JointPQPlayer,272,277,549,61,4,JointPQPlayer
14832,JointPQPlayer,251,246,497,42,15,Player A
14833,JointPQPlayer,257,257,514,53,13,Tie
14834,JointPQPlayer,271,276,547,53,2,JointPQPlayer
14835,JointPQPlayer,259,254,513,43,10,Player A
14836,JointPQPlayer,267,267,534,49,5,Tie
14837,JointPQPlayer,267,272,539,57,6,JointPQPlayer
14838,JointPQPlayer,266,261,527,51,8,Player A
14839,JointPQPlayer,269,269,538,59,7,Tie
14840,JointPQPlayer,179,179,358,8,50,Tie
14841,JointPQPlayer,256,256,512,45,11,Tie
14842,JointPQPlayer,255,255,510,46,12,Tie
14843,JointPQPlayer,218,218,436,32,32,Tie
14844,JointPQPlayer,265,265,530,57,9,Tie
14845,JointPQPlayer,186,191,377,15,46,JointPQPlayer
14846,JointPQPlayer,263,258,521,51,10,Player A
14847,JointPQPlayer,244,244,488,36,16,Tie
14848,JointPQPlayer,228,228,456,31,25,Tie
14849,JointPQPlayer,259,259,518,42,8,Tie
14850,JointPQPlayer,247,247,494,45,17,Tie
14851,JointPQPlayer,243,248,491,45,18,JointPQPlayer
14852,JointPQPlayer,188,188,376,8,44,Tie
14853,JointPQPlayer,205,200,405,22,39,Player A
14854,JointPQPlayer,174,179,353,9,52,JointPQPlayer
14855,JointPQPlayer,259,259,518,48,10,Tie
14856,JointPQPlayer,254,254,508,44,12,Tie
14857,JointPQPlayer,261,256,517,50,11,Player A
14858,JointPQPlayer,246,246,492,46,18,Tie
14859,JointPQPlayer,251,251,502,41,13,Tie
14860,JointPQPlayer,268,268,536,57,7,Tie
14861,JointPQPlayer,207,207,414,28,38,Tie
14862,JointPQPlayer,263,268,531,52,7,JointPQPlayer
14863,JointPQPlayer,242,242,484,41,19,Tie
14864,JointPQPlayer,253,248,501,40,13,Player A
14865,JointPQPlayer,246,246,492,37,15,Tie
14866,JointPQPlayer,255,255,510,46,12,Tie
14867,JointPQPlayer,191,196,387,13,42,JointPQPlayer
14868,JointPQPlayer,240,235,475,38,21,Player A
14869,JointPQPlayer,249,254,503,33,10,JointPQPlayer
14870,JointPQPlayer,250,250,500,48,16,Tie
14871,JointPQPlayer,250,245,495,46,17,Player A
14872,JointPQPlayer,265,265,530,57,9,Tie
14873,JointPQPlayer,236,236,472,32,20,Tie
14874,JointPQPlayer,268,273,541,56,5,JointPQPlayer
14875,JointPQPlayer,171,171,342,13,57,Tie
14876,JointPQPlayer,231,231,462,34,24,Tie
14877,JointPQPlayer,186,181,367,14,49,Player A
14878,JointPQPlayer,267,267,534,55,7,Tie
14879,JointPQPlayer,267,272,539,57,6,JointPQPlayer
14880,JointPQPlayer,221,216,437,27,30,Player A
14881,JointPQPlayer,251,256,507,46,13,JointPQPlayer
14882,JointPQPlayer,253,248,501,49,16,Player A
14883,JointPQPlayer,241,246,487,38,17,JointPQPlayer
14884,JointPQPlayer,253,248,501,46,15,Player A
14885,JointPQPlayer,174,179,353,9,52,JointPQPlayer
14886,JointPQPlayer,201,196,397,17,40,Player A
14887,JointPQPlayer,264,264,528,43,5,Tie
14888,JointPQPlayer,250,250,500,45,15,Tie
14889,JointPQPlayer,264,264,528,46,6,Tie
14890,JointPQPlayer,263,263,526,50,8,Tie
14891,JointPQPlayer,236,241,477,37,20,JointPQPlayer
14892,JointPQPlayer,274,269,543,58,5,Player A
14893,JointPQPlayer,250,250,500,45,15,Tie
14894,JointPQPlayer,249,249,498,46,16,Tie
14895,JointPQPlayer,238,238,476,42,22,Tie
14896,JointPQPlayer,237,242,479,36,19,JointPQPlayer
14897,JointPQPlayer,263,263,526,50,8,Tie
14898,JointPQPlayer,255,250,505,44,13,Player A
14899,JointPQPlayer,247,247,494,42,16,Tie
14900,JointPQPlayer,268,273,541,62,7,JointPQPlayer
14901,JointPQPlayer,257,252,509,45,12,Player A
14902,JointPQPlayer,270,270,540,55,5,Tie
14903,JointPQPlayer,167,172,339,13,58,JointPQPlayer
14904,JointPQPlayer,270,265,535,50,5,Player A
14905,JointPQPlayer,271,271,542,54,4,Tie
14906,JointPQPlayer,251,251,502,47,15,Tie
14907,JointPQPlayer,263,263,526,53,9,Tie
14908,JointPQPlayer,173,178,351,10,53,JointPQPlayer
14909,JointPQPlayer,262,262,524,45,7,Tie
14910,JointPQPlayer,265,260,525,55,10,Player A
14911,JointPQPlayer,235,240,475,35,20,JointPQPlayer
14912,JointPQPlayer,266,261,527,54,9,Player A
14913,JointPQPlayer,250,250,500,39,13,Tie
14914,JointPQPlayer,174,174,348,13,55,Tie
14915,JointPQPlayer,253,253,506,48,14,Tie
14916,JointPQPlayer,176,181,357,7,50,JointPQPlayer
14917,JointPQPlayer,239,234,473,39,22,Player A
14918,JointPQPlayer,263,263,526,50,8,Tie
14919,JointPQPlayer,266,266,532,53,7,Tie
14920,JointPQPlayer,195,195,390,19,43,Tie
14921,JointPQPlayer,257,257,514,44,10,Tie
14922,JointPQPlayer,263,263,526,47,7,Tie
14923,JointPQPlayer,229,229,458,36,26,Tie
14924,JointPQPlayer,241,241,482,48,22,Tie
14925,JointPQPlayer,201,201,402,22,40,Tie
14926,JointPQPlayer,244,244,488,48,20,Tie
14927,JointPQPlayer,251,251,502,44,14,Tie
14928,JointPQPlayer,266,271,537,55,6,JointPQPlayer
14929,JointPQPlayer,253,248,501,49,16,Player A
14930,JointPQPlayer,254,254,508,50,14,Tie
14931,JointPQPlayer,245,245,490,41,17,Tie
14932,JointPQPlayer,169,174,343,5,54,JointPQPlayer
14933,JointPQPlayer,260,255,515,48,11,Player A
14934,JointPQPlayer,250,255,505,47,14,JointPQPlayer
14935,JointPQPlayer,262,257,519,49,10,Player A
14936,JointPQPlayer,240,245,485,42,19,JointPQPlayer
14937,JointPQPlayer,203,203,406,20,38,Tie
14938,JointPQPlayer,260,255,515,39,8,Player A
14939,JointPQPlayer,167,172,339,7,56,JointPQPlayer
14940,JointPQPlayer,263,258,521,48,9,Player A
14941,JointPQPlayer,257,257,514,44,10,Tie
14942,JointPQPlayer,229,229,458,33,25,Tie
14943,JointPQPlayer,258,258,516,46,10,Tie
14944,JointPQPlayer,250,255,505,41,12,JointPQPlayer
14945,JointPQPlayer,233,233,466,44,26,Tie
14946,JointPQPlayer,262,257,519,52,11,Player A
14947,JointPQPlayer,161,166,327,7,60,JointPQPlayer
14948,JointPQPlayer,192,187,379,20,47,Player A
14949,JointPQPlayer,230,235,465,40,25,JointPQPlayer
14950,JointPQPlayer,267,262,529,53,8,Player A
14951,JointPQPlayer,206,206,412,29,39,Tie
14952,JointPQPlayer,261,261,522,55,11,Tie
14953,JointPQPlayer,270,270,540,64,8,Tie
14954,JointPQPlayer,250,255,505,41,12,JointPQPlayer
14955,JointPQPlayer,256,251,507,43,12,Player A
14956,JointPQPlayer,247,252,499,38,13,JointPQPlayer
14957,JointPQPlayer,271,266,537,55,6,Player A
14958,JointPQPlayer,255,260,515,48,11,JointPQPlayer
14959,JointPQPlayer,180,180,360,4,48,Tie
14960,JointPQPlayer,165,160,325,5,60,Player A
14961,JointPQPlayer,243,243,486,43,19,Tie
14962,JointPQPlayer,241,246,487,53,22,JointPQPlayer
14963,JointPQPlayer,258,253,511,44,11,Player A
14964,JointPQPlayer,280,280,560,66,2,Tie
14965,JointPQPlayer,228,228,456,34,26,Tie
14966,JointPQPlayer,257,257,514,47,11,Tie
14967,JointPQPlayer,171,176,347,9,54,JointPQPlayer
14968,JointPQPlayer,258,258,516,49,11,Tie
14969,JointPQPlayer,256,256,512,42,10,Tie
14970,JointPQPlayer,228,223,451,35,28,Player A
14971,JointPQPlayer,210,210,420,25,35,Tie
14972,JointPQPlayer,250,250,500,39,13,Tie
14973,JointPQPlayer,259,259,518,51,11,Tie
14974,JointPQPlayer,239,239,478,41,21,Tie
14975,JointPQPlayer,260,260,520,50,10,Tie
14976,JointPQPlayer,258,263,521,45,8,JointPQPlayer
14977,JointPQPlayer,245,240,485,42,19,Player A
14978,JointPQPlayer,261,261,522,46,8,Tie
14979,JointPQPlayer,251,256,507,43,12,JointPQPlayer
14980,JointPQPlayer,225,220,445,26,27,Player A
14981,JointPQPlayer,252,252,504,40,12,Tie
14982,JointPQPlayer,160,165,325,5,60,JointPQPlayer
14983,JointPQPlayer,260,255,515,54,13,Player A
14984,JointPQPlayer,271,271,542,63,7,Tie
14985,JointPQPlayer,256,256,512,42,10,Tie
14986,JointPQPlayer,190,190,380,21,47,Tie
14987,JointPQPlayer,251,251,502,50,16,Tie
14988,JointPQPlayer,211,211,422,21,33,Tie
14989,JointPQPlayer,265,270,535,53,6,JointPQPlayer
14990,JointPQPlayer,260,255,515,57,14,Player A
14991,JointPQPlayer,257,257,514,47,11,Tie
14992,JointPQPlayer,257,262,519,52,11,JointPQPlayer
14993,JointPQPlayer,249,244,493,47,18,Player A
14994,JointPQPlayer,270,270,540,61,7,Tie
14995,JointPQPlayer,263,268,531,49,6,JointPQPlayer
14996,JointPQPlayer,239,234,473,42,23,Player A
14997,JointPQPlayer,223,228,451,29,26,JointPQPlayer
14998,JointPQPlayer,255,250,505,44,13,Player A
14999,JointPQPlayer,268,268,536,60,8,Tie
15000,JointPQPlayer,262,262,524,48,8,Tie
15001,JointPQPlayer,178,183,361,8,49,JointPQPlayer
15002,JointPQPlayer,241,236,477,31,18,Player A
15003,JointPQPlayer,256,256,512,45,11,Tie
15004,JointPQPlayer,224,224,448,29,27,Tie
15005,JointPQPlayer,186,191,377,9,44,JointPQPlayer
15006,JointPQPlayer,234,234,468,37,23,Tie
15007,JointPQPlayer,239,234,473,36,21,Player A
15008,JointPQPlayer,260,260,520,47,9,Tie
15009,JointPQPlayer,224,224,448,35,29,Tie
15010,JointPQPlayer,185,190,375,13,46,JointPQPlayer
15011,JointPQPlayer,175,175,350,9,53,Tie
15012,JointPQPlayer,260,260,520,44,8,Tie
15013,JointPQPlayer,254,254,508,44,12,Tie
15014,JointPQPlayer,222,217,439,26,29,Player A
15015,JointPQPlayer,200,200,400,17,39,Tie
15016,JointPQPlayer,226,231,457,41,28,JointPQPlayer
15017,JointPQPlayer,168,163,331,8,59,Player A
15018,JointPQPlayer,251,256,507,31,8,JointPQPlayer
15019,JointPQPlayer,262,257,519,49,10,Player A
15020,JointPQPlayer,239,239,478,35,19,Tie
15021,JointPQPlayer,245,245,490,41,17,Tie
15022,JointPQPlayer,266,271,537,55,6,JointPQPlayer
15023,JointPQPlayer,189,189,378,10,44,Tie
15024,JointPQPlayer,251,246,497,48,17,Player A
15025,JointPQPlayer,265,265,530,48,6,Tie
15026,JointPQPlayer,253,253,506,48,14,Tie
15027,JointPQPlayer,264,264,528,49,7,Tie
15028,JointPQPlayer,237,237,474,34,20,Tie
15029,JointPQPlayer,250,250,500,51,17,Tie
15030,JointPQPlayer,264,264,528,49,7,Tie
15031,JointPQPlayer,242,242,484,41,19,Tie
15032,JointPQPlayer,253,258,511,47,12,JointPQPlayer
15033,JointPQPlayer,247,247,494,36,14,Tie
15034,JointPQPlayer,179,179,358,8,50,Tie
15035,JointPQPlayer,254,249,503,51,16,Player A
15036,JointPQPlayer,262,267,529,56,9,JointPQPlayer
15037,JointPQPlayer,264,264,528,46,6,Tie
15038,JointPQPlayer,242,242,484,41,19,Tie
15039,JointPQPlayer,233,233,466,29,21,Tie
15040,JointPQPlayer,259,259,518,48,10,Tie
15041,JointPQPlayer,250,250,500,51,17,Tie
15042,JointPQPlayer,186,186,372,10,46,Tie
15043,JointPQPlayer,249,244,493,38,15,Player A
15044,JointPQPlayer,156,161,317,6,63,JointPQPlayer
15045,JointPQPlayer,263,263,526,56,10,Tie
15046,JointPQPlayer,187,182,369,13,48,Player A
15047,JointPQPlayer,256,256,512,45,11,Tie
15048,JointPQPlayer,192,192,384,16,44,Tie
15049,JointPQPlayer,265,265,530,51,7,Tie
15050,JointPQPlayer,244,249,493,35,14,JointPQPlayer
15051,JointPQPlayer,244,239,483,37,18,Player A
15052,JointPQPlayer,244,244,488,48,20,Tie
15053,JointPQPlayer,265,270,535,53,6,JointPQPlayer
15054,JointPQPlayer,269,264,533,54,7,Player A
15055,JointPQPlayer,269,269,538,59,7,Tie
15056,JointPQPlayer,273,273,546,52,2,Tie
15057,JointPQPlayer,257,257,514,50,12,Tie
15058,JointPQPlayer,270,270,540,49,3,Tie
15059,JointPQPlayer,253,253,506,54,16,Tie
15060,JointPQPlayer,246,246,492,49,19,Tie
15061,JointPQPlayer,277,277,554,60,2,Tie
15062,JointPQPlayer,260,260,520,47,9,Tie
15063,JointPQPlayer,262,267,529,50,7,JointPQPlayer
15064,JointPQPlayer,210,205,415,29,38,Player A
15065,JointPQPlayer,264,264,528,49,7,Tie
15066,JointPQPlayer,176,181,357,4,49,JointPQPlayer
15067,JointPQPlayer,217,212,429,28,33,Player A
15068,JointPQPlayer,247,247,494,36,14,Tie
15069,JointPQPlayer,265,270,535,62,9,JointPQPlayer
15070,JointPQPlayer,262,257,519,49,10,Player A
15071,JointPQPlayer,261,266,527,48,7,JointPQPlayer
15072,JointPQPlayer,221,216,437,30,31,Player A
15073,JointPQPlayer,223,223,446,27,27,Tie
15074,JointPQPlayer,258,263,521,39,6,JointPQPlayer
15075,JointPQPlayer,272,267,539,57,6,Player A
15076,JointPQPlayer,265,265,530,48,6,Tie
15077,JointPQPlayer,259,259,518,51,11,Tie
15078,JointPQPlayer,245,250,495,46,17,JointPQPlayer
15079,JointPQPlayer,227,222,449,30,27,Player A
15080,JointPQPlayer,276,276,552,61,3,Tie
15081,JointPQPlayer,233,233,466,38,24,Tie
15082,JointPQPlayer,251,256,507,46,13,JointPQPlayer
15083,JointPQPlayer,173,173,346,8,54,Tie
15084,JointPQPlayer,218,218,436,23,29,Tie
15085,JointPQPlayer,189,189,378,7,43,Tie
15086,JointPQPlayer,239,234,473,42,23,Player A
15087,JointPQPlayer,267,267,534,49,5,Tie
15088,JointPQPlayer,256,261,517,44,9,JointPQPlayer
15089,JointPQPlayer,249,244,493,41,16,Player A
15090,JointPQPlayer,261,261,522,49,9,Tie
15091,JointPQPlayer,268,268,536,57,7,Tie
15092,JointPQPlayer,228,228,456,34,26,Tie
15093,JointPQPlayer,257,257,514,50,12,Tie
15094,JointPQPlayer,251,256,507,43,12,JointPQPlayer
15095,JointPQPlayer,269,264,533,54,7,Player A
15096,JointPQPlayer,177,177,354,10,52,Tie
15097,JointPQPlayer,230,230,460,29,23,Tie
15098,JointPQPlayer,259,259,518,51,11,Tie
15099,JointPQPlayer,229,229,458,33,25,Tie
15100,JointPQPlayer,258,258,516,49,11,Tie
15101,JointPQPlayer,259,259,518,45,9,Tie
15102,JointPQPlayer,260,260,520,44,8,Tie
15103,JointPQPlayer,269,274,543,55,4,JointPQPlayer
15104,JointPQPlayer,261,256,517,50,11,Player A
15105,JointPQPlayer,268,268,536,51,5,Tie
15106,JointPQPlayer,219,219,438,25,29,Tie
15107,JointPQPlayer,213,213,426,19,31,Tie
15108,JointPQPlayer,258,258,516,46,10,Tie
15109,JointPQPlayer,258,258,516,49,11,Tie
15110,JointPQPlayer,264,264,528,49,7,Tie
15111,JointPQPlayer,186,186,372,13,47,Tie
15112,JointPQPlayer,222,222,444,43,33,Tie
15113,JointPQPlayer,249,249,498,46,16,Tie
15114,JointPQPlayer,264,264,528,49,7,Tie
15115,JointPQPlayer,249,249,498,37,13,Tie
15116,JointPQPlayer,255,260,515,48,11,JointPQPlayer
15117,JointPQPlayer,221,216,437,30,31,Player A
15118,JointPQPlayer,175,180,355,8,51,JointPQPlayer
15119,JointPQPlayer,269,264,533,60,9,Player A
15120,JointPQPlayer,258,263,521,51,10,JointPQPlayer
15121,JointPQPlayer,249,249,498,40,14,Tie
15122,JointPQPlayer,263,263,526,44,6,Tie
15123,JointPQPlayer,262,257,519,49,10,Player A
15124,JointPQPlayer,152,157,309,1,64,JointPQPlayer
15125,JointPQPlayer,267,267,534,52,6,Tie
15126,JointPQPlayer,269,264,533,54,7,Player A
15127,JointPQPlayer,255,260,515,54,13,JointPQPlayer
15128,JointPQPlayer,250,250,500,48,16,Tie
15129,JointPQPlayer,236,231,467,33,22,Player A
15130,JointPQPlayer,209,209,418,23,35,Tie
15131,JointPQPlayer,268,268,536,48,4,Tie
15132,JointPQPlayer,261,261,522,58,12,Tie
15133,JointPQPlayer,185,190,375,7,44,JointPQPlayer
15134,JointPQPlayer,252,252,504,40,12,Tie
15135,JointPQPlayer,259,254,513,46,11,Player A
15136,JointPQPlayer,262,262,524,45,7,Tie
15137,JointPQPlayer,224,224,448,38,30,Tie
15138,JointPQPlayer,191,191,382,14,44,Tie
15139,JointPQPlayer,258,258,516,43,9,Tie
15140,JointPQPlayer,248,248,496,44,16,Tie
15141,JointPQPlayer,253,258,511,41,10,JointPQPlayer
15142,JointPQPlayer,253,248,501,46,15,Player A
15143,JointPQPlayer,252,257,509,42,11,JointPQPlayer
15144,JointPQPlayer,165,165,330,4,58,Tie
15145,JointPQPlayer,275,270,545,60,5,Player A
15146,JointPQPlayer,236,236,472,38,22,Tie
15147,JointPQPlayer,257,257,514,53,13,Tie
15148,JointPQPlayer,242,247,489,37,16,JointPQPlayer
15149,JointPQPlayer,244,239,483,34,17,Player A
15150,JointPQPlayer,245,250,495,37,14,JointPQPlayer
15151,JointPQPlayer,175,175,350,9,53,Tie
15152,JointPQPlayer,258,258,516,52,12,Tie
15153,JointPQPlayer,269,264,533,51,6,Player A
15154,JointPQPlayer,184,184,368,9,47,Tie
15155,JointPQPlayer,213,213,426,34,36,Tie
15156,JointPQPlayer,208,208,416,30,38,Tie
15157,JointPQPlayer,226,226,452,30,26,Tie
15158,JointPQPlayer,260,260,520,47,9,Tie
15159,JointPQPlayer,224,229,453,28,25,JointPQPlayer
15160,JointPQPlayer,258,258,516,46,10,Tie
15161,JointPQPlayer,237,232,469,38,23,Player A
15162,JointPQPlayer,242,242,484,44,20,Tie
15163,JointPQPlayer,239,239,478,38,20,Tie
15164,JointPQPlayer,219,224,443,24,27,JointPQPlayer
15165,JointPQPlayer,171,166,337,5,56,Player A
15166,JointPQPlayer,151,151,302,3,67,Tie
15167,JointPQPlayer,200,200,400,14,38,Tie
15168,JointPQPlayer,266,266,532,56,8,Tie
15169,JointPQPlayer,244,244,488,36,16,Tie
15170,JointPQPlayer,189,194,383,24,47,JointPQPlayer
15171,JointPQPlayer,255,255,510,43,11,Tie
15172,JointPQPlayer,266,266,532,62,10,Tie
15173,JointPQPlayer,261,261,522,46,8,Tie
15174,JointPQPlayer,255,250,505,47,14,Player A
15175,JointPQPlayer,250,250,500,42,14,Tie
15176,JointPQPlayer,197,197,394,20,42,Tie
15177,JointPQPlayer,272,277,549,61,4,JointPQPlayer
15178,JointPQPlayer,206,206,412,26,38,Tie
15179,JointPQPlayer,262,257,519,52,11,Player A
15180,JointPQPlayer,267,272,539,57,6,JointPQPlayer
15181,JointPQPlayer,253,248,501,46,15,Player A
15182,JointPQPlayer,251,251,502,44,14,Tie
15183,JointPQPlayer,176,181,357,10,51,JointPQPlayer
15184,JointPQPlayer,251,246,497,48,17,Player A
15185,JointPQPlayer,245,245,490,44,18,Tie
15186,JointPQPlayer,226,231,457,35,26,JointPQPlayer
15187,JointPQPlayer,240,235,475,35,20,Player A
15188,JointPQPlayer,261,266,527,54,9,JointPQPlayer
15189,JointPQPlayer,257,252,509,48,13,Player A
15190,JointPQPlayer,268,268,536,48,4,Tie
15191,JointPQPlayer,253,258,511,50,13,JointPQPlayer
15192,JointPQPlayer,164,164,328,5,59,Tie
15193,JointPQPlayer,235,235,470,36,22,Tie
15194,JointPQPlayer,180,180,360,10,50,Tie
15195,JointPQPlayer,231,226,457,35,26,Player A
15196,JointPQPlayer,265,265,530,48,6,Tie
15197,JointPQPlayer,269,269,538,50,4,Tie
15198,JointPQPlayer,161,166,327,1,58,JointPQPlayer
15199,JointPQPlayer,270,270,540,55,5,Tie
15200,JointPQPlayer,251,246,497,39,14,Player A
15201,JointPQPlayer,221,226,447,28,27,JointPQPlayer
15202,JointPQPlayer,271,266,537,58,7,Player A
15203,JointPQPlayer,245,245,490,41,17,Tie
15204,JointPQPlayer,258,258,516,52,12,Tie
15205,JointPQPlayer,252,252,504,49,15,Tie
15206,JointPQPlayer,251,251,502,47,15,Tie
15207,JointPQPlayer,256,261,517,50,11,JointPQPlayer
15208,JointPQPlayer,251,246,497,48,17,Player A
15209,JointPQPlayer,258,258,516,43,9,Tie
15210,JointPQPlayer,249,249,498,37,13,Tie
15211,JointPQPlayer,249,249,498,43,15,Tie
15212,JointPQPlayer,265,265,530,57,9,Tie
15213,JointPQPlayer,252,257,509,42,11,JointPQPlayer
15214,JointPQPlayer,197,192,389,18,43,Player A
15215,JointPQPlayer,177,177,354,10,52,Tie
15216,JointPQPlayer,255,260,515,48,11,JointPQPlayer
15217,JointPQPlayer,234,229,463,29,22,Player A
15218,JointPQPlayer,261,266,527,48,7,JointPQPlayer
15219,JointPQPlayer,249,244,493,44,17,Player A
15220,JointPQPlayer,250,255,505,47,14,JointPQPlayer
15221,JointPQPlayer,260,255,515,42,9,Player A
15222,JointPQPlayer,270,270,540,58,6,Tie
15223,JointPQPlayer,254,254,508,41,11,Tie
15224,JointPQPlayer,234,239,473,36,21,JointPQPlayer
15225,JointPQPlayer,255,255,510,43,11,Tie
15226,JointPQPlayer,268,263,531,46,5,Player A
15227,JointPQPlayer,260,265,525,49,8,JointPQPlayer
15228,JointPQPlayer,175,175,350,6,52,Tie
15229,JointPQPlayer,169,169,338,3,55,Tie
15230,JointPQPlayer,236,236,472,44,24,Tie
15231,JointPQPlayer,223,223,446,39,31,Tie
15232,JointPQPlayer,170,170,340,5,55,Tie
15233,JointPQPlayer,274,269,543,52,3,Player A
15234,JointPQPlayer,199,199,398,15,39,Tie
15235,JointPQPlayer,179,184,363,10,49,JointPQPlayer
15236,JointPQPlayer,236,236,472,38,22,Tie
15237,JointPQPlayer,264,259,523,47,8,Player A
15238,JointPQPlayer,256,256,512,51,13,Tie
15239,JointPQPlayer,213,213,426,31,35,Tie
15240,JointPQPlayer,237,242,479,45,22,JointPQPlayer
15241,JointPQPlayer,275,270,545,63,6,Player A
15242,JointPQPlayer,237,242,479,42,21,JointPQPlayer
15243,JointPQPlayer,236,231,467,36,23,Player A
15244,JointPQPlayer,191,196,387,16,43,JointPQPlayer
15245,JointPQPlayer,262,262,524,48,8,Tie
15246,JointPQPlayer,257,257,514,53,13,Tie
15247,JointPQPlayer,204,204,408,22,38,Tie
15248,JointPQPlayer,245,245,490,41,17,Tie
15249,JointPQPlayer,262,262,524,51,9,Tie
15250,JointPQPlayer,189,189,378,13,45,Tie
15251,JointPQPlayer,231,226,457,35,26,Player A
15252,JointPQPlayer,257,257,514,47,11,Tie
15253,JointPQPlayer,171,176,347,12,55,JointPQPlayer
15254,JointPQPlayer,242,237,479,42,21,Player A
15255,JointPQPlayer,258,258,516,40,8,Tie
15256,JointPQPlayer,265,270,535,50,5,JointPQPlayer
15257,JointPQPlayer,249,244,493,47,18,Player A
15258,JointPQPlayer,268,268,536,51,5,Tie
15259,JointPQPlayer,258,263,521,39,6,JointPQPlayer
15260,JointPQPlayer,246,241,487,44,19,Player A
15261,JointPQPlayer,248,248,496,41,15,Tie
15262,JointPQPlayer,219,224,443,27,28,JointPQPlayer
15263,JointPQPlayer,258,253,511,44,11,Player A
15264,JointPQPlayer,250,255,505,50,15,JointPQPlayer
15265,JointPQPlayer,179,179,358,8,50,Tie
15266,JointPQPlayer,271,266,537,52,5,Player A
15267,JointPQPlayer,249,249,498,46,16,Tie
15268,JointPQPlayer,255,255,510,46,12,Tie
15269,JointPQPlayer,242,242,484,35,17,Tie
15270,JointPQPlayer,191,196,387,25,46,JointPQPlayer
15271,JointPQPlayer,259,254,513,52,13,Player A
15272,JointPQPlayer,194,199,393,13,40,JointPQPlayer
15273,JointPQPlayer,247,247,494,45,17,Tie
15274,JointPQPlayer,252,247,499,44,15,Player A
15275,JointPQPlayer,173,178,351,7,52,JointPQPlayer
15276,JointPQPlayer,221,216,437,36,33,Player A
15277,JointPQPlayer,263,263,526,53,9,Tie
15278,JointPQPlayer,264,269,533,54,7,JointPQPlayer
15279,JointPQPlayer,252,252,504,34,10,Tie
15280,JointPQPlayer,260,260,520,50,10,Tie
15281,JointPQPlayer,266,261,527,51,8,Player A
15282,JointPQPlayer,263,263,526,53,9,Tie
15283,JointPQPlayer,263,268,531,52,7,JointPQPlayer
15284,JointPQPlayer,262,257,519,46,9,Player A
15285,JointPQPlayer,213,213,426,22,32,Tie
15286,JointPQPlayer,244,249,493,41,16,JointPQPlayer
15287,JointPQPlayer,252,252,504,46,14,Tie
15288,JointPQPlayer,259,254,513,49,12,Player A
15289,JointPQPlayer,281,281,562,65,1,Tie
15290,JointPQPlayer,265,265,530,54,8,Tie
15291,JointPQPlayer,242,242,484,47,21,Tie
15292,JointPQPlayer,245,250,495,40,15,JointPQPlayer
15293,JointPQPlayer,234,229,463,35,24,Player A
15294,JointPQPlayer,269,269,538,50,4,Tie
15295,JointPQPlayer,264,264,528,46,6,Tie
15296,JointPQPlayer,162,167,329,12,61,JointPQPlayer
15297,JointPQPlayer,265,260,525,49,8,Player A
15298,JointPQPlayer,215,220,435,34,33,JointPQPlayer
15299,JointPQPlayer,250,250,500,33,11,Tie
15300,JointPQPlayer,188,188,376,8,44,Tie
15301,JointPQPlayer,274,269,543,58,5,Player A
15302,JointPQPlayer,266,266,532,53,7,Tie
15303,JointPQPlayer,254,254,508,44,12,Tie
15304,JointPQPlayer,263,263,526,56,10,Tie
15305,JointPQPlayer,252,257,509,45,12,JointPQPlayer
15306,JointPQPlayer,229,224,453,31,26,Player A
15307,JointPQPlayer,235,235,470,39,23,Tie
15308,JointPQPlayer,276,276,552,64,4,Tie
15309,JointPQPlayer,211,216,427,26,33,JointPQPlayer
15310,JointPQPlayer,198,193,391,14,41,Player A
15311,JointPQPlayer,214,219,433,26,31,JointPQPlayer
15312,JointPQPlayer,252,247,499,44,15,Player A
15313,JointPQPlayer,162,167,329,6,59,JointPQPlayer
15314,JointPQPlayer,174,169,343,5,54,Player A
15315,JointPQPlayer,220,220,440,27,29,Tie
15316,JointPQPlayer,261,261,522,55,11,Tie
15317,JointPQPlayer,181,181,362,6,48,Tie
15318,JointPQPlayer,258,258,516,49,11,Tie
15319,JointPQPlayer,247,247,494,48,18,Tie
15320,JointPQPlayer,269,269,538,59,7,Tie
15321,JointPQPlayer,269,274,543,55,4,JointPQPlayer
15322,JointPQPlayer,165,165,330,4,58,Tie
15323,JointPQPlayer,253,248,501,43,14,Player A
15324,JointPQPlayer,173,173,346,11,55,Tie
15325,JointPQPlayer,190,195,385,11,42,JointPQPlayer
15326,JointPQPlayer,270,265,535,53,6,Player A
15327,JointPQPlayer,250,250,500,45,15,Tie
15328,JointPQPlayer,256,256,512,42,10,Tie
15329,JointPQPlayer,258,263,521,48,9,JointPQPlayer
15330,JointPQPlayer,227,227,454,41,29,Tie
15331,JointPQPlayer,273,268,541,59,6,Player A
15332,JointPQPlayer,194,194,388,14,42,Tie
15333,JointPQPlayer,271,271,542,51,3,Tie
15334,JointPQPlayer,246,246,492,34,14,Tie
15335,JointPQPlayer,250,255,505,41,12,JointPQPlayer
15336,JointPQPlayer,258,258,516,52,12,Tie
15337,JointPQPlayer,244,239,483,37,18,Player A
15338,JointPQPlayer,181,186,367,5,46,JointPQPlayer
15339,JointPQPlayer,244,239,483,34,17,Player A
15340,JointPQPlayer,262,262,524,51,9,Tie
15341,JointPQPlayer,275,275,550,59,3,Tie
15342,JointPQPlayer,244,249,493,35,14,JointPQPlayer
15343,JointPQPlayer,252,247,499,41,14,Player A
15344,JointPQPlayer,245,245,490,41,17,Tie
15345,JointPQPlayer,256,256,512,42,10,Tie
15346,JointPQPlayer,233,233,466,38,24,Tie
15347,JointPQPlayer,245,250,495,37,14,JointPQPlayer
15348,JointPQPlayer,265,260,525,49,8,Player A
15349,JointPQPlayer,212,212,424,20,32,Tie
15350,JointPQPlayer,260,265,525,46,7,JointPQPlayer
15351,JointPQPlayer,258,253,511,50,13,Player A
15352,JointPQPlayer,232,232,464,39,25,Tie
15353,JointPQPlayer,237,237,474,43,23,Tie
15354,JointPQPlayer,179,184,363,13,50,JointPQPlayer
15355,JointPQPlayer,260,255,515,45,10,Player A
15356,JointPQPlayer,262,262,524,48,8,Tie
15357,JointPQPlayer,202,202,404,21,39,Tie
15358,JointPQPlayer,167,172,339,4,55,JointPQPlayer
15359,JointPQPlayer,255,250,505,44,13,Player A
15360,JointPQPlayer,270,270,540,58,6,Tie
15361,JointPQPlayer,258,258,516,49,11,Tie
15362,JointPQPlayer,213,213,426,25,33,Tie
15363,JointPQPlayer,255,255,510,43,11,Tie
15364,JointPQPlayer,208,208,416,24,36,Tie
15365,JointPQPlayer,254,254,508,41,11,Tie
15366,JointPQPlayer,264,264,528,55,9,Tie
15367,JointPQPlayer,266,266,532,47,5,Tie
15368,JointPQPlayer,267,267,534,52,6,Tie
15369,JointPQPlayer,248,248,496,35,13,Tie
15370,JointPQPlayer,255,255,510,49,13,Tie
15371,JointPQPlayer,263,263,526,47,7,Tie
15372,JointPQPlayer,261,261,522,55,11,Tie
15373,JointPQPlayer,262,262,524,48,8,Tie
15374,JointPQPlayer,162,167,329,6,59,JointPQPlayer
15375,JointPQPlayer,235,230,465,34,23,Player A
15376,JointPQPlayer,263,263,526,50,8,Tie
15377,JointPQPlayer,200,200,400,20,40,Tie
15378,JointPQPlayer,269,269,538,56,6,Tie
15379,JointPQPlayer,239,239,478,44,22,Tie
15380,JointPQPlayer,257,262,519,49,10,JointPQPlayer
15381,JointPQPlayer,252,247,499,41,14,Player A
15382,JointPQPlayer,247,247,494,39,15,Tie
15383,JointPQPlayer,259,259,518,54,12,Tie
15384,JointPQPlayer,230,235,465,25,20,JointPQPlayer
15385,JointPQPlayer,228,228,456,25,23,Tie
15386,JointPQPlayer,186,186,372,7,45,Tie
15387,JointPQPlayer,213,208,421,20,33,Player A
15388,JointPQPlayer,234,239,473,33,20,JointPQPlayer
15389,JointPQPlayer,200,200,400,23,41,Tie
15390,JointPQPlayer,199,199,398,21,41,Tie
15391,JointPQPlayer,272,267,539,60,7,Player A
15392,JointPQPlayer,187,187,374,12,46,Tie
15393,JointPQPlayer,265,265,530,54,8,Tie
15394,JointPQPlayer,214,214,428,33,35,Tie
15395,JointPQPlayer,258,263,521,51,10,JointPQPlayer
15396,JointPQPlayer,200,200,400,17,39,Tie
15397,JointPQPlayer,174,174,348,4,52,Tie
15398,JointPQPlayer,242,237,479,48,23,Player A
15399,JointPQPlayer,266,266,532,53,7,Tie
15400,JointPQPlayer,223,223,446,36,30,Tie
15401,JointPQPlayer,273,278,551,57,2,JointPQPlayer
15402,JointPQPlayer,258,258,516,46,10,Tie
15403,JointPQPlayer,231,226,457,41,28,Player A
15404,JointPQPlayer,235,235,470,36,22,Tie
15405,JointPQPlayer,233,233,466,38,24,Tie
15406,JointPQPlayer,152,157,309,4,65,JointPQPlayer
15407,JointPQPlayer,257,252,509,45,12,Player A
15408,JointPQPlayer,254,259,513,49,12,JointPQPlayer
15409,JointPQPlayer,265,260,525,49,8,Player A
15410,JointPQPlayer,240,245,485,39,18,JointPQPlayer
15411,JointPQPlayer,267,262,529,50,7,Player A
15412,JointPQPlayer,239,239,478,41,21,Tie
15413,JointPQPlayer,270,270,540,58,6,Tie
15414,JointPQPlayer,248,248,496,50,18,Tie
15415,JointPQPlayer,243,243,486,43,19,Tie
15416,JointPQPlayer,185,190,375,13,46,JointPQPlayer
15417,JointPQPlayer,234,229,463,32,23,Player A
15418,JointPQPlayer,257,257,514,44,10,Tie
15419,JointPQPlayer,254,254,508,44,12,Tie
15420,JointPQPlayer,272,277,549,58,3,JointPQPlayer
15421,JointPQPlayer,183,178,361,8,49,Player A
15422,JointPQPlayer,258,258,516,46,10,Tie
15423,JointPQPlayer,246,246,492,40,16,Tie
15424,JointPQPlayer,231,236,467,33,22,JointPQPlayer
15425,JointPQPlayer,249,244,493,38,15,Player A
15426,JointPQPlayer,250,250,500,48,16,Tie
15427,JointPQPlayer,251,251,502,41,13,Tie
15428,JointPQPlayer,259,264,523,53,10,JointPQPlayer
15429,JointPQPlayer,258,253,511,41,10,Player A
15430,JointPQPlayer,266,271,537,55,6,JointPQPlayer
15431,JointPQPlayer,281,276,557,60,1,Player A
15432,JointPQPlayer,225,230,455,27,24,JointPQPlayer
15433,JointPQPlayer,178,178,356,12,52,Tie
15434,JointPQPlayer,270,265,535,56,7,Player A
15435,JointPQPlayer,234,234,468,34,22,Tie
15436,JointPQPlayer,274,274,548,57,3,Tie
15437,JointPQPlayer,260,260,520,53,11,Tie
15438,JointPQPlayer,208,208,416,15,33,Tie
15439,JointPQPlayer,171,176,347,6,53,JointPQPlayer
15440,JointPQPlayer,247,242,489,46,19,Player A
15441,JointPQPlayer,251,251,502,47,15,Tie
15442,JointPQPlayer,268,268,536,57,7,Tie
15443,JointPQPlayer,267,267,534,52,6,Tie
15444,JointPQPlayer,214,214,428,27,33,Tie
15445,JointPQPlayer,205,210,415,20,35,JointPQPlayer
15446,JointPQPlayer,268,263,531,58,9,Player A
15447,JointPQPlayer,235,235,470,39,23,Tie
15448,JointPQPlayer,274,274,548,60,4,Tie
15449,JointPQPlayer,250,255,505,44,13,JointPQPlayer
15450,JointPQPlayer,263,258,521,54,11,Player A
15451,JointPQPlayer,230,230,460,35,25,Tie
15452,JointPQPlayer,278,278,556,62,2,Tie
15453,JointPQPlayer,171,176,347,9,54,JointPQPlayer
15454,JointPQPlayer,274,269,543,58,5,Player A
15455,JointPQPlayer,249,254,503,33,10,JointPQPlayer
15456,JointPQPlayer,193,193,386,12,42,Tie
15457,JointPQPlayer,242,237,479,39,20,Player A
15458,JointPQPlayer,237,237,474,37,21,Tie
15459,JointPQPlayer,173,178,351,10,53,JointPQPlayer
15460,JointPQPlayer,244,244,488,42,18,Tie
15461,JointPQPlayer,201,201,402,16,38,Tie
15462,JointPQPlayer,243,238,481,47,22,Player A
15463,JointPQPlayer,190,195,385,17,44,JointPQPlayer
15464,JointPQPlayer,282,282,564,67,1,Tie
15465,JointPQPlayer,249,244,493,41,16,Player A
15466,JointPQPlayer,250,255,505,41,12,JointPQPlayer
15467,JointPQPlayer,247,242,489,37,16,Player A
15468,JointPQPlayer,156,156,312,4,64,Tie
15469,JointPQPlayer,212,212,424,26,34,Tie
15470,JointPQPlayer,268,268,536,66,10,Tie
15471,JointPQPlayer,244,249,493,38,15,JointPQPlayer
15472,JointPQPlayer,251,246,497,45,16,Player A
15473,JointPQPlayer,184,189,373,17,48,JointPQPlayer
15474,JointPQPlayer,258,253,511,47,12,Player A
15475,JointPQPlayer,255,255,510,49,13,Tie
15476,JointPQPlayer,242,242,484,35,17,Tie
15477,JointPQPlayer,253,258,511,44,11,JointPQPlayer
15478,JointPQPlayer,267,262,529,53,8,Player A
15479,JointPQPlayer,239,244,483,37,18,JointPQPlayer
15480,JointPQPlayer,244,239,483,34,17,Player A
15481,JointPQPlayer,249,249,498,46,16,Tie
15482,JointPQPlayer,227,227,454,32,26,Tie
15483,JointPQPlayer,212,217,429,19,30,JointPQPlayer
15484,JointPQPlayer,257,257,514,50,12,Tie
15485,JointPQPlayer,177,172,349,8,53,Player A
15486,JointPQPlayer,248,248,496,47,17,Tie
15487,JointPQPlayer,263,263,526,47,7,Tie
15488,JointPQPlayer,247,252,499,47,16,JointPQPlayer
15489,JointPQPlayer,258,258,516,43,9,Tie
15490,JointPQPlayer,263,263,526,53,9,Tie
15491,JointPQPlayer,237,237,474,31,19,Tie
15492,JointPQPlayer,242,237,479,39,20,Player A
15493,JointPQPlayer,176,176,352,8,52,Tie
15494,JointPQPlayer,252,252,504,43,13,Tie
15495,JointPQPlayer,251,251,502,50,16,Tie
15496,JointPQPlayer,194,199,393,19,42,JointPQPlayer
15497,JointPQPlayer,249,244,493,41,16,Player A
15498,JointPQPlayer,238,243,481,35,18,JointPQPlayer
15499,JointPQPlayer,224,219,443,30,29,Player A
15500,JointPQPlayer,246,246,492,46,18,Tie
15501,JointPQPlayer,262,262,524,51,9,Tie
15502,JointPQPlayer,224,224,448,32,28,Tie
15503,JointPQPlayer,262,262,524,51,9,Tie
15504,JointPQPlayer,244,249,493,44,17,JointPQPlayer
15505,JointPQPlayer,250,245,495,46,17,Player A
15506,JointPQPlayer,174,174,348,4,52,Tie
15507,JointPQPlayer,259,264,523,56,11,JointPQPlayer
15508,JointPQPlayer,263,263,526,53,9,Tie
15509,JointPQPlayer,192,187,379,14,45,Player A
15510,JointPQPlayer,255,255,510,46,12,Tie
15511,JointPQPlayer,267,272,539,51,4,JointPQPlayer
15512,JointPQPlayer,265,260,525,49,8,Player A
15513,JointPQPlayer,175,175,350,9,53,Tie
15514,JointPQPlayer,234,234,468,43,25,Tie
15515,JointPQPlayer,259,264,523,47,8,JointPQPlayer
15516,JointPQPlayer,198,193,391,11,40,Player A
15517,JointPQPlayer,254,254,508,41,11,Tie
15518,JointPQPlayer,263,263,526,50,8,Tie
15519,JointPQPlayer,182,187,369,10,47,JointPQPlayer
15520,JointPQPlayer,239,234,473,45,24,Player A
15521,JointPQPlayer,251,256,507,46,13,JointPQPlayer
15522,JointPQPlayer,269,264,533,57,8,Player A
15523,JointPQPlayer,247,252,499,44,15,JointPQPlayer
15524,JointPQPlayer,236,231,467,39,24,Player A
15525,JointPQPlayer,208,208,416,21,35,Tie
15526,JointPQPlayer,243,248,491,45,18,JointPQPlayer
15527,JointPQPlayer,257,252,509,48,13,Player A
15528,JointPQPlayer,173,173,346,8,54,Tie
15529,JointPQPlayer,270,270,540,52,4,Tie
15530,JointPQPlayer,198,198,396,13,39,Tie
15531,JointPQPlayer,232,232,464,36,24,Tie
15532,JointPQPlayer,260,260,520,41,7,Tie
15533,JointPQPlayer,228,228,456,28,24,Tie
15534,JointPQPlayer,273,273,546,58,4,Tie
15535,JointPQPlayer,263,263,526,50,8,Tie
15536,JointPQPlayer,247,247,494,45,17,Tie
15537,JointPQPlayer,211,211,422,27,35,Tie
15538,JointPQPlayer,259,259,518,39,7,Tie
15539,JointPQPlayer,249,254,503,39,12,JointPQPlayer
15540,JointPQPlayer,257,257,514,44,10,Tie
15541,JointPQPlayer,229,224,453,28,25,Player A
15542,JointPQPlayer,265,265,530,48,6,Tie
15543,JointPQPlayer,258,258,516,49,11,Tie
15544,JointPQPlayer,254,254,508,41,11,Tie
15545,JointPQPlayer,239,239,478,38,20,Tie
15546,JointPQPlayer,185,185,370,8,46,Tie
15547,JointPQPlayer,250,255,505,44,13,JointPQPlayer
15548,JointPQPlayer,265,260,525,46,7,Player A
15549,JointPQPlayer,241,246,487,47,20,JointPQPlayer
15550,JointPQPlayer,258,253,511,38,9,Player A
15551,JointPQPlayer,248,248,496,38,14,Tie
15552,JointPQPlayer,266,266,532,53,7,Tie
15553,JointPQPlayer,248,248,496,41,15,Tie
15554,JointPQPlayer,245,250,495,43,16,JointPQPlayer
15555,JointPQPlayer,266,261,527,57,10,Player A
15556,JointPQPlayer,256,256,512,51,13,Tie
15557,JointPQPlayer,268,268,536,54,6,Tie
15558,JointPQPlayer,260,260,520,56,12,Tie
15559,JointPQPlayer,259,264,523,47,8,JointPQPlayer
15560,JointPQPlayer,192,187,379,11,44,Player A
15561,JointPQPlayer,255,255,510,43,11,Tie
15562,JointPQPlayer,257,262,519,52,11,JointPQPlayer
15563,JointPQPlayer,240,235,475,44,23,Player A
15564,JointPQPlayer,155,160,315,4,63,JointPQPlayer
15565,JointPQPlayer,183,178,361,8,49,Player A
15566,JointPQPlayer,236,236,472,32,20,Tie
15567,JointPQPlayer,176,181,357,10,51,JointPQPlayer
15568,JointPQPlayer,252,247,499,41,14,Player A
15569,JointPQPlayer,261,261,522,49,9,Tie
15570,JointPQPlayer,188,188,376,11,45,Tie
15571,JointPQPlayer,192,192,384,16,44,Tie
15572,JointPQPlayer,242,242,484,35,17,Tie
15573,JointPQPlayer,220,220,440,33,31,Tie
15574,JointPQPlayer,266,271,537,52,5,JointPQPlayer
15575,JointPQPlayer,255,250,505,41,12,Player A
15576,JointPQPlayer,223,228,451,29,26,JointPQPlayer
15577,JointPQPlayer,175,175,350,9,53,Tie
15578,JointPQPlayer,266,266,532,56,8,Tie
15579,JointPQPlayer,167,167,334,5,57,Tie
15580,JointPQPlayer,254,254,508,53,15,Tie
15581,JointPQPlayer,270,270,540,52,4,Tie
15582,JointPQPlayer,180,180,360,10,50,Tie
15583,JointPQPlayer,200,195,395,18,41,Player A
15584,JointPQPlayer,245,245,490,44,18,Tie
15585,JointPQPlayer,160,160,320,9,63,Tie
15586,JointPQPlayer,181,181,362,9,49,Tie
15587,JointPQPlayer,189,194,383,9,42,JointPQPlayer
15588,JointPQPlayer,237,232,469,38,23,Player A
15589,JointPQPlayer,274,274,548,66,6,Tie
15590,JointPQPlayer,248,248,496,44,16,Tie
15591,JointPQPlayer,190,190,380,12,44,Tie
15592,JointPQPlayer,176,176,352,8,52,Tie
15593,JointPQPlayer,194,199,393,16,41,JointPQPlayer
15594,JointPQPlayer,254,249,503,42,13,Player A
15595,JointPQPlayer,230,230,460,47,29,Tie
15596,JointPQPlayer,271,271,542,60,6,Tie
15597,JointPQPlayer,259,259,518,54,12,Tie
15598,JointPQPlayer,208,208,416,18,34,Tie
15599,JointPQPlayer,271,271,542,51,3,Tie
15600,JointPQPlayer,257,257,514,44,10,Tie
15601,JointPQPlayer,259,259,518,57,13,Tie
15602,JointPQPlayer,242,247,489,43,18,JointPQPlayer
15603,JointPQPlayer,268,263,531,58,9,Player A
15604,JointPQPlayer,180,180,360,7,49,Tie
15605,JointPQPlayer,247,247,494,42,16,Tie
15606,JointPQPlayer,157,162,319,2,61,JointPQPlayer
15607,JointPQPlayer,259,259,518,51,11,Tie
15608,JointPQPlayer,220,220,440,33,31,Tie
15609,JointPQPlayer,238,238,476,36,20,Tie
15610,JointPQPlayer,261,256,517,50,11,Player A
15611,JointPQPlayer,260,260,520,44,8,Tie
15612,JointPQPlayer,265,265,530,54,8,Tie
15613,JointPQPlayer,187,192,379,17,46,JointPQPlayer
15614,JointPQPlayer,220,220,440,36,32,Tie
15615,JointPQPlayer,239,239,478,44,22,Tie
15616,JointPQPlayer,171,171,342,4,54,Tie
15617,JointPQPlayer,246,246,492,43,17,Tie
15618,JointPQPlayer,171,171,342,7,55,Tie
15619,JointPQPlayer,197,197,394,8,38,Tie
15620,JointPQPlayer,249,249,498,46,16,Tie
15621,JointPQPlayer,252,247,499,38,13,Player A
15622,JointPQPlayer,262,262,524,51,9,Tie
15623,JointPQPlayer,239,244,483,40,19,JointPQPlayer
15624,JointPQPlayer,247,242,489,37,16,Player A
15625,JointPQPlayer,186,191,377,9,44,JointPQPlayer
15626,JointPQPlayer,238,238,476,39,21,Tie
15627,JointPQPlayer,251,251,502,47,15,Tie
15628,JointPQPlayer,273,268,541,62,7,Player A
15629,JointPQPlayer,253,258,511,44,11,JointPQPlayer
15630,JointPQPlayer,249,244,493,41,16,Player A
15631,JointPQPlayer,242,242,484,38,18,Tie
15632,JointPQPlayer,255,255,510,43,11,Tie
15633,JointPQPlayer,263,263,526,56,10,Tie
15634,JointPQPlayer,263,268,531,52,7,JointPQPlayer
15635,JointPQPlayer,269,264,533,51,6,Player A
15636,JointPQPlayer,267,267,534,49,5,Tie
15637,JointPQPlayer,258,263,521,54,11,JointPQPlayer
15638,JointPQPlayer,244,239,483,40,19,Player A
15639,JointPQPlayer,269,269,538,53,5,Tie
15640,JointPQPlayer,230,230,460,35,25,Tie
15641,JointPQPlayer,261,261,522,40,6,Tie
15642,JointPQPlayer,253,253,506,36,10,Tie
15643,JointPQPlayer,186,186,372,16,48,Tie
15644,JointPQPlayer,185,190,375,7,44,JointPQPlayer
15645,JointPQPlayer,274,269,543,55,4,Player A
15646,JointPQPlayer,257,257,514,44,10,Tie
15647,JointPQPlayer,197,197,394,17,41,Tie
15648,JointPQPlayer,249,249,498,46,16,Tie
15649,JointPQPlayer,247,247,494,45,17,Tie
15650,JointPQPlayer,227,227,454,35,27,Tie
15651,JointPQPlayer,250,255,505,38,11,JointPQPlayer
15652,JointPQPlayer,256,256,512,48,12,Tie
15653,JointPQPlayer,252,247,499,47,16,Player A
15654,JointPQPlayer,266,271,537,52,5,JointPQPlayer
15655,JointPQPlayer,241,236,477,40,21,Player A
15656,JointPQPlayer,242,242,484,41,19,Tie
15657,JointPQPlayer,266,266,532,53,7,Tie
15658,JointPQPlayer,266,271,537,55,6,JointPQPlayer
15659,JointPQPlayer,231,226,457,38,27,Player A
15660,JointPQPlayer,258,263,521,45,8,JointPQPlayer
15661,JointPQPlayer,249,249,498,43,15,Tie
15662,JointPQPlayer,258,258,516,49,11,Tie
15663,JointPQPlayer,264,259,523,53,10,Player A
15664,JointPQPlayer,244,244,488,36,16,Tie
15665,JointPQPlayer,213,213,426,25,33,Tie
15666,JointPQPlayer,253,253,506,48,14,Tie
15667,JointPQPlayer,221,221,442,38,32,Tie
15668,JointPQPlayer,173,178,351,7,52,JointPQPlayer
15669,JointPQPlayer,207,207,414,28,38,Tie
15670,JointPQPlayer,195,190,385,23,46,Player A
15671,JointPQPlayer,253,253,506,36,10,Tie
15672,JointPQPlayer,250,250,500,45,15,Tie
15673,JointPQPlayer,253,253,506,39,11,Tie
15674,JointPQPlayer,269,269,538,47,3,Tie
15675,JointPQPlayer,270,270,540,52,4,Tie
15676,JointPQPlayer,225,230,455,27,24,JointPQPlayer
15677,JointPQPlayer,176,176,352,5,51,Tie
15678,JointPQPlayer,174,174,348,10,54,Tie
15679,JointPQPlayer,179,179,358,11,51,Tie
15680,JointPQPlayer,247,242,489,46,19,Player A
15681,JointPQPlayer,263,268,531,55,8,JointPQPlayer
15682,JointPQPlayer,218,218,436,38,34,Tie
15683,JointPQPlayer,194,194,388,17,43,Tie
15684,JointPQPlayer,238,238,476,39,21,Tie
15685,JointPQPlayer,250,245,495,40,15,Player A
15686,JointPQPlayer,276,276,552,67,5,Tie
15687,JointPQPlayer,240,240,480,43,21,Tie
15688,JointPQPlayer,264,269,533,57,8,JointPQPlayer
15689,JointPQPlayer,270,265,535,47,4,Player A
15690,JointPQPlayer,259,259,518,54,12,Tie
15691,JointPQPlayer,249,254,503,45,14,JointPQPlayer
15692,JointPQPlayer,249,249,498,55,19,Tie
15693,JointPQPlayer,266,261,527,51,8,Player A
15694,JointPQPlayer,227,227,454,29,25,Tie
15695,JointPQPlayer,166,171,337,8,57,JointPQPlayer
15696,JointPQPlayer,267,262,529,53,8,Player A
15697,JointPQPlayer,262,267,529,50,7,JointPQPlayer
15698,JointPQPlayer,240,235,475,35,20,Player A
15699,JointPQPlayer,255,255,510,40,10,Tie
15700,JointPQPlayer,266,266,532,47,5,Tie
15701,JointPQPlayer,244,249,493,47,18,JointPQPlayer
15702,JointPQPlayer,260,260,520,50,10,Tie
15703,JointPQPlayer,260,255,515,48,11,Player A
15704,JointPQPlayer,261,261,522,46,8,Tie
15705,JointPQPlayer,244,244,488,36,16,Tie
15706,JointPQPlayer,261,261,522,49,9,Tie
15707,JointPQPlayer,222,222,444,25,27,Tie
15708,JointPQPlayer,259,264,523,47,8,JointPQPlayer
15709,JointPQPlayer,274,269,543,55,4,Player A
15710,JointPQPlayer,242,247,489,40,17,JointPQPlayer
15711,JointPQPlayer,256,256,512,51,13,Tie
15712,JointPQPlayer,253,253,506,42,12,Tie
15713,JointPQPlayer,256,251,507,37,10,Player A
15714,JointPQPlayer,268,268,536,60,8,Tie
15715,JointPQPlayer,260,260,520,47,9,Tie
15716,JointPQPlayer,259,264,523,44,7,JointPQPlayer
15717,JointPQPlayer,244,239,483,40,19,Player A
15718,JointPQPlayer,150,155,305,3,66,JointPQPlayer
15719,JointPQPlayer,265,265,530,51,7,Tie
15720,JointPQPlayer,255,250,505,41,12,Player A
15721,JointPQPlayer,237,237,474,34,20,Tie
15722,JointPQPlayer,259,264,523,56,11,JointPQPlayer
15723,JointPQPlayer,270,265,535,53,6,Player A
15724,JointPQPlayer,262,262,524,54,10,Tie
15725,JointPQPlayer,178,183,361,11,50,JointPQPlayer
15726,JointPQPlayer,266,266,532,53,7,Tie
15727,JointPQPlayer,241,236,477,34,19,Player A
15728,JointPQPlayer,223,228,451,35,28,JointPQPlayer
15729,JointPQPlayer,252,247,499,41,14,Player A
15730,JointPQPlayer,261,261,522,49,9,Tie
15731,JointPQPlayer,156,161,317,6,63,JointPQPlayer
15732,JointPQPlayer,280,275,555,67,4,Player A
15733,JointPQPlayer,254,254,508,50,14,Tie
15734,JointPQPlayer,271,271,542,60,6,Tie
15735,JointPQPlayer,264,264,528,49,7,Tie
15736,JointPQPlayer,171,176,347,9,54,JointPQPlayer
15737,JointPQPlayer,264,259,523,50,9,Player A
15738,JointPQPlayer,261,261,522,43,7,Tie
15739,JointPQPlayer,216,221,437,27,30,JointPQPlayer
15740,JointPQPlayer,263,258,521,45,8,Player A
15741,JointPQPlayer,235,235,470,36,22,Tie
15742,JointPQPlayer,254,259,513,49,12,JointPQPlayer
15743,JointPQPlayer,217,212,429,28,33,Player A
15744,JointPQPlayer,248,248,496,41,15,Tie
15745,JointPQPlayer,204,204,408,22,38,Tie
15746,JointPQPlayer,244,244,488,36,16,Tie
15747,JointPQPlayer,257,257,514,47,11,Tie
15748,JointPQPlayer,249,249,498,37,13,Tie
15749,JointPQPlayer,203,208,411,22,37,JointPQPlayer
15750,JointPQPlayer,190,185,375,19,48,Player A
15751,JointPQPlayer,249,254,503,45,14,JointPQPlayer
15752,JointPQPlayer,199,194,393,25,44,Player A
15753,JointPQPlayer,189,189,378,10,44,Tie
15754,JointPQPlayer,247,252,499,50,17,JointPQPlayer
15755,JointPQPlayer,262,257,519,52,11,Player A
15756,JointPQPlayer,268,268,536,48,4,Tie
15757,JointPQPlayer,181,181,362,9,49,Tie
15758,JointPQPlayer,260,260,520,44,8,Tie
15759,JointPQPlayer,252,252,504,43,13,Tie
15760,JointPQPlayer,265,270,535,50,5,JointPQPlayer
15761,JointPQPlayer,236,236,472,38,22,Tie
15762,JointPQPlayer,240,240,480,28,16,Tie
15763,JointPQPlayer,179,179,358,17,53,Tie
15764,JointPQPlayer,250,245,495,49,18,Player A
15765,JointPQPlayer,267,267,534,55,7,Tie
15766,JointPQPlayer,250,250,500,36,12,Tie
15767,JointPQPlayer,251,251,502,41,13,Tie
15768,JointPQPlayer,215,220,435,31,32,JointPQPlayer
15769,JointPQPlayer,252,247,499,44,15,Player A
15770,JointPQPlayer,183,183,366,16,50,Tie
15771,JointPQPlayer,170,175,345,7,54,JointPQPlayer
15772,JointPQPlayer,258,253,511,35,8,Player A
15773,JointPQPlayer,275,280,555,61,2,JointPQPlayer
15774,JointPQPlayer,172,172,344,9,55,Tie
15775,JointPQPlayer,257,252,509,48,13,Player A
15776,JointPQPlayer,245,250,495,43,16,JointPQPlayer
15777,JointPQPlayer,225,220,445,32,29,Player A
15778,JointPQPlayer,266,266,532,59,9,Tie
15779,JointPQPlayer,163,168,331,8,59,JointPQPlayer
15780,JointPQPlayer,251,246,497,45,16,Player A
15781,JointPQPlayer,261,266,527,57,10,JointPQPlayer
15782,JointPQPlayer,257,252,509,48,13,Player A
15783,JointPQPlayer,203,203,406,23,39,Tie
15784,JointPQPlayer,173,178,351,10,53,JointPQPlayer
15785,JointPQPlayer,266,261,527,54,9,Player A
15786,JointPQPlayer,260,260,520,50,10,Tie
15787,JointPQPlayer,167,172,339,10,57,JointPQPlayer
15788,JointPQPlayer,251,246,497,42,15,Player A
15789,JointPQPlayer,178,183,361,14,51,JointPQPlayer
15790,JointPQPlayer,267,262,529,53,8,Player A
15791,JointPQPlayer,237,237,474,37,21,Tie
15792,JointPQPlayer,266,266,532,47,5,Tie
15793,JointPQPlayer,196,196,392,12,40,Tie
15794,JointPQPlayer,267,267,534,55,7,Tie
15795,JointPQPlayer,232,237,469,41,24,JointPQPlayer
15796,JointPQPlayer,212,212,424,26,34,Tie
15797,JointPQPlayer,263,258,521,42,7,Player A
15798,JointPQPlayer,151,156,307,5,66,JointPQPlayer
15799,JointPQPlayer,245,240,485,36,17,Player A
15800,JointPQPlayer,268,268,536,54,6,Tie
15801,JointPQPlayer,247,247,494,48,18,Tie
15802,JointPQPlayer,217,217,434,39,35,Tie
15803,JointPQPlayer,256,256,512,42,10,Tie
15804,JointPQPlayer,264,264,528,58,10,Tie
15805,JointPQPlayer,177,177,354,7,51,Tie
15806,JointPQPlayer,251,251,502,38,12,Tie
15807,JointPQPlayer,269,269,538,53,5,Tie
15808,JointPQPlayer,264,264,528,46,6,Tie
15809,JointPQPlayer,218,223,441,28,29,JointPQPlayer
15810,JointPQPlayer,249,249,498,46,16,Tie
15811,JointPQPlayer,242,242,484,38,18,Tie
15812,JointPQPlayer,276,271,547,62,5,Player A
15813,JointPQPlayer,230,230,460,38,26,Tie
15814,JointPQPlayer,181,186,367,11,48,JointPQPlayer
15815,JointPQPlayer,257,252,509,39,10,Player A
15816,JointPQPlayer,244,244,488,45,19,Tie
15817,JointPQPlayer,268,268,536,51,5,Tie
15818,JointPQPlayer,260,265,525,46,7,JointPQPlayer
15819,JointPQPlayer,270,270,540,58,6,Tie
15820,JointPQPlayer,256,256,512,51,13,Tie
15821,JointPQPlayer,215,210,425,27,34,Player A
15822,JointPQPlayer,221,221,442,35,31,Tie
15823,JointPQPlayer,271,271,542,51,3,Tie
15824,JointPQPlayer,240,240,480,34,18,Tie
15825,JointPQPlayer,242,247,489,37,16,JointPQPlayer
15826,JointPQPlayer,188,188,376,14,46,Tie
15827,JointPQPlayer,241,241,482,39,19,Tie
15828,JointPQPlayer,249,249,498,43,15,Tie
15829,JointPQPlayer,262,257,519,49,10,Player A
15830,JointPQPlayer,265,270,535,56,7,JointPQPlayer
15831,JointPQPlayer,172,172,344,12,56,Tie
15832,JointPQPlayer,260,255,515,48,11,Player A
15833,JointPQPlayer,257,257,514,50,12,Tie
15834,JointPQPlayer,164,169,333,4,57,JointPQPlayer
15835,JointPQPlayer,206,201,407,27,40,Player A
15836,JointPQPlayer,251,251,502,47,15,Tie
15837,JointPQPlayer,164,169,333,7,58,JointPQPlayer
15838,JointPQPlayer,194,189,383,18,45,Player A
15839,JointPQPlayer,257,262,519,49,10,JointPQPlayer
15840,JointPQPlayer,250,245,495,43,16,Player A
15841,JointPQPlayer,225,230,455,33,26,JointPQPlayer
15842,JointPQPlayer,256,256,512,54,14,Tie
15843,JointPQPlayer,269,269,538,56,6,Tie
15844,JointPQPlayer,240,235,475,35,20,Player A
15845,JointPQPlayer,271,271,542,60,6,Tie
15846,JointPQPlayer,246,246,492,46,18,Tie
15847,JointPQPlayer,238,238,476,42,22,Tie
15848,JointPQPlayer,178,183,361,11,50,JointPQPlayer
15849,JointPQPlayer,256,251,507,40,11,Player A
15850,JointPQPlayer,260,260,520,50,10,Tie
15851,JointPQPlayer,171,176,347,3,52,JointPQPlayer
15852,JointPQPlayer,219,214,433,29,32,Player A
15853,JointPQPlayer,266,266,532,56,8,Tie
15854,JointPQPlayer,245,245,490,38,16,Tie
15855,JointPQPlayer,273,273,546,61,5,Tie
15856,JointPQPlayer,223,223,446,18,24,Tie
15857,JointPQPlayer,245,250,495,40,15,JointPQPlayer
15858,JointPQPlayer,253,248,501,49,16,Player A
15859,JointPQPlayer,274,274,548,60,4,Tie
15860,JointPQPlayer,233,233,466,41,25,Tie
15861,JointPQPlayer,242,247,489,37,16,JointPQPlayer
15862,JointPQPlayer,215,215,430,23,31,Tie
15863,JointPQPlayer,274,274,548,63,5,Tie
15864,JointPQPlayer,229,224,453,34,27,Player A
15865,JointPQPlayer,236,241,477,34,19,JointPQPlayer
15866,JointPQPlayer,210,205,415,20,35,Player A
15867,JointPQPlayer,215,220,435,28,31,JointPQPlayer
15868,JointPQPlayer,257,252,509,42,11,Player A
15869,JointPQPlayer,217,222,439,26,29,JointPQPlayer
15870,JointPQPlayer,273,268,541,59,6,Player A
15871,JointPQPlayer,250,250,500,39,13,Tie
15872,JointPQPlayer,252,252,504,43,13,Tie
15873,JointPQPlayer,177,182,359,6,49,JointPQPlayer
15874,JointPQPlayer,257,257,514,47,11,Tie
15875,JointPQPlayer,162,162,324,4,60,Tie
15876,JointPQPlayer,196,196,392,12,40,Tie
15877,JointPQPlayer,202,202,404,15,37,Tie
15878,JointPQPlayer,244,239,483,40,19,Player A
15879,JointPQPlayer,163,168,331,5,58,JointPQPlayer
15880,JointPQPlayer,278,273,551,60,3,Player A
15881,JointPQPlayer,259,259,518,39,7,Tie
15882,JointPQPlayer,266,266,532,56,8,Tie
15883,JointPQPlayer,260,260,520,47,9,Tie
15884,JointPQPlayer,227,227,454,38,28,Tie
15885,JointPQPlayer,261,261,522,52,10,Tie
15886,JointPQPlayer,265,270,535,56,7,JointPQPlayer
15887,JointPQPlayer,244,239,483,43,20,Player A
15888,JointPQPlayer,274,279,553,65,4,JointPQPlayer
15889,JointPQPlayer,265,260,525,46,7,Player A
15890,JointPQPlayer,177,182,359,12,51,JointPQPlayer
15891,JointPQPlayer,239,239,478,41,21,Tie
15892,JointPQPlayer,166,166,332,6,58,Tie
15893,JointPQPlayer,233,228,461,39,26,Player A
15894,JointPQPlayer,223,223,446,30,28,Tie
15895,JointPQPlayer,255,255,510,40,10,Tie
15896,JointPQPlayer,252,252,504,46,14,Tie
15897,JointPQPlayer,211,211,422,24,34,Tie
15898,JointPQPlayer,250,250,500,39,13,Tie
15899,JointPQPlayer,253,253,506,39,11,Tie
15900,JointPQPlayer,240,240,480,34,18,Tie
15901,JointPQPlayer,257,262,519,55,12,JointPQPlayer
15902,JointPQPlayer,234,229,463,35,24,Player A
15903,JointPQPlayer,246,246,492,43,17,Tie
15904,JointPQPlayer,267,267,534,58,8,Tie
15905,JointPQPlayer,264,264,528,52,8,Tie
15906,JointPQPlayer,243,243,486,46,20,Tie
15907,JointPQPlayer,253,258,511,41,10,JointPQPlayer
15908,JointPQPlayer,186,186,372,13,47,Tie
15909,JointPQPlayer,262,257,519,43,8,Player A
15910,JointPQPlayer,201,206,407,9,34,JointPQPlayer
15911,JointPQPlayer,264,259,523,56,11,Player A
15912,JointPQPlayer,255,255,510,40,10,Tie
15913,JointPQPlayer,260,265,525,52,9,JointPQPlayer
15914,JointPQPlayer,241,236,477,37,20,Player A
15915,JointPQPlayer,264,264,528,49,7,Tie
15916,JointPQPlayer,272,272,544,59,5,Tie
15917,JointPQPlayer,268,273,541,56,5,JointPQPlayer
15918,JointPQPlayer,261,256,517,47,10,Player A
15919,JointPQPlayer,258,258,516,49,11,Tie
15920,JointPQPlayer,254,254,508,50,14,Tie
15921,JointPQPlayer,163,168,331,5,58,JointPQPlayer
15922,JointPQPlayer,253,248,501,43,14,Player A
15923,JointPQPlayer,257,262,519,52,11,JointPQPlayer
15924,JointPQPlayer,187,187,374,9,45,Tie
15925,JointPQPlayer,189,189,378,10,44,Tie
15926,JointPQPlayer,273,268,541,53,4,Player A
15927,JointPQPlayer,263,263,526,44,6,Tie
15928,JointPQPlayer,161,166,327,7,60,JointPQPlayer
15929,JointPQPlayer,261,256,517,44,9,Player A
15930,JointPQPlayer,201,201,402,19,39,Tie
15931,JointPQPlayer,267,267,534,55,7,Tie
15932,JointPQPlayer,266,271,537,61,8,JointPQPlayer
15933,JointPQPlayer,265,260,525,49,8,Player A
15934,JointPQPlayer,273,273,546,52,2,Tie
15935,JointPQPlayer,271,271,542,54,4,Tie
15936,JointPQPlayer,277,282,559,62,1,JointPQPlayer
15937,JointPQPlayer,251,246,497,51,18,Player A
15938,JointPQPlayer,258,258,516,49,11,Tie
15939,JointPQPlayer,253,253,506,39,11,Tie
15940,JointPQPlayer,242,247,489,49,20,JointPQPlayer
15941,JointPQPlayer,243,243,486,46,20,Tie
15942,JointPQPlayer,254,254,508,41,11,Tie
15943,JointPQPlayer,176,171,347,9,54,Player A
15944,JointPQPlayer,183,183,366,10,48,Tie
15945,JointPQPlayer,255,255,510,52,14,Tie
15946,JointPQPlayer,254,254,508,47,13,Tie
15947,JointPQPlayer,271,271,542,63,7,Tie
15948,JointPQPlayer,250,250,500,39,13,Tie
15949,JointPQPlayer,199,204,403,23,40,JointPQPlayer
15950,JointPQPlayer,256,251,507,46,13,Player A
15951,JointPQPlayer,177,182,359,6,49,JointPQPlayer
15952,JointPQPlayer,251,246,497,42,15,Player A
15953,JointPQPlayer,252,257,509,45,12,JointPQPlayer
15954,JointPQPlayer,261,256,517,47,10,Player A
15955,JointPQPlayer,260,260,520,50,10,Tie
15956,JointPQPlayer,256,256,512,48,12,Tie
15957,JointPQPlayer,236,241,477,43,22,JointPQPlayer
15958,JointPQPlayer,186,186,372,7,45,Tie
15959,JointPQPlayer,251,251,502,44,14,Tie
15960,JointPQPlayer,260,260,520,53,11,Tie
15961,JointPQPlayer,248,243,491,42,17,Player A
15962,JointPQPlayer,203,203,406,14,36,Tie
15963,JointPQPlayer,258,258,516,52,12,Tie
15964,JointPQPlayer,246,246,492,37,15,Tie
15965,JointPQPlayer,229,234,463,41,26,JointPQPlayer
15966,JointPQPlayer,232,227,459,28,23,Player A
15967,JointPQPlayer,225,225,450,37,29,Tie
15968,JointPQPlayer,272,272,544,56,4,Tie
15969,JointPQPlayer,223,223,446,30,28,Tie
15970,JointPQPlayer,236,241,477,43,22,JointPQPlayer
15971,JointPQPlayer,175,175,350,12,54,Tie
15972,JointPQPlayer,231,226,457,29,24,Player A
15973,JointPQPlayer,247,247,494,42,16,Tie
15974,JointPQPlayer,225,225,450,28,26,Tie
15975,JointPQPlayer,205,205,410,24,38,Tie
15976,JointPQPlayer,237,237,474,25,17,Tie
15977,JointPQPlayer,261,261,522,49,9,Tie
15978,JointPQPlayer,178,183,361,11,50,JointPQPlayer
15979,JointPQPlayer,271,266,537,55,6,Player A
15980,JointPQPlayer,259,259,518,51,11,Tie
15981,JointPQPlayer,267,267,534,61,9,Tie
15982,JointPQPlayer,258,258,516,46,10,Tie
15983,JointPQPlayer,257,257,514,50,12,Tie
15984,JointPQPlayer,251,251,502,44,14,Tie
15985,JointPQPlayer,242,242,484,41,19,Tie
15986,JointPQPlayer,249,249,498,46,16,Tie
15987,JointPQPlayer,248,248,496,41,15,Tie
15988,JointPQPlayer,217,222,439,29,30,JointPQPlayer
15989,JointPQPlayer,253,248,501,43,14,Player A
15990,JointPQPlayer,219,224,443,30,29,JointPQPlayer
15991,JointPQPlayer,223,218,441,31,30,Player A
15992,JointPQPlayer,243,248,491,42,17,JointPQPlayer
15993,JointPQPlayer,225,220,445,35,30,Player A
15994,JointPQPlayer,180,180,360,13,51,Tie
15995,JointPQPlayer,273,273,546,58,4,Tie
15996,JointPQPlayer,223,223,446,36,30,Tie
15997,JointPQPlayer,252,257,509,51,14,JointPQPlayer
15998,JointPQPlayer,184,179,363,10,49,Player A
15999,JointPQPlayer,189,194,383,12,43,JointPQPlayer
16000,JointPQPlayer,199,194,393,10,39,Player A
16001,JointPQPlayer,260,265,525,49,8,JointPQPlayer
16002,JointPQPlayer,239,239,478,38,20,Tie
16003,JointPQPlayer,246,246,492,34,14,Tie
16004,JointPQPlayer,219,219,438,28,30,Tie
16005,JointPQPlayer,241,241,482,39,19,Tie
16006,JointPQPlayer,249,249,498,46,16,Tie
16007,JointPQPlayer,264,264,528,49,7,Tie
16008,JointPQPlayer,254,249,503,45,14,Player A
16009,JointPQPlayer,274,279,553,62,3,JointPQPlayer
16010,JointPQPlayer,242,237,479,36,19,Player A
16011,JointPQPlayer,266,266,532,50,6,Tie
16012,JointPQPlayer,230,235,465,37,24,JointPQPlayer
16013,JointPQPlayer,256,251,507,37,10,Player A
16014,JointPQPlayer,182,182,364,11,49,Tie
16015,JointPQPlayer,215,220,435,31,32,JointPQPlayer
16016,JointPQPlayer,187,182,369,13,48,Player A
16017,JointPQPlayer,256,261,517,44,9,JointPQPlayer
16018,JointPQPlayer,267,262,529,53,8,Player A
16019,JointPQPlayer,250,250,500,39,13,Tie
16020,JointPQPlayer,255,260,515,45,10,JointPQPlayer
16021,JointPQPlayer,258,253,511,44,11,Player A
16022,JointPQPlayer,248,248,496,47,17,Tie
16023,JointPQPlayer,244,244,488,42,18,Tie
16024,JointPQPlayer,268,273,541,56,5,JointPQPlayer
16025,JointPQPlayer,243,238,481,41,20,Player A
16026,JointPQPlayer,248,248,496,44,16,Tie
16027,JointPQPlayer,224,224,448,38,30,Tie
16028,JointPQPlayer,183,188,371,12,47,JointPQPlayer
16029,JointPQPlayer,260,255,515,54,13,Player A
16030,JointPQPlayer,215,220,435,31,32,JointPQPlayer
16031,JointPQPlayer,181,181,362,9,49,Tie
16032,JointPQPlayer,244,244,488,42,18,Tie
16033,JointPQPlayer,234,229,463,35,24,Player A
16034,JointPQPlayer,249,249,498,37,13,Tie
16035,JointPQPlayer,239,239,478,38,20,Tie
16036,JointPQPlayer,264,269,533,48,5,JointPQPlayer
16037,JointPQPlayer,237,232,469,35,22,Player A
16038,JointPQPlayer,255,255,510,52,14,Tie
16039,JointPQPlayer,246,251,497,42,15,JointPQPlayer
16040,JointPQPlayer,245,245,490,44,18,Tie
16041,JointPQPlayer,213,208,421,20,33,Player A
16042,JointPQPlayer,247,247,494,48,18,Tie
16043,JointPQPlayer,258,258,516,46,10,Tie
16044,JointPQPlayer,256,261,517,47,10,JointPQPlayer
16045,JointPQPlayer,242,237,479,42,21,Player A
16046,JointPQPlayer,270,275,545,57,4,JointPQPlayer
16047,JointPQPlayer,255,255,510,40,10,Tie
16048,JointPQPlayer,243,243,486,37,17,Tie
16049,JointPQPlayer,259,254,513,46,11,Player A
16050,JointPQPlayer,179,184,363,13,50,JointPQPlayer
16051,JointPQPlayer,221,221,442,41,33,Tie
16052,JointPQPlayer,263,263,526,53,9,Tie
16053,JointPQPlayer,263,258,521,51,10,Player A
16054,JointPQPlayer,244,244,488,39,17,Tie
16055,JointPQPlayer,257,257,514,38,8,Tie
16056,JointPQPlayer,237,242,479,45,22,JointPQPlayer
16057,JointPQPlayer,271,266,537,52,5,Player A
16058,JointPQPlayer,256,256,512,45,11,Tie
16059,JointPQPlayer,242,247,489,34,15,JointPQPlayer
16060,JointPQPlayer,247,242,489,37,16,Player A
16061,JointPQPlayer,165,170,335,6,57,JointPQPlayer
16062,JointPQPlayer,162,162,324,7,61,Tie
16063,JointPQPlayer,269,264,533,54,7,Player A
16064,JointPQPlayer,196,201,397,14,39,JointPQPlayer
16065,JointPQPlayer,249,244,493,32,13,Player A
16066,JointPQPlayer,263,268,531,52,7,JointPQPlayer
16067,JointPQPlayer,247,242,489,43,18,Player A
16068,JointPQPlayer,243,248,491,45,18,JointPQPlayer
16069,JointPQPlayer,240,235,475,32,19,Player A
16070,JointPQPlayer,153,158,311,3,64,JointPQPlayer
16071,JointPQPlayer,242,237,479,42,21,Player A
16072,JointPQPlayer,183,183,366,7,47,Tie
16073,JointPQPlayer,279,279,558,67,3,Tie
16074,JointPQPlayer,242,242,484,38,18,Tie
16075,JointPQPlayer,255,255,510,43,11,Tie
16076,JointPQPlayer,256,261,517,53,12,JointPQPlayer
16077,JointPQPlayer,252,252,504,52,16,Tie
16078,JointPQPlayer,266,266,532,47,5,Tie
16079,JointPQPlayer,265,260,525,52,9,Player A
16080,JointPQPlayer,269,269,538,53,5,Tie
16081,JointPQPlayer,266,266,532,50,6,Tie
16082,JointPQPlayer,259,259,518,51,11,Tie
16083,JointPQPlayer,179,184,363,13,50,JointPQPlayer
16084,JointPQPlayer,251,246,497,42,15,Player A
16085,JointPQPlayer,250,250,500,42,14,Tie
16086,JointPQPlayer,226,231,457,35,26,JointPQPlayer
16087,JointPQPlayer,235,235,470,48,26,Tie
16088,JointPQPlayer,246,241,487,35,16,Player A
16089,JointPQPlayer,246,251,497,42,15,JointPQPlayer
16090,JointPQPlayer,272,272,544,56,4,Tie
16091,JointPQPlayer,242,237,479,39,20,Player A
16092,JointPQPlayer,255,260,515,45,10,JointPQPlayer
16093,JointPQPlayer,271,266,537,58,7,Player A
16094,JointPQPlayer,261,261,522,46,8,Tie
16095,JointPQPlayer,179,179,358,17,53,Tie
16096,JointPQPlayer,258,263,521,42,7,JointPQPlayer
16097,JointPQPlayer,268,263,531,52,7,Player A
16098,JointPQPlayer,261,261,522,46,8,Tie
16099,JointPQPlayer,185,190,375,13,46,JointPQPlayer
16100,JointPQPlayer,254,249,503,45,14,Player A
16101,JointPQPlayer,252,252,504,46,14,Tie
16102,JointPQPlayer,260,260,520,44,8,Tie
16103,JointPQPlayer,241,241,482,42,20,Tie
16104,JointPQPlayer,196,201,397,14,39,JointPQPlayer
16105,JointPQPlayer,258,253,511,47,12,Player A
16106,JointPQPlayer,282,282,564,70,2,Tie
16107,JointPQPlayer,258,258,516,43,9,Tie
16108,JointPQPlayer,234,239,473,36,21,JointPQPlayer
16109,JointPQPlayer,239,234,473,39,22,Player A
16110,JointPQPlayer,250,250,500,36,12,Tie
16111,JointPQPlayer,181,186,367,8,47,JointPQPlayer
16112,JointPQPlayer,247,242,489,43,18,Player A
16113,JointPQPlayer,244,244,488,36,16,Tie
16114,JointPQPlayer,256,261,517,41,8,JointPQPlayer
16115,JointPQPlayer,195,190,385,23,46,Player A
16116,JointPQPlayer,236,236,472,38,22,Tie
16117,JointPQPlayer,229,229,458,45,29,Tie
16118,JointPQPlayer,256,256,512,54,14,Tie
16119,JointPQPlayer,270,270,540,52,4,Tie
16120,JointPQPlayer,232,232,464,33,23,Tie
16121,JointPQPlayer,178,183,361,8,49,JointPQPlayer
16122,JointPQPlayer,222,222,444,34,30,Tie
16123,JointPQPlayer,228,223,451,32,27,Player A
16124,JointPQPlayer,181,186,367,8,47,JointPQPlayer
16125,JointPQPlayer,219,214,433,23,30,Player A
16126,JointPQPlayer,267,267,534,55,7,Tie
16127,JointPQPlayer,253,253,506,48,14,Tie
16128,JointPQPlayer,265,265,530,54,8,Tie
16129,JointPQPlayer,172,177,349,11,54,JointPQPlayer
16130,JointPQPlayer,265,260,525,49,8,Player A
16131,JointPQPlayer,249,254,503,48,15,JointPQPlayer
16132,JointPQPlayer,272,267,539,51,4,Player A
16133,JointPQPlayer,256,256,512,48,12,Tie
16134,JointPQPlayer,279,279,558,61,1,Tie
16135,JointPQPlayer,174,179,353,6,51,JointPQPlayer
16136,JointPQPlayer,259,259,518,48,10,Tie
16137,JointPQPlayer,278,273,551,60,3,Player A
16138,JointPQPlayer,270,275,545,63,6,JointPQPlayer
16139,JointPQPlayer,262,257,519,46,9,Player A
16140,JointPQPlayer,202,202,404,15,37,Tie
16141,JointPQPlayer,256,256,512,48,12,Tie
16142,JointPQPlayer,236,236,472,41,23,Tie
16143,JointPQPlayer,254,259,513,43,10,JointPQPlayer
16144,JointPQPlayer,265,265,530,48,6,Tie
16145,JointPQPlayer,191,191,382,8,42,Tie
16146,JointPQPlayer,239,234,473,39,22,Player A
16147,JointPQPlayer,175,175,350,6,52,Tie
16148,JointPQPlayer,177,182,359,3,48,JointPQPlayer
16149,JointPQPlayer,253,253,506,39,11,Tie
16150,JointPQPlayer,271,266,537,55,6,Player A
16151,JointPQPlayer,241,246,487,38,17,JointPQPlayer
16152,JointPQPlayer,239,234,473,30,19,Player A
16153,JointPQPlayer,252,252,504,40,12,Tie
16154,JointPQPlayer,218,218,436,29,31,Tie
16155,JointPQPlayer,254,254,508,50,14,Tie
16156,JointPQPlayer,252,252,504,46,14,Tie
16157,JointPQPlayer,247,247,494,45,17,Tie
16158,JointPQPlayer,271,271,542,57,5,Tie
16159,JointPQPlayer,183,188,371,3,44,JointPQPlayer
16160,JointPQPlayer,261,256,517,44,9,Player A
16161,JointPQPlayer,230,235,465,34,23,JointPQPlayer
16162,JointPQPlayer,202,197,399,28,43,Player A
16163,JointPQPlayer,184,189,373,5,44,JointPQPlayer
16164,JointPQPlayer,258,253,511,44,11,Player A
16165,JointPQPlayer,175,175,350,6,52,Tie
16166,JointPQPlayer,230,235,465,37,24,JointPQPlayer
16167,JointPQPlayer,269,269,538,44,2,Tie
16168,JointPQPlayer,264,259,523,50,9,Player A
16169,JointPQPlayer,254,259,513,43,10,JointPQPlayer
16170,JointPQPlayer,258,253,511,47,12,Player A
16171,JointPQPlayer,271,271,542,54,4,Tie
16172,JointPQPlayer,190,190,380,15,45,Tie
16173,JointPQPlayer,251,251,502,41,13,Tie
16174,JointPQPlayer,177,177,354,4,50,Tie
16175,JointPQPlayer,263,263,526,53,9,Tie
16176,JointPQPlayer,179,184,363,13,50,JointPQPlayer
16177,JointPQPlayer,260,255,515,42,9,Player A
16178,JointPQPlayer,185,185,370,14,48,Tie
16179,JointPQPlayer,192,197,389,27,46,JointPQPlayer
16180,JointPQPlayer,246,241,487,41,18,Player A
16181,JointPQPlayer,259,259,518,51,11,Tie
16182,JointPQPlayer,177,182,359,6,49,JointPQPlayer
16183,JointPQPlayer,255,250,505,50,15,Player A
16184,JointPQPlayer,245,245,490,44,18,Tie
16185,JointPQPlayer,271,271,542,60,6,Tie
16186,JointPQPlayer,258,258,516,43,9,Tie
16187,JointPQPlayer,265,265,530,51,7,Tie
16188,JointPQPlayer,242,247,489,40,17,JointPQPlayer
16189,JointPQPlayer,229,229,458,27,23,Tie
16190,JointPQPlayer,262,257,519,43,8,Player A
16191,JointPQPlayer,252,252,504,43,13,Tie
16192,JointPQPlayer,250,250,500,39,13,Tie
16193,JointPQPlayer,187,187,374,9,45,Tie
16194,JointPQPlayer,261,266,527,51,8,JointPQPlayer
16195,JointPQPlayer,232,227,459,34,25,Player A
16196,JointPQPlayer,252,257,509,42,11,JointPQPlayer
16197,JointPQPlayer,155,155,310,5,65,Tie
16198,JointPQPlayer,279,279,558,61,1,Tie
16199,JointPQPlayer,229,224,453,31,26,Player A
16200,JointPQPlayer,187,192,379,14,45,JointPQPlayer
16201,JointPQPlayer,249,244,493,38,15,Player A
16202,JointPQPlayer,210,210,420,25,35,Tie
16203,JointPQPlayer,163,168,331,5,58,JointPQPlayer
16204,JointPQPlayer,183,178,361,5,48,Player A
16205,JointPQPlayer,227,227,454,29,25,Tie
16206,JointPQPlayer,168,173,341,6,55,JointPQPlayer
16207,JointPQPlayer,255,255,510,40,10,Tie
16208,JointPQPlayer,263,258,521,45,8,Player A
16209,JointPQPlayer,253,253,506,45,13,Tie
16210,JointPQPlayer,243,243,486,37,17,Tie
16211,JointPQPlayer,213,213,426,28,34,Tie
16212,JointPQPlayer,180,180,360,4,48,Tie
16213,JointPQPlayer,249,249,498,46,16,Tie
16214,JointPQPlayer,253,258,511,50,13,JointPQPlayer
16215,JointPQPlayer,267,262,529,50,7,Player A
16216,JointPQPlayer,159,164,323,6,61,JointPQPlayer
16217,JointPQPlayer,179,174,353,12,53,Player A
16218,JointPQPlayer,252,257,509,42,11,JointPQPlayer
16219,JointPQPlayer,261,261,522,52,10,Tie
16220,JointPQPlayer,209,209,418,26,36,Tie
16221,JointPQPlayer,251,246,497,39,14,Player A
16222,JointPQPlayer,191,196,387,7,40,JointPQPlayer
16223,JointPQPlayer,271,266,537,58,7,Player A
16224,JointPQPlayer,217,217,434,30,32,Tie
16225,JointPQPlayer,264,264,528,49,7,Tie
16226,JointPQPlayer,248,253,501,37,12,JointPQPlayer
16227,JointPQPlayer,234,229,463,35,24,Player A
16228,JointPQPlayer,259,259,518,42,8,Tie
16229,JointPQPlayer,258,263,521,42,7,JointPQPlayer
16230,JointPQPlayer,255,250,505,41,12,Player A
16231,JointPQPlayer,250,250,500,48,16,Tie
16232,JointPQPlayer,171,176,347,6,53,JointPQPlayer
16233,JointPQPlayer,183,178,361,14,51,Player A
16234,JointPQPlayer,250,250,500,39,13,Tie
16235,JointPQPlayer,264,264,528,52,8,Tie
16236,JointPQPlayer,257,262,519,55,12,JointPQPlayer
16237,JointPQPlayer,234,229,463,35,24,Player A
16238,JointPQPlayer,258,258,516,46,10,Tie
16239,JointPQPlayer,256,256,512,48,12,Tie
16240,JointPQPlayer,200,205,405,10,35,JointPQPlayer
16241,JointPQPlayer,266,261,527,51,8,Player A
16242,JointPQPlayer,198,203,401,18,39,JointPQPlayer
16243,JointPQPlayer,239,234,473,36,21,Player A
16244,JointPQPlayer,228,233,461,36,25,JointPQPlayer
16245,JointPQPlayer,255,255,510,49,13,Tie
16246,JointPQPlayer,177,177,354,7,51,Tie
16247,JointPQPlayer,261,256,517,56,13,Player A
16248,JointPQPlayer,257,257,514,44,10,Tie
16249,JointPQPlayer,240,240,480,34,18,Tie
16250,JointPQPlayer,163,168,331,2,57,JointPQPlayer
16251,JointPQPlayer,247,247,494,42,16,Tie
16252,JointPQPlayer,220,220,440,24,28,Tie
16253,JointPQPlayer,186,181,367,8,47,Player A
16254,JointPQPlayer,256,261,517,41,8,JointPQPlayer
16255,JointPQPlayer,227,222,449,30,27,Player A
16256,JointPQPlayer,251,251,502,44,14,Tie
16257,JointPQPlayer,207,212,419,30,37,JointPQPlayer
16258,JointPQPlayer,272,267,539,57,6,Player A
16259,JointPQPlayer,268,273,541,59,6,JointPQPlayer
16260,JointPQPlayer,254,249,503,42,13,Player A
16261,JointPQPlayer,243,243,486,49,21,Tie
16262,JointPQPlayer,258,258,516,52,12,Tie
16263,JointPQPlayer,262,262,524,57,11,Tie
16264,JointPQPlayer,174,179,353,6,51,JointPQPlayer
16265,JointPQPlayer,272,267,539,51,4,Player A
16266,JointPQPlayer,253,253,506,48,14,Tie
16267,JointPQPlayer,255,255,510,43,11,Tie
16268,JointPQPlayer,259,259,518,45,9,Tie
16269,JointPQPlayer,267,267,534,58,8,Tie
16270,JointPQPlayer,257,257,514,50,12,Tie
16271,JointPQPlayer,265,265,530,54,8,Tie
16272,JointPQPlayer,229,234,463,41,26,JointPQPlayer
16273,JointPQPlayer,224,224,448,38,30,Tie
16274,JointPQPlayer,229,224,453,28,25,Player A
16275,JointPQPlayer,248,248,496,35,13,Tie
16276,JointPQPlayer,251,251,502,47,15,Tie
16277,JointPQPlayer,242,247,489,40,17,JointPQPlayer
16278,JointPQPlayer,218,213,431,24,31,Player A
16279,JointPQPlayer,223,228,451,32,27,JointPQPlayer
16280,JointPQPlayer,243,238,481,35,18,Player A
16281,JointPQPlayer,242,247,489,34,15,JointPQPlayer
16282,JointPQPlayer,249,244,493,41,16,Player A
16283,JointPQPlayer,247,247,494,39,15,Tie
16284,JointPQPlayer,170,175,345,4,53,JointPQPlayer
16285,JointPQPlayer,258,258,516,46,10,Tie
16286,JointPQPlayer,225,225,450,43,31,Tie
16287,JointPQPlayer,157,157,314,6,64,Tie
16288,JointPQPlayer,263,258,521,57,12,Player A
16289,JointPQPlayer,262,267,529,47,6,JointPQPlayer
16290,JointPQPlayer,226,221,447,37,30,Player A
16291,JointPQPlayer,173,173,346,5,53,Tie
16292,JointPQPlayer,226,231,457,41,28,JointPQPlayer
16293,JointPQPlayer,233,233,466,41,25,Tie
16294,JointPQPlayer,258,253,511,44,11,Player A
16295,JointPQPlayer,223,223,446,33,29,Tie
16296,JointPQPlayer,251,256,507,46,13,JointPQPlayer
16297,JointPQPlayer,173,173,346,5,53,Tie
16298,JointPQPlayer,173,168,341,6,55,Player A
16299,JointPQPlayer,234,239,473,42,23,JointPQPlayer
16300,JointPQPlayer,267,262,529,56,9,Player A
16301,JointPQPlayer,263,268,531,58,9,JointPQPlayer
16302,JointPQPlayer,261,256,517,47,10,Player A
16303,JointPQPlayer,260,260,520,44,8,Tie
16304,JointPQPlayer,262,267,529,50,7,JointPQPlayer
16305,JointPQPlayer,272,267,539,60,7,Player A
16306,JointPQPlayer,248,248,496,38,14,Tie
16307,JointPQPlayer,187,192,379,8,43,JointPQPlayer
16308,JointPQPlayer,253,248,501,37,12,Player A
16309,JointPQPlayer,233,238,471,40,23,JointPQPlayer
16310,JointPQPlayer,212,212,424,29,35,Tie
16311,JointPQPlayer,167,167,334,5,57,Tie
16312,JointPQPlayer,254,249,503,36,11,Player A
16313,JointPQPlayer,270,270,540,61,7,Tie
16314,JointPQPlayer,210,210,420,19,33,Tie
16315,JointPQPlayer,261,261,522,37,5,Tie
16316,JointPQPlayer,258,263,521,45,8,JointPQPlayer
16317,JointPQPlayer,241,236,477,46,23,Player A
16318,JointPQPlayer,252,252,504,49,15,Tie
16319,JointPQPlayer,224,224,448,29,27,Tie
16320,JointPQPlayer,238,243,481,35,18,JointPQPlayer
16321,JointPQPlayer,270,265,535,56,7,Player A
16322,JointPQPlayer,189,194,383,12,43,JointPQPlayer
16323,JointPQPlayer,271,266,537,55,6,Player A
16324,JointPQPlayer,229,229,458,30,24,Tie
16325,JointPQPlayer,270,275,545,54,3,JointPQPlayer
16326,JointPQPlayer,243,238,481,35,18,Player A
16327,JointPQPlayer,264,264,528,49,7,Tie
16328,JointPQPlayer,264,264,528,55,9,Tie
16329,JointPQPlayer,277,277,554,63,3,Tie
16330,JointPQPlayer,258,258,516,49,11,Tie
16331,JointPQPlayer,228,233,461,36,25,JointPQPlayer
16332,JointPQPlayer,264,259,523,50,9,Player A
16333,JointPQPlayer,231,236,467,42,25,JointPQPlayer
16334,JointPQPlayer,246,241,487,41,18,Player A
16335,JointPQPlayer,254,254,508,44,12,Tie
16336,JointPQPlayer,182,187,369,10,47,JointPQPlayer
16337,JointPQPlayer,246,241,487,41,18,Player A
16338,JointPQPlayer,270,270,540,52,4,Tie
16339,JointPQPlayer,258,258,516,52,12,Tie
16340,JointPQPlayer,247,247,494,39,15,Tie
16341,JointPQPlayer,242,242,484,47,21,Tie
16342,JointPQPlayer,174,179,353,6,51,JointPQPlayer
16343,JointPQPlayer,260,255,515,45,10,Player A
16344,JointPQPlayer,270,275,545,60,5,JointPQPlayer
16345,JointPQPlayer,155,155,310,5,65,Tie
16346,JointPQPlayer,263,258,521,51,10,Player A
16347,JointPQPlayer,260,260,520,50,10,Tie
16348,JointPQPlayer,245,245,490,44,18,Tie
16349,JointPQPlayer,269,269,538,53,5,Tie
16350,JointPQPlayer,212,217,429,28,33,JointPQPlayer
16351,JointPQPlayer,243,238,481,35,18,Player A
16352,JointPQPlayer,259,259,518,48,10,Tie
16353,JointPQPlayer,267,267,534,52,6,Tie
16354,JointPQPlayer,271,271,542,57,5,Tie
16355,JointPQPlayer,242,242,484,44,20,Tie
16356,JointPQPlayer,277,277,554,63,3,Tie
16357,JointPQPlayer,265,265,530,57,9,Tie
16358,JointPQPlayer,228,228,456,37,27,Tie
16359,JointPQPlayer,262,262,524,48,8,Tie
16360,JointPQPlayer,180,180,360,7,49,Tie
16361,JointPQPlayer,258,258,516,46,10,Tie
16362,JointPQPlayer,251,256,507,40,11,JointPQPlayer
16363,JointPQPlayer,250,245,495,46,17,Player A
16364,JointPQPlayer,254,254,508,47,13,Tie
16365,JointPQPlayer,170,175,345,7,54,JointPQPlayer
16366,JointPQPlayer,243,238,481,44,21,Player A
16367,JointPQPlayer,183,183,366,7,47,Tie
16368,JointPQPlayer,263,263,526,56,10,Tie
16369,JointPQPlayer,181,186,367,8,47,JointPQPlayer
16370,JointPQPlayer,257,252,509,51,14,Player A
16371,JointPQPlayer,265,270,535,53,6,JointPQPlayer
16372,JointPQPlayer,275,270,545,60,5,Player A
16373,JointPQPlayer,266,266,532,50,6,Tie
16374,JointPQPlayer,271,271,542,54,4,Tie
16375,JointPQPlayer,170,175,345,10,55,JointPQPlayer
16376,JointPQPlayer,245,240,485,42,19,Player A
16377,JointPQPlayer,245,245,490,44,18,Tie
16378,JointPQPlayer,266,271,537,58,7,JointPQPlayer
16379,JointPQPlayer,257,252,509,39,10,Player A
16380,JointPQPlayer,265,265,530,48,6,Tie
16381,JointPQPlayer,158,163,321,4,61,JointPQPlayer
16382,JointPQPlayer,245,240,485,45,20,Player A
16383,JointPQPlayer,271,271,542,57,5,Tie
16384,JointPQPlayer,272,272,544,56,4,Tie
16385,JointPQPlayer,260,260,520,50,10,Tie
16386,JointPQPlayer,260,265,525,46,7,JointPQPlayer
16387,JointPQPlayer,159,159,318,1,61,Tie
16388,JointPQPlayer,253,253,506,42,12,Tie
16389,JointPQPlayer,231,226,457,38,27,Player A
16390,JointPQPlayer,270,270,540,55,5,Tie
16391,JointPQPlayer,255,260,515,42,9,JointPQPlayer
16392,JointPQPlayer,250,250,500,39,13,Tie
16393,JointPQPlayer,190,185,375,13,46,Player A
16394,JointPQPlayer,179,179,358,11,51,Tie
16395,JointPQPlayer,255,255,510,49,13,Tie
16396,JointPQPlayer,259,264,523,50,9,JointPQPlayer
16397,JointPQPlayer,272,267,539,60,7,Player A
16398,JointPQPlayer,213,213,426,28,34,Tie
16399,JointPQPlayer,227,227,454,29,25,Tie
16400,JointPQPlayer,173,178,351,4,51,JointPQPlayer
16401,JointPQPlayer,254,254,508,47,13,Tie
16402,JointPQPlayer,154,154,308,6,66,Tie
16403,JointPQPlayer,251,246,497,45,16,Player A
16404,JointPQPlayer,254,259,513,49,12,JointPQPlayer
16405,JointPQPlayer,247,247,494,42,16,Tie
16406,JointPQPlayer,250,245,495,37,14,Player A
16407,JointPQPlayer,260,260,520,44,8,Tie
16408,JointPQPlayer,250,250,500,36,12,Tie
16409,JointPQPlayer,159,164,323,3,60,JointPQPlayer
16410,JointPQPlayer,259,254,513,49,12,Player A
16411,JointPQPlayer,270,270,540,49,3,Tie
16412,JointPQPlayer,184,184,368,15,49,Tie
16413,JointPQPlayer,268,268,536,54,6,Tie
16414,JointPQPlayer,276,276,552,67,5,Tie
16415,JointPQPlayer,247,247,494,42,16,Tie
16416,JointPQPlayer,193,198,391,20,43,JointPQPlayer
16417,JointPQPlayer,277,277,554,63,3,Tie
16418,JointPQPlayer,248,243,491,42,17,Player A
16419,JointPQPlayer,248,248,496,44,16,Tie
16420,JointPQPlayer,253,253,506,48,14,Tie
16421,JointPQPlayer,266,266,532,56,8,Tie
16422,JointPQPlayer,261,261,522,55,11,Tie
16423,JointPQPlayer,248,253,501,46,15,JointPQPlayer
16424,JointPQPlayer,222,217,439,29,30,Player A
16425,JointPQPlayer,249,249,498,40,14,Tie
16426,JointPQPlayer,207,207,414,19,35,Tie
16427,JointPQPlayer,257,262,519,43,8,JointPQPlayer
16428,JointPQPlayer,200,195,395,24,43,Player A
16429,JointPQPlayer,233,238,471,31,20,JointPQPlayer
16430,JointPQPlayer,260,260,520,53,11,Tie
16431,JointPQPlayer,275,275,550,68,6,Tie
16432,JointPQPlayer,252,247,499,41,14,Player A
16433,JointPQPlayer,255,260,515,48,11,JointPQPlayer
16434,JointPQPlayer,240,235,475,41,22,Player A
16435,JointPQPlayer,228,228,456,31,25,Tie
16436,JointPQPlayer,179,184,363,4,47,JointPQPlayer
16437,JointPQPlayer,271,266,537,52,5,Player A
16438,JointPQPlayer,253,258,511,47,12,JointPQPlayer
16439,JointPQPlayer,250,250,500,39,13,Tie
16440,JointPQPlayer,259,259,518,48,10,Tie
16441,JointPQPlayer,167,167,334,5,57,Tie
16442,JointPQPlayer,225,220,445,29,28,Player A
16443,JointPQPlayer,269,269,538,50,4,Tie
16444,JointPQPlayer,271,271,542,57,5,Tie
16445,JointPQPlayer,242,247,489,43,18,JointPQPlayer
16446,JointPQPlayer,256,251,507,40,11,Player A
16447,JointPQPlayer,243,243,486,37,17,Tie
16448,JointPQPlayer,251,251,502,41,13,Tie
16449,JointPQPlayer,257,262,519,46,9,JointPQPlayer
16450,JointPQPlayer,215,215,430,35,35,Tie
16451,JointPQPlayer,163,163,326,3,59,Tie
16452,JointPQPlayer,237,237,474,43,23,Tie
16453,JointPQPlayer,194,189,383,15,44,Player A
16454,JointPQPlayer,186,191,377,6,43,JointPQPlayer
16455,JointPQPlayer,267,262,529,53,8,Player A
16456,JointPQPlayer,244,244,488,45,19,Tie
16457,JointPQPlayer,245,250,495,40,15,JointPQPlayer
16458,JointPQPlayer,256,251,507,52,15,Player A
16459,JointPQPlayer,251,251,502,41,13,Tie
16460,JointPQPlayer,206,211,417,19,34,JointPQPlayer
16461,JointPQPlayer,258,258,516,46,10,Tie
16462,JointPQPlayer,260,255,515,48,11,Player A
16463,JointPQPlayer,258,258,516,43,9,Tie
16464,JointPQPlayer,221,221,442,29,29,Tie
16465,JointPQPlayer,238,243,481,32,17,JointPQPlayer
16466,JointPQPlayer,248,248,496,35,13,Tie
16467,JointPQPlayer,257,252,509,48,13,Player A
16468,JointPQPlayer,224,229,453,40,29,JointPQPlayer
16469,JointPQPlayer,256,251,507,46,13,Player A
16470,JointPQPlayer,274,274,548,66,6,Tie
16471,JointPQPlayer,259,259,518,51,11,Tie
16472,JointPQPlayer,173,173,346,8,54,Tie
16473,JointPQPlayer,255,255,510,46,12,Tie
16474,JointPQPlayer,233,233,466,35,23,Tie
16475,JointPQPlayer,255,255,510,46,12,Tie
16476,JointPQPlayer,244,244,488,42,18,Tie
16477,JointPQPlayer,171,176,347,12,55,JointPQPlayer
16478,JointPQPlayer,264,259,523,41,6,Player A
16479,JointPQPlayer,248,253,501,46,15,JointPQPlayer
16480,JointPQPlayer,267,262,529,47,6,Player A
16481,JointPQPlayer,268,273,541,56,5,JointPQPlayer
16482,JointPQPlayer,250,245,495,40,15,Player A
16483,JointPQPlayer,209,214,423,28,35,JointPQPlayer
16484,JointPQPlayer,259,254,513,49,12,Player A
16485,JointPQPlayer,253,253,506,51,15,Tie
16486,JointPQPlayer,182,182,364,8,48,Tie
16487,JointPQPlayer,255,260,515,48,11,JointPQPlayer
16488,JointPQPlayer,255,250,505,50,15,Player A
16489,JointPQPlayer,263,263,526,47,7,Tie
16490,JointPQPlayer,232,232,464,39,25,Tie
16491,JointPQPlayer,255,255,510,40,10,Tie
16492,JointPQPlayer,263,263,526,47,7,Tie
16493,JointPQPlayer,259,259,518,57,13,Tie
16494,JointPQPlayer,178,183,361,5,48,JointPQPlayer
16495,JointPQPlayer,252,247,499,41,14,Player A
16496,JointPQPlayer,256,256,512,51,13,Tie
16497,JointPQPlayer,242,242,484,47,21,Tie
16498,JointPQPlayer,174,179,353,9,52,JointPQPlayer
16499,JointPQPlayer,257,252,509,51,14,Player A
16500,JointPQPlayer,263,268,531,58,9,JointPQPlayer
16501,JointPQPlayer,254,249,503,45,14,Player A
16502,JointPQPlayer,170,175,345,7,54,JointPQPlayer
16503,JointPQPlayer,261,256,517,53,12,Player A
16504,JointPQPlayer,258,258,516,43,9,Tie
16505,JointPQPlayer,169,174,343,5,54,JointPQPlayer
16506,JointPQPlayer,261,261,522,46,8,Tie
16507,JointPQPlayer,236,231,467,36,23,Player A
16508,JointPQPlayer,266,266,532,53,7,Tie
16509,JointPQPlayer,168,173,341,3,54,JointPQPlayer
16510,JointPQPlayer,249,244,493,44,17,Player A
16511,JointPQPlayer,245,250,495,37,14,JointPQPlayer
16512,JointPQPlayer,256,251,507,49,14,Player A
16513,JointPQPlayer,229,229,458,30,24,Tie
16514,JointPQPlayer,254,254,508,38,10,Tie
16515,JointPQPlayer,239,244,483,40,19,JointPQPlayer
16516,JointPQPlayer,261,256,517,53,12,Player A
16517,JointPQPlayer,270,275,545,63,6,JointPQPlayer
16518,JointPQPlayer,252,252,504,40,12,Tie
16519,JointPQPlayer,268,268,536,51,5,Tie
16520,JointPQPlayer,256,251,507,40,11,Player A
16521,JointPQPlayer,257,262,519,46,9,JointPQPlayer
16522,JointPQPlayer,264,259,523,50,9,Player A
16523,JointPQPlayer,268,268,536,51,5,Tie
16524,JointPQPlayer,184,184,368,9,47,Tie
16525,JointPQPlayer,249,254,503,48,15,JointPQPlayer
16526,JointPQPlayer,180,175,355,8,51,Player A
16527,JointPQPlayer,239,239,478,38,20,Tie
16528,JointPQPlayer,255,260,515,48,11,JointPQPlayer
16529,JointPQPlayer,154,154,308,3,65,Tie
16530,JointPQPlayer,253,248,501,49,16,Player A
16531,JointPQPlayer,267,267,534,55,7,Tie
16532,JointPQPlayer,236,236,472,32,20,Tie
16533,JointPQPlayer,253,253,506,36,10,Tie
16534,JointPQPlayer,257,257,514,50,12,Tie
16535,JointPQPlayer,269,269,538,53,5,Tie
16536,JointPQPlayer,211,211,422,30,36,Tie
16537,JointPQPlayer,249,249,498,43,15,Tie
16538,JointPQPlayer,243,243,486,43,19,Tie
16539,JointPQPlayer,263,263,526,53,9,Tie
16540,JointPQPlayer,258,258,516,52,12,Tie
16541,JointPQPlayer,265,265,530,54,8,Tie
16542,JointPQPlayer,237,237,474,40,22,Tie
16543,JointPQPlayer,175,180,355,17,54,JointPQPlayer
16544,JointPQPlayer,235,230,465,37,24,Player A
16545,JointPQPlayer,196,196,392,21,43,Tie
16546,JointPQPlayer,245,245,490,41,17,Tie
16547,JointPQPlayer,260,260,520,47,9,Tie
16548,JointPQPlayer,270,270,540,55,5,Tie
16549,JointPQPlayer,262,267,529,50,7,JointPQPlayer
16550,JointPQPlayer,185,185,370,8,46,Tie
16551,JointPQPlayer,258,258,516,46,10,Tie
16552,JointPQPlayer,225,220,445,23,26,Player A
16553,JointPQPlayer,250,250,500,45,15,Tie
16554,JointPQPlayer,258,258,516,43,9,Tie
16555,JointPQPlayer,241,241,482,42,20,Tie
16556,JointPQPlayer,175,180,355,5,50,JointPQPlayer
16557,JointPQPlayer,243,238,481,41,20,Player A
16558,JointPQPlayer,249,249,498,46,16,Tie
16559,JointPQPlayer,255,255,510,49,13,Tie
16560,JointPQPlayer,234,234,468,46,26,Tie
16561,JointPQPlayer,263,263,526,50,8,Tie
16562,JointPQPlayer,237,237,474,40,22,Tie
16563,JointPQPlayer,256,256,512,45,11,Tie
16564,JointPQPlayer,182,182,364,11,49,Tie
16565,JointPQPlayer,199,204,403,23,40,JointPQPlayer
16566,JointPQPlayer,250,245,495,43,16,Player A
16567,JointPQPlayer,197,202,399,28,43,JointPQPlayer
16568,JointPQPlayer,255,250,505,41,12,Player A
16569,JointPQPlayer,238,243,481,44,21,JointPQPlayer
16570,JointPQPlayer,226,226,452,33,27,Tie
16571,JointPQPlayer,263,258,521,45,8,Player A
16572,JointPQPlayer,236,241,477,34,19,JointPQPlayer
16573,JointPQPlayer,255,255,510,49,13,Tie
16574,JointPQPlayer,263,263,526,53,9,Tie
16575,JointPQPlayer,230,230,460,32,24,Tie
16576,JointPQPlayer,261,261,522,49,9,Tie
16577,JointPQPlayer,160,160,320,3,61,Tie
16578,JointPQPlayer,266,266,532,59,9,Tie
16579,JointPQPlayer,234,229,463,32,23,Player A
16580,JointPQPlayer,181,181,362,6,48,Tie
16581,JointPQPlayer,255,255,510,46,12,Tie
16582,JointPQPlayer,260,260,520,53,11,Tie
16583,JointPQPlayer,258,258,516,46,10,Tie
16584,JointPQPlayer,242,247,489,43,18,JointPQPlayer
16585,JointPQPlayer,159,154,313,5,64,Player A
16586,JointPQPlayer,201,201,402,22,40,Tie
16587,JointPQPlayer,269,274,543,58,5,JointPQPlayer
16588,JointPQPlayer,169,169,338,6,56,Tie
16589,JointPQPlayer,262,257,519,46,9,Player A
16590,JointPQPlayer,256,261,517,44,9,JointPQPlayer
16591,JointPQPlayer,180,180,360,7,49,Tie
16592,JointPQPlayer,240,235,475,35,20,Player A
16593,JointPQPlayer,243,243,486,46,20,Tie
16594,JointPQPlayer,255,255,510,49,13,Tie
16595,JointPQPlayer,266,266,532,53,7,Tie
16596,JointPQPlayer,261,266,527,51,8,JointPQPlayer
16597,JointPQPlayer,252,252,504,49,15,Tie
16598,JointPQPlayer,269,264,533,51,6,Player A
16599,JointPQPlayer,265,265,530,48,6,Tie
16600,JointPQPlayer,246,246,492,46,18,Tie
16601,JointPQPlayer,242,242,484,38,18,Tie
16602,JointPQPlayer,280,285,565,68,1,JointPQPlayer
0,revTitforTat,225,225,450,25,25,Tie
1,revTitforTat,225,225,450,25,25,Tie
2,revTitforTat,225,225,450,25,25,Tie
3,revTitforTat,225,225,450,25,25,Tie
4,revTitforTat,225,225,450,25,25,Tie
5,revTitforTat,225,225,450,25,25,Tie
6,revTitforTat,225,225,450,25,25,Tie
7,revTitforTat,225,225,450,25,25,Tie
8,revTitforTat,225,225,450,25,25,Tie
9,revTitforTat,225,225,450,25,25,Tie
10,revTitforTat,225,225,450,25,25,Tie
0,PatternPlayer,235,230,465,16,17,Player A
1,PatternPlayer,232,237,469,17,16,PatternPlayer
2,PatternPlayer,235,230,465,16,17,Player A
3,PatternPlayer,233,233,466,17,17,Tie
4,PatternPlayer,232,237,469,17,16,PatternPlayer
5,PatternPlayer,235,230,465,16,17,Player A
6,PatternPlayer,233,233,466,17,17,Tie
7,PatternPlayer,232,237,469,17,16,PatternPlayer
8,PatternPlayer,235,230,465,16,17,Player A
9,PatternPlayer,233,233,466,17,17,Tie
10,PatternPlayer,232,237,469,17,16,PatternPlayer
11,PatternPlayer,235,230,465,16,17,Player A
12,PatternPlayer,233,233,466,17,17,Tie
0,GrudgePlayer,300,300,600,100,0,Tie
1,GrudgePlayer,300,300,600,100,0,Tie
2,GrudgePlayer,300,300,600,100,0,Tie
3,GrudgePlayer,300,300,600,100,0,Tie
4,GrudgePlayer,300,300,600,100,0,Tie
5,GrudgePlayer,300,300,600,100,0,Tie
6,GrudgePlayer,300,300,600,100,0,Tie
7,GrudgePlayer,300,300,600,100,0,Tie
8,GrudgePlayer,300,300,600,100,0,Tie
9,GrudgePlayer,300,300,600,100,0,Tie
10,GrudgePlayer,300,300,600,100,0,Tie
0,Gullible,300,300,600,100,0,Tie
1,Gullible,300,300,600,100,0,Tie
2,Gullible,300,300,600,100,0,Tie
3,Gullible,300,300,600,100,0,Tie
4,Gullible,300,300,600,100,0,Tie
5,Gullible,300,300,600,100,0,Tie
6,Gullible,300,300,600,100,0,Tie
7,Gullible,300,300,600,100,0,Tie
8,Gullible,300,300,600,100,0,Tie
9,Gullible,300,300,600,100,0,Tie
10,Gullible,300,300,600,100,0,Tie
0,Sly Fox,99,104,203,0,99,Sly Fox
1,Sly Fox,100,100,200,0,100,Tie
2,Sly Fox,100,100,200,0,100,Tie
3,Sly Fox,100,100,200,0,100,Tie
4,Sly Fox,100,100,200,0,100,Tie
5,Sly Fox,100,100,200,0,100,Tie
6,Sly Fox,100,100,200,0,100,Tie
7,Sly Fox,100,100,200,0,100,Tie
8,Sly Fox,100,100,200,0,100,Tie
9,Sly Fox,100,100,200,0,100,Tie
10,Sly Fox,100,100,200,0,100,Tie
0,Evan,251,246,497,0,1,Player A
1,Evan,250,250,500,0,0,Tie
2,Evan,250,250,500,0,0,Tie
3,Evan,250,250,500,0,0,Tie
4,Evan,250,250,500,0,0,Tie
5,Evan,250,250,500,0,0,Tie
6,Evan,250,250,500,0,0,Tie
7,Evan,250,250,500,0,0,Tie
8,Evan,250,250,500,0,0,Tie
9,Evan,250,250,500,0,0,Tie
10,Evan,250,250,500,0,0,Tie
0,Randy,226,231,457,23,22,Randy
1,Randy,234,234,468,31,21,Tie
2,Randy,226,221,447,25,26,Player A
3,Randy,225,225,450,19,23,Tie
4,Randy,237,242,479,30,17,Randy
5,Randy,227,222,449,27,26,Player A
6,Randy,228,233,461,30,23,Randy
7,Randy,232,232,464,33,23,Tie
8,Randy,225,220,445,23,26,Player A
9,Randy,232,232,464,27,21,Tie
10,Randy,221,221,442,26,28,Tie
11,Randy,222,227,449,30,27,Randy
12,Randy,215,215,430,17,29,Tie
13,Randy,229,229,458,27,23,Tie
14,Randy,224,219,443,21,26,Player A
15,Randy,224,229,453,31,26,Randy
16,Randy,215,210,425,21,32,Player A
17,Randy,230,230,460,32,24,Tie
18,Randy,222,222,444,22,26,Tie
19,Randy,224,229,453,25,24,Randy
20,Randy,228,228,456,28,24,Tie
21,Randy,234,229,463,32,23,Player A
22,Randy,236,241,477,31,18,Randy
23,Randy,219,219,438,25,29,Tie
24,Randy,225,220,445,26,27,Player A
25,Randy,211,211,422,24,34,Tie
26,Randy,221,221,442,17,25,Tie
27,Randy,213,213,426,25,33,Tie
28,Randy,199,199,398,15,39,Tie
29,Randy,231,236,467,27,20,Randy
30,Randy,213,208,421,20,33,Player A
31,Randy,225,230,455,30,25,Randy
32,Randy,230,230,460,26,22,Tie
33,Randy,226,221,447,22,25,Player A
34,Randy,226,231,457,32,25,Randy
35,Randy,217,212,429,22,31,Player A
36,Randy,211,211,422,18,32,Tie
37,Randy,236,241,477,37,20,Randy
38,Randy,221,221,442,26,28,Tie
39,Randy,213,208,421,23,34,Player A
40,Randy,220,220,440,18,26,Tie
41,Randy,246,246,492,34,14,Tie
42,Randy,233,238,471,22,17,Randy
43,Randy,218,213,431,21,30,Player A
44,Randy,216,216,432,22,30,Tie
45,Randy,223,228,451,26,25,Randy
46,Randy,223,223,446,24,26,Tie
47,Randy,224,219,443,27,28,Player A
48,Randy,233,238,471,25,18,Randy
49,Randy,236,231,467,33,22,Player A
50,Randy,235,240,475,29,18,Randy
51,Randy,206,206,412,17,35,Tie
52,Randy,236,231,467,30,21,Player A
53,Randy,228,228,456,28,24,Tie
54,Randy,212,212,424,20,32,Tie
55,Randy,208,208,416,21,35,Tie
56,Randy,201,206,407,15,36,Randy
57,Randy,227,222,449,27,26,Player A
58,Randy,199,204,403,20,39,Randy
59,Randy,236,236,472,23,17,Tie
60,Randy,240,235,475,32,19,Player A
61,Randy,217,222,439,29,30,Randy
62,Randy,220,215,435,19,28,Player A
63,Randy,221,221,442,26,28,Tie
64,Randy,228,228,456,22,22,Tie
65,Randy,203,208,411,13,34,Randy
66,Randy,226,221,447,22,25,Player A
67,Randy,222,222,444,28,28,Tie
68,Randy,229,229,458,33,25,Tie
69,Randy,215,215,430,17,29,Tie
70,Randy,241,246,487,35,16,Randy
71,Randy,220,215,435,28,31,Player A
72,Randy,217,217,434,24,30,Tie
73,Randy,225,225,450,22,24,Tie
74,Randy,222,222,444,19,25,Tie
75,Randy,216,221,437,27,30,Randy
76,Randy,224,224,448,20,24,Tie
77,Randy,223,223,446,24,26,Tie
78,Randy,242,237,479,33,18,Player A
79,Randy,238,238,476,30,18,Tie
80,Randy,227,232,459,28,23,Randy
81,Randy,229,229,458,27,23,Tie
82,Randy,233,228,461,24,21,Player A
83,Randy,217,217,434,18,28,Tie
84,Randy,219,224,443,30,29,Randy
85,Randy,222,222,444,22,26,Tie
86,Randy,209,204,413,21,36,Player A
87,Randy,228,233,461,24,21,Randy
88,Randy,219,219,438,22,28,Tie
89,Randy,230,225,455,30,25,Player A
90,Randy,233,233,466,26,20,Tie
91,Randy,215,215,430,23,31,Tie
92,Randy,234,239,473,21,16,Randy
93,Randy,208,208,416,18,34,Tie
94,Randy,216,216,432,22,30,Tie
95,Randy,216,216,432,25,31,Tie
96,Randy,224,224,448,20,24,Tie
97,Randy,238,233,471,34,21,Player A
98,Randy,230,230,460,26,22,Tie
99,Randy,229,229,458,21,21,Tie
100,Randy,216,216,432,22,30,Tie
101,Randy,236,236,472,32,20,Tie
102,Randy,231,236,467,30,21,Randy
103,Randy,240,235,475,32,19,Player A
104,Randy,202,207,409,17,36,Randy
105,Randy,225,220,445,23,26,Player A
106,Randy,235,235,470,30,20,Tie
107,Randy,226,231,457,32,25,Randy
108,Randy,224,219,443,24,27,Player A
109,Randy,220,225,445,26,27,Randy
110,Randy,237,232,469,35,22,Player A
111,Randy,232,232,464,27,21,Tie
112,Randy,221,221,442,23,27,Tie
113,Randy,210,210,420,25,35,Tie
114,Randy,225,230,455,27,24,Randy
115,Randy,204,199,403,14,37,Player A
116,Randy,235,240,475,32,19,Randy
117,Randy,227,227,454,23,23,Tie
118,Randy,237,232,469,26,19,Player A
119,Randy,223,223,446,21,25,Tie
120,Randy,219,219,438,22,28,Tie
121,Randy,242,247,489,34,15,Randy
122,Randy,216,211,427,20,31,Player A
123,Randy,236,236,472,32,20,Tie
124,Randy,212,217,429,19,30,Randy
125,Randy,231,226,457,26,23,Player A
126,Randy,227,227,454,26,24,Tie
127,Randy,223,228,451,29,26,Randy
128,Randy,229,229,458,27,23,Tie
129,Randy,233,233,466,29,21,Tie
130,Randy,210,205,415,23,36,Player A
131,Randy,237,237,474,31,19,Tie
132,Randy,244,244,488,39,17,Tie
133,Randy,219,219,438,19,27,Tie
134,Randy,238,243,481,32,17,Randy
135,Randy,230,230,460,26,22,Tie
136,Randy,247,247,494,30,12,Tie
137,Randy,240,240,480,31,17,Tie
138,Randy,216,216,432,19,29,Tie
139,Randy,227,222,449,18,23,Player A
140,Randy,228,228,456,25,23,Tie
141,Randy,213,213,426,16,30,Tie
142,Randy,209,214,423,19,32,Randy
143,Randy,232,227,459,31,24,Player A
144,Randy,227,227,454,20,22,Tie
145,Randy,217,222,439,20,27,Randy
146,Randy,235,230,465,31,22,Player A
147,Randy,230,235,465,28,21,Randy
148,Randy,238,233,471,31,20,Player A
149,Randy,204,204,408,19,37,Tie
150,Randy,234,239,473,33,20,Randy
151,Randy,228,228,456,22,22,Tie
152,Randy,238,233,471,31,20,Player A
153,Randy,231,231,462,25,21,Tie
154,Randy,216,221,437,27,30,Randy
155,Randy,235,230,465,34,23,Player A
156,Randy,211,216,427,26,33,Randy
157,Randy,235,230,465,28,21,Player A
158,Randy,216,216,432,16,28,Tie
159,Randy,198,198,396,16,40,Tie
160,Randy,227,227,454,26,24,Tie
161,Randy,241,241,482,36,18,Tie
162,Randy,222,222,444,19,25,Tie
163,Randy,215,220,435,22,29,Randy
164,Randy,233,228,461,30,23,Player A
165,Randy,237,242,479,27,16,Randy
166,Randy,233,233,466,20,18,Tie
167,Randy,241,241,482,27,15,Tie
168,Randy,229,224,453,28,25,Player A
169,Randy,219,219,438,16,26,Tie
170,Randy,210,210,420,16,32,Tie
171,Randy,216,221,437,24,29,Randy
172,Randy,235,235,470,27,19,Tie
173,Randy,220,220,440,21,27,Tie
174,Randy,209,209,418,20,34,Tie
175,Randy,234,229,463,29,22,Player A
176,Randy,230,235,465,31,22,Randy
177,Randy,226,221,447,28,27,Player A
178,Randy,242,242,484,35,17,Tie
179,Randy,234,239,473,30,19,Randy
180,Randy,211,211,422,12,30,Tie
181,Randy,208,203,411,13,34,Player A
182,Randy,231,231,462,25,21,Tie
183,Randy,218,223,441,19,26,Randy
184,Randy,226,226,452,33,27,Tie
185,Randy,233,228,461,24,21,Player A
186,Randy,223,223,446,21,25,Tie
187,Randy,226,231,457,26,23,Randy
188,Randy,229,229,458,30,24,Tie
189,Randy,229,224,453,22,23,Player A
190,Randy,231,231,462,25,21,Tie
191,Randy,220,225,445,26,27,Randy
192,Randy,214,214,428,18,30,Tie
193,Randy,223,218,441,19,26,Player A
194,Randy,239,239,478,29,17,Tie
195,Randy,229,229,458,24,22,Tie
196,Randy,198,198,396,10,38,Tie
197,Randy,223,223,446,24,26,Tie
198,Randy,230,230,460,26,22,Tie
199,Randy,221,221,442,20,26,Tie
200,Randy,221,226,447,22,25,Randy
201,Randy,247,242,489,34,15,Player A
202,Randy,229,229,458,27,23,Tie
203,Randy,227,227,454,26,24,Tie
204,Randy,213,213,426,28,34,Tie
205,Randy,249,249,498,40,14,Tie
206,Randy,212,217,429,19,30,Randy
207,Randy,212,207,419,21,34,Player A
208,Randy,220,225,445,23,26,Randy
209,Randy,242,242,484,29,15,Tie
210,Randy,215,210,425,24,33,Player A
211,Randy,221,226,447,19,24,Randy
212,Randy,227,222,449,27,26,Player A
213,Randy,232,232,464,27,21,Tie
214,Randy,242,247,489,37,16,Randy
215,Randy,211,211,422,15,31,Tie
216,Randy,221,216,437,21,28,Player A
217,Randy,226,226,452,21,23,Tie
218,Randy,230,235,465,25,20,Randy
219,Randy,228,223,451,23,24,Player A
220,Randy,235,240,475,29,18,Randy
221,Randy,238,233,471,28,19,Player A
222,Randy,234,234,468,31,21,Tie
223,Randy,223,228,451,26,25,Randy
224,Randy,222,217,439,17,26,Player A
225,Randy,248,253,501,43,14,Randy
226,Randy,229,229,458,24,22,Tie
227,Randy,203,203,406,14,36,Tie
228,Randy,230,230,460,20,20,Tie
229,Randy,208,208,416,15,33,Tie
230,Randy,232,227,459,19,20,Player A
231,Randy,224,224,448,23,25,Tie
232,Randy,218,223,441,22,27,Randy
233,Randy,219,219,438,22,28,Tie
234,Randy,210,210,420,13,31,Tie
235,Randy,229,224,453,22,23,Player A
236,Randy,223,228,451,26,25,Randy
237,Randy,228,223,451,26,25,Player A
238,Randy,225,230,455,27,24,Randy
239,Randy,231,231,462,28,22,Tie
240,Randy,223,218,441,22,27,Player A
241,Randy,222,222,444,28,28,Tie
242,Randy,233,238,471,31,20,Randy
243,Randy,236,231,467,33,22,Player A
244,Randy,219,219,438,22,28,Tie
245,Randy,233,233,466,29,21,Tie
246,Randy,218,218,436,23,29,Tie
247,Randy,229,234,463,29,22,Randy
248,Randy,227,222,449,21,24,Player A
249,Randy,222,222,444,25,27,Tie
250,Randy,219,219,438,25,29,Tie
251,Randy,205,210,415,14,33,Randy
252,Randy,221,221,442,29,29,Tie
253,Randy,224,219,443,24,27,Player A
254,Randy,223,223,446,21,25,Tie
255,Randy,221,221,442,35,31,Tie
256,Randy,226,226,452,21,23,Tie
257,Randy,229,234,463,29,22,Randy
258,Randy,237,232,469,35,22,Player A
259,Randy,244,249,493,29,12,Randy
260,Randy,219,214,433,23,30,Player A
261,Randy,245,250,495,37,14,Randy
262,Randy,207,207,414,22,36,Tie
263,Randy,228,223,451,29,26,Player A
264,Randy,237,242,479,30,17,Randy
265,Randy,223,223,446,24,26,Tie
266,Randy,207,202,409,20,37,Player A
267,Randy,214,219,433,17,28,Randy
268,Randy,234,234,468,28,20,Tie
269,Randy,226,221,447,22,25,Player A
270,Randy,210,215,425,21,32,Randy
271,Randy,228,223,451,20,23,Player A
272,Randy,226,231,457,23,22,Randy
273,Randy,230,230,460,23,21,Tie
274,Randy,222,217,439,29,30,Player A
275,Randy,230,235,465,28,21,Randy
276,Randy,222,217,439,20,27,Player A
277,Randy,209,214,423,25,34,Randy
278,Randy,221,221,442,32,30,Tie
279,Randy,237,232,469,29,20,Player A
280,Randy,223,228,451,20,23,Randy
281,Randy,238,233,471,31,20,Player A
282,Randy,211,216,427,20,31,Randy
283,Randy,229,224,453,28,25,Player A
284,Randy,203,208,411,13,34,Randy
285,Randy,227,222,449,18,23,Player A
286,Randy,231,231,462,25,21,Tie
287,Randy,207,212,419,18,33,Randy
288,Randy,238,233,471,34,21,Player A
289,Randy,220,225,445,23,26,Randy
290,Randy,227,227,454,32,26,Tie
291,Randy,238,238,476,33,19,Tie
292,Randy,205,205,410,21,37,Tie
293,Randy,200,200,400,17,39,Tie
294,Randy,242,242,484,32,16,Tie
295,Randy,232,232,464,36,24,Tie
296,Randy,217,212,429,22,31,Player A
297,Randy,223,228,451,26,25,Randy
298,Randy,217,217,434,21,29,Tie
299,Randy,222,222,444,19,25,Tie
300,Randy,215,215,430,23,31,Tie
301,Randy,234,234,468,31,21,Tie
302,Randy,229,229,458,27,23,Tie
303,Randy,231,226,457,32,25,Player A
304,Randy,226,231,457,32,25,Randy
305,Randy,223,223,446,21,25,Tie
306,Randy,223,223,446,21,25,Tie
307,Randy,209,209,418,14,32,Tie
308,Randy,208,203,411,19,36,Player A
309,Randy,223,228,451,26,25,Randy
310,Randy,230,230,460,20,20,Tie
311,Randy,243,238,481,35,18,Player A
312,Randy,236,236,472,29,19,Tie
313,Randy,233,238,471,34,21,Randy
314,Randy,228,228,456,25,23,Tie
315,Randy,209,204,413,24,37,Player A
316,Randy,218,223,441,28,29,Randy
317,Randy,230,225,455,24,23,Player A
318,Randy,224,229,453,16,21,Randy
319,Randy,226,221,447,28,27,Player A
320,Randy,228,233,461,24,21,Randy
321,Randy,231,231,462,31,23,Tie
322,Randy,227,227,454,23,23,Tie
323,Randy,216,211,427,23,32,Player A
324,Randy,212,217,429,19,30,Randy
325,Randy,219,219,438,19,27,Tie
326,Randy,225,225,450,25,25,Tie
327,Randy,238,233,471,25,18,Player A
328,Randy,247,247,494,39,15,Tie
329,Randy,210,210,420,13,31,Tie
330,Randy,227,232,459,25,22,Randy
331,Randy,251,246,497,33,12,Player A
332,Randy,209,209,418,17,33,Tie
333,Randy,214,219,433,23,30,Randy
334,Randy,240,235,475,29,18,Player A
335,Randy,239,239,478,35,19,Tie
336,Randy,227,232,459,28,23,Randy
337,Randy,227,227,454,26,24,Tie
338,Randy,217,212,429,16,29,Player A
339,Randy,217,217,434,21,29,Tie
340,Randy,214,214,428,21,31,Tie
341,Randy,218,223,441,22,27,Randy
342,Randy,236,236,472,32,20,Tie
343,Randy,230,225,455,21,22,Player A
344,Randy,234,239,473,24,17,Randy
345,Randy,212,207,419,15,32,Player A
346,Randy,227,227,454,20,22,Tie
347,Randy,238,243,481,32,17,Randy
348,Randy,213,213,426,25,33,Tie
349,Randy,227,222,449,30,27,Player A
350,Randy,213,218,431,24,31,Randy
351,Randy,245,240,485,33,16,Player A
352,Randy,222,227,449,24,25,Randy
353,Randy,236,231,467,24,19,Player A
354,Randy,234,239,473,24,17,Randy
355,Randy,237,237,474,34,20,Tie
356,Randy,228,228,456,28,24,Tie
357,Randy,227,222,449,21,24,Player A
358,Randy,222,222,444,25,27,Tie
359,Randy,238,243,481,29,16,Randy
360,Randy,224,224,448,20,24,Tie
361,Randy,213,208,421,23,34,Player A
362,Randy,218,218,436,23,29,Tie
363,Randy,222,227,449,24,25,Randy
364,Randy,228,228,456,25,23,Tie
365,Randy,209,209,418,20,34,Tie
366,Randy,229,224,453,28,25,Player A
367,Randy,226,231,457,29,24,Randy
368,Randy,226,221,447,34,29,Player A
369,Randy,213,218,431,24,31,Randy
370,Randy,222,217,439,23,28,Player A
371,Randy,221,226,447,19,24,Randy
372,Randy,222,217,439,26,29,Player A
373,Randy,233,233,466,32,22,Tie
374,Randy,234,234,468,28,20,Tie
375,Randy,224,229,453,34,27,Randy
376,Randy,237,237,474,31,19,Tie
377,Randy,220,220,440,30,30,Tie
378,Randy,230,225,455,24,23,Player A
379,Randy,232,232,464,27,21,Tie
380,Randy,207,212,419,18,33,Randy
381,Randy,232,227,459,31,24,Player A
382,Randy,220,220,440,24,28,Tie
383,Randy,241,241,482,33,17,Tie
384,Randy,236,236,472,32,20,Tie
385,Randy,228,233,461,27,22,Randy
386,Randy,238,233,471,31,20,Player A
387,Randy,236,236,472,29,19,Tie
388,Randy,222,227,449,27,26,Randy
389,Randy,230,230,460,26,22,Tie
390,Randy,207,207,414,16,34,Tie
391,Randy,197,192,389,18,43,Player A
392,Randy,211,216,427,17,30,Randy
393,Randy,232,227,459,28,23,Player A
394,Randy,226,231,457,29,24,Randy
395,Randy,220,215,435,19,28,Player A
396,Randy,214,214,428,21,31,Tie
397,Randy,227,227,454,29,25,Tie
398,Randy,223,223,446,24,26,Tie
399,Randy,239,239,478,32,18,Tie
400,Randy,228,233,461,24,21,Randy
401,Randy,235,230,465,28,21,Player A
402,Randy,226,231,457,23,22,Randy
403,Randy,232,232,464,27,21,Tie
404,Randy,234,229,463,20,19,Player A
405,Randy,234,239,473,27,18,Randy
406,Randy,208,208,416,21,35,Tie
407,Randy,237,232,469,29,20,Player A
408,Randy,228,233,461,33,24,Randy
409,Randy,214,209,423,19,32,Player A
410,Randy,219,224,443,21,26,Randy
411,Randy,229,224,453,25,24,Player A
412,Randy,247,252,499,32,11,Randy
413,Randy,227,222,449,30,27,Player A
414,Randy,217,222,439,29,30,Randy
415,Randy,241,236,477,31,18,Player A
416,Randy,217,217,434,21,29,Tie
417,Randy,232,232,464,30,22,Tie
418,Randy,204,209,413,15,34,Randy
419,Randy,241,241,482,33,17,Tie
420,Randy,227,227,454,17,21,Tie
421,Randy,224,224,448,26,26,Tie
422,Randy,243,238,481,38,19,Player A
423,Randy,217,217,434,15,27,Tie
424,Randy,253,253,506,42,12,Tie
425,Randy,219,224,443,24,27,Randy
426,Randy,230,225,455,21,22,Player A
427,Randy,220,220,440,24,28,Tie
428,Randy,221,226,447,25,26,Randy
429,Randy,225,220,445,26,27,Player A
430,Randy,225,230,455,27,24,Randy
431,Randy,228,228,456,28,24,Tie
432,Randy,220,215,435,19,28,Player A
433,Randy,231,236,467,30,21,Randy
434,Randy,227,227,454,26,24,Tie
435,Randy,218,213,431,27,32,Player A
436,Randy,223,223,446,24,26,Tie
437,Randy,231,231,462,25,21,Tie
438,Randy,226,231,457,23,22,Randy
439,Randy,221,216,437,21,28,Player A
440,Randy,217,217,434,27,31,Tie
441,Randy,227,232,459,28,23,Randy
442,Randy,235,230,465,25,20,Player A
443,Randy,222,227,449,27,26,Randy
444,Randy,227,222,449,18,23,Player A
445,Randy,230,235,465,31,22,Randy
446,Randy,232,227,459,25,22,Player A
447,Randy,229,229,458,30,24,Tie
448,Randy,238,243,481,32,17,Randy
449,Randy,226,226,452,27,25,Tie
450,Randy,199,199,398,15,39,Tie
