Game,Opponent,PlayerA_Score,PlayerB_Score,Cumulative_Score,CCs,DDs,Winner
0,QLearningPlayer,315,50,365,0,45,Player A
1,QLearningPlayer,335,45,380,0,40,Player A
2,QLearningPlayer,292,67,359,3,48,Player A
3,QLearningPlayer,271,61,332,0,56,Player A
4,QLearningPlayer,325,70,395,6,37,Player A
5,QLearningPlayer,315,50,365,0,45,Player A
6,QLearningPlayer,291,56,347,0,51,Player A
7,QLearningPlayer,300,60,360,1,47,Player A
8,QLearningPlayer,258,68,326,0,58,Player A
9,QLearningPlayer,302,82,384,7,41,Player A
10,QLearningPlayer,303,53,356,0,48,Player A
11,QLearningPlayer,270,140,410,18,36,Player A
12,QLearningPlayer,307,52,359,0,47,Player A
13,QLearningPlayer,311,51,362,0,46,Player A
14,QLearningPlayer,307,67,374,3,43,Player A
15,QLearningPlayer,278,63,341,0,53,Player A
16,QLearningPlayer,266,71,337,2,55,Player A
17,QLearningPlayer,319,49,368,0,44,Player A
18,QLearningPlayer,258,83,341,3,54,Player A
19,QLearningPlayer,316,56,372,1,43,Player A
20,QLearningPlayer,267,62,329,0,57,Player A
21,QLearningPlayer,299,54,353,0,49,Player A
22,QLearningPlayer,260,90,350,6,52,Player A
23,QLearningPlayer,264,69,333,1,56,Player A
24,QLearningPlayer,289,69,358,2,48,Player A
25,QLearningPlayer,323,48,371,0,43,Player A
26,QLearningPlayer,291,56,347,0,51,Player A
27,QLearningPlayer,274,64,338,0,54,Player A
28,QLearningPlayer,339,44,383,0,39,Player A
29,QLearningPlayer,307,52,359,0,47,Player A
30,QLearningPlayer,287,57,344,0,52,Player A
31,QLearningPlayer,298,63,361,2,47,Player A
32,QLearningPlayer,295,55,350,0,50,Player A
33,QLearningPlayer,270,140,410,18,36,Player A
34,QLearningPlayer,268,83,351,4,51,Player A
35,QLearningPlayer,297,57,354,1,49,Player A
36,QLearningPlayer,244,89,333,4,57,Player A
37,QLearningPlayer,299,54,353,0,49,Player A
38,QLearningPlayer,295,55,350,0,50,Player A
39,QLearningPlayer,295,65,360,1,47,Player A
40,QLearningPlayer,302,102,404,12,36,Player A
41,QLearningPlayer,323,68,391,2,37,Player A
42,QLearningPlayer,306,61,367,2,45,Player A
43,QLearningPlayer,271,61,332,0,56,Player A
44,QLearningPlayer,276,86,362,6,48,Player A
45,QLearningPlayer,302,67,369,4,45,Player A
46,QLearningPlayer,290,60,350,0,50,Player A
47,QLearningPlayer,287,57,344,0,52,Player A
48,QLearningPlayer,262,67,329,0,57,Player A
49,QLearningPlayer,314,49,363,1,46,Player A
50,QLearningPlayer,249,74,323,0,59,Player A
51,QLearningPlayer,291,56,347,0,51,Player A
52,QLearningPlayer,295,55,350,0,50,Player A
53,QLearningPlayer,284,64,348,1,51,Player A
54,QLearningPlayer,279,59,338,0,54,Player A
55,QLearningPlayer,274,79,353,3,50,Player A
56,QLearningPlayer,257,77,334,2,56,Player A
57,QLearningPlayer,286,66,352,2,50,Player A
58,QLearningPlayer,307,52,359,0,47,Player A
59,QLearningPlayer,287,67,354,1,49,Player A
60,QLearningPlayer,307,52,359,0,47,Player A
61,QLearningPlayer,320,60,380,3,41,Player A
62,QLearningPlayer,249,109,358,8,50,Player A
63,QLearningPlayer,283,58,341,0,53,Player A
64,QLearningPlayer,217,212,429,31,34,Player A
65,QLearningPlayer,315,50,365,0,45,Player A
66,QLearningPlayer,295,55,350,0,50,Player A
67,QLearningPlayer,273,73,346,2,52,Player A
68,QLearningPlayer,317,52,369,1,44,Player A
69,QLearningPlayer,290,70,360,4,48,Player A
70,QLearningPlayer,303,53,356,0,48,Player A
71,QLearningPlayer,280,65,345,1,52,Player A
72,QLearningPlayer,260,70,330,1,57,Player A
73,QLearningPlayer,278,83,361,5,48,Player A
74,QLearningPlayer,282,92,374,6,44,Player A
75,QLearningPlayer,290,70,360,4,48,Player A
76,QLearningPlayer,308,58,366,1,45,Player A
77,QLearningPlayer,319,49,368,0,44,Player A
78,QLearningPlayer,299,54,353,0,49,Player A
79,QLearningPlayer,315,65,380,3,41,Player A
80,QLearningPlayer,313,53,366,1,45,Player A
81,QLearningPlayer,263,73,336,1,55,Player A
82,QLearningPlayer,333,48,381,1,40,Player A
83,QLearningPlayer,282,67,349,2,51,Player A
84,QLearningPlayer,301,56,357,1,48,Player A
85,QLearningPlayer,318,53,371,0,43,Player A
86,QLearningPlayer,287,57,344,0,52,Player A
87,QLearningPlayer,303,53,356,0,48,Player A
88,QLearningPlayer,307,52,359,0,47,Player A
89,QLearningPlayer,303,53,356,0,48,Player A
90,QLearningPlayer,307,52,359,0,47,Player A
91,QLearningPlayer,291,56,347,0,51,Player A
92,QLearningPlayer,295,60,355,2,49,Player A
93,QLearningPlayer,275,70,345,1,52,Player A
94,QLearningPlayer,278,83,361,5,48,Player A
95,QLearningPlayer,302,67,369,4,45,Player A
96,QLearningPlayer,293,63,356,3,49,Player A
97,QLearningPlayer,301,66,367,2,45,Player A
98,QLearningPlayer,294,69,363,4,47,Player A
99,QLearningPlayer,270,85,355,5,50,Player A
100,QLearningPlayer,279,59,338,0,54,Player A
101,QLearningPlayer,332,42,374,0,42,Player A
102,QLearningPlayer,295,55,350,0,50,Player A
103,QLearningPlayer,295,55,350,0,50,Player A
104,QLearningPlayer,253,138,391,17,42,Player A
105,QLearningPlayer,279,59,338,0,54,Player A
106,QLearningPlayer,296,61,357,1,48,Player A
107,QLearningPlayer,257,82,339,4,55,Player A
108,QLearningPlayer,284,64,348,1,51,Player A
109,QLearningPlayer,299,54,353,0,49,Player A
110,QLearningPlayer,310,85,395,9,38,Player A
111,QLearningPlayer,283,58,341,0,53,Player A
112,QLearningPlayer,279,59,338,0,54,Player A
113,QLearningPlayer,291,56,347,0,51,Player A
114,QLearningPlayer,303,53,356,0,48,Player A
115,QLearningPlayer,314,64,378,4,42,Player A
116,QLearningPlayer,295,55,350,0,50,Player A
117,QLearningPlayer,311,51,362,0,46,Player A
118,QLearningPlayer,287,57,344,0,52,Player A
119,QLearningPlayer,315,50,365,0,45,Player A
120,QLearningPlayer,291,56,347,0,51,Player A
121,QLearningPlayer,318,63,381,4,41,Player A
122,QLearningPlayer,339,44,383,0,39,Player A
123,QLearningPlayer,276,66,342,1,53,Player A
124,QLearningPlayer,307,52,359,0,47,Player A
125,QLearningPlayer,259,84,343,5,54,Player A
126,QLearningPlayer,306,61,367,2,45,Player A
127,QLearningPlayer,304,69,373,5,44,Player A
128,QLearningPlayer,295,55,350,0,50,Player A
129,QLearningPlayer,303,53,356,0,48,Player A
130,QLearningPlayer,282,107,389,12,41,Player A
131,QLearningPlayer,307,52,359,0,47,Player A
132,QLearningPlayer,327,47,374,0,42,Player A
133,QLearningPlayer,319,49,368,0,44,Player A
134,QLearningPlayer,276,66,342,1,53,Player A
135,QLearningPlayer,290,65,355,2,49,Player A
136,QLearningPlayer,331,46,377,0,41,Player A
137,QLearningPlayer,323,48,371,0,43,Player A
138,QLearningPlayer,248,128,376,8,44,Player A
139,QLearningPlayer,295,55,350,0,50,Player A
140,QLearningPlayer,279,59,338,0,54,Player A
141,QLearningPlayer,251,81,332,3,57,Player A
142,QLearningPlayer,311,51,362,0,46,Player A
143,QLearningPlayer,309,59,368,3,45,Player A
144,QLearningPlayer,294,59,353,0,49,Player A
145,QLearningPlayer,295,55,350,0,50,Player A
146,QLearningPlayer,288,73,361,5,48,Player A
147,QLearningPlayer,286,76,362,3,47,Player A
148,QLearningPlayer,273,63,336,1,55,Player A
149,QLearningPlayer,300,65,365,3,46,Player A
150,QLearningPlayer,291,56,347,0,51,Player A
151,QLearningPlayer,291,56,347,0,51,Player A
152,QLearningPlayer,308,48,356,0,48,Player A
153,QLearningPlayer,300,80,380,6,42,Player A
154,QLearningPlayer,288,68,356,3,49,Player A
155,QLearningPlayer,319,49,368,0,44,Player A
156,QLearningPlayer,302,62,364,2,46,Player A
157,QLearningPlayer,299,54,353,0,49,Player A
158,QLearningPlayer,304,64,368,3,45,Player A
159,QLearningPlayer,293,83,376,8,44,Player A
160,QLearningPlayer,222,97,319,2,61,Player A
161,QLearningPlayer,314,64,378,4,42,Player A
162,QLearningPlayer,303,53,356,0,48,Player A
163,QLearningPlayer,233,133,366,13,49,Player A
164,QLearningPlayer,292,62,354,1,49,Player A
165,QLearningPlayer,293,78,371,6,45,Player A
166,QLearningPlayer,295,55,350,0,50,Player A
167,QLearningPlayer,292,67,359,3,48,Player A
168,QLearningPlayer,295,55,350,0,50,Player A
169,QLearningPlayer,294,64,358,2,48,Player A
170,QLearningPlayer,283,58,341,0,53,Player A
171,QLearningPlayer,283,58,341,0,53,Player A
172,QLearningPlayer,280,65,345,1,52,Player A
173,QLearningPlayer,279,59,338,0,54,Player A
174,QLearningPlayer,290,70,360,4,48,Player A
175,QLearningPlayer,286,66,352,2,50,Player A
176,QLearningPlayer,293,68,361,2,47,Player A
177,QLearningPlayer,320,55,375,1,42,Player A
178,QLearningPlayer,304,64,368,3,45,Player A
179,QLearningPlayer,323,48,371,0,43,Player A
180,QLearningPlayer,298,73,371,6,45,Player A
181,QLearningPlayer,311,66,377,3,42,Player A
182,QLearningPlayer,325,50,375,1,42,Player A
183,QLearningPlayer,297,72,369,4,45,Player A
184,QLearningPlayer,287,57,344,0,52,Player A
185,QLearningPlayer,295,55,350,0,50,Player A
186,QLearningPlayer,309,54,363,1,46,Player A
187,QLearningPlayer,294,59,353,0,49,Player A
188,QLearningPlayer,307,52,359,0,47,Player A
189,QLearningPlayer,288,63,351,1,50,Player A
190,QLearningPlayer,303,53,356,0,48,Player A
191,QLearningPlayer,347,42,389,0,37,Player A
192,QLearningPlayer,255,65,320,0,60,Player A
193,QLearningPlayer,295,55,350,0,50,Player A
194,QLearningPlayer,267,62,329,0,57,Player A
195,QLearningPlayer,299,89,388,8,40,Player A
196,QLearningPlayer,284,109,393,10,39,Player A
197,QLearningPlayer,281,66,347,0,51,Player A
198,QLearningPlayer,260,75,335,3,56,Player A
199,QLearningPlayer,283,68,351,1,50,Player A
200,QLearningPlayer,292,62,354,4,50,Player A
201,QLearningPlayer,317,82,399,4,35,Player A
202,QLearningPlayer,266,66,332,0,56,Player A
203,QLearningPlayer,296,51,347,0,51,Player A
204,QLearningPlayer,268,108,376,11,45,Player A
205,QLearningPlayer,291,56,347,0,51,Player A
206,QLearningPlayer,311,51,362,0,46,Player A
207,QLearningPlayer,319,49,368,0,44,Player A
208,QLearningPlayer,315,50,365,0,45,Player A
209,QLearningPlayer,287,57,344,0,52,Player A
210,QLearningPlayer,285,75,360,4,48,Player A
211,QLearningPlayer,278,78,356,3,49,Player A
212,QLearningPlayer,281,106,387,10,41,Player A
213,QLearningPlayer,283,58,341,0,53,Player A
214,QLearningPlayer,279,59,338,0,54,Player A
215,QLearningPlayer,287,57,344,0,52,Player A
216,QLearningPlayer,313,68,381,4,41,Player A
217,QLearningPlayer,343,43,386,0,38,Player A
218,QLearningPlayer,262,67,329,0,57,Player A
219,QLearningPlayer,283,93,376,5,43,Player A
220,QLearningPlayer,281,71,352,2,50,Player A
221,QLearningPlayer,267,82,349,5,52,Player A
222,QLearningPlayer,286,61,347,0,51,Player A
223,QLearningPlayer,275,60,335,0,55,Player A
224,QLearningPlayer,290,80,370,5,45,Player A
225,QLearningPlayer,300,60,360,1,47,Player A
226,QLearningPlayer,281,81,362,6,48,Player A
227,QLearningPlayer,294,79,373,5,44,Player A
228,QLearningPlayer,275,60,335,0,55,Player A
229,QLearningPlayer,302,62,364,2,46,Player A
230,QLearningPlayer,287,57,344,0,52,Player A
231,QLearningPlayer,303,53,356,0,48,Player A
232,QLearningPlayer,311,51,362,0,46,Player A
233,QLearningPlayer,289,69,358,5,49,Player A
234,QLearningPlayer,303,68,371,3,44,Player A
235,QLearningPlayer,308,73,381,7,42,Player A
236,QLearningPlayer,292,87,379,8,43,Player A
237,QLearningPlayer,300,60,360,1,47,Player A
238,QLearningPlayer,318,53,371,0,43,Player A
239,QLearningPlayer,288,73,361,5,48,Player A
240,QLearningPlayer,311,51,362,0,46,Player A
241,QLearningPlayer,275,60,335,0,55,Player A
242,QLearningPlayer,319,49,368,0,44,Player A
243,QLearningPlayer,289,64,353,3,50,Player A
244,QLearningPlayer,294,69,363,1,46,Player A
245,QLearningPlayer,256,76,332,6,58,Player A
246,QLearningPlayer,292,72,364,2,46,Player A
247,QLearningPlayer,319,49,368,0,44,Player A
248,QLearningPlayer,307,52,359,0,47,Player A
249,QLearningPlayer,297,57,354,1,49,Player A
250,QLearningPlayer,302,57,359,0,47,Player A
251,QLearningPlayer,315,50,365,0,45,Player A
252,QLearningPlayer,303,53,356,0,48,Player A
253,QLearningPlayer,319,49,368,0,44,Player A
254,QLearningPlayer,300,50,350,0,50,Player A
255,QLearningPlayer,300,60,360,1,47,Player A
256,QLearningPlayer,290,110,400,8,36,Player A
257,QLearningPlayer,291,56,347,0,51,Player A
258,QLearningPlayer,287,57,344,0,52,Player A
259,QLearningPlayer,279,59,338,0,54,Player A
260,QLearningPlayer,264,69,333,1,56,Player A
261,QLearningPlayer,329,49,378,1,41,Player A
262,QLearningPlayer,282,117,399,13,38,Player A
263,QLearningPlayer,295,55,350,0,50,Player A
264,QLearningPlayer,331,46,377,0,41,Player A
265,QLearningPlayer,300,60,360,1,47,Player A
266,QLearningPlayer,307,52,359,0,47,Player A
267,QLearningPlayer,283,58,341,0,53,Player A
268,QLearningPlayer,268,108,376,8,44,Player A
269,QLearningPlayer,267,82,349,2,51,Player A
270,QLearningPlayer,319,49,368,0,44,Player A
271,QLearningPlayer,310,60,370,2,44,Player A
272,QLearningPlayer,277,72,349,2,51,Player A
273,QLearningPlayer,279,59,338,0,54,Player A
274,QLearningPlayer,315,50,365,0,45,Player A
275,QLearningPlayer,278,68,346,2,52,Player A
276,QLearningPlayer,278,63,341,0,53,Player A
277,QLearningPlayer,308,58,366,1,45,Player A
278,QLearningPlayer,267,62,329,0,57,Player A
279,QLearningPlayer,295,55,350,0,50,Player A
280,QLearningPlayer,323,53,376,2,42,Player A
281,QLearningPlayer,252,107,359,12,51,Player A
282,QLearningPlayer,256,71,327,1,58,Player A
283,QLearningPlayer,312,57,369,1,44,Player A
284,QLearningPlayer,279,114,393,13,40,Player A
285,QLearningPlayer,312,57,369,1,44,Player A
286,QLearningPlayer,305,65,370,5,45,Player A
287,QLearningPlayer,297,67,364,2,46,Player A
288,QLearningPlayer,305,55,360,1,47,Player A
289,QLearningPlayer,263,73,336,1,55,Player A
290,QLearningPlayer,280,70,350,3,51,Player A
291,QLearningPlayer,327,47,374,0,42,Player A
292,QLearningPlayer,311,51,362,0,46,Player A
293,QLearningPlayer,299,54,353,0,49,Player A
294,QLearningPlayer,322,72,394,5,37,Player A
295,QLearningPlayer,299,54,353,0,49,Player A
296,QLearningPlayer,284,64,348,1,51,Player A
297,QLearningPlayer,273,73,346,5,53,Player A
298,QLearningPlayer,303,78,381,7,42,Player A
299,QLearningPlayer,294,59,353,0,49,Player A
300,QLearningPlayer,298,53,351,1,50,Player A
301,QLearningPlayer,278,83,361,5,48,Player A
302,QLearningPlayer,311,56,367,2,45,Player A
303,QLearningPlayer,284,64,348,1,51,Player A
304,QLearningPlayer,283,58,341,0,53,Player A
305,QLearningPlayer,288,53,341,0,53,Player A
306,QLearningPlayer,303,53,356,0,48,Player A
307,QLearningPlayer,299,54,353,0,49,Player A
308,QLearningPlayer,265,120,385,11,42,Player A
309,QLearningPlayer,302,72,374,6,44,Player A
310,QLearningPlayer,297,72,369,4,45,Player A
311,QLearningPlayer,311,51,362,0,46,Player A
312,QLearningPlayer,271,76,347,3,52,Player A
313,QLearningPlayer,295,70,365,3,46,Player A
314,QLearningPlayer,307,52,359,0,47,Player A
315,QLearningPlayer,271,61,332,0,56,Player A
316,QLearningPlayer,317,62,379,2,41,Player A
317,QLearningPlayer,304,59,363,1,46,Player A
318,QLearningPlayer,260,125,385,14,43,Player A
319,QLearningPlayer,283,58,341,0,53,Player A
320,QLearningPlayer,327,47,374,0,42,Player A
321,QLearningPlayer,343,43,386,0,38,Player A
322,QLearningPlayer,250,70,320,0,60,Player A
323,QLearningPlayer,295,55,350,0,50,Player A
324,QLearningPlayer,307,52,359,0,47,Player A
325,QLearningPlayer,317,57,374,3,43,Player A
326,QLearningPlayer,283,78,361,5,48,Player A
327,QLearningPlayer,238,88,326,3,59,Player A
328,QLearningPlayer,322,57,379,2,41,Player A
329,QLearningPlayer,307,52,359,0,47,Player A
330,QLearningPlayer,319,54,373,2,43,Player A
331,QLearningPlayer,303,63,366,1,45,Player A
332,QLearningPlayer,315,50,365,0,45,Player A
333,QLearningPlayer,254,84,338,3,55,Player A
334,QLearningPlayer,267,62,329,0,57,Player A
335,QLearningPlayer,307,72,379,5,42,Player A
336,QLearningPlayer,262,82,344,3,53,Player A
337,QLearningPlayer,310,65,375,4,43,Player A
338,QLearningPlayer,296,66,362,3,47,Player A
339,QLearningPlayer,299,54,353,0,49,Player A
340,QLearningPlayer,286,76,362,6,48,Player A
341,QLearningPlayer,308,58,366,1,45,Player A
342,QLearningPlayer,307,52,359,0,47,Player A
343,QLearningPlayer,339,44,383,0,39,Player A
344,QLearningPlayer,315,50,365,0,45,Player A
345,QLearningPlayer,321,51,372,1,43,Player A
346,QLearningPlayer,304,59,363,1,46,Player A
347,QLearningPlayer,284,84,368,6,46,Player A
348,QLearningPlayer,317,52,369,1,44,Player A
349,QLearningPlayer,300,60,360,1,47,Player A
350,QLearningPlayer,291,66,357,4,49,Player A
351,QLearningPlayer,278,73,351,4,51,Player A
352,QLearningPlayer,287,67,354,1,49,Player A
353,QLearningPlayer,327,47,374,0,42,Player A
354,QLearningPlayer,311,51,362,0,46,Player A
355,QLearningPlayer,326,46,372,1,43,Player A
356,QLearningPlayer,290,85,375,7,44,Player A
357,QLearningPlayer,319,49,368,0,44,Player A
358,QLearningPlayer,306,61,367,2,45,Player A
359,QLearningPlayer,272,67,339,1,54,Player A
360,QLearningPlayer,269,74,343,2,53,Player A
361,QLearningPlayer,319,49,368,0,44,Player A
362,QLearningPlayer,295,55,350,0,50,Player A
363,QLearningPlayer,337,57,394,2,36,Player A
364,QLearningPlayer,310,80,390,10,40,Player A
365,QLearningPlayer,269,94,363,7,48,Player A
366,QLearningPlayer,291,56,347,0,51,Player A
367,QLearningPlayer,275,60,335,0,55,Player A
368,QLearningPlayer,295,55,350,0,50,Player A
369,QLearningPlayer,283,58,341,0,53,Player A
370,QLearningPlayer,278,63,341,0,53,Player A
371,QLearningPlayer,291,91,382,8,42,Player A
372,QLearningPlayer,299,79,378,7,43,Player A
373,QLearningPlayer,276,66,342,1,53,Player A
374,QLearningPlayer,325,50,375,1,42,Player A
375,QLearningPlayer,283,78,361,5,48,Player A
376,QLearningPlayer,287,72,359,3,48,Player A
377,QLearningPlayer,240,95,335,6,57,Player A
378,QLearningPlayer,305,75,380,6,42,Player A
379,QLearningPlayer,292,82,374,6,44,Player A
380,QLearningPlayer,271,76,347,3,52,Player A
381,QLearningPlayer,282,67,349,2,51,Player A
382,QLearningPlayer,314,59,373,2,43,Player A
383,QLearningPlayer,339,44,383,0,39,Player A
384,QLearningPlayer,258,93,351,7,52,Player A
385,QLearningPlayer,270,65,335,0,55,Player A
386,QLearningPlayer,307,52,359,0,47,Player A
387,QLearningPlayer,313,53,366,1,45,Player A
388,QLearningPlayer,262,162,424,20,32,Player A
389,QLearningPlayer,284,119,403,11,36,Player A
390,QLearningPlayer,267,72,339,1,54,Player A
391,QLearningPlayer,272,67,339,1,54,Player A
392,QLearningPlayer,303,53,356,0,48,Player A
393,QLearningPlayer,291,56,347,0,51,Player A
394,QLearningPlayer,284,74,358,2,48,Player A
395,QLearningPlayer,275,85,360,4,48,Player A
396,QLearningPlayer,291,56,347,0,51,Player A
397,QLearningPlayer,290,85,375,7,44,Player A
398,QLearningPlayer,269,144,413,15,34,Player A
399,QLearningPlayer,313,53,366,1,45,Player A
400,QLearningPlayer,284,64,348,1,51,Player A
401,QLearningPlayer,264,89,353,6,51,Player A
402,QLearningPlayer,298,63,361,2,47,Player A
403,QLearningPlayer,289,59,348,1,51,Player A
404,QLearningPlayer,303,68,371,3,44,Player A
405,QLearningPlayer,271,61,332,0,56,Player A
406,QLearningPlayer,292,82,374,3,43,Player A
407,QLearningPlayer,332,42,374,0,42,Player A
408,QLearningPlayer,234,89,323,3,60,Player A
409,QLearningPlayer,253,78,331,2,57,Player A
410,QLearningPlayer,339,44,383,0,39,Player A
411,QLearningPlayer,319,49,368,0,44,Player A
412,QLearningPlayer,292,62,354,1,49,Player A
413,QLearningPlayer,275,75,350,3,51,Player A
414,QLearningPlayer,286,66,352,2,50,Player A
415,QLearningPlayer,289,79,368,6,46,Player A
416,QLearningPlayer,271,61,332,0,56,Player A
417,QLearningPlayer,316,66,382,5,41,Player A
418,QLearningPlayer,323,48,371,0,43,Player A
419,QLearningPlayer,274,64,338,0,54,Player A
420,QLearningPlayer,303,53,356,0,48,Player A
421,QLearningPlayer,298,68,366,4,46,Player A
422,QLearningPlayer,318,53,371,0,43,Player A
423,QLearningPlayer,307,52,359,0,47,Player A
424,QLearningPlayer,286,71,357,4,49,Player A
425,QLearningPlayer,315,75,390,4,38,Player A
426,QLearningPlayer,290,65,355,2,49,Player A
427,QLearningPlayer,303,53,356,0,48,Player A
428,QLearningPlayer,275,60,335,0,55,Player A
429,QLearningPlayer,290,70,360,4,48,Player A
430,QLearningPlayer,320,55,375,1,42,Player A
431,QLearningPlayer,312,62,374,3,43,Player A
432,QLearningPlayer,327,47,374,0,42,Player A
433,QLearningPlayer,294,64,358,2,48,Player A
434,QLearningPlayer,279,59,338,0,54,Player A
435,QLearningPlayer,303,53,356,0,48,Player A
436,QLearningPlayer,264,69,333,1,56,Player A
437,QLearningPlayer,295,55,350,0,50,Player A
438,QLearningPlayer,264,69,333,1,56,Player A
439,QLearningPlayer,285,70,355,5,50,Player A
440,QLearningPlayer,299,109,408,13,35,Player A
441,QLearningPlayer,303,53,356,0,48,Player A
442,QLearningPlayer,275,60,335,0,55,Player A
443,QLearningPlayer,279,79,358,5,49,Player A
444,QLearningPlayer,298,58,356,0,48,Player A
445,QLearningPlayer,307,52,359,0,47,Player A
446,QLearningPlayer,285,60,345,1,52,Player A
447,QLearningPlayer,308,68,376,5,43,Player A
448,QLearningPlayer,311,51,362,0,46,Player A
449,QLearningPlayer,315,50,365,0,45,Player A
450,QLearningPlayer,258,68,326,0,58,Player A
451,QLearningPlayer,270,90,360,7,49,Player A
452,QLearningPlayer,257,147,404,15,37,Player A
453,QLearningPlayer,322,52,374,3,43,Player A
454,QLearningPlayer,284,69,353,0,49,Player A
455,QLearningPlayer,353,48,401,3,34,Player A
456,QLearningPlayer,264,124,388,8,40,Player A
457,QLearningPlayer,282,72,354,4,50,Player A
458,QLearningPlayer,285,95,380,9,43,Player A
459,QLearningPlayer,283,58,341,0,53,Player A
460,QLearningPlayer,315,50,365,0,45,Player A
461,QLearningPlayer,296,61,357,1,48,Player A
462,QLearningPlayer,284,64,348,1,51,Player A
463,QLearningPlayer,282,67,349,2,51,Player A
464,QLearningPlayer,267,137,404,15,37,Player A
465,QLearningPlayer,295,55,350,0,50,Player A
466,QLearningPlayer,280,65,345,1,52,Player A
467,QLearningPlayer,295,55,350,0,50,Player A
468,QLearningPlayer,303,53,356,0,48,Player A
469,QLearningPlayer,273,83,356,6,50,Player A
470,QLearningPlayer,303,53,356,0,48,Player A
471,QLearningPlayer,288,63,351,1,50,Player A
472,QLearningPlayer,324,79,403,5,34,Player A
473,QLearningPlayer,277,97,374,9,45,Player A
474,QLearningPlayer,298,68,366,4,46,Player A
475,QLearningPlayer,312,67,379,5,42,Player A
476,QLearningPlayer,255,85,340,5,55,Player A
477,QLearningPlayer,289,94,383,6,41,Player A
478,QLearningPlayer,303,53,356,0,48,Player A
479,QLearningPlayer,315,50,365,0,45,Player A
480,QLearningPlayer,252,77,329,3,58,Player A
481,QLearningPlayer,289,74,363,4,47,Player A
482,QLearningPlayer,331,46,377,0,41,Player A
483,QLearningPlayer,291,56,347,0,51,Player A
484,QLearningPlayer,267,82,349,5,52,Player A
485,QLearningPlayer,310,60,370,2,44,Player A
486,QLearningPlayer,271,76,347,3,52,Player A
487,QLearningPlayer,269,129,398,15,39,Player A
488,QLearningPlayer,323,48,371,0,43,Player A
489,QLearningPlayer,319,49,368,0,44,Player A
490,QLearningPlayer,279,59,338,0,54,Player A
491,QLearningPlayer,291,56,347,0,51,Player A
492,QLearningPlayer,301,106,407,12,35,Player A
493,QLearningPlayer,303,53,356,0,48,Player A
494,QLearningPlayer,299,54,353,0,49,Player A
495,QLearningPlayer,305,55,360,1,47,Player A
496,QLearningPlayer,304,59,363,1,46,Player A
497,QLearningPlayer,276,96,372,7,45,Player A
498,QLearningPlayer,298,78,376,5,43,Player A
499,QLearningPlayer,305,55,360,1,47,Player A
500,QLearningPlayer,296,61,357,1,48,Player A
501,QLearningPlayer,271,61,332,0,56,Player A
502,QLearningPlayer,294,84,378,10,44,Player A
503,QLearningPlayer,299,79,378,4,42,Player A
504,QLearningPlayer,294,74,368,6,46,Player A
505,QLearningPlayer,242,197,439,29,30,Player A
506,QLearningPlayer,278,68,346,2,52,Player A
507,QLearningPlayer,293,63,356,0,48,Player A
508,QLearningPlayer,294,54,348,1,51,Player A
509,QLearningPlayer,306,61,367,2,45,Player A
510,QLearningPlayer,291,56,347,0,51,Player A
511,QLearningPlayer,307,52,359,0,47,Player A
512,QLearningPlayer,287,57,344,0,52,Player A
513,QLearningPlayer,296,61,357,1,48,Player A
514,QLearningPlayer,323,48,371,0,43,Player A
515,QLearningPlayer,246,121,367,8,47,Player A
516,QLearningPlayer,303,78,381,7,42,Player A
517,QLearningPlayer,299,54,353,0,49,Player A
518,QLearningPlayer,308,58,366,1,45,Player A
519,QLearningPlayer,287,57,344,0,52,Player A
520,QLearningPlayer,282,67,349,2,51,Player A
521,QLearningPlayer,268,68,336,1,55,Player A
522,QLearningPlayer,270,115,385,8,41,Player A
523,QLearningPlayer,243,68,311,0,63,Player A
524,QLearningPlayer,316,56,372,1,43,Player A
525,QLearningPlayer,255,140,395,15,40,Player A
526,QLearningPlayer,279,59,338,0,54,Player A
527,QLearningPlayer,295,55,350,0,50,Player A
528,QLearningPlayer,266,146,412,20,36,Player A
529,QLearningPlayer,287,57,344,0,52,Player A
530,QLearningPlayer,247,102,349,8,53,Player A
531,QLearningPlayer,299,54,353,0,49,Player A
532,QLearningPlayer,256,86,342,4,54,Player A
533,QLearningPlayer,290,70,360,4,48,Player A
534,QLearningPlayer,283,83,366,7,47,Player A
535,QLearningPlayer,262,67,329,0,57,Player A
536,QLearningPlayer,315,50,365,0,45,Player A
537,QLearningPlayer,262,67,329,0,57,Player A
538,QLearningPlayer,323,48,371,0,43,Player A
539,QLearningPlayer,331,46,377,0,41,Player A
540,QLearningPlayer,295,55,350,0,50,Player A
541,QLearningPlayer,264,69,333,1,56,Player A
542,QLearningPlayer,333,48,381,1,40,Player A
543,QLearningPlayer,270,65,335,0,55,Player A
544,QLearningPlayer,297,77,374,3,43,Player A
545,QLearningPlayer,271,136,407,21,38,Player A
546,QLearningPlayer,260,75,335,0,55,Player A
547,QLearningPlayer,328,53,381,1,40,Player A
548,QLearningPlayer,331,46,377,0,41,Player A
549,QLearningPlayer,285,100,385,11,42,Player A
550,QLearningPlayer,284,129,413,6,31,Player A
551,QLearningPlayer,267,62,329,0,57,Player A
552,QLearningPlayer,271,61,332,0,56,Player A
553,QLearningPlayer,303,53,356,0,48,Player A
554,QLearningPlayer,250,70,320,0,60,Player A
555,QLearningPlayer,319,49,368,0,44,Player A
556,QLearningPlayer,331,46,377,0,41,Player A
557,QLearningPlayer,315,50,365,0,45,Player A
558,QLearningPlayer,281,61,342,1,53,Player A
559,QLearningPlayer,261,76,337,2,55,Player A
560,QLearningPlayer,258,68,326,0,58,Player A
561,QLearningPlayer,246,86,332,3,57,Player A
562,QLearningPlayer,300,65,365,3,46,Player A
563,QLearningPlayer,275,60,335,0,55,Player A
564,QLearningPlayer,291,56,347,0,51,Player A
565,QLearningPlayer,290,80,370,8,46,Player A
566,QLearningPlayer,288,68,356,3,49,Player A
567,QLearningPlayer,268,68,336,1,55,Player A
568,QLearningPlayer,298,63,361,2,47,Player A
569,QLearningPlayer,283,58,341,0,53,Player A
570,QLearningPlayer,287,57,344,0,52,Player A
571,QLearningPlayer,238,138,376,14,46,Player A
572,QLearningPlayer,307,52,359,0,47,Player A
573,QLearningPlayer,287,57,344,0,52,Player A
574,QLearningPlayer,298,68,366,4,46,Player A
575,QLearningPlayer,252,82,334,2,56,Player A
576,QLearningPlayer,287,57,344,0,52,Player A
577,QLearningPlayer,331,51,382,2,40,Player A
578,QLearningPlayer,289,69,358,2,48,Player A
579,QLearningPlayer,315,50,365,0,45,Player A
580,QLearningPlayer,335,45,380,0,40,Player A
581,QLearningPlayer,326,56,382,2,40,Player A
582,QLearningPlayer,275,60,335,0,55,Player A
583,QLearningPlayer,278,63,341,0,53,Player A
584,QLearningPlayer,295,55,350,0,50,Player A
585,QLearningPlayer,280,65,345,1,52,Player A
586,QLearningPlayer,304,69,373,5,44,Player A
587,QLearningPlayer,319,49,368,0,44,Player A
588,QLearningPlayer,298,63,361,2,47,Player A
589,QLearningPlayer,286,66,352,2,50,Player A
590,QLearningPlayer,266,66,332,0,56,Player A
591,QLearningPlayer,285,60,345,1,52,Player A
592,QLearningPlayer,303,88,391,11,40,Player A
593,QLearningPlayer,299,54,353,0,49,Player A
594,QLearningPlayer,323,48,371,0,43,Player A
595,QLearningPlayer,287,57,344,0,52,Player A
596,QLearningPlayer,310,65,375,4,43,Player A
597,QLearningPlayer,309,59,368,3,45,Player A
598,QLearningPlayer,324,54,378,1,41,Player A
599,QLearningPlayer,320,55,375,1,42,Player A
600,QLearningPlayer,267,62,329,0,57,Player A
601,QLearningPlayer,329,49,378,1,41,Player A
602,QLearningPlayer,302,57,359,0,47,Player A
603,QLearningPlayer,307,87,394,8,38,Player A
604,QLearningPlayer,284,69,353,3,50,Player A
605,QLearningPlayer,308,58,366,1,45,Player A
606,QLearningPlayer,262,82,344,6,54,Player A
607,QLearningPlayer,283,88,371,3,44,Player A
608,QLearningPlayer,283,58,341,0,53,Player A
609,QLearningPlayer,335,45,380,0,40,Player A
610,QLearningPlayer,314,49,363,1,46,Player A
611,QLearningPlayer,314,54,368,0,44,Player A
612,QLearningPlayer,283,58,341,0,53,Player A
613,QLearningPlayer,303,53,356,0,48,Player A
614,QLearningPlayer,279,59,338,0,54,Player A
615,QLearningPlayer,290,65,355,2,49,Player A
616,QLearningPlayer,311,51,362,0,46,Player A
617,QLearningPlayer,260,85,345,4,53,Player A
618,QLearningPlayer,279,74,353,3,50,Player A
619,QLearningPlayer,318,58,376,2,42,Player A
620,QLearningPlayer,335,45,380,0,40,Player A
621,QLearningPlayer,294,69,363,4,47,Player A
622,QLearningPlayer,304,59,363,1,46,Player A
623,QLearningPlayer,327,47,374,0,42,Player A
624,QLearningPlayer,295,55,350,0,50,Player A
625,QLearningPlayer,287,57,344,0,52,Player A
626,QLearningPlayer,295,55,350,0,50,Player A
627,QLearningPlayer,323,48,371,0,43,Player A
628,QLearningPlayer,287,57,344,0,52,Player A
629,QLearningPlayer,289,79,368,6,46,Player A
630,QLearningPlayer,284,69,353,3,50,Player A
631,QLearningPlayer,294,64,358,2,48,Player A
632,QLearningPlayer,279,89,368,6,46,Player A
633,QLearningPlayer,316,66,382,5,41,Player A
634,QLearningPlayer,295,65,360,1,47,Player A
635,QLearningPlayer,283,58,341,0,53,Player A
636,QLearningPlayer,288,63,351,1,50,Player A
637,QLearningPlayer,291,56,347,0,51,Player A
638,QLearningPlayer,318,63,381,4,41,Player A
639,QLearningPlayer,300,65,365,3,46,Player A
640,QLearningPlayer,299,54,353,0,49,Player A
641,QLearningPlayer,303,53,356,0,48,Player A
642,QLearningPlayer,347,42,389,0,37,Player A
643,QLearningPlayer,303,53,356,0,48,Player A
644,QLearningPlayer,260,70,330,1,57,Player A
645,QLearningPlayer,315,60,375,1,42,Player A
646,QLearningPlayer,295,75,370,5,45,Player A
647,QLearningPlayer,271,61,332,0,56,Player A
648,QLearningPlayer,249,124,373,11,46,Player A
649,QLearningPlayer,291,71,362,3,47,Player A
650,QLearningPlayer,300,60,360,1,47,Player A
651,QLearningPlayer,341,46,387,1,38,Player A
652,QLearningPlayer,316,61,377,3,42,Player A
653,QLearningPlayer,327,47,374,0,42,Player A
654,QLearningPlayer,271,61,332,0,56,Player A
655,QLearningPlayer,319,49,368,0,44,Player A
656,QLearningPlayer,307,52,359,0,47,Player A
657,QLearningPlayer,283,58,341,0,53,Player A
658,QLearningPlayer,268,68,336,1,55,Player A
659,QLearningPlayer,316,56,372,1,43,Player A
660,QLearningPlayer,312,52,364,2,46,Player A
661,QLearningPlayer,322,57,379,2,41,Player A
662,QLearningPlayer,287,82,369,7,46,Player A
663,QLearningPlayer,286,66,352,2,50,Player A
664,QLearningPlayer,291,56,347,0,51,Player A
665,QLearningPlayer,283,58,341,0,53,Player A
666,QLearningPlayer,308,58,366,1,45,Player A
667,QLearningPlayer,299,54,353,0,49,Player A
668,QLearningPlayer,315,50,365,0,45,Player A
669,QLearningPlayer,307,52,359,0,47,Player A
670,QLearningPlayer,278,68,346,2,52,Player A
671,QLearningPlayer,278,63,341,0,53,Player A
672,QLearningPlayer,339,59,398,3,35,Player A
673,QLearningPlayer,270,65,335,0,55,Player A
674,QLearningPlayer,251,126,377,12,45,Player A
675,QLearningPlayer,303,53,356,0,48,Player A
676,QLearningPlayer,218,118,336,7,57,Player A
677,QLearningPlayer,275,60,335,0,55,Player A
678,QLearningPlayer,317,57,374,3,43,Player A
679,QLearningPlayer,295,70,365,3,46,Player A
680,QLearningPlayer,291,56,347,0,51,Player A
681,QLearningPlayer,316,61,377,3,42,Player A
682,QLearningPlayer,268,73,341,3,54,Player A
683,QLearningPlayer,332,62,394,5,37,Player A
684,QLearningPlayer,281,86,367,8,47,Player A
685,QLearningPlayer,295,70,365,3,46,Player A
686,QLearningPlayer,287,57,344,0,52,Player A
687,QLearningPlayer,274,69,343,2,53,Player A
688,QLearningPlayer,247,77,324,1,59,Player A
689,QLearningPlayer,287,57,344,0,52,Player A
690,QLearningPlayer,301,86,387,7,40,Player A
691,QLearningPlayer,310,65,375,4,43,Player A
692,QLearningPlayer,345,45,390,1,37,Player A
693,QLearningPlayer,243,168,411,19,36,Player A
694,QLearningPlayer,318,68,386,0,38,Player A
695,QLearningPlayer,302,62,364,2,46,Player A
696,QLearningPlayer,263,63,326,0,58,Player A
697,QLearningPlayer,261,76,337,2,55,Player A
698,QLearningPlayer,321,51,372,1,43,Player A
699,QLearningPlayer,294,69,363,4,47,Player A
700,QLearningPlayer,246,71,317,0,61,Player A
701,QLearningPlayer,311,61,372,4,44,Player A
702,QLearningPlayer,296,116,412,17,35,Player A
703,QLearningPlayer,294,64,358,2,48,Player A
704,QLearningPlayer,288,88,376,8,44,Player A
705,QLearningPlayer,296,86,382,5,41,Player A
706,QLearningPlayer,311,51,362,0,46,Player A
707,QLearningPlayer,303,58,361,2,47,Player A
708,QLearningPlayer,308,58,366,1,45,Player A
709,QLearningPlayer,291,56,347,0,51,Player A
710,QLearningPlayer,287,57,344,0,52,Player A
711,QLearningPlayer,348,43,391,2,37,Player A
712,QLearningPlayer,243,148,391,20,43,Player A
713,QLearningPlayer,317,62,379,2,41,Player A
714,QLearningPlayer,303,53,356,0,48,Player A
715,QLearningPlayer,315,50,365,0,45,Player A
716,QLearningPlayer,298,63,361,2,47,Player A
717,QLearningPlayer,294,64,358,2,48,Player A
718,QLearningPlayer,299,54,353,0,49,Player A
719,QLearningPlayer,260,100,360,7,49,Player A
720,QLearningPlayer,296,71,367,5,46,Player A
721,QLearningPlayer,295,115,410,18,36,Player A
722,QLearningPlayer,279,69,348,1,51,Player A
723,QLearningPlayer,319,49,368,0,44,Player A
724,QLearningPlayer,315,50,365,0,45,Player A
725,QLearningPlayer,334,64,398,6,36,Player A
726,QLearningPlayer,287,57,344,0,52,Player A
727,QLearningPlayer,291,56,347,0,51,Player A
728,QLearningPlayer,271,86,357,7,50,Player A
729,QLearningPlayer,295,55,350,0,50,Player A
730,QLearningPlayer,279,59,338,0,54,Player A
731,QLearningPlayer,276,91,367,8,47,Player A
732,QLearningPlayer,310,60,370,2,44,Player A
733,QLearningPlayer,267,77,344,3,53,Player A
734,QLearningPlayer,271,61,332,0,56,Player A
735,QLearningPlayer,275,75,350,3,51,Player A
736,QLearningPlayer,303,53,356,0,48,Player A
737,QLearningPlayer,275,60,335,0,55,Player A
738,QLearningPlayer,321,66,387,4,39,Player A
739,QLearningPlayer,274,74,348,1,51,Player A
740,QLearningPlayer,304,59,363,1,46,Player A
741,QLearningPlayer,283,58,341,0,53,Player A
742,QLearningPlayer,290,65,355,2,49,Player A
743,QLearningPlayer,326,51,377,0,41,Player A
744,QLearningPlayer,295,55,350,0,50,Player A
745,QLearningPlayer,323,48,371,0,43,Player A
746,QLearningPlayer,287,57,344,0,52,Player A
747,QLearningPlayer,303,58,361,2,47,Player A
748,QLearningPlayer,279,69,348,1,51,Player A
749,QLearningPlayer,286,66,352,2,50,Player A
750,QLearningPlayer,293,58,351,1,50,Player A
751,QLearningPlayer,286,71,357,4,49,Player A
752,QLearningPlayer,294,59,353,0,49,Player A
753,QLearningPlayer,311,56,367,2,45,Player A
754,QLearningPlayer,291,71,362,3,47,Player A
755,QLearningPlayer,291,61,352,2,50,Player A
756,QLearningPlayer,314,54,368,0,44,Player A
757,QLearningPlayer,303,53,356,0,48,Player A
758,QLearningPlayer,281,76,357,4,49,Player A
759,QLearningPlayer,313,58,371,3,44,Player A
760,QLearningPlayer,241,121,362,12,50,Player A
761,QLearningPlayer,310,55,365,0,45,Player A
762,QLearningPlayer,229,99,328,5,59,Player A
763,QLearningPlayer,267,67,334,2,56,Player A
764,QLearningPlayer,289,69,358,2,48,Player A
765,QLearningPlayer,269,64,333,1,56,Player A
766,QLearningPlayer,260,80,340,2,54,Player A
767,QLearningPlayer,287,57,344,0,52,Player A
768,QLearningPlayer,248,143,391,14,41,Player A
769,QLearningPlayer,276,66,342,1,53,Player A
770,QLearningPlayer,282,67,349,2,51,Player A
771,QLearningPlayer,291,56,347,0,51,Player A
772,QLearningPlayer,302,72,374,3,43,Player A
773,QLearningPlayer,302,67,369,4,45,Player A
774,QLearningPlayer,284,69,353,3,50,Player A
775,QLearningPlayer,294,64,358,2,48,Player A
776,QLearningPlayer,271,61,332,0,56,Player A
777,QLearningPlayer,270,65,335,0,55,Player A
778,QLearningPlayer,319,49,368,0,44,Player A
779,QLearningPlayer,291,56,347,0,51,Player A
780,QLearningPlayer,299,54,353,0,49,Player A
781,QLearningPlayer,295,55,350,0,50,Player A
782,QLearningPlayer,291,56,347,0,51,Player A
783,QLearningPlayer,283,83,366,7,47,Player A
784,QLearningPlayer,295,55,350,0,50,Player A
785,QLearningPlayer,282,62,344,0,52,Player A
786,QLearningPlayer,295,55,350,0,50,Player A
787,QLearningPlayer,280,65,345,1,52,Player A
788,QLearningPlayer,303,53,356,0,48,Player A
789,QLearningPlayer,284,64,348,1,51,Player A
790,QLearningPlayer,307,52,359,0,47,Player A
791,QLearningPlayer,307,52,359,0,47,Player A
792,QLearningPlayer,311,51,362,0,46,Player A
793,QLearningPlayer,295,55,350,0,50,Player A
794,QLearningPlayer,295,55,350,0,50,Player A
795,QLearningPlayer,262,67,329,0,57,Player A
796,QLearningPlayer,297,97,394,11,39,Player A
797,QLearningPlayer,259,64,323,0,59,Player A
798,QLearningPlayer,278,88,366,10,48,Player A
799,QLearningPlayer,274,79,353,3,50,Player A
800,QLearningPlayer,303,53,356,0,48,Player A
801,QLearningPlayer,256,136,392,15,41,Player A
802,QLearningPlayer,244,99,343,5,54,Player A
803,QLearningPlayer,311,51,362,0,46,Player A
804,QLearningPlayer,261,76,337,2,55,Player A
805,QLearningPlayer,290,65,355,2,49,Player A
806,QLearningPlayer,315,50,365,0,45,Player A
807,QLearningPlayer,315,50,365,0,45,Player A
808,QLearningPlayer,295,60,355,2,49,Player A
809,QLearningPlayer,256,81,337,2,55,Player A
810,QLearningPlayer,287,57,344,0,52,Player A
811,QLearningPlayer,319,49,368,0,44,Player A
812,QLearningPlayer,293,63,356,3,49,Player A
813,QLearningPlayer,283,93,376,5,43,Player A
814,QLearningPlayer,262,97,359,6,49,Player A
815,QLearningPlayer,283,73,356,3,49,Player A
816,QLearningPlayer,317,72,389,6,39,Player A
817,QLearningPlayer,308,58,366,1,45,Player A
818,QLearningPlayer,284,64,348,1,51,Player A
819,QLearningPlayer,283,58,341,0,53,Player A
820,QLearningPlayer,287,57,344,0,52,Player A
821,QLearningPlayer,316,61,377,3,42,Player A
822,QLearningPlayer,319,49,368,0,44,Player A
823,QLearningPlayer,298,58,356,0,48,Player A
824,QLearningPlayer,315,50,365,0,45,Player A
825,QLearningPlayer,323,48,371,0,43,Player A
826,QLearningPlayer,287,67,354,1,49,Player A
827,QLearningPlayer,288,68,356,3,49,Player A
828,QLearningPlayer,294,104,398,12,38,Player A
829,QLearningPlayer,314,59,373,2,43,Player A
830,QLearningPlayer,287,57,344,0,52,Player A
831,QLearningPlayer,310,60,370,2,44,Player A
832,QLearningPlayer,303,53,356,0,48,Player A
833,QLearningPlayer,327,47,374,0,42,Player A
834,QLearningPlayer,264,69,333,1,56,Player A
835,QLearningPlayer,307,52,359,0,47,Player A
836,QLearningPlayer,303,78,381,7,42,Player A
837,QLearningPlayer,319,49,368,0,44,Player A
838,QLearningPlayer,323,53,376,2,42,Player A
839,QLearningPlayer,289,84,373,5,44,Player A
840,QLearningPlayer,288,73,361,5,48,Player A
841,QLearningPlayer,295,55,350,0,50,Player A
842,QLearningPlayer,319,49,368,0,44,Player A
843,QLearningPlayer,295,55,350,0,50,Player A
844,QLearningPlayer,283,68,351,4,51,Player A
845,QLearningPlayer,301,71,372,4,44,Player A
846,QLearningPlayer,272,67,339,1,54,Player A
847,QLearningPlayer,287,57,344,0,52,Player A
848,QLearningPlayer,329,49,378,1,41,Player A
849,QLearningPlayer,328,53,381,1,40,Player A
850,QLearningPlayer,280,115,395,12,39,Player A
851,QLearningPlayer,283,58,341,0,53,Player A
852,QLearningPlayer,294,74,368,6,46,Player A
853,QLearningPlayer,324,54,378,1,41,Player A
854,QLearningPlayer,306,66,372,4,44,Player A
855,QLearningPlayer,302,77,379,5,42,Player A
856,QLearningPlayer,283,58,341,0,53,Player A
857,QLearningPlayer,295,60,355,2,49,Player A
858,QLearningPlayer,304,59,363,1,46,Player A
859,QLearningPlayer,268,68,336,1,55,Player A
860,QLearningPlayer,267,87,354,4,50,Player A
861,QLearningPlayer,307,52,359,0,47,Player A
862,QLearningPlayer,305,65,370,5,45,Player A
863,QLearningPlayer,284,104,388,8,40,Player A
864,QLearningPlayer,307,62,369,1,44,Player A
865,QLearningPlayer,290,55,345,1,52,Player A
866,QLearningPlayer,297,67,364,2,46,Player A
867,QLearningPlayer,311,66,377,3,42,Player A
868,QLearningPlayer,289,79,368,3,45,Player A
869,QLearningPlayer,306,61,367,2,45,Player A
870,QLearningPlayer,283,68,351,1,50,Player A
871,QLearningPlayer,282,67,349,2,51,Player A
872,QLearningPlayer,315,50,365,0,45,Player A
873,QLearningPlayer,261,96,357,7,50,Player A
874,QLearningPlayer,291,91,382,8,42,Player A
875,QLearningPlayer,268,123,391,17,42,Player A
876,QLearningPlayer,279,59,338,0,54,Player A
877,QLearningPlayer,315,50,365,0,45,Player A
878,QLearningPlayer,298,68,366,4,46,Player A
879,QLearningPlayer,332,52,384,1,39,Player A
880,QLearningPlayer,295,55,350,0,50,Player A
881,QLearningPlayer,308,63,371,3,44,Player A
882,QLearningPlayer,277,117,394,11,39,Player A
883,QLearningPlayer,328,58,386,3,39,Player A
884,QLearningPlayer,291,56,347,0,51,Player A
885,QLearningPlayer,303,53,356,0,48,Player A
886,QLearningPlayer,246,106,352,5,51,Player A
887,QLearningPlayer,302,67,369,4,45,Player A
888,QLearningPlayer,252,137,389,15,42,Player A
889,QLearningPlayer,279,59,338,0,54,Player A
890,QLearningPlayer,302,62,364,2,46,Player A
891,QLearningPlayer,257,67,324,1,59,Player A
892,QLearningPlayer,289,69,358,2,48,Player A
893,QLearningPlayer,292,62,354,1,49,Player A
894,QLearningPlayer,283,58,341,0,53,Player A
895,QLearningPlayer,285,75,360,4,48,Player A
896,QLearningPlayer,258,68,326,0,58,Player A
897,QLearningPlayer,254,69,323,0,59,Player A
898,QLearningPlayer,281,121,402,19,39,Player A
899,QLearningPlayer,277,72,349,2,51,Player A
900,QLearningPlayer,265,110,375,7,44,Player A
901,QLearningPlayer,298,63,361,2,47,Player A
902,QLearningPlayer,302,57,359,0,47,Player A
903,QLearningPlayer,297,57,354,1,49,Player A
904,QLearningPlayer,271,131,402,19,39,Player A
905,QLearningPlayer,261,161,422,18,32,Player A
906,QLearningPlayer,287,57,344,0,52,Player A
907,QLearningPlayer,307,52,359,0,47,Player A
908,QLearningPlayer,307,57,364,2,46,Player A
909,QLearningPlayer,255,100,355,11,52,Player A
910,QLearningPlayer,271,96,367,8,47,Player A
911,QLearningPlayer,303,68,371,6,45,Player A
912,QLearningPlayer,287,67,354,1,49,Player A
913,QLearningPlayer,275,60,335,0,55,Player A
914,QLearningPlayer,303,53,356,0,48,Player A
915,QLearningPlayer,254,69,323,0,59,Player A
916,QLearningPlayer,322,47,369,1,44,Player A
917,QLearningPlayer,252,87,339,4,55,Player A
918,QLearningPlayer,287,57,344,0,52,Player A
919,QLearningPlayer,278,83,361,5,48,Player A
920,QLearningPlayer,280,65,345,1,52,Player A
921,QLearningPlayer,276,66,342,1,53,Player A
922,QLearningPlayer,323,48,371,0,43,Player A
923,QLearningPlayer,300,65,365,3,46,Player A
924,QLearningPlayer,295,55,350,0,50,Player A
925,QLearningPlayer,268,93,361,8,49,Player A
926,QLearningPlayer,328,58,386,3,39,Player A
927,QLearningPlayer,295,55,350,0,50,Player A
928,QLearningPlayer,296,61,357,1,48,Player A
929,QLearningPlayer,255,75,330,1,57,Player A
930,QLearningPlayer,280,65,345,1,52,Player A
931,QLearningPlayer,290,65,355,2,49,Player A
932,QLearningPlayer,295,55,350,0,50,Player A
933,QLearningPlayer,248,88,336,4,56,Player A
934,QLearningPlayer,280,85,365,6,47,Player A
935,QLearningPlayer,311,51,362,0,46,Player A
936,QLearningPlayer,300,80,380,6,42,Player A
937,QLearningPlayer,299,54,353,0,49,Player A
938,QLearningPlayer,261,76,337,2,55,Player A
939,QLearningPlayer,268,68,336,1,55,Player A
940,QLearningPlayer,319,49,368,0,44,Player A
941,QLearningPlayer,312,67,379,5,42,Player A
942,QLearningPlayer,299,54,353,0,49,Player A
943,QLearningPlayer,300,60,360,1,47,Player A
944,QLearningPlayer,272,97,369,10,47,Player A
945,QLearningPlayer,303,53,356,0,48,Player A
946,QLearningPlayer,270,80,350,3,51,Player A
947,QLearningPlayer,307,52,359,0,47,Player A
948,QLearningPlayer,295,55,350,0,50,Player A
949,QLearningPlayer,291,66,357,4,49,Player A
950,QLearningPlayer,271,86,357,4,49,Player A
951,QLearningPlayer,286,66,352,2,50,Player A
952,QLearningPlayer,293,68,361,2,47,Player A
953,QLearningPlayer,295,55,350,0,50,Player A
954,QLearningPlayer,295,55,350,0,50,Player A
955,QLearningPlayer,313,53,366,1,45,Player A
956,QLearningPlayer,274,64,338,0,54,Player A
957,QLearningPlayer,313,53,366,1,45,Player A
958,QLearningPlayer,300,80,380,6,42,Player A
959,QLearningPlayer,325,50,375,1,42,Player A
960,QLearningPlayer,294,59,353,0,49,Player A
961,QLearningPlayer,295,55,350,0,50,Player A
962,QLearningPlayer,303,78,381,7,42,Player A
963,QLearningPlayer,266,86,352,5,51,Player A
964,QLearningPlayer,301,66,367,2,45,Player A
965,QLearningPlayer,299,59,358,2,48,Player A
966,QLearningPlayer,287,67,354,1,49,Player A
967,QLearningPlayer,298,53,351,1,50,Player A
968,QLearningPlayer,310,60,370,2,44,Player A
969,QLearningPlayer,302,62,364,2,46,Player A
970,QLearningPlayer,322,57,379,2,41,Player A
971,QLearningPlayer,298,68,366,4,46,Player A
972,QLearningPlayer,284,64,348,1,51,Player A
973,QLearningPlayer,312,57,369,1,44,Player A
974,QLearningPlayer,254,159,413,18,35,Player A
975,QLearningPlayer,271,61,332,0,56,Player A
976,QLearningPlayer,303,53,356,0,48,Player A
977,QLearningPlayer,323,48,371,0,43,Player A
978,QLearningPlayer,287,107,394,11,39,Player A
979,QLearningPlayer,291,56,347,0,51,Player A
980,QLearningPlayer,295,55,350,0,50,Player A
981,QLearningPlayer,279,59,338,0,54,Player A
982,QLearningPlayer,291,56,347,0,51,Player A
983,QLearningPlayer,311,51,362,0,46,Player A
984,QLearningPlayer,256,146,402,13,37,Player A
985,QLearningPlayer,284,64,348,1,51,Player A
986,QLearningPlayer,307,52,359,0,47,Player A
987,QLearningPlayer,322,62,384,4,40,Player A
988,QLearningPlayer,275,75,350,3,51,Player A
989,QLearningPlayer,323,48,371,0,43,Player A
990,QLearningPlayer,282,72,354,4,50,Player A
991,QLearningPlayer,285,90,375,7,44,Player A
992,QLearningPlayer,291,56,347,0,51,Player A
993,QLearningPlayer,311,51,362,0,46,Player A
994,QLearningPlayer,319,49,368,0,44,Player A
995,QLearningPlayer,295,55,350,0,50,Player A
996,QLearningPlayer,303,53,356,0,48,Player A
997,QLearningPlayer,340,50,390,1,37,Player A
998,QLearningPlayer,305,55,360,1,47,Player A
999,QLearningPlayer,298,63,361,2,47,Player A
1000,QLearningPlayer,242,92,334,5,57,Player A
1001,QLearningPlayer,277,77,354,4,50,Player A
1002,QLearningPlayer,286,71,357,4,49,Player A
1003,QLearningPlayer,302,62,364,2,46,Player A
1004,QLearningPlayer,304,59,363,1,46,Player A
1005,QLearningPlayer,280,70,350,3,51,Player A
1006,QLearningPlayer,316,71,387,7,40,Player A
1007,QLearningPlayer,280,75,355,2,49,Player A
1008,QLearningPlayer,291,56,347,0,51,Player A
1009,QLearningPlayer,286,76,362,6,48,Player A
1010,QLearningPlayer,309,69,378,7,43,Player A
1011,QLearningPlayer,303,73,376,5,43,Player A
1012,QLearningPlayer,294,59,353,0,49,Player A
1013,QLearningPlayer,309,54,363,1,46,Player A
1014,QLearningPlayer,281,91,372,10,46,Player A
1015,QLearningPlayer,294,74,368,3,45,Player A
1016,QLearningPlayer,293,58,351,1,50,Player A
1017,QLearningPlayer,263,68,331,2,57,Player A
1018,QLearningPlayer,277,77,354,4,50,Player A
1019,QLearningPlayer,310,60,370,2,44,Player A
1020,QLearningPlayer,319,49,368,0,44,Player A
1021,QLearningPlayer,335,45,380,0,40,Player A
1022,QLearningPlayer,279,59,338,0,54,Player A
1023,QLearningPlayer,271,71,342,1,53,Player A
1024,QLearningPlayer,289,69,358,2,48,Player A
1025,QLearningPlayer,287,57,344,0,52,Player A
1026,QLearningPlayer,287,57,344,0,52,Player A
1027,QLearningPlayer,280,65,345,1,52,Player A
1028,QLearningPlayer,295,55,350,0,50,Player A
1029,QLearningPlayer,258,68,326,0,58,Player A
1030,QLearningPlayer,278,68,346,2,52,Player A
1031,QLearningPlayer,296,76,372,7,45,Player A
1032,QLearningPlayer,296,81,377,6,43,Player A
1033,QLearningPlayer,260,70,330,1,57,Player A
1034,QLearningPlayer,327,47,374,0,42,Player A
1035,QLearningPlayer,327,57,384,4,40,Player A
1036,QLearningPlayer,323,73,396,7,37,Player A
1037,QLearningPlayer,311,51,362,0,46,Player A
1038,QLearningPlayer,275,60,335,0,55,Player A
1039,QLearningPlayer,281,106,387,13,42,Player A
1040,QLearningPlayer,255,90,345,4,53,Player A
1041,QLearningPlayer,323,48,371,0,43,Player A
1042,QLearningPlayer,303,53,356,0,48,Player A
1043,QLearningPlayer,263,63,326,0,58,Player A
1044,QLearningPlayer,299,54,353,0,49,Player A
1045,QLearningPlayer,271,61,332,0,56,Player A
1046,QLearningPlayer,311,71,382,8,42,Player A
1047,QLearningPlayer,287,97,384,10,42,Player A
1048,QLearningPlayer,285,80,365,6,47,Player A
1049,QLearningPlayer,274,69,343,2,53,Player A
1050,QLearningPlayer,319,49,368,0,44,Player A
1051,QLearningPlayer,287,57,344,0,52,Player A
1052,QLearningPlayer,275,75,350,3,51,Player A
1053,QLearningPlayer,297,77,374,6,44,Player A
1054,QLearningPlayer,331,46,377,0,41,Player A
1055,QLearningPlayer,319,49,368,0,44,Player A
1056,QLearningPlayer,299,54,353,0,49,Player A
1057,QLearningPlayer,341,46,387,1,38,Player A
1058,QLearningPlayer,316,61,377,3,42,Player A
1059,QLearningPlayer,282,67,349,2,51,Player A
1060,QLearningPlayer,260,90,350,6,52,Player A
1061,QLearningPlayer,312,67,379,2,41,Player A
1062,QLearningPlayer,267,62,329,0,57,Player A
1063,QLearningPlayer,274,69,343,2,53,Player A
1064,QLearningPlayer,253,83,336,1,55,Player A
1065,QLearningPlayer,319,49,368,0,44,Player A
1066,QLearningPlayer,303,53,356,0,48,Player A
1067,QLearningPlayer,260,75,335,3,56,Player A
1068,QLearningPlayer,274,119,393,10,39,Player A
1069,QLearningPlayer,303,53,356,0,48,Player A
1070,QLearningPlayer,304,49,353,0,49,Player A
1071,QLearningPlayer,315,50,365,0,45,Player A
1072,QLearningPlayer,303,53,356,0,48,Player A
1073,QLearningPlayer,287,57,344,0,52,Player A
1074,QLearningPlayer,295,55,350,0,50,Player A
1075,QLearningPlayer,254,89,343,5,54,Player A
1076,QLearningPlayer,291,76,367,5,46,Player A
1077,QLearningPlayer,295,55,350,0,50,Player A
1078,QLearningPlayer,319,49,368,0,44,Player A
1079,QLearningPlayer,296,61,357,1,48,Player A
1080,QLearningPlayer,287,57,344,0,52,Player A
1081,QLearningPlayer,290,60,350,0,50,Player A
1082,QLearningPlayer,315,50,365,0,45,Player A
1083,QLearningPlayer,319,49,368,0,44,Player A
1084,QLearningPlayer,295,55,350,0,50,Player A
1085,QLearningPlayer,279,94,373,8,45,Player A
1086,QLearningPlayer,319,49,368,0,44,Player A
1087,QLearningPlayer,267,62,329,0,57,Player A
1088,QLearningPlayer,271,76,347,3,52,Player A
1089,QLearningPlayer,298,58,356,0,48,Player A
1090,QLearningPlayer,313,53,366,1,45,Player A
1091,QLearningPlayer,286,66,352,2,50,Player A
1092,QLearningPlayer,287,57,344,0,52,Player A
1093,QLearningPlayer,315,50,365,0,45,Player A
1094,QLearningPlayer,271,121,392,15,41,Player A
1095,QLearningPlayer,275,60,335,0,55,Player A
1096,QLearningPlayer,289,59,348,1,51,Player A
1097,QLearningPlayer,287,57,344,0,52,Player A
1098,QLearningPlayer,260,70,330,1,57,Player A
1099,QLearningPlayer,335,45,380,0,40,Player A
1100,QLearningPlayer,299,74,373,5,44,Player A
1101,QLearningPlayer,279,59,338,0,54,Player A
1102,QLearningPlayer,282,72,354,4,50,Player A
1103,QLearningPlayer,363,38,401,0,33,Player A
1104,QLearningPlayer,279,59,338,0,54,Player A
1105,QLearningPlayer,294,69,363,4,47,Player A
1106,QLearningPlayer,250,90,340,5,55,Player A
1107,QLearningPlayer,268,73,341,3,54,Player A
1108,QLearningPlayer,313,68,381,4,41,Player A
1109,QLearningPlayer,295,55,350,0,50,Player A
1110,QLearningPlayer,319,49,368,0,44,Player A
1111,QLearningPlayer,292,67,359,3,48,Player A
1112,QLearningPlayer,290,100,390,10,40,Player A
1113,QLearningPlayer,263,83,346,2,52,Player A
1114,QLearningPlayer,285,60,345,1,52,Player A
1115,QLearningPlayer,310,60,370,2,44,Player A
1116,QLearningPlayer,288,68,356,3,49,Player A
1117,QLearningPlayer,298,58,356,0,48,Player A
1118,QLearningPlayer,321,51,372,1,43,Player A
1119,QLearningPlayer,279,64,343,2,53,Player A
1120,QLearningPlayer,289,64,353,0,49,Player A
1121,QLearningPlayer,267,62,329,0,57,Player A
1122,QLearningPlayer,303,53,356,0,48,Player A
1123,QLearningPlayer,277,82,359,6,49,Player A
1124,QLearningPlayer,283,58,341,0,53,Player A
1125,QLearningPlayer,319,49,368,0,44,Player A
1126,QLearningPlayer,291,56,347,0,51,Player A
1127,QLearningPlayer,303,53,356,0,48,Player A
1128,QLearningPlayer,295,55,350,0,50,Player A
1129,QLearningPlayer,268,68,336,1,55,Player A
1130,QLearningPlayer,286,66,352,2,50,Player A
1131,QLearningPlayer,271,61,332,0,56,Player A
1132,QLearningPlayer,308,58,366,1,45,Player A
1133,QLearningPlayer,262,82,344,3,53,Player A
1134,QLearningPlayer,308,63,371,3,44,Player A
1135,QLearningPlayer,280,70,350,3,51,Player A
1136,QLearningPlayer,274,69,343,2,53,Player A
1137,QLearningPlayer,287,57,344,0,52,Player A
1138,QLearningPlayer,298,63,361,2,47,Player A
1139,QLearningPlayer,276,66,342,1,53,Player A
1140,QLearningPlayer,249,169,418,20,34,Player A
1141,QLearningPlayer,296,76,372,4,44,Player A
1142,QLearningPlayer,299,54,353,0,49,Player A
1143,QLearningPlayer,291,56,347,0,51,Player A
1144,QLearningPlayer,307,52,359,0,47,Player A
1145,QLearningPlayer,260,150,410,15,35,Player A
1146,QLearningPlayer,321,56,377,3,42,Player A
1147,QLearningPlayer,295,55,350,0,50,Player A
1148,QLearningPlayer,304,59,363,1,46,Player A
1149,QLearningPlayer,337,47,384,1,39,Player A
1150,QLearningPlayer,279,79,358,5,49,Player A
1151,QLearningPlayer,283,78,361,2,47,Player A
1152,QLearningPlayer,307,52,359,0,47,Player A
1153,QLearningPlayer,298,63,361,2,47,Player A
1154,QLearningPlayer,301,56,357,1,48,Player A
1155,QLearningPlayer,316,61,377,3,42,Player A
1156,QLearningPlayer,302,92,394,8,38,Player A
1157,QLearningPlayer,281,76,357,4,49,Player A
1158,QLearningPlayer,285,60,345,1,52,Player A
1159,QLearningPlayer,294,69,363,4,47,Player A
1160,QLearningPlayer,292,62,354,1,49,Player A
1161,QLearningPlayer,331,56,387,4,39,Player A
1162,QLearningPlayer,307,67,374,3,43,Player A
1163,QLearningPlayer,315,90,405,10,35,Player A
1164,QLearningPlayer,267,62,329,0,57,Player A
1165,QLearningPlayer,270,65,335,0,55,Player A
1166,QLearningPlayer,263,78,341,3,54,Player A
1167,QLearningPlayer,273,73,346,2,52,Player A
1168,QLearningPlayer,286,56,342,1,53,Player A
1169,QLearningPlayer,283,73,356,3,49,Player A
1170,QLearningPlayer,308,53,361,2,47,Player A
1171,QLearningPlayer,286,66,352,2,50,Player A
1172,QLearningPlayer,278,88,366,7,47,Player A
1173,QLearningPlayer,276,66,342,1,53,Player A
1174,QLearningPlayer,311,51,362,0,46,Player A
1175,QLearningPlayer,331,46,377,0,41,Player A
1176,QLearningPlayer,300,80,380,6,42,Player A
1177,QLearningPlayer,299,54,353,0,49,Player A
1178,QLearningPlayer,265,105,370,8,46,Player A
1179,QLearningPlayer,299,54,353,0,49,Player A
1180,QLearningPlayer,287,97,384,10,42,Player A
1181,QLearningPlayer,303,53,356,0,48,Player A
1182,QLearningPlayer,307,52,359,0,47,Player A
1183,QLearningPlayer,307,52,359,0,47,Player A
1184,QLearningPlayer,296,61,357,1,48,Player A
1185,QLearningPlayer,290,65,355,2,49,Player A
1186,QLearningPlayer,319,49,368,0,44,Player A
1187,QLearningPlayer,307,52,359,0,47,Player A
1188,QLearningPlayer,311,51,362,0,46,Player A
1189,QLearningPlayer,279,59,338,0,54,Player A
1190,QLearningPlayer,323,48,371,0,43,Player A
1191,QLearningPlayer,282,67,349,2,51,Player A
1192,QLearningPlayer,299,54,353,0,49,Player A
1193,QLearningPlayer,300,65,365,3,46,Player A
1194,QLearningPlayer,291,56,347,0,51,Player A
1195,QLearningPlayer,290,70,360,4,48,Player A
1196,QLearningPlayer,286,61,347,0,51,Player A
1197,QLearningPlayer,240,145,385,14,43,Player A
1198,QLearningPlayer,282,72,354,4,50,Player A
1199,QLearningPlayer,278,63,341,0,53,Player A
1200,QLearningPlayer,283,58,341,0,53,Player A
1201,QLearningPlayer,261,66,327,1,58,Player A
1202,QLearningPlayer,291,56,347,0,51,Player A
1203,QLearningPlayer,307,52,359,0,47,Player A
1204,QLearningPlayer,283,58,341,0,53,Player A
1205,QLearningPlayer,296,61,357,1,48,Player A
1206,QLearningPlayer,315,50,365,0,45,Player A
1207,QLearningPlayer,319,49,368,0,44,Player A
1208,QLearningPlayer,311,51,362,0,46,Player A
1209,QLearningPlayer,296,61,357,1,48,Player A
1210,QLearningPlayer,264,69,333,1,56,Player A
1211,QLearningPlayer,294,84,378,7,43,Player A
1212,QLearningPlayer,283,68,351,4,51,Player A
1213,QLearningPlayer,304,59,363,1,46,Player A
1214,QLearningPlayer,302,57,359,0,47,Player A
1215,QLearningPlayer,312,82,394,5,37,Player A
1216,QLearningPlayer,250,175,425,21,32,Player A
1217,QLearningPlayer,296,81,377,9,44,Player A
1218,QLearningPlayer,212,197,409,17,36,Player A
1219,QLearningPlayer,319,49,368,0,44,Player A
1220,QLearningPlayer,240,90,330,7,59,Player A
1221,QLearningPlayer,274,104,378,10,44,Player A
1222,QLearningPlayer,323,58,381,1,40,Player A
1223,QLearningPlayer,240,240,480,37,19,Tie
1224,QLearningPlayer,323,48,371,0,43,Player A
1225,QLearningPlayer,243,148,391,14,41,Player A
1226,QLearningPlayer,268,88,356,6,50,Player A
1227,QLearningPlayer,292,62,354,1,49,Player A
1228,QLearningPlayer,276,71,347,3,52,Player A
1229,QLearningPlayer,266,81,347,3,52,Player A
1230,QLearningPlayer,284,69,353,3,50,Player A
1231,QLearningPlayer,331,46,377,0,41,Player A
1232,QLearningPlayer,299,54,353,0,49,Player A
1233,QLearningPlayer,291,56,347,0,51,Player A
1234,QLearningPlayer,276,66,342,1,53,Player A
1235,QLearningPlayer,295,55,350,0,50,Player A
1236,QLearningPlayer,283,58,341,0,53,Player A
1237,QLearningPlayer,335,45,380,0,40,Player A
1238,QLearningPlayer,291,56,347,0,51,Player A
1239,QLearningPlayer,280,70,350,3,51,Player A
1240,QLearningPlayer,315,50,365,0,45,Player A
1241,QLearningPlayer,276,71,347,3,52,Player A
1242,QLearningPlayer,280,65,345,1,52,Player A
1243,QLearningPlayer,272,67,339,1,54,Player A
1244,QLearningPlayer,294,69,363,4,47,Player A
1245,QLearningPlayer,299,54,353,0,49,Player A
1246,QLearningPlayer,315,50,365,0,45,Player A
1247,QLearningPlayer,303,53,356,0,48,Player A
1248,QLearningPlayer,299,54,353,0,49,Player A
1249,QLearningPlayer,280,70,350,3,51,Player A
1250,QLearningPlayer,315,50,365,0,45,Player A
1251,QLearningPlayer,278,68,346,2,52,Player A
1252,QLearningPlayer,257,77,334,2,56,Player A
1253,QLearningPlayer,296,76,372,4,44,Player A
1254,QLearningPlayer,299,54,353,0,49,Player A
1255,QLearningPlayer,277,62,339,1,54,Player A
1256,QLearningPlayer,299,69,368,3,45,Player A
1257,QLearningPlayer,257,97,354,7,51,Player A
1258,QLearningPlayer,268,88,356,6,50,Player A
1259,QLearningPlayer,266,71,337,2,55,Player A
1260,QLearningPlayer,241,121,362,9,49,Player A
1261,QLearningPlayer,297,57,354,1,49,Player A
1262,QLearningPlayer,304,64,368,3,45,Player A
1263,QLearningPlayer,263,78,341,3,54,Player A
1264,QLearningPlayer,311,56,367,2,45,Player A
1265,QLearningPlayer,304,59,363,1,46,Player A
1266,QLearningPlayer,274,64,338,0,54,Player A
1267,QLearningPlayer,335,45,380,0,40,Player A
1268,QLearningPlayer,246,101,347,9,54,Player A
1269,QLearningPlayer,316,51,367,2,45,Player A
1270,QLearningPlayer,257,92,349,5,52,Player A
1271,QLearningPlayer,308,58,366,4,46,Player A
1272,QLearningPlayer,224,179,403,20,39,Player A
1273,QLearningPlayer,299,64,363,1,46,Player A
1274,QLearningPlayer,316,46,362,0,46,Player A
1275,QLearningPlayer,299,54,353,0,49,Player A
1276,QLearningPlayer,264,69,333,1,56,Player A
1277,QLearningPlayer,316,61,377,3,42,Player A
1278,QLearningPlayer,284,94,378,7,43,Player A
1279,QLearningPlayer,275,85,360,4,48,Player A
1280,QLearningPlayer,284,74,358,5,49,Player A
1281,QLearningPlayer,273,78,351,4,51,Player A
1282,QLearningPlayer,315,50,365,0,45,Player A
1283,QLearningPlayer,311,51,362,0,46,Player A
1284,QLearningPlayer,292,62,354,1,49,Player A
1285,QLearningPlayer,326,61,387,4,39,Player A
1286,QLearningPlayer,276,81,357,4,49,Player A
1287,QLearningPlayer,300,60,360,1,47,Player A
1288,QLearningPlayer,319,49,368,0,44,Player A
1289,QLearningPlayer,311,51,362,0,46,Player A
1290,QLearningPlayer,290,65,355,2,49,Player A
1291,QLearningPlayer,314,59,373,2,43,Player A
1292,QLearningPlayer,295,55,350,0,50,Player A
1293,QLearningPlayer,291,56,347,0,51,Player A
1294,QLearningPlayer,291,76,367,5,46,Player A
1295,QLearningPlayer,306,66,372,4,44,Player A
1296,QLearningPlayer,319,49,368,0,44,Player A
1297,QLearningPlayer,283,58,341,0,53,Player A
1298,QLearningPlayer,280,95,375,10,45,Player A
1299,QLearningPlayer,312,62,374,3,43,Player A
1300,QLearningPlayer,300,60,360,1,47,Player A
1301,QLearningPlayer,318,58,376,2,42,Player A
1302,QLearningPlayer,323,63,386,6,40,Player A
1303,QLearningPlayer,300,60,360,1,47,Player A
1304,QLearningPlayer,298,63,361,2,47,Player A
1305,QLearningPlayer,282,67,349,2,51,Player A
1306,QLearningPlayer,290,75,365,6,47,Player A
1307,QLearningPlayer,305,65,370,2,44,Player A
1308,QLearningPlayer,297,57,354,1,49,Player A
1309,QLearningPlayer,288,63,351,1,50,Player A
1310,QLearningPlayer,280,75,355,5,50,Player A
1311,QLearningPlayer,325,65,390,4,38,Player A
1312,QLearningPlayer,277,62,339,1,54,Player A
1313,QLearningPlayer,295,55,350,0,50,Player A
1314,QLearningPlayer,287,97,384,7,41,Player A
1315,QLearningPlayer,323,48,371,0,43,Player A
1316,QLearningPlayer,305,55,360,1,47,Player A
1317,QLearningPlayer,298,73,371,3,44,Player A
1318,QLearningPlayer,311,51,362,0,46,Player A
1319,QLearningPlayer,309,64,373,2,43,Player A
1320,QLearningPlayer,267,62,329,0,57,Player A
1321,QLearningPlayer,311,56,367,2,45,Player A
1322,QLearningPlayer,318,58,376,2,42,Player A
1323,QLearningPlayer,305,60,365,3,46,Player A
1324,QLearningPlayer,277,102,379,11,44,Player A
1325,QLearningPlayer,276,76,352,2,50,Player A
1326,QLearningPlayer,283,73,356,3,49,Player A
1327,QLearningPlayer,291,56,347,0,51,Player A
1328,QLearningPlayer,300,65,365,3,46,Player A
1329,QLearningPlayer,314,59,373,2,43,Player A
1330,QLearningPlayer,325,50,375,1,42,Player A
1331,QLearningPlayer,282,147,429,19,30,Player A
1332,QLearningPlayer,278,113,391,8,39,Player A
1333,QLearningPlayer,292,62,354,1,49,Player A
1334,QLearningPlayer,291,56,347,0,51,Player A
1335,QLearningPlayer,271,86,357,7,50,Player A
1336,QLearningPlayer,264,84,348,4,52,Player A
1337,QLearningPlayer,312,57,369,1,44,Player A
1338,QLearningPlayer,298,68,366,4,46,Player A
1339,QLearningPlayer,307,52,359,0,47,Player A
1340,QLearningPlayer,291,56,347,0,51,Player A
1341,QLearningPlayer,292,82,374,6,44,Player A
1342,QLearningPlayer,264,69,333,1,56,Player A
1343,QLearningPlayer,319,49,368,0,44,Player A
1344,QLearningPlayer,302,62,364,2,46,Player A
1345,QLearningPlayer,311,51,362,0,46,Player A
1346,QLearningPlayer,307,52,359,0,47,Player A
1347,QLearningPlayer,335,45,380,0,40,Player A
1348,QLearningPlayer,291,56,347,0,51,Player A
1349,QLearningPlayer,302,57,359,0,47,Player A
1350,QLearningPlayer,323,48,371,0,43,Player A
1351,QLearningPlayer,292,62,354,1,49,Player A
1352,QLearningPlayer,271,61,332,0,56,Player A
1353,QLearningPlayer,247,97,344,6,54,Player A
1354,QLearningPlayer,292,72,364,5,47,Player A
1355,QLearningPlayer,297,62,359,3,48,Player A
1356,QLearningPlayer,265,100,365,9,48,Player A
1357,QLearningPlayer,303,53,356,0,48,Player A
1358,QLearningPlayer,285,85,370,5,45,Player A
1359,QLearningPlayer,282,122,404,18,38,Player A
1360,QLearningPlayer,314,59,373,2,43,Player A
1361,QLearningPlayer,299,54,353,0,49,Player A
1362,QLearningPlayer,272,67,339,1,54,Player A
1363,QLearningPlayer,286,66,352,2,50,Player A
1364,QLearningPlayer,294,59,353,0,49,Player A
1365,QLearningPlayer,312,62,374,3,43,Player A
1366,QLearningPlayer,299,54,353,0,49,Player A
1367,QLearningPlayer,303,53,356,0,48,Player A
1368,QLearningPlayer,266,71,337,2,55,Player A
1369,QLearningPlayer,294,64,358,2,48,Player A
1370,QLearningPlayer,294,59,353,0,49,Player A
1371,QLearningPlayer,299,54,353,0,49,Player A
1372,QLearningPlayer,325,50,375,1,42,Player A
1373,QLearningPlayer,298,58,356,0,48,Player A
1374,QLearningPlayer,308,53,361,2,47,Player A
1375,QLearningPlayer,281,106,387,7,40,Player A
1376,QLearningPlayer,251,211,462,34,24,Player A
1377,QLearningPlayer,291,56,347,0,51,Player A
1378,QLearningPlayer,287,57,344,0,52,Player A
1379,QLearningPlayer,275,60,335,0,55,Player A
1380,QLearningPlayer,302,57,359,0,47,Player A
1381,QLearningPlayer,320,60,380,3,41,Player A
1382,QLearningPlayer,280,120,400,11,37,Player A
1383,QLearningPlayer,287,57,344,0,52,Player A
1384,QLearningPlayer,283,83,366,7,47,Player A
1385,QLearningPlayer,304,64,368,3,45,Player A
1386,QLearningPlayer,292,62,354,1,49,Player A
1387,QLearningPlayer,261,76,337,2,55,Player A
1388,QLearningPlayer,275,75,350,3,51,Player A
1389,QLearningPlayer,287,57,344,0,52,Player A
1390,QLearningPlayer,287,57,344,0,52,Player A
1391,QLearningPlayer,296,61,357,1,48,Player A
1392,QLearningPlayer,286,66,352,2,50,Player A
1393,QLearningPlayer,312,57,369,1,44,Player A
1394,QLearningPlayer,349,44,393,1,36,Player A
1395,QLearningPlayer,262,67,329,0,57,Player A
1396,QLearningPlayer,295,55,350,0,50,Player A
1397,QLearningPlayer,307,52,359,0,47,Player A
1398,QLearningPlayer,304,69,373,5,44,Player A
1399,QLearningPlayer,299,64,363,1,46,Player A
1400,QLearningPlayer,329,49,378,1,41,Player A
1401,QLearningPlayer,251,76,327,1,58,Player A
1402,QLearningPlayer,308,68,376,5,43,Player A
1403,QLearningPlayer,323,48,371,0,43,Player A
1404,QLearningPlayer,275,60,335,0,55,Player A
1405,QLearningPlayer,276,66,342,1,53,Player A
1406,QLearningPlayer,327,47,374,0,42,Player A
1407,QLearningPlayer,280,75,355,5,50,Player A
1408,QLearningPlayer,330,50,380,0,40,Player A
1409,QLearningPlayer,310,70,380,6,42,Player A
1410,QLearningPlayer,329,54,383,3,40,Player A
1411,QLearningPlayer,307,62,369,1,44,Player A
1412,QLearningPlayer,222,142,364,14,50,Player A
1413,QLearningPlayer,275,60,335,0,55,Player A
1414,QLearningPlayer,327,47,374,0,42,Player A
1415,QLearningPlayer,287,57,344,0,52,Player A
1416,QLearningPlayer,281,81,362,6,48,Player A
1417,QLearningPlayer,298,58,356,0,48,Player A
1418,QLearningPlayer,329,49,378,1,41,Player A
1419,QLearningPlayer,265,100,365,6,47,Player A
1420,QLearningPlayer,303,53,356,0,48,Player A
1421,QLearningPlayer,315,65,380,3,41,Player A
1422,QLearningPlayer,303,58,361,2,47,Player A
1423,QLearningPlayer,312,62,374,3,43,Player A
1424,QLearningPlayer,295,60,355,2,49,Player A
1425,QLearningPlayer,302,62,364,2,46,Player A
1426,QLearningPlayer,315,60,375,1,42,Player A
1427,QLearningPlayer,312,47,359,0,47,Player A
1428,QLearningPlayer,259,79,338,3,55,Player A
1429,QLearningPlayer,244,144,388,14,42,Player A
1430,QLearningPlayer,302,62,364,2,46,Player A
1431,QLearningPlayer,290,65,355,2,49,Player A
1432,QLearningPlayer,304,64,368,3,45,Player A
1433,QLearningPlayer,294,64,358,2,48,Player A
1434,QLearningPlayer,256,71,327,1,58,Player A
1435,QLearningPlayer,304,59,363,1,46,Player A
1436,QLearningPlayer,343,43,386,0,38,Player A
1437,QLearningPlayer,321,51,372,1,43,Player A
1438,QLearningPlayer,311,51,362,0,46,Player A
1439,QLearningPlayer,325,60,385,2,39,Player A
1440,QLearningPlayer,307,52,359,0,47,Player A
1441,QLearningPlayer,307,52,359,0,47,Player A
1442,QLearningPlayer,311,51,362,0,46,Player A
1443,QLearningPlayer,297,67,364,2,46,Player A
1444,QLearningPlayer,307,52,359,0,47,Player A
1445,QLearningPlayer,303,53,356,0,48,Player A
1446,QLearningPlayer,206,246,452,30,26,QLearningPlayer
1447,QLearningPlayer,287,67,354,1,49,Player A
1448,QLearningPlayer,291,56,347,0,51,Player A
1449,QLearningPlayer,284,64,348,1,51,Player A
1450,QLearningPlayer,259,64,323,0,59,Player A
1451,QLearningPlayer,307,52,359,0,47,Player A
1452,QLearningPlayer,284,64,348,1,51,Player A
1453,QLearningPlayer,259,64,323,0,59,Player A
1454,QLearningPlayer,309,79,388,5,39,Player A
1455,QLearningPlayer,306,66,372,4,44,Player A
1456,QLearningPlayer,260,85,345,4,53,Player A
1457,QLearningPlayer,299,54,353,0,49,Player A
1458,QLearningPlayer,300,60,360,1,47,Player A
1459,QLearningPlayer,288,63,351,1,50,Player A
1460,QLearningPlayer,298,63,361,2,47,Player A
1461,QLearningPlayer,309,54,363,1,46,Player A
1462,QLearningPlayer,345,45,390,1,37,Player A
1463,QLearningPlayer,278,98,376,11,45,Player A
1464,QLearningPlayer,308,58,366,1,45,Player A
1465,QLearningPlayer,295,55,350,0,50,Player A
1466,QLearningPlayer,266,66,332,0,56,Player A
1467,QLearningPlayer,347,42,389,0,37,Player A
1468,QLearningPlayer,262,77,339,4,55,Player A
1469,QLearningPlayer,257,97,354,7,51,Player A
1470,QLearningPlayer,307,52,359,0,47,Player A
1471,QLearningPlayer,286,66,352,2,50,Player A
1472,QLearningPlayer,276,66,342,1,53,Player A
1473,QLearningPlayer,269,74,343,2,53,Player A
1474,QLearningPlayer,321,51,372,1,43,Player A
1475,QLearningPlayer,274,74,348,4,52,Player A
1476,QLearningPlayer,302,67,369,4,45,Player A
1477,QLearningPlayer,287,102,389,9,40,Player A
1478,QLearningPlayer,287,72,359,3,48,Player A
1479,QLearningPlayer,247,82,329,3,58,Player A
1480,QLearningPlayer,322,57,379,2,41,Player A
1481,QLearningPlayer,315,50,365,0,45,Player A
1482,QLearningPlayer,310,70,380,6,42,Player A
1483,QLearningPlayer,292,67,359,3,48,Player A
1484,QLearningPlayer,311,51,362,0,46,Player A
1485,QLearningPlayer,252,72,324,1,59,Player A
1486,QLearningPlayer,311,51,362,0,46,Player A
1487,QLearningPlayer,315,50,365,0,45,Player A
1488,QLearningPlayer,312,57,369,1,44,Player A
1489,QLearningPlayer,298,63,361,2,47,Player A
1490,QLearningPlayer,311,51,362,0,46,Player A
1491,QLearningPlayer,283,58,341,0,53,Player A
1492,QLearningPlayer,284,84,368,6,46,Player A
1493,QLearningPlayer,299,54,353,0,49,Player A
1494,QLearningPlayer,289,99,388,11,41,Player A
1495,QLearningPlayer,250,105,355,8,51,Player A
1496,QLearningPlayer,304,64,368,3,45,Player A
1497,QLearningPlayer,278,63,341,0,53,Player A
1498,QLearningPlayer,335,45,380,0,40,Player A
1499,QLearningPlayer,289,69,358,2,48,Player A
1500,QLearningPlayer,310,60,370,2,44,Player A
1501,QLearningPlayer,269,84,353,6,51,Player A
1502,QLearningPlayer,295,55,350,0,50,Player A
1503,QLearningPlayer,287,57,344,0,52,Player A
1504,QLearningPlayer,295,55,350,0,50,Player A
1505,QLearningPlayer,267,87,354,7,51,Player A
1506,QLearningPlayer,273,113,386,12,42,Player A
1507,QLearningPlayer,323,48,371,0,43,Player A
1508,QLearningPlayer,320,55,375,1,42,Player A
1509,QLearningPlayer,311,51,362,0,46,Player A
1510,QLearningPlayer,291,56,347,0,51,Player A
1511,QLearningPlayer,293,58,351,1,50,Player A
1512,QLearningPlayer,298,98,396,7,37,Player A
1513,QLearningPlayer,295,55,350,0,50,Player A
1514,QLearningPlayer,280,70,350,3,51,Player A
1515,QLearningPlayer,294,59,353,0,49,Player A
1516,QLearningPlayer,271,61,332,0,56,Player A
1517,QLearningPlayer,319,49,368,0,44,Player A
1518,QLearningPlayer,295,55,350,0,50,Player A
1519,QLearningPlayer,298,68,366,4,46,Player A
1520,QLearningPlayer,300,60,360,1,47,Player A
1521,QLearningPlayer,305,55,360,1,47,Player A
1522,QLearningPlayer,294,64,358,2,48,Player A
1523,QLearningPlayer,288,63,351,1,50,Player A
1524,QLearningPlayer,271,66,337,2,55,Player A
1525,QLearningPlayer,299,64,363,1,46,Player A
1526,QLearningPlayer,303,53,356,0,48,Player A
1527,QLearningPlayer,270,65,335,0,55,Player A
1528,QLearningPlayer,314,49,363,1,46,Player A
1529,QLearningPlayer,279,104,383,9,42,Player A
1530,QLearningPlayer,303,53,356,0,48,Player A
1531,QLearningPlayer,314,84,398,6,36,Player A
1532,QLearningPlayer,271,61,332,0,56,Player A
1533,QLearningPlayer,307,62,369,1,44,Player A
1534,QLearningPlayer,315,50,365,0,45,Player A
1535,QLearningPlayer,307,52,359,0,47,Player A
1536,QLearningPlayer,302,72,374,6,44,Player A
1537,QLearningPlayer,286,66,352,2,50,Player A
1538,QLearningPlayer,301,81,382,5,41,Player A
1539,QLearningPlayer,299,54,353,0,49,Player A
1540,QLearningPlayer,291,56,347,0,51,Player A
1541,QLearningPlayer,327,47,374,0,42,Player A
1542,QLearningPlayer,306,66,372,4,44,Player A
1543,QLearningPlayer,275,90,365,3,46,Player A
1544,QLearningPlayer,315,50,365,0,45,Player A
1545,QLearningPlayer,295,55,350,0,50,Player A
1546,QLearningPlayer,275,70,345,1,52,Player A
1547,QLearningPlayer,299,54,353,0,49,Player A
1548,QLearningPlayer,287,57,344,0,52,Player A
1549,QLearningPlayer,299,54,353,0,49,Player A
1550,QLearningPlayer,279,59,338,0,54,Player A
1551,QLearningPlayer,291,71,362,3,47,Player A
1552,QLearningPlayer,294,94,388,11,41,Player A
1553,QLearningPlayer,319,49,368,0,44,Player A
1554,QLearningPlayer,302,77,379,8,43,Player A
1555,QLearningPlayer,283,68,351,1,50,Player A
1556,QLearningPlayer,299,54,353,0,49,Player A
1557,QLearningPlayer,319,49,368,0,44,Player A
1558,QLearningPlayer,283,58,341,0,53,Player A
1559,QLearningPlayer,332,57,389,3,38,Player A
1560,QLearningPlayer,283,58,341,0,53,Player A
1561,QLearningPlayer,271,61,332,0,56,Player A
1562,QLearningPlayer,287,57,344,0,52,Player A
1563,QLearningPlayer,294,59,353,0,49,Player A
1564,QLearningPlayer,292,67,359,3,48,Player A
1565,QLearningPlayer,271,76,347,3,52,Player A
1566,QLearningPlayer,295,60,355,2,49,Player A
1567,QLearningPlayer,297,67,364,2,46,Player A
1568,QLearningPlayer,263,63,326,0,58,Player A
1569,QLearningPlayer,291,56,347,0,51,Player A
1570,QLearningPlayer,343,43,386,0,38,Player A
1571,QLearningPlayer,327,47,374,0,42,Player A
1572,QLearningPlayer,266,76,342,4,54,Player A
1573,QLearningPlayer,315,50,365,0,45,Player A
1574,QLearningPlayer,307,52,359,0,47,Player A
1575,QLearningPlayer,279,79,358,5,49,Player A
1576,QLearningPlayer,290,75,365,6,47,Player A
1577,QLearningPlayer,289,79,368,3,45,Player A
1578,QLearningPlayer,286,61,347,0,51,Player A
1579,QLearningPlayer,311,51,362,0,46,Player A
1580,QLearningPlayer,308,48,356,0,48,Player A
1581,QLearningPlayer,279,59,338,0,54,Player A
1582,QLearningPlayer,279,59,338,0,54,Player A
1583,QLearningPlayer,281,76,357,4,49,Player A
1584,QLearningPlayer,275,60,335,0,55,Player A
1585,QLearningPlayer,286,86,372,7,45,Player A
1586,QLearningPlayer,302,62,364,2,46,Player A
1587,QLearningPlayer,307,52,359,0,47,Player A
1588,QLearningPlayer,295,55,350,0,50,Player A
1589,QLearningPlayer,272,67,339,1,54,Player A
1590,QLearningPlayer,315,50,365,0,45,Player A
1591,QLearningPlayer,269,74,343,2,53,Player A
1592,QLearningPlayer,299,54,353,0,49,Player A
1593,QLearningPlayer,310,65,375,4,43,Player A
1594,QLearningPlayer,302,62,364,2,46,Player A
1595,QLearningPlayer,259,89,348,4,52,Player A
1596,QLearningPlayer,327,47,374,0,42,Player A
1597,QLearningPlayer,299,54,353,0,49,Player A
1598,QLearningPlayer,303,53,356,0,48,Player A
1599,QLearningPlayer,309,54,363,1,46,Player A
1600,QLearningPlayer,315,50,365,0,45,Player A
1601,QLearningPlayer,279,59,338,0,54,Player A
1602,QLearningPlayer,327,47,374,0,42,Player A
1603,QLearningPlayer,353,43,396,1,35,Player A
1604,QLearningPlayer,327,47,374,0,42,Player A
1605,QLearningPlayer,303,53,356,0,48,Player A
1606,QLearningPlayer,314,59,373,2,43,Player A
1607,QLearningPlayer,287,57,344,0,52,Player A
1608,QLearningPlayer,315,50,365,0,45,Player A
1609,QLearningPlayer,287,57,344,0,52,Player A
1610,QLearningPlayer,260,125,385,11,42,Player A
1611,QLearningPlayer,303,53,356,0,48,Player A
1612,QLearningPlayer,277,72,349,2,51,Player A
1613,QLearningPlayer,290,80,370,8,46,Player A
1614,QLearningPlayer,274,64,338,0,54,Player A
1615,QLearningPlayer,291,56,347,0,51,Player A
1616,QLearningPlayer,264,69,333,1,56,Player A
1617,QLearningPlayer,311,56,367,2,45,Player A
1618,QLearningPlayer,308,58,366,1,45,Player A
1619,QLearningPlayer,323,48,371,0,43,Player A
1620,QLearningPlayer,284,64,348,1,51,Player A
1621,QLearningPlayer,315,50,365,0,45,Player A
1622,QLearningPlayer,279,59,338,0,54,Player A
1623,QLearningPlayer,311,51,362,0,46,Player A
1624,QLearningPlayer,287,57,344,0,52,Player A
1625,QLearningPlayer,313,53,366,1,45,Player A
1626,QLearningPlayer,280,70,350,3,51,Player A
1627,QLearningPlayer,301,81,382,8,42,Player A
1628,QLearningPlayer,298,63,361,2,47,Player A
1629,QLearningPlayer,330,45,375,1,42,Player A
1630,QLearningPlayer,280,65,345,1,52,Player A
1631,QLearningPlayer,255,80,335,3,56,Player A
1632,QLearningPlayer,320,55,375,1,42,Player A
1633,QLearningPlayer,308,58,366,1,45,Player A
1634,QLearningPlayer,320,55,375,1,42,Player A
1635,QLearningPlayer,299,54,353,0,49,Player A
1636,QLearningPlayer,286,106,392,12,40,Player A
1637,QLearningPlayer,291,56,347,0,51,Player A
1638,QLearningPlayer,315,50,365,0,45,Player A
1639,QLearningPlayer,288,63,351,1,50,Player A
1640,QLearningPlayer,304,69,373,5,44,Player A
1641,QLearningPlayer,299,54,353,0,49,Player A
1642,QLearningPlayer,287,57,344,0,52,Player A
1643,QLearningPlayer,278,63,341,0,53,Player A
1644,QLearningPlayer,306,61,367,2,45,Player A
1645,QLearningPlayer,307,52,359,0,47,Player A
1646,QLearningPlayer,268,68,336,1,55,Player A
1647,QLearningPlayer,240,75,315,1,62,Player A
1648,QLearningPlayer,306,61,367,2,45,Player A
1649,QLearningPlayer,332,52,384,1,39,Player A
1650,QLearningPlayer,306,71,377,6,43,Player A
1651,QLearningPlayer,282,72,354,4,50,Player A
1652,QLearningPlayer,309,64,373,2,43,Player A
1653,QLearningPlayer,282,62,344,0,52,Player A
1654,QLearningPlayer,307,62,369,1,44,Player A
1655,QLearningPlayer,311,51,362,0,46,Player A
1656,QLearningPlayer,329,59,388,5,39,Player A
1657,QLearningPlayer,253,88,341,6,55,Player A
1658,QLearningPlayer,325,50,375,1,42,Player A
1659,QLearningPlayer,300,60,360,1,47,Player A
1660,QLearningPlayer,291,56,347,0,51,Player A
1661,QLearningPlayer,275,70,345,1,52,Player A
1662,QLearningPlayer,284,84,368,6,46,Player A
1663,QLearningPlayer,315,50,365,0,45,Player A
1664,QLearningPlayer,279,59,338,0,54,Player A
1665,QLearningPlayer,276,76,352,5,51,Player A
1666,QLearningPlayer,284,64,348,1,51,Player A
1667,QLearningPlayer,335,45,380,0,40,Player A
1668,QLearningPlayer,323,53,376,2,42,Player A
1669,QLearningPlayer,274,79,353,3,50,Player A
1670,QLearningPlayer,315,50,365,0,45,Player A
1671,QLearningPlayer,329,49,378,1,41,Player A
1672,QLearningPlayer,309,64,373,2,43,Player A
1673,QLearningPlayer,287,57,344,0,52,Player A
1674,QLearningPlayer,287,57,344,0,52,Player A
1675,QLearningPlayer,291,56,347,0,51,Player A
1676,QLearningPlayer,289,59,348,1,51,Player A
1677,QLearningPlayer,319,54,373,2,43,Player A
1678,QLearningPlayer,275,75,350,3,51,Player A
1679,QLearningPlayer,289,69,358,2,48,Player A
1680,QLearningPlayer,307,52,359,0,47,Player A
1681,QLearningPlayer,295,55,350,0,50,Player A
1682,QLearningPlayer,288,53,341,0,53,Player A
1683,QLearningPlayer,298,63,361,2,47,Player A
1684,QLearningPlayer,250,70,320,0,60,Player A
1685,QLearningPlayer,287,57,344,0,52,Player A
1686,QLearningPlayer,281,81,362,6,48,Player A
1687,QLearningPlayer,299,54,353,0,49,Player A
1688,QLearningPlayer,286,71,357,4,49,Player A
1689,QLearningPlayer,312,57,369,1,44,Player A
1690,QLearningPlayer,272,67,339,1,54,Player A
1691,QLearningPlayer,291,71,362,3,47,Player A
1692,QLearningPlayer,314,59,373,2,43,Player A
1693,QLearningPlayer,306,61,367,2,45,Player A
1694,QLearningPlayer,329,49,378,1,41,Player A
1695,QLearningPlayer,285,75,360,4,48,Player A
1696,QLearningPlayer,268,73,341,3,54,Player A
1697,QLearningPlayer,321,51,372,1,43,Player A
1698,QLearningPlayer,279,69,348,1,51,Player A
1699,QLearningPlayer,307,52,359,0,47,Player A
1700,QLearningPlayer,270,100,370,8,46,Player A
1701,QLearningPlayer,299,54,353,0,49,Player A
1702,QLearningPlayer,290,110,400,11,37,Player A
1703,QLearningPlayer,294,79,373,5,44,Player A
1704,QLearningPlayer,287,57,344,0,52,Player A
1705,QLearningPlayer,267,62,329,0,57,Player A
1706,QLearningPlayer,309,64,373,2,43,Player A
1707,QLearningPlayer,303,53,356,0,48,Player A
1708,QLearningPlayer,307,57,364,2,46,Player A
1709,QLearningPlayer,237,92,329,6,59,Player A
1710,QLearningPlayer,281,91,372,7,45,Player A
1711,QLearningPlayer,285,60,345,1,52,Player A
1712,QLearningPlayer,291,66,357,1,48,Player A
1713,QLearningPlayer,309,54,363,1,46,Player A
1714,QLearningPlayer,297,92,389,6,39,Player A
1715,QLearningPlayer,279,59,338,0,54,Player A
1716,QLearningPlayer,274,64,338,0,54,Player A
1717,QLearningPlayer,267,62,329,0,57,Player A
1718,QLearningPlayer,323,48,371,0,43,Player A
1719,QLearningPlayer,319,49,368,0,44,Player A
1720,QLearningPlayer,335,45,380,0,40,Player A
1721,QLearningPlayer,311,51,362,0,46,Player A
1722,QLearningPlayer,323,48,371,0,43,Player A
1723,QLearningPlayer,299,54,353,0,49,Player A
1724,QLearningPlayer,297,67,364,5,47,Player A
1725,QLearningPlayer,285,75,360,4,48,Player A
1726,QLearningPlayer,321,56,377,3,42,Player A
1727,QLearningPlayer,299,79,378,7,43,Player A
1728,QLearningPlayer,287,82,369,4,45,Player A
1729,QLearningPlayer,280,65,345,1,52,Player A
1730,QLearningPlayer,251,81,332,3,57,Player A
1731,QLearningPlayer,301,56,357,1,48,Player A
1732,QLearningPlayer,305,55,360,1,47,Player A
1733,QLearningPlayer,302,62,364,2,46,Player A
1734,QLearningPlayer,319,49,368,0,44,Player A
1735,QLearningPlayer,220,250,470,36,22,QLearningPlayer
1736,QLearningPlayer,276,66,342,1,53,Player A
1737,QLearningPlayer,274,89,363,4,47,Player A
1738,QLearningPlayer,333,48,381,1,40,Player A
1739,QLearningPlayer,355,40,395,0,35,Player A
1740,QLearningPlayer,299,54,353,0,49,Player A
1741,QLearningPlayer,319,49,368,0,44,Player A
1742,QLearningPlayer,239,79,318,1,61,Player A
1743,QLearningPlayer,337,47,384,1,39,Player A
1744,QLearningPlayer,291,91,382,8,42,Player A
1745,QLearningPlayer,301,71,372,4,44,Player A
1746,QLearningPlayer,335,45,380,0,40,Player A
1747,QLearningPlayer,345,45,390,1,37,Player A
1748,QLearningPlayer,301,71,372,4,44,Player A
1749,QLearningPlayer,328,53,381,1,40,Player A
1750,QLearningPlayer,283,58,341,0,53,Player A
1751,QLearningPlayer,279,84,363,4,47,Player A
1752,QLearningPlayer,323,48,371,0,43,Player A
1753,QLearningPlayer,283,58,341,0,53,Player A
1754,QLearningPlayer,290,105,395,12,39,Player A
1755,QLearningPlayer,297,67,364,5,47,Player A
1756,QLearningPlayer,313,63,376,2,42,Player A
1757,QLearningPlayer,298,63,361,2,47,Player A
1758,QLearningPlayer,258,73,331,2,57,Player A
1759,QLearningPlayer,288,63,351,1,50,Player A
1760,QLearningPlayer,307,52,359,0,47,Player A
1761,QLearningPlayer,299,89,388,11,41,Player A
1762,QLearningPlayer,322,52,374,0,42,Player A
1763,QLearningPlayer,323,48,371,0,43,Player A
1764,QLearningPlayer,245,115,360,7,49,Player A
1765,QLearningPlayer,299,54,353,0,49,Player A
1766,QLearningPlayer,303,53,356,0,48,Player A
1767,QLearningPlayer,286,71,357,4,49,Player A
1768,QLearningPlayer,271,136,407,15,36,Player A
1769,QLearningPlayer,258,178,436,17,27,Player A
1770,QLearningPlayer,315,50,365,0,45,Player A
1771,QLearningPlayer,277,67,344,3,53,Player A
1772,QLearningPlayer,306,56,362,0,46,Player A
1773,QLearningPlayer,289,59,348,1,51,Player A
1774,QLearningPlayer,276,66,342,1,53,Player A
1775,QLearningPlayer,287,57,344,0,52,Player A
1776,QLearningPlayer,261,91,352,5,51,Player A
1777,QLearningPlayer,279,69,348,1,51,Player A
1778,QLearningPlayer,307,52,359,0,47,Player A
1779,QLearningPlayer,297,57,354,1,49,Player A
1780,QLearningPlayer,283,73,356,3,49,Player A
1781,QLearningPlayer,252,112,364,8,48,Player A
1782,QLearningPlayer,320,55,375,1,42,Player A
1783,QLearningPlayer,288,63,351,1,50,Player A
1784,QLearningPlayer,280,55,335,0,55,Player A
1785,QLearningPlayer,283,83,366,7,47,Player A
1786,QLearningPlayer,310,60,370,2,44,Player A
1787,QLearningPlayer,303,53,356,0,48,Player A
1788,QLearningPlayer,277,72,349,2,51,Player A
1789,QLearningPlayer,316,56,372,1,43,Player A
1790,QLearningPlayer,291,56,347,0,51,Player A
1791,QLearningPlayer,286,111,397,11,38,Player A
1792,QLearningPlayer,279,59,338,0,54,Player A
1793,QLearningPlayer,316,56,372,1,43,Player A
1794,QLearningPlayer,295,55,350,0,50,Player A
1795,QLearningPlayer,247,157,404,18,38,Player A
1796,QLearningPlayer,302,67,369,4,45,Player A
1797,QLearningPlayer,294,64,358,2,48,Player A
1798,QLearningPlayer,337,47,384,1,39,Player A
1799,QLearningPlayer,295,55,350,0,50,Player A
1800,QLearningPlayer,303,53,356,0,48,Player A
1801,QLearningPlayer,279,59,338,0,54,Player A
1802,QLearningPlayer,307,52,359,0,47,Player A
1803,QLearningPlayer,315,50,365,0,45,Player A
1804,QLearningPlayer,258,73,331,2,57,Player A
1805,QLearningPlayer,291,56,347,0,51,Player A
1806,QLearningPlayer,308,63,371,3,44,Player A
1807,QLearningPlayer,299,54,353,0,49,Player A
1808,QLearningPlayer,290,75,365,3,46,Player A
1809,QLearningPlayer,311,51,362,0,46,Player A
1810,QLearningPlayer,257,82,339,4,55,Player A
1811,QLearningPlayer,310,60,370,2,44,Player A
1812,QLearningPlayer,312,62,374,3,43,Player A
1813,QLearningPlayer,304,79,383,6,41,Player A
1814,QLearningPlayer,327,52,379,2,41,Player A
1815,QLearningPlayer,309,64,373,2,43,Player A
1816,QLearningPlayer,312,62,374,3,43,Player A
1817,QLearningPlayer,273,73,346,2,52,Player A
1818,QLearningPlayer,284,64,348,1,51,Player A
1819,QLearningPlayer,290,60,350,0,50,Player A
1820,QLearningPlayer,276,71,347,3,52,Player A
1821,QLearningPlayer,277,62,339,1,54,Player A
1822,QLearningPlayer,310,55,365,0,45,Player A
1823,QLearningPlayer,321,76,397,5,36,Player A
1824,QLearningPlayer,291,56,347,0,51,Player A
1825,QLearningPlayer,315,50,365,0,45,Player A
1826,QLearningPlayer,297,57,354,1,49,Player A
1827,QLearningPlayer,296,61,357,1,48,Player A
1828,QLearningPlayer,303,53,356,0,48,Player A
1829,QLearningPlayer,275,65,340,2,54,Player A
1830,QLearningPlayer,296,61,357,1,48,Player A
1831,QLearningPlayer,295,55,350,0,50,Player A
1832,QLearningPlayer,309,59,368,3,45,Player A
1833,QLearningPlayer,303,63,366,1,45,Player A
1834,QLearningPlayer,272,67,339,1,54,Player A
1835,QLearningPlayer,284,54,338,0,54,Player A
1836,QLearningPlayer,311,51,362,0,46,Player A
1837,QLearningPlayer,307,52,359,0,47,Player A
1838,QLearningPlayer,307,52,359,0,47,Player A
1839,QLearningPlayer,323,48,371,0,43,Player A
1840,QLearningPlayer,307,52,359,0,47,Player A
1841,QLearningPlayer,287,57,344,0,52,Player A
1842,QLearningPlayer,288,73,361,5,48,Player A
1843,QLearningPlayer,286,61,347,0,51,Player A
1844,QLearningPlayer,290,70,360,4,48,Player A
1845,QLearningPlayer,286,66,352,2,50,Player A
1846,QLearningPlayer,347,67,414,10,32,Player A
1847,QLearningPlayer,245,90,335,3,56,Player A
1848,QLearningPlayer,286,66,352,2,50,Player A
1849,QLearningPlayer,295,55,350,0,50,Player A
1850,QLearningPlayer,263,78,341,3,54,Player A
1851,QLearningPlayer,307,52,359,0,47,Player A
1852,QLearningPlayer,306,66,372,1,43,Player A
1853,QLearningPlayer,279,59,338,0,54,Player A
1854,QLearningPlayer,281,76,357,4,49,Player A
0,PatternLearningPlayer,118,118,236,0,88,Tie
1,PatternLearningPlayer,116,111,227,0,91,Player A
2,PatternLearningPlayer,120,110,230,0,90,Player A
3,PatternLearningPlayer,120,110,230,0,90,Player A
4,PatternLearningPlayer,121,106,227,0,91,Player A
5,PatternLearningPlayer,123,113,236,0,88,Player A
6,PatternLearningPlayer,119,114,233,0,89,Player A
7,PatternLearningPlayer,119,114,233,0,89,Player A
8,PatternLearningPlayer,119,114,233,0,89,Player A
9,PatternLearningPlayer,123,113,236,0,88,Player A
10,PatternLearningPlayer,123,113,236,0,88,Player A
11,PatternLearningPlayer,111,116,227,0,91,PatternLearningPlayer
12,PatternLearningPlayer,119,114,233,0,89,Player A
13,PatternLearningPlayer,111,116,227,0,91,PatternLearningPlayer
14,PatternLearningPlayer,115,115,230,0,90,Tie
15,PatternLearningPlayer,115,115,230,0,90,Tie
16,PatternLearningPlayer,116,111,227,0,91,Player A
17,PatternLearningPlayer,115,115,230,0,90,Tie
18,PatternLearningPlayer,120,110,230,0,90,Player A
19,PatternLearningPlayer,124,109,233,0,89,Player A
20,PatternLearningPlayer,120,110,230,0,90,Player A
21,PatternLearningPlayer,128,108,236,0,88,Player A
22,PatternLearningPlayer,115,115,230,0,90,Tie
23,PatternLearningPlayer,125,105,230,0,90,Player A
24,PatternLearningPlayer,294,274,568,86,6,Player A
25,PatternLearningPlayer,114,119,233,0,89,PatternLearningPlayer
26,PatternLearningPlayer,120,110,230,0,90,Player A
27,PatternLearningPlayer,124,109,233,0,89,Player A
28,PatternLearningPlayer,120,110,230,0,90,Player A
29,PatternLearningPlayer,120,110,230,0,90,Player A
30,PatternLearningPlayer,119,114,233,0,89,Player A
31,PatternLearningPlayer,117,107,224,0,92,Player A
32,PatternLearningPlayer,296,296,592,98,2,Tie
33,PatternLearningPlayer,118,128,246,1,85,PatternLearningPlayer
34,PatternLearningPlayer,123,113,236,0,88,Player A
35,PatternLearningPlayer,123,113,236,0,88,Player A
36,PatternLearningPlayer,115,115,230,0,90,Tie
37,PatternLearningPlayer,119,114,233,0,89,Player A
38,PatternLearningPlayer,119,114,233,0,89,Player A
39,PatternLearningPlayer,111,116,227,0,91,PatternLearningPlayer
40,PatternLearningPlayer,124,109,233,0,89,Player A
41,PatternLearningPlayer,114,119,233,0,89,PatternLearningPlayer
42,PatternLearningPlayer,120,110,230,0,90,Player A
43,PatternLearningPlayer,124,109,233,0,89,Player A
44,PatternLearningPlayer,110,120,230,0,90,PatternLearningPlayer
45,PatternLearningPlayer,120,110,230,0,90,Player A
46,PatternLearningPlayer,110,120,230,0,90,PatternLearningPlayer
0,TitForTat,119,114,233,0,89,Player A
1,TitForTat,115,115,230,0,90,Tie
2,TitForTat,115,115,230,0,90,Tie
3,TitForTat,115,115,230,0,90,Tie
4,TitForTat,115,115,230,0,90,Tie
5,TitForTat,115,115,230,0,90,Tie
6,TitForTat,115,115,230,0,90,Tie
7,TitForTat,111,116,227,0,91,TitForTat
8,TitForTat,116,111,227,0,91,Player A
9,TitForTat,115,115,230,0,90,Tie
10,TitForTat,115,115,230,0,90,Tie
11,TitForTat,115,115,230,0,90,Tie
0,Bayesian,127,112,239,0,87,Player A
1,Bayesian,112,112,224,0,92,Tie
2,Bayesian,106,131,237,1,88,Bayesian
3,Bayesian,98,123,221,0,93,Bayesian
4,Bayesian,111,116,227,0,91,Bayesian
5,Bayesian,120,110,230,0,90,Player A
6,Bayesian,119,114,233,0,89,Player A
7,Bayesian,132,107,239,0,87,Player A
8,Bayesian,132,107,239,0,87,Player A
9,Bayesian,99,119,218,0,94,Bayesian
10,Bayesian,103,128,231,1,90,Bayesian
11,Bayesian,106,121,227,0,91,Bayesian
12,Bayesian,132,107,239,0,87,Player A
13,Bayesian,111,116,227,0,91,Bayesian
14,Bayesian,116,111,227,0,91,Player A
15,Bayesian,111,116,227,0,91,Bayesian
16,Bayesian,127,122,249,1,84,Player A
17,Bayesian,111,126,237,1,88,Bayesian
18,Bayesian,138,108,246,1,85,Player A
19,Bayesian,124,119,243,1,86,Player A
20,Bayesian,119,114,233,0,89,Player A
21,Bayesian,115,115,230,0,90,Tie
22,Bayesian,115,115,230,0,90,Tie
23,Bayesian,103,118,221,0,93,Bayesian
24,Bayesian,102,142,244,2,86,Bayesian
25,Bayesian,107,117,224,0,92,Bayesian
26,Bayesian,115,125,240,1,87,Bayesian
27,Bayesian,120,110,230,0,90,Player A
28,Bayesian,102,132,234,1,89,Bayesian
29,Bayesian,119,114,233,0,89,Player A
30,Bayesian,124,129,253,2,83,Bayesian
31,Bayesian,116,111,227,0,91,Player A
32,Bayesian,132,107,239,0,87,Player A
33,Bayesian,120,110,230,0,90,Player A
34,Bayesian,124,109,233,0,89,Player A
35,Bayesian,119,114,233,0,89,Player A
36,Bayesian,102,122,224,0,92,Bayesian
37,Bayesian,119,124,243,1,86,Bayesian
38,Bayesian,103,118,221,0,93,Bayesian
39,Bayesian,141,121,262,2,80,Player A
40,Bayesian,120,110,230,0,90,Player A
41,Bayesian,106,131,237,1,88,Bayesian
42,Bayesian,111,116,227,0,91,Bayesian
43,Bayesian,125,105,230,0,90,Player A
44,Bayesian,124,109,233,0,89,Player A
45,Bayesian,106,131,237,1,88,Bayesian
46,Bayesian,110,120,230,0,90,Bayesian
47,Bayesian,125,105,230,0,90,Player A
48,Bayesian,136,106,242,0,86,Player A
49,Bayesian,107,117,224,0,92,Bayesian
50,Bayesian,116,111,227,0,91,Player A
51,Bayesian,111,126,237,1,88,Bayesian
52,Bayesian,128,108,236,0,88,Player A
53,Bayesian,108,113,221,0,93,Bayesian
54,Bayesian,107,117,224,0,92,Bayesian
55,Bayesian,102,122,224,0,92,Bayesian
56,Bayesian,133,103,236,0,88,Player A
57,Bayesian,112,132,244,2,86,Bayesian
58,Bayesian,118,128,246,1,85,Bayesian
59,Bayesian,110,150,260,6,82,Bayesian
60,Bayesian,119,129,248,0,84,Bayesian
61,Bayesian,119,134,253,2,83,Bayesian
62,Bayesian,129,104,233,0,89,Player A
63,Bayesian,120,110,230,0,90,Player A
64,Bayesian,106,121,227,0,91,Bayesian
65,Bayesian,122,112,234,1,89,Player A
66,Bayesian,131,111,242,0,86,Player A
67,Bayesian,118,138,256,2,82,Bayesian
68,Bayesian,145,100,245,0,85,Player A
69,Bayesian,124,109,233,0,89,Player A
70,Bayesian,102,122,224,0,92,Bayesian
71,Bayesian,120,110,230,0,90,Player A
72,Bayesian,124,109,233,0,89,Player A
73,Bayesian,132,107,239,0,87,Player A
74,Bayesian,116,131,247,2,85,Bayesian
75,Bayesian,120,110,230,0,90,Player A
76,Bayesian,107,117,224,0,92,Bayesian
77,Bayesian,124,109,233,0,89,Player A
78,Bayesian,111,116,227,0,91,Bayesian
79,Bayesian,111,116,227,0,91,Bayesian
80,Bayesian,112,112,224,0,92,Tie
81,Bayesian,123,113,236,0,88,Player A
82,Bayesian,120,110,230,0,90,Player A
83,Bayesian,111,116,227,0,91,Bayesian
84,Bayesian,123,113,236,0,88,Player A
85,Bayesian,116,111,227,0,91,Player A
86,Bayesian,123,113,236,0,88,Player A
87,Bayesian,111,136,247,2,85,Bayesian
88,Bayesian,112,112,224,0,92,Tie
89,Bayesian,135,120,255,1,82,Player A
90,Bayesian,140,115,255,1,82,Player A
91,Bayesian,128,108,236,0,88,Player A
92,Bayesian,110,120,230,0,90,Bayesian
93,Bayesian,93,138,231,1,90,Bayesian
94,Bayesian,128,108,236,0,88,Player A
95,Bayesian,128,108,236,0,88,Player A
96,Bayesian,111,136,247,2,85,Bayesian
97,Bayesian,111,116,227,0,91,Bayesian
98,Bayesian,119,124,243,1,86,Bayesian
99,Bayesian,132,117,249,1,84,Player A
100,Bayesian,107,117,224,0,92,Bayesian
101,Bayesian,124,109,233,0,89,Player A
102,Bayesian,128,108,236,0,88,Player A
103,Bayesian,111,116,227,0,91,Bayesian
104,Bayesian,111,116,227,0,91,Bayesian
105,Bayesian,119,114,233,0,89,Player A
106,Bayesian,129,104,233,0,89,Player A
107,Bayesian,128,108,236,0,88,Player A
108,Bayesian,107,127,234,1,89,Bayesian
109,Bayesian,102,122,224,0,92,Bayesian
110,Bayesian,119,114,233,0,89,Player A
111,Bayesian,141,101,242,0,86,Player A
112,Bayesian,116,111,227,0,91,Player A
113,Bayesian,132,107,239,0,87,Player A
114,Bayesian,128,108,236,0,88,Player A
115,Bayesian,115,115,230,0,90,Tie
116,Bayesian,119,124,243,1,86,Bayesian
117,Bayesian,107,137,244,2,86,Bayesian
118,Bayesian,115,115,230,0,90,Tie
119,Bayesian,107,127,234,1,89,Bayesian
120,Bayesian,111,116,227,0,91,Bayesian
121,Bayesian,128,108,236,0,88,Player A
122,Bayesian,120,110,230,0,90,Player A
123,Bayesian,120,120,240,1,87,Tie
124,Bayesian,107,117,224,0,92,Bayesian
125,Bayesian,103,128,231,1,90,Bayesian
126,Bayesian,107,117,224,0,92,Bayesian
127,Bayesian,128,118,246,1,85,Player A
128,Bayesian,99,119,218,0,94,Bayesian
129,Bayesian,120,110,230,0,90,Player A
130,Bayesian,118,113,231,1,90,Player A
131,Bayesian,128,128,256,2,82,Tie
132,Bayesian,115,115,230,0,90,Tie
133,Bayesian,99,119,218,0,94,Bayesian
134,Bayesian,120,110,230,0,90,Player A
135,Bayesian,128,108,236,0,88,Player A
136,Bayesian,107,117,224,0,92,Bayesian
137,Bayesian,116,111,227,0,91,Player A
138,Bayesian,115,115,230,0,90,Tie
139,Bayesian,133,113,246,1,85,Player A
140,Bayesian,115,115,230,0,90,Tie
141,Bayesian,111,116,227,0,91,Bayesian
142,Bayesian,115,135,250,2,84,Bayesian
143,Bayesian,115,125,240,1,87,Bayesian
144,Bayesian,115,125,240,1,87,Bayesian
145,Bayesian,111,116,227,0,91,Bayesian
146,Bayesian,124,109,233,0,89,Player A
147,Bayesian,115,115,230,0,90,Tie
148,Bayesian,111,116,227,0,91,Bayesian
149,Bayesian,103,118,221,0,93,Bayesian
150,Bayesian,128,108,236,0,88,Player A
151,Bayesian,120,120,240,1,87,Tie
152,Bayesian,132,107,239,0,87,Player A
153,Bayesian,120,110,230,0,90,Player A
154,Bayesian,116,111,227,0,91,Player A
155,Bayesian,97,137,234,1,89,Bayesian
156,Bayesian,124,109,233,0,89,Player A
157,Bayesian,112,112,224,0,92,Tie
158,Bayesian,137,102,239,0,87,Player A
159,Bayesian,111,116,227,0,91,Bayesian
160,Bayesian,111,116,227,0,91,Bayesian
161,Bayesian,128,108,236,0,88,Player A
162,Bayesian,116,111,227,0,91,Player A
163,Bayesian,119,124,243,1,86,Bayesian
164,Bayesian,124,109,233,0,89,Player A
165,Bayesian,111,126,237,1,88,Bayesian
166,Bayesian,115,115,230,0,90,Tie
167,Bayesian,132,107,239,0,87,Player A
168,Bayesian,125,105,230,0,90,Player A
169,Bayesian,115,125,240,1,87,Bayesian
170,Bayesian,131,111,242,0,86,Player A
171,Bayesian,121,106,227,0,91,Player A
172,Bayesian,111,116,227,0,91,Bayesian
173,Bayesian,124,109,233,0,89,Player A
174,Bayesian,107,117,224,0,92,Bayesian
175,Bayesian,115,115,230,0,90,Tie
176,Bayesian,108,113,221,0,93,Bayesian
177,Bayesian,102,132,234,1,89,Bayesian
178,Bayesian,128,108,236,0,88,Player A
179,Bayesian,99,119,218,0,94,Bayesian
180,Bayesian,123,113,236,0,88,Player A
181,Bayesian,107,117,224,0,92,Bayesian
182,Bayesian,112,112,224,0,92,Tie
183,Bayesian,127,112,239,0,87,Player A
184,Bayesian,111,116,227,0,91,Bayesian
185,Bayesian,120,110,230,0,90,Player A
186,Bayesian,120,110,230,0,90,Player A
187,Bayesian,136,106,242,0,86,Player A
188,Bayesian,120,110,230,0,90,Player A
189,Bayesian,118,113,231,1,90,Player A
190,Bayesian,129,104,233,0,89,Player A
191,Bayesian,123,113,236,0,88,Player A
192,Bayesian,120,110,230,0,90,Player A
193,Bayesian,120,110,230,0,90,Player A
194,Bayesian,116,111,227,0,91,Player A
195,Bayesian,115,115,230,0,90,Tie
196,Bayesian,107,117,224,0,92,Bayesian
197,Bayesian,103,118,221,0,93,Bayesian
198,Bayesian,123,113,236,0,88,Player A
199,Bayesian,124,109,233,0,89,Player A
200,Bayesian,99,139,238,2,88,Bayesian
201,Bayesian,115,115,230,0,90,Tie
202,Bayesian,116,111,227,0,91,Player A
203,Bayesian,132,107,239,0,87,Player A
204,Bayesian,102,122,224,0,92,Bayesian
205,Bayesian,107,117,224,0,92,Bayesian
206,Bayesian,107,117,224,0,92,Bayesian
207,Bayesian,107,127,234,1,89,Bayesian
208,Bayesian,115,115,230,0,90,Tie
209,Bayesian,111,116,227,0,91,Bayesian
210,Bayesian,106,121,227,0,91,Bayesian
211,Bayesian,107,117,224,0,92,Bayesian
212,Bayesian,108,113,221,0,93,Bayesian
213,Bayesian,94,124,218,0,94,Bayesian
214,Bayesian,124,109,233,0,89,Player A
215,Bayesian,131,106,237,1,88,Player A
216,Bayesian,113,133,246,1,85,Bayesian
217,Bayesian,106,121,227,0,91,Bayesian
218,Bayesian,129,104,233,0,89,Player A
219,Bayesian,108,113,221,0,93,Bayesian
220,Bayesian,119,124,243,1,86,Bayesian
221,Bayesian,124,109,233,0,89,Player A
222,Bayesian,125,105,230,0,90,Player A
223,Bayesian,117,117,234,1,89,Tie
224,Bayesian,130,115,245,0,85,Player A
225,Bayesian,124,109,233,0,89,Player A
226,Bayesian,119,114,233,0,89,Player A
227,Bayesian,117,147,264,4,80,Bayesian
228,Bayesian,115,115,230,0,90,Tie
229,Bayesian,116,111,227,0,91,Player A
230,Bayesian,119,114,233,0,89,Player A
231,Bayesian,103,118,221,0,93,Bayesian
232,Bayesian,120,110,230,0,90,Player A
233,Bayesian,102,122,224,0,92,Bayesian
234,Bayesian,107,117,224,0,92,Bayesian
235,Bayesian,132,107,239,0,87,Player A
236,Bayesian,103,118,221,0,93,Bayesian
237,Bayesian,124,109,233,0,89,Player A
238,Bayesian,120,110,230,0,90,Player A
239,Bayesian,128,128,256,2,82,Tie
240,Bayesian,107,117,224,0,92,Bayesian
241,Bayesian,118,128,246,1,85,Bayesian
0,UCBPlayer,126,126,252,7,85,Tie
1,UCBPlayer,111,351,462,28,22,UCBPlayer
2,UCBPlayer,116,126,242,3,87,UCBPlayer
3,UCBPlayer,122,347,469,32,21,UCBPlayer
4,UCBPlayer,107,132,239,0,87,UCBPlayer
5,UCBPlayer,132,337,469,35,22,UCBPlayer
6,UCBPlayer,103,148,251,0,83,UCBPlayer
7,UCBPlayer,136,321,457,35,26,UCBPlayer
8,UCBPlayer,99,164,263,0,79,UCBPlayer
9,UCBPlayer,140,305,445,35,30,UCBPlayer
10,UCBPlayer,95,180,275,0,75,UCBPlayer
11,UCBPlayer,144,289,433,35,34,UCBPlayer
12,UCBPlayer,91,196,287,0,71,UCBPlayer
13,UCBPlayer,148,273,421,35,38,UCBPlayer
14,UCBPlayer,87,212,299,0,67,UCBPlayer
15,UCBPlayer,152,257,409,35,42,UCBPlayer
16,UCBPlayer,84,224,308,0,64,UCBPlayer
17,UCBPlayer,146,251,397,32,45,UCBPlayer
18,UCBPlayer,89,234,323,3,60,UCBPlayer
19,UCBPlayer,138,243,381,28,49,UCBPlayer
20,UCBPlayer,97,242,339,7,56,UCBPlayer
21,UCBPlayer,130,235,365,24,53,UCBPlayer
22,UCBPlayer,105,250,355,11,52,UCBPlayer
23,UCBPlayer,122,227,349,20,57,UCBPlayer
24,UCBPlayer,109,259,368,15,49,UCBPlayer
25,UCBPlayer,118,218,336,16,60,UCBPlayer
26,UCBPlayer,117,267,384,19,45,UCBPlayer
27,UCBPlayer,110,210,320,12,64,UCBPlayer
28,UCBPlayer,126,271,397,23,42,UCBPlayer
29,UCBPlayer,105,210,315,10,65,UCBPlayer
30,UCBPlayer,130,275,405,25,40,UCBPlayer
31,UCBPlayer,105,210,315,10,65,UCBPlayer
32,UCBPlayer,130,275,405,25,40,UCBPlayer
33,UCBPlayer,106,206,312,10,66,UCBPlayer
34,UCBPlayer,130,275,405,25,40,UCBPlayer
35,UCBPlayer,105,210,315,10,65,UCBPlayer
36,UCBPlayer,131,271,402,25,41,UCBPlayer
37,UCBPlayer,105,210,315,10,65,UCBPlayer
38,UCBPlayer,130,275,405,25,40,UCBPlayer
39,UCBPlayer,105,210,315,10,65,UCBPlayer
40,UCBPlayer,130,275,405,25,40,UCBPlayer
41,UCBPlayer,103,203,306,10,68,UCBPlayer
42,UCBPlayer,128,283,411,25,38,UCBPlayer
43,UCBPlayer,111,186,297,10,71,UCBPlayer
44,UCBPlayer,124,299,423,25,34,UCBPlayer
45,UCBPlayer,115,170,285,10,75,UCBPlayer
46,UCBPlayer,120,315,435,25,30,UCBPlayer
47,UCBPlayer,119,154,273,10,79,UCBPlayer
48,UCBPlayer,112,332,444,25,27,UCBPlayer
49,UCBPlayer,127,137,264,10,82,UCBPlayer
50,UCBPlayer,104,349,453,25,24,UCBPlayer
51,UCBPlayer,126,126,252,7,85,Tie
52,UCBPlayer,111,351,462,28,22,UCBPlayer
53,UCBPlayer,116,126,242,3,87,UCBPlayer
54,UCBPlayer,122,347,469,32,21,UCBPlayer
55,UCBPlayer,107,132,239,0,87,UCBPlayer
56,UCBPlayer,132,337,469,35,22,UCBPlayer
57,UCBPlayer,103,148,251,0,83,UCBPlayer
58,UCBPlayer,136,321,457,35,26,UCBPlayer
59,UCBPlayer,99,164,263,0,79,UCBPlayer
60,UCBPlayer,140,305,445,35,30,UCBPlayer
61,UCBPlayer,95,180,275,0,75,UCBPlayer
62,UCBPlayer,144,289,433,35,34,UCBPlayer
63,UCBPlayer,91,196,287,0,71,UCBPlayer
64,UCBPlayer,148,273,421,35,38,UCBPlayer
65,UCBPlayer,87,212,299,0,67,UCBPlayer
66,UCBPlayer,152,257,409,35,42,UCBPlayer
67,UCBPlayer,84,224,308,0,64,UCBPlayer
68,UCBPlayer,146,251,397,32,45,UCBPlayer
69,UCBPlayer,89,234,323,3,60,UCBPlayer
70,UCBPlayer,138,243,381,28,49,UCBPlayer
71,UCBPlayer,97,242,339,7,56,UCBPlayer
72,UCBPlayer,130,235,365,24,53,UCBPlayer
73,UCBPlayer,105,250,355,11,52,UCBPlayer
74,UCBPlayer,122,227,349,20,57,UCBPlayer
75,UCBPlayer,109,259,368,15,49,UCBPlayer
76,UCBPlayer,118,218,336,16,60,UCBPlayer
77,UCBPlayer,117,267,384,19,45,UCBPlayer
78,UCBPlayer,110,210,320,12,64,UCBPlayer
79,UCBPlayer,126,271,397,23,42,UCBPlayer
80,UCBPlayer,105,210,315,10,65,UCBPlayer
81,UCBPlayer,130,275,405,25,40,UCBPlayer
82,UCBPlayer,105,210,315,10,65,UCBPlayer
83,UCBPlayer,130,275,405,25,40,UCBPlayer
84,UCBPlayer,106,206,312,10,66,UCBPlayer
85,UCBPlayer,130,275,405,25,40,UCBPlayer
86,UCBPlayer,105,210,315,10,65,UCBPlayer
87,UCBPlayer,131,271,402,25,41,UCBPlayer
88,UCBPlayer,105,210,315,10,65,UCBPlayer
89,UCBPlayer,130,275,405,25,40,UCBPlayer
90,UCBPlayer,105,210,315,10,65,UCBPlayer
91,UCBPlayer,130,275,405,25,40,UCBPlayer
92,UCBPlayer,103,203,306,10,68,UCBPlayer
93,UCBPlayer,128,283,411,25,38,UCBPlayer
94,UCBPlayer,111,186,297,10,71,UCBPlayer
95,UCBPlayer,124,299,423,25,34,UCBPlayer
96,UCBPlayer,115,170,285,10,75,UCBPlayer
97,UCBPlayer,120,315,435,25,30,UCBPlayer
98,UCBPlayer,119,154,273,10,79,UCBPlayer
99,UCBPlayer,112,332,444,25,27,UCBPlayer
100,UCBPlayer,127,137,264,10,82,UCBPlayer
101,UCBPlayer,104,349,453,25,24,UCBPlayer
102,UCBPlayer,126,126,252,7,85,Tie
103,UCBPlayer,111,351,462,28,22,UCBPlayer
104,UCBPlayer,116,126,242,3,87,UCBPlayer
105,UCBPlayer,122,347,469,32,21,UCBPlayer
106,UCBPlayer,107,132,239,0,87,UCBPlayer
107,UCBPlayer,132,337,469,35,22,UCBPlayer
108,UCBPlayer,103,148,251,0,83,UCBPlayer
109,UCBPlayer,136,321,457,35,26,UCBPlayer
110,UCBPlayer,99,164,263,0,79,UCBPlayer
111,UCBPlayer,140,305,445,35,30,UCBPlayer
112,UCBPlayer,95,180,275,0,75,UCBPlayer
113,UCBPlayer,144,289,433,35,34,UCBPlayer
114,UCBPlayer,91,196,287,0,71,UCBPlayer
115,UCBPlayer,148,273,421,35,38,UCBPlayer
116,UCBPlayer,87,212,299,0,67,UCBPlayer
117,UCBPlayer,152,257,409,35,42,UCBPlayer
118,UCBPlayer,84,224,308,0,64,UCBPlayer
119,UCBPlayer,146,251,397,32,45,UCBPlayer
120,UCBPlayer,89,234,323,3,60,UCBPlayer
121,UCBPlayer,138,243,381,28,49,UCBPlayer
122,UCBPlayer,97,242,339,7,56,UCBPlayer
123,UCBPlayer,130,235,365,24,53,UCBPlayer
124,UCBPlayer,105,250,355,11,52,UCBPlayer
125,UCBPlayer,122,227,349,20,57,UCBPlayer
126,UCBPlayer,109,259,368,15,49,UCBPlayer
127,UCBPlayer,118,218,336,16,60,UCBPlayer
128,UCBPlayer,117,267,384,19,45,UCBPlayer
129,UCBPlayer,110,210,320,12,64,UCBPlayer
130,UCBPlayer,126,271,397,23,42,UCBPlayer
131,UCBPlayer,105,210,315,10,65,UCBPlayer
132,UCBPlayer,130,275,405,25,40,UCBPlayer
133,UCBPlayer,105,210,315,10,65,UCBPlayer
134,UCBPlayer,130,275,405,25,40,UCBPlayer
135,UCBPlayer,106,206,312,10,66,UCBPlayer
136,UCBPlayer,130,275,405,25,40,UCBPlayer
137,UCBPlayer,105,210,315,10,65,UCBPlayer
138,UCBPlayer,131,271,402,25,41,UCBPlayer
139,UCBPlayer,105,210,315,10,65,UCBPlayer
140,UCBPlayer,130,275,405,25,40,UCBPlayer
141,UCBPlayer,105,210,315,10,65,UCBPlayer
142,UCBPlayer,130,275,405,25,40,UCBPlayer
143,UCBPlayer,103,203,306,10,68,UCBPlayer
144,UCBPlayer,128,283,411,25,38,UCBPlayer
145,UCBPlayer,111,186,297,10,71,UCBPlayer
146,UCBPlayer,124,299,423,25,34,UCBPlayer
147,UCBPlayer,115,170,285,10,75,UCBPlayer
148,UCBPlayer,120,315,435,25,30,UCBPlayer
149,UCBPlayer,119,154,273,10,79,UCBPlayer
150,UCBPlayer,112,332,444,25,27,UCBPlayer
151,UCBPlayer,127,137,264,10,82,UCBPlayer
152,UCBPlayer,104,349,453,25,24,UCBPlayer
153,UCBPlayer,126,126,252,7,85,Tie
154,UCBPlayer,111,351,462,28,22,UCBPlayer
155,UCBPlayer,116,126,242,3,87,UCBPlayer
156,UCBPlayer,122,347,469,32,21,UCBPlayer
157,UCBPlayer,107,132,239,0,87,UCBPlayer
158,UCBPlayer,132,337,469,35,22,UCBPlayer
159,UCBPlayer,103,148,251,0,83,UCBPlayer
160,UCBPlayer,136,321,457,35,26,UCBPlayer
161,UCBPlayer,99,164,263,0,79,UCBPlayer
162,UCBPlayer,140,305,445,35,30,UCBPlayer
163,UCBPlayer,95,180,275,0,75,UCBPlayer
164,UCBPlayer,144,289,433,35,34,UCBPlayer
165,UCBPlayer,91,196,287,0,71,UCBPlayer
166,UCBPlayer,148,273,421,35,38,UCBPlayer
167,UCBPlayer,87,212,299,0,67,UCBPlayer
168,UCBPlayer,152,257,409,35,42,UCBPlayer
169,UCBPlayer,84,224,308,0,64,UCBPlayer
170,UCBPlayer,146,251,397,32,45,UCBPlayer
171,UCBPlayer,89,234,323,3,60,UCBPlayer
172,UCBPlayer,138,243,381,28,49,UCBPlayer
173,UCBPlayer,97,242,339,7,56,UCBPlayer
174,UCBPlayer,130,235,365,24,53,UCBPlayer
175,UCBPlayer,105,250,355,11,52,UCBPlayer
176,UCBPlayer,122,227,349,20,57,UCBPlayer
177,UCBPlayer,109,259,368,15,49,UCBPlayer
178,UCBPlayer,118,218,336,16,60,UCBPlayer
179,UCBPlayer,117,267,384,19,45,UCBPlayer
180,UCBPlayer,110,210,320,12,64,UCBPlayer
181,UCBPlayer,126,271,397,23,42,UCBPlayer
182,UCBPlayer,105,210,315,10,65,UCBPlayer
183,UCBPlayer,130,275,405,25,40,UCBPlayer
184,UCBPlayer,105,210,315,10,65,UCBPlayer
185,UCBPlayer,130,275,405,25,40,UCBPlayer
186,UCBPlayer,106,206,312,10,66,UCBPlayer
187,UCBPlayer,130,275,405,25,40,UCBPlayer
188,UCBPlayer,105,210,315,10,65,UCBPlayer
189,UCBPlayer,131,271,402,25,41,UCBPlayer
190,UCBPlayer,105,210,315,10,65,UCBPlayer
191,UCBPlayer,130,275,405,25,40,UCBPlayer
192,UCBPlayer,105,210,315,10,65,UCBPlayer
193,UCBPlayer,130,275,405,25,40,UCBPlayer
194,UCBPlayer,103,203,306,10,68,UCBPlayer
195,UCBPlayer,128,283,411,25,38,UCBPlayer
196,UCBPlayer,111,186,297,10,71,UCBPlayer
197,UCBPlayer,124,299,423,25,34,UCBPlayer
198,UCBPlayer,115,170,285,10,75,UCBPlayer
199,UCBPlayer,120,315,435,25,30,UCBPlayer
200,UCBPlayer,119,154,273,10,79,UCBPlayer
201,UCBPlayer,112,332,444,25,27,UCBPlayer
202,UCBPlayer,127,137,264,10,82,UCBPlayer
203,UCBPlayer,104,349,453,25,24,UCBPlayer
204,UCBPlayer,126,126,252,7,85,Tie
205,UCBPlayer,111,351,462,28,22,UCBPlayer
206,UCBPlayer,116,126,242,3,87,UCBPlayer
207,UCBPlayer,122,347,469,32,21,UCBPlayer
208,UCBPlayer,107,132,239,0,87,UCBPlayer
209,UCBPlayer,132,337,469,35,22,UCBPlayer
210,UCBPlayer,103,148,251,0,83,UCBPlayer
211,UCBPlayer,136,321,457,35,26,UCBPlayer
212,UCBPlayer,99,164,263,0,79,UCBPlayer
213,UCBPlayer,140,305,445,35,30,UCBPlayer
214,UCBPlayer,95,180,275,0,75,UCBPlayer
215,UCBPlayer,144,289,433,35,34,UCBPlayer
216,UCBPlayer,91,196,287,0,71,UCBPlayer
217,UCBPlayer,148,273,421,35,38,UCBPlayer
218,UCBPlayer,87,212,299,0,67,UCBPlayer
219,UCBPlayer,152,257,409,35,42,UCBPlayer
220,UCBPlayer,84,224,308,0,64,UCBPlayer
221,UCBPlayer,146,251,397,32,45,UCBPlayer
222,UCBPlayer,89,234,323,3,60,UCBPlayer
223,UCBPlayer,138,243,381,28,49,UCBPlayer
224,UCBPlayer,97,242,339,7,56,UCBPlayer
225,UCBPlayer,130,235,365,24,53,UCBPlayer
226,UCBPlayer,105,250,355,11,52,UCBPlayer
227,UCBPlayer,122,227,349,20,57,UCBPlayer
228,UCBPlayer,109,259,368,15,49,UCBPlayer
229,UCBPlayer,118,218,336,16,60,UCBPlayer
230,UCBPlayer,117,267,384,19,45,UCBPlayer
231,UCBPlayer,110,210,320,12,64,UCBPlayer
232,UCBPlayer,126,271,397,23,42,UCBPlayer
233,UCBPlayer,105,210,315,10,65,UCBPlayer
234,UCBPlayer,130,275,405,25,40,UCBPlayer
235,UCBPlayer,105,210,315,10,65,UCBPlayer
236,UCBPlayer,130,275,405,25,40,UCBPlayer
237,UCBPlayer,106,206,312,10,66,UCBPlayer
238,UCBPlayer,130,275,405,25,40,UCBPlayer
239,UCBPlayer,105,210,315,10,65,UCBPlayer
240,UCBPlayer,131,271,402,25,41,UCBPlayer
241,UCBPlayer,105,210,315,10,65,UCBPlayer
242,UCBPlayer,130,275,405,25,40,UCBPlayer
243,UCBPlayer,105,210,315,10,65,UCBPlayer
244,UCBPlayer,130,275,405,25,40,UCBPlayer
245,UCBPlayer,103,203,306,10,68,UCBPlayer
246,UCBPlayer,128,283,411,25,38,UCBPlayer
247,UCBPlayer,111,186,297,10,71,UCBPlayer
248,UCBPlayer,124,299,423,25,34,UCBPlayer
249,UCBPlayer,115,170,285,10,75,UCBPlayer
250,UCBPlayer,120,315,435,25,30,UCBPlayer
251,UCBPlayer,119,154,273,10,79,UCBPlayer
252,UCBPlayer,112,332,444,25,27,UCBPlayer
253,UCBPlayer,127,137,264,10,82,UCBPlayer
254,UCBPlayer,104,349,453,25,24,UCBPlayer
255,UCBPlayer,126,126,252,7,85,Tie
256,UCBPlayer,111,351,462,28,22,UCBPlayer
257,UCBPlayer,116,126,242,3,87,UCBPlayer
258,UCBPlayer,122,347,469,32,21,UCBPlayer
259,UCBPlayer,107,132,239,0,87,UCBPlayer
260,UCBPlayer,132,337,469,35,22,UCBPlayer
261,UCBPlayer,103,148,251,0,83,UCBPlayer
262,UCBPlayer,136,321,457,35,26,UCBPlayer
263,UCBPlayer,99,164,263,0,79,UCBPlayer
264,UCBPlayer,140,305,445,35,30,UCBPlayer
265,UCBPlayer,95,180,275,0,75,UCBPlayer
266,UCBPlayer,144,289,433,35,34,UCBPlayer
267,UCBPlayer,91,196,287,0,71,UCBPlayer
268,UCBPlayer,148,273,421,35,38,UCBPlayer
269,UCBPlayer,87,212,299,0,67,UCBPlayer
270,UCBPlayer,152,257,409,35,42,UCBPlayer
271,UCBPlayer,84,224,308,0,64,UCBPlayer
272,UCBPlayer,146,251,397,32,45,UCBPlayer
273,UCBPlayer,89,234,323,3,60,UCBPlayer
274,UCBPlayer,138,243,381,28,49,UCBPlayer
275,UCBPlayer,97,242,339,7,56,UCBPlayer
276,UCBPlayer,130,235,365,24,53,UCBPlayer
277,UCBPlayer,105,250,355,11,52,UCBPlayer
278,UCBPlayer,122,227,349,20,57,UCBPlayer
279,UCBPlayer,109,259,368,15,49,UCBPlayer
280,UCBPlayer,118,218,336,16,60,UCBPlayer
281,UCBPlayer,117,267,384,19,45,UCBPlayer
282,UCBPlayer,110,210,320,12,64,UCBPlayer
283,UCBPlayer,126,271,397,23,42,UCBPlayer
284,UCBPlayer,105,210,315,10,65,UCBPlayer
285,UCBPlayer,130,275,405,25,40,UCBPlayer
286,UCBPlayer,105,210,315,10,65,UCBPlayer
287,UCBPlayer,130,275,405,25,40,UCBPlayer
288,UCBPlayer,106,206,312,10,66,UCBPlayer
289,UCBPlayer,130,275,405,25,40,UCBPlayer
290,UCBPlayer,105,210,315,10,65,UCBPlayer
291,UCBPlayer,131,271,402,25,41,UCBPlayer
292,UCBPlayer,105,210,315,10,65,UCBPlayer
293,UCBPlayer,130,275,405,25,40,UCBPlayer
294,UCBPlayer,105,210,315,10,65,UCBPlayer
295,UCBPlayer,130,275,405,25,40,UCBPlayer
296,UCBPlayer,103,203,306,10,68,UCBPlayer
297,UCBPlayer,128,283,411,25,38,UCBPlayer
298,UCBPlayer,111,186,297,10,71,UCBPlayer
299,UCBPlayer,124,299,423,25,34,UCBPlayer
300,UCBPlayer,115,170,285,10,75,UCBPlayer
301,UCBPlayer,120,315,435,25,30,UCBPlayer
302,UCBPlayer,119,154,273,10,79,UCBPlayer
303,UCBPlayer,112,332,444,25,27,UCBPlayer
304,UCBPlayer,127,137,264,10,82,UCBPlayer
305,UCBPlayer,104,349,453,25,24,UCBPlayer
306,UCBPlayer,126,126,252,7,85,Tie
307,UCBPlayer,111,351,462,28,22,UCBPlayer
308,UCBPlayer,116,126,242,3,87,UCBPlayer
309,UCBPlayer,122,347,469,32,21,UCBPlayer
310,UCBPlayer,107,132,239,0,87,UCBPlayer
311,UCBPlayer,132,337,469,35,22,UCBPlayer
312,UCBPlayer,103,148,251,0,83,UCBPlayer
313,UCBPlayer,136,321,457,35,26,UCBPlayer
314,UCBPlayer,99,164,263,0,79,UCBPlayer
315,UCBPlayer,140,305,445,35,30,UCBPlayer
316,UCBPlayer,95,180,275,0,75,UCBPlayer
317,UCBPlayer,144,289,433,35,34,UCBPlayer
318,UCBPlayer,91,196,287,0,71,UCBPlayer
319,UCBPlayer,148,273,421,35,38,UCBPlayer
320,UCBPlayer,87,212,299,0,67,UCBPlayer
321,UCBPlayer,152,257,409,35,42,UCBPlayer
322,UCBPlayer,84,224,308,0,64,UCBPlayer
323,UCBPlayer,146,251,397,32,45,UCBPlayer
324,UCBPlayer,89,234,323,3,60,UCBPlayer
325,UCBPlayer,138,243,381,28,49,UCBPlayer
326,UCBPlayer,97,242,339,7,56,UCBPlayer
327,UCBPlayer,130,235,365,24,53,UCBPlayer
328,UCBPlayer,105,250,355,11,52,UCBPlayer
329,UCBPlayer,122,227,349,20,57,UCBPlayer
330,UCBPlayer,109,259,368,15,49,UCBPlayer
331,UCBPlayer,118,218,336,16,60,UCBPlayer
332,UCBPlayer,117,267,384,19,45,UCBPlayer
333,UCBPlayer,110,210,320,12,64,UCBPlayer
334,UCBPlayer,126,271,397,23,42,UCBPlayer
335,UCBPlayer,105,210,315,10,65,UCBPlayer
336,UCBPlayer,130,275,405,25,40,UCBPlayer
337,UCBPlayer,105,210,315,10,65,UCBPlayer
338,UCBPlayer,130,275,405,25,40,UCBPlayer
339,UCBPlayer,106,206,312,10,66,UCBPlayer
340,UCBPlayer,130,275,405,25,40,UCBPlayer
341,UCBPlayer,105,210,315,10,65,UCBPlayer
342,UCBPlayer,131,271,402,25,41,UCBPlayer
343,UCBPlayer,105,210,315,10,65,UCBPlayer
344,UCBPlayer,130,275,405,25,40,UCBPlayer
345,UCBPlayer,105,210,315,10,65,UCBPlayer
346,UCBPlayer,130,275,405,25,40,UCBPlayer
347,UCBPlayer,103,203,306,10,68,UCBPlayer
348,UCBPlayer,128,283,411,25,38,UCBPlayer
349,UCBPlayer,111,186,297,10,71,UCBPlayer
350,UCBPlayer,124,299,423,25,34,UCBPlayer
351,UCBPlayer,115,170,285,10,75,UCBPlayer
352,UCBPlayer,120,315,435,25,30,UCBPlayer
353,UCBPlayer,119,154,273,10,79,UCBPlayer
354,UCBPlayer,112,332,444,25,27,UCBPlayer
355,UCBPlayer,127,137,264,10,82,UCBPlayer
356,UCBPlayer,104,349,453,25,24,UCBPlayer
357,UCBPlayer,126,126,252,7,85,Tie
358,UCBPlayer,111,351,462,28,22,UCBPlayer
359,UCBPlayer,116,126,242,3,87,UCBPlayer
360,UCBPlayer,122,347,469,32,21,UCBPlayer
361,UCBPlayer,107,132,239,0,87,UCBPlayer
362,UCBPlayer,132,337,469,35,22,UCBPlayer
363,UCBPlayer,103,148,251,0,83,UCBPlayer
364,UCBPlayer,136,321,457,35,26,UCBPlayer
365,UCBPlayer,99,164,263,0,79,UCBPlayer
366,UCBPlayer,140,305,445,35,30,UCBPlayer
367,UCBPlayer,95,180,275,0,75,UCBPlayer
368,UCBPlayer,144,289,433,35,34,UCBPlayer
369,UCBPlayer,91,196,287,0,71,UCBPlayer
370,UCBPlayer,148,273,421,35,38,UCBPlayer
371,UCBPlayer,87,212,299,0,67,UCBPlayer
372,UCBPlayer,152,257,409,35,42,UCBPlayer
373,UCBPlayer,84,224,308,0,64,UCBPlayer
374,UCBPlayer,146,251,397,32,45,UCBPlayer
375,UCBPlayer,89,234,323,3,60,UCBPlayer
376,UCBPlayer,138,243,381,28,49,UCBPlayer
377,UCBPlayer,97,242,339,7,56,UCBPlayer
378,UCBPlayer,130,235,365,24,53,UCBPlayer
379,UCBPlayer,105,250,355,11,52,UCBPlayer
380,UCBPlayer,122,227,349,20,57,UCBPlayer
381,UCBPlayer,109,259,368,15,49,UCBPlayer
382,UCBPlayer,118,218,336,16,60,UCBPlayer
383,UCBPlayer,117,267,384,19,45,UCBPlayer
384,UCBPlayer,110,210,320,12,64,UCBPlayer
385,UCBPlayer,126,271,397,23,42,UCBPlayer
386,UCBPlayer,105,210,315,10,65,UCBPlayer
387,UCBPlayer,130,275,405,25,40,UCBPlayer
388,UCBPlayer,105,210,315,10,65,UCBPlayer
389,UCBPlayer,130,275,405,25,40,UCBPlayer
390,UCBPlayer,106,206,312,10,66,UCBPlayer
391,UCBPlayer,130,275,405,25,40,UCBPlayer
392,UCBPlayer,105,210,315,10,65,UCBPlayer
393,UCBPlayer,131,271,402,25,41,UCBPlayer
394,UCBPlayer,105,210,315,10,65,UCBPlayer
395,UCBPlayer,130,275,405,25,40,UCBPlayer
396,UCBPlayer,105,210,315,10,65,UCBPlayer
397,UCBPlayer,130,275,405,25,40,UCBPlayer
398,UCBPlayer,103,203,306,10,68,UCBPlayer
399,UCBPlayer,128,283,411,25,38,UCBPlayer
400,UCBPlayer,111,186,297,10,71,UCBPlayer
401,UCBPlayer,124,299,423,25,34,UCBPlayer
402,UCBPlayer,115,170,285,10,75,UCBPlayer
403,UCBPlayer,120,315,435,25,30,UCBPlayer
404,UCBPlayer,119,154,273,10,79,UCBPlayer
405,UCBPlayer,112,332,444,25,27,UCBPlayer
406,UCBPlayer,127,137,264,10,82,UCBPlayer
407,UCBPlayer,104,349,453,25,24,UCBPlayer
408,UCBPlayer,126,126,252,7,85,Tie
409,UCBPlayer,111,351,462,28,22,UCBPlayer
410,UCBPlayer,116,126,242,3,87,UCBPlayer
411,UCBPlayer,122,347,469,32,21,UCBPlayer
412,UCBPlayer,107,132,239,0,87,UCBPlayer
413,UCBPlayer,132,337,469,35,22,UCBPlayer
414,UCBPlayer,103,148,251,0,83,UCBPlayer
415,UCBPlayer,136,321,457,35,26,UCBPlayer
416,UCBPlayer,99,164,263,0,79,UCBPlayer
417,UCBPlayer,140,305,445,35,30,UCBPlayer
418,UCBPlayer,95,180,275,0,75,UCBPlayer
419,UCBPlayer,144,289,433,35,34,UCBPlayer
420,UCBPlayer,91,196,287,0,71,UCBPlayer
421,UCBPlayer,148,273,421,35,38,UCBPlayer
422,UCBPlayer,87,212,299,0,67,UCBPlayer
423,UCBPlayer,152,257,409,35,42,UCBPlayer
424,UCBPlayer,84,224,308,0,64,UCBPlayer
425,UCBPlayer,146,251,397,32,45,UCBPlayer
426,UCBPlayer,89,234,323,3,60,UCBPlayer
427,UCBPlayer,138,243,381,28,49,UCBPlayer
428,UCBPlayer,97,242,339,7,56,UCBPlayer
429,UCBPlayer,130,235,365,24,53,UCBPlayer
430,UCBPlayer,105,250,355,11,52,UCBPlayer
431,UCBPlayer,122,227,349,20,57,UCBPlayer
432,UCBPlayer,109,259,368,15,49,UCBPlayer
433,UCBPlayer,118,218,336,16,60,UCBPlayer
434,UCBPlayer,117,267,384,19,45,UCBPlayer
435,UCBPlayer,110,210,320,12,64,UCBPlayer
436,UCBPlayer,126,271,397,23,42,UCBPlayer
437,UCBPlayer,105,210,315,10,65,UCBPlayer
438,UCBPlayer,130,275,405,25,40,UCBPlayer
439,UCBPlayer,105,210,315,10,65,UCBPlayer
440,UCBPlayer,130,275,405,25,40,UCBPlayer
441,UCBPlayer,106,206,312,10,66,UCBPlayer
442,UCBPlayer,130,275,405,25,40,UCBPlayer
443,UCBPlayer,105,210,315,10,65,UCBPlayer
444,UCBPlayer,131,271,402,25,41,UCBPlayer
445,UCBPlayer,105,210,315,10,65,UCBPlayer
446,UCBPlayer,130,275,405,25,40,UCBPlayer
447,UCBPlayer,105,210,315,10,65,UCBPlayer
448,UCBPlayer,130,275,405,25,40,UCBPlayer
449,UCBPlayer,103,203,306,10,68,UCBPlayer
450,UCBPlayer,128,283,411,25,38,UCBPlayer
451,UCBPlayer,111,186,297,10,71,UCBPlayer
452,UCBPlayer,124,299,423,25,34,UCBPlayer
453,UCBPlayer,115,170,285,10,75,UCBPlayer
454,UCBPlayer,120,315,435,25,30,UCBPlayer
455,UCBPlayer,119,154,273,10,79,UCBPlayer
456,UCBPlayer,112,332,444,25,27,UCBPlayer
457,UCBPlayer,127,137,264,10,82,UCBPlayer
458,UCBPlayer,104,349,453,25,24,UCBPlayer
459,UCBPlayer,126,126,252,7,85,Tie
460,UCBPlayer,111,351,462,28,22,UCBPlayer
461,UCBPlayer,116,126,242,3,87,UCBPlayer
462,UCBPlayer,122,347,469,32,21,UCBPlayer
463,UCBPlayer,107,132,239,0,87,UCBPlayer
464,UCBPlayer,132,337,469,35,22,UCBPlayer
465,UCBPlayer,103,148,251,0,83,UCBPlayer
466,UCBPlayer,136,321,457,35,26,UCBPlayer
467,UCBPlayer,99,164,263,0,79,UCBPlayer
468,UCBPlayer,140,305,445,35,30,UCBPlayer
469,UCBPlayer,95,180,275,0,75,UCBPlayer
470,UCBPlayer,144,289,433,35,34,UCBPlayer
471,UCBPlayer,91,196,287,0,71,UCBPlayer
472,UCBPlayer,148,273,421,35,38,UCBPlayer
473,UCBPlayer,87,212,299,0,67,UCBPlayer
474,UCBPlayer,152,257,409,35,42,UCBPlayer
475,UCBPlayer,84,224,308,0,64,UCBPlayer
476,UCBPlayer,146,251,397,32,45,UCBPlayer
477,UCBPlayer,89,234,323,3,60,UCBPlayer
478,UCBPlayer,138,243,381,28,49,UCBPlayer
479,UCBPlayer,97,242,339,7,56,UCBPlayer
480,UCBPlayer,130,235,365,24,53,UCBPlayer
481,UCBPlayer,105,250,355,11,52,UCBPlayer
482,UCBPlayer,122,227,349,20,57,UCBPlayer
483,UCBPlayer,109,259,368,15,49,UCBPlayer
484,UCBPlayer,118,218,336,16,60,UCBPlayer
485,UCBPlayer,117,267,384,19,45,UCBPlayer
486,UCBPlayer,110,210,320,12,64,UCBPlayer
487,UCBPlayer,126,271,397,23,42,UCBPlayer
488,UCBPlayer,105,210,315,10,65,UCBPlayer
489,UCBPlayer,130,275,405,25,40,UCBPlayer
490,UCBPlayer,105,210,315,10,65,UCBPlayer
491,UCBPlayer,130,275,405,25,40,UCBPlayer
492,UCBPlayer,106,206,312,10,66,UCBPlayer
493,UCBPlayer,130,275,405,25,40,UCBPlayer
494,UCBPlayer,105,210,315,10,65,UCBPlayer
495,UCBPlayer,131,271,402,25,41,UCBPlayer
496,UCBPlayer,105,210,315,10,65,UCBPlayer
497,UCBPlayer,130,275,405,25,40,UCBPlayer
498,UCBPlayer,105,210,315,10,65,UCBPlayer
499,UCBPlayer,130,275,405,25,40,UCBPlayer
500,UCBPlayer,103,203,306,10,68,UCBPlayer
501,UCBPlayer,128,283,411,25,38,UCBPlayer
502,UCBPlayer,111,186,297,10,71,UCBPlayer
503,UCBPlayer,124,299,423,25,34,UCBPlayer
504,UCBPlayer,115,170,285,10,75,UCBPlayer
505,UCBPlayer,120,315,435,25,30,UCBPlayer
506,UCBPlayer,119,154,273,10,79,UCBPlayer
507,UCBPlayer,112,332,444,25,27,UCBPlayer
508,UCBPlayer,127,137,264,10,82,UCBPlayer
509,UCBPlayer,104,349,453,25,24,UCBPlayer
510,UCBPlayer,126,126,252,7,85,Tie
511,UCBPlayer,111,351,462,28,22,UCBPlayer
512,UCBPlayer,116,126,242,3,87,UCBPlayer
513,UCBPlayer,122,347,469,32,21,UCBPlayer
514,UCBPlayer,107,132,239,0,87,UCBPlayer
515,UCBPlayer,132,337,469,35,22,UCBPlayer
516,UCBPlayer,103,148,251,0,83,UCBPlayer
517,UCBPlayer,136,321,457,35,26,UCBPlayer
518,UCBPlayer,99,164,263,0,79,UCBPlayer
519,UCBPlayer,140,305,445,35,30,UCBPlayer
520,UCBPlayer,95,180,275,0,75,UCBPlayer
521,UCBPlayer,144,289,433,35,34,UCBPlayer
522,UCBPlayer,91,196,287,0,71,UCBPlayer
523,UCBPlayer,148,273,421,35,38,UCBPlayer
524,UCBPlayer,87,212,299,0,67,UCBPlayer
525,UCBPlayer,152,257,409,35,42,UCBPlayer
526,UCBPlayer,84,224,308,0,64,UCBPlayer
527,UCBPlayer,146,251,397,32,45,UCBPlayer
528,UCBPlayer,89,234,323,3,60,UCBPlayer
529,UCBPlayer,138,243,381,28,49,UCBPlayer
530,UCBPlayer,97,242,339,7,56,UCBPlayer
531,UCBPlayer,130,235,365,24,53,UCBPlayer
532,UCBPlayer,105,250,355,11,52,UCBPlayer
533,UCBPlayer,122,227,349,20,57,UCBPlayer
534,UCBPlayer,109,259,368,15,49,UCBPlayer
535,UCBPlayer,118,218,336,16,60,UCBPlayer
536,UCBPlayer,117,267,384,19,45,UCBPlayer
537,UCBPlayer,110,210,320,12,64,UCBPlayer
538,UCBPlayer,126,271,397,23,42,UCBPlayer
539,UCBPlayer,105,210,315,10,65,UCBPlayer
540,UCBPlayer,130,275,405,25,40,UCBPlayer
541,UCBPlayer,105,210,315,10,65,UCBPlayer
542,UCBPlayer,130,275,405,25,40,UCBPlayer
543,UCBPlayer,106,206,312,10,66,UCBPlayer
544,UCBPlayer,130,275,405,25,40,UCBPlayer
545,UCBPlayer,105,210,315,10,65,UCBPlayer
546,UCBPlayer,131,271,402,25,41,UCBPlayer
547,UCBPlayer,105,210,315,10,65,UCBPlayer
548,UCBPlayer,130,275,405,25,40,UCBPlayer
549,UCBPlayer,105,210,315,10,65,UCBPlayer
550,UCBPlayer,130,275,405,25,40,UCBPlayer
551,UCBPlayer,103,203,306,10,68,UCBPlayer
552,UCBPlayer,128,283,411,25,38,UCBPlayer
553,UCBPlayer,111,186,297,10,71,UCBPlayer
554,UCBPlayer,124,299,423,25,34,UCBPlayer
555,UCBPlayer,115,170,285,10,75,UCBPlayer
556,UCBPlayer,120,315,435,25,30,UCBPlayer
557,UCBPlayer,119,154,273,10,79,UCBPlayer
558,UCBPlayer,112,332,444,25,27,UCBPlayer
559,UCBPlayer,127,137,264,10,82,UCBPlayer
560,UCBPlayer,104,349,453,25,24,UCBPlayer
561,UCBPlayer,126,126,252,7,85,Tie
562,UCBPlayer,111,351,462,28,22,UCBPlayer
563,UCBPlayer,116,126,242,3,87,UCBPlayer
564,UCBPlayer,122,347,469,32,21,UCBPlayer
565,UCBPlayer,107,132,239,0,87,UCBPlayer
566,UCBPlayer,132,337,469,35,22,UCBPlayer
567,UCBPlayer,103,148,251,0,83,UCBPlayer
568,UCBPlayer,136,321,457,35,26,UCBPlayer
569,UCBPlayer,99,164,263,0,79,UCBPlayer
570,UCBPlayer,140,305,445,35,30,UCBPlayer
571,UCBPlayer,95,180,275,0,75,UCBPlayer
572,UCBPlayer,144,289,433,35,34,UCBPlayer
573,UCBPlayer,91,196,287,0,71,UCBPlayer
574,UCBPlayer,148,273,421,35,38,UCBPlayer
575,UCBPlayer,87,212,299,0,67,UCBPlayer
576,UCBPlayer,152,257,409,35,42,UCBPlayer
577,UCBPlayer,84,224,308,0,64,UCBPlayer
578,UCBPlayer,146,251,397,32,45,UCBPlayer
579,UCBPlayer,89,234,323,3,60,UCBPlayer
580,UCBPlayer,138,243,381,28,49,UCBPlayer
581,UCBPlayer,97,242,339,7,56,UCBPlayer
582,UCBPlayer,130,235,365,24,53,UCBPlayer
583,UCBPlayer,105,250,355,11,52,UCBPlayer
584,UCBPlayer,122,227,349,20,57,UCBPlayer
585,UCBPlayer,109,259,368,15,49,UCBPlayer
586,UCBPlayer,118,218,336,16,60,UCBPlayer
587,UCBPlayer,117,267,384,19,45,UCBPlayer
588,UCBPlayer,110,210,320,12,64,UCBPlayer
589,UCBPlayer,126,271,397,23,42,UCBPlayer
590,UCBPlayer,105,210,315,10,65,UCBPlayer
591,UCBPlayer,130,275,405,25,40,UCBPlayer
592,UCBPlayer,105,210,315,10,65,UCBPlayer
593,UCBPlayer,130,275,405,25,40,UCBPlayer
594,UCBPlayer,106,206,312,10,66,UCBPlayer
595,UCBPlayer,130,275,405,25,40,UCBPlayer
596,UCBPlayer,105,210,315,10,65,UCBPlayer
597,UCBPlayer,131,271,402,25,41,UCBPlayer
598,UCBPlayer,105,210,315,10,65,UCBPlayer
599,UCBPlayer,130,275,405,25,40,UCBPlayer
600,UCBPlayer,105,210,315,10,65,UCBPlayer
601,UCBPlayer,130,275,405,25,40,UCBPlayer
602,UCBPlayer,103,203,306,10,68,UCBPlayer
603,UCBPlayer,128,283,411,25,38,UCBPlayer
604,UCBPlayer,111,186,297,10,71,UCBPlayer
605,UCBPlayer,124,299,423,25,34,UCBPlayer
606,UCBPlayer,115,170,285,10,75,UCBPlayer
607,UCBPlayer,120,315,435,25,30,UCBPlayer
608,UCBPlayer,119,154,273,10,79,UCBPlayer
609,UCBPlayer,112,332,444,25,27,UCBPlayer
610,UCBPlayer,127,137,264,10,82,UCBPlayer
611,UCBPlayer,104,349,453,25,24,UCBPlayer
612,UCBPlayer,126,126,252,7,85,Tie
613,UCBPlayer,111,351,462,28,22,UCBPlayer
614,UCBPlayer,116,126,242,3,87,UCBPlayer
615,UCBPlayer,122,347,469,32,21,UCBPlayer
616,UCBPlayer,107,132,239,0,87,UCBPlayer
617,UCBPlayer,132,337,469,35,22,UCBPlayer
618,UCBPlayer,103,148,251,0,83,UCBPlayer
619,UCBPlayer,136,321,457,35,26,UCBPlayer
620,UCBPlayer,99,164,263,0,79,UCBPlayer
621,UCBPlayer,140,305,445,35,30,UCBPlayer
622,UCBPlayer,95,180,275,0,75,UCBPlayer
623,UCBPlayer,144,289,433,35,34,UCBPlayer
624,UCBPlayer,91,196,287,0,71,UCBPlayer
625,UCBPlayer,148,273,421,35,38,UCBPlayer
626,UCBPlayer,87,212,299,0,67,UCBPlayer
627,UCBPlayer,152,257,409,35,42,UCBPlayer
628,UCBPlayer,84,224,308,0,64,UCBPlayer
629,UCBPlayer,146,251,397,32,45,UCBPlayer
630,UCBPlayer,89,234,323,3,60,UCBPlayer
631,UCBPlayer,138,243,381,28,49,UCBPlayer
632,UCBPlayer,97,242,339,7,56,UCBPlayer
633,UCBPlayer,130,235,365,24,53,UCBPlayer
634,UCBPlayer,105,250,355,11,52,UCBPlayer
635,UCBPlayer,122,227,349,20,57,UCBPlayer
636,UCBPlayer,109,259,368,15,49,UCBPlayer
637,UCBPlayer,118,218,336,16,60,UCBPlayer
638,UCBPlayer,117,267,384,19,45,UCBPlayer
639,UCBPlayer,110,210,320,12,64,UCBPlayer
640,UCBPlayer,126,271,397,23,42,UCBPlayer
641,UCBPlayer,105,210,315,10,65,UCBPlayer
642,UCBPlayer,130,275,405,25,40,UCBPlayer
643,UCBPlayer,105,210,315,10,65,UCBPlayer
644,UCBPlayer,130,275,405,25,40,UCBPlayer
645,UCBPlayer,106,206,312,10,66,UCBPlayer
646,UCBPlayer,130,275,405,25,40,UCBPlayer
647,UCBPlayer,105,210,315,10,65,UCBPlayer
648,UCBPlayer,131,271,402,25,41,UCBPlayer
649,UCBPlayer,105,210,315,10,65,UCBPlayer
650,UCBPlayer,130,275,405,25,40,UCBPlayer
651,UCBPlayer,105,210,315,10,65,UCBPlayer
652,UCBPlayer,130,275,405,25,40,UCBPlayer
653,UCBPlayer,103,203,306,10,68,UCBPlayer
654,UCBPlayer,128,283,411,25,38,UCBPlayer
655,UCBPlayer,111,186,297,10,71,UCBPlayer
656,UCBPlayer,124,299,423,25,34,UCBPlayer
657,UCBPlayer,115,170,285,10,75,UCBPlayer
658,UCBPlayer,120,315,435,25,30,UCBPlayer
659,UCBPlayer,119,154,273,10,79,UCBPlayer
660,UCBPlayer,112,332,444,25,27,UCBPlayer
661,UCBPlayer,127,137,264,10,82,UCBPlayer
662,UCBPlayer,104,349,453,25,24,UCBPlayer
663,UCBPlayer,126,126,252,7,85,Tie
664,UCBPlayer,111,351,462,28,22,UCBPlayer
665,UCBPlayer,116,126,242,3,87,UCBPlayer
666,UCBPlayer,122,347,469,32,21,UCBPlayer
667,UCBPlayer,107,132,239,0,87,UCBPlayer
668,UCBPlayer,132,337,469,35,22,UCBPlayer
669,UCBPlayer,103,148,251,0,83,UCBPlayer
670,UCBPlayer,136,321,457,35,26,UCBPlayer
671,UCBPlayer,99,164,263,0,79,UCBPlayer
672,UCBPlayer,140,305,445,35,30,UCBPlayer
673,UCBPlayer,95,180,275,0,75,UCBPlayer
674,UCBPlayer,144,289,433,35,34,UCBPlayer
675,UCBPlayer,91,196,287,0,71,UCBPlayer
676,UCBPlayer,148,273,421,35,38,UCBPlayer
677,UCBPlayer,87,212,299,0,67,UCBPlayer
678,UCBPlayer,152,257,409,35,42,UCBPlayer
679,UCBPlayer,84,224,308,0,64,UCBPlayer
680,UCBPlayer,146,251,397,32,45,UCBPlayer
681,UCBPlayer,89,234,323,3,60,UCBPlayer
682,UCBPlayer,138,243,381,28,49,UCBPlayer
683,UCBPlayer,97,242,339,7,56,UCBPlayer
684,UCBPlayer,130,235,365,24,53,UCBPlayer
685,UCBPlayer,105,250,355,11,52,UCBPlayer
686,UCBPlayer,122,227,349,20,57,UCBPlayer
687,UCBPlayer,109,259,368,15,49,UCBPlayer
688,UCBPlayer,118,218,336,16,60,UCBPlayer
689,UCBPlayer,117,267,384,19,45,UCBPlayer
690,UCBPlayer,110,210,320,12,64,UCBPlayer
691,UCBPlayer,126,271,397,23,42,UCBPlayer
692,UCBPlayer,105,210,315,10,65,UCBPlayer
693,UCBPlayer,130,275,405,25,40,UCBPlayer
694,UCBPlayer,105,210,315,10,65,UCBPlayer
695,UCBPlayer,130,275,405,25,40,UCBPlayer
696,UCBPlayer,106,206,312,10,66,UCBPlayer
697,UCBPlayer,130,275,405,25,40,UCBPlayer
698,UCBPlayer,105,210,315,10,65,UCBPlayer
699,UCBPlayer,131,271,402,25,41,UCBPlayer
700,UCBPlayer,105,210,315,10,65,UCBPlayer
701,UCBPlayer,130,275,405,25,40,UCBPlayer
702,UCBPlayer,105,210,315,10,65,UCBPlayer
703,UCBPlayer,130,275,405,25,40,UCBPlayer
704,UCBPlayer,103,203,306,10,68,UCBPlayer
705,UCBPlayer,128,283,411,25,38,UCBPlayer
706,UCBPlayer,111,186,297,10,71,UCBPlayer
707,UCBPlayer,124,299,423,25,34,UCBPlayer
708,UCBPlayer,115,170,285,10,75,UCBPlayer
709,UCBPlayer,120,315,435,25,30,UCBPlayer
710,UCBPlayer,119,154,273,10,79,UCBPlayer
711,UCBPlayer,112,332,444,25,27,UCBPlayer
712,UCBPlayer,127,137,264,10,82,UCBPlayer
713,UCBPlayer,104,349,453,25,24,UCBPlayer
714,UCBPlayer,126,126,252,7,85,Tie
715,UCBPlayer,111,351,462,28,22,UCBPlayer
716,UCBPlayer,116,126,242,3,87,UCBPlayer
717,UCBPlayer,122,347,469,32,21,UCBPlayer
718,UCBPlayer,107,132,239,0,87,UCBPlayer
719,UCBPlayer,132,337,469,35,22,UCBPlayer
720,UCBPlayer,103,148,251,0,83,UCBPlayer
721,UCBPlayer,136,321,457,35,26,UCBPlayer
722,UCBPlayer,99,164,263,0,79,UCBPlayer
723,UCBPlayer,140,305,445,35,30,UCBPlayer
724,UCBPlayer,95,180,275,0,75,UCBPlayer
725,UCBPlayer,144,289,433,35,34,UCBPlayer
726,UCBPlayer,91,196,287,0,71,UCBPlayer
727,UCBPlayer,148,273,421,35,38,UCBPlayer
728,UCBPlayer,87,212,299,0,67,UCBPlayer
729,UCBPlayer,152,257,409,35,42,UCBPlayer
730,UCBPlayer,84,224,308,0,64,UCBPlayer
731,UCBPlayer,146,251,397,32,45,UCBPlayer
732,UCBPlayer,89,234,323,3,60,UCBPlayer
733,UCBPlayer,138,243,381,28,49,UCBPlayer
734,UCBPlayer,97,242,339,7,56,UCBPlayer
735,UCBPlayer,130,235,365,24,53,UCBPlayer
736,UCBPlayer,105,250,355,11,52,UCBPlayer
737,UCBPlayer,122,227,349,20,57,UCBPlayer
738,UCBPlayer,109,259,368,15,49,UCBPlayer
739,UCBPlayer,118,218,336,16,60,UCBPlayer
740,UCBPlayer,117,267,384,19,45,UCBPlayer
741,UCBPlayer,110,210,320,12,64,UCBPlayer
742,UCBPlayer,126,271,397,23,42,UCBPlayer
743,UCBPlayer,105,210,315,10,65,UCBPlayer
744,UCBPlayer,130,275,405,25,40,UCBPlayer
745,UCBPlayer,105,210,315,10,65,UCBPlayer
746,UCBPlayer,130,275,405,25,40,UCBPlayer
747,UCBPlayer,106,206,312,10,66,UCBPlayer
748,UCBPlayer,130,275,405,25,40,UCBPlayer
749,UCBPlayer,105,210,315,10,65,UCBPlayer
750,UCBPlayer,131,271,402,25,41,UCBPlayer
751,UCBPlayer,105,210,315,10,65,UCBPlayer
752,UCBPlayer,130,275,405,25,40,UCBPlayer
753,UCBPlayer,105,210,315,10,65,UCBPlayer
754,UCBPlayer,130,275,405,25,40,UCBPlayer
755,UCBPlayer,103,203,306,10,68,UCBPlayer
756,UCBPlayer,128,283,411,25,38,UCBPlayer
757,UCBPlayer,111,186,297,10,71,UCBPlayer
758,UCBPlayer,124,299,423,25,34,UCBPlayer
759,UCBPlayer,115,170,285,10,75,UCBPlayer
760,UCBPlayer,120,315,435,25,30,UCBPlayer
761,UCBPlayer,119,154,273,10,79,UCBPlayer
762,UCBPlayer,112,332,444,25,27,UCBPlayer
763,UCBPlayer,127,137,264,10,82,UCBPlayer
764,UCBPlayer,104,349,453,25,24,UCBPlayer
765,UCBPlayer,126,126,252,7,85,Tie
766,UCBPlayer,111,351,462,28,22,UCBPlayer
767,UCBPlayer,116,126,242,3,87,UCBPlayer
768,UCBPlayer,122,347,469,32,21,UCBPlayer
769,UCBPlayer,107,132,239,0,87,UCBPlayer
770,UCBPlayer,132,337,469,35,22,UCBPlayer
771,UCBPlayer,103,148,251,0,83,UCBPlayer
772,UCBPlayer,136,321,457,35,26,UCBPlayer
773,UCBPlayer,99,164,263,0,79,UCBPlayer
774,UCBPlayer,140,305,445,35,30,UCBPlayer
775,UCBPlayer,95,180,275,0,75,UCBPlayer
776,UCBPlayer,144,289,433,35,34,UCBPlayer
777,UCBPlayer,91,196,287,0,71,UCBPlayer
778,UCBPlayer,148,273,421,35,38,UCBPlayer
779,UCBPlayer,87,212,299,0,67,UCBPlayer
780,UCBPlayer,152,257,409,35,42,UCBPlayer
781,UCBPlayer,84,224,308,0,64,UCBPlayer
782,UCBPlayer,146,251,397,32,45,UCBPlayer
783,UCBPlayer,89,234,323,3,60,UCBPlayer
784,UCBPlayer,138,243,381,28,49,UCBPlayer
785,UCBPlayer,97,242,339,7,56,UCBPlayer
786,UCBPlayer,130,235,365,24,53,UCBPlayer
787,UCBPlayer,105,250,355,11,52,UCBPlayer
788,UCBPlayer,122,227,349,20,57,UCBPlayer
789,UCBPlayer,109,259,368,15,49,UCBPlayer
790,UCBPlayer,118,218,336,16,60,UCBPlayer
791,UCBPlayer,117,267,384,19,45,UCBPlayer
792,UCBPlayer,110,210,320,12,64,UCBPlayer
793,UCBPlayer,126,271,397,23,42,UCBPlayer
794,UCBPlayer,105,210,315,10,65,UCBPlayer
795,UCBPlayer,130,275,405,25,40,UCBPlayer
796,UCBPlayer,105,210,315,10,65,UCBPlayer
797,UCBPlayer,130,275,405,25,40,UCBPlayer
798,UCBPlayer,106,206,312,10,66,UCBPlayer
799,UCBPlayer,130,275,405,25,40,UCBPlayer
800,UCBPlayer,105,210,315,10,65,UCBPlayer
801,UCBPlayer,131,271,402,25,41,UCBPlayer
802,UCBPlayer,105,210,315,10,65,UCBPlayer
803,UCBPlayer,130,275,405,25,40,UCBPlayer
804,UCBPlayer,105,210,315,10,65,UCBPlayer
805,UCBPlayer,130,275,405,25,40,UCBPlayer
806,UCBPlayer,103,203,306,10,68,UCBPlayer
807,UCBPlayer,128,283,411,25,38,UCBPlayer
808,UCBPlayer,111,186,297,10,71,UCBPlayer
809,UCBPlayer,124,299,423,25,34,UCBPlayer
810,UCBPlayer,115,170,285,10,75,UCBPlayer
811,UCBPlayer,120,315,435,25,30,UCBPlayer
812,UCBPlayer,119,154,273,10,79,UCBPlayer
813,UCBPlayer,112,332,444,25,27,UCBPlayer
814,UCBPlayer,127,137,264,10,82,UCBPlayer
815,UCBPlayer,104,349,453,25,24,UCBPlayer
816,UCBPlayer,126,126,252,7,85,Tie
817,UCBPlayer,111,351,462,28,22,UCBPlayer
818,UCBPlayer,116,126,242,3,87,UCBPlayer
819,UCBPlayer,122,347,469,32,21,UCBPlayer
820,UCBPlayer,107,132,239,0,87,UCBPlayer
821,UCBPlayer,132,337,469,35,22,UCBPlayer
822,UCBPlayer,103,148,251,0,83,UCBPlayer
823,UCBPlayer,136,321,457,35,26,UCBPlayer
824,UCBPlayer,99,164,263,0,79,UCBPlayer
825,UCBPlayer,140,305,445,35,30,UCBPlayer
826,UCBPlayer,95,180,275,0,75,UCBPlayer
827,UCBPlayer,144,289,433,35,34,UCBPlayer
828,UCBPlayer,91,196,287,0,71,UCBPlayer
829,UCBPlayer,148,273,421,35,38,UCBPlayer
830,UCBPlayer,87,212,299,0,67,UCBPlayer
831,UCBPlayer,152,257,409,35,42,UCBPlayer
832,UCBPlayer,84,224,308,0,64,UCBPlayer
833,UCBPlayer,146,251,397,32,45,UCBPlayer
834,UCBPlayer,89,234,323,3,60,UCBPlayer
835,UCBPlayer,138,243,381,28,49,UCBPlayer
836,UCBPlayer,97,242,339,7,56,UCBPlayer
837,UCBPlayer,130,235,365,24,53,UCBPlayer
838,UCBPlayer,105,250,355,11,52,UCBPlayer
839,UCBPlayer,122,227,349,20,57,UCBPlayer
840,UCBPlayer,109,259,368,15,49,UCBPlayer
841,UCBPlayer,118,218,336,16,60,UCBPlayer
842,UCBPlayer,117,267,384,19,45,UCBPlayer
843,UCBPlayer,110,210,320,12,64,UCBPlayer
844,UCBPlayer,126,271,397,23,42,UCBPlayer
845,UCBPlayer,105,210,315,10,65,UCBPlayer
846,UCBPlayer,130,275,405,25,40,UCBPlayer
847,UCBPlayer,105,210,315,10,65,UCBPlayer
848,UCBPlayer,130,275,405,25,40,UCBPlayer
849,UCBPlayer,106,206,312,10,66,UCBPlayer
850,UCBPlayer,130,275,405,25,40,UCBPlayer
851,UCBPlayer,105,210,315,10,65,UCBPlayer
852,UCBPlayer,131,271,402,25,41,UCBPlayer
853,UCBPlayer,105,210,315,10,65,UCBPlayer
854,UCBPlayer,130,275,405,25,40,UCBPlayer
855,UCBPlayer,105,210,315,10,65,UCBPlayer
856,UCBPlayer,130,275,405,25,40,UCBPlayer
857,UCBPlayer,103,203,306,10,68,UCBPlayer
858,UCBPlayer,128,283,411,25,38,UCBPlayer
859,UCBPlayer,111,186,297,10,71,UCBPlayer
860,UCBPlayer,124,299,423,25,34,UCBPlayer
861,UCBPlayer,115,170,285,10,75,UCBPlayer
862,UCBPlayer,120,315,435,25,30,UCBPlayer
863,UCBPlayer,119,154,273,10,79,UCBPlayer
864,UCBPlayer,112,332,444,25,27,UCBPlayer
865,UCBPlayer,127,137,264,10,82,UCBPlayer
866,UCBPlayer,104,349,453,25,24,UCBPlayer
867,UCBPlayer,126,126,252,7,85,Tie
868,UCBPlayer,111,351,462,28,22,UCBPlayer
869,UCBPlayer,116,126,242,3,87,UCBPlayer
870,UCBPlayer,122,347,469,32,21,UCBPlayer
871,UCBPlayer,107,132,239,0,87,UCBPlayer
872,UCBPlayer,132,337,469,35,22,UCBPlayer
873,UCBPlayer,103,148,251,0,83,UCBPlayer
874,UCBPlayer,136,321,457,35,26,UCBPlayer
875,UCBPlayer,99,164,263,0,79,UCBPlayer
876,UCBPlayer,140,305,445,35,30,UCBPlayer
877,UCBPlayer,95,180,275,0,75,UCBPlayer
878,UCBPlayer,144,289,433,35,34,UCBPlayer
879,UCBPlayer,91,196,287,0,71,UCBPlayer
880,UCBPlayer,148,273,421,35,38,UCBPlayer
881,UCBPlayer,87,212,299,0,67,UCBPlayer
882,UCBPlayer,152,257,409,35,42,UCBPlayer
883,UCBPlayer,84,224,308,0,64,UCBPlayer
884,UCBPlayer,146,251,397,32,45,UCBPlayer
885,UCBPlayer,89,234,323,3,60,UCBPlayer
886,UCBPlayer,138,243,381,28,49,UCBPlayer
887,UCBPlayer,97,242,339,7,56,UCBPlayer
888,UCBPlayer,130,235,365,24,53,UCBPlayer
889,UCBPlayer,105,250,355,11,52,UCBPlayer
890,UCBPlayer,122,227,349,20,57,UCBPlayer
891,UCBPlayer,109,259,368,15,49,UCBPlayer
892,UCBPlayer,118,218,336,16,60,UCBPlayer
893,UCBPlayer,117,267,384,19,45,UCBPlayer
894,UCBPlayer,110,210,320,12,64,UCBPlayer
895,UCBPlayer,126,271,397,23,42,UCBPlayer
896,UCBPlayer,105,210,315,10,65,UCBPlayer
897,UCBPlayer,130,275,405,25,40,UCBPlayer
898,UCBPlayer,105,210,315,10,65,UCBPlayer
899,UCBPlayer,130,275,405,25,40,UCBPlayer
900,UCBPlayer,106,206,312,10,66,UCBPlayer
901,UCBPlayer,130,275,405,25,40,UCBPlayer
902,UCBPlayer,105,210,315,10,65,UCBPlayer
903,UCBPlayer,131,271,402,25,41,UCBPlayer
904,UCBPlayer,105,210,315,10,65,UCBPlayer
905,UCBPlayer,130,275,405,25,40,UCBPlayer
906,UCBPlayer,105,210,315,10,65,UCBPlayer
907,UCBPlayer,130,275,405,25,40,UCBPlayer
908,UCBPlayer,103,203,306,10,68,UCBPlayer
909,UCBPlayer,128,283,411,25,38,UCBPlayer
910,UCBPlayer,111,186,297,10,71,UCBPlayer
911,UCBPlayer,124,299,423,25,34,UCBPlayer
912,UCBPlayer,115,170,285,10,75,UCBPlayer
913,UCBPlayer,120,315,435,25,30,UCBPlayer
914,UCBPlayer,119,154,273,10,79,UCBPlayer
915,UCBPlayer,112,332,444,25,27,UCBPlayer
916,UCBPlayer,127,137,264,10,82,UCBPlayer
917,UCBPlayer,104,349,453,25,24,UCBPlayer
918,UCBPlayer,126,126,252,7,85,Tie
919,UCBPlayer,111,351,462,28,22,UCBPlayer
920,UCBPlayer,116,126,242,3,87,UCBPlayer
921,UCBPlayer,122,347,469,32,21,UCBPlayer
922,UCBPlayer,107,132,239,0,87,UCBPlayer
923,UCBPlayer,132,337,469,35,22,UCBPlayer
924,UCBPlayer,103,148,251,0,83,UCBPlayer
925,UCBPlayer,136,321,457,35,26,UCBPlayer
926,UCBPlayer,99,164,263,0,79,UCBPlayer
927,UCBPlayer,140,305,445,35,30,UCBPlayer
928,UCBPlayer,95,180,275,0,75,UCBPlayer
929,UCBPlayer,144,289,433,35,34,UCBPlayer
930,UCBPlayer,91,196,287,0,71,UCBPlayer
931,UCBPlayer,148,273,421,35,38,UCBPlayer
932,UCBPlayer,87,212,299,0,67,UCBPlayer
933,UCBPlayer,152,257,409,35,42,UCBPlayer
934,UCBPlayer,84,224,308,0,64,UCBPlayer
935,UCBPlayer,146,251,397,32,45,UCBPlayer
936,UCBPlayer,89,234,323,3,60,UCBPlayer
937,UCBPlayer,138,243,381,28,49,UCBPlayer
938,UCBPlayer,97,242,339,7,56,UCBPlayer
939,UCBPlayer,130,235,365,24,53,UCBPlayer
940,UCBPlayer,105,250,355,11,52,UCBPlayer
941,UCBPlayer,122,227,349,20,57,UCBPlayer
942,UCBPlayer,109,259,368,15,49,UCBPlayer
943,UCBPlayer,118,218,336,16,60,UCBPlayer
944,UCBPlayer,117,267,384,19,45,UCBPlayer
945,UCBPlayer,110,210,320,12,64,UCBPlayer
946,UCBPlayer,126,271,397,23,42,UCBPlayer
947,UCBPlayer,105,210,315,10,65,UCBPlayer
948,UCBPlayer,130,275,405,25,40,UCBPlayer
949,UCBPlayer,105,210,315,10,65,UCBPlayer
950,UCBPlayer,130,275,405,25,40,UCBPlayer
951,UCBPlayer,106,206,312,10,66,UCBPlayer
952,UCBPlayer,130,275,405,25,40,UCBPlayer
953,UCBPlayer,105,210,315,10,65,UCBPlayer
954,UCBPlayer,131,271,402,25,41,UCBPlayer
955,UCBPlayer,105,210,315,10,65,UCBPlayer
956,UCBPlayer,130,275,405,25,40,UCBPlayer
957,UCBPlayer,105,210,315,10,65,UCBPlayer
958,UCBPlayer,130,275,405,25,40,UCBPlayer
959,UCBPlayer,103,203,306,10,68,UCBPlayer
960,UCBPlayer,128,283,411,25,38,UCBPlayer
961,UCBPlayer,111,186,297,10,71,UCBPlayer
962,UCBPlayer,124,299,423,25,34,UCBPlayer
963,UCBPlayer,115,170,285,10,75,UCBPlayer
964,UCBPlayer,120,315,435,25,30,UCBPlayer
965,UCBPlayer,119,154,273,10,79,UCBPlayer
966,UCBPlayer,112,332,444,25,27,UCBPlayer
967,UCBPlayer,127,137,264,10,82,UCBPlayer
968,UCBPlayer,104,349,453,25,24,UCBPlayer
969,UCBPlayer,126,126,252,7,85,Tie
970,UCBPlayer,111,351,462,28,22,UCBPlayer
971,UCBPlayer,116,126,242,3,87,UCBPlayer
972,UCBPlayer,122,347,469,32,21,UCBPlayer
973,UCBPlayer,107,132,239,0,87,UCBPlayer
974,UCBPlayer,132,337,469,35,22,UCBPlayer
975,UCBPlayer,103,148,251,0,83,UCBPlayer
976,UCBPlayer,136,321,457,35,26,UCBPlayer
977,UCBPlayer,99,164,263,0,79,UCBPlayer
978,UCBPlayer,140,305,445,35,30,UCBPlayer
979,UCBPlayer,95,180,275,0,75,UCBPlayer
980,UCBPlayer,144,289,433,35,34,UCBPlayer
981,UCBPlayer,91,196,287,0,71,UCBPlayer
982,UCBPlayer,148,273,421,35,38,UCBPlayer
983,UCBPlayer,87,212,299,0,67,UCBPlayer
984,UCBPlayer,152,257,409,35,42,UCBPlayer
985,UCBPlayer,84,224,308,0,64,UCBPlayer
986,UCBPlayer,146,251,397,32,45,UCBPlayer
987,UCBPlayer,89,234,323,3,60,UCBPlayer
988,UCBPlayer,138,243,381,28,49,UCBPlayer
989,UCBPlayer,97,242,339,7,56,UCBPlayer
990,UCBPlayer,130,235,365,24,53,UCBPlayer
991,UCBPlayer,105,250,355,11,52,UCBPlayer
992,UCBPlayer,122,227,349,20,57,UCBPlayer
993,UCBPlayer,109,259,368,15,49,UCBPlayer
994,UCBPlayer,118,218,336,16,60,UCBPlayer
995,UCBPlayer,117,267,384,19,45,UCBPlayer
996,UCBPlayer,110,210,320,12,64,UCBPlayer
997,UCBPlayer,126,271,397,23,42,UCBPlayer
998,UCBPlayer,105,210,315,10,65,UCBPlayer
999,UCBPlayer,130,275,405,25,40,UCBPlayer
1000,UCBPlayer,105,210,315,10,65,UCBPlayer
1001,UCBPlayer,130,275,405,25,40,UCBPlayer
1002,UCBPlayer,106,206,312,10,66,UCBPlayer
1003,UCBPlayer,130,275,405,25,40,UCBPlayer
1004,UCBPlayer,105,210,315,10,65,UCBPlayer
1005,UCBPlayer,131,271,402,25,41,UCBPlayer
1006,UCBPlayer,105,210,315,10,65,UCBPlayer
1007,UCBPlayer,130,275,405,25,40,UCBPlayer
1008,UCBPlayer,105,210,315,10,65,UCBPlayer
1009,UCBPlayer,130,275,405,25,40,UCBPlayer
1010,UCBPlayer,103,203,306,10,68,UCBPlayer
1011,UCBPlayer,128,283,411,25,38,UCBPlayer
1012,UCBPlayer,111,186,297,10,71,UCBPlayer
1013,UCBPlayer,124,299,423,25,34,UCBPlayer
1014,UCBPlayer,115,170,285,10,75,UCBPlayer
1015,UCBPlayer,120,315,435,25,30,UCBPlayer
1016,UCBPlayer,119,154,273,10,79,UCBPlayer
1017,UCBPlayer,112,332,444,25,27,UCBPlayer
1018,UCBPlayer,127,137,264,10,82,UCBPlayer
1019,UCBPlayer,104,349,453,25,24,UCBPlayer
1020,UCBPlayer,126,126,252,7,85,Tie
1021,UCBPlayer,111,351,462,28,22,UCBPlayer
1022,UCBPlayer,116,126,242,3,87,UCBPlayer
1023,UCBPlayer,122,347,469,32,21,UCBPlayer
1024,UCBPlayer,107,132,239,0,87,UCBPlayer
1025,UCBPlayer,132,337,469,35,22,UCBPlayer
1026,UCBPlayer,103,148,251,0,83,UCBPlayer
1027,UCBPlayer,136,321,457,35,26,UCBPlayer
1028,UCBPlayer,99,164,263,0,79,UCBPlayer
1029,UCBPlayer,140,305,445,35,30,UCBPlayer
1030,UCBPlayer,95,180,275,0,75,UCBPlayer
1031,UCBPlayer,144,289,433,35,34,UCBPlayer
1032,UCBPlayer,91,196,287,0,71,UCBPlayer
1033,UCBPlayer,148,273,421,35,38,UCBPlayer
1034,UCBPlayer,87,212,299,0,67,UCBPlayer
1035,UCBPlayer,152,257,409,35,42,UCBPlayer
1036,UCBPlayer,84,224,308,0,64,UCBPlayer
1037,UCBPlayer,146,251,397,32,45,UCBPlayer
1038,UCBPlayer,89,234,323,3,60,UCBPlayer
1039,UCBPlayer,138,243,381,28,49,UCBPlayer
1040,UCBPlayer,97,242,339,7,56,UCBPlayer
1041,UCBPlayer,130,235,365,24,53,UCBPlayer
1042,UCBPlayer,105,250,355,11,52,UCBPlayer
1043,UCBPlayer,122,227,349,20,57,UCBPlayer
1044,UCBPlayer,109,259,368,15,49,UCBPlayer
1045,UCBPlayer,118,218,336,16,60,UCBPlayer
1046,UCBPlayer,117,267,384,19,45,UCBPlayer
1047,UCBPlayer,110,210,320,12,64,UCBPlayer
1048,UCBPlayer,126,271,397,23,42,UCBPlayer
1049,UCBPlayer,105,210,315,10,65,UCBPlayer
1050,UCBPlayer,130,275,405,25,40,UCBPlayer
1051,UCBPlayer,105,210,315,10,65,UCBPlayer
1052,UCBPlayer,130,275,405,25,40,UCBPlayer
1053,UCBPlayer,106,206,312,10,66,UCBPlayer
1054,UCBPlayer,130,275,405,25,40,UCBPlayer
1055,UCBPlayer,105,210,315,10,65,UCBPlayer
1056,UCBPlayer,131,271,402,25,41,UCBPlayer
1057,UCBPlayer,105,210,315,10,65,UCBPlayer
1058,UCBPlayer,130,275,405,25,40,UCBPlayer
1059,UCBPlayer,105,210,315,10,65,UCBPlayer
1060,UCBPlayer,130,275,405,25,40,UCBPlayer
1061,UCBPlayer,103,203,306,10,68,UCBPlayer
1062,UCBPlayer,128,283,411,25,38,UCBPlayer
1063,UCBPlayer,111,186,297,10,71,UCBPlayer
1064,UCBPlayer,124,299,423,25,34,UCBPlayer
1065,UCBPlayer,115,170,285,10,75,UCBPlayer
1066,UCBPlayer,120,315,435,25,30,UCBPlayer
1067,UCBPlayer,119,154,273,10,79,UCBPlayer
1068,UCBPlayer,112,332,444,25,27,UCBPlayer
1069,UCBPlayer,127,137,264,10,82,UCBPlayer
1070,UCBPlayer,104,349,453,25,24,UCBPlayer
1071,UCBPlayer,126,126,252,7,85,Tie
1072,UCBPlayer,111,351,462,28,22,UCBPlayer
1073,UCBPlayer,116,126,242,3,87,UCBPlayer
1074,UCBPlayer,122,347,469,32,21,UCBPlayer
1075,UCBPlayer,107,132,239,0,87,UCBPlayer
1076,UCBPlayer,132,337,469,35,22,UCBPlayer
1077,UCBPlayer,103,148,251,0,83,UCBPlayer
1078,UCBPlayer,136,321,457,35,26,UCBPlayer
1079,UCBPlayer,99,164,263,0,79,UCBPlayer
1080,UCBPlayer,140,305,445,35,30,UCBPlayer
1081,UCBPlayer,95,180,275,0,75,UCBPlayer
1082,UCBPlayer,144,289,433,35,34,UCBPlayer
1083,UCBPlayer,91,196,287,0,71,UCBPlayer
1084,UCBPlayer,148,273,421,35,38,UCBPlayer
1085,UCBPlayer,87,212,299,0,67,UCBPlayer
1086,UCBPlayer,152,257,409,35,42,UCBPlayer
1087,UCBPlayer,84,224,308,0,64,UCBPlayer
1088,UCBPlayer,146,251,397,32,45,UCBPlayer
1089,UCBPlayer,89,234,323,3,60,UCBPlayer
1090,UCBPlayer,138,243,381,28,49,UCBPlayer
1091,UCBPlayer,97,242,339,7,56,UCBPlayer
1092,UCBPlayer,130,235,365,24,53,UCBPlayer
1093,UCBPlayer,105,250,355,11,52,UCBPlayer
1094,UCBPlayer,122,227,349,20,57,UCBPlayer
1095,UCBPlayer,109,259,368,15,49,UCBPlayer
1096,UCBPlayer,118,218,336,16,60,UCBPlayer
1097,UCBPlayer,117,267,384,19,45,UCBPlayer
1098,UCBPlayer,110,210,320,12,64,UCBPlayer
1099,UCBPlayer,126,271,397,23,42,UCBPlayer
1100,UCBPlayer,105,210,315,10,65,UCBPlayer
1101,UCBPlayer,130,275,405,25,40,UCBPlayer
1102,UCBPlayer,105,210,315,10,65,UCBPlayer
1103,UCBPlayer,130,275,405,25,40,UCBPlayer
1104,UCBPlayer,106,206,312,10,66,UCBPlayer
1105,UCBPlayer,130,275,405,25,40,UCBPlayer
1106,UCBPlayer,105,210,315,10,65,UCBPlayer
1107,UCBPlayer,131,271,402,25,41,UCBPlayer
1108,UCBPlayer,105,210,315,10,65,UCBPlayer
1109,UCBPlayer,130,275,405,25,40,UCBPlayer
1110,UCBPlayer,105,210,315,10,65,UCBPlayer
1111,UCBPlayer,130,275,405,25,40,UCBPlayer
1112,UCBPlayer,103,203,306,10,68,UCBPlayer
1113,UCBPlayer,128,283,411,25,38,UCBPlayer
1114,UCBPlayer,111,186,297,10,71,UCBPlayer
1115,UCBPlayer,124,299,423,25,34,UCBPlayer
1116,UCBPlayer,115,170,285,10,75,UCBPlayer
1117,UCBPlayer,120,315,435,25,30,UCBPlayer
1118,UCBPlayer,119,154,273,10,79,UCBPlayer
1119,UCBPlayer,112,332,444,25,27,UCBPlayer
1120,UCBPlayer,127,137,264,10,82,UCBPlayer
1121,UCBPlayer,104,349,453,25,24,UCBPlayer
1122,UCBPlayer,126,126,252,7,85,Tie
1123,UCBPlayer,111,351,462,28,22,UCBPlayer
1124,UCBPlayer,116,126,242,3,87,UCBPlayer
1125,UCBPlayer,122,347,469,32,21,UCBPlayer
1126,UCBPlayer,107,132,239,0,87,UCBPlayer
1127,UCBPlayer,132,337,469,35,22,UCBPlayer
1128,UCBPlayer,103,148,251,0,83,UCBPlayer
1129,UCBPlayer,136,321,457,35,26,UCBPlayer
1130,UCBPlayer,99,164,263,0,79,UCBPlayer
1131,UCBPlayer,140,305,445,35,30,UCBPlayer
1132,UCBPlayer,95,180,275,0,75,UCBPlayer
1133,UCBPlayer,144,289,433,35,34,UCBPlayer
1134,UCBPlayer,91,196,287,0,71,UCBPlayer
1135,UCBPlayer,148,273,421,35,38,UCBPlayer
1136,UCBPlayer,87,212,299,0,67,UCBPlayer
1137,UCBPlayer,152,257,409,35,42,UCBPlayer
1138,UCBPlayer,84,224,308,0,64,UCBPlayer
1139,UCBPlayer,146,251,397,32,45,UCBPlayer
1140,UCBPlayer,89,234,323,3,60,UCBPlayer
1141,UCBPlayer,138,243,381,28,49,UCBPlayer
1142,UCBPlayer,97,242,339,7,56,UCBPlayer
1143,UCBPlayer,130,235,365,24,53,UCBPlayer
1144,UCBPlayer,105,250,355,11,52,UCBPlayer
1145,UCBPlayer,122,227,349,20,57,UCBPlayer
1146,UCBPlayer,109,259,368,15,49,UCBPlayer
1147,UCBPlayer,118,218,336,16,60,UCBPlayer
1148,UCBPlayer,117,267,384,19,45,UCBPlayer
1149,UCBPlayer,110,210,320,12,64,UCBPlayer
1150,UCBPlayer,126,271,397,23,42,UCBPlayer
1151,UCBPlayer,105,210,315,10,65,UCBPlayer
1152,UCBPlayer,130,275,405,25,40,UCBPlayer
1153,UCBPlayer,105,210,315,10,65,UCBPlayer
1154,UCBPlayer,130,275,405,25,40,UCBPlayer
1155,UCBPlayer,106,206,312,10,66,UCBPlayer
1156,UCBPlayer,130,275,405,25,40,UCBPlayer
1157,UCBPlayer,105,210,315,10,65,UCBPlayer
1158,UCBPlayer,131,271,402,25,41,UCBPlayer
1159,UCBPlayer,105,210,315,10,65,UCBPlayer
1160,UCBPlayer,130,275,405,25,40,UCBPlayer
1161,UCBPlayer,105,210,315,10,65,UCBPlayer
1162,UCBPlayer,130,275,405,25,40,UCBPlayer
1163,UCBPlayer,103,203,306,10,68,UCBPlayer
1164,UCBPlayer,128,283,411,25,38,UCBPlayer
1165,UCBPlayer,111,186,297,10,71,UCBPlayer
1166,UCBPlayer,124,299,423,25,34,UCBPlayer
1167,UCBPlayer,115,170,285,10,75,UCBPlayer
1168,UCBPlayer,120,315,435,25,30,UCBPlayer
1169,UCBPlayer,119,154,273,10,79,UCBPlayer
1170,UCBPlayer,112,332,444,25,27,UCBPlayer
1171,UCBPlayer,127,137,264,10,82,UCBPlayer
1172,UCBPlayer,104,349,453,25,24,UCBPlayer
1173,UCBPlayer,126,126,252,7,85,Tie
1174,UCBPlayer,111,351,462,28,22,UCBPlayer
1175,UCBPlayer,116,126,242,3,87,UCBPlayer
1176,UCBPlayer,122,347,469,32,21,UCBPlayer
1177,UCBPlayer,107,132,239,0,87,UCBPlayer
1178,UCBPlayer,132,337,469,35,22,UCBPlayer
1179,UCBPlayer,103,148,251,0,83,UCBPlayer
1180,UCBPlayer,136,321,457,35,26,UCBPlayer
1181,UCBPlayer,99,164,263,0,79,UCBPlayer
1182,UCBPlayer,140,305,445,35,30,UCBPlayer
1183,UCBPlayer,95,180,275,0,75,UCBPlayer
1184,UCBPlayer,144,289,433,35,34,UCBPlayer
1185,UCBPlayer,91,196,287,0,71,UCBPlayer
1186,UCBPlayer,148,273,421,35,38,UCBPlayer
1187,UCBPlayer,87,212,299,0,67,UCBPlayer
1188,UCBPlayer,152,257,409,35,42,UCBPlayer
1189,UCBPlayer,84,224,308,0,64,UCBPlayer
1190,UCBPlayer,146,251,397,32,45,UCBPlayer
1191,UCBPlayer,89,234,323,3,60,UCBPlayer
1192,UCBPlayer,138,243,381,28,49,UCBPlayer
1193,UCBPlayer,97,242,339,7,56,UCBPlayer
1194,UCBPlayer,130,235,365,24,53,UCBPlayer
1195,UCBPlayer,105,250,355,11,52,UCBPlayer
1196,UCBPlayer,122,227,349,20,57,UCBPlayer
1197,UCBPlayer,109,259,368,15,49,UCBPlayer
1198,UCBPlayer,118,218,336,16,60,UCBPlayer
1199,UCBPlayer,117,267,384,19,45,UCBPlayer
1200,UCBPlayer,110,210,320,12,64,UCBPlayer
1201,UCBPlayer,126,271,397,23,42,UCBPlayer
1202,UCBPlayer,105,210,315,10,65,UCBPlayer
1203,UCBPlayer,130,275,405,25,40,UCBPlayer
1204,UCBPlayer,105,210,315,10,65,UCBPlayer
1205,UCBPlayer,130,275,405,25,40,UCBPlayer
1206,UCBPlayer,106,206,312,10,66,UCBPlayer
1207,UCBPlayer,130,275,405,25,40,UCBPlayer
1208,UCBPlayer,105,210,315,10,65,UCBPlayer
1209,UCBPlayer,131,271,402,25,41,UCBPlayer
1210,UCBPlayer,105,210,315,10,65,UCBPlayer
1211,UCBPlayer,130,275,405,25,40,UCBPlayer
1212,UCBPlayer,105,210,315,10,65,UCBPlayer
1213,UCBPlayer,130,275,405,25,40,UCBPlayer
1214,UCBPlayer,103,203,306,10,68,UCBPlayer
1215,UCBPlayer,128,283,411,25,38,UCBPlayer
1216,UCBPlayer,111,186,297,10,71,UCBPlayer
1217,UCBPlayer,124,299,423,25,34,UCBPlayer
1218,UCBPlayer,115,170,285,10,75,UCBPlayer
1219,UCBPlayer,120,315,435,25,30,UCBPlayer
1220,UCBPlayer,119,154,273,10,79,UCBPlayer
1221,UCBPlayer,112,332,444,25,27,UCBPlayer
1222,UCBPlayer,127,137,264,10,82,UCBPlayer
1223,UCBPlayer,104,349,453,25,24,UCBPlayer
1224,UCBPlayer,126,126,252,7,85,Tie
1225,UCBPlayer,111,351,462,28,22,UCBPlayer
1226,UCBPlayer,116,126,242,3,87,UCBPlayer
1227,UCBPlayer,122,347,469,32,21,UCBPlayer
1228,UCBPlayer,107,132,239,0,87,UCBPlayer
1229,UCBPlayer,132,337,469,35,22,UCBPlayer
1230,UCBPlayer,103,148,251,0,83,UCBPlayer
1231,UCBPlayer,136,321,457,35,26,UCBPlayer
1232,UCBPlayer,99,164,263,0,79,UCBPlayer
1233,UCBPlayer,140,305,445,35,30,UCBPlayer
1234,UCBPlayer,95,180,275,0,75,UCBPlayer
1235,UCBPlayer,144,289,433,35,34,UCBPlayer
1236,UCBPlayer,91,196,287,0,71,UCBPlayer
1237,UCBPlayer,148,273,421,35,38,UCBPlayer
1238,UCBPlayer,87,212,299,0,67,UCBPlayer
1239,UCBPlayer,152,257,409,35,42,UCBPlayer
1240,UCBPlayer,84,224,308,0,64,UCBPlayer
1241,UCBPlayer,146,251,397,32,45,UCBPlayer
1242,UCBPlayer,89,234,323,3,60,UCBPlayer
1243,UCBPlayer,138,243,381,28,49,UCBPlayer
1244,UCBPlayer,97,242,339,7,56,UCBPlayer
1245,UCBPlayer,130,235,365,24,53,UCBPlayer
1246,UCBPlayer,105,250,355,11,52,UCBPlayer
1247,UCBPlayer,122,227,349,20,57,UCBPlayer
1248,UCBPlayer,109,259,368,15,49,UCBPlayer
1249,UCBPlayer,118,218,336,16,60,UCBPlayer
1250,UCBPlayer,117,267,384,19,45,UCBPlayer
1251,UCBPlayer,110,210,320,12,64,UCBPlayer
1252,UCBPlayer,126,271,397,23,42,UCBPlayer
1253,UCBPlayer,105,210,315,10,65,UCBPlayer
1254,UCBPlayer,130,275,405,25,40,UCBPlayer
1255,UCBPlayer,105,210,315,10,65,UCBPlayer
1256,UCBPlayer,130,275,405,25,40,UCBPlayer
1257,UCBPlayer,106,206,312,10,66,UCBPlayer
1258,UCBPlayer,130,275,405,25,40,UCBPlayer
1259,UCBPlayer,105,210,315,10,65,UCBPlayer
1260,UCBPlayer,131,271,402,25,41,UCBPlayer
1261,UCBPlayer,105,210,315,10,65,UCBPlayer
1262,UCBPlayer,130,275,405,25,40,UCBPlayer
1263,UCBPlayer,105,210,315,10,65,UCBPlayer
1264,UCBPlayer,130,275,405,25,40,UCBPlayer
1265,UCBPlayer,103,203,306,10,68,UCBPlayer
1266,UCBPlayer,128,283,411,25,38,UCBPlayer
1267,UCBPlayer,111,186,297,10,71,UCBPlayer
1268,UCBPlayer,124,299,423,25,34,UCBPlayer
1269,UCBPlayer,115,170,285,10,75,UCBPlayer
1270,UCBPlayer,120,315,435,25,30,UCBPlayer
1271,UCBPlayer,119,154,273,10,79,UCBPlayer
1272,UCBPlayer,112,332,444,25,27,UCBPlayer
1273,UCBPlayer,127,137,264,10,82,UCBPlayer
1274,UCBPlayer,104,349,453,25,24,UCBPlayer
1275,UCBPlayer,126,126,252,7,85,Tie
1276,UCBPlayer,111,351,462,28,22,UCBPlayer
1277,UCBPlayer,116,126,242,3,87,UCBPlayer
1278,UCBPlayer,122,347,469,32,21,UCBPlayer
1279,UCBPlayer,107,132,239,0,87,UCBPlayer
1280,UCBPlayer,132,337,469,35,22,UCBPlayer
1281,UCBPlayer,103,148,251,0,83,UCBPlayer
1282,UCBPlayer,136,321,457,35,26,UCBPlayer
1283,UCBPlayer,99,164,263,0,79,UCBPlayer
1284,UCBPlayer,140,305,445,35,30,UCBPlayer
1285,UCBPlayer,95,180,275,0,75,UCBPlayer
1286,UCBPlayer,144,289,433,35,34,UCBPlayer
1287,UCBPlayer,91,196,287,0,71,UCBPlayer
1288,UCBPlayer,148,273,421,35,38,UCBPlayer
1289,UCBPlayer,87,212,299,0,67,UCBPlayer
1290,UCBPlayer,152,257,409,35,42,UCBPlayer
1291,UCBPlayer,84,224,308,0,64,UCBPlayer
1292,UCBPlayer,146,251,397,32,45,UCBPlayer
1293,UCBPlayer,89,234,323,3,60,UCBPlayer
1294,UCBPlayer,138,243,381,28,49,UCBPlayer
1295,UCBPlayer,97,242,339,7,56,UCBPlayer
1296,UCBPlayer,130,235,365,24,53,UCBPlayer
1297,UCBPlayer,105,250,355,11,52,UCBPlayer
1298,UCBPlayer,122,227,349,20,57,UCBPlayer
1299,UCBPlayer,109,259,368,15,49,UCBPlayer
1300,UCBPlayer,118,218,336,16,60,UCBPlayer
1301,UCBPlayer,117,267,384,19,45,UCBPlayer
1302,UCBPlayer,110,210,320,12,64,UCBPlayer
1303,UCBPlayer,126,271,397,23,42,UCBPlayer
1304,UCBPlayer,105,210,315,10,65,UCBPlayer
1305,UCBPlayer,130,275,405,25,40,UCBPlayer
1306,UCBPlayer,105,210,315,10,65,UCBPlayer
1307,UCBPlayer,130,275,405,25,40,UCBPlayer
1308,UCBPlayer,106,206,312,10,66,UCBPlayer
1309,UCBPlayer,130,275,405,25,40,UCBPlayer
1310,UCBPlayer,105,210,315,10,65,UCBPlayer
1311,UCBPlayer,131,271,402,25,41,UCBPlayer
1312,UCBPlayer,105,210,315,10,65,UCBPlayer
1313,UCBPlayer,130,275,405,25,40,UCBPlayer
1314,UCBPlayer,105,210,315,10,65,UCBPlayer
1315,UCBPlayer,130,275,405,25,40,UCBPlayer
1316,UCBPlayer,103,203,306,10,68,UCBPlayer
1317,UCBPlayer,128,283,411,25,38,UCBPlayer
1318,UCBPlayer,111,186,297,10,71,UCBPlayer
1319,UCBPlayer,124,299,423,25,34,UCBPlayer
1320,UCBPlayer,115,170,285,10,75,UCBPlayer
1321,UCBPlayer,120,315,435,25,30,UCBPlayer
1322,UCBPlayer,119,154,273,10,79,UCBPlayer
1323,UCBPlayer,112,332,444,25,27,UCBPlayer
1324,UCBPlayer,127,137,264,10,82,UCBPlayer
1325,UCBPlayer,104,349,453,25,24,UCBPlayer
1326,UCBPlayer,126,126,252,7,85,Tie
1327,UCBPlayer,111,351,462,28,22,UCBPlayer
1328,UCBPlayer,116,126,242,3,87,UCBPlayer
1329,UCBPlayer,122,347,469,32,21,UCBPlayer
1330,UCBPlayer,107,132,239,0,87,UCBPlayer
1331,UCBPlayer,132,337,469,35,22,UCBPlayer
1332,UCBPlayer,103,148,251,0,83,UCBPlayer
1333,UCBPlayer,136,321,457,35,26,UCBPlayer
1334,UCBPlayer,99,164,263,0,79,UCBPlayer
1335,UCBPlayer,140,305,445,35,30,UCBPlayer
1336,UCBPlayer,95,180,275,0,75,UCBPlayer
1337,UCBPlayer,144,289,433,35,34,UCBPlayer
1338,UCBPlayer,91,196,287,0,71,UCBPlayer
1339,UCBPlayer,148,273,421,35,38,UCBPlayer
1340,UCBPlayer,87,212,299,0,67,UCBPlayer
1341,UCBPlayer,152,257,409,35,42,UCBPlayer
1342,UCBPlayer,84,224,308,0,64,UCBPlayer
1343,UCBPlayer,146,251,397,32,45,UCBPlayer
1344,UCBPlayer,89,234,323,3,60,UCBPlayer
1345,UCBPlayer,138,243,381,28,49,UCBPlayer
1346,UCBPlayer,97,242,339,7,56,UCBPlayer
1347,UCBPlayer,130,235,365,24,53,UCBPlayer
1348,UCBPlayer,105,250,355,11,52,UCBPlayer
1349,UCBPlayer,122,227,349,20,57,UCBPlayer
1350,UCBPlayer,109,259,368,15,49,UCBPlayer
1351,UCBPlayer,118,218,336,16,60,UCBPlayer
1352,UCBPlayer,117,267,384,19,45,UCBPlayer
1353,UCBPlayer,110,210,320,12,64,UCBPlayer
1354,UCBPlayer,126,271,397,23,42,UCBPlayer
1355,UCBPlayer,105,210,315,10,65,UCBPlayer
1356,UCBPlayer,130,275,405,25,40,UCBPlayer
1357,UCBPlayer,105,210,315,10,65,UCBPlayer
1358,UCBPlayer,130,275,405,25,40,UCBPlayer
1359,UCBPlayer,106,206,312,10,66,UCBPlayer
1360,UCBPlayer,130,275,405,25,40,UCBPlayer
1361,UCBPlayer,105,210,315,10,65,UCBPlayer
1362,UCBPlayer,131,271,402,25,41,UCBPlayer
1363,UCBPlayer,105,210,315,10,65,UCBPlayer
1364,UCBPlayer,130,275,405,25,40,UCBPlayer
1365,UCBPlayer,105,210,315,10,65,UCBPlayer
1366,UCBPlayer,130,275,405,25,40,UCBPlayer
1367,UCBPlayer,103,203,306,10,68,UCBPlayer
1368,UCBPlayer,128,283,411,25,38,UCBPlayer
1369,UCBPlayer,111,186,297,10,71,UCBPlayer
1370,UCBPlayer,124,299,423,25,34,UCBPlayer
1371,UCBPlayer,115,170,285,10,75,UCBPlayer
1372,UCBPlayer,120,315,435,25,30,UCBPlayer
1373,UCBPlayer,119,154,273,10,79,UCBPlayer
1374,UCBPlayer,112,332,444,25,27,UCBPlayer
1375,UCBPlayer,127,137,264,10,82,UCBPlayer
1376,UCBPlayer,104,349,453,25,24,UCBPlayer
1377,UCBPlayer,126,126,252,7,85,Tie
1378,UCBPlayer,111,351,462,28,22,UCBPlayer
1379,UCBPlayer,116,126,242,3,87,UCBPlayer
1380,UCBPlayer,122,347,469,32,21,UCBPlayer
1381,UCBPlayer,107,132,239,0,87,UCBPlayer
1382,UCBPlayer,132,337,469,35,22,UCBPlayer
1383,UCBPlayer,103,148,251,0,83,UCBPlayer
1384,UCBPlayer,136,321,457,35,26,UCBPlayer
1385,UCBPlayer,99,164,263,0,79,UCBPlayer
1386,UCBPlayer,140,305,445,35,30,UCBPlayer
1387,UCBPlayer,95,180,275,0,75,UCBPlayer
1388,UCBPlayer,144,289,433,35,34,UCBPlayer
1389,UCBPlayer,91,196,287,0,71,UCBPlayer
1390,UCBPlayer,148,273,421,35,38,UCBPlayer
1391,UCBPlayer,87,212,299,0,67,UCBPlayer
1392,UCBPlayer,152,257,409,35,42,UCBPlayer
1393,UCBPlayer,84,224,308,0,64,UCBPlayer
1394,UCBPlayer,146,251,397,32,45,UCBPlayer
1395,UCBPlayer,89,234,323,3,60,UCBPlayer
1396,UCBPlayer,138,243,381,28,49,UCBPlayer
1397,UCBPlayer,97,242,339,7,56,UCBPlayer
1398,UCBPlayer,130,235,365,24,53,UCBPlayer
1399,UCBPlayer,105,250,355,11,52,UCBPlayer
1400,UCBPlayer,122,227,349,20,57,UCBPlayer
1401,UCBPlayer,109,259,368,15,49,UCBPlayer
1402,UCBPlayer,118,218,336,16,60,UCBPlayer
1403,UCBPlayer,117,267,384,19,45,UCBPlayer
1404,UCBPlayer,110,210,320,12,64,UCBPlayer
1405,UCBPlayer,126,271,397,23,42,UCBPlayer
1406,UCBPlayer,105,210,315,10,65,UCBPlayer
1407,UCBPlayer,130,275,405,25,40,UCBPlayer
1408,UCBPlayer,105,210,315,10,65,UCBPlayer
1409,UCBPlayer,130,275,405,25,40,UCBPlayer
1410,UCBPlayer,106,206,312,10,66,UCBPlayer
1411,UCBPlayer,130,275,405,25,40,UCBPlayer
1412,UCBPlayer,105,210,315,10,65,UCBPlayer
1413,UCBPlayer,131,271,402,25,41,UCBPlayer
1414,UCBPlayer,105,210,315,10,65,UCBPlayer
1415,UCBPlayer,130,275,405,25,40,UCBPlayer
1416,UCBPlayer,105,210,315,10,65,UCBPlayer
1417,UCBPlayer,130,275,405,25,40,UCBPlayer
1418,UCBPlayer,103,203,306,10,68,UCBPlayer
1419,UCBPlayer,128,283,411,25,38,UCBPlayer
1420,UCBPlayer,111,186,297,10,71,UCBPlayer
1421,UCBPlayer,124,299,423,25,34,UCBPlayer
1422,UCBPlayer,115,170,285,10,75,UCBPlayer
1423,UCBPlayer,120,315,435,25,30,UCBPlayer
1424,UCBPlayer,119,154,273,10,79,UCBPlayer
1425,UCBPlayer,112,332,444,25,27,UCBPlayer
1426,UCBPlayer,127,137,264,10,82,UCBPlayer
1427,UCBPlayer,104,349,453,25,24,UCBPlayer
1428,UCBPlayer,126,126,252,7,85,Tie
1429,UCBPlayer,111,351,462,28,22,UCBPlayer
1430,UCBPlayer,116,126,242,3,87,UCBPlayer
1431,UCBPlayer,122,347,469,32,21,UCBPlayer
1432,UCBPlayer,107,132,239,0,87,UCBPlayer
1433,UCBPlayer,132,337,469,35,22,UCBPlayer
1434,UCBPlayer,103,148,251,0,83,UCBPlayer
1435,UCBPlayer,136,321,457,35,26,UCBPlayer
1436,UCBPlayer,99,164,263,0,79,UCBPlayer
1437,UCBPlayer,140,305,445,35,30,UCBPlayer
1438,UCBPlayer,95,180,275,0,75,UCBPlayer
1439,UCBPlayer,144,289,433,35,34,UCBPlayer
1440,UCBPlayer,91,196,287,0,71,UCBPlayer
1441,UCBPlayer,148,273,421,35,38,UCBPlayer
1442,UCBPlayer,87,212,299,0,67,UCBPlayer
1443,UCBPlayer,152,257,409,35,42,UCBPlayer
1444,UCBPlayer,84,224,308,0,64,UCBPlayer
1445,UCBPlayer,146,251,397,32,45,UCBPlayer
1446,UCBPlayer,89,234,323,3,60,UCBPlayer
1447,UCBPlayer,138,243,381,28,49,UCBPlayer
1448,UCBPlayer,97,242,339,7,56,UCBPlayer
1449,UCBPlayer,130,235,365,24,53,UCBPlayer
1450,UCBPlayer,105,250,355,11,52,UCBPlayer
1451,UCBPlayer,122,227,349,20,57,UCBPlayer
1452,UCBPlayer,109,259,368,15,49,UCBPlayer
1453,UCBPlayer,118,218,336,16,60,UCBPlayer
1454,UCBPlayer,117,267,384,19,45,UCBPlayer
1455,UCBPlayer,110,210,320,12,64,UCBPlayer
1456,UCBPlayer,126,271,397,23,42,UCBPlayer
1457,UCBPlayer,105,210,315,10,65,UCBPlayer
1458,UCBPlayer,130,275,405,25,40,UCBPlayer
1459,UCBPlayer,105,210,315,10,65,UCBPlayer
1460,UCBPlayer,130,275,405,25,40,UCBPlayer
1461,UCBPlayer,106,206,312,10,66,UCBPlayer
1462,UCBPlayer,130,275,405,25,40,UCBPlayer
1463,UCBPlayer,105,210,315,10,65,UCBPlayer
1464,UCBPlayer,131,271,402,25,41,UCBPlayer
1465,UCBPlayer,105,210,315,10,65,UCBPlayer
1466,UCBPlayer,130,275,405,25,40,UCBPlayer
1467,UCBPlayer,105,210,315,10,65,UCBPlayer
1468,UCBPlayer,130,275,405,25,40,UCBPlayer
1469,UCBPlayer,103,203,306,10,68,UCBPlayer
1470,UCBPlayer,128,283,411,25,38,UCBPlayer
1471,UCBPlayer,111,186,297,10,71,UCBPlayer
1472,UCBPlayer,124,299,423,25,34,UCBPlayer
1473,UCBPlayer,115,170,285,10,75,UCBPlayer
1474,UCBPlayer,120,315,435,25,30,UCBPlayer
1475,UCBPlayer,119,154,273,10,79,UCBPlayer
1476,UCBPlayer,112,332,444,25,27,UCBPlayer
1477,UCBPlayer,127,137,264,10,82,UCBPlayer
1478,UCBPlayer,104,349,453,25,24,UCBPlayer
1479,UCBPlayer,126,126,252,7,85,Tie
1480,UCBPlayer,111,351,462,28,22,UCBPlayer
1481,UCBPlayer,116,126,242,3,87,UCBPlayer
1482,UCBPlayer,122,347,469,32,21,UCBPlayer
1483,UCBPlayer,107,132,239,0,87,UCBPlayer
1484,UCBPlayer,132,337,469,35,22,UCBPlayer
1485,UCBPlayer,103,148,251,0,83,UCBPlayer
1486,UCBPlayer,136,321,457,35,26,UCBPlayer
1487,UCBPlayer,99,164,263,0,79,UCBPlayer
1488,UCBPlayer,140,305,445,35,30,UCBPlayer
1489,UCBPlayer,95,180,275,0,75,UCBPlayer
1490,UCBPlayer,144,289,433,35,34,UCBPlayer
1491,UCBPlayer,91,196,287,0,71,UCBPlayer
1492,UCBPlayer,148,273,421,35,38,UCBPlayer
1493,UCBPlayer,87,212,299,0,67,UCBPlayer
1494,UCBPlayer,152,257,409,35,42,UCBPlayer
1495,UCBPlayer,84,224,308,0,64,UCBPlayer
1496,UCBPlayer,146,251,397,32,45,UCBPlayer
1497,UCBPlayer,89,234,323,3,60,UCBPlayer
1498,UCBPlayer,138,243,381,28,49,UCBPlayer
1499,UCBPlayer,97,242,339,7,56,UCBPlayer
1500,UCBPlayer,130,235,365,24,53,UCBPlayer
1501,UCBPlayer,105,250,355,11,52,UCBPlayer
1502,UCBPlayer,122,227,349,20,57,UCBPlayer
1503,UCBPlayer,109,259,368,15,49,UCBPlayer
1504,UCBPlayer,118,218,336,16,60,UCBPlayer
1505,UCBPlayer,117,267,384,19,45,UCBPlayer
1506,UCBPlayer,110,210,320,12,64,UCBPlayer
1507,UCBPlayer,126,271,397,23,42,UCBPlayer
1508,UCBPlayer,105,210,315,10,65,UCBPlayer
1509,UCBPlayer,130,275,405,25,40,UCBPlayer
1510,UCBPlayer,105,210,315,10,65,UCBPlayer
1511,UCBPlayer,130,275,405,25,40,UCBPlayer
1512,UCBPlayer,106,206,312,10,66,UCBPlayer
1513,UCBPlayer,130,275,405,25,40,UCBPlayer
1514,UCBPlayer,105,210,315,10,65,UCBPlayer
1515,UCBPlayer,131,271,402,25,41,UCBPlayer
1516,UCBPlayer,105,210,315,10,65,UCBPlayer
1517,UCBPlayer,130,275,405,25,40,UCBPlayer
1518,UCBPlayer,105,210,315,10,65,UCBPlayer
1519,UCBPlayer,130,275,405,25,40,UCBPlayer
1520,UCBPlayer,103,203,306,10,68,UCBPlayer
1521,UCBPlayer,128,283,411,25,38,UCBPlayer
1522,UCBPlayer,111,186,297,10,71,UCBPlayer
1523,UCBPlayer,124,299,423,25,34,UCBPlayer
1524,UCBPlayer,115,170,285,10,75,UCBPlayer
1525,UCBPlayer,120,315,435,25,30,UCBPlayer
1526,UCBPlayer,119,154,273,10,79,UCBPlayer
1527,UCBPlayer,112,332,444,25,27,UCBPlayer
1528,UCBPlayer,127,137,264,10,82,UCBPlayer
1529,UCBPlayer,104,349,453,25,24,UCBPlayer
1530,UCBPlayer,126,126,252,7,85,Tie
1531,UCBPlayer,111,351,462,28,22,UCBPlayer
1532,UCBPlayer,116,126,242,3,87,UCBPlayer
1533,UCBPlayer,122,347,469,32,21,UCBPlayer
1534,UCBPlayer,107,132,239,0,87,UCBPlayer
1535,UCBPlayer,132,337,469,35,22,UCBPlayer
1536,UCBPlayer,103,148,251,0,83,UCBPlayer
1537,UCBPlayer,136,321,457,35,26,UCBPlayer
1538,UCBPlayer,99,164,263,0,79,UCBPlayer
1539,UCBPlayer,140,305,445,35,30,UCBPlayer
1540,UCBPlayer,95,180,275,0,75,UCBPlayer
1541,UCBPlayer,144,289,433,35,34,UCBPlayer
1542,UCBPlayer,91,196,287,0,71,UCBPlayer
1543,UCBPlayer,148,273,421,35,38,UCBPlayer
1544,UCBPlayer,87,212,299,0,67,UCBPlayer
1545,UCBPlayer,152,257,409,35,42,UCBPlayer
1546,UCBPlayer,84,224,308,0,64,UCBPlayer
1547,UCBPlayer,146,251,397,32,45,UCBPlayer
1548,UCBPlayer,89,234,323,3,60,UCBPlayer
1549,UCBPlayer,138,243,381,28,49,UCBPlayer
1550,UCBPlayer,97,242,339,7,56,UCBPlayer
1551,UCBPlayer,130,235,365,24,53,UCBPlayer
1552,UCBPlayer,105,250,355,11,52,UCBPlayer
1553,UCBPlayer,122,227,349,20,57,UCBPlayer
1554,UCBPlayer,109,259,368,15,49,UCBPlayer
1555,UCBPlayer,118,218,336,16,60,UCBPlayer
1556,UCBPlayer,117,267,384,19,45,UCBPlayer
1557,UCBPlayer,110,210,320,12,64,UCBPlayer
1558,UCBPlayer,126,271,397,23,42,UCBPlayer
1559,UCBPlayer,105,210,315,10,65,UCBPlayer
1560,UCBPlayer,130,275,405,25,40,UCBPlayer
1561,UCBPlayer,105,210,315,10,65,UCBPlayer
1562,UCBPlayer,130,275,405,25,40,UCBPlayer
1563,UCBPlayer,106,206,312,10,66,UCBPlayer
1564,UCBPlayer,130,275,405,25,40,UCBPlayer
1565,UCBPlayer,105,210,315,10,65,UCBPlayer
1566,UCBPlayer,131,271,402,25,41,UCBPlayer
1567,UCBPlayer,105,210,315,10,65,UCBPlayer
1568,UCBPlayer,130,275,405,25,40,UCBPlayer
1569,UCBPlayer,105,210,315,10,65,UCBPlayer
1570,UCBPlayer,130,275,405,25,40,UCBPlayer
1571,UCBPlayer,103,203,306,10,68,UCBPlayer
1572,UCBPlayer,128,283,411,25,38,UCBPlayer
1573,UCBPlayer,111,186,297,10,71,UCBPlayer
1574,UCBPlayer,124,299,423,25,34,UCBPlayer
1575,UCBPlayer,115,170,285,10,75,UCBPlayer
1576,UCBPlayer,120,315,435,25,30,UCBPlayer
1577,UCBPlayer,119,154,273,10,79,UCBPlayer
1578,UCBPlayer,112,332,444,25,27,UCBPlayer
1579,UCBPlayer,127,137,264,10,82,UCBPlayer
1580,UCBPlayer,104,349,453,25,24,UCBPlayer
1581,UCBPlayer,126,126,252,7,85,Tie
1582,UCBPlayer,111,351,462,28,22,UCBPlayer
1583,UCBPlayer,116,126,242,3,87,UCBPlayer
1584,UCBPlayer,122,347,469,32,21,UCBPlayer
1585,UCBPlayer,107,132,239,0,87,UCBPlayer
1586,UCBPlayer,132,337,469,35,22,UCBPlayer
1587,UCBPlayer,103,148,251,0,83,UCBPlayer
1588,UCBPlayer,136,321,457,35,26,UCBPlayer
1589,UCBPlayer,99,164,263,0,79,UCBPlayer
1590,UCBPlayer,140,305,445,35,30,UCBPlayer
1591,UCBPlayer,95,180,275,0,75,UCBPlayer
1592,UCBPlayer,144,289,433,35,34,UCBPlayer
1593,UCBPlayer,91,196,287,0,71,UCBPlayer
1594,UCBPlayer,148,273,421,35,38,UCBPlayer
1595,UCBPlayer,87,212,299,0,67,UCBPlayer
1596,UCBPlayer,152,257,409,35,42,UCBPlayer
1597,UCBPlayer,84,224,308,0,64,UCBPlayer
1598,UCBPlayer,146,251,397,32,45,UCBPlayer
1599,UCBPlayer,89,234,323,3,60,UCBPlayer
1600,UCBPlayer,138,243,381,28,49,UCBPlayer
1601,UCBPlayer,97,242,339,7,56,UCBPlayer
1602,UCBPlayer,130,235,365,24,53,UCBPlayer
1603,UCBPlayer,105,250,355,11,52,UCBPlayer
1604,UCBPlayer,122,227,349,20,57,UCBPlayer
1605,UCBPlayer,109,259,368,15,49,UCBPlayer
1606,UCBPlayer,118,218,336,16,60,UCBPlayer
1607,UCBPlayer,117,267,384,19,45,UCBPlayer
1608,UCBPlayer,110,210,320,12,64,UCBPlayer
1609,UCBPlayer,126,271,397,23,42,UCBPlayer
1610,UCBPlayer,105,210,315,10,65,UCBPlayer
1611,UCBPlayer,130,275,405,25,40,UCBPlayer
1612,UCBPlayer,105,210,315,10,65,UCBPlayer
1613,UCBPlayer,130,275,405,25,40,UCBPlayer
1614,UCBPlayer,106,206,312,10,66,UCBPlayer
1615,UCBPlayer,130,275,405,25,40,UCBPlayer
1616,UCBPlayer,105,210,315,10,65,UCBPlayer
1617,UCBPlayer,131,271,402,25,41,UCBPlayer
1618,UCBPlayer,105,210,315,10,65,UCBPlayer
1619,UCBPlayer,130,275,405,25,40,UCBPlayer
1620,UCBPlayer,105,210,315,10,65,UCBPlayer
1621,UCBPlayer,130,275,405,25,40,UCBPlayer
1622,UCBPlayer,103,203,306,10,68,UCBPlayer
1623,UCBPlayer,128,283,411,25,38,UCBPlayer
1624,UCBPlayer,111,186,297,10,71,UCBPlayer
1625,UCBPlayer,124,299,423,25,34,UCBPlayer
1626,UCBPlayer,115,170,285,10,75,UCBPlayer
1627,UCBPlayer,120,315,435,25,30,UCBPlayer
1628,UCBPlayer,119,154,273,10,79,UCBPlayer
1629,UCBPlayer,112,332,444,25,27,UCBPlayer
1630,UCBPlayer,127,137,264,10,82,UCBPlayer
1631,UCBPlayer,104,349,453,25,24,UCBPlayer
1632,UCBPlayer,126,126,252,7,85,Tie
1633,UCBPlayer,111,351,462,28,22,UCBPlayer
1634,UCBPlayer,116,126,242,3,87,UCBPlayer
1635,UCBPlayer,122,347,469,32,21,UCBPlayer
1636,UCBPlayer,107,132,239,0,87,UCBPlayer
1637,UCBPlayer,132,337,469,35,22,UCBPlayer
1638,UCBPlayer,103,148,251,0,83,UCBPlayer
1639,UCBPlayer,136,321,457,35,26,UCBPlayer
1640,UCBPlayer,99,164,263,0,79,UCBPlayer
1641,UCBPlayer,140,305,445,35,30,UCBPlayer
1642,UCBPlayer,95,180,275,0,75,UCBPlayer
1643,UCBPlayer,144,289,433,35,34,UCBPlayer
1644,UCBPlayer,91,196,287,0,71,UCBPlayer
1645,UCBPlayer,148,273,421,35,38,UCBPlayer
1646,UCBPlayer,87,212,299,0,67,UCBPlayer
1647,UCBPlayer,152,257,409,35,42,UCBPlayer
1648,UCBPlayer,84,224,308,0,64,UCBPlayer
1649,UCBPlayer,146,251,397,32,45,UCBPlayer
1650,UCBPlayer,89,234,323,3,60,UCBPlayer
1651,UCBPlayer,138,243,381,28,49,UCBPlayer
1652,UCBPlayer,97,242,339,7,56,UCBPlayer
1653,UCBPlayer,130,235,365,24,53,UCBPlayer
1654,UCBPlayer,105,250,355,11,52,UCBPlayer
1655,UCBPlayer,122,227,349,20,57,UCBPlayer
1656,UCBPlayer,109,259,368,15,49,UCBPlayer
1657,UCBPlayer,118,218,336,16,60,UCBPlayer
1658,UCBPlayer,117,267,384,19,45,UCBPlayer
1659,UCBPlayer,110,210,320,12,64,UCBPlayer
1660,UCBPlayer,126,271,397,23,42,UCBPlayer
1661,UCBPlayer,105,210,315,10,65,UCBPlayer
1662,UCBPlayer,130,275,405,25,40,UCBPlayer
1663,UCBPlayer,105,210,315,10,65,UCBPlayer
1664,UCBPlayer,130,275,405,25,40,UCBPlayer
1665,UCBPlayer,106,206,312,10,66,UCBPlayer
1666,UCBPlayer,130,275,405,25,40,UCBPlayer
1667,UCBPlayer,105,210,315,10,65,UCBPlayer
1668,UCBPlayer,131,271,402,25,41,UCBPlayer
1669,UCBPlayer,105,210,315,10,65,UCBPlayer
1670,UCBPlayer,130,275,405,25,40,UCBPlayer
1671,UCBPlayer,105,210,315,10,65,UCBPlayer
1672,UCBPlayer,130,275,405,25,40,UCBPlayer
1673,UCBPlayer,103,203,306,10,68,UCBPlayer
1674,UCBPlayer,128,283,411,25,38,UCBPlayer
1675,UCBPlayer,111,186,297,10,71,UCBPlayer
1676,UCBPlayer,124,299,423,25,34,UCBPlayer
1677,UCBPlayer,115,170,285,10,75,UCBPlayer
1678,UCBPlayer,120,315,435,25,30,UCBPlayer
1679,UCBPlayer,119,154,273,10,79,UCBPlayer
1680,UCBPlayer,112,332,444,25,27,UCBPlayer
1681,UCBPlayer,127,137,264,10,82,UCBPlayer
1682,UCBPlayer,104,349,453,25,24,UCBPlayer
1683,UCBPlayer,126,126,252,7,85,Tie
1684,UCBPlayer,111,351,462,28,22,UCBPlayer
1685,UCBPlayer,116,126,242,3,87,UCBPlayer
1686,UCBPlayer,122,347,469,32,21,UCBPlayer
1687,UCBPlayer,107,132,239,0,87,UCBPlayer
1688,UCBPlayer,132,337,469,35,22,UCBPlayer
1689,UCBPlayer,103,148,251,0,83,UCBPlayer
1690,UCBPlayer,136,321,457,35,26,UCBPlayer
1691,UCBPlayer,99,164,263,0,79,UCBPlayer
1692,UCBPlayer,140,305,445,35,30,UCBPlayer
1693,UCBPlayer,95,180,275,0,75,UCBPlayer
1694,UCBPlayer,144,289,433,35,34,UCBPlayer
1695,UCBPlayer,91,196,287,0,71,UCBPlayer
1696,UCBPlayer,148,273,421,35,38,UCBPlayer
1697,UCBPlayer,87,212,299,0,67,UCBPlayer
1698,UCBPlayer,152,257,409,35,42,UCBPlayer
1699,UCBPlayer,84,224,308,0,64,UCBPlayer
1700,UCBPlayer,146,251,397,32,45,UCBPlayer
1701,UCBPlayer,89,234,323,3,60,UCBPlayer
1702,UCBPlayer,138,243,381,28,49,UCBPlayer
1703,UCBPlayer,97,242,339,7,56,UCBPlayer
1704,UCBPlayer,130,235,365,24,53,UCBPlayer
1705,UCBPlayer,105,250,355,11,52,UCBPlayer
1706,UCBPlayer,122,227,349,20,57,UCBPlayer
1707,UCBPlayer,109,259,368,15,49,UCBPlayer
1708,UCBPlayer,118,218,336,16,60,UCBPlayer
1709,UCBPlayer,117,267,384,19,45,UCBPlayer
1710,UCBPlayer,110,210,320,12,64,UCBPlayer
1711,UCBPlayer,126,271,397,23,42,UCBPlayer
1712,UCBPlayer,105,210,315,10,65,UCBPlayer
1713,UCBPlayer,130,275,405,25,40,UCBPlayer
1714,UCBPlayer,105,210,315,10,65,UCBPlayer
1715,UCBPlayer,130,275,405,25,40,UCBPlayer
1716,UCBPlayer,106,206,312,10,66,UCBPlayer
1717,UCBPlayer,130,275,405,25,40,UCBPlayer
1718,UCBPlayer,105,210,315,10,65,UCBPlayer
1719,UCBPlayer,131,271,402,25,41,UCBPlayer
1720,UCBPlayer,105,210,315,10,65,UCBPlayer
1721,UCBPlayer,130,275,405,25,40,UCBPlayer
1722,UCBPlayer,105,210,315,10,65,UCBPlayer
1723,UCBPlayer,130,275,405,25,40,UCBPlayer
1724,UCBPlayer,103,203,306,10,68,UCBPlayer
1725,UCBPlayer,128,283,411,25,38,UCBPlayer
1726,UCBPlayer,111,186,297,10,71,UCBPlayer
1727,UCBPlayer,124,299,423,25,34,UCBPlayer
1728,UCBPlayer,115,170,285,10,75,UCBPlayer
1729,UCBPlayer,120,315,435,25,30,UCBPlayer
1730,UCBPlayer,119,154,273,10,79,UCBPlayer
1731,UCBPlayer,112,332,444,25,27,UCBPlayer
1732,UCBPlayer,127,137,264,10,82,UCBPlayer
1733,UCBPlayer,104,349,453,25,24,UCBPlayer
1734,UCBPlayer,126,126,252,7,85,Tie
1735,UCBPlayer,111,351,462,28,22,UCBPlayer
1736,UCBPlayer,116,126,242,3,87,UCBPlayer
1737,UCBPlayer,122,347,469,32,21,UCBPlayer
1738,UCBPlayer,107,132,239,0,87,UCBPlayer
1739,UCBPlayer,132,337,469,35,22,UCBPlayer
1740,UCBPlayer,103,148,251,0,83,UCBPlayer
1741,UCBPlayer,136,321,457,35,26,UCBPlayer
1742,UCBPlayer,99,164,263,0,79,UCBPlayer
1743,UCBPlayer,140,305,445,35,30,UCBPlayer
1744,UCBPlayer,95,180,275,0,75,UCBPlayer
1745,UCBPlayer,144,289,433,35,34,UCBPlayer
1746,UCBPlayer,91,196,287,0,71,UCBPlayer
1747,UCBPlayer,148,273,421,35,38,UCBPlayer
1748,UCBPlayer,87,212,299,0,67,UCBPlayer
1749,UCBPlayer,152,257,409,35,42,UCBPlayer
1750,UCBPlayer,84,224,308,0,64,UCBPlayer
1751,UCBPlayer,146,251,397,32,45,UCBPlayer
1752,UCBPlayer,89,234,323,3,60,UCBPlayer
1753,UCBPlayer,138,243,381,28,49,UCBPlayer
1754,UCBPlayer,97,242,339,7,56,UCBPlayer
1755,UCBPlayer,130,235,365,24,53,UCBPlayer
1756,UCBPlayer,105,250,355,11,52,UCBPlayer
1757,UCBPlayer,122,227,349,20,57,UCBPlayer
1758,UCBPlayer,109,259,368,15,49,UCBPlayer
1759,UCBPlayer,118,218,336,16,60,UCBPlayer
1760,UCBPlayer,117,267,384,19,45,UCBPlayer
1761,UCBPlayer,110,210,320,12,64,UCBPlayer
1762,UCBPlayer,126,271,397,23,42,UCBPlayer
1763,UCBPlayer,105,210,315,10,65,UCBPlayer
1764,UCBPlayer,130,275,405,25,40,UCBPlayer
1765,UCBPlayer,105,210,315,10,65,UCBPlayer
1766,UCBPlayer,130,275,405,25,40,UCBPlayer
1767,UCBPlayer,106,206,312,10,66,UCBPlayer
1768,UCBPlayer,130,275,405,25,40,UCBPlayer
1769,UCBPlayer,105,210,315,10,65,UCBPlayer
1770,UCBPlayer,131,271,402,25,41,UCBPlayer
1771,UCBPlayer,105,210,315,10,65,UCBPlayer
1772,UCBPlayer,130,275,405,25,40,UCBPlayer
1773,UCBPlayer,105,210,315,10,65,UCBPlayer
1774,UCBPlayer,130,275,405,25,40,UCBPlayer
1775,UCBPlayer,103,203,306,10,68,UCBPlayer
1776,UCBPlayer,128,283,411,25,38,UCBPlayer
1777,UCBPlayer,111,186,297,10,71,UCBPlayer
1778,UCBPlayer,124,299,423,25,34,UCBPlayer
1779,UCBPlayer,115,170,285,10,75,UCBPlayer
1780,UCBPlayer,120,315,435,25,30,UCBPlayer
1781,UCBPlayer,119,154,273,10,79,UCBPlayer
1782,UCBPlayer,112,332,444,25,27,UCBPlayer
1783,UCBPlayer,127,137,264,10,82,UCBPlayer
1784,UCBPlayer,104,349,453,25,24,UCBPlayer
1785,UCBPlayer,126,126,252,7,85,Tie
1786,UCBPlayer,111,351,462,28,22,UCBPlayer
1787,UCBPlayer,116,126,242,3,87,UCBPlayer
1788,UCBPlayer,122,347,469,32,21,UCBPlayer
1789,UCBPlayer,107,132,239,0,87,UCBPlayer
1790,UCBPlayer,132,337,469,35,22,UCBPlayer
1791,UCBPlayer,103,148,251,0,83,UCBPlayer
1792,UCBPlayer,136,321,457,35,26,UCBPlayer
1793,UCBPlayer,99,164,263,0,79,UCBPlayer
1794,UCBPlayer,140,305,445,35,30,UCBPlayer
1795,UCBPlayer,95,180,275,0,75,UCBPlayer
1796,UCBPlayer,144,289,433,35,34,UCBPlayer
1797,UCBPlayer,91,196,287,0,71,UCBPlayer
1798,UCBPlayer,148,273,421,35,38,UCBPlayer
1799,UCBPlayer,87,212,299,0,67,UCBPlayer
1800,UCBPlayer,152,257,409,35,42,UCBPlayer
1801,UCBPlayer,84,224,308,0,64,UCBPlayer
1802,UCBPlayer,146,251,397,32,45,UCBPlayer
1803,UCBPlayer,89,234,323,3,60,UCBPlayer
1804,UCBPlayer,138,243,381,28,49,UCBPlayer
1805,UCBPlayer,97,242,339,7,56,UCBPlayer
1806,UCBPlayer,130,235,365,24,53,UCBPlayer
1807,UCBPlayer,105,250,355,11,52,UCBPlayer
1808,UCBPlayer,122,227,349,20,57,UCBPlayer
1809,UCBPlayer,109,259,368,15,49,UCBPlayer
1810,UCBPlayer,118,218,336,16,60,UCBPlayer
1811,UCBPlayer,117,267,384,19,45,UCBPlayer
1812,UCBPlayer,110,210,320,12,64,UCBPlayer
1813,UCBPlayer,126,271,397,23,42,UCBPlayer
1814,UCBPlayer,105,210,315,10,65,UCBPlayer
1815,UCBPlayer,130,275,405,25,40,UCBPlayer
1816,UCBPlayer,105,210,315,10,65,UCBPlayer
1817,UCBPlayer,130,275,405,25,40,UCBPlayer
1818,UCBPlayer,106,206,312,10,66,UCBPlayer
1819,UCBPlayer,130,275,405,25,40,UCBPlayer
1820,UCBPlayer,105,210,315,10,65,UCBPlayer
1821,UCBPlayer,131,271,402,25,41,UCBPlayer
1822,UCBPlayer,105,210,315,10,65,UCBPlayer
1823,UCBPlayer,130,275,405,25,40,UCBPlayer
1824,UCBPlayer,105,210,315,10,65,UCBPlayer
1825,UCBPlayer,130,275,405,25,40,UCBPlayer
1826,UCBPlayer,103,203,306,10,68,UCBPlayer
1827,UCBPlayer,128,283,411,25,38,UCBPlayer
1828,UCBPlayer,111,186,297,10,71,UCBPlayer
1829,UCBPlayer,124,299,423,25,34,UCBPlayer
1830,UCBPlayer,115,170,285,10,75,UCBPlayer
1831,UCBPlayer,120,315,435,25,30,UCBPlayer
1832,UCBPlayer,119,154,273,10,79,UCBPlayer
1833,UCBPlayer,112,332,444,25,27,UCBPlayer
1834,UCBPlayer,127,137,264,10,82,UCBPlayer
1835,UCBPlayer,104,349,453,25,24,UCBPlayer
1836,UCBPlayer,126,126,252,7,85,Tie
1837,UCBPlayer,111,351,462,28,22,UCBPlayer
1838,UCBPlayer,116,126,242,3,87,UCBPlayer
1839,UCBPlayer,122,347,469,32,21,UCBPlayer
1840,UCBPlayer,107,132,239,0,87,UCBPlayer
1841,UCBPlayer,132,337,469,35,22,UCBPlayer
1842,UCBPlayer,103,148,251,0,83,UCBPlayer
1843,UCBPlayer,136,321,457,35,26,UCBPlayer
1844,UCBPlayer,99,164,263,0,79,UCBPlayer
1845,UCBPlayer,140,305,445,35,30,UCBPlayer
1846,UCBPlayer,95,180,275,0,75,UCBPlayer
1847,UCBPlayer,144,289,433,35,34,UCBPlayer
1848,UCBPlayer,91,196,287,0,71,UCBPlayer
1849,UCBPlayer,148,273,421,35,38,UCBPlayer
1850,UCBPlayer,87,212,299,0,67,UCBPlayer
1851,UCBPlayer,152,257,409,35,42,UCBPlayer
1852,UCBPlayer,84,224,308,0,64,UCBPlayer
1853,UCBPlayer,146,251,397,32,45,UCBPlayer
1854,UCBPlayer,89,234,323,3,60,UCBPlayer
1855,UCBPlayer,138,243,381,28,49,UCBPlayer
1856,UCBPlayer,97,242,339,7,56,UCBPlayer
1857,UCBPlayer,130,235,365,24,53,UCBPlayer
1858,UCBPlayer,105,250,355,11,52,UCBPlayer
1859,UCBPlayer,122,227,349,20,57,UCBPlayer
1860,UCBPlayer,109,259,368,15,49,UCBPlayer
1861,UCBPlayer,118,218,336,16,60,UCBPlayer
1862,UCBPlayer,117,267,384,19,45,UCBPlayer
1863,UCBPlayer,110,210,320,12,64,UCBPlayer
1864,UCBPlayer,126,271,397,23,42,UCBPlayer
1865,UCBPlayer,105,210,315,10,65,UCBPlayer
1866,UCBPlayer,130,275,405,25,40,UCBPlayer
1867,UCBPlayer,105,210,315,10,65,UCBPlayer
1868,UCBPlayer,130,275,405,25,40,UCBPlayer
1869,UCBPlayer,106,206,312,10,66,UCBPlayer
1870,UCBPlayer,130,275,405,25,40,UCBPlayer
1871,UCBPlayer,105,210,315,10,65,UCBPlayer
1872,UCBPlayer,131,271,402,25,41,UCBPlayer
1873,UCBPlayer,105,210,315,10,65,UCBPlayer
1874,UCBPlayer,130,275,405,25,40,UCBPlayer
1875,UCBPlayer,105,210,315,10,65,UCBPlayer
1876,UCBPlayer,130,275,405,25,40,UCBPlayer
1877,UCBPlayer,103,203,306,10,68,UCBPlayer
1878,UCBPlayer,128,283,411,25,38,UCBPlayer
1879,UCBPlayer,111,186,297,10,71,UCBPlayer
1880,UCBPlayer,124,299,423,25,34,UCBPlayer
1881,UCBPlayer,115,170,285,10,75,UCBPlayer
1882,UCBPlayer,120,315,435,25,30,UCBPlayer
1883,UCBPlayer,119,154,273,10,79,UCBPlayer
1884,UCBPlayer,112,332,444,25,27,UCBPlayer
1885,UCBPlayer,127,137,264,10,82,UCBPlayer
1886,UCBPlayer,104,349,453,25,24,UCBPlayer
1887,UCBPlayer,126,126,252,7,85,Tie
1888,UCBPlayer,111,351,462,28,22,UCBPlayer
1889,UCBPlayer,116,126,242,3,87,UCBPlayer
1890,UCBPlayer,122,347,469,32,21,UCBPlayer
1891,UCBPlayer,107,132,239,0,87,UCBPlayer
1892,UCBPlayer,132,337,469,35,22,UCBPlayer
1893,UCBPlayer,103,148,251,0,83,UCBPlayer
1894,UCBPlayer,136,321,457,35,26,UCBPlayer
1895,UCBPlayer,99,164,263,0,79,UCBPlayer
1896,UCBPlayer,140,305,445,35,30,UCBPlayer
1897,UCBPlayer,95,180,275,0,75,UCBPlayer
1898,UCBPlayer,144,289,433,35,34,UCBPlayer
1899,UCBPlayer,91,196,287,0,71,UCBPlayer
1900,UCBPlayer,148,273,421,35,38,UCBPlayer
1901,UCBPlayer,87,212,299,0,67,UCBPlayer
1902,UCBPlayer,152,257,409,35,42,UCBPlayer
1903,UCBPlayer,84,224,308,0,64,UCBPlayer
1904,UCBPlayer,146,251,397,32,45,UCBPlayer
1905,UCBPlayer,89,234,323,3,60,UCBPlayer
1906,UCBPlayer,138,243,381,28,49,UCBPlayer
1907,UCBPlayer,97,242,339,7,56,UCBPlayer
1908,UCBPlayer,130,235,365,24,53,UCBPlayer
1909,UCBPlayer,105,250,355,11,52,UCBPlayer
1910,UCBPlayer,122,227,349,20,57,UCBPlayer
1911,UCBPlayer,109,259,368,15,49,UCBPlayer
1912,UCBPlayer,118,218,336,16,60,UCBPlayer
1913,UCBPlayer,117,267,384,19,45,UCBPlayer
1914,UCBPlayer,110,210,320,12,64,UCBPlayer
1915,UCBPlayer,126,271,397,23,42,UCBPlayer
1916,UCBPlayer,105,210,315,10,65,UCBPlayer
1917,UCBPlayer,130,275,405,25,40,UCBPlayer
1918,UCBPlayer,105,210,315,10,65,UCBPlayer
1919,UCBPlayer,130,275,405,25,40,UCBPlayer
1920,UCBPlayer,106,206,312,10,66,UCBPlayer
1921,UCBPlayer,130,275,405,25,40,UCBPlayer
1922,UCBPlayer,105,210,315,10,65,UCBPlayer
1923,UCBPlayer,131,271,402,25,41,UCBPlayer
1924,UCBPlayer,105,210,315,10,65,UCBPlayer
1925,UCBPlayer,130,275,405,25,40,UCBPlayer
1926,UCBPlayer,105,210,315,10,65,UCBPlayer
1927,UCBPlayer,130,275,405,25,40,UCBPlayer
1928,UCBPlayer,103,203,306,10,68,UCBPlayer
1929,UCBPlayer,128,283,411,25,38,UCBPlayer
1930,UCBPlayer,111,186,297,10,71,UCBPlayer
1931,UCBPlayer,124,299,423,25,34,UCBPlayer
1932,UCBPlayer,115,170,285,10,75,UCBPlayer
1933,UCBPlayer,120,315,435,25,30,UCBPlayer
1934,UCBPlayer,119,154,273,10,79,UCBPlayer
1935,UCBPlayer,112,332,444,25,27,UCBPlayer
1936,UCBPlayer,127,137,264,10,82,UCBPlayer
1937,UCBPlayer,104,349,453,25,24,UCBPlayer
1938,UCBPlayer,126,126,252,7,85,Tie
1939,UCBPlayer,111,351,462,28,22,UCBPlayer
1940,UCBPlayer,116,126,242,3,87,UCBPlayer
1941,UCBPlayer,122,347,469,32,21,UCBPlayer
1942,UCBPlayer,107,132,239,0,87,UCBPlayer
1943,UCBPlayer,132,337,469,35,22,UCBPlayer
1944,UCBPlayer,103,148,251,0,83,UCBPlayer
1945,UCBPlayer,136,321,457,35,26,UCBPlayer
1946,UCBPlayer,99,164,263,0,79,UCBPlayer
1947,UCBPlayer,140,305,445,35,30,UCBPlayer
1948,UCBPlayer,95,180,275,0,75,UCBPlayer
1949,UCBPlayer,144,289,433,35,34,UCBPlayer
1950,UCBPlayer,91,196,287,0,71,UCBPlayer
1951,UCBPlayer,148,273,421,35,38,UCBPlayer
1952,UCBPlayer,87,212,299,0,67,UCBPlayer
1953,UCBPlayer,152,257,409,35,42,UCBPlayer
1954,UCBPlayer,84,224,308,0,64,UCBPlayer
1955,UCBPlayer,146,251,397,32,45,UCBPlayer
1956,UCBPlayer,89,234,323,3,60,UCBPlayer
1957,UCBPlayer,138,243,381,28,49,UCBPlayer
1958,UCBPlayer,97,242,339,7,56,UCBPlayer
1959,UCBPlayer,130,235,365,24,53,UCBPlayer
1960,UCBPlayer,105,250,355,11,52,UCBPlayer
1961,UCBPlayer,122,227,349,20,57,UCBPlayer
1962,UCBPlayer,109,259,368,15,49,UCBPlayer
1963,UCBPlayer,118,218,336,16,60,UCBPlayer
1964,UCBPlayer,117,267,384,19,45,UCBPlayer
1965,UCBPlayer,110,210,320,12,64,UCBPlayer
1966,UCBPlayer,126,271,397,23,42,UCBPlayer
1967,UCBPlayer,105,210,315,10,65,UCBPlayer
1968,UCBPlayer,130,275,405,25,40,UCBPlayer
1969,UCBPlayer,105,210,315,10,65,UCBPlayer
1970,UCBPlayer,130,275,405,25,40,UCBPlayer
1971,UCBPlayer,106,206,312,10,66,UCBPlayer
1972,UCBPlayer,130,275,405,25,40,UCBPlayer
1973,UCBPlayer,105,210,315,10,65,UCBPlayer
1974,UCBPlayer,131,271,402,25,41,UCBPlayer
1975,UCBPlayer,105,210,315,10,65,UCBPlayer
1976,UCBPlayer,130,275,405,25,40,UCBPlayer
1977,UCBPlayer,105,210,315,10,65,UCBPlayer
1978,UCBPlayer,130,275,405,25,40,UCBPlayer
1979,UCBPlayer,103,203,306,10,68,UCBPlayer
1980,UCBPlayer,128,283,411,25,38,UCBPlayer
1981,UCBPlayer,111,186,297,10,71,UCBPlayer
1982,UCBPlayer,124,299,423,25,34,UCBPlayer
1983,UCBPlayer,115,170,285,10,75,UCBPlayer
1984,UCBPlayer,120,315,435,25,30,UCBPlayer
1985,UCBPlayer,119,154,273,10,79,UCBPlayer
1986,UCBPlayer,112,332,444,25,27,UCBPlayer
1987,UCBPlayer,127,137,264,10,82,UCBPlayer
1988,UCBPlayer,104,349,453,25,24,UCBPlayer
1989,UCBPlayer,126,126,252,7,85,Tie
1990,UCBPlayer,111,351,462,28,22,UCBPlayer
1991,UCBPlayer,116,126,242,3,87,UCBPlayer
1992,UCBPlayer,122,347,469,32,21,UCBPlayer
1993,UCBPlayer,107,132,239,0,87,UCBPlayer
1994,UCBPlayer,132,337,469,35,22,UCBPlayer
1995,UCBPlayer,103,148,251,0,83,UCBPlayer
1996,UCBPlayer,136,321,457,35,26,UCBPlayer
1997,UCBPlayer,99,164,263,0,79,UCBPlayer
1998,UCBPlayer,140,305,445,35,30,UCBPlayer
1999,UCBPlayer,95,180,275,0,75,UCBPlayer
2000,UCBPlayer,144,289,433,35,34,UCBPlayer
2001,UCBPlayer,91,196,287,0,71,UCBPlayer
2002,UCBPlayer,148,273,421,35,38,UCBPlayer
2003,UCBPlayer,87,212,299,0,67,UCBPlayer
2004,UCBPlayer,152,257,409,35,42,UCBPlayer
2005,UCBPlayer,84,224,308,0,64,UCBPlayer
2006,UCBPlayer,146,251,397,32,45,UCBPlayer
2007,UCBPlayer,89,234,323,3,60,UCBPlayer
2008,UCBPlayer,138,243,381,28,49,UCBPlayer
2009,UCBPlayer,97,242,339,7,56,UCBPlayer
2010,UCBPlayer,130,235,365,24,53,UCBPlayer
2011,UCBPlayer,105,250,355,11,52,UCBPlayer
2012,UCBPlayer,122,227,349,20,57,UCBPlayer
2013,UCBPlayer,109,259,368,15,49,UCBPlayer
2014,UCBPlayer,118,218,336,16,60,UCBPlayer
2015,UCBPlayer,117,267,384,19,45,UCBPlayer
2016,UCBPlayer,110,210,320,12,64,UCBPlayer
2017,UCBPlayer,126,271,397,23,42,UCBPlayer
2018,UCBPlayer,105,210,315,10,65,UCBPlayer
2019,UCBPlayer,130,275,405,25,40,UCBPlayer
2020,UCBPlayer,105,210,315,10,65,UCBPlayer
2021,UCBPlayer,130,275,405,25,40,UCBPlayer
2022,UCBPlayer,106,206,312,10,66,UCBPlayer
2023,UCBPlayer,130,275,405,25,40,UCBPlayer
2024,UCBPlayer,105,210,315,10,65,UCBPlayer
2025,UCBPlayer,131,271,402,25,41,UCBPlayer
2026,UCBPlayer,105,210,315,10,65,UCBPlayer
2027,UCBPlayer,130,275,405,25,40,UCBPlayer
2028,UCBPlayer,105,210,315,10,65,UCBPlayer
2029,UCBPlayer,130,275,405,25,40,UCBPlayer
2030,UCBPlayer,103,203,306,10,68,UCBPlayer
2031,UCBPlayer,128,283,411,25,38,UCBPlayer
2032,UCBPlayer,111,186,297,10,71,UCBPlayer
2033,UCBPlayer,124,299,423,25,34,UCBPlayer
2034,UCBPlayer,115,170,285,10,75,UCBPlayer
2035,UCBPlayer,120,315,435,25,30,UCBPlayer
2036,UCBPlayer,119,154,273,10,79,UCBPlayer
2037,UCBPlayer,112,332,444,25,27,UCBPlayer
2038,UCBPlayer,127,137,264,10,82,UCBPlayer
2039,UCBPlayer,104,349,453,25,24,UCBPlayer
2040,UCBPlayer,126,126,252,7,85,Tie
2041,UCBPlayer,111,351,462,28,22,UCBPlayer
2042,UCBPlayer,116,126,242,3,87,UCBPlayer
2043,UCBPlayer,122,347,469,32,21,UCBPlayer
2044,UCBPlayer,107,132,239,0,87,UCBPlayer
2045,UCBPlayer,132,337,469,35,22,UCBPlayer
2046,UCBPlayer,103,148,251,0,83,UCBPlayer
2047,UCBPlayer,136,321,457,35,26,UCBPlayer
2048,UCBPlayer,99,164,263,0,79,UCBPlayer
2049,UCBPlayer,140,305,445,35,30,UCBPlayer
2050,UCBPlayer,95,180,275,0,75,UCBPlayer
2051,UCBPlayer,144,289,433,35,34,UCBPlayer
2052,UCBPlayer,91,196,287,0,71,UCBPlayer
2053,UCBPlayer,148,273,421,35,38,UCBPlayer
2054,UCBPlayer,87,212,299,0,67,UCBPlayer
2055,UCBPlayer,152,257,409,35,42,UCBPlayer
2056,UCBPlayer,84,224,308,0,64,UCBPlayer
2057,UCBPlayer,146,251,397,32,45,UCBPlayer
2058,UCBPlayer,89,234,323,3,60,UCBPlayer
2059,UCBPlayer,138,243,381,28,49,UCBPlayer
2060,UCBPlayer,97,242,339,7,56,UCBPlayer
2061,UCBPlayer,130,235,365,24,53,UCBPlayer
2062,UCBPlayer,105,250,355,11,52,UCBPlayer
2063,UCBPlayer,122,227,349,20,57,UCBPlayer
2064,UCBPlayer,109,259,368,15,49,UCBPlayer
2065,UCBPlayer,118,218,336,16,60,UCBPlayer
2066,UCBPlayer,117,267,384,19,45,UCBPlayer
2067,UCBPlayer,110,210,320,12,64,UCBPlayer
2068,UCBPlayer,126,271,397,23,42,UCBPlayer
2069,UCBPlayer,105,210,315,10,65,UCBPlayer
2070,UCBPlayer,130,275,405,25,40,UCBPlayer
2071,UCBPlayer,105,210,315,10,65,UCBPlayer
2072,UCBPlayer,130,275,405,25,40,UCBPlayer
2073,UCBPlayer,106,206,312,10,66,UCBPlayer
2074,UCBPlayer,130,275,405,25,40,UCBPlayer
2075,UCBPlayer,105,210,315,10,65,UCBPlayer
2076,UCBPlayer,131,271,402,25,41,UCBPlayer
2077,UCBPlayer,105,210,315,10,65,UCBPlayer
2078,UCBPlayer,130,275,405,25,40,UCBPlayer
2079,UCBPlayer,105,210,315,10,65,UCBPlayer
2080,UCBPlayer,130,275,405,25,40,UCBPlayer
2081,UCBPlayer,103,203,306,10,68,UCBPlayer
2082,UCBPlayer,128,283,411,25,38,UCBPlayer
2083,UCBPlayer,111,186,297,10,71,UCBPlayer
2084,UCBPlayer,124,299,423,25,34,UCBPlayer
2085,UCBPlayer,115,170,285,10,75,UCBPlayer
2086,UCBPlayer,120,315,435,25,30,UCBPlayer
2087,UCBPlayer,119,154,273,10,79,UCBPlayer
2088,UCBPlayer,112,332,444,25,27,UCBPlayer
2089,UCBPlayer,127,137,264,10,82,UCBPlayer
2090,UCBPlayer,104,349,453,25,24,UCBPlayer
2091,UCBPlayer,126,126,252,7,85,Tie
2092,UCBPlayer,111,351,462,28,22,UCBPlayer
2093,UCBPlayer,116,126,242,3,87,UCBPlayer
2094,UCBPlayer,122,347,469,32,21,UCBPlayer
2095,UCBPlayer,107,132,239,0,87,UCBPlayer
2096,UCBPlayer,132,337,469,35,22,UCBPlayer
2097,UCBPlayer,103,148,251,0,83,UCBPlayer
2098,UCBPlayer,136,321,457,35,26,UCBPlayer
2099,UCBPlayer,99,164,263,0,79,UCBPlayer
2100,UCBPlayer,140,305,445,35,30,UCBPlayer
2101,UCBPlayer,95,180,275,0,75,UCBPlayer
2102,UCBPlayer,144,289,433,35,34,UCBPlayer
2103,UCBPlayer,91,196,287,0,71,UCBPlayer
2104,UCBPlayer,148,273,421,35,38,UCBPlayer
2105,UCBPlayer,87,212,299,0,67,UCBPlayer
2106,UCBPlayer,152,257,409,35,42,UCBPlayer
2107,UCBPlayer,84,224,308,0,64,UCBPlayer
2108,UCBPlayer,146,251,397,32,45,UCBPlayer
2109,UCBPlayer,89,234,323,3,60,UCBPlayer
2110,UCBPlayer,138,243,381,28,49,UCBPlayer
2111,UCBPlayer,97,242,339,7,56,UCBPlayer
2112,UCBPlayer,130,235,365,24,53,UCBPlayer
2113,UCBPlayer,105,250,355,11,52,UCBPlayer
2114,UCBPlayer,122,227,349,20,57,UCBPlayer
2115,UCBPlayer,109,259,368,15,49,UCBPlayer
2116,UCBPlayer,118,218,336,16,60,UCBPlayer
2117,UCBPlayer,117,267,384,19,45,UCBPlayer
2118,UCBPlayer,110,210,320,12,64,UCBPlayer
2119,UCBPlayer,126,271,397,23,42,UCBPlayer
2120,UCBPlayer,105,210,315,10,65,UCBPlayer
2121,UCBPlayer,130,275,405,25,40,UCBPlayer
2122,UCBPlayer,105,210,315,10,65,UCBPlayer
2123,UCBPlayer,130,275,405,25,40,UCBPlayer
2124,UCBPlayer,106,206,312,10,66,UCBPlayer
2125,UCBPlayer,130,275,405,25,40,UCBPlayer
2126,UCBPlayer,105,210,315,10,65,UCBPlayer
2127,UCBPlayer,131,271,402,25,41,UCBPlayer
2128,UCBPlayer,105,210,315,10,65,UCBPlayer
2129,UCBPlayer,130,275,405,25,40,UCBPlayer
2130,UCBPlayer,105,210,315,10,65,UCBPlayer
2131,UCBPlayer,130,275,405,25,40,UCBPlayer
2132,UCBPlayer,103,203,306,10,68,UCBPlayer
2133,UCBPlayer,128,283,411,25,38,UCBPlayer
2134,UCBPlayer,111,186,297,10,71,UCBPlayer
2135,UCBPlayer,124,299,423,25,34,UCBPlayer
2136,UCBPlayer,115,170,285,10,75,UCBPlayer
2137,UCBPlayer,120,315,435,25,30,UCBPlayer
2138,UCBPlayer,119,154,273,10,79,UCBPlayer
2139,UCBPlayer,112,332,444,25,27,UCBPlayer
2140,UCBPlayer,127,137,264,10,82,UCBPlayer
2141,UCBPlayer,104,349,453,25,24,UCBPlayer
2142,UCBPlayer,126,126,252,7,85,Tie
2143,UCBPlayer,111,351,462,28,22,UCBPlayer
2144,UCBPlayer,116,126,242,3,87,UCBPlayer
2145,UCBPlayer,122,347,469,32,21,UCBPlayer
2146,UCBPlayer,107,132,239,0,87,UCBPlayer
2147,UCBPlayer,132,337,469,35,22,UCBPlayer
2148,UCBPlayer,103,148,251,0,83,UCBPlayer
2149,UCBPlayer,136,321,457,35,26,UCBPlayer
2150,UCBPlayer,99,164,263,0,79,UCBPlayer
2151,UCBPlayer,140,305,445,35,30,UCBPlayer
2152,UCBPlayer,95,180,275,0,75,UCBPlayer
2153,UCBPlayer,144,289,433,35,34,UCBPlayer
2154,UCBPlayer,91,196,287,0,71,UCBPlayer
2155,UCBPlayer,148,273,421,35,38,UCBPlayer
2156,UCBPlayer,87,212,299,0,67,UCBPlayer
2157,UCBPlayer,152,257,409,35,42,UCBPlayer
2158,UCBPlayer,84,224,308,0,64,UCBPlayer
2159,UCBPlayer,146,251,397,32,45,UCBPlayer
2160,UCBPlayer,89,234,323,3,60,UCBPlayer
2161,UCBPlayer,138,243,381,28,49,UCBPlayer
2162,UCBPlayer,97,242,339,7,56,UCBPlayer
2163,UCBPlayer,130,235,365,24,53,UCBPlayer
2164,UCBPlayer,105,250,355,11,52,UCBPlayer
2165,UCBPlayer,122,227,349,20,57,UCBPlayer
2166,UCBPlayer,109,259,368,15,49,UCBPlayer
2167,UCBPlayer,118,218,336,16,60,UCBPlayer
2168,UCBPlayer,117,267,384,19,45,UCBPlayer
2169,UCBPlayer,110,210,320,12,64,UCBPlayer
2170,UCBPlayer,126,271,397,23,42,UCBPlayer
2171,UCBPlayer,105,210,315,10,65,UCBPlayer
2172,UCBPlayer,130,275,405,25,40,UCBPlayer
2173,UCBPlayer,105,210,315,10,65,UCBPlayer
2174,UCBPlayer,130,275,405,25,40,UCBPlayer
2175,UCBPlayer,106,206,312,10,66,UCBPlayer
2176,UCBPlayer,130,275,405,25,40,UCBPlayer
2177,UCBPlayer,105,210,315,10,65,UCBPlayer
2178,UCBPlayer,131,271,402,25,41,UCBPlayer
2179,UCBPlayer,105,210,315,10,65,UCBPlayer
2180,UCBPlayer,130,275,405,25,40,UCBPlayer
2181,UCBPlayer,105,210,315,10,65,UCBPlayer
2182,UCBPlayer,130,275,405,25,40,UCBPlayer
2183,UCBPlayer,103,203,306,10,68,UCBPlayer
2184,UCBPlayer,128,283,411,25,38,UCBPlayer
2185,UCBPlayer,111,186,297,10,71,UCBPlayer
2186,UCBPlayer,124,299,423,25,34,UCBPlayer
2187,UCBPlayer,115,170,285,10,75,UCBPlayer
2188,UCBPlayer,120,315,435,25,30,UCBPlayer
2189,UCBPlayer,119,154,273,10,79,UCBPlayer
2190,UCBPlayer,112,332,444,25,27,UCBPlayer
2191,UCBPlayer,127,137,264,10,82,UCBPlayer
2192,UCBPlayer,104,349,453,25,24,UCBPlayer
2193,UCBPlayer,126,126,252,7,85,Tie
2194,UCBPlayer,111,351,462,28,22,UCBPlayer
2195,UCBPlayer,116,126,242,3,87,UCBPlayer
2196,UCBPlayer,122,347,469,32,21,UCBPlayer
2197,UCBPlayer,107,132,239,0,87,UCBPlayer
2198,UCBPlayer,132,337,469,35,22,UCBPlayer
2199,UCBPlayer,103,148,251,0,83,UCBPlayer
2200,UCBPlayer,136,321,457,35,26,UCBPlayer
2201,UCBPlayer,99,164,263,0,79,UCBPlayer
2202,UCBPlayer,140,305,445,35,30,UCBPlayer
2203,UCBPlayer,95,180,275,0,75,UCBPlayer
2204,UCBPlayer,144,289,433,35,34,UCBPlayer
2205,UCBPlayer,91,196,287,0,71,UCBPlayer
2206,UCBPlayer,148,273,421,35,38,UCBPlayer
2207,UCBPlayer,87,212,299,0,67,UCBPlayer
2208,UCBPlayer,152,257,409,35,42,UCBPlayer
2209,UCBPlayer,84,224,308,0,64,UCBPlayer
2210,UCBPlayer,146,251,397,32,45,UCBPlayer
2211,UCBPlayer,89,234,323,3,60,UCBPlayer
2212,UCBPlayer,138,243,381,28,49,UCBPlayer
2213,UCBPlayer,97,242,339,7,56,UCBPlayer
2214,UCBPlayer,130,235,365,24,53,UCBPlayer
2215,UCBPlayer,105,250,355,11,52,UCBPlayer
2216,UCBPlayer,122,227,349,20,57,UCBPlayer
2217,UCBPlayer,109,259,368,15,49,UCBPlayer
2218,UCBPlayer,118,218,336,16,60,UCBPlayer
2219,UCBPlayer,117,267,384,19,45,UCBPlayer
2220,UCBPlayer,110,210,320,12,64,UCBPlayer
2221,UCBPlayer,126,271,397,23,42,UCBPlayer
2222,UCBPlayer,105,210,315,10,65,UCBPlayer
2223,UCBPlayer,130,275,405,25,40,UCBPlayer
2224,UCBPlayer,105,210,315,10,65,UCBPlayer
2225,UCBPlayer,130,275,405,25,40,UCBPlayer
2226,UCBPlayer,106,206,312,10,66,UCBPlayer
2227,UCBPlayer,130,275,405,25,40,UCBPlayer
2228,UCBPlayer,105,210,315,10,65,UCBPlayer
2229,UCBPlayer,131,271,402,25,41,UCBPlayer
2230,UCBPlayer,105,210,315,10,65,UCBPlayer
2231,UCBPlayer,130,275,405,25,40,UCBPlayer
2232,UCBPlayer,105,210,315,10,65,UCBPlayer
2233,UCBPlayer,130,275,405,25,40,UCBPlayer
2234,UCBPlayer,103,203,306,10,68,UCBPlayer
2235,UCBPlayer,128,283,411,25,38,UCBPlayer
2236,UCBPlayer,111,186,297,10,71,UCBPlayer
2237,UCBPlayer,124,299,423,25,34,UCBPlayer
2238,UCBPlayer,115,170,285,10,75,UCBPlayer
2239,UCBPlayer,120,315,435,25,30,UCBPlayer
2240,UCBPlayer,119,154,273,10,79,UCBPlayer
2241,UCBPlayer,112,332,444,25,27,UCBPlayer
2242,UCBPlayer,127,137,264,10,82,UCBPlayer
2243,UCBPlayer,104,349,453,25,24,UCBPlayer
2244,UCBPlayer,126,126,252,7,85,Tie
2245,UCBPlayer,111,351,462,28,22,UCBPlayer
2246,UCBPlayer,116,126,242,3,87,UCBPlayer
2247,UCBPlayer,122,347,469,32,21,UCBPlayer
2248,UCBPlayer,107,132,239,0,87,UCBPlayer
2249,UCBPlayer,132,337,469,35,22,UCBPlayer
2250,UCBPlayer,103,148,251,0,83,UCBPlayer
2251,UCBPlayer,136,321,457,35,26,UCBPlayer
2252,UCBPlayer,99,164,263,0,79,UCBPlayer
2253,UCBPlayer,140,305,445,35,30,UCBPlayer
2254,UCBPlayer,95,180,275,0,75,UCBPlayer
2255,UCBPlayer,144,289,433,35,34,UCBPlayer
2256,UCBPlayer,91,196,287,0,71,UCBPlayer
2257,UCBPlayer,148,273,421,35,38,UCBPlayer
2258,UCBPlayer,87,212,299,0,67,UCBPlayer
2259,UCBPlayer,152,257,409,35,42,UCBPlayer
2260,UCBPlayer,84,224,308,0,64,UCBPlayer
2261,UCBPlayer,146,251,397,32,45,UCBPlayer
2262,UCBPlayer,89,234,323,3,60,UCBPlayer
2263,UCBPlayer,138,243,381,28,49,UCBPlayer
2264,UCBPlayer,97,242,339,7,56,UCBPlayer
2265,UCBPlayer,130,235,365,24,53,UCBPlayer
2266,UCBPlayer,105,250,355,11,52,UCBPlayer
2267,UCBPlayer,122,227,349,20,57,UCBPlayer
2268,UCBPlayer,109,259,368,15,49,UCBPlayer
2269,UCBPlayer,118,218,336,16,60,UCBPlayer
2270,UCBPlayer,117,267,384,19,45,UCBPlayer
2271,UCBPlayer,110,210,320,12,64,UCBPlayer
2272,UCBPlayer,126,271,397,23,42,UCBPlayer
2273,UCBPlayer,105,210,315,10,65,UCBPlayer
2274,UCBPlayer,130,275,405,25,40,UCBPlayer
2275,UCBPlayer,105,210,315,10,65,UCBPlayer
2276,UCBPlayer,130,275,405,25,40,UCBPlayer
2277,UCBPlayer,106,206,312,10,66,UCBPlayer
2278,UCBPlayer,130,275,405,25,40,UCBPlayer
2279,UCBPlayer,105,210,315,10,65,UCBPlayer
2280,UCBPlayer,131,271,402,25,41,UCBPlayer
2281,UCBPlayer,105,210,315,10,65,UCBPlayer
2282,UCBPlayer,130,275,405,25,40,UCBPlayer
2283,UCBPlayer,105,210,315,10,65,UCBPlayer
2284,UCBPlayer,130,275,405,25,40,UCBPlayer
2285,UCBPlayer,103,203,306,10,68,UCBPlayer
2286,UCBPlayer,128,283,411,25,38,UCBPlayer
2287,UCBPlayer,111,186,297,10,71,UCBPlayer
2288,UCBPlayer,124,299,423,25,34,UCBPlayer
2289,UCBPlayer,115,170,285,10,75,UCBPlayer
2290,UCBPlayer,120,315,435,25,30,UCBPlayer
2291,UCBPlayer,119,154,273,10,79,UCBPlayer
2292,UCBPlayer,112,332,444,25,27,UCBPlayer
2293,UCBPlayer,127,137,264,10,82,UCBPlayer
2294,UCBPlayer,104,349,453,25,24,UCBPlayer
2295,UCBPlayer,126,126,252,7,85,Tie
2296,UCBPlayer,111,351,462,28,22,UCBPlayer
2297,UCBPlayer,116,126,242,3,87,UCBPlayer
2298,UCBPlayer,122,347,469,32,21,UCBPlayer
2299,UCBPlayer,107,132,239,0,87,UCBPlayer
2300,UCBPlayer,132,337,469,35,22,UCBPlayer
2301,UCBPlayer,103,148,251,0,83,UCBPlayer
2302,UCBPlayer,136,321,457,35,26,UCBPlayer
2303,UCBPlayer,99,164,263,0,79,UCBPlayer
2304,UCBPlayer,140,305,445,35,30,UCBPlayer
2305,UCBPlayer,95,180,275,0,75,UCBPlayer
2306,UCBPlayer,144,289,433,35,34,UCBPlayer
2307,UCBPlayer,91,196,287,0,71,UCBPlayer
2308,UCBPlayer,148,273,421,35,38,UCBPlayer
2309,UCBPlayer,87,212,299,0,67,UCBPlayer
2310,UCBPlayer,152,257,409,35,42,UCBPlayer
2311,UCBPlayer,84,224,308,0,64,UCBPlayer
2312,UCBPlayer,146,251,397,32,45,UCBPlayer
2313,UCBPlayer,89,234,323,3,60,UCBPlayer
2314,UCBPlayer,138,243,381,28,49,UCBPlayer
2315,UCBPlayer,97,242,339,7,56,UCBPlayer
2316,UCBPlayer,130,235,365,24,53,UCBPlayer
2317,UCBPlayer,105,250,355,11,52,UCBPlayer
2318,UCBPlayer,122,227,349,20,57,UCBPlayer
2319,UCBPlayer,109,259,368,15,49,UCBPlayer
2320,UCBPlayer,118,218,336,16,60,UCBPlayer
2321,UCBPlayer,117,267,384,19,45,UCBPlayer
2322,UCBPlayer,110,210,320,12,64,UCBPlayer
2323,UCBPlayer,126,271,397,23,42,UCBPlayer
2324,UCBPlayer,105,210,315,10,65,UCBPlayer
2325,UCBPlayer,130,275,405,25,40,UCBPlayer
2326,UCBPlayer,105,210,315,10,65,UCBPlayer
2327,UCBPlayer,130,275,405,25,40,UCBPlayer
2328,UCBPlayer,106,206,312,10,66,UCBPlayer
2329,UCBPlayer,130,275,405,25,40,UCBPlayer
2330,UCBPlayer,105,210,315,10,65,UCBPlayer
2331,UCBPlayer,131,271,402,25,41,UCBPlayer
2332,UCBPlayer,105,210,315,10,65,UCBPlayer
2333,UCBPlayer,130,275,405,25,40,UCBPlayer
2334,UCBPlayer,105,210,315,10,65,UCBPlayer
2335,UCBPlayer,130,275,405,25,40,UCBPlayer
2336,UCBPlayer,103,203,306,10,68,UCBPlayer
2337,UCBPlayer,128,283,411,25,38,UCBPlayer
2338,UCBPlayer,111,186,297,10,71,UCBPlayer
2339,UCBPlayer,124,299,423,25,34,UCBPlayer
2340,UCBPlayer,115,170,285,10,75,UCBPlayer
2341,UCBPlayer,120,315,435,25,30,UCBPlayer
2342,UCBPlayer,119,154,273,10,79,UCBPlayer
2343,UCBPlayer,112,332,444,25,27,UCBPlayer
2344,UCBPlayer,127,137,264,10,82,UCBPlayer
2345,UCBPlayer,104,349,453,25,24,UCBPlayer
2346,UCBPlayer,126,126,252,7,85,Tie
2347,UCBPlayer,111,351,462,28,22,UCBPlayer
2348,UCBPlayer,116,126,242,3,87,UCBPlayer
2349,UCBPlayer,122,347,469,32,21,UCBPlayer
2350,UCBPlayer,107,132,239,0,87,UCBPlayer
2351,UCBPlayer,132,337,469,35,22,UCBPlayer
2352,UCBPlayer,103,148,251,0,83,UCBPlayer
2353,UCBPlayer,136,321,457,35,26,UCBPlayer
2354,UCBPlayer,99,164,263,0,79,UCBPlayer
2355,UCBPlayer,140,305,445,35,30,UCBPlayer
2356,UCBPlayer,95,180,275,0,75,UCBPlayer
2357,UCBPlayer,144,289,433,35,34,UCBPlayer
2358,UCBPlayer,91,196,287,0,71,UCBPlayer
2359,UCBPlayer,148,273,421,35,38,UCBPlayer
2360,UCBPlayer,87,212,299,0,67,UCBPlayer
2361,UCBPlayer,152,257,409,35,42,UCBPlayer
2362,UCBPlayer,84,224,308,0,64,UCBPlayer
2363,UCBPlayer,146,251,397,32,45,UCBPlayer
2364,UCBPlayer,89,234,323,3,60,UCBPlayer
2365,UCBPlayer,138,243,381,28,49,UCBPlayer
2366,UCBPlayer,97,242,339,7,56,UCBPlayer
2367,UCBPlayer,130,235,365,24,53,UCBPlayer
2368,UCBPlayer,105,250,355,11,52,UCBPlayer
2369,UCBPlayer,122,227,349,20,57,UCBPlayer
2370,UCBPlayer,109,259,368,15,49,UCBPlayer
2371,UCBPlayer,118,218,336,16,60,UCBPlayer
2372,UCBPlayer,117,267,384,19,45,UCBPlayer
2373,UCBPlayer,110,210,320,12,64,UCBPlayer
2374,UCBPlayer,126,271,397,23,42,UCBPlayer
2375,UCBPlayer,105,210,315,10,65,UCBPlayer
2376,UCBPlayer,130,275,405,25,40,UCBPlayer
2377,UCBPlayer,105,210,315,10,65,UCBPlayer
2378,UCBPlayer,130,275,405,25,40,UCBPlayer
2379,UCBPlayer,106,206,312,10,66,UCBPlayer
2380,UCBPlayer,130,275,405,25,40,UCBPlayer
2381,UCBPlayer,105,210,315,10,65,UCBPlayer
2382,UCBPlayer,131,271,402,25,41,UCBPlayer
2383,UCBPlayer,105,210,315,10,65,UCBPlayer
2384,UCBPlayer,130,275,405,25,40,UCBPlayer
2385,UCBPlayer,105,210,315,10,65,UCBPlayer
2386,UCBPlayer,130,275,405,25,40,UCBPlayer
2387,UCBPlayer,103,203,306,10,68,UCBPlayer
2388,UCBPlayer,128,283,411,25,38,UCBPlayer
2389,UCBPlayer,111,186,297,10,71,UCBPlayer
2390,UCBPlayer,124,299,423,25,34,UCBPlayer
2391,UCBPlayer,115,170,285,10,75,UCBPlayer
2392,UCBPlayer,120,315,435,25,30,UCBPlayer
2393,UCBPlayer,119,154,273,10,79,UCBPlayer
2394,UCBPlayer,112,332,444,25,27,UCBPlayer
2395,UCBPlayer,127,137,264,10,82,UCBPlayer
2396,UCBPlayer,104,349,453,25,24,UCBPlayer
2397,UCBPlayer,126,126,252,7,85,Tie
2398,UCBPlayer,111,351,462,28,22,UCBPlayer
2399,UCBPlayer,116,126,242,3,87,UCBPlayer
2400,UCBPlayer,122,347,469,32,21,UCBPlayer
2401,UCBPlayer,107,132,239,0,87,UCBPlayer
2402,UCBPlayer,132,337,469,35,22,UCBPlayer
2403,UCBPlayer,103,148,251,0,83,UCBPlayer
2404,UCBPlayer,136,321,457,35,26,UCBPlayer
2405,UCBPlayer,99,164,263,0,79,UCBPlayer
2406,UCBPlayer,140,305,445,35,30,UCBPlayer
2407,UCBPlayer,95,180,275,0,75,UCBPlayer
2408,UCBPlayer,144,289,433,35,34,UCBPlayer
2409,UCBPlayer,91,196,287,0,71,UCBPlayer
2410,UCBPlayer,148,273,421,35,38,UCBPlayer
2411,UCBPlayer,87,212,299,0,67,UCBPlayer
2412,UCBPlayer,152,257,409,35,42,UCBPlayer
2413,UCBPlayer,84,224,308,0,64,UCBPlayer
2414,UCBPlayer,146,251,397,32,45,UCBPlayer
2415,UCBPlayer,89,234,323,3,60,UCBPlayer
2416,UCBPlayer,138,243,381,28,49,UCBPlayer
2417,UCBPlayer,97,242,339,7,56,UCBPlayer
2418,UCBPlayer,130,235,365,24,53,UCBPlayer
2419,UCBPlayer,105,250,355,11,52,UCBPlayer
2420,UCBPlayer,122,227,349,20,57,UCBPlayer
2421,UCBPlayer,109,259,368,15,49,UCBPlayer
2422,UCBPlayer,118,218,336,16,60,UCBPlayer
2423,UCBPlayer,117,267,384,19,45,UCBPlayer
2424,UCBPlayer,110,210,320,12,64,UCBPlayer
2425,UCBPlayer,126,271,397,23,42,UCBPlayer
2426,UCBPlayer,105,210,315,10,65,UCBPlayer
2427,UCBPlayer,130,275,405,25,40,UCBPlayer
2428,UCBPlayer,105,210,315,10,65,UCBPlayer
2429,UCBPlayer,130,275,405,25,40,UCBPlayer
2430,UCBPlayer,106,206,312,10,66,UCBPlayer
2431,UCBPlayer,130,275,405,25,40,UCBPlayer
2432,UCBPlayer,105,210,315,10,65,UCBPlayer
2433,UCBPlayer,131,271,402,25,41,UCBPlayer
2434,UCBPlayer,105,210,315,10,65,UCBPlayer
2435,UCBPlayer,130,275,405,25,40,UCBPlayer
2436,UCBPlayer,105,210,315,10,65,UCBPlayer
2437,UCBPlayer,130,275,405,25,40,UCBPlayer
2438,UCBPlayer,103,203,306,10,68,UCBPlayer
2439,UCBPlayer,128,283,411,25,38,UCBPlayer
2440,UCBPlayer,111,186,297,10,71,UCBPlayer
2441,UCBPlayer,124,299,423,25,34,UCBPlayer
2442,UCBPlayer,115,170,285,10,75,UCBPlayer
2443,UCBPlayer,120,315,435,25,30,UCBPlayer
2444,UCBPlayer,119,154,273,10,79,UCBPlayer
2445,UCBPlayer,112,332,444,25,27,UCBPlayer
2446,UCBPlayer,127,137,264,10,82,UCBPlayer
2447,UCBPlayer,104,349,453,25,24,UCBPlayer
2448,UCBPlayer,126,126,252,7,85,Tie
2449,UCBPlayer,111,351,462,28,22,UCBPlayer
2450,UCBPlayer,116,126,242,3,87,UCBPlayer
2451,UCBPlayer,122,347,469,32,21,UCBPlayer
2452,UCBPlayer,107,132,239,0,87,UCBPlayer
2453,UCBPlayer,132,337,469,35,22,UCBPlayer
2454,UCBPlayer,103,148,251,0,83,UCBPlayer
2455,UCBPlayer,136,321,457,35,26,UCBPlayer
2456,UCBPlayer,99,164,263,0,79,UCBPlayer
2457,UCBPlayer,140,305,445,35,30,UCBPlayer
2458,UCBPlayer,95,180,275,0,75,UCBPlayer
2459,UCBPlayer,144,289,433,35,34,UCBPlayer
2460,UCBPlayer,91,196,287,0,71,UCBPlayer
2461,UCBPlayer,148,273,421,35,38,UCBPlayer
2462,UCBPlayer,87,212,299,0,67,UCBPlayer
2463,UCBPlayer,152,257,409,35,42,UCBPlayer
2464,UCBPlayer,84,224,308,0,64,UCBPlayer
2465,UCBPlayer,146,251,397,32,45,UCBPlayer
2466,UCBPlayer,89,234,323,3,60,UCBPlayer
2467,UCBPlayer,138,243,381,28,49,UCBPlayer
2468,UCBPlayer,97,242,339,7,56,UCBPlayer
2469,UCBPlayer,130,235,365,24,53,UCBPlayer
2470,UCBPlayer,105,250,355,11,52,UCBPlayer
2471,UCBPlayer,122,227,349,20,57,UCBPlayer
2472,UCBPlayer,109,259,368,15,49,UCBPlayer
2473,UCBPlayer,118,218,336,16,60,UCBPlayer
2474,UCBPlayer,117,267,384,19,45,UCBPlayer
2475,UCBPlayer,110,210,320,12,64,UCBPlayer
2476,UCBPlayer,126,271,397,23,42,UCBPlayer
2477,UCBPlayer,105,210,315,10,65,UCBPlayer
2478,UCBPlayer,130,275,405,25,40,UCBPlayer
2479,UCBPlayer,105,210,315,10,65,UCBPlayer
2480,UCBPlayer,130,275,405,25,40,UCBPlayer
2481,UCBPlayer,106,206,312,10,66,UCBPlayer
2482,UCBPlayer,130,275,405,25,40,UCBPlayer
2483,UCBPlayer,105,210,315,10,65,UCBPlayer
2484,UCBPlayer,131,271,402,25,41,UCBPlayer
2485,UCBPlayer,105,210,315,10,65,UCBPlayer
2486,UCBPlayer,130,275,405,25,40,UCBPlayer
2487,UCBPlayer,105,210,315,10,65,UCBPlayer
2488,UCBPlayer,130,275,405,25,40,UCBPlayer
2489,UCBPlayer,103,203,306,10,68,UCBPlayer
2490,UCBPlayer,128,283,411,25,38,UCBPlayer
2491,UCBPlayer,111,186,297,10,71,UCBPlayer
2492,UCBPlayer,124,299,423,25,34,UCBPlayer
2493,UCBPlayer,115,170,285,10,75,UCBPlayer
2494,UCBPlayer,120,315,435,25,30,UCBPlayer
2495,UCBPlayer,119,154,273,10,79,UCBPlayer
2496,UCBPlayer,112,332,444,25,27,UCBPlayer
2497,UCBPlayer,127,137,264,10,82,UCBPlayer
2498,UCBPlayer,104,349,453,25,24,UCBPlayer
2499,UCBPlayer,126,126,252,7,85,Tie
2500,UCBPlayer,111,351,462,28,22,UCBPlayer
2501,UCBPlayer,116,126,242,3,87,UCBPlayer
2502,UCBPlayer,122,347,469,32,21,UCBPlayer
2503,UCBPlayer,107,132,239,0,87,UCBPlayer
2504,UCBPlayer,132,337,469,35,22,UCBPlayer
2505,UCBPlayer,103,148,251,0,83,UCBPlayer
2506,UCBPlayer,136,321,457,35,26,UCBPlayer
2507,UCBPlayer,99,164,263,0,79,UCBPlayer
2508,UCBPlayer,140,305,445,35,30,UCBPlayer
2509,UCBPlayer,95,180,275,0,75,UCBPlayer
2510,UCBPlayer,144,289,433,35,34,UCBPlayer
2511,UCBPlayer,91,196,287,0,71,UCBPlayer
2512,UCBPlayer,148,273,421,35,38,UCBPlayer
2513,UCBPlayer,87,212,299,0,67,UCBPlayer
2514,UCBPlayer,152,257,409,35,42,UCBPlayer
2515,UCBPlayer,84,224,308,0,64,UCBPlayer
2516,UCBPlayer,146,251,397,32,45,UCBPlayer
2517,UCBPlayer,89,234,323,3,60,UCBPlayer
2518,UCBPlayer,138,243,381,28,49,UCBPlayer
2519,UCBPlayer,97,242,339,7,56,UCBPlayer
2520,UCBPlayer,130,235,365,24,53,UCBPlayer
2521,UCBPlayer,105,250,355,11,52,UCBPlayer
2522,UCBPlayer,122,227,349,20,57,UCBPlayer
2523,UCBPlayer,109,259,368,15,49,UCBPlayer
2524,UCBPlayer,118,218,336,16,60,UCBPlayer
2525,UCBPlayer,117,267,384,19,45,UCBPlayer
2526,UCBPlayer,110,210,320,12,64,UCBPlayer
2527,UCBPlayer,126,271,397,23,42,UCBPlayer
2528,UCBPlayer,105,210,315,10,65,UCBPlayer
2529,UCBPlayer,130,275,405,25,40,UCBPlayer
2530,UCBPlayer,105,210,315,10,65,UCBPlayer
2531,UCBPlayer,130,275,405,25,40,UCBPlayer
2532,UCBPlayer,106,206,312,10,66,UCBPlayer
2533,UCBPlayer,130,275,405,25,40,UCBPlayer
2534,UCBPlayer,105,210,315,10,65,UCBPlayer
2535,UCBPlayer,131,271,402,25,41,UCBPlayer
2536,UCBPlayer,105,210,315,10,65,UCBPlayer
2537,UCBPlayer,130,275,405,25,40,UCBPlayer
2538,UCBPlayer,105,210,315,10,65,UCBPlayer
2539,UCBPlayer,130,275,405,25,40,UCBPlayer
2540,UCBPlayer,103,203,306,10,68,UCBPlayer
2541,UCBPlayer,128,283,411,25,38,UCBPlayer
2542,UCBPlayer,111,186,297,10,71,UCBPlayer
2543,UCBPlayer,124,299,423,25,34,UCBPlayer
2544,UCBPlayer,115,170,285,10,75,UCBPlayer
2545,UCBPlayer,120,315,435,25,30,UCBPlayer
2546,UCBPlayer,119,154,273,10,79,UCBPlayer
2547,UCBPlayer,112,332,444,25,27,UCBPlayer
2548,UCBPlayer,127,137,264,10,82,UCBPlayer
2549,UCBPlayer,104,349,453,25,24,UCBPlayer
2550,UCBPlayer,126,126,252,7,85,Tie
2551,UCBPlayer,111,351,462,28,22,UCBPlayer
2552,UCBPlayer,116,126,242,3,87,UCBPlayer
2553,UCBPlayer,122,347,469,32,21,UCBPlayer
2554,UCBPlayer,107,132,239,0,87,UCBPlayer
2555,UCBPlayer,132,337,469,35,22,UCBPlayer
2556,UCBPlayer,103,148,251,0,83,UCBPlayer
2557,UCBPlayer,136,321,457,35,26,UCBPlayer
2558,UCBPlayer,99,164,263,0,79,UCBPlayer
2559,UCBPlayer,140,305,445,35,30,UCBPlayer
2560,UCBPlayer,95,180,275,0,75,UCBPlayer
2561,UCBPlayer,144,289,433,35,34,UCBPlayer
2562,UCBPlayer,91,196,287,0,71,UCBPlayer
2563,UCBPlayer,148,273,421,35,38,UCBPlayer
2564,UCBPlayer,87,212,299,0,67,UCBPlayer
2565,UCBPlayer,152,257,409,35,42,UCBPlayer
2566,UCBPlayer,84,224,308,0,64,UCBPlayer
2567,UCBPlayer,146,251,397,32,45,UCBPlayer
2568,UCBPlayer,89,234,323,3,60,UCBPlayer
2569,UCBPlayer,138,243,381,28,49,UCBPlayer
2570,UCBPlayer,97,242,339,7,56,UCBPlayer
2571,UCBPlayer,130,235,365,24,53,UCBPlayer
2572,UCBPlayer,105,250,355,11,52,UCBPlayer
2573,UCBPlayer,122,227,349,20,57,UCBPlayer
2574,UCBPlayer,109,259,368,15,49,UCBPlayer
2575,UCBPlayer,118,218,336,16,60,UCBPlayer
2576,UCBPlayer,117,267,384,19,45,UCBPlayer
2577,UCBPlayer,110,210,320,12,64,UCBPlayer
2578,UCBPlayer,126,271,397,23,42,UCBPlayer
2579,UCBPlayer,105,210,315,10,65,UCBPlayer
2580,UCBPlayer,130,275,405,25,40,UCBPlayer
2581,UCBPlayer,105,210,315,10,65,UCBPlayer
2582,UCBPlayer,130,275,405,25,40,UCBPlayer
2583,UCBPlayer,106,206,312,10,66,UCBPlayer
2584,UCBPlayer,130,275,405,25,40,UCBPlayer
2585,UCBPlayer,105,210,315,10,65,UCBPlayer
2586,UCBPlayer,131,271,402,25,41,UCBPlayer
2587,UCBPlayer,105,210,315,10,65,UCBPlayer
2588,UCBPlayer,130,275,405,25,40,UCBPlayer
2589,UCBPlayer,105,210,315,10,65,UCBPlayer
2590,UCBPlayer,130,275,405,25,40,UCBPlayer
2591,UCBPlayer,103,203,306,10,68,UCBPlayer
2592,UCBPlayer,128,283,411,25,38,UCBPlayer
2593,UCBPlayer,111,186,297,10,71,UCBPlayer
2594,UCBPlayer,124,299,423,25,34,UCBPlayer
2595,UCBPlayer,115,170,285,10,75,UCBPlayer
2596,UCBPlayer,120,315,435,25,30,UCBPlayer
2597,UCBPlayer,119,154,273,10,79,UCBPlayer
2598,UCBPlayer,112,332,444,25,27,UCBPlayer
2599,UCBPlayer,127,137,264,10,82,UCBPlayer
2600,UCBPlayer,104,349,453,25,24,UCBPlayer
2601,UCBPlayer,126,126,252,7,85,Tie
2602,UCBPlayer,111,351,462,28,22,UCBPlayer
2603,UCBPlayer,116,126,242,3,87,UCBPlayer
2604,UCBPlayer,122,347,469,32,21,UCBPlayer
2605,UCBPlayer,107,132,239,0,87,UCBPlayer
2606,UCBPlayer,132,337,469,35,22,UCBPlayer
2607,UCBPlayer,103,148,251,0,83,UCBPlayer
2608,UCBPlayer,136,321,457,35,26,UCBPlayer
2609,UCBPlayer,99,164,263,0,79,UCBPlayer
2610,UCBPlayer,140,305,445,35,30,UCBPlayer
2611,UCBPlayer,95,180,275,0,75,UCBPlayer
2612,UCBPlayer,144,289,433,35,34,UCBPlayer
2613,UCBPlayer,91,196,287,0,71,UCBPlayer
2614,UCBPlayer,148,273,421,35,38,UCBPlayer
2615,UCBPlayer,87,212,299,0,67,UCBPlayer
2616,UCBPlayer,152,257,409,35,42,UCBPlayer
2617,UCBPlayer,84,224,308,0,64,UCBPlayer
2618,UCBPlayer,146,251,397,32,45,UCBPlayer
2619,UCBPlayer,89,234,323,3,60,UCBPlayer
2620,UCBPlayer,138,243,381,28,49,UCBPlayer
2621,UCBPlayer,97,242,339,7,56,UCBPlayer
2622,UCBPlayer,130,235,365,24,53,UCBPlayer
2623,UCBPlayer,105,250,355,11,52,UCBPlayer
2624,UCBPlayer,122,227,349,20,57,UCBPlayer
2625,UCBPlayer,109,259,368,15,49,UCBPlayer
2626,UCBPlayer,118,218,336,16,60,UCBPlayer
2627,UCBPlayer,117,267,384,19,45,UCBPlayer
2628,UCBPlayer,110,210,320,12,64,UCBPlayer
2629,UCBPlayer,126,271,397,23,42,UCBPlayer
2630,UCBPlayer,105,210,315,10,65,UCBPlayer
2631,UCBPlayer,130,275,405,25,40,UCBPlayer
2632,UCBPlayer,105,210,315,10,65,UCBPlayer
2633,UCBPlayer,130,275,405,25,40,UCBPlayer
2634,UCBPlayer,106,206,312,10,66,UCBPlayer
2635,UCBPlayer,130,275,405,25,40,UCBPlayer
2636,UCBPlayer,105,210,315,10,65,UCBPlayer
2637,UCBPlayer,131,271,402,25,41,UCBPlayer
2638,UCBPlayer,105,210,315,10,65,UCBPlayer
2639,UCBPlayer,130,275,405,25,40,UCBPlayer
2640,UCBPlayer,105,210,315,10,65,UCBPlayer
2641,UCBPlayer,130,275,405,25,40,UCBPlayer
2642,UCBPlayer,103,203,306,10,68,UCBPlayer
2643,UCBPlayer,128,283,411,25,38,UCBPlayer
2644,UCBPlayer,111,186,297,10,71,UCBPlayer
2645,UCBPlayer,124,299,423,25,34,UCBPlayer
2646,UCBPlayer,115,170,285,10,75,UCBPlayer
2647,UCBPlayer,120,315,435,25,30,UCBPlayer
2648,UCBPlayer,119,154,273,10,79,UCBPlayer
2649,UCBPlayer,112,332,444,25,27,UCBPlayer
2650,UCBPlayer,127,137,264,10,82,UCBPlayer
2651,UCBPlayer,104,349,453,25,24,UCBPlayer
2652,UCBPlayer,126,126,252,7,85,Tie
2653,UCBPlayer,111,351,462,28,22,UCBPlayer
2654,UCBPlayer,116,126,242,3,87,UCBPlayer
2655,UCBPlayer,122,347,469,32,21,UCBPlayer
2656,UCBPlayer,107,132,239,0,87,UCBPlayer
2657,UCBPlayer,132,337,469,35,22,UCBPlayer
2658,UCBPlayer,103,148,251,0,83,UCBPlayer
2659,UCBPlayer,136,321,457,35,26,UCBPlayer
2660,UCBPlayer,99,164,263,0,79,UCBPlayer
2661,UCBPlayer,140,305,445,35,30,UCBPlayer
2662,UCBPlayer,95,180,275,0,75,UCBPlayer
2663,UCBPlayer,144,289,433,35,34,UCBPlayer
2664,UCBPlayer,91,196,287,0,71,UCBPlayer
2665,UCBPlayer,148,273,421,35,38,UCBPlayer
2666,UCBPlayer,87,212,299,0,67,UCBPlayer
2667,UCBPlayer,152,257,409,35,42,UCBPlayer
2668,UCBPlayer,84,224,308,0,64,UCBPlayer
2669,UCBPlayer,146,251,397,32,45,UCBPlayer
2670,UCBPlayer,89,234,323,3,60,UCBPlayer
2671,UCBPlayer,138,243,381,28,49,UCBPlayer
2672,UCBPlayer,97,242,339,7,56,UCBPlayer
2673,UCBPlayer,130,235,365,24,53,UCBPlayer
2674,UCBPlayer,105,250,355,11,52,UCBPlayer
2675,UCBPlayer,122,227,349,20,57,UCBPlayer
2676,UCBPlayer,109,259,368,15,49,UCBPlayer
2677,UCBPlayer,118,218,336,16,60,UCBPlayer
2678,UCBPlayer,117,267,384,19,45,UCBPlayer
2679,UCBPlayer,110,210,320,12,64,UCBPlayer
2680,UCBPlayer,126,271,397,23,42,UCBPlayer
2681,UCBPlayer,105,210,315,10,65,UCBPlayer
2682,UCBPlayer,130,275,405,25,40,UCBPlayer
2683,UCBPlayer,105,210,315,10,65,UCBPlayer
2684,UCBPlayer,130,275,405,25,40,UCBPlayer
2685,UCBPlayer,106,206,312,10,66,UCBPlayer
2686,UCBPlayer,130,275,405,25,40,UCBPlayer
2687,UCBPlayer,105,210,315,10,65,UCBPlayer
2688,UCBPlayer,131,271,402,25,41,UCBPlayer
2689,UCBPlayer,105,210,315,10,65,UCBPlayer
2690,UCBPlayer,130,275,405,25,40,UCBPlayer
2691,UCBPlayer,105,210,315,10,65,UCBPlayer
2692,UCBPlayer,130,275,405,25,40,UCBPlayer
2693,UCBPlayer,103,203,306,10,68,UCBPlayer
2694,UCBPlayer,128,283,411,25,38,UCBPlayer
2695,UCBPlayer,111,186,297,10,71,UCBPlayer
2696,UCBPlayer,124,299,423,25,34,UCBPlayer
2697,UCBPlayer,115,170,285,10,75,UCBPlayer
2698,UCBPlayer,120,315,435,25,30,UCBPlayer
2699,UCBPlayer,119,154,273,10,79,UCBPlayer
2700,UCBPlayer,112,332,444,25,27,UCBPlayer
2701,UCBPlayer,127,137,264,10,82,UCBPlayer
2702,UCBPlayer,104,349,453,25,24,UCBPlayer
2703,UCBPlayer,126,126,252,7,85,Tie
2704,UCBPlayer,111,351,462,28,22,UCBPlayer
2705,UCBPlayer,116,126,242,3,87,UCBPlayer
2706,UCBPlayer,122,347,469,32,21,UCBPlayer
2707,UCBPlayer,107,132,239,0,87,UCBPlayer
2708,UCBPlayer,132,337,469,35,22,UCBPlayer
2709,UCBPlayer,103,148,251,0,83,UCBPlayer
2710,UCBPlayer,136,321,457,35,26,UCBPlayer
2711,UCBPlayer,99,164,263,0,79,UCBPlayer
2712,UCBPlayer,140,305,445,35,30,UCBPlayer
2713,UCBPlayer,95,180,275,0,75,UCBPlayer
2714,UCBPlayer,144,289,433,35,34,UCBPlayer
2715,UCBPlayer,91,196,287,0,71,UCBPlayer
2716,UCBPlayer,148,273,421,35,38,UCBPlayer
2717,UCBPlayer,87,212,299,0,67,UCBPlayer
2718,UCBPlayer,152,257,409,35,42,UCBPlayer
2719,UCBPlayer,84,224,308,0,64,UCBPlayer
2720,UCBPlayer,146,251,397,32,45,UCBPlayer
2721,UCBPlayer,89,234,323,3,60,UCBPlayer
2722,UCBPlayer,138,243,381,28,49,UCBPlayer
2723,UCBPlayer,97,242,339,7,56,UCBPlayer
2724,UCBPlayer,130,235,365,24,53,UCBPlayer
2725,UCBPlayer,105,250,355,11,52,UCBPlayer
2726,UCBPlayer,122,227,349,20,57,UCBPlayer
2727,UCBPlayer,109,259,368,15,49,UCBPlayer
2728,UCBPlayer,118,218,336,16,60,UCBPlayer
2729,UCBPlayer,117,267,384,19,45,UCBPlayer
2730,UCBPlayer,110,210,320,12,64,UCBPlayer
2731,UCBPlayer,126,271,397,23,42,UCBPlayer
2732,UCBPlayer,105,210,315,10,65,UCBPlayer
2733,UCBPlayer,130,275,405,25,40,UCBPlayer
2734,UCBPlayer,105,210,315,10,65,UCBPlayer
2735,UCBPlayer,130,275,405,25,40,UCBPlayer
2736,UCBPlayer,106,206,312,10,66,UCBPlayer
2737,UCBPlayer,130,275,405,25,40,UCBPlayer
2738,UCBPlayer,105,210,315,10,65,UCBPlayer
2739,UCBPlayer,131,271,402,25,41,UCBPlayer
2740,UCBPlayer,105,210,315,10,65,UCBPlayer
2741,UCBPlayer,130,275,405,25,40,UCBPlayer
2742,UCBPlayer,105,210,315,10,65,UCBPlayer
2743,UCBPlayer,130,275,405,25,40,UCBPlayer
2744,UCBPlayer,103,203,306,10,68,UCBPlayer
2745,UCBPlayer,128,283,411,25,38,UCBPlayer
2746,UCBPlayer,111,186,297,10,71,UCBPlayer
2747,UCBPlayer,124,299,423,25,34,UCBPlayer
2748,UCBPlayer,115,170,285,10,75,UCBPlayer
2749,UCBPlayer,120,315,435,25,30,UCBPlayer
2750,UCBPlayer,119,154,273,10,79,UCBPlayer
2751,UCBPlayer,112,332,444,25,27,UCBPlayer
2752,UCBPlayer,127,137,264,10,82,UCBPlayer
2753,UCBPlayer,104,349,453,25,24,UCBPlayer
2754,UCBPlayer,126,126,252,7,85,Tie
2755,UCBPlayer,111,351,462,28,22,UCBPlayer
2756,UCBPlayer,116,126,242,3,87,UCBPlayer
2757,UCBPlayer,122,347,469,32,21,UCBPlayer
2758,UCBPlayer,107,132,239,0,87,UCBPlayer
2759,UCBPlayer,132,337,469,35,22,UCBPlayer
2760,UCBPlayer,103,148,251,0,83,UCBPlayer
2761,UCBPlayer,136,321,457,35,26,UCBPlayer
2762,UCBPlayer,99,164,263,0,79,UCBPlayer
2763,UCBPlayer,140,305,445,35,30,UCBPlayer
2764,UCBPlayer,95,180,275,0,75,UCBPlayer
2765,UCBPlayer,144,289,433,35,34,UCBPlayer
2766,UCBPlayer,91,196,287,0,71,UCBPlayer
2767,UCBPlayer,148,273,421,35,38,UCBPlayer
2768,UCBPlayer,87,212,299,0,67,UCBPlayer
2769,UCBPlayer,152,257,409,35,42,UCBPlayer
2770,UCBPlayer,84,224,308,0,64,UCBPlayer
2771,UCBPlayer,146,251,397,32,45,UCBPlayer
2772,UCBPlayer,89,234,323,3,60,UCBPlayer
2773,UCBPlayer,138,243,381,28,49,UCBPlayer
2774,UCBPlayer,97,242,339,7,56,UCBPlayer
2775,UCBPlayer,130,235,365,24,53,UCBPlayer
2776,UCBPlayer,105,250,355,11,52,UCBPlayer
2777,UCBPlayer,122,227,349,20,57,UCBPlayer
2778,UCBPlayer,109,259,368,15,49,UCBPlayer
2779,UCBPlayer,118,218,336,16,60,UCBPlayer
2780,UCBPlayer,117,267,384,19,45,UCBPlayer
2781,UCBPlayer,110,210,320,12,64,UCBPlayer
2782,UCBPlayer,126,271,397,23,42,UCBPlayer
2783,UCBPlayer,105,210,315,10,65,UCBPlayer
2784,UCBPlayer,130,275,405,25,40,UCBPlayer
2785,UCBPlayer,105,210,315,10,65,UCBPlayer
2786,UCBPlayer,130,275,405,25,40,UCBPlayer
2787,UCBPlayer,106,206,312,10,66,UCBPlayer
2788,UCBPlayer,130,275,405,25,40,UCBPlayer
2789,UCBPlayer,105,210,315,10,65,UCBPlayer
2790,UCBPlayer,131,271,402,25,41,UCBPlayer
2791,UCBPlayer,105,210,315,10,65,UCBPlayer
2792,UCBPlayer,130,275,405,25,40,UCBPlayer
2793,UCBPlayer,105,210,315,10,65,UCBPlayer
2794,UCBPlayer,130,275,405,25,40,UCBPlayer
2795,UCBPlayer,103,203,306,10,68,UCBPlayer
2796,UCBPlayer,128,283,411,25,38,UCBPlayer
2797,UCBPlayer,111,186,297,10,71,UCBPlayer
2798,UCBPlayer,124,299,423,25,34,UCBPlayer
2799,UCBPlayer,115,170,285,10,75,UCBPlayer
2800,UCBPlayer,120,315,435,25,30,UCBPlayer
2801,UCBPlayer,119,154,273,10,79,UCBPlayer
2802,UCBPlayer,112,332,444,25,27,UCBPlayer
2803,UCBPlayer,127,137,264,10,82,UCBPlayer
2804,UCBPlayer,104,349,453,25,24,UCBPlayer
2805,UCBPlayer,126,126,252,7,85,Tie
2806,UCBPlayer,111,351,462,28,22,UCBPlayer
2807,UCBPlayer,116,126,242,3,87,UCBPlayer
2808,UCBPlayer,122,347,469,32,21,UCBPlayer
2809,UCBPlayer,107,132,239,0,87,UCBPlayer
2810,UCBPlayer,132,337,469,35,22,UCBPlayer
2811,UCBPlayer,103,148,251,0,83,UCBPlayer
2812,UCBPlayer,136,321,457,35,26,UCBPlayer
2813,UCBPlayer,99,164,263,0,79,UCBPlayer
2814,UCBPlayer,140,305,445,35,30,UCBPlayer
2815,UCBPlayer,95,180,275,0,75,UCBPlayer
2816,UCBPlayer,144,289,433,35,34,UCBPlayer
2817,UCBPlayer,91,196,287,0,71,UCBPlayer
2818,UCBPlayer,148,273,421,35,38,UCBPlayer
2819,UCBPlayer,87,212,299,0,67,UCBPlayer
2820,UCBPlayer,152,257,409,35,42,UCBPlayer
2821,UCBPlayer,84,224,308,0,64,UCBPlayer
2822,UCBPlayer,146,251,397,32,45,UCBPlayer
2823,UCBPlayer,89,234,323,3,60,UCBPlayer
2824,UCBPlayer,138,243,381,28,49,UCBPlayer
2825,UCBPlayer,97,242,339,7,56,UCBPlayer
2826,UCBPlayer,130,235,365,24,53,UCBPlayer
2827,UCBPlayer,105,250,355,11,52,UCBPlayer
2828,UCBPlayer,122,227,349,20,57,UCBPlayer
2829,UCBPlayer,109,259,368,15,49,UCBPlayer
2830,UCBPlayer,118,218,336,16,60,UCBPlayer
2831,UCBPlayer,117,267,384,19,45,UCBPlayer
2832,UCBPlayer,110,210,320,12,64,UCBPlayer
2833,UCBPlayer,126,271,397,23,42,UCBPlayer
2834,UCBPlayer,105,210,315,10,65,UCBPlayer
2835,UCBPlayer,130,275,405,25,40,UCBPlayer
2836,UCBPlayer,105,210,315,10,65,UCBPlayer
2837,UCBPlayer,130,275,405,25,40,UCBPlayer
2838,UCBPlayer,106,206,312,10,66,UCBPlayer
2839,UCBPlayer,130,275,405,25,40,UCBPlayer
2840,UCBPlayer,105,210,315,10,65,UCBPlayer
2841,UCBPlayer,131,271,402,25,41,UCBPlayer
2842,UCBPlayer,105,210,315,10,65,UCBPlayer
2843,UCBPlayer,130,275,405,25,40,UCBPlayer
2844,UCBPlayer,105,210,315,10,65,UCBPlayer
2845,UCBPlayer,130,275,405,25,40,UCBPlayer
2846,UCBPlayer,103,203,306,10,68,UCBPlayer
2847,UCBPlayer,128,283,411,25,38,UCBPlayer
2848,UCBPlayer,111,186,297,10,71,UCBPlayer
2849,UCBPlayer,124,299,423,25,34,UCBPlayer
2850,UCBPlayer,115,170,285,10,75,UCBPlayer
2851,UCBPlayer,120,315,435,25,30,UCBPlayer
2852,UCBPlayer,119,154,273,10,79,UCBPlayer
2853,UCBPlayer,112,332,444,25,27,UCBPlayer
2854,UCBPlayer,127,137,264,10,82,UCBPlayer
2855,UCBPlayer,104,349,453,25,24,UCBPlayer
2856,UCBPlayer,126,126,252,7,85,Tie
2857,UCBPlayer,111,351,462,28,22,UCBPlayer
2858,UCBPlayer,116,126,242,3,87,UCBPlayer
2859,UCBPlayer,122,347,469,32,21,UCBPlayer
2860,UCBPlayer,107,132,239,0,87,UCBPlayer
2861,UCBPlayer,132,337,469,35,22,UCBPlayer
2862,UCBPlayer,103,148,251,0,83,UCBPlayer
2863,UCBPlayer,136,321,457,35,26,UCBPlayer
2864,UCBPlayer,99,164,263,0,79,UCBPlayer
2865,UCBPlayer,140,305,445,35,30,UCBPlayer
2866,UCBPlayer,95,180,275,0,75,UCBPlayer
2867,UCBPlayer,144,289,433,35,34,UCBPlayer
2868,UCBPlayer,91,196,287,0,71,UCBPlayer
2869,UCBPlayer,148,273,421,35,38,UCBPlayer
2870,UCBPlayer,87,212,299,0,67,UCBPlayer
2871,UCBPlayer,152,257,409,35,42,UCBPlayer
2872,UCBPlayer,84,224,308,0,64,UCBPlayer
2873,UCBPlayer,146,251,397,32,45,UCBPlayer
2874,UCBPlayer,89,234,323,3,60,UCBPlayer
2875,UCBPlayer,138,243,381,28,49,UCBPlayer
2876,UCBPlayer,97,242,339,7,56,UCBPlayer
2877,UCBPlayer,130,235,365,24,53,UCBPlayer
2878,UCBPlayer,105,250,355,11,52,UCBPlayer
2879,UCBPlayer,122,227,349,20,57,UCBPlayer
2880,UCBPlayer,109,259,368,15,49,UCBPlayer
2881,UCBPlayer,118,218,336,16,60,UCBPlayer
2882,UCBPlayer,117,267,384,19,45,UCBPlayer
2883,UCBPlayer,110,210,320,12,64,UCBPlayer
2884,UCBPlayer,126,271,397,23,42,UCBPlayer
2885,UCBPlayer,105,210,315,10,65,UCBPlayer
2886,UCBPlayer,130,275,405,25,40,UCBPlayer
2887,UCBPlayer,105,210,315,10,65,UCBPlayer
2888,UCBPlayer,130,275,405,25,40,UCBPlayer
2889,UCBPlayer,106,206,312,10,66,UCBPlayer
2890,UCBPlayer,130,275,405,25,40,UCBPlayer
2891,UCBPlayer,105,210,315,10,65,UCBPlayer
2892,UCBPlayer,131,271,402,25,41,UCBPlayer
2893,UCBPlayer,105,210,315,10,65,UCBPlayer
2894,UCBPlayer,130,275,405,25,40,UCBPlayer
2895,UCBPlayer,105,210,315,10,65,UCBPlayer
2896,UCBPlayer,130,275,405,25,40,UCBPlayer
2897,UCBPlayer,103,203,306,10,68,UCBPlayer
2898,UCBPlayer,128,283,411,25,38,UCBPlayer
2899,UCBPlayer,111,186,297,10,71,UCBPlayer
2900,UCBPlayer,124,299,423,25,34,UCBPlayer
2901,UCBPlayer,115,170,285,10,75,UCBPlayer
2902,UCBPlayer,120,315,435,25,30,UCBPlayer
2903,UCBPlayer,119,154,273,10,79,UCBPlayer
2904,UCBPlayer,112,332,444,25,27,UCBPlayer
2905,UCBPlayer,127,137,264,10,82,UCBPlayer
2906,UCBPlayer,104,349,453,25,24,UCBPlayer
2907,UCBPlayer,126,126,252,7,85,Tie
2908,UCBPlayer,111,351,462,28,22,UCBPlayer
2909,UCBPlayer,116,126,242,3,87,UCBPlayer
2910,UCBPlayer,122,347,469,32,21,UCBPlayer
2911,UCBPlayer,107,132,239,0,87,UCBPlayer
2912,UCBPlayer,132,337,469,35,22,UCBPlayer
2913,UCBPlayer,103,148,251,0,83,UCBPlayer
2914,UCBPlayer,136,321,457,35,26,UCBPlayer
2915,UCBPlayer,99,164,263,0,79,UCBPlayer
2916,UCBPlayer,140,305,445,35,30,UCBPlayer
2917,UCBPlayer,95,180,275,0,75,UCBPlayer
2918,UCBPlayer,144,289,433,35,34,UCBPlayer
2919,UCBPlayer,91,196,287,0,71,UCBPlayer
2920,UCBPlayer,148,273,421,35,38,UCBPlayer
2921,UCBPlayer,87,212,299,0,67,UCBPlayer
2922,UCBPlayer,152,257,409,35,42,UCBPlayer
2923,UCBPlayer,84,224,308,0,64,UCBPlayer
2924,UCBPlayer,146,251,397,32,45,UCBPlayer
2925,UCBPlayer,89,234,323,3,60,UCBPlayer
2926,UCBPlayer,138,243,381,28,49,UCBPlayer
2927,UCBPlayer,97,242,339,7,56,UCBPlayer
2928,UCBPlayer,130,235,365,24,53,UCBPlayer
2929,UCBPlayer,105,250,355,11,52,UCBPlayer
2930,UCBPlayer,122,227,349,20,57,UCBPlayer
2931,UCBPlayer,109,259,368,15,49,UCBPlayer
2932,UCBPlayer,118,218,336,16,60,UCBPlayer
2933,UCBPlayer,117,267,384,19,45,UCBPlayer
2934,UCBPlayer,110,210,320,12,64,UCBPlayer
2935,UCBPlayer,126,271,397,23,42,UCBPlayer
2936,UCBPlayer,105,210,315,10,65,UCBPlayer
2937,UCBPlayer,130,275,405,25,40,UCBPlayer
2938,UCBPlayer,105,210,315,10,65,UCBPlayer
2939,UCBPlayer,130,275,405,25,40,UCBPlayer
2940,UCBPlayer,106,206,312,10,66,UCBPlayer
2941,UCBPlayer,130,275,405,25,40,UCBPlayer
2942,UCBPlayer,105,210,315,10,65,UCBPlayer
2943,UCBPlayer,131,271,402,25,41,UCBPlayer
2944,UCBPlayer,105,210,315,10,65,UCBPlayer
2945,UCBPlayer,130,275,405,25,40,UCBPlayer
2946,UCBPlayer,105,210,315,10,65,UCBPlayer
2947,UCBPlayer,130,275,405,25,40,UCBPlayer
2948,UCBPlayer,103,203,306,10,68,UCBPlayer
2949,UCBPlayer,128,283,411,25,38,UCBPlayer
2950,UCBPlayer,111,186,297,10,71,UCBPlayer
2951,UCBPlayer,124,299,423,25,34,UCBPlayer
2952,UCBPlayer,115,170,285,10,75,UCBPlayer
2953,UCBPlayer,120,315,435,25,30,UCBPlayer
2954,UCBPlayer,119,154,273,10,79,UCBPlayer
2955,UCBPlayer,112,332,444,25,27,UCBPlayer
2956,UCBPlayer,127,137,264,10,82,UCBPlayer
2957,UCBPlayer,104,349,453,25,24,UCBPlayer
2958,UCBPlayer,126,126,252,7,85,Tie
2959,UCBPlayer,111,351,462,28,22,UCBPlayer
2960,UCBPlayer,116,126,242,3,87,UCBPlayer
2961,UCBPlayer,122,347,469,32,21,UCBPlayer
2962,UCBPlayer,107,132,239,0,87,UCBPlayer
2963,UCBPlayer,132,337,469,35,22,UCBPlayer
2964,UCBPlayer,103,148,251,0,83,UCBPlayer
2965,UCBPlayer,136,321,457,35,26,UCBPlayer
2966,UCBPlayer,99,164,263,0,79,UCBPlayer
2967,UCBPlayer,140,305,445,35,30,UCBPlayer
2968,UCBPlayer,95,180,275,0,75,UCBPlayer
2969,UCBPlayer,144,289,433,35,34,UCBPlayer
2970,UCBPlayer,91,196,287,0,71,UCBPlayer
2971,UCBPlayer,148,273,421,35,38,UCBPlayer
2972,UCBPlayer,87,212,299,0,67,UCBPlayer
2973,UCBPlayer,152,257,409,35,42,UCBPlayer
2974,UCBPlayer,84,224,308,0,64,UCBPlayer
2975,UCBPlayer,146,251,397,32,45,UCBPlayer
2976,UCBPlayer,89,234,323,3,60,UCBPlayer
2977,UCBPlayer,138,243,381,28,49,UCBPlayer
2978,UCBPlayer,97,242,339,7,56,UCBPlayer
2979,UCBPlayer,130,235,365,24,53,UCBPlayer
2980,UCBPlayer,105,250,355,11,52,UCBPlayer
2981,UCBPlayer,122,227,349,20,57,UCBPlayer
2982,UCBPlayer,109,259,368,15,49,UCBPlayer
2983,UCBPlayer,118,218,336,16,60,UCBPlayer
2984,UCBPlayer,117,267,384,19,45,UCBPlayer
2985,UCBPlayer,110,210,320,12,64,UCBPlayer
2986,UCBPlayer,126,271,397,23,42,UCBPlayer
2987,UCBPlayer,105,210,315,10,65,UCBPlayer
2988,UCBPlayer,130,275,405,25,40,UCBPlayer
2989,UCBPlayer,105,210,315,10,65,UCBPlayer
2990,UCBPlayer,130,275,405,25,40,UCBPlayer
2991,UCBPlayer,106,206,312,10,66,UCBPlayer
2992,UCBPlayer,130,275,405,25,40,UCBPlayer
2993,UCBPlayer,105,210,315,10,65,UCBPlayer
2994,UCBPlayer,131,271,402,25,41,UCBPlayer
2995,UCBPlayer,105,210,315,10,65,UCBPlayer
2996,UCBPlayer,130,275,405,25,40,UCBPlayer
2997,UCBPlayer,105,210,315,10,65,UCBPlayer
2998,UCBPlayer,130,275,405,25,40,UCBPlayer
2999,UCBPlayer,103,203,306,10,68,UCBPlayer
3000,UCBPlayer,128,283,411,25,38,UCBPlayer
3001,UCBPlayer,111,186,297,10,71,UCBPlayer
3002,UCBPlayer,124,299,423,25,34,UCBPlayer
3003,UCBPlayer,115,170,285,10,75,UCBPlayer
3004,UCBPlayer,120,315,435,25,30,UCBPlayer
3005,UCBPlayer,119,154,273,10,79,UCBPlayer
3006,UCBPlayer,112,332,444,25,27,UCBPlayer
3007,UCBPlayer,127,137,264,10,82,UCBPlayer
3008,UCBPlayer,104,349,453,25,24,UCBPlayer
3009,UCBPlayer,126,126,252,7,85,Tie
3010,UCBPlayer,111,351,462,28,22,UCBPlayer
3011,UCBPlayer,116,126,242,3,87,UCBPlayer
3012,UCBPlayer,122,347,469,32,21,UCBPlayer
3013,UCBPlayer,107,132,239,0,87,UCBPlayer
3014,UCBPlayer,132,337,469,35,22,UCBPlayer
3015,UCBPlayer,103,148,251,0,83,UCBPlayer
3016,UCBPlayer,136,321,457,35,26,UCBPlayer
3017,UCBPlayer,99,164,263,0,79,UCBPlayer
3018,UCBPlayer,140,305,445,35,30,UCBPlayer
3019,UCBPlayer,95,180,275,0,75,UCBPlayer
3020,UCBPlayer,144,289,433,35,34,UCBPlayer
3021,UCBPlayer,91,196,287,0,71,UCBPlayer
3022,UCBPlayer,148,273,421,35,38,UCBPlayer
3023,UCBPlayer,87,212,299,0,67,UCBPlayer
3024,UCBPlayer,152,257,409,35,42,UCBPlayer
3025,UCBPlayer,84,224,308,0,64,UCBPlayer
3026,UCBPlayer,146,251,397,32,45,UCBPlayer
3027,UCBPlayer,89,234,323,3,60,UCBPlayer
3028,UCBPlayer,138,243,381,28,49,UCBPlayer
3029,UCBPlayer,97,242,339,7,56,UCBPlayer
3030,UCBPlayer,130,235,365,24,53,UCBPlayer
3031,UCBPlayer,105,250,355,11,52,UCBPlayer
3032,UCBPlayer,122,227,349,20,57,UCBPlayer
3033,UCBPlayer,109,259,368,15,49,UCBPlayer
3034,UCBPlayer,118,218,336,16,60,UCBPlayer
3035,UCBPlayer,117,267,384,19,45,UCBPlayer
3036,UCBPlayer,110,210,320,12,64,UCBPlayer
3037,UCBPlayer,126,271,397,23,42,UCBPlayer
3038,UCBPlayer,105,210,315,10,65,UCBPlayer
3039,UCBPlayer,130,275,405,25,40,UCBPlayer
3040,UCBPlayer,105,210,315,10,65,UCBPlayer
3041,UCBPlayer,130,275,405,25,40,UCBPlayer
3042,UCBPlayer,106,206,312,10,66,UCBPlayer
3043,UCBPlayer,130,275,405,25,40,UCBPlayer
3044,UCBPlayer,105,210,315,10,65,UCBPlayer
3045,UCBPlayer,131,271,402,25,41,UCBPlayer
3046,UCBPlayer,105,210,315,10,65,UCBPlayer
3047,UCBPlayer,130,275,405,25,40,UCBPlayer
3048,UCBPlayer,105,210,315,10,65,UCBPlayer
3049,UCBPlayer,130,275,405,25,40,UCBPlayer
3050,UCBPlayer,103,203,306,10,68,UCBPlayer
3051,UCBPlayer,128,283,411,25,38,UCBPlayer
3052,UCBPlayer,111,186,297,10,71,UCBPlayer
3053,UCBPlayer,124,299,423,25,34,UCBPlayer
3054,UCBPlayer,115,170,285,10,75,UCBPlayer
3055,UCBPlayer,120,315,435,25,30,UCBPlayer
3056,UCBPlayer,119,154,273,10,79,UCBPlayer
3057,UCBPlayer,112,332,444,25,27,UCBPlayer
3058,UCBPlayer,127,137,264,10,82,UCBPlayer
3059,UCBPlayer,104,349,453,25,24,UCBPlayer
3060,UCBPlayer,126,126,252,7,85,Tie
3061,UCBPlayer,111,351,462,28,22,UCBPlayer
3062,UCBPlayer,116,126,242,3,87,UCBPlayer
3063,UCBPlayer,122,347,469,32,21,UCBPlayer
3064,UCBPlayer,107,132,239,0,87,UCBPlayer
3065,UCBPlayer,132,337,469,35,22,UCBPlayer
3066,UCBPlayer,103,148,251,0,83,UCBPlayer
3067,UCBPlayer,136,321,457,35,26,UCBPlayer
3068,UCBPlayer,99,164,263,0,79,UCBPlayer
3069,UCBPlayer,140,305,445,35,30,UCBPlayer
3070,UCBPlayer,95,180,275,0,75,UCBPlayer
3071,UCBPlayer,144,289,433,35,34,UCBPlayer
3072,UCBPlayer,91,196,287,0,71,UCBPlayer
3073,UCBPlayer,148,273,421,35,38,UCBPlayer
3074,UCBPlayer,87,212,299,0,67,UCBPlayer
3075,UCBPlayer,152,257,409,35,42,UCBPlayer
3076,UCBPlayer,84,224,308,0,64,UCBPlayer
3077,UCBPlayer,146,251,397,32,45,UCBPlayer
3078,UCBPlayer,89,234,323,3,60,UCBPlayer
3079,UCBPlayer,138,243,381,28,49,UCBPlayer
3080,UCBPlayer,97,242,339,7,56,UCBPlayer
3081,UCBPlayer,130,235,365,24,53,UCBPlayer
3082,UCBPlayer,105,250,355,11,52,UCBPlayer
3083,UCBPlayer,122,227,349,20,57,UCBPlayer
3084,UCBPlayer,109,259,368,15,49,UCBPlayer
3085,UCBPlayer,118,218,336,16,60,UCBPlayer
3086,UCBPlayer,117,267,384,19,45,UCBPlayer
3087,UCBPlayer,110,210,320,12,64,UCBPlayer
3088,UCBPlayer,126,271,397,23,42,UCBPlayer
3089,UCBPlayer,105,210,315,10,65,UCBPlayer
3090,UCBPlayer,130,275,405,25,40,UCBPlayer
3091,UCBPlayer,105,210,315,10,65,UCBPlayer
3092,UCBPlayer,130,275,405,25,40,UCBPlayer
3093,UCBPlayer,106,206,312,10,66,UCBPlayer
3094,UCBPlayer,130,275,405,25,40,UCBPlayer
3095,UCBPlayer,105,210,315,10,65,UCBPlayer
3096,UCBPlayer,131,271,402,25,41,UCBPlayer
3097,UCBPlayer,105,210,315,10,65,UCBPlayer
3098,UCBPlayer,130,275,405,25,40,UCBPlayer
3099,UCBPlayer,105,210,315,10,65,UCBPlayer
3100,UCBPlayer,130,275,405,25,40,UCBPlayer
3101,UCBPlayer,103,203,306,10,68,UCBPlayer
3102,UCBPlayer,128,283,411,25,38,UCBPlayer
3103,UCBPlayer,111,186,297,10,71,UCBPlayer
3104,UCBPlayer,124,299,423,25,34,UCBPlayer
3105,UCBPlayer,115,170,285,10,75,UCBPlayer
3106,UCBPlayer,120,315,435,25,30,UCBPlayer
3107,UCBPlayer,119,154,273,10,79,UCBPlayer
3108,UCBPlayer,112,332,444,25,27,UCBPlayer
3109,UCBPlayer,127,137,264,10,82,UCBPlayer
3110,UCBPlayer,104,349,453,25,24,UCBPlayer
3111,UCBPlayer,126,126,252,7,85,Tie
3112,UCBPlayer,111,351,462,28,22,UCBPlayer
3113,UCBPlayer,116,126,242,3,87,UCBPlayer
3114,UCBPlayer,122,347,469,32,21,UCBPlayer
3115,UCBPlayer,107,132,239,0,87,UCBPlayer
3116,UCBPlayer,132,337,469,35,22,UCBPlayer
3117,UCBPlayer,103,148,251,0,83,UCBPlayer
3118,UCBPlayer,136,321,457,35,26,UCBPlayer
3119,UCBPlayer,99,164,263,0,79,UCBPlayer
3120,UCBPlayer,140,305,445,35,30,UCBPlayer
3121,UCBPlayer,95,180,275,0,75,UCBPlayer
3122,UCBPlayer,144,289,433,35,34,UCBPlayer
3123,UCBPlayer,91,196,287,0,71,UCBPlayer
3124,UCBPlayer,148,273,421,35,38,UCBPlayer
3125,UCBPlayer,87,212,299,0,67,UCBPlayer
3126,UCBPlayer,152,257,409,35,42,UCBPlayer
3127,UCBPlayer,84,224,308,0,64,UCBPlayer
3128,UCBPlayer,146,251,397,32,45,UCBPlayer
3129,UCBPlayer,89,234,323,3,60,UCBPlayer
3130,UCBPlayer,138,243,381,28,49,UCBPlayer
3131,UCBPlayer,97,242,339,7,56,UCBPlayer
3132,UCBPlayer,130,235,365,24,53,UCBPlayer
3133,UCBPlayer,105,250,355,11,52,UCBPlayer
3134,UCBPlayer,122,227,349,20,57,UCBPlayer
3135,UCBPlayer,109,259,368,15,49,UCBPlayer
3136,UCBPlayer,118,218,336,16,60,UCBPlayer
3137,UCBPlayer,117,267,384,19,45,UCBPlayer
3138,UCBPlayer,110,210,320,12,64,UCBPlayer
3139,UCBPlayer,126,271,397,23,42,UCBPlayer
3140,UCBPlayer,105,210,315,10,65,UCBPlayer
3141,UCBPlayer,130,275,405,25,40,UCBPlayer
3142,UCBPlayer,105,210,315,10,65,UCBPlayer
3143,UCBPlayer,130,275,405,25,40,UCBPlayer
3144,UCBPlayer,106,206,312,10,66,UCBPlayer
3145,UCBPlayer,130,275,405,25,40,UCBPlayer
3146,UCBPlayer,105,210,315,10,65,UCBPlayer
3147,UCBPlayer,131,271,402,25,41,UCBPlayer
3148,UCBPlayer,105,210,315,10,65,UCBPlayer
3149,UCBPlayer,130,275,405,25,40,UCBPlayer
3150,UCBPlayer,105,210,315,10,65,UCBPlayer
3151,UCBPlayer,130,275,405,25,40,UCBPlayer
3152,UCBPlayer,103,203,306,10,68,UCBPlayer
3153,UCBPlayer,128,283,411,25,38,UCBPlayer
3154,UCBPlayer,111,186,297,10,71,UCBPlayer
3155,UCBPlayer,124,299,423,25,34,UCBPlayer
3156,UCBPlayer,115,170,285,10,75,UCBPlayer
3157,UCBPlayer,120,315,435,25,30,UCBPlayer
3158,UCBPlayer,119,154,273,10,79,UCBPlayer
3159,UCBPlayer,112,332,444,25,27,UCBPlayer
3160,UCBPlayer,127,137,264,10,82,UCBPlayer
3161,UCBPlayer,104,349,453,25,24,UCBPlayer
3162,UCBPlayer,126,126,252,7,85,Tie
3163,UCBPlayer,111,351,462,28,22,UCBPlayer
3164,UCBPlayer,116,126,242,3,87,UCBPlayer
3165,UCBPlayer,122,347,469,32,21,UCBPlayer
3166,UCBPlayer,107,132,239,0,87,UCBPlayer
3167,UCBPlayer,132,337,469,35,22,UCBPlayer
3168,UCBPlayer,103,148,251,0,83,UCBPlayer
3169,UCBPlayer,136,321,457,35,26,UCBPlayer
3170,UCBPlayer,99,164,263,0,79,UCBPlayer
3171,UCBPlayer,140,305,445,35,30,UCBPlayer
3172,UCBPlayer,95,180,275,0,75,UCBPlayer
3173,UCBPlayer,144,289,433,35,34,UCBPlayer
3174,UCBPlayer,91,196,287,0,71,UCBPlayer
3175,UCBPlayer,148,273,421,35,38,UCBPlayer
3176,UCBPlayer,87,212,299,0,67,UCBPlayer
3177,UCBPlayer,152,257,409,35,42,UCBPlayer
3178,UCBPlayer,84,224,308,0,64,UCBPlayer
3179,UCBPlayer,146,251,397,32,45,UCBPlayer
3180,UCBPlayer,89,234,323,3,60,UCBPlayer
3181,UCBPlayer,138,243,381,28,49,UCBPlayer
3182,UCBPlayer,97,242,339,7,56,UCBPlayer
3183,UCBPlayer,130,235,365,24,53,UCBPlayer
3184,UCBPlayer,105,250,355,11,52,UCBPlayer
3185,UCBPlayer,122,227,349,20,57,UCBPlayer
3186,UCBPlayer,109,259,368,15,49,UCBPlayer
3187,UCBPlayer,118,218,336,16,60,UCBPlayer
3188,UCBPlayer,117,267,384,19,45,UCBPlayer
3189,UCBPlayer,110,210,320,12,64,UCBPlayer
3190,UCBPlayer,126,271,397,23,42,UCBPlayer
3191,UCBPlayer,105,210,315,10,65,UCBPlayer
3192,UCBPlayer,130,275,405,25,40,UCBPlayer
3193,UCBPlayer,105,210,315,10,65,UCBPlayer
3194,UCBPlayer,130,275,405,25,40,UCBPlayer
3195,UCBPlayer,106,206,312,10,66,UCBPlayer
3196,UCBPlayer,130,275,405,25,40,UCBPlayer
3197,UCBPlayer,105,210,315,10,65,UCBPlayer
3198,UCBPlayer,131,271,402,25,41,UCBPlayer
3199,UCBPlayer,105,210,315,10,65,UCBPlayer
3200,UCBPlayer,130,275,405,25,40,UCBPlayer
3201,UCBPlayer,105,210,315,10,65,UCBPlayer
3202,UCBPlayer,130,275,405,25,40,UCBPlayer
3203,UCBPlayer,103,203,306,10,68,UCBPlayer
3204,UCBPlayer,128,283,411,25,38,UCBPlayer
3205,UCBPlayer,111,186,297,10,71,UCBPlayer
3206,UCBPlayer,124,299,423,25,34,UCBPlayer
3207,UCBPlayer,115,170,285,10,75,UCBPlayer
3208,UCBPlayer,120,315,435,25,30,UCBPlayer
3209,UCBPlayer,119,154,273,10,79,UCBPlayer
3210,UCBPlayer,112,332,444,25,27,UCBPlayer
3211,UCBPlayer,127,137,264,10,82,UCBPlayer
3212,UCBPlayer,104,349,453,25,24,UCBPlayer
3213,UCBPlayer,126,126,252,7,85,Tie
3214,UCBPlayer,111,351,462,28,22,UCBPlayer
3215,UCBPlayer,116,126,242,3,87,UCBPlayer
3216,UCBPlayer,122,347,469,32,21,UCBPlayer
3217,UCBPlayer,107,132,239,0,87,UCBPlayer
3218,UCBPlayer,132,337,469,35,22,UCBPlayer
3219,UCBPlayer,103,148,251,0,83,UCBPlayer
3220,UCBPlayer,136,321,457,35,26,UCBPlayer
3221,UCBPlayer,99,164,263,0,79,UCBPlayer
3222,UCBPlayer,140,305,445,35,30,UCBPlayer
3223,UCBPlayer,95,180,275,0,75,UCBPlayer
3224,UCBPlayer,144,289,433,35,34,UCBPlayer
3225,UCBPlayer,91,196,287,0,71,UCBPlayer
3226,UCBPlayer,148,273,421,35,38,UCBPlayer
3227,UCBPlayer,87,212,299,0,67,UCBPlayer
3228,UCBPlayer,152,257,409,35,42,UCBPlayer
3229,UCBPlayer,84,224,308,0,64,UCBPlayer
3230,UCBPlayer,146,251,397,32,45,UCBPlayer
3231,UCBPlayer,89,234,323,3,60,UCBPlayer
3232,UCBPlayer,138,243,381,28,49,UCBPlayer
3233,UCBPlayer,97,242,339,7,56,UCBPlayer
3234,UCBPlayer,130,235,365,24,53,UCBPlayer
3235,UCBPlayer,105,250,355,11,52,UCBPlayer
3236,UCBPlayer,122,227,349,20,57,UCBPlayer
3237,UCBPlayer,109,259,368,15,49,UCBPlayer
3238,UCBPlayer,118,218,336,16,60,UCBPlayer
3239,UCBPlayer,117,267,384,19,45,UCBPlayer
3240,UCBPlayer,110,210,320,12,64,UCBPlayer
3241,UCBPlayer,126,271,397,23,42,UCBPlayer
3242,UCBPlayer,105,210,315,10,65,UCBPlayer
3243,UCBPlayer,130,275,405,25,40,UCBPlayer
3244,UCBPlayer,105,210,315,10,65,UCBPlayer
3245,UCBPlayer,130,275,405,25,40,UCBPlayer
3246,UCBPlayer,106,206,312,10,66,UCBPlayer
3247,UCBPlayer,130,275,405,25,40,UCBPlayer
3248,UCBPlayer,105,210,315,10,65,UCBPlayer
3249,UCBPlayer,131,271,402,25,41,UCBPlayer
3250,UCBPlayer,105,210,315,10,65,UCBPlayer
3251,UCBPlayer,130,275,405,25,40,UCBPlayer
3252,UCBPlayer,105,210,315,10,65,UCBPlayer
3253,UCBPlayer,130,275,405,25,40,UCBPlayer
3254,UCBPlayer,103,203,306,10,68,UCBPlayer
3255,UCBPlayer,128,283,411,25,38,UCBPlayer
3256,UCBPlayer,111,186,297,10,71,UCBPlayer
3257,UCBPlayer,124,299,423,25,34,UCBPlayer
3258,UCBPlayer,115,170,285,10,75,UCBPlayer
3259,UCBPlayer,120,315,435,25,30,UCBPlayer
3260,UCBPlayer,119,154,273,10,79,UCBPlayer
3261,UCBPlayer,112,332,444,25,27,UCBPlayer
3262,UCBPlayer,127,137,264,10,82,UCBPlayer
3263,UCBPlayer,104,349,453,25,24,UCBPlayer
3264,UCBPlayer,126,126,252,7,85,Tie
3265,UCBPlayer,111,351,462,28,22,UCBPlayer
3266,UCBPlayer,116,126,242,3,87,UCBPlayer
3267,UCBPlayer,122,347,469,32,21,UCBPlayer
3268,UCBPlayer,107,132,239,0,87,UCBPlayer
3269,UCBPlayer,132,337,469,35,22,UCBPlayer
3270,UCBPlayer,103,148,251,0,83,UCBPlayer
3271,UCBPlayer,136,321,457,35,26,UCBPlayer
3272,UCBPlayer,99,164,263,0,79,UCBPlayer
3273,UCBPlayer,140,305,445,35,30,UCBPlayer
3274,UCBPlayer,95,180,275,0,75,UCBPlayer
3275,UCBPlayer,144,289,433,35,34,UCBPlayer
3276,UCBPlayer,91,196,287,0,71,UCBPlayer
3277,UCBPlayer,148,273,421,35,38,UCBPlayer
3278,UCBPlayer,87,212,299,0,67,UCBPlayer
3279,UCBPlayer,152,257,409,35,42,UCBPlayer
3280,UCBPlayer,84,224,308,0,64,UCBPlayer
3281,UCBPlayer,146,251,397,32,45,UCBPlayer
3282,UCBPlayer,89,234,323,3,60,UCBPlayer
3283,UCBPlayer,138,243,381,28,49,UCBPlayer
3284,UCBPlayer,97,242,339,7,56,UCBPlayer
3285,UCBPlayer,130,235,365,24,53,UCBPlayer
3286,UCBPlayer,105,250,355,11,52,UCBPlayer
3287,UCBPlayer,122,227,349,20,57,UCBPlayer
3288,UCBPlayer,109,259,368,15,49,UCBPlayer
3289,UCBPlayer,118,218,336,16,60,UCBPlayer
3290,UCBPlayer,117,267,384,19,45,UCBPlayer
3291,UCBPlayer,110,210,320,12,64,UCBPlayer
3292,UCBPlayer,126,271,397,23,42,UCBPlayer
3293,UCBPlayer,105,210,315,10,65,UCBPlayer
3294,UCBPlayer,130,275,405,25,40,UCBPlayer
3295,UCBPlayer,105,210,315,10,65,UCBPlayer
3296,UCBPlayer,130,275,405,25,40,UCBPlayer
3297,UCBPlayer,106,206,312,10,66,UCBPlayer
3298,UCBPlayer,130,275,405,25,40,UCBPlayer
3299,UCBPlayer,105,210,315,10,65,UCBPlayer
3300,UCBPlayer,131,271,402,25,41,UCBPlayer
3301,UCBPlayer,105,210,315,10,65,UCBPlayer
3302,UCBPlayer,130,275,405,25,40,UCBPlayer
3303,UCBPlayer,105,210,315,10,65,UCBPlayer
3304,UCBPlayer,130,275,405,25,40,UCBPlayer
3305,UCBPlayer,103,203,306,10,68,UCBPlayer
3306,UCBPlayer,128,283,411,25,38,UCBPlayer
3307,UCBPlayer,111,186,297,10,71,UCBPlayer
3308,UCBPlayer,124,299,423,25,34,UCBPlayer
3309,UCBPlayer,115,170,285,10,75,UCBPlayer
3310,UCBPlayer,120,315,435,25,30,UCBPlayer
3311,UCBPlayer,119,154,273,10,79,UCBPlayer
3312,UCBPlayer,112,332,444,25,27,UCBPlayer
3313,UCBPlayer,127,137,264,10,82,UCBPlayer
3314,UCBPlayer,104,349,453,25,24,UCBPlayer
3315,UCBPlayer,126,126,252,7,85,Tie
3316,UCBPlayer,111,351,462,28,22,UCBPlayer
3317,UCBPlayer,116,126,242,3,87,UCBPlayer
3318,UCBPlayer,122,347,469,32,21,UCBPlayer
3319,UCBPlayer,107,132,239,0,87,UCBPlayer
3320,UCBPlayer,132,337,469,35,22,UCBPlayer
3321,UCBPlayer,103,148,251,0,83,UCBPlayer
3322,UCBPlayer,136,321,457,35,26,UCBPlayer
3323,UCBPlayer,99,164,263,0,79,UCBPlayer
3324,UCBPlayer,140,305,445,35,30,UCBPlayer
3325,UCBPlayer,95,180,275,0,75,UCBPlayer
3326,UCBPlayer,144,289,433,35,34,UCBPlayer
3327,UCBPlayer,91,196,287,0,71,UCBPlayer
3328,UCBPlayer,148,273,421,35,38,UCBPlayer
3329,UCBPlayer,87,212,299,0,67,UCBPlayer
3330,UCBPlayer,152,257,409,35,42,UCBPlayer
3331,UCBPlayer,84,224,308,0,64,UCBPlayer
3332,UCBPlayer,146,251,397,32,45,UCBPlayer
3333,UCBPlayer,89,234,323,3,60,UCBPlayer
3334,UCBPlayer,138,243,381,28,49,UCBPlayer
3335,UCBPlayer,97,242,339,7,56,UCBPlayer
3336,UCBPlayer,130,235,365,24,53,UCBPlayer
3337,UCBPlayer,105,250,355,11,52,UCBPlayer
3338,UCBPlayer,122,227,349,20,57,UCBPlayer
3339,UCBPlayer,109,259,368,15,49,UCBPlayer
3340,UCBPlayer,118,218,336,16,60,UCBPlayer
3341,UCBPlayer,117,267,384,19,45,UCBPlayer
3342,UCBPlayer,110,210,320,12,64,UCBPlayer
3343,UCBPlayer,126,271,397,23,42,UCBPlayer
3344,UCBPlayer,105,210,315,10,65,UCBPlayer
3345,UCBPlayer,130,275,405,25,40,UCBPlayer
3346,UCBPlayer,105,210,315,10,65,UCBPlayer
3347,UCBPlayer,130,275,405,25,40,UCBPlayer
3348,UCBPlayer,106,206,312,10,66,UCBPlayer
3349,UCBPlayer,130,275,405,25,40,UCBPlayer
3350,UCBPlayer,105,210,315,10,65,UCBPlayer
3351,UCBPlayer,131,271,402,25,41,UCBPlayer
3352,UCBPlayer,105,210,315,10,65,UCBPlayer
3353,UCBPlayer,130,275,405,25,40,UCBPlayer
3354,UCBPlayer,105,210,315,10,65,UCBPlayer
3355,UCBPlayer,130,275,405,25,40,UCBPlayer
3356,UCBPlayer,103,203,306,10,68,UCBPlayer
3357,UCBPlayer,128,283,411,25,38,UCBPlayer
3358,UCBPlayer,111,186,297,10,71,UCBPlayer
3359,UCBPlayer,124,299,423,25,34,UCBPlayer
3360,UCBPlayer,115,170,285,10,75,UCBPlayer
3361,UCBPlayer,120,315,435,25,30,UCBPlayer
3362,UCBPlayer,119,154,273,10,79,UCBPlayer
3363,UCBPlayer,112,332,444,25,27,UCBPlayer
3364,UCBPlayer,127,137,264,10,82,UCBPlayer
3365,UCBPlayer,104,349,453,25,24,UCBPlayer
3366,UCBPlayer,126,126,252,7,85,Tie
3367,UCBPlayer,111,351,462,28,22,UCBPlayer
3368,UCBPlayer,116,126,242,3,87,UCBPlayer
3369,UCBPlayer,122,347,469,32,21,UCBPlayer
3370,UCBPlayer,107,132,239,0,87,UCBPlayer
3371,UCBPlayer,132,337,469,35,22,UCBPlayer
3372,UCBPlayer,103,148,251,0,83,UCBPlayer
3373,UCBPlayer,136,321,457,35,26,UCBPlayer
3374,UCBPlayer,99,164,263,0,79,UCBPlayer
3375,UCBPlayer,140,305,445,35,30,UCBPlayer
3376,UCBPlayer,95,180,275,0,75,UCBPlayer
3377,UCBPlayer,144,289,433,35,34,UCBPlayer
3378,UCBPlayer,91,196,287,0,71,UCBPlayer
3379,UCBPlayer,148,273,421,35,38,UCBPlayer
3380,UCBPlayer,87,212,299,0,67,UCBPlayer
3381,UCBPlayer,152,257,409,35,42,UCBPlayer
3382,UCBPlayer,84,224,308,0,64,UCBPlayer
3383,UCBPlayer,146,251,397,32,45,UCBPlayer
3384,UCBPlayer,89,234,323,3,60,UCBPlayer
3385,UCBPlayer,138,243,381,28,49,UCBPlayer
3386,UCBPlayer,97,242,339,7,56,UCBPlayer
3387,UCBPlayer,130,235,365,24,53,UCBPlayer
3388,UCBPlayer,105,250,355,11,52,UCBPlayer
3389,UCBPlayer,122,227,349,20,57,UCBPlayer
3390,UCBPlayer,109,259,368,15,49,UCBPlayer
3391,UCBPlayer,118,218,336,16,60,UCBPlayer
3392,UCBPlayer,117,267,384,19,45,UCBPlayer
3393,UCBPlayer,110,210,320,12,64,UCBPlayer
3394,UCBPlayer,126,271,397,23,42,UCBPlayer
3395,UCBPlayer,105,210,315,10,65,UCBPlayer
3396,UCBPlayer,130,275,405,25,40,UCBPlayer
3397,UCBPlayer,105,210,315,10,65,UCBPlayer
3398,UCBPlayer,130,275,405,25,40,UCBPlayer
3399,UCBPlayer,106,206,312,10,66,UCBPlayer
3400,UCBPlayer,130,275,405,25,40,UCBPlayer
3401,UCBPlayer,105,210,315,10,65,UCBPlayer
3402,UCBPlayer,131,271,402,25,41,UCBPlayer
3403,UCBPlayer,105,210,315,10,65,UCBPlayer
3404,UCBPlayer,130,275,405,25,40,UCBPlayer
3405,UCBPlayer,105,210,315,10,65,UCBPlayer
3406,UCBPlayer,130,275,405,25,40,UCBPlayer
3407,UCBPlayer,103,203,306,10,68,UCBPlayer
3408,UCBPlayer,128,283,411,25,38,UCBPlayer
3409,UCBPlayer,111,186,297,10,71,UCBPlayer
3410,UCBPlayer,124,299,423,25,34,UCBPlayer
3411,UCBPlayer,115,170,285,10,75,UCBPlayer
3412,UCBPlayer,120,315,435,25,30,UCBPlayer
3413,UCBPlayer,119,154,273,10,79,UCBPlayer
3414,UCBPlayer,112,332,444,25,27,UCBPlayer
3415,UCBPlayer,127,137,264,10,82,UCBPlayer
3416,UCBPlayer,104,349,453,25,24,UCBPlayer
3417,UCBPlayer,126,126,252,7,85,Tie
3418,UCBPlayer,111,351,462,28,22,UCBPlayer
3419,UCBPlayer,116,126,242,3,87,UCBPlayer
3420,UCBPlayer,122,347,469,32,21,UCBPlayer
3421,UCBPlayer,107,132,239,0,87,UCBPlayer
3422,UCBPlayer,132,337,469,35,22,UCBPlayer
3423,UCBPlayer,103,148,251,0,83,UCBPlayer
3424,UCBPlayer,136,321,457,35,26,UCBPlayer
3425,UCBPlayer,99,164,263,0,79,UCBPlayer
3426,UCBPlayer,140,305,445,35,30,UCBPlayer
3427,UCBPlayer,95,180,275,0,75,UCBPlayer
3428,UCBPlayer,144,289,433,35,34,UCBPlayer
3429,UCBPlayer,91,196,287,0,71,UCBPlayer
3430,UCBPlayer,148,273,421,35,38,UCBPlayer
3431,UCBPlayer,87,212,299,0,67,UCBPlayer
3432,UCBPlayer,152,257,409,35,42,UCBPlayer
3433,UCBPlayer,84,224,308,0,64,UCBPlayer
3434,UCBPlayer,146,251,397,32,45,UCBPlayer
3435,UCBPlayer,89,234,323,3,60,UCBPlayer
3436,UCBPlayer,138,243,381,28,49,UCBPlayer
3437,UCBPlayer,97,242,339,7,56,UCBPlayer
3438,UCBPlayer,130,235,365,24,53,UCBPlayer
3439,UCBPlayer,105,250,355,11,52,UCBPlayer
3440,UCBPlayer,122,227,349,20,57,UCBPlayer
3441,UCBPlayer,109,259,368,15,49,UCBPlayer
3442,UCBPlayer,118,218,336,16,60,UCBPlayer
3443,UCBPlayer,117,267,384,19,45,UCBPlayer
3444,UCBPlayer,110,210,320,12,64,UCBPlayer
3445,UCBPlayer,126,271,397,23,42,UCBPlayer
3446,UCBPlayer,105,210,315,10,65,UCBPlayer
3447,UCBPlayer,130,275,405,25,40,UCBPlayer
3448,UCBPlayer,105,210,315,10,65,UCBPlayer
3449,UCBPlayer,130,275,405,25,40,UCBPlayer
3450,UCBPlayer,106,206,312,10,66,UCBPlayer
3451,UCBPlayer,130,275,405,25,40,UCBPlayer
3452,UCBPlayer,105,210,315,10,65,UCBPlayer
3453,UCBPlayer,131,271,402,25,41,UCBPlayer
3454,UCBPlayer,105,210,315,10,65,UCBPlayer
3455,UCBPlayer,130,275,405,25,40,UCBPlayer
3456,UCBPlayer,105,210,315,10,65,UCBPlayer
3457,UCBPlayer,130,275,405,25,40,UCBPlayer
3458,UCBPlayer,103,203,306,10,68,UCBPlayer
3459,UCBPlayer,128,283,411,25,38,UCBPlayer
3460,UCBPlayer,111,186,297,10,71,UCBPlayer
3461,UCBPlayer,124,299,423,25,34,UCBPlayer
3462,UCBPlayer,115,170,285,10,75,UCBPlayer
3463,UCBPlayer,120,315,435,25,30,UCBPlayer
3464,UCBPlayer,119,154,273,10,79,UCBPlayer
3465,UCBPlayer,112,332,444,25,27,UCBPlayer
3466,UCBPlayer,127,137,264,10,82,UCBPlayer
3467,UCBPlayer,104,349,453,25,24,UCBPlayer
3468,UCBPlayer,126,126,252,7,85,Tie
3469,UCBPlayer,111,351,462,28,22,UCBPlayer
3470,UCBPlayer,116,126,242,3,87,UCBPlayer
3471,UCBPlayer,122,347,469,32,21,UCBPlayer
3472,UCBPlayer,107,132,239,0,87,UCBPlayer
3473,UCBPlayer,132,337,469,35,22,UCBPlayer
3474,UCBPlayer,103,148,251,0,83,UCBPlayer
3475,UCBPlayer,136,321,457,35,26,UCBPlayer
3476,UCBPlayer,99,164,263,0,79,UCBPlayer
3477,UCBPlayer,140,305,445,35,30,UCBPlayer
3478,UCBPlayer,95,180,275,0,75,UCBPlayer
3479,UCBPlayer,144,289,433,35,34,UCBPlayer
3480,UCBPlayer,91,196,287,0,71,UCBPlayer
3481,UCBPlayer,148,273,421,35,38,UCBPlayer
3482,UCBPlayer,87,212,299,0,67,UCBPlayer
3483,UCBPlayer,152,257,409,35,42,UCBPlayer
3484,UCBPlayer,84,224,308,0,64,UCBPlayer
3485,UCBPlayer,146,251,397,32,45,UCBPlayer
3486,UCBPlayer,89,234,323,3,60,UCBPlayer
3487,UCBPlayer,138,243,381,28,49,UCBPlayer
3488,UCBPlayer,97,242,339,7,56,UCBPlayer
3489,UCBPlayer,130,235,365,24,53,UCBPlayer
3490,UCBPlayer,105,250,355,11,52,UCBPlayer
3491,UCBPlayer,122,227,349,20,57,UCBPlayer
3492,UCBPlayer,109,259,368,15,49,UCBPlayer
3493,UCBPlayer,118,218,336,16,60,UCBPlayer
3494,UCBPlayer,117,267,384,19,45,UCBPlayer
3495,UCBPlayer,110,210,320,12,64,UCBPlayer
3496,UCBPlayer,126,271,397,23,42,UCBPlayer
3497,UCBPlayer,105,210,315,10,65,UCBPlayer
3498,UCBPlayer,130,275,405,25,40,UCBPlayer
3499,UCBPlayer,105,210,315,10,65,UCBPlayer
3500,UCBPlayer,130,275,405,25,40,UCBPlayer
3501,UCBPlayer,106,206,312,10,66,UCBPlayer
3502,UCBPlayer,130,275,405,25,40,UCBPlayer
3503,UCBPlayer,105,210,315,10,65,UCBPlayer
3504,UCBPlayer,131,271,402,25,41,UCBPlayer
3505,UCBPlayer,105,210,315,10,65,UCBPlayer
3506,UCBPlayer,130,275,405,25,40,UCBPlayer
3507,UCBPlayer,105,210,315,10,65,UCBPlayer
3508,UCBPlayer,130,275,405,25,40,UCBPlayer
3509,UCBPlayer,103,203,306,10,68,UCBPlayer
3510,UCBPlayer,128,283,411,25,38,UCBPlayer
3511,UCBPlayer,111,186,297,10,71,UCBPlayer
3512,UCBPlayer,124,299,423,25,34,UCBPlayer
3513,UCBPlayer,115,170,285,10,75,UCBPlayer
3514,UCBPlayer,120,315,435,25,30,UCBPlayer
3515,UCBPlayer,119,154,273,10,79,UCBPlayer
3516,UCBPlayer,112,332,444,25,27,UCBPlayer
3517,UCBPlayer,127,137,264,10,82,UCBPlayer
3518,UCBPlayer,104,349,453,25,24,UCBPlayer
3519,UCBPlayer,126,126,252,7,85,Tie
3520,UCBPlayer,111,351,462,28,22,UCBPlayer
3521,UCBPlayer,116,126,242,3,87,UCBPlayer
3522,UCBPlayer,122,347,469,32,21,UCBPlayer
3523,UCBPlayer,107,132,239,0,87,UCBPlayer
3524,UCBPlayer,132,337,469,35,22,UCBPlayer
3525,UCBPlayer,103,148,251,0,83,UCBPlayer
3526,UCBPlayer,136,321,457,35,26,UCBPlayer
3527,UCBPlayer,99,164,263,0,79,UCBPlayer
3528,UCBPlayer,140,305,445,35,30,UCBPlayer
3529,UCBPlayer,95,180,275,0,75,UCBPlayer
3530,UCBPlayer,144,289,433,35,34,UCBPlayer
3531,UCBPlayer,91,196,287,0,71,UCBPlayer
3532,UCBPlayer,148,273,421,35,38,UCBPlayer
3533,UCBPlayer,87,212,299,0,67,UCBPlayer
3534,UCBPlayer,152,257,409,35,42,UCBPlayer
3535,UCBPlayer,84,224,308,0,64,UCBPlayer
3536,UCBPlayer,146,251,397,32,45,UCBPlayer
3537,UCBPlayer,89,234,323,3,60,UCBPlayer
3538,UCBPlayer,138,243,381,28,49,UCBPlayer
3539,UCBPlayer,97,242,339,7,56,UCBPlayer
3540,UCBPlayer,130,235,365,24,53,UCBPlayer
3541,UCBPlayer,105,250,355,11,52,UCBPlayer
3542,UCBPlayer,122,227,349,20,57,UCBPlayer
3543,UCBPlayer,109,259,368,15,49,UCBPlayer
3544,UCBPlayer,118,218,336,16,60,UCBPlayer
3545,UCBPlayer,117,267,384,19,45,UCBPlayer
3546,UCBPlayer,110,210,320,12,64,UCBPlayer
3547,UCBPlayer,126,271,397,23,42,UCBPlayer
3548,UCBPlayer,105,210,315,10,65,UCBPlayer
3549,UCBPlayer,130,275,405,25,40,UCBPlayer
3550,UCBPlayer,105,210,315,10,65,UCBPlayer
3551,UCBPlayer,130,275,405,25,40,UCBPlayer
3552,UCBPlayer,106,206,312,10,66,UCBPlayer
3553,UCBPlayer,130,275,405,25,40,UCBPlayer
3554,UCBPlayer,105,210,315,10,65,UCBPlayer
3555,UCBPlayer,131,271,402,25,41,UCBPlayer
3556,UCBPlayer,105,210,315,10,65,UCBPlayer
3557,UCBPlayer,130,275,405,25,40,UCBPlayer
3558,UCBPlayer,105,210,315,10,65,UCBPlayer
3559,UCBPlayer,130,275,405,25,40,UCBPlayer
3560,UCBPlayer,103,203,306,10,68,UCBPlayer
3561,UCBPlayer,128,283,411,25,38,UCBPlayer
3562,UCBPlayer,111,186,297,10,71,UCBPlayer
3563,UCBPlayer,124,299,423,25,34,UCBPlayer
3564,UCBPlayer,115,170,285,10,75,UCBPlayer
3565,UCBPlayer,120,315,435,25,30,UCBPlayer
3566,UCBPlayer,119,154,273,10,79,UCBPlayer
3567,UCBPlayer,112,332,444,25,27,UCBPlayer
3568,UCBPlayer,127,137,264,10,82,UCBPlayer
3569,UCBPlayer,104,349,453,25,24,UCBPlayer
3570,UCBPlayer,126,126,252,7,85,Tie
3571,UCBPlayer,111,351,462,28,22,UCBPlayer
3572,UCBPlayer,116,126,242,3,87,UCBPlayer
3573,UCBPlayer,122,347,469,32,21,UCBPlayer
3574,UCBPlayer,107,132,239,0,87,UCBPlayer
3575,UCBPlayer,132,337,469,35,22,UCBPlayer
3576,UCBPlayer,103,148,251,0,83,UCBPlayer
3577,UCBPlayer,136,321,457,35,26,UCBPlayer
3578,UCBPlayer,99,164,263,0,79,UCBPlayer
3579,UCBPlayer,140,305,445,35,30,UCBPlayer
3580,UCBPlayer,95,180,275,0,75,UCBPlayer
3581,UCBPlayer,144,289,433,35,34,UCBPlayer
3582,UCBPlayer,91,196,287,0,71,UCBPlayer
3583,UCBPlayer,148,273,421,35,38,UCBPlayer
3584,UCBPlayer,87,212,299,0,67,UCBPlayer
3585,UCBPlayer,152,257,409,35,42,UCBPlayer
3586,UCBPlayer,84,224,308,0,64,UCBPlayer
3587,UCBPlayer,146,251,397,32,45,UCBPlayer
3588,UCBPlayer,89,234,323,3,60,UCBPlayer
3589,UCBPlayer,138,243,381,28,49,UCBPlayer
3590,UCBPlayer,97,242,339,7,56,UCBPlayer
3591,UCBPlayer,130,235,365,24,53,UCBPlayer
3592,UCBPlayer,105,250,355,11,52,UCBPlayer
3593,UCBPlayer,122,227,349,20,57,UCBPlayer
3594,UCBPlayer,109,259,368,15,49,UCBPlayer
3595,UCBPlayer,118,218,336,16,60,UCBPlayer
3596,UCBPlayer,117,267,384,19,45,UCBPlayer
3597,UCBPlayer,110,210,320,12,64,UCBPlayer
3598,UCBPlayer,126,271,397,23,42,UCBPlayer
3599,UCBPlayer,105,210,315,10,65,UCBPlayer
3600,UCBPlayer,130,275,405,25,40,UCBPlayer
3601,UCBPlayer,105,210,315,10,65,UCBPlayer
3602,UCBPlayer,130,275,405,25,40,UCBPlayer
3603,UCBPlayer,106,206,312,10,66,UCBPlayer
3604,UCBPlayer,130,275,405,25,40,UCBPlayer
3605,UCBPlayer,105,210,315,10,65,UCBPlayer
3606,UCBPlayer,131,271,402,25,41,UCBPlayer
3607,UCBPlayer,105,210,315,10,65,UCBPlayer
3608,UCBPlayer,130,275,405,25,40,UCBPlayer
3609,UCBPlayer,105,210,315,10,65,UCBPlayer
3610,UCBPlayer,130,275,405,25,40,UCBPlayer
3611,UCBPlayer,103,203,306,10,68,UCBPlayer
3612,UCBPlayer,128,283,411,25,38,UCBPlayer
3613,UCBPlayer,111,186,297,10,71,UCBPlayer
3614,UCBPlayer,124,299,423,25,34,UCBPlayer
3615,UCBPlayer,115,170,285,10,75,UCBPlayer
3616,UCBPlayer,120,315,435,25,30,UCBPlayer
3617,UCBPlayer,119,154,273,10,79,UCBPlayer
3618,UCBPlayer,112,332,444,25,27,UCBPlayer
3619,UCBPlayer,127,137,264,10,82,UCBPlayer
3620,UCBPlayer,104,349,453,25,24,UCBPlayer
3621,UCBPlayer,126,126,252,7,85,Tie
3622,UCBPlayer,111,351,462,28,22,UCBPlayer
3623,UCBPlayer,116,126,242,3,87,UCBPlayer
3624,UCBPlayer,122,347,469,32,21,UCBPlayer
3625,UCBPlayer,107,132,239,0,87,UCBPlayer
3626,UCBPlayer,132,337,469,35,22,UCBPlayer
3627,UCBPlayer,103,148,251,0,83,UCBPlayer
3628,UCBPlayer,136,321,457,35,26,UCBPlayer
3629,UCBPlayer,99,164,263,0,79,UCBPlayer
3630,UCBPlayer,140,305,445,35,30,UCBPlayer
3631,UCBPlayer,95,180,275,0,75,UCBPlayer
3632,UCBPlayer,144,289,433,35,34,UCBPlayer
3633,UCBPlayer,91,196,287,0,71,UCBPlayer
3634,UCBPlayer,148,273,421,35,38,UCBPlayer
3635,UCBPlayer,87,212,299,0,67,UCBPlayer
3636,UCBPlayer,152,257,409,35,42,UCBPlayer
3637,UCBPlayer,84,224,308,0,64,UCBPlayer
3638,UCBPlayer,146,251,397,32,45,UCBPlayer
3639,UCBPlayer,89,234,323,3,60,UCBPlayer
3640,UCBPlayer,138,243,381,28,49,UCBPlayer
3641,UCBPlayer,97,242,339,7,56,UCBPlayer
3642,UCBPlayer,130,235,365,24,53,UCBPlayer
3643,UCBPlayer,105,250,355,11,52,UCBPlayer
3644,UCBPlayer,122,227,349,20,57,UCBPlayer
3645,UCBPlayer,109,259,368,15,49,UCBPlayer
3646,UCBPlayer,118,218,336,16,60,UCBPlayer
3647,UCBPlayer,117,267,384,19,45,UCBPlayer
3648,UCBPlayer,110,210,320,12,64,UCBPlayer
3649,UCBPlayer,126,271,397,23,42,UCBPlayer
3650,UCBPlayer,105,210,315,10,65,UCBPlayer
3651,UCBPlayer,130,275,405,25,40,UCBPlayer
3652,UCBPlayer,105,210,315,10,65,UCBPlayer
3653,UCBPlayer,130,275,405,25,40,UCBPlayer
3654,UCBPlayer,106,206,312,10,66,UCBPlayer
3655,UCBPlayer,130,275,405,25,40,UCBPlayer
3656,UCBPlayer,105,210,315,10,65,UCBPlayer
3657,UCBPlayer,131,271,402,25,41,UCBPlayer
3658,UCBPlayer,105,210,315,10,65,UCBPlayer
3659,UCBPlayer,130,275,405,25,40,UCBPlayer
3660,UCBPlayer,105,210,315,10,65,UCBPlayer
3661,UCBPlayer,130,275,405,25,40,UCBPlayer
3662,UCBPlayer,103,203,306,10,68,UCBPlayer
3663,UCBPlayer,128,283,411,25,38,UCBPlayer
3664,UCBPlayer,111,186,297,10,71,UCBPlayer
3665,UCBPlayer,124,299,423,25,34,UCBPlayer
3666,UCBPlayer,115,170,285,10,75,UCBPlayer
3667,UCBPlayer,120,315,435,25,30,UCBPlayer
3668,UCBPlayer,119,154,273,10,79,UCBPlayer
3669,UCBPlayer,112,332,444,25,27,UCBPlayer
3670,UCBPlayer,127,137,264,10,82,UCBPlayer
3671,UCBPlayer,104,349,453,25,24,UCBPlayer
3672,UCBPlayer,126,126,252,7,85,Tie
3673,UCBPlayer,111,351,462,28,22,UCBPlayer
3674,UCBPlayer,116,126,242,3,87,UCBPlayer
3675,UCBPlayer,122,347,469,32,21,UCBPlayer
3676,UCBPlayer,107,132,239,0,87,UCBPlayer
3677,UCBPlayer,132,337,469,35,22,UCBPlayer
3678,UCBPlayer,103,148,251,0,83,UCBPlayer
3679,UCBPlayer,136,321,457,35,26,UCBPlayer
3680,UCBPlayer,99,164,263,0,79,UCBPlayer
3681,UCBPlayer,140,305,445,35,30,UCBPlayer
3682,UCBPlayer,95,180,275,0,75,UCBPlayer
3683,UCBPlayer,144,289,433,35,34,UCBPlayer
3684,UCBPlayer,91,196,287,0,71,UCBPlayer
3685,UCBPlayer,148,273,421,35,38,UCBPlayer
3686,UCBPlayer,87,212,299,0,67,UCBPlayer
3687,UCBPlayer,152,257,409,35,42,UCBPlayer
3688,UCBPlayer,84,224,308,0,64,UCBPlayer
3689,UCBPlayer,146,251,397,32,45,UCBPlayer
3690,UCBPlayer,89,234,323,3,60,UCBPlayer
3691,UCBPlayer,138,243,381,28,49,UCBPlayer
3692,UCBPlayer,97,242,339,7,56,UCBPlayer
3693,UCBPlayer,130,235,365,24,53,UCBPlayer
3694,UCBPlayer,105,250,355,11,52,UCBPlayer
3695,UCBPlayer,122,227,349,20,57,UCBPlayer
3696,UCBPlayer,109,259,368,15,49,UCBPlayer
3697,UCBPlayer,118,218,336,16,60,UCBPlayer
3698,UCBPlayer,117,267,384,19,45,UCBPlayer
3699,UCBPlayer,110,210,320,12,64,UCBPlayer
3700,UCBPlayer,126,271,397,23,42,UCBPlayer
3701,UCBPlayer,105,210,315,10,65,UCBPlayer
3702,UCBPlayer,130,275,405,25,40,UCBPlayer
3703,UCBPlayer,105,210,315,10,65,UCBPlayer
3704,UCBPlayer,130,275,405,25,40,UCBPlayer
3705,UCBPlayer,106,206,312,10,66,UCBPlayer
3706,UCBPlayer,130,275,405,25,40,UCBPlayer
3707,UCBPlayer,105,210,315,10,65,UCBPlayer
3708,UCBPlayer,131,271,402,25,41,UCBPlayer
3709,UCBPlayer,105,210,315,10,65,UCBPlayer
3710,UCBPlayer,130,275,405,25,40,UCBPlayer
3711,UCBPlayer,105,210,315,10,65,UCBPlayer
3712,UCBPlayer,130,275,405,25,40,UCBPlayer
3713,UCBPlayer,103,203,306,10,68,UCBPlayer
3714,UCBPlayer,128,283,411,25,38,UCBPlayer
3715,UCBPlayer,111,186,297,10,71,UCBPlayer
3716,UCBPlayer,124,299,423,25,34,UCBPlayer
3717,UCBPlayer,115,170,285,10,75,UCBPlayer
3718,UCBPlayer,120,315,435,25,30,UCBPlayer
3719,UCBPlayer,119,154,273,10,79,UCBPlayer
3720,UCBPlayer,112,332,444,25,27,UCBPlayer
3721,UCBPlayer,127,137,264,10,82,UCBPlayer
3722,UCBPlayer,104,349,453,25,24,UCBPlayer
3723,UCBPlayer,126,126,252,7,85,Tie
3724,UCBPlayer,111,351,462,28,22,UCBPlayer
3725,UCBPlayer,116,126,242,3,87,UCBPlayer
3726,UCBPlayer,122,347,469,32,21,UCBPlayer
3727,UCBPlayer,107,132,239,0,87,UCBPlayer
3728,UCBPlayer,132,337,469,35,22,UCBPlayer
3729,UCBPlayer,103,148,251,0,83,UCBPlayer
3730,UCBPlayer,136,321,457,35,26,UCBPlayer
3731,UCBPlayer,99,164,263,0,79,UCBPlayer
3732,UCBPlayer,140,305,445,35,30,UCBPlayer
3733,UCBPlayer,95,180,275,0,75,UCBPlayer
3734,UCBPlayer,144,289,433,35,34,UCBPlayer
3735,UCBPlayer,91,196,287,0,71,UCBPlayer
3736,UCBPlayer,148,273,421,35,38,UCBPlayer
3737,UCBPlayer,87,212,299,0,67,UCBPlayer
3738,UCBPlayer,152,257,409,35,42,UCBPlayer
3739,UCBPlayer,84,224,308,0,64,UCBPlayer
3740,UCBPlayer,146,251,397,32,45,UCBPlayer
3741,UCBPlayer,89,234,323,3,60,UCBPlayer
3742,UCBPlayer,138,243,381,28,49,UCBPlayer
3743,UCBPlayer,97,242,339,7,56,UCBPlayer
3744,UCBPlayer,130,235,365,24,53,UCBPlayer
3745,UCBPlayer,105,250,355,11,52,UCBPlayer
3746,UCBPlayer,122,227,349,20,57,UCBPlayer
3747,UCBPlayer,109,259,368,15,49,UCBPlayer
3748,UCBPlayer,118,218,336,16,60,UCBPlayer
3749,UCBPlayer,117,267,384,19,45,UCBPlayer
3750,UCBPlayer,110,210,320,12,64,UCBPlayer
3751,UCBPlayer,126,271,397,23,42,UCBPlayer
3752,UCBPlayer,105,210,315,10,65,UCBPlayer
3753,UCBPlayer,130,275,405,25,40,UCBPlayer
3754,UCBPlayer,105,210,315,10,65,UCBPlayer
3755,UCBPlayer,130,275,405,25,40,UCBPlayer
3756,UCBPlayer,106,206,312,10,66,UCBPlayer
3757,UCBPlayer,130,275,405,25,40,UCBPlayer
3758,UCBPlayer,105,210,315,10,65,UCBPlayer
3759,UCBPlayer,131,271,402,25,41,UCBPlayer
3760,UCBPlayer,105,210,315,10,65,UCBPlayer
3761,UCBPlayer,130,275,405,25,40,UCBPlayer
3762,UCBPlayer,105,210,315,10,65,UCBPlayer
3763,UCBPlayer,130,275,405,25,40,UCBPlayer
3764,UCBPlayer,103,203,306,10,68,UCBPlayer
3765,UCBPlayer,128,283,411,25,38,UCBPlayer
3766,UCBPlayer,111,186,297,10,71,UCBPlayer
3767,UCBPlayer,124,299,423,25,34,UCBPlayer
3768,UCBPlayer,115,170,285,10,75,UCBPlayer
3769,UCBPlayer,120,315,435,25,30,UCBPlayer
3770,UCBPlayer,119,154,273,10,79,UCBPlayer
3771,UCBPlayer,112,332,444,25,27,UCBPlayer
3772,UCBPlayer,127,137,264,10,82,UCBPlayer
3773,UCBPlayer,104,349,453,25,24,UCBPlayer
3774,UCBPlayer,126,126,252,7,85,Tie
3775,UCBPlayer,111,351,462,28,22,UCBPlayer
3776,UCBPlayer,116,126,242,3,87,UCBPlayer
3777,UCBPlayer,122,347,469,32,21,UCBPlayer
3778,UCBPlayer,107,132,239,0,87,UCBPlayer
3779,UCBPlayer,132,337,469,35,22,UCBPlayer
3780,UCBPlayer,103,148,251,0,83,UCBPlayer
3781,UCBPlayer,136,321,457,35,26,UCBPlayer
3782,UCBPlayer,99,164,263,0,79,UCBPlayer
3783,UCBPlayer,140,305,445,35,30,UCBPlayer
3784,UCBPlayer,95,180,275,0,75,UCBPlayer
3785,UCBPlayer,144,289,433,35,34,UCBPlayer
3786,UCBPlayer,91,196,287,0,71,UCBPlayer
3787,UCBPlayer,148,273,421,35,38,UCBPlayer
3788,UCBPlayer,87,212,299,0,67,UCBPlayer
3789,UCBPlayer,152,257,409,35,42,UCBPlayer
3790,UCBPlayer,84,224,308,0,64,UCBPlayer
3791,UCBPlayer,146,251,397,32,45,UCBPlayer
3792,UCBPlayer,89,234,323,3,60,UCBPlayer
3793,UCBPlayer,138,243,381,28,49,UCBPlayer
3794,UCBPlayer,97,242,339,7,56,UCBPlayer
3795,UCBPlayer,130,235,365,24,53,UCBPlayer
3796,UCBPlayer,105,250,355,11,52,UCBPlayer
3797,UCBPlayer,122,227,349,20,57,UCBPlayer
3798,UCBPlayer,109,259,368,15,49,UCBPlayer
3799,UCBPlayer,118,218,336,16,60,UCBPlayer
3800,UCBPlayer,117,267,384,19,45,UCBPlayer
3801,UCBPlayer,110,210,320,12,64,UCBPlayer
3802,UCBPlayer,126,271,397,23,42,UCBPlayer
3803,UCBPlayer,105,210,315,10,65,UCBPlayer
3804,UCBPlayer,130,275,405,25,40,UCBPlayer
3805,UCBPlayer,105,210,315,10,65,UCBPlayer
3806,UCBPlayer,130,275,405,25,40,UCBPlayer
3807,UCBPlayer,106,206,312,10,66,UCBPlayer
3808,UCBPlayer,130,275,405,25,40,UCBPlayer
3809,UCBPlayer,105,210,315,10,65,UCBPlayer
3810,UCBPlayer,131,271,402,25,41,UCBPlayer
3811,UCBPlayer,105,210,315,10,65,UCBPlayer
3812,UCBPlayer,130,275,405,25,40,UCBPlayer
3813,UCBPlayer,105,210,315,10,65,UCBPlayer
3814,UCBPlayer,130,275,405,25,40,UCBPlayer
3815,UCBPlayer,103,203,306,10,68,UCBPlayer
3816,UCBPlayer,128,283,411,25,38,UCBPlayer
3817,UCBPlayer,111,186,297,10,71,UCBPlayer
3818,UCBPlayer,124,299,423,25,34,UCBPlayer
3819,UCBPlayer,115,170,285,10,75,UCBPlayer
3820,UCBPlayer,120,315,435,25,30,UCBPlayer
3821,UCBPlayer,119,154,273,10,79,UCBPlayer
3822,UCBPlayer,112,332,444,25,27,UCBPlayer
3823,UCBPlayer,127,137,264,10,82,UCBPlayer
3824,UCBPlayer,104,349,453,25,24,UCBPlayer
3825,UCBPlayer,126,126,252,7,85,Tie
3826,UCBPlayer,111,351,462,28,22,UCBPlayer
3827,UCBPlayer,116,126,242,3,87,UCBPlayer
3828,UCBPlayer,122,347,469,32,21,UCBPlayer
3829,UCBPlayer,107,132,239,0,87,UCBPlayer
3830,UCBPlayer,132,337,469,35,22,UCBPlayer
3831,UCBPlayer,103,148,251,0,83,UCBPlayer
3832,UCBPlayer,136,321,457,35,26,UCBPlayer
3833,UCBPlayer,99,164,263,0,79,UCBPlayer
3834,UCBPlayer,140,305,445,35,30,UCBPlayer
3835,UCBPlayer,95,180,275,0,75,UCBPlayer
3836,UCBPlayer,144,289,433,35,34,UCBPlayer
3837,UCBPlayer,91,196,287,0,71,UCBPlayer
3838,UCBPlayer,148,273,421,35,38,UCBPlayer
3839,UCBPlayer,87,212,299,0,67,UCBPlayer
3840,UCBPlayer,152,257,409,35,42,UCBPlayer
3841,UCBPlayer,84,224,308,0,64,UCBPlayer
3842,UCBPlayer,146,251,397,32,45,UCBPlayer
3843,UCBPlayer,89,234,323,3,60,UCBPlayer
3844,UCBPlayer,138,243,381,28,49,UCBPlayer
3845,UCBPlayer,97,242,339,7,56,UCBPlayer
3846,UCBPlayer,130,235,365,24,53,UCBPlayer
3847,UCBPlayer,105,250,355,11,52,UCBPlayer
3848,UCBPlayer,122,227,349,20,57,UCBPlayer
3849,UCBPlayer,109,259,368,15,49,UCBPlayer
3850,UCBPlayer,118,218,336,16,60,UCBPlayer
3851,UCBPlayer,117,267,384,19,45,UCBPlayer
3852,UCBPlayer,110,210,320,12,64,UCBPlayer
3853,UCBPlayer,126,271,397,23,42,UCBPlayer
3854,UCBPlayer,105,210,315,10,65,UCBPlayer
3855,UCBPlayer,130,275,405,25,40,UCBPlayer
3856,UCBPlayer,105,210,315,10,65,UCBPlayer
3857,UCBPlayer,130,275,405,25,40,UCBPlayer
3858,UCBPlayer,106,206,312,10,66,UCBPlayer
3859,UCBPlayer,130,275,405,25,40,UCBPlayer
3860,UCBPlayer,105,210,315,10,65,UCBPlayer
3861,UCBPlayer,131,271,402,25,41,UCBPlayer
3862,UCBPlayer,105,210,315,10,65,UCBPlayer
3863,UCBPlayer,130,275,405,25,40,UCBPlayer
3864,UCBPlayer,105,210,315,10,65,UCBPlayer
3865,UCBPlayer,130,275,405,25,40,UCBPlayer
3866,UCBPlayer,103,203,306,10,68,UCBPlayer
3867,UCBPlayer,128,283,411,25,38,UCBPlayer
3868,UCBPlayer,111,186,297,10,71,UCBPlayer
3869,UCBPlayer,124,299,423,25,34,UCBPlayer
3870,UCBPlayer,115,170,285,10,75,UCBPlayer
3871,UCBPlayer,120,315,435,25,30,UCBPlayer
3872,UCBPlayer,119,154,273,10,79,UCBPlayer
3873,UCBPlayer,112,332,444,25,27,UCBPlayer
3874,UCBPlayer,127,137,264,10,82,UCBPlayer
3875,UCBPlayer,104,349,453,25,24,UCBPlayer
3876,UCBPlayer,126,126,252,7,85,Tie
3877,UCBPlayer,111,351,462,28,22,UCBPlayer
3878,UCBPlayer,116,126,242,3,87,UCBPlayer
3879,UCBPlayer,122,347,469,32,21,UCBPlayer
3880,UCBPlayer,107,132,239,0,87,UCBPlayer
3881,UCBPlayer,132,337,469,35,22,UCBPlayer
3882,UCBPlayer,103,148,251,0,83,UCBPlayer
3883,UCBPlayer,136,321,457,35,26,UCBPlayer
3884,UCBPlayer,99,164,263,0,79,UCBPlayer
3885,UCBPlayer,140,305,445,35,30,UCBPlayer
3886,UCBPlayer,95,180,275,0,75,UCBPlayer
3887,UCBPlayer,144,289,433,35,34,UCBPlayer
3888,UCBPlayer,91,196,287,0,71,UCBPlayer
3889,UCBPlayer,148,273,421,35,38,UCBPlayer
3890,UCBPlayer,87,212,299,0,67,UCBPlayer
3891,UCBPlayer,152,257,409,35,42,UCBPlayer
3892,UCBPlayer,84,224,308,0,64,UCBPlayer
3893,UCBPlayer,146,251,397,32,45,UCBPlayer
3894,UCBPlayer,89,234,323,3,60,UCBPlayer
3895,UCBPlayer,138,243,381,28,49,UCBPlayer
3896,UCBPlayer,97,242,339,7,56,UCBPlayer
3897,UCBPlayer,130,235,365,24,53,UCBPlayer
3898,UCBPlayer,105,250,355,11,52,UCBPlayer
3899,UCBPlayer,122,227,349,20,57,UCBPlayer
3900,UCBPlayer,109,259,368,15,49,UCBPlayer
3901,UCBPlayer,118,218,336,16,60,UCBPlayer
3902,UCBPlayer,117,267,384,19,45,UCBPlayer
3903,UCBPlayer,110,210,320,12,64,UCBPlayer
3904,UCBPlayer,126,271,397,23,42,UCBPlayer
3905,UCBPlayer,105,210,315,10,65,UCBPlayer
3906,UCBPlayer,130,275,405,25,40,UCBPlayer
3907,UCBPlayer,105,210,315,10,65,UCBPlayer
3908,UCBPlayer,130,275,405,25,40,UCBPlayer
3909,UCBPlayer,106,206,312,10,66,UCBPlayer
3910,UCBPlayer,130,275,405,25,40,UCBPlayer
3911,UCBPlayer,105,210,315,10,65,UCBPlayer
3912,UCBPlayer,131,271,402,25,41,UCBPlayer
3913,UCBPlayer,105,210,315,10,65,UCBPlayer
3914,UCBPlayer,130,275,405,25,40,UCBPlayer
3915,UCBPlayer,105,210,315,10,65,UCBPlayer
3916,UCBPlayer,130,275,405,25,40,UCBPlayer
3917,UCBPlayer,103,203,306,10,68,UCBPlayer
3918,UCBPlayer,128,283,411,25,38,UCBPlayer
3919,UCBPlayer,111,186,297,10,71,UCBPlayer
3920,UCBPlayer,124,299,423,25,34,UCBPlayer
3921,UCBPlayer,115,170,285,10,75,UCBPlayer
3922,UCBPlayer,120,315,435,25,30,UCBPlayer
3923,UCBPlayer,119,154,273,10,79,UCBPlayer
3924,UCBPlayer,112,332,444,25,27,UCBPlayer
3925,UCBPlayer,127,137,264,10,82,UCBPlayer
3926,UCBPlayer,104,349,453,25,24,UCBPlayer
3927,UCBPlayer,126,126,252,7,85,Tie
3928,UCBPlayer,111,351,462,28,22,UCBPlayer
3929,UCBPlayer,116,126,242,3,87,UCBPlayer
3930,UCBPlayer,122,347,469,32,21,UCBPlayer
3931,UCBPlayer,107,132,239,0,87,UCBPlayer
3932,UCBPlayer,132,337,469,35,22,UCBPlayer
3933,UCBPlayer,103,148,251,0,83,UCBPlayer
3934,UCBPlayer,136,321,457,35,26,UCBPlayer
3935,UCBPlayer,99,164,263,0,79,UCBPlayer
3936,UCBPlayer,140,305,445,35,30,UCBPlayer
3937,UCBPlayer,95,180,275,0,75,UCBPlayer
3938,UCBPlayer,144,289,433,35,34,UCBPlayer
3939,UCBPlayer,91,196,287,0,71,UCBPlayer
3940,UCBPlayer,148,273,421,35,38,UCBPlayer
3941,UCBPlayer,87,212,299,0,67,UCBPlayer
3942,UCBPlayer,152,257,409,35,42,UCBPlayer
3943,UCBPlayer,84,224,308,0,64,UCBPlayer
3944,UCBPlayer,146,251,397,32,45,UCBPlayer
3945,UCBPlayer,89,234,323,3,60,UCBPlayer
3946,UCBPlayer,138,243,381,28,49,UCBPlayer
3947,UCBPlayer,97,242,339,7,56,UCBPlayer
3948,UCBPlayer,130,235,365,24,53,UCBPlayer
3949,UCBPlayer,105,250,355,11,52,UCBPlayer
3950,UCBPlayer,122,227,349,20,57,UCBPlayer
3951,UCBPlayer,109,259,368,15,49,UCBPlayer
3952,UCBPlayer,118,218,336,16,60,UCBPlayer
3953,UCBPlayer,117,267,384,19,45,UCBPlayer
3954,UCBPlayer,110,210,320,12,64,UCBPlayer
3955,UCBPlayer,126,271,397,23,42,UCBPlayer
3956,UCBPlayer,105,210,315,10,65,UCBPlayer
3957,UCBPlayer,130,275,405,25,40,UCBPlayer
3958,UCBPlayer,105,210,315,10,65,UCBPlayer
3959,UCBPlayer,130,275,405,25,40,UCBPlayer
3960,UCBPlayer,106,206,312,10,66,UCBPlayer
3961,UCBPlayer,130,275,405,25,40,UCBPlayer
3962,UCBPlayer,105,210,315,10,65,UCBPlayer
3963,UCBPlayer,131,271,402,25,41,UCBPlayer
3964,UCBPlayer,105,210,315,10,65,UCBPlayer
3965,UCBPlayer,130,275,405,25,40,UCBPlayer
3966,UCBPlayer,105,210,315,10,65,UCBPlayer
3967,UCBPlayer,130,275,405,25,40,UCBPlayer
3968,UCBPlayer,103,203,306,10,68,UCBPlayer
3969,UCBPlayer,128,283,411,25,38,UCBPlayer
3970,UCBPlayer,111,186,297,10,71,UCBPlayer
3971,UCBPlayer,124,299,423,25,34,UCBPlayer
3972,UCBPlayer,115,170,285,10,75,UCBPlayer
3973,UCBPlayer,120,315,435,25,30,UCBPlayer
3974,UCBPlayer,119,154,273,10,79,UCBPlayer
3975,UCBPlayer,112,332,444,25,27,UCBPlayer
3976,UCBPlayer,127,137,264,10,82,UCBPlayer
3977,UCBPlayer,104,349,453,25,24,UCBPlayer
3978,UCBPlayer,126,126,252,7,85,Tie
3979,UCBPlayer,111,351,462,28,22,UCBPlayer
3980,UCBPlayer,116,126,242,3,87,UCBPlayer
3981,UCBPlayer,122,347,469,32,21,UCBPlayer
3982,UCBPlayer,107,132,239,0,87,UCBPlayer
3983,UCBPlayer,132,337,469,35,22,UCBPlayer
3984,UCBPlayer,103,148,251,0,83,UCBPlayer
3985,UCBPlayer,136,321,457,35,26,UCBPlayer
3986,UCBPlayer,99,164,263,0,79,UCBPlayer
3987,UCBPlayer,140,305,445,35,30,UCBPlayer
3988,UCBPlayer,95,180,275,0,75,UCBPlayer
3989,UCBPlayer,144,289,433,35,34,UCBPlayer
3990,UCBPlayer,91,196,287,0,71,UCBPlayer
3991,UCBPlayer,148,273,421,35,38,UCBPlayer
3992,UCBPlayer,87,212,299,0,67,UCBPlayer
3993,UCBPlayer,152,257,409,35,42,UCBPlayer
3994,UCBPlayer,84,224,308,0,64,UCBPlayer
3995,UCBPlayer,146,251,397,32,45,UCBPlayer
3996,UCBPlayer,89,234,323,3,60,UCBPlayer
3997,UCBPlayer,138,243,381,28,49,UCBPlayer
3998,UCBPlayer,97,242,339,7,56,UCBPlayer
3999,UCBPlayer,130,235,365,24,53,UCBPlayer
4000,UCBPlayer,105,250,355,11,52,UCBPlayer
4001,UCBPlayer,122,227,349,20,57,UCBPlayer
4002,UCBPlayer,109,259,368,15,49,UCBPlayer
4003,UCBPlayer,118,218,336,16,60,UCBPlayer
4004,UCBPlayer,117,267,384,19,45,UCBPlayer
4005,UCBPlayer,110,210,320,12,64,UCBPlayer
4006,UCBPlayer,126,271,397,23,42,UCBPlayer
4007,UCBPlayer,105,210,315,10,65,UCBPlayer
4008,UCBPlayer,130,275,405,25,40,UCBPlayer
4009,UCBPlayer,105,210,315,10,65,UCBPlayer
4010,UCBPlayer,130,275,405,25,40,UCBPlayer
4011,UCBPlayer,106,206,312,10,66,UCBPlayer
4012,UCBPlayer,130,275,405,25,40,UCBPlayer
4013,UCBPlayer,105,210,315,10,65,UCBPlayer
4014,UCBPlayer,131,271,402,25,41,UCBPlayer
4015,UCBPlayer,105,210,315,10,65,UCBPlayer
4016,UCBPlayer,130,275,405,25,40,UCBPlayer
4017,UCBPlayer,105,210,315,10,65,UCBPlayer
4018,UCBPlayer,130,275,405,25,40,UCBPlayer
4019,UCBPlayer,103,203,306,10,68,UCBPlayer
4020,UCBPlayer,128,283,411,25,38,UCBPlayer
4021,UCBPlayer,111,186,297,10,71,UCBPlayer
4022,UCBPlayer,124,299,423,25,34,UCBPlayer
4023,UCBPlayer,115,170,285,10,75,UCBPlayer
4024,UCBPlayer,120,315,435,25,30,UCBPlayer
4025,UCBPlayer,119,154,273,10,79,UCBPlayer
4026,UCBPlayer,112,332,444,25,27,UCBPlayer
4027,UCBPlayer,127,137,264,10,82,UCBPlayer
4028,UCBPlayer,104,349,453,25,24,UCBPlayer
4029,UCBPlayer,126,126,252,7,85,Tie
4030,UCBPlayer,111,351,462,28,22,UCBPlayer
4031,UCBPlayer,116,126,242,3,87,UCBPlayer
4032,UCBPlayer,122,347,469,32,21,UCBPlayer
4033,UCBPlayer,107,132,239,0,87,UCBPlayer
4034,UCBPlayer,132,337,469,35,22,UCBPlayer
4035,UCBPlayer,103,148,251,0,83,UCBPlayer
4036,UCBPlayer,136,321,457,35,26,UCBPlayer
4037,UCBPlayer,99,164,263,0,79,UCBPlayer
4038,UCBPlayer,140,305,445,35,30,UCBPlayer
4039,UCBPlayer,95,180,275,0,75,UCBPlayer
4040,UCBPlayer,144,289,433,35,34,UCBPlayer
4041,UCBPlayer,91,196,287,0,71,UCBPlayer
4042,UCBPlayer,148,273,421,35,38,UCBPlayer
4043,UCBPlayer,87,212,299,0,67,UCBPlayer
4044,UCBPlayer,152,257,409,35,42,UCBPlayer
4045,UCBPlayer,84,224,308,0,64,UCBPlayer
4046,UCBPlayer,146,251,397,32,45,UCBPlayer
4047,UCBPlayer,89,234,323,3,60,UCBPlayer
4048,UCBPlayer,138,243,381,28,49,UCBPlayer
4049,UCBPlayer,97,242,339,7,56,UCBPlayer
4050,UCBPlayer,130,235,365,24,53,UCBPlayer
4051,UCBPlayer,105,250,355,11,52,UCBPlayer
4052,UCBPlayer,122,227,349,20,57,UCBPlayer
4053,UCBPlayer,109,259,368,15,49,UCBPlayer
4054,UCBPlayer,118,218,336,16,60,UCBPlayer
4055,UCBPlayer,117,267,384,19,45,UCBPlayer
4056,UCBPlayer,110,210,320,12,64,UCBPlayer
4057,UCBPlayer,126,271,397,23,42,UCBPlayer
4058,UCBPlayer,105,210,315,10,65,UCBPlayer
4059,UCBPlayer,130,275,405,25,40,UCBPlayer
4060,UCBPlayer,105,210,315,10,65,UCBPlayer
4061,UCBPlayer,130,275,405,25,40,UCBPlayer
4062,UCBPlayer,106,206,312,10,66,UCBPlayer
4063,UCBPlayer,130,275,405,25,40,UCBPlayer
4064,UCBPlayer,105,210,315,10,65,UCBPlayer
4065,UCBPlayer,131,271,402,25,41,UCBPlayer
4066,UCBPlayer,105,210,315,10,65,UCBPlayer
4067,UCBPlayer,130,275,405,25,40,UCBPlayer
4068,UCBPlayer,105,210,315,10,65,UCBPlayer
4069,UCBPlayer,130,275,405,25,40,UCBPlayer
4070,UCBPlayer,103,203,306,10,68,UCBPlayer
4071,UCBPlayer,128,283,411,25,38,UCBPlayer
4072,UCBPlayer,111,186,297,10,71,UCBPlayer
4073,UCBPlayer,124,299,423,25,34,UCBPlayer
4074,UCBPlayer,115,170,285,10,75,UCBPlayer
4075,UCBPlayer,120,315,435,25,30,UCBPlayer
4076,UCBPlayer,119,154,273,10,79,UCBPlayer
4077,UCBPlayer,112,332,444,25,27,UCBPlayer
4078,UCBPlayer,127,137,264,10,82,UCBPlayer
4079,UCBPlayer,104,349,453,25,24,UCBPlayer
4080,UCBPlayer,126,126,252,7,85,Tie
4081,UCBPlayer,111,351,462,28,22,UCBPlayer
4082,UCBPlayer,116,126,242,3,87,UCBPlayer
4083,UCBPlayer,122,347,469,32,21,UCBPlayer
4084,UCBPlayer,107,132,239,0,87,UCBPlayer
4085,UCBPlayer,132,337,469,35,22,UCBPlayer
4086,UCBPlayer,103,148,251,0,83,UCBPlayer
4087,UCBPlayer,136,321,457,35,26,UCBPlayer
4088,UCBPlayer,99,164,263,0,79,UCBPlayer
4089,UCBPlayer,140,305,445,35,30,UCBPlayer
4090,UCBPlayer,95,180,275,0,75,UCBPlayer
4091,UCBPlayer,144,289,433,35,34,UCBPlayer
4092,UCBPlayer,91,196,287,0,71,UCBPlayer
4093,UCBPlayer,148,273,421,35,38,UCBPlayer
4094,UCBPlayer,87,212,299,0,67,UCBPlayer
4095,UCBPlayer,152,257,409,35,42,UCBPlayer
4096,UCBPlayer,84,224,308,0,64,UCBPlayer
4097,UCBPlayer,146,251,397,32,45,UCBPlayer
4098,UCBPlayer,89,234,323,3,60,UCBPlayer
4099,UCBPlayer,138,243,381,28,49,UCBPlayer
4100,UCBPlayer,97,242,339,7,56,UCBPlayer
4101,UCBPlayer,130,235,365,24,53,UCBPlayer
4102,UCBPlayer,105,250,355,11,52,UCBPlayer
4103,UCBPlayer,122,227,349,20,57,UCBPlayer
4104,UCBPlayer,109,259,368,15,49,UCBPlayer
4105,UCBPlayer,118,218,336,16,60,UCBPlayer
4106,UCBPlayer,117,267,384,19,45,UCBPlayer
4107,UCBPlayer,110,210,320,12,64,UCBPlayer
4108,UCBPlayer,126,271,397,23,42,UCBPlayer
4109,UCBPlayer,105,210,315,10,65,UCBPlayer
4110,UCBPlayer,130,275,405,25,40,UCBPlayer
4111,UCBPlayer,105,210,315,10,65,UCBPlayer
4112,UCBPlayer,130,275,405,25,40,UCBPlayer
4113,UCBPlayer,106,206,312,10,66,UCBPlayer
4114,UCBPlayer,130,275,405,25,40,UCBPlayer
4115,UCBPlayer,105,210,315,10,65,UCBPlayer
4116,UCBPlayer,131,271,402,25,41,UCBPlayer
4117,UCBPlayer,105,210,315,10,65,UCBPlayer
4118,UCBPlayer,130,275,405,25,40,UCBPlayer
4119,UCBPlayer,105,210,315,10,65,UCBPlayer
4120,UCBPlayer,130,275,405,25,40,UCBPlayer
4121,UCBPlayer,103,203,306,10,68,UCBPlayer
4122,UCBPlayer,128,283,411,25,38,UCBPlayer
4123,UCBPlayer,111,186,297,10,71,UCBPlayer
4124,UCBPlayer,124,299,423,25,34,UCBPlayer
4125,UCBPlayer,115,170,285,10,75,UCBPlayer
4126,UCBPlayer,120,315,435,25,30,UCBPlayer
4127,UCBPlayer,119,154,273,10,79,UCBPlayer
4128,UCBPlayer,112,332,444,25,27,UCBPlayer
4129,UCBPlayer,127,137,264,10,82,UCBPlayer
4130,UCBPlayer,104,349,453,25,24,UCBPlayer
4131,UCBPlayer,126,126,252,7,85,Tie
4132,UCBPlayer,111,351,462,28,22,UCBPlayer
4133,UCBPlayer,116,126,242,3,87,UCBPlayer
4134,UCBPlayer,122,347,469,32,21,UCBPlayer
4135,UCBPlayer,107,132,239,0,87,UCBPlayer
4136,UCBPlayer,132,337,469,35,22,UCBPlayer
4137,UCBPlayer,103,148,251,0,83,UCBPlayer
4138,UCBPlayer,136,321,457,35,26,UCBPlayer
4139,UCBPlayer,99,164,263,0,79,UCBPlayer
4140,UCBPlayer,140,305,445,35,30,UCBPlayer
4141,UCBPlayer,95,180,275,0,75,UCBPlayer
4142,UCBPlayer,144,289,433,35,34,UCBPlayer
4143,UCBPlayer,91,196,287,0,71,UCBPlayer
4144,UCBPlayer,148,273,421,35,38,UCBPlayer
4145,UCBPlayer,87,212,299,0,67,UCBPlayer
4146,UCBPlayer,152,257,409,35,42,UCBPlayer
4147,UCBPlayer,84,224,308,0,64,UCBPlayer
4148,UCBPlayer,146,251,397,32,45,UCBPlayer
4149,UCBPlayer,89,234,323,3,60,UCBPlayer
4150,UCBPlayer,138,243,381,28,49,UCBPlayer
4151,UCBPlayer,97,242,339,7,56,UCBPlayer
4152,UCBPlayer,130,235,365,24,53,UCBPlayer
4153,UCBPlayer,105,250,355,11,52,UCBPlayer
4154,UCBPlayer,122,227,349,20,57,UCBPlayer
4155,UCBPlayer,109,259,368,15,49,UCBPlayer
4156,UCBPlayer,118,218,336,16,60,UCBPlayer
4157,UCBPlayer,117,267,384,19,45,UCBPlayer
4158,UCBPlayer,110,210,320,12,64,UCBPlayer
4159,UCBPlayer,126,271,397,23,42,UCBPlayer
4160,UCBPlayer,105,210,315,10,65,UCBPlayer
4161,UCBPlayer,130,275,405,25,40,UCBPlayer
4162,UCBPlayer,105,210,315,10,65,UCBPlayer
4163,UCBPlayer,130,275,405,25,40,UCBPlayer
4164,UCBPlayer,106,206,312,10,66,UCBPlayer
4165,UCBPlayer,130,275,405,25,40,UCBPlayer
4166,UCBPlayer,105,210,315,10,65,UCBPlayer
4167,UCBPlayer,131,271,402,25,41,UCBPlayer
4168,UCBPlayer,105,210,315,10,65,UCBPlayer
4169,UCBPlayer,130,275,405,25,40,UCBPlayer
4170,UCBPlayer,105,210,315,10,65,UCBPlayer
4171,UCBPlayer,130,275,405,25,40,UCBPlayer
4172,UCBPlayer,103,203,306,10,68,UCBPlayer
4173,UCBPlayer,128,283,411,25,38,UCBPlayer
4174,UCBPlayer,111,186,297,10,71,UCBPlayer
4175,UCBPlayer,124,299,423,25,34,UCBPlayer
4176,UCBPlayer,115,170,285,10,75,UCBPlayer
4177,UCBPlayer,120,315,435,25,30,UCBPlayer
4178,UCBPlayer,119,154,273,10,79,UCBPlayer
4179,UCBPlayer,112,332,444,25,27,UCBPlayer
4180,UCBPlayer,127,137,264,10,82,UCBPlayer
4181,UCBPlayer,104,349,453,25,24,UCBPlayer
4182,UCBPlayer,126,126,252,7,85,Tie
4183,UCBPlayer,111,351,462,28,22,UCBPlayer
4184,UCBPlayer,116,126,242,3,87,UCBPlayer
4185,UCBPlayer,122,347,469,32,21,UCBPlayer
4186,UCBPlayer,107,132,239,0,87,UCBPlayer
4187,UCBPlayer,132,337,469,35,22,UCBPlayer
4188,UCBPlayer,103,148,251,0,83,UCBPlayer
4189,UCBPlayer,136,321,457,35,26,UCBPlayer
4190,UCBPlayer,99,164,263,0,79,UCBPlayer
4191,UCBPlayer,140,305,445,35,30,UCBPlayer
4192,UCBPlayer,95,180,275,0,75,UCBPlayer
4193,UCBPlayer,144,289,433,35,34,UCBPlayer
4194,UCBPlayer,91,196,287,0,71,UCBPlayer
4195,UCBPlayer,148,273,421,35,38,UCBPlayer
4196,UCBPlayer,87,212,299,0,67,UCBPlayer
4197,UCBPlayer,152,257,409,35,42,UCBPlayer
4198,UCBPlayer,84,224,308,0,64,UCBPlayer
4199,UCBPlayer,146,251,397,32,45,UCBPlayer
4200,UCBPlayer,89,234,323,3,60,UCBPlayer
4201,UCBPlayer,138,243,381,28,49,UCBPlayer
4202,UCBPlayer,97,242,339,7,56,UCBPlayer
4203,UCBPlayer,130,235,365,24,53,UCBPlayer
4204,UCBPlayer,105,250,355,11,52,UCBPlayer
4205,UCBPlayer,122,227,349,20,57,UCBPlayer
4206,UCBPlayer,109,259,368,15,49,UCBPlayer
4207,UCBPlayer,118,218,336,16,60,UCBPlayer
4208,UCBPlayer,117,267,384,19,45,UCBPlayer
4209,UCBPlayer,110,210,320,12,64,UCBPlayer
4210,UCBPlayer,126,271,397,23,42,UCBPlayer
4211,UCBPlayer,105,210,315,10,65,UCBPlayer
4212,UCBPlayer,130,275,405,25,40,UCBPlayer
4213,UCBPlayer,105,210,315,10,65,UCBPlayer
4214,UCBPlayer,130,275,405,25,40,UCBPlayer
4215,UCBPlayer,106,206,312,10,66,UCBPlayer
4216,UCBPlayer,130,275,405,25,40,UCBPlayer
4217,UCBPlayer,105,210,315,10,65,UCBPlayer
4218,UCBPlayer,131,271,402,25,41,UCBPlayer
4219,UCBPlayer,105,210,315,10,65,UCBPlayer
4220,UCBPlayer,130,275,405,25,40,UCBPlayer
4221,UCBPlayer,105,210,315,10,65,UCBPlayer
4222,UCBPlayer,130,275,405,25,40,UCBPlayer
4223,UCBPlayer,103,203,306,10,68,UCBPlayer
4224,UCBPlayer,128,283,411,25,38,UCBPlayer
4225,UCBPlayer,111,186,297,10,71,UCBPlayer
4226,UCBPlayer,124,299,423,25,34,UCBPlayer
4227,UCBPlayer,115,170,285,10,75,UCBPlayer
4228,UCBPlayer,120,315,435,25,30,UCBPlayer
4229,UCBPlayer,119,154,273,10,79,UCBPlayer
4230,UCBPlayer,112,332,444,25,27,UCBPlayer
4231,UCBPlayer,127,137,264,10,82,UCBPlayer
4232,UCBPlayer,104,349,453,25,24,UCBPlayer
4233,UCBPlayer,126,126,252,7,85,Tie
4234,UCBPlayer,111,351,462,28,22,UCBPlayer
4235,UCBPlayer,116,126,242,3,87,UCBPlayer
4236,UCBPlayer,122,347,469,32,21,UCBPlayer
4237,UCBPlayer,107,132,239,0,87,UCBPlayer
4238,UCBPlayer,132,337,469,35,22,UCBPlayer
4239,UCBPlayer,103,148,251,0,83,UCBPlayer
4240,UCBPlayer,136,321,457,35,26,UCBPlayer
4241,UCBPlayer,99,164,263,0,79,UCBPlayer
4242,UCBPlayer,140,305,445,35,30,UCBPlayer
4243,UCBPlayer,95,180,275,0,75,UCBPlayer
4244,UCBPlayer,144,289,433,35,34,UCBPlayer
4245,UCBPlayer,91,196,287,0,71,UCBPlayer
4246,UCBPlayer,148,273,421,35,38,UCBPlayer
4247,UCBPlayer,87,212,299,0,67,UCBPlayer
4248,UCBPlayer,152,257,409,35,42,UCBPlayer
4249,UCBPlayer,84,224,308,0,64,UCBPlayer
4250,UCBPlayer,146,251,397,32,45,UCBPlayer
4251,UCBPlayer,89,234,323,3,60,UCBPlayer
4252,UCBPlayer,138,243,381,28,49,UCBPlayer
4253,UCBPlayer,97,242,339,7,56,UCBPlayer
4254,UCBPlayer,130,235,365,24,53,UCBPlayer
4255,UCBPlayer,105,250,355,11,52,UCBPlayer
4256,UCBPlayer,122,227,349,20,57,UCBPlayer
4257,UCBPlayer,109,259,368,15,49,UCBPlayer
4258,UCBPlayer,118,218,336,16,60,UCBPlayer
4259,UCBPlayer,117,267,384,19,45,UCBPlayer
4260,UCBPlayer,110,210,320,12,64,UCBPlayer
4261,UCBPlayer,126,271,397,23,42,UCBPlayer
4262,UCBPlayer,105,210,315,10,65,UCBPlayer
4263,UCBPlayer,130,275,405,25,40,UCBPlayer
4264,UCBPlayer,105,210,315,10,65,UCBPlayer
4265,UCBPlayer,130,275,405,25,40,UCBPlayer
4266,UCBPlayer,106,206,312,10,66,UCBPlayer
4267,UCBPlayer,130,275,405,25,40,UCBPlayer
4268,UCBPlayer,105,210,315,10,65,UCBPlayer
4269,UCBPlayer,131,271,402,25,41,UCBPlayer
4270,UCBPlayer,105,210,315,10,65,UCBPlayer
4271,UCBPlayer,130,275,405,25,40,UCBPlayer
4272,UCBPlayer,105,210,315,10,65,UCBPlayer
4273,UCBPlayer,130,275,405,25,40,UCBPlayer
4274,UCBPlayer,103,203,306,10,68,UCBPlayer
4275,UCBPlayer,128,283,411,25,38,UCBPlayer
4276,UCBPlayer,111,186,297,10,71,UCBPlayer
4277,UCBPlayer,124,299,423,25,34,UCBPlayer
4278,UCBPlayer,115,170,285,10,75,UCBPlayer
4279,UCBPlayer,120,315,435,25,30,UCBPlayer
4280,UCBPlayer,119,154,273,10,79,UCBPlayer
4281,UCBPlayer,112,332,444,25,27,UCBPlayer
4282,UCBPlayer,127,137,264,10,82,UCBPlayer
4283,UCBPlayer,104,349,453,25,24,UCBPlayer
4284,UCBPlayer,126,126,252,7,85,Tie
4285,UCBPlayer,111,351,462,28,22,UCBPlayer
4286,UCBPlayer,116,126,242,3,87,UCBPlayer
4287,UCBPlayer,122,347,469,32,21,UCBPlayer
4288,UCBPlayer,107,132,239,0,87,UCBPlayer
4289,UCBPlayer,132,337,469,35,22,UCBPlayer
4290,UCBPlayer,103,148,251,0,83,UCBPlayer
4291,UCBPlayer,136,321,457,35,26,UCBPlayer
4292,UCBPlayer,99,164,263,0,79,UCBPlayer
4293,UCBPlayer,140,305,445,35,30,UCBPlayer
4294,UCBPlayer,95,180,275,0,75,UCBPlayer
4295,UCBPlayer,144,289,433,35,34,UCBPlayer
4296,UCBPlayer,91,196,287,0,71,UCBPlayer
4297,UCBPlayer,148,273,421,35,38,UCBPlayer
4298,UCBPlayer,87,212,299,0,67,UCBPlayer
4299,UCBPlayer,152,257,409,35,42,UCBPlayer
4300,UCBPlayer,84,224,308,0,64,UCBPlayer
4301,UCBPlayer,146,251,397,32,45,UCBPlayer
4302,UCBPlayer,89,234,323,3,60,UCBPlayer
4303,UCBPlayer,138,243,381,28,49,UCBPlayer
4304,UCBPlayer,97,242,339,7,56,UCBPlayer
4305,UCBPlayer,130,235,365,24,53,UCBPlayer
4306,UCBPlayer,105,250,355,11,52,UCBPlayer
4307,UCBPlayer,122,227,349,20,57,UCBPlayer
4308,UCBPlayer,109,259,368,15,49,UCBPlayer
4309,UCBPlayer,118,218,336,16,60,UCBPlayer
4310,UCBPlayer,117,267,384,19,45,UCBPlayer
4311,UCBPlayer,110,210,320,12,64,UCBPlayer
4312,UCBPlayer,126,271,397,23,42,UCBPlayer
4313,UCBPlayer,105,210,315,10,65,UCBPlayer
4314,UCBPlayer,130,275,405,25,40,UCBPlayer
4315,UCBPlayer,105,210,315,10,65,UCBPlayer
4316,UCBPlayer,130,275,405,25,40,UCBPlayer
4317,UCBPlayer,106,206,312,10,66,UCBPlayer
4318,UCBPlayer,130,275,405,25,40,UCBPlayer
4319,UCBPlayer,105,210,315,10,65,UCBPlayer
4320,UCBPlayer,131,271,402,25,41,UCBPlayer
4321,UCBPlayer,105,210,315,10,65,UCBPlayer
4322,UCBPlayer,130,275,405,25,40,UCBPlayer
4323,UCBPlayer,105,210,315,10,65,UCBPlayer
4324,UCBPlayer,130,275,405,25,40,UCBPlayer
4325,UCBPlayer,103,203,306,10,68,UCBPlayer
4326,UCBPlayer,128,283,411,25,38,UCBPlayer
4327,UCBPlayer,111,186,297,10,71,UCBPlayer
4328,UCBPlayer,124,299,423,25,34,UCBPlayer
4329,UCBPlayer,115,170,285,10,75,UCBPlayer
4330,UCBPlayer,120,315,435,25,30,UCBPlayer
4331,UCBPlayer,119,154,273,10,79,UCBPlayer
4332,UCBPlayer,112,332,444,25,27,UCBPlayer
4333,UCBPlayer,127,137,264,10,82,UCBPlayer
4334,UCBPlayer,104,349,453,25,24,UCBPlayer
4335,UCBPlayer,126,126,252,7,85,Tie
4336,UCBPlayer,111,351,462,28,22,UCBPlayer
4337,UCBPlayer,116,126,242,3,87,UCBPlayer
4338,UCBPlayer,122,347,469,32,21,UCBPlayer
4339,UCBPlayer,107,132,239,0,87,UCBPlayer
4340,UCBPlayer,132,337,469,35,22,UCBPlayer
4341,UCBPlayer,103,148,251,0,83,UCBPlayer
4342,UCBPlayer,136,321,457,35,26,UCBPlayer
4343,UCBPlayer,99,164,263,0,79,UCBPlayer
4344,UCBPlayer,140,305,445,35,30,UCBPlayer
4345,UCBPlayer,95,180,275,0,75,UCBPlayer
4346,UCBPlayer,144,289,433,35,34,UCBPlayer
4347,UCBPlayer,91,196,287,0,71,UCBPlayer
4348,UCBPlayer,148,273,421,35,38,UCBPlayer
4349,UCBPlayer,87,212,299,0,67,UCBPlayer
4350,UCBPlayer,152,257,409,35,42,UCBPlayer
4351,UCBPlayer,84,224,308,0,64,UCBPlayer
4352,UCBPlayer,146,251,397,32,45,UCBPlayer
4353,UCBPlayer,89,234,323,3,60,UCBPlayer
4354,UCBPlayer,138,243,381,28,49,UCBPlayer
4355,UCBPlayer,97,242,339,7,56,UCBPlayer
4356,UCBPlayer,130,235,365,24,53,UCBPlayer
4357,UCBPlayer,105,250,355,11,52,UCBPlayer
4358,UCBPlayer,122,227,349,20,57,UCBPlayer
4359,UCBPlayer,109,259,368,15,49,UCBPlayer
4360,UCBPlayer,118,218,336,16,60,UCBPlayer
4361,UCBPlayer,117,267,384,19,45,UCBPlayer
4362,UCBPlayer,110,210,320,12,64,UCBPlayer
4363,UCBPlayer,126,271,397,23,42,UCBPlayer
4364,UCBPlayer,105,210,315,10,65,UCBPlayer
4365,UCBPlayer,130,275,405,25,40,UCBPlayer
4366,UCBPlayer,105,210,315,10,65,UCBPlayer
4367,UCBPlayer,130,275,405,25,40,UCBPlayer
4368,UCBPlayer,106,206,312,10,66,UCBPlayer
4369,UCBPlayer,130,275,405,25,40,UCBPlayer
4370,UCBPlayer,105,210,315,10,65,UCBPlayer
4371,UCBPlayer,131,271,402,25,41,UCBPlayer
4372,UCBPlayer,105,210,315,10,65,UCBPlayer
4373,UCBPlayer,130,275,405,25,40,UCBPlayer
4374,UCBPlayer,105,210,315,10,65,UCBPlayer
4375,UCBPlayer,130,275,405,25,40,UCBPlayer
4376,UCBPlayer,103,203,306,10,68,UCBPlayer
4377,UCBPlayer,128,283,411,25,38,UCBPlayer
4378,UCBPlayer,111,186,297,10,71,UCBPlayer
4379,UCBPlayer,124,299,423,25,34,UCBPlayer
4380,UCBPlayer,115,170,285,10,75,UCBPlayer
4381,UCBPlayer,120,315,435,25,30,UCBPlayer
4382,UCBPlayer,119,154,273,10,79,UCBPlayer
4383,UCBPlayer,112,332,444,25,27,UCBPlayer
4384,UCBPlayer,127,137,264,10,82,UCBPlayer
4385,UCBPlayer,104,349,453,25,24,UCBPlayer
4386,UCBPlayer,126,126,252,7,85,Tie
4387,UCBPlayer,111,351,462,28,22,UCBPlayer
4388,UCBPlayer,116,126,242,3,87,UCBPlayer
4389,UCBPlayer,122,347,469,32,21,UCBPlayer
4390,UCBPlayer,107,132,239,0,87,UCBPlayer
4391,UCBPlayer,132,337,469,35,22,UCBPlayer
4392,UCBPlayer,103,148,251,0,83,UCBPlayer
4393,UCBPlayer,136,321,457,35,26,UCBPlayer
4394,UCBPlayer,99,164,263,0,79,UCBPlayer
4395,UCBPlayer,140,305,445,35,30,UCBPlayer
4396,UCBPlayer,95,180,275,0,75,UCBPlayer
4397,UCBPlayer,144,289,433,35,34,UCBPlayer
4398,UCBPlayer,91,196,287,0,71,UCBPlayer
4399,UCBPlayer,148,273,421,35,38,UCBPlayer
4400,UCBPlayer,87,212,299,0,67,UCBPlayer
4401,UCBPlayer,152,257,409,35,42,UCBPlayer
4402,UCBPlayer,84,224,308,0,64,UCBPlayer
4403,UCBPlayer,146,251,397,32,45,UCBPlayer
4404,UCBPlayer,89,234,323,3,60,UCBPlayer
4405,UCBPlayer,138,243,381,28,49,UCBPlayer
4406,UCBPlayer,97,242,339,7,56,UCBPlayer
4407,UCBPlayer,130,235,365,24,53,UCBPlayer
4408,UCBPlayer,105,250,355,11,52,UCBPlayer
4409,UCBPlayer,122,227,349,20,57,UCBPlayer
4410,UCBPlayer,109,259,368,15,49,UCBPlayer
4411,UCBPlayer,118,218,336,16,60,UCBPlayer
4412,UCBPlayer,117,267,384,19,45,UCBPlayer
4413,UCBPlayer,110,210,320,12,64,UCBPlayer
4414,UCBPlayer,126,271,397,23,42,UCBPlayer
4415,UCBPlayer,105,210,315,10,65,UCBPlayer
4416,UCBPlayer,130,275,405,25,40,UCBPlayer
4417,UCBPlayer,105,210,315,10,65,UCBPlayer
4418,UCBPlayer,130,275,405,25,40,UCBPlayer
4419,UCBPlayer,106,206,312,10,66,UCBPlayer
4420,UCBPlayer,130,275,405,25,40,UCBPlayer
4421,UCBPlayer,105,210,315,10,65,UCBPlayer
4422,UCBPlayer,131,271,402,25,41,UCBPlayer
4423,UCBPlayer,105,210,315,10,65,UCBPlayer
4424,UCBPlayer,130,275,405,25,40,UCBPlayer
4425,UCBPlayer,105,210,315,10,65,UCBPlayer
4426,UCBPlayer,130,275,405,25,40,UCBPlayer
4427,UCBPlayer,103,203,306,10,68,UCBPlayer
4428,UCBPlayer,128,283,411,25,38,UCBPlayer
4429,UCBPlayer,111,186,297,10,71,UCBPlayer
4430,UCBPlayer,124,299,423,25,34,UCBPlayer
4431,UCBPlayer,115,170,285,10,75,UCBPlayer
4432,UCBPlayer,120,315,435,25,30,UCBPlayer
4433,UCBPlayer,119,154,273,10,79,UCBPlayer
4434,UCBPlayer,112,332,444,25,27,UCBPlayer
4435,UCBPlayer,127,137,264,10,82,UCBPlayer
4436,UCBPlayer,104,349,453,25,24,UCBPlayer
4437,UCBPlayer,126,126,252,7,85,Tie
4438,UCBPlayer,111,351,462,28,22,UCBPlayer
4439,UCBPlayer,116,126,242,3,87,UCBPlayer
4440,UCBPlayer,122,347,469,32,21,UCBPlayer
4441,UCBPlayer,107,132,239,0,87,UCBPlayer
4442,UCBPlayer,132,337,469,35,22,UCBPlayer
4443,UCBPlayer,103,148,251,0,83,UCBPlayer
4444,UCBPlayer,136,321,457,35,26,UCBPlayer
4445,UCBPlayer,99,164,263,0,79,UCBPlayer
4446,UCBPlayer,140,305,445,35,30,UCBPlayer
4447,UCBPlayer,95,180,275,0,75,UCBPlayer
4448,UCBPlayer,144,289,433,35,34,UCBPlayer
4449,UCBPlayer,91,196,287,0,71,UCBPlayer
4450,UCBPlayer,148,273,421,35,38,UCBPlayer
4451,UCBPlayer,87,212,299,0,67,UCBPlayer
4452,UCBPlayer,152,257,409,35,42,UCBPlayer
4453,UCBPlayer,84,224,308,0,64,UCBPlayer
4454,UCBPlayer,146,251,397,32,45,UCBPlayer
4455,UCBPlayer,89,234,323,3,60,UCBPlayer
4456,UCBPlayer,138,243,381,28,49,UCBPlayer
4457,UCBPlayer,97,242,339,7,56,UCBPlayer
4458,UCBPlayer,130,235,365,24,53,UCBPlayer
4459,UCBPlayer,105,250,355,11,52,UCBPlayer
4460,UCBPlayer,122,227,349,20,57,UCBPlayer
4461,UCBPlayer,109,259,368,15,49,UCBPlayer
4462,UCBPlayer,118,218,336,16,60,UCBPlayer
4463,UCBPlayer,117,267,384,19,45,UCBPlayer
4464,UCBPlayer,110,210,320,12,64,UCBPlayer
4465,UCBPlayer,126,271,397,23,42,UCBPlayer
4466,UCBPlayer,105,210,315,10,65,UCBPlayer
4467,UCBPlayer,130,275,405,25,40,UCBPlayer
4468,UCBPlayer,105,210,315,10,65,UCBPlayer
4469,UCBPlayer,130,275,405,25,40,UCBPlayer
4470,UCBPlayer,106,206,312,10,66,UCBPlayer
4471,UCBPlayer,130,275,405,25,40,UCBPlayer
4472,UCBPlayer,105,210,315,10,65,UCBPlayer
4473,UCBPlayer,131,271,402,25,41,UCBPlayer
4474,UCBPlayer,105,210,315,10,65,UCBPlayer
4475,UCBPlayer,130,275,405,25,40,UCBPlayer
4476,UCBPlayer,105,210,315,10,65,UCBPlayer
4477,UCBPlayer,130,275,405,25,40,UCBPlayer
4478,UCBPlayer,103,203,306,10,68,UCBPlayer
4479,UCBPlayer,128,283,411,25,38,UCBPlayer
4480,UCBPlayer,111,186,297,10,71,UCBPlayer
4481,UCBPlayer,124,299,423,25,34,UCBPlayer
4482,UCBPlayer,115,170,285,10,75,UCBPlayer
4483,UCBPlayer,120,315,435,25,30,UCBPlayer
4484,UCBPlayer,119,154,273,10,79,UCBPlayer
4485,UCBPlayer,112,332,444,25,27,UCBPlayer
4486,UCBPlayer,127,137,264,10,82,UCBPlayer
4487,UCBPlayer,104,349,453,25,24,UCBPlayer
4488,UCBPlayer,126,126,252,7,85,Tie
4489,UCBPlayer,111,351,462,28,22,UCBPlayer
4490,UCBPlayer,116,126,242,3,87,UCBPlayer
4491,UCBPlayer,122,347,469,32,21,UCBPlayer
4492,UCBPlayer,107,132,239,0,87,UCBPlayer
4493,UCBPlayer,132,337,469,35,22,UCBPlayer
4494,UCBPlayer,103,148,251,0,83,UCBPlayer
4495,UCBPlayer,136,321,457,35,26,UCBPlayer
4496,UCBPlayer,99,164,263,0,79,UCBPlayer
4497,UCBPlayer,140,305,445,35,30,UCBPlayer
4498,UCBPlayer,95,180,275,0,75,UCBPlayer
4499,UCBPlayer,144,289,433,35,34,UCBPlayer
4500,UCBPlayer,91,196,287,0,71,UCBPlayer
4501,UCBPlayer,148,273,421,35,38,UCBPlayer
4502,UCBPlayer,87,212,299,0,67,UCBPlayer
4503,UCBPlayer,152,257,409,35,42,UCBPlayer
4504,UCBPlayer,84,224,308,0,64,UCBPlayer
4505,UCBPlayer,146,251,397,32,45,UCBPlayer
4506,UCBPlayer,89,234,323,3,60,UCBPlayer
4507,UCBPlayer,138,243,381,28,49,UCBPlayer
4508,UCBPlayer,97,242,339,7,56,UCBPlayer
4509,UCBPlayer,130,235,365,24,53,UCBPlayer
4510,UCBPlayer,105,250,355,11,52,UCBPlayer
4511,UCBPlayer,122,227,349,20,57,UCBPlayer
4512,UCBPlayer,109,259,368,15,49,UCBPlayer
4513,UCBPlayer,118,218,336,16,60,UCBPlayer
4514,UCBPlayer,117,267,384,19,45,UCBPlayer
4515,UCBPlayer,110,210,320,12,64,UCBPlayer
4516,UCBPlayer,126,271,397,23,42,UCBPlayer
4517,UCBPlayer,105,210,315,10,65,UCBPlayer
4518,UCBPlayer,130,275,405,25,40,UCBPlayer
4519,UCBPlayer,105,210,315,10,65,UCBPlayer
4520,UCBPlayer,130,275,405,25,40,UCBPlayer
4521,UCBPlayer,106,206,312,10,66,UCBPlayer
4522,UCBPlayer,130,275,405,25,40,UCBPlayer
4523,UCBPlayer,105,210,315,10,65,UCBPlayer
4524,UCBPlayer,131,271,402,25,41,UCBPlayer
4525,UCBPlayer,105,210,315,10,65,UCBPlayer
4526,UCBPlayer,130,275,405,25,40,UCBPlayer
4527,UCBPlayer,105,210,315,10,65,UCBPlayer
4528,UCBPlayer,130,275,405,25,40,UCBPlayer
4529,UCBPlayer,103,203,306,10,68,UCBPlayer
4530,UCBPlayer,128,283,411,25,38,UCBPlayer
4531,UCBPlayer,111,186,297,10,71,UCBPlayer
4532,UCBPlayer,124,299,423,25,34,UCBPlayer
4533,UCBPlayer,115,170,285,10,75,UCBPlayer
4534,UCBPlayer,120,315,435,25,30,UCBPlayer
4535,UCBPlayer,119,154,273,10,79,UCBPlayer
4536,UCBPlayer,112,332,444,25,27,UCBPlayer
4537,UCBPlayer,127,137,264,10,82,UCBPlayer
4538,UCBPlayer,104,349,453,25,24,UCBPlayer
4539,UCBPlayer,126,126,252,7,85,Tie
4540,UCBPlayer,111,351,462,28,22,UCBPlayer
4541,UCBPlayer,116,126,242,3,87,UCBPlayer
4542,UCBPlayer,122,347,469,32,21,UCBPlayer
4543,UCBPlayer,107,132,239,0,87,UCBPlayer
4544,UCBPlayer,132,337,469,35,22,UCBPlayer
4545,UCBPlayer,103,148,251,0,83,UCBPlayer
4546,UCBPlayer,136,321,457,35,26,UCBPlayer
4547,UCBPlayer,99,164,263,0,79,UCBPlayer
4548,UCBPlayer,140,305,445,35,30,UCBPlayer
4549,UCBPlayer,95,180,275,0,75,UCBPlayer
4550,UCBPlayer,144,289,433,35,34,UCBPlayer
4551,UCBPlayer,91,196,287,0,71,UCBPlayer
4552,UCBPlayer,148,273,421,35,38,UCBPlayer
4553,UCBPlayer,87,212,299,0,67,UCBPlayer
4554,UCBPlayer,152,257,409,35,42,UCBPlayer
4555,UCBPlayer,84,224,308,0,64,UCBPlayer
4556,UCBPlayer,146,251,397,32,45,UCBPlayer
4557,UCBPlayer,89,234,323,3,60,UCBPlayer
4558,UCBPlayer,138,243,381,28,49,UCBPlayer
4559,UCBPlayer,97,242,339,7,56,UCBPlayer
4560,UCBPlayer,130,235,365,24,53,UCBPlayer
4561,UCBPlayer,105,250,355,11,52,UCBPlayer
4562,UCBPlayer,122,227,349,20,57,UCBPlayer
4563,UCBPlayer,109,259,368,15,49,UCBPlayer
4564,UCBPlayer,118,218,336,16,60,UCBPlayer
4565,UCBPlayer,117,267,384,19,45,UCBPlayer
4566,UCBPlayer,110,210,320,12,64,UCBPlayer
4567,UCBPlayer,126,271,397,23,42,UCBPlayer
4568,UCBPlayer,105,210,315,10,65,UCBPlayer
4569,UCBPlayer,130,275,405,25,40,UCBPlayer
4570,UCBPlayer,105,210,315,10,65,UCBPlayer
4571,UCBPlayer,130,275,405,25,40,UCBPlayer
4572,UCBPlayer,106,206,312,10,66,UCBPlayer
4573,UCBPlayer,130,275,405,25,40,UCBPlayer
4574,UCBPlayer,105,210,315,10,65,UCBPlayer
4575,UCBPlayer,131,271,402,25,41,UCBPlayer
4576,UCBPlayer,105,210,315,10,65,UCBPlayer
4577,UCBPlayer,130,275,405,25,40,UCBPlayer
4578,UCBPlayer,105,210,315,10,65,UCBPlayer
4579,UCBPlayer,130,275,405,25,40,UCBPlayer
4580,UCBPlayer,103,203,306,10,68,UCBPlayer
4581,UCBPlayer,128,283,411,25,38,UCBPlayer
4582,UCBPlayer,111,186,297,10,71,UCBPlayer
4583,UCBPlayer,124,299,423,25,34,UCBPlayer
4584,UCBPlayer,115,170,285,10,75,UCBPlayer
4585,UCBPlayer,120,315,435,25,30,UCBPlayer
4586,UCBPlayer,119,154,273,10,79,UCBPlayer
4587,UCBPlayer,112,332,444,25,27,UCBPlayer
4588,UCBPlayer,127,137,264,10,82,UCBPlayer
4589,UCBPlayer,104,349,453,25,24,UCBPlayer
4590,UCBPlayer,126,126,252,7,85,Tie
4591,UCBPlayer,111,351,462,28,22,UCBPlayer
4592,UCBPlayer,116,126,242,3,87,UCBPlayer
4593,UCBPlayer,122,347,469,32,21,UCBPlayer
4594,UCBPlayer,107,132,239,0,87,UCBPlayer
4595,UCBPlayer,132,337,469,35,22,UCBPlayer
4596,UCBPlayer,103,148,251,0,83,UCBPlayer
4597,UCBPlayer,136,321,457,35,26,UCBPlayer
4598,UCBPlayer,99,164,263,0,79,UCBPlayer
4599,UCBPlayer,140,305,445,35,30,UCBPlayer
4600,UCBPlayer,95,180,275,0,75,UCBPlayer
4601,UCBPlayer,144,289,433,35,34,UCBPlayer
4602,UCBPlayer,91,196,287,0,71,UCBPlayer
4603,UCBPlayer,148,273,421,35,38,UCBPlayer
4604,UCBPlayer,87,212,299,0,67,UCBPlayer
4605,UCBPlayer,152,257,409,35,42,UCBPlayer
4606,UCBPlayer,84,224,308,0,64,UCBPlayer
4607,UCBPlayer,146,251,397,32,45,UCBPlayer
4608,UCBPlayer,89,234,323,3,60,UCBPlayer
4609,UCBPlayer,138,243,381,28,49,UCBPlayer
4610,UCBPlayer,97,242,339,7,56,UCBPlayer
4611,UCBPlayer,130,235,365,24,53,UCBPlayer
4612,UCBPlayer,105,250,355,11,52,UCBPlayer
4613,UCBPlayer,122,227,349,20,57,UCBPlayer
4614,UCBPlayer,109,259,368,15,49,UCBPlayer
4615,UCBPlayer,118,218,336,16,60,UCBPlayer
4616,UCBPlayer,117,267,384,19,45,UCBPlayer
4617,UCBPlayer,110,210,320,12,64,UCBPlayer
4618,UCBPlayer,126,271,397,23,42,UCBPlayer
4619,UCBPlayer,105,210,315,10,65,UCBPlayer
4620,UCBPlayer,130,275,405,25,40,UCBPlayer
4621,UCBPlayer,105,210,315,10,65,UCBPlayer
4622,UCBPlayer,130,275,405,25,40,UCBPlayer
4623,UCBPlayer,106,206,312,10,66,UCBPlayer
4624,UCBPlayer,130,275,405,25,40,UCBPlayer
4625,UCBPlayer,105,210,315,10,65,UCBPlayer
4626,UCBPlayer,131,271,402,25,41,UCBPlayer
4627,UCBPlayer,105,210,315,10,65,UCBPlayer
4628,UCBPlayer,130,275,405,25,40,UCBPlayer
4629,UCBPlayer,105,210,315,10,65,UCBPlayer
4630,UCBPlayer,130,275,405,25,40,UCBPlayer
4631,UCBPlayer,103,203,306,10,68,UCBPlayer
4632,UCBPlayer,128,283,411,25,38,UCBPlayer
4633,UCBPlayer,111,186,297,10,71,UCBPlayer
4634,UCBPlayer,124,299,423,25,34,UCBPlayer
4635,UCBPlayer,115,170,285,10,75,UCBPlayer
4636,UCBPlayer,120,315,435,25,30,UCBPlayer
4637,UCBPlayer,119,154,273,10,79,UCBPlayer
4638,UCBPlayer,112,332,444,25,27,UCBPlayer
4639,UCBPlayer,127,137,264,10,82,UCBPlayer
4640,UCBPlayer,104,349,453,25,24,UCBPlayer
4641,UCBPlayer,126,126,252,7,85,Tie
4642,UCBPlayer,111,351,462,28,22,UCBPlayer
4643,UCBPlayer,116,126,242,3,87,UCBPlayer
4644,UCBPlayer,122,347,469,32,21,UCBPlayer
4645,UCBPlayer,107,132,239,0,87,UCBPlayer
4646,UCBPlayer,132,337,469,35,22,UCBPlayer
4647,UCBPlayer,103,148,251,0,83,UCBPlayer
4648,UCBPlayer,136,321,457,35,26,UCBPlayer
4649,UCBPlayer,99,164,263,0,79,UCBPlayer
4650,UCBPlayer,140,305,445,35,30,UCBPlayer
4651,UCBPlayer,95,180,275,0,75,UCBPlayer
4652,UCBPlayer,144,289,433,35,34,UCBPlayer
4653,UCBPlayer,91,196,287,0,71,UCBPlayer
4654,UCBPlayer,148,273,421,35,38,UCBPlayer
4655,UCBPlayer,87,212,299,0,67,UCBPlayer
4656,UCBPlayer,152,257,409,35,42,UCBPlayer
4657,UCBPlayer,84,224,308,0,64,UCBPlayer
4658,UCBPlayer,146,251,397,32,45,UCBPlayer
4659,UCBPlayer,89,234,323,3,60,UCBPlayer
4660,UCBPlayer,138,243,381,28,49,UCBPlayer
4661,UCBPlayer,97,242,339,7,56,UCBPlayer
4662,UCBPlayer,130,235,365,24,53,UCBPlayer
4663,UCBPlayer,105,250,355,11,52,UCBPlayer
4664,UCBPlayer,122,227,349,20,57,UCBPlayer
4665,UCBPlayer,109,259,368,15,49,UCBPlayer
4666,UCBPlayer,118,218,336,16,60,UCBPlayer
4667,UCBPlayer,117,267,384,19,45,UCBPlayer
4668,UCBPlayer,110,210,320,12,64,UCBPlayer
4669,UCBPlayer,126,271,397,23,42,UCBPlayer
4670,UCBPlayer,105,210,315,10,65,UCBPlayer
4671,UCBPlayer,130,275,405,25,40,UCBPlayer
4672,UCBPlayer,105,210,315,10,65,UCBPlayer
4673,UCBPlayer,130,275,405,25,40,UCBPlayer
4674,UCBPlayer,106,206,312,10,66,UCBPlayer
4675,UCBPlayer,130,275,405,25,40,UCBPlayer
4676,UCBPlayer,105,210,315,10,65,UCBPlayer
4677,UCBPlayer,131,271,402,25,41,UCBPlayer
4678,UCBPlayer,105,210,315,10,65,UCBPlayer
4679,UCBPlayer,130,275,405,25,40,UCBPlayer
4680,UCBPlayer,105,210,315,10,65,UCBPlayer
4681,UCBPlayer,130,275,405,25,40,UCBPlayer
4682,UCBPlayer,103,203,306,10,68,UCBPlayer
4683,UCBPlayer,128,283,411,25,38,UCBPlayer
4684,UCBPlayer,111,186,297,10,71,UCBPlayer
4685,UCBPlayer,124,299,423,25,34,UCBPlayer
4686,UCBPlayer,115,170,285,10,75,UCBPlayer
4687,UCBPlayer,120,315,435,25,30,UCBPlayer
4688,UCBPlayer,119,154,273,10,79,UCBPlayer
4689,UCBPlayer,112,332,444,25,27,UCBPlayer
4690,UCBPlayer,127,137,264,10,82,UCBPlayer
4691,UCBPlayer,104,349,453,25,24,UCBPlayer
4692,UCBPlayer,126,126,252,7,85,Tie
4693,UCBPlayer,111,351,462,28,22,UCBPlayer
4694,UCBPlayer,116,126,242,3,87,UCBPlayer
4695,UCBPlayer,122,347,469,32,21,UCBPlayer
4696,UCBPlayer,107,132,239,0,87,UCBPlayer
4697,UCBPlayer,132,337,469,35,22,UCBPlayer
4698,UCBPlayer,103,148,251,0,83,UCBPlayer
4699,UCBPlayer,136,321,457,35,26,UCBPlayer
4700,UCBPlayer,99,164,263,0,79,UCBPlayer
4701,UCBPlayer,140,305,445,35,30,UCBPlayer
4702,UCBPlayer,95,180,275,0,75,UCBPlayer
4703,UCBPlayer,144,289,433,35,34,UCBPlayer
4704,UCBPlayer,91,196,287,0,71,UCBPlayer
4705,UCBPlayer,148,273,421,35,38,UCBPlayer
4706,UCBPlayer,87,212,299,0,67,UCBPlayer
4707,UCBPlayer,152,257,409,35,42,UCBPlayer
4708,UCBPlayer,84,224,308,0,64,UCBPlayer
4709,UCBPlayer,146,251,397,32,45,UCBPlayer
4710,UCBPlayer,89,234,323,3,60,UCBPlayer
4711,UCBPlayer,138,243,381,28,49,UCBPlayer
4712,UCBPlayer,97,242,339,7,56,UCBPlayer
4713,UCBPlayer,130,235,365,24,53,UCBPlayer
4714,UCBPlayer,105,250,355,11,52,UCBPlayer
4715,UCBPlayer,122,227,349,20,57,UCBPlayer
4716,UCBPlayer,109,259,368,15,49,UCBPlayer
4717,UCBPlayer,118,218,336,16,60,UCBPlayer
4718,UCBPlayer,117,267,384,19,45,UCBPlayer
4719,UCBPlayer,110,210,320,12,64,UCBPlayer
4720,UCBPlayer,126,271,397,23,42,UCBPlayer
4721,UCBPlayer,105,210,315,10,65,UCBPlayer
4722,UCBPlayer,130,275,405,25,40,UCBPlayer
4723,UCBPlayer,105,210,315,10,65,UCBPlayer
4724,UCBPlayer,130,275,405,25,40,UCBPlayer
4725,UCBPlayer,106,206,312,10,66,UCBPlayer
4726,UCBPlayer,130,275,405,25,40,UCBPlayer
4727,UCBPlayer,105,210,315,10,65,UCBPlayer
4728,UCBPlayer,131,271,402,25,41,UCBPlayer
4729,UCBPlayer,105,210,315,10,65,UCBPlayer
4730,UCBPlayer,130,275,405,25,40,UCBPlayer
4731,UCBPlayer,105,210,315,10,65,UCBPlayer
4732,UCBPlayer,130,275,405,25,40,UCBPlayer
4733,UCBPlayer,103,203,306,10,68,UCBPlayer
4734,UCBPlayer,128,283,411,25,38,UCBPlayer
4735,UCBPlayer,111,186,297,10,71,UCBPlayer
4736,UCBPlayer,124,299,423,25,34,UCBPlayer
4737,UCBPlayer,115,170,285,10,75,UCBPlayer
4738,UCBPlayer,120,315,435,25,30,UCBPlayer
4739,UCBPlayer,119,154,273,10,79,UCBPlayer
4740,UCBPlayer,112,332,444,25,27,UCBPlayer
4741,UCBPlayer,127,137,264,10,82,UCBPlayer
4742,UCBPlayer,104,349,453,25,24,UCBPlayer
4743,UCBPlayer,126,126,252,7,85,Tie
4744,UCBPlayer,111,351,462,28,22,UCBPlayer
4745,UCBPlayer,116,126,242,3,87,UCBPlayer
4746,UCBPlayer,122,347,469,32,21,UCBPlayer
4747,UCBPlayer,107,132,239,0,87,UCBPlayer
4748,UCBPlayer,132,337,469,35,22,UCBPlayer
4749,UCBPlayer,103,148,251,0,83,UCBPlayer
4750,UCBPlayer,136,321,457,35,26,UCBPlayer
4751,UCBPlayer,99,164,263,0,79,UCBPlayer
4752,UCBPlayer,140,305,445,35,30,UCBPlayer
4753,UCBPlayer,95,180,275,0,75,UCBPlayer
4754,UCBPlayer,144,289,433,35,34,UCBPlayer
4755,UCBPlayer,91,196,287,0,71,UCBPlayer
4756,UCBPlayer,148,273,421,35,38,UCBPlayer
4757,UCBPlayer,87,212,299,0,67,UCBPlayer
4758,UCBPlayer,152,257,409,35,42,UCBPlayer
4759,UCBPlayer,84,224,308,0,64,UCBPlayer
4760,UCBPlayer,146,251,397,32,45,UCBPlayer
4761,UCBPlayer,89,234,323,3,60,UCBPlayer
4762,UCBPlayer,138,243,381,28,49,UCBPlayer
4763,UCBPlayer,97,242,339,7,56,UCBPlayer
4764,UCBPlayer,130,235,365,24,53,UCBPlayer
4765,UCBPlayer,105,250,355,11,52,UCBPlayer
4766,UCBPlayer,122,227,349,20,57,UCBPlayer
4767,UCBPlayer,109,259,368,15,49,UCBPlayer
4768,UCBPlayer,118,218,336,16,60,UCBPlayer
4769,UCBPlayer,117,267,384,19,45,UCBPlayer
4770,UCBPlayer,110,210,320,12,64,UCBPlayer
4771,UCBPlayer,126,271,397,23,42,UCBPlayer
4772,UCBPlayer,105,210,315,10,65,UCBPlayer
4773,UCBPlayer,130,275,405,25,40,UCBPlayer
4774,UCBPlayer,105,210,315,10,65,UCBPlayer
4775,UCBPlayer,130,275,405,25,40,UCBPlayer
4776,UCBPlayer,106,206,312,10,66,UCBPlayer
4777,UCBPlayer,130,275,405,25,40,UCBPlayer
4778,UCBPlayer,105,210,315,10,65,UCBPlayer
4779,UCBPlayer,131,271,402,25,41,UCBPlayer
4780,UCBPlayer,105,210,315,10,65,UCBPlayer
4781,UCBPlayer,130,275,405,25,40,UCBPlayer
4782,UCBPlayer,105,210,315,10,65,UCBPlayer
4783,UCBPlayer,130,275,405,25,40,UCBPlayer
4784,UCBPlayer,103,203,306,10,68,UCBPlayer
4785,UCBPlayer,128,283,411,25,38,UCBPlayer
4786,UCBPlayer,111,186,297,10,71,UCBPlayer
4787,UCBPlayer,124,299,423,25,34,UCBPlayer
4788,UCBPlayer,115,170,285,10,75,UCBPlayer
4789,UCBPlayer,120,315,435,25,30,UCBPlayer
4790,UCBPlayer,119,154,273,10,79,UCBPlayer
4791,UCBPlayer,112,332,444,25,27,UCBPlayer
4792,UCBPlayer,127,137,264,10,82,UCBPlayer
4793,UCBPlayer,104,349,453,25,24,UCBPlayer
4794,UCBPlayer,126,126,252,7,85,Tie
4795,UCBPlayer,111,351,462,28,22,UCBPlayer
4796,UCBPlayer,116,126,242,3,87,UCBPlayer
4797,UCBPlayer,122,347,469,32,21,UCBPlayer
4798,UCBPlayer,107,132,239,0,87,UCBPlayer
4799,UCBPlayer,132,337,469,35,22,UCBPlayer
4800,UCBPlayer,103,148,251,0,83,UCBPlayer
4801,UCBPlayer,136,321,457,35,26,UCBPlayer
4802,UCBPlayer,99,164,263,0,79,UCBPlayer
4803,UCBPlayer,140,305,445,35,30,UCBPlayer
4804,UCBPlayer,95,180,275,0,75,UCBPlayer
4805,UCBPlayer,144,289,433,35,34,UCBPlayer
4806,UCBPlayer,91,196,287,0,71,UCBPlayer
4807,UCBPlayer,148,273,421,35,38,UCBPlayer
4808,UCBPlayer,87,212,299,0,67,UCBPlayer
4809,UCBPlayer,152,257,409,35,42,UCBPlayer
4810,UCBPlayer,84,224,308,0,64,UCBPlayer
4811,UCBPlayer,146,251,397,32,45,UCBPlayer
4812,UCBPlayer,89,234,323,3,60,UCBPlayer
4813,UCBPlayer,138,243,381,28,49,UCBPlayer
4814,UCBPlayer,97,242,339,7,56,UCBPlayer
4815,UCBPlayer,130,235,365,24,53,UCBPlayer
4816,UCBPlayer,105,250,355,11,52,UCBPlayer
4817,UCBPlayer,122,227,349,20,57,UCBPlayer
4818,UCBPlayer,109,259,368,15,49,UCBPlayer
4819,UCBPlayer,118,218,336,16,60,UCBPlayer
4820,UCBPlayer,117,267,384,19,45,UCBPlayer
4821,UCBPlayer,110,210,320,12,64,UCBPlayer
4822,UCBPlayer,126,271,397,23,42,UCBPlayer
4823,UCBPlayer,105,210,315,10,65,UCBPlayer
4824,UCBPlayer,130,275,405,25,40,UCBPlayer
4825,UCBPlayer,105,210,315,10,65,UCBPlayer
4826,UCBPlayer,130,275,405,25,40,UCBPlayer
4827,UCBPlayer,106,206,312,10,66,UCBPlayer
4828,UCBPlayer,130,275,405,25,40,UCBPlayer
4829,UCBPlayer,105,210,315,10,65,UCBPlayer
4830,UCBPlayer,131,271,402,25,41,UCBPlayer
4831,UCBPlayer,105,210,315,10,65,UCBPlayer
4832,UCBPlayer,130,275,405,25,40,UCBPlayer
4833,UCBPlayer,105,210,315,10,65,UCBPlayer
4834,UCBPlayer,130,275,405,25,40,UCBPlayer
4835,UCBPlayer,103,203,306,10,68,UCBPlayer
4836,UCBPlayer,128,283,411,25,38,UCBPlayer
4837,UCBPlayer,111,186,297,10,71,UCBPlayer
4838,UCBPlayer,124,299,423,25,34,UCBPlayer
4839,UCBPlayer,115,170,285,10,75,UCBPlayer
4840,UCBPlayer,120,315,435,25,30,UCBPlayer
4841,UCBPlayer,119,154,273,10,79,UCBPlayer
4842,UCBPlayer,112,332,444,25,27,UCBPlayer
4843,UCBPlayer,127,137,264,10,82,UCBPlayer
4844,UCBPlayer,104,349,453,25,24,UCBPlayer
4845,UCBPlayer,126,126,252,7,85,Tie
4846,UCBPlayer,111,351,462,28,22,UCBPlayer
4847,UCBPlayer,116,126,242,3,87,UCBPlayer
4848,UCBPlayer,122,347,469,32,21,UCBPlayer
4849,UCBPlayer,107,132,239,0,87,UCBPlayer
4850,UCBPlayer,132,337,469,35,22,UCBPlayer
4851,UCBPlayer,103,148,251,0,83,UCBPlayer
4852,UCBPlayer,136,321,457,35,26,UCBPlayer
4853,UCBPlayer,99,164,263,0,79,UCBPlayer
4854,UCBPlayer,140,305,445,35,30,UCBPlayer
4855,UCBPlayer,95,180,275,0,75,UCBPlayer
4856,UCBPlayer,144,289,433,35,34,UCBPlayer
4857,UCBPlayer,91,196,287,0,71,UCBPlayer
4858,UCBPlayer,148,273,421,35,38,UCBPlayer
4859,UCBPlayer,87,212,299,0,67,UCBPlayer
4860,UCBPlayer,152,257,409,35,42,UCBPlayer
4861,UCBPlayer,84,224,308,0,64,UCBPlayer
4862,UCBPlayer,146,251,397,32,45,UCBPlayer
4863,UCBPlayer,89,234,323,3,60,UCBPlayer
4864,UCBPlayer,138,243,381,28,49,UCBPlayer
4865,UCBPlayer,97,242,339,7,56,UCBPlayer
4866,UCBPlayer,130,235,365,24,53,UCBPlayer
4867,UCBPlayer,105,250,355,11,52,UCBPlayer
4868,UCBPlayer,122,227,349,20,57,UCBPlayer
4869,UCBPlayer,109,259,368,15,49,UCBPlayer
4870,UCBPlayer,118,218,336,16,60,UCBPlayer
4871,UCBPlayer,117,267,384,19,45,UCBPlayer
4872,UCBPlayer,110,210,320,12,64,UCBPlayer
4873,UCBPlayer,126,271,397,23,42,UCBPlayer
4874,UCBPlayer,105,210,315,10,65,UCBPlayer
4875,UCBPlayer,130,275,405,25,40,UCBPlayer
4876,UCBPlayer,105,210,315,10,65,UCBPlayer
4877,UCBPlayer,130,275,405,25,40,UCBPlayer
4878,UCBPlayer,106,206,312,10,66,UCBPlayer
4879,UCBPlayer,130,275,405,25,40,UCBPlayer
4880,UCBPlayer,105,210,315,10,65,UCBPlayer
4881,UCBPlayer,131,271,402,25,41,UCBPlayer
4882,UCBPlayer,105,210,315,10,65,UCBPlayer
4883,UCBPlayer,130,275,405,25,40,UCBPlayer
4884,UCBPlayer,105,210,315,10,65,UCBPlayer
4885,UCBPlayer,130,275,405,25,40,UCBPlayer
4886,UCBPlayer,103,203,306,10,68,UCBPlayer
4887,UCBPlayer,128,283,411,25,38,UCBPlayer
4888,UCBPlayer,111,186,297,10,71,UCBPlayer
4889,UCBPlayer,124,299,423,25,34,UCBPlayer
4890,UCBPlayer,115,170,285,10,75,UCBPlayer
4891,UCBPlayer,120,315,435,25,30,UCBPlayer
4892,UCBPlayer,119,154,273,10,79,UCBPlayer
4893,UCBPlayer,112,332,444,25,27,UCBPlayer
4894,UCBPlayer,127,137,264,10,82,UCBPlayer
4895,UCBPlayer,104,349,453,25,24,UCBPlayer
4896,UCBPlayer,126,126,252,7,85,Tie
4897,UCBPlayer,111,351,462,28,22,UCBPlayer
4898,UCBPlayer,116,126,242,3,87,UCBPlayer
4899,UCBPlayer,122,347,469,32,21,UCBPlayer
4900,UCBPlayer,107,132,239,0,87,UCBPlayer
4901,UCBPlayer,132,337,469,35,22,UCBPlayer
4902,UCBPlayer,103,148,251,0,83,UCBPlayer
4903,UCBPlayer,136,321,457,35,26,UCBPlayer
4904,UCBPlayer,99,164,263,0,79,UCBPlayer
4905,UCBPlayer,140,305,445,35,30,UCBPlayer
4906,UCBPlayer,95,180,275,0,75,UCBPlayer
4907,UCBPlayer,144,289,433,35,34,UCBPlayer
4908,UCBPlayer,91,196,287,0,71,UCBPlayer
4909,UCBPlayer,148,273,421,35,38,UCBPlayer
4910,UCBPlayer,87,212,299,0,67,UCBPlayer
4911,UCBPlayer,152,257,409,35,42,UCBPlayer
4912,UCBPlayer,84,224,308,0,64,UCBPlayer
4913,UCBPlayer,146,251,397,32,45,UCBPlayer
4914,UCBPlayer,89,234,323,3,60,UCBPlayer
4915,UCBPlayer,138,243,381,28,49,UCBPlayer
4916,UCBPlayer,97,242,339,7,56,UCBPlayer
4917,UCBPlayer,130,235,365,24,53,UCBPlayer
4918,UCBPlayer,105,250,355,11,52,UCBPlayer
4919,UCBPlayer,122,227,349,20,57,UCBPlayer
4920,UCBPlayer,109,259,368,15,49,UCBPlayer
4921,UCBPlayer,118,218,336,16,60,UCBPlayer
4922,UCBPlayer,117,267,384,19,45,UCBPlayer
4923,UCBPlayer,110,210,320,12,64,UCBPlayer
4924,UCBPlayer,126,271,397,23,42,UCBPlayer
4925,UCBPlayer,105,210,315,10,65,UCBPlayer
4926,UCBPlayer,130,275,405,25,40,UCBPlayer
4927,UCBPlayer,105,210,315,10,65,UCBPlayer
4928,UCBPlayer,130,275,405,25,40,UCBPlayer
4929,UCBPlayer,106,206,312,10,66,UCBPlayer
4930,UCBPlayer,130,275,405,25,40,UCBPlayer
4931,UCBPlayer,105,210,315,10,65,UCBPlayer
4932,UCBPlayer,131,271,402,25,41,UCBPlayer
4933,UCBPlayer,105,210,315,10,65,UCBPlayer
4934,UCBPlayer,130,275,405,25,40,UCBPlayer
4935,UCBPlayer,105,210,315,10,65,UCBPlayer
4936,UCBPlayer,130,275,405,25,40,UCBPlayer
4937,UCBPlayer,103,203,306,10,68,UCBPlayer
4938,UCBPlayer,128,283,411,25,38,UCBPlayer
4939,UCBPlayer,111,186,297,10,71,UCBPlayer
4940,UCBPlayer,124,299,423,25,34,UCBPlayer
4941,UCBPlayer,115,170,285,10,75,UCBPlayer
4942,UCBPlayer,120,315,435,25,30,UCBPlayer
4943,UCBPlayer,119,154,273,10,79,UCBPlayer
4944,UCBPlayer,112,332,444,25,27,UCBPlayer
4945,UCBPlayer,127,137,264,10,82,UCBPlayer
4946,UCBPlayer,104,349,453,25,24,UCBPlayer
4947,UCBPlayer,126,126,252,7,85,Tie
4948,UCBPlayer,111,351,462,28,22,UCBPlayer
4949,UCBPlayer,116,126,242,3,87,UCBPlayer
4950,UCBPlayer,122,347,469,32,21,UCBPlayer
4951,UCBPlayer,107,132,239,0,87,UCBPlayer
4952,UCBPlayer,132,337,469,35,22,UCBPlayer
4953,UCBPlayer,103,148,251,0,83,UCBPlayer
4954,UCBPlayer,136,321,457,35,26,UCBPlayer
4955,UCBPlayer,99,164,263,0,79,UCBPlayer
4956,UCBPlayer,140,305,445,35,30,UCBPlayer
4957,UCBPlayer,95,180,275,0,75,UCBPlayer
4958,UCBPlayer,144,289,433,35,34,UCBPlayer
4959,UCBPlayer,91,196,287,0,71,UCBPlayer
4960,UCBPlayer,148,273,421,35,38,UCBPlayer
4961,UCBPlayer,87,212,299,0,67,UCBPlayer
4962,UCBPlayer,152,257,409,35,42,UCBPlayer
4963,UCBPlayer,84,224,308,0,64,UCBPlayer
4964,UCBPlayer,146,251,397,32,45,UCBPlayer
4965,UCBPlayer,89,234,323,3,60,UCBPlayer
4966,UCBPlayer,138,243,381,28,49,UCBPlayer
4967,UCBPlayer,97,242,339,7,56,UCBPlayer
4968,UCBPlayer,130,235,365,24,53,UCBPlayer
4969,UCBPlayer,105,250,355,11,52,UCBPlayer
4970,UCBPlayer,122,227,349,20,57,UCBPlayer
4971,UCBPlayer,109,259,368,15,49,UCBPlayer
4972,UCBPlayer,118,218,336,16,60,UCBPlayer
4973,UCBPlayer,117,267,384,19,45,UCBPlayer
4974,UCBPlayer,110,210,320,12,64,UCBPlayer
4975,UCBPlayer,126,271,397,23,42,UCBPlayer
4976,UCBPlayer,105,210,315,10,65,UCBPlayer
4977,UCBPlayer,130,275,405,25,40,UCBPlayer
4978,UCBPlayer,105,210,315,10,65,UCBPlayer
4979,UCBPlayer,130,275,405,25,40,UCBPlayer
4980,UCBPlayer,106,206,312,10,66,UCBPlayer
4981,UCBPlayer,130,275,405,25,40,UCBPlayer
4982,UCBPlayer,105,210,315,10,65,UCBPlayer
4983,UCBPlayer,131,271,402,25,41,UCBPlayer
4984,UCBPlayer,105,210,315,10,65,UCBPlayer
4985,UCBPlayer,130,275,405,25,40,UCBPlayer
4986,UCBPlayer,105,210,315,10,65,UCBPlayer
4987,UCBPlayer,130,275,405,25,40,UCBPlayer
4988,UCBPlayer,103,203,306,10,68,UCBPlayer
4989,UCBPlayer,128,283,411,25,38,UCBPlayer
4990,UCBPlayer,111,186,297,10,71,UCBPlayer
4991,UCBPlayer,124,299,423,25,34,UCBPlayer
4992,UCBPlayer,115,170,285,10,75,UCBPlayer
4993,UCBPlayer,120,315,435,25,30,UCBPlayer
4994,UCBPlayer,119,154,273,10,79,UCBPlayer
4995,UCBPlayer,112,332,444,25,27,UCBPlayer
4996,UCBPlayer,127,137,264,10,82,UCBPlayer
4997,UCBPlayer,104,349,453,25,24,UCBPlayer
4998,UCBPlayer,126,126,252,7,85,Tie
4999,UCBPlayer,111,351,462,28,22,UCBPlayer
5000,UCBPlayer,116,126,242,3,87,UCBPlayer
5001,UCBPlayer,122,347,469,32,21,UCBPlayer
5002,UCBPlayer,107,132,239,0,87,UCBPlayer
5003,UCBPlayer,132,337,469,35,22,UCBPlayer
5004,UCBPlayer,103,148,251,0,83,UCBPlayer
5005,UCBPlayer,136,321,457,35,26,UCBPlayer
5006,UCBPlayer,99,164,263,0,79,UCBPlayer
5007,UCBPlayer,140,305,445,35,30,UCBPlayer
5008,UCBPlayer,95,180,275,0,75,UCBPlayer
5009,UCBPlayer,144,289,433,35,34,UCBPlayer
5010,UCBPlayer,91,196,287,0,71,UCBPlayer
5011,UCBPlayer,148,273,421,35,38,UCBPlayer
5012,UCBPlayer,87,212,299,0,67,UCBPlayer
5013,UCBPlayer,152,257,409,35,42,UCBPlayer
5014,UCBPlayer,84,224,308,0,64,UCBPlayer
5015,UCBPlayer,146,251,397,32,45,UCBPlayer
5016,UCBPlayer,89,234,323,3,60,UCBPlayer
5017,UCBPlayer,138,243,381,28,49,UCBPlayer
5018,UCBPlayer,97,242,339,7,56,UCBPlayer
5019,UCBPlayer,130,235,365,24,53,UCBPlayer
5020,UCBPlayer,105,250,355,11,52,UCBPlayer
5021,UCBPlayer,122,227,349,20,57,UCBPlayer
5022,UCBPlayer,109,259,368,15,49,UCBPlayer
5023,UCBPlayer,118,218,336,16,60,UCBPlayer
5024,UCBPlayer,117,267,384,19,45,UCBPlayer
5025,UCBPlayer,110,210,320,12,64,UCBPlayer
5026,UCBPlayer,126,271,397,23,42,UCBPlayer
5027,UCBPlayer,105,210,315,10,65,UCBPlayer
5028,UCBPlayer,130,275,405,25,40,UCBPlayer
5029,UCBPlayer,105,210,315,10,65,UCBPlayer
5030,UCBPlayer,130,275,405,25,40,UCBPlayer
5031,UCBPlayer,106,206,312,10,66,UCBPlayer
5032,UCBPlayer,130,275,405,25,40,UCBPlayer
5033,UCBPlayer,105,210,315,10,65,UCBPlayer
5034,UCBPlayer,131,271,402,25,41,UCBPlayer
5035,UCBPlayer,105,210,315,10,65,UCBPlayer
5036,UCBPlayer,130,275,405,25,40,UCBPlayer
5037,UCBPlayer,105,210,315,10,65,UCBPlayer
5038,UCBPlayer,130,275,405,25,40,UCBPlayer
5039,UCBPlayer,103,203,306,10,68,UCBPlayer
5040,UCBPlayer,128,283,411,25,38,UCBPlayer
5041,UCBPlayer,111,186,297,10,71,UCBPlayer
5042,UCBPlayer,124,299,423,25,34,UCBPlayer
5043,UCBPlayer,115,170,285,10,75,UCBPlayer
5044,UCBPlayer,120,315,435,25,30,UCBPlayer
5045,UCBPlayer,119,154,273,10,79,UCBPlayer
5046,UCBPlayer,112,332,444,25,27,UCBPlayer
5047,UCBPlayer,127,137,264,10,82,UCBPlayer
5048,UCBPlayer,104,349,453,25,24,UCBPlayer
5049,UCBPlayer,126,126,252,7,85,Tie
5050,UCBPlayer,111,351,462,28,22,UCBPlayer
5051,UCBPlayer,116,126,242,3,87,UCBPlayer
5052,UCBPlayer,122,347,469,32,21,UCBPlayer
5053,UCBPlayer,107,132,239,0,87,UCBPlayer
5054,UCBPlayer,132,337,469,35,22,UCBPlayer
5055,UCBPlayer,103,148,251,0,83,UCBPlayer
5056,UCBPlayer,136,321,457,35,26,UCBPlayer
5057,UCBPlayer,99,164,263,0,79,UCBPlayer
5058,UCBPlayer,140,305,445,35,30,UCBPlayer
5059,UCBPlayer,95,180,275,0,75,UCBPlayer
5060,UCBPlayer,144,289,433,35,34,UCBPlayer
5061,UCBPlayer,91,196,287,0,71,UCBPlayer
5062,UCBPlayer,148,273,421,35,38,UCBPlayer
5063,UCBPlayer,87,212,299,0,67,UCBPlayer
5064,UCBPlayer,152,257,409,35,42,UCBPlayer
5065,UCBPlayer,84,224,308,0,64,UCBPlayer
5066,UCBPlayer,146,251,397,32,45,UCBPlayer
5067,UCBPlayer,89,234,323,3,60,UCBPlayer
5068,UCBPlayer,138,243,381,28,49,UCBPlayer
5069,UCBPlayer,97,242,339,7,56,UCBPlayer
5070,UCBPlayer,130,235,365,24,53,UCBPlayer
5071,UCBPlayer,105,250,355,11,52,UCBPlayer
5072,UCBPlayer,122,227,349,20,57,UCBPlayer
5073,UCBPlayer,109,259,368,15,49,UCBPlayer
5074,UCBPlayer,118,218,336,16,60,UCBPlayer
5075,UCBPlayer,117,267,384,19,45,UCBPlayer
5076,UCBPlayer,110,210,320,12,64,UCBPlayer
5077,UCBPlayer,126,271,397,23,42,UCBPlayer
5078,UCBPlayer,105,210,315,10,65,UCBPlayer
5079,UCBPlayer,130,275,405,25,40,UCBPlayer
5080,UCBPlayer,105,210,315,10,65,UCBPlayer
5081,UCBPlayer,130,275,405,25,40,UCBPlayer
5082,UCBPlayer,106,206,312,10,66,UCBPlayer
5083,UCBPlayer,130,275,405,25,40,UCBPlayer
5084,UCBPlayer,105,210,315,10,65,UCBPlayer
5085,UCBPlayer,131,271,402,25,41,UCBPlayer
5086,UCBPlayer,105,210,315,10,65,UCBPlayer
5087,UCBPlayer,130,275,405,25,40,UCBPlayer
5088,UCBPlayer,105,210,315,10,65,UCBPlayer
5089,UCBPlayer,130,275,405,25,40,UCBPlayer
5090,UCBPlayer,103,203,306,10,68,UCBPlayer
5091,UCBPlayer,128,283,411,25,38,UCBPlayer
5092,UCBPlayer,111,186,297,10,71,UCBPlayer
5093,UCBPlayer,124,299,423,25,34,UCBPlayer
5094,UCBPlayer,115,170,285,10,75,UCBPlayer
5095,UCBPlayer,120,315,435,25,30,UCBPlayer
5096,UCBPlayer,119,154,273,10,79,UCBPlayer
5097,UCBPlayer,112,332,444,25,27,UCBPlayer
5098,UCBPlayer,127,137,264,10,82,UCBPlayer
5099,UCBPlayer,104,349,453,25,24,UCBPlayer
5100,UCBPlayer,126,126,252,7,85,Tie
5101,UCBPlayer,111,351,462,28,22,UCBPlayer
5102,UCBPlayer,116,126,242,3,87,UCBPlayer
5103,UCBPlayer,122,347,469,32,21,UCBPlayer
5104,UCBPlayer,107,132,239,0,87,UCBPlayer
5105,UCBPlayer,132,337,469,35,22,UCBPlayer
5106,UCBPlayer,103,148,251,0,83,UCBPlayer
5107,UCBPlayer,136,321,457,35,26,UCBPlayer
5108,UCBPlayer,99,164,263,0,79,UCBPlayer
5109,UCBPlayer,140,305,445,35,30,UCBPlayer
5110,UCBPlayer,95,180,275,0,75,UCBPlayer
5111,UCBPlayer,144,289,433,35,34,UCBPlayer
5112,UCBPlayer,91,196,287,0,71,UCBPlayer
5113,UCBPlayer,148,273,421,35,38,UCBPlayer
5114,UCBPlayer,87,212,299,0,67,UCBPlayer
5115,UCBPlayer,152,257,409,35,42,UCBPlayer
5116,UCBPlayer,84,224,308,0,64,UCBPlayer
5117,UCBPlayer,146,251,397,32,45,UCBPlayer
5118,UCBPlayer,89,234,323,3,60,UCBPlayer
5119,UCBPlayer,138,243,381,28,49,UCBPlayer
5120,UCBPlayer,97,242,339,7,56,UCBPlayer
5121,UCBPlayer,130,235,365,24,53,UCBPlayer
5122,UCBPlayer,105,250,355,11,52,UCBPlayer
5123,UCBPlayer,122,227,349,20,57,UCBPlayer
5124,UCBPlayer,109,259,368,15,49,UCBPlayer
5125,UCBPlayer,118,218,336,16,60,UCBPlayer
5126,UCBPlayer,117,267,384,19,45,UCBPlayer
5127,UCBPlayer,110,210,320,12,64,UCBPlayer
5128,UCBPlayer,126,271,397,23,42,UCBPlayer
5129,UCBPlayer,105,210,315,10,65,UCBPlayer
5130,UCBPlayer,130,275,405,25,40,UCBPlayer
5131,UCBPlayer,105,210,315,10,65,UCBPlayer
5132,UCBPlayer,130,275,405,25,40,UCBPlayer
5133,UCBPlayer,106,206,312,10,66,UCBPlayer
5134,UCBPlayer,130,275,405,25,40,UCBPlayer
5135,UCBPlayer,105,210,315,10,65,UCBPlayer
5136,UCBPlayer,131,271,402,25,41,UCBPlayer
5137,UCBPlayer,105,210,315,10,65,UCBPlayer
5138,UCBPlayer,130,275,405,25,40,UCBPlayer
5139,UCBPlayer,105,210,315,10,65,UCBPlayer
5140,UCBPlayer,130,275,405,25,40,UCBPlayer
5141,UCBPlayer,103,203,306,10,68,UCBPlayer
5142,UCBPlayer,128,283,411,25,38,UCBPlayer
5143,UCBPlayer,111,186,297,10,71,UCBPlayer
5144,UCBPlayer,124,299,423,25,34,UCBPlayer
5145,UCBPlayer,115,170,285,10,75,UCBPlayer
5146,UCBPlayer,120,315,435,25,30,UCBPlayer
5147,UCBPlayer,119,154,273,10,79,UCBPlayer
5148,UCBPlayer,112,332,444,25,27,UCBPlayer
5149,UCBPlayer,127,137,264,10,82,UCBPlayer
5150,UCBPlayer,104,349,453,25,24,UCBPlayer
5151,UCBPlayer,126,126,252,7,85,Tie
5152,UCBPlayer,111,351,462,28,22,UCBPlayer
5153,UCBPlayer,116,126,242,3,87,UCBPlayer
5154,UCBPlayer,122,347,469,32,21,UCBPlayer
5155,UCBPlayer,107,132,239,0,87,UCBPlayer
5156,UCBPlayer,132,337,469,35,22,UCBPlayer
5157,UCBPlayer,103,148,251,0,83,UCBPlayer
5158,UCBPlayer,136,321,457,35,26,UCBPlayer
5159,UCBPlayer,99,164,263,0,79,UCBPlayer
5160,UCBPlayer,140,305,445,35,30,UCBPlayer
5161,UCBPlayer,95,180,275,0,75,UCBPlayer
5162,UCBPlayer,144,289,433,35,34,UCBPlayer
5163,UCBPlayer,91,196,287,0,71,UCBPlayer
5164,UCBPlayer,148,273,421,35,38,UCBPlayer
5165,UCBPlayer,87,212,299,0,67,UCBPlayer
5166,UCBPlayer,152,257,409,35,42,UCBPlayer
5167,UCBPlayer,84,224,308,0,64,UCBPlayer
5168,UCBPlayer,146,251,397,32,45,UCBPlayer
5169,UCBPlayer,89,234,323,3,60,UCBPlayer
5170,UCBPlayer,138,243,381,28,49,UCBPlayer
5171,UCBPlayer,97,242,339,7,56,UCBPlayer
5172,UCBPlayer,130,235,365,24,53,UCBPlayer
5173,UCBPlayer,105,250,355,11,52,UCBPlayer
5174,UCBPlayer,122,227,349,20,57,UCBPlayer
5175,UCBPlayer,109,259,368,15,49,UCBPlayer
5176,UCBPlayer,118,218,336,16,60,UCBPlayer
5177,UCBPlayer,117,267,384,19,45,UCBPlayer
5178,UCBPlayer,110,210,320,12,64,UCBPlayer
5179,UCBPlayer,126,271,397,23,42,UCBPlayer
5180,UCBPlayer,105,210,315,10,65,UCBPlayer
5181,UCBPlayer,130,275,405,25,40,UCBPlayer
5182,UCBPlayer,105,210,315,10,65,UCBPlayer
5183,UCBPlayer,130,275,405,25,40,UCBPlayer
5184,UCBPlayer,106,206,312,10,66,UCBPlayer
5185,UCBPlayer,130,275,405,25,40,UCBPlayer
5186,UCBPlayer,105,210,315,10,65,UCBPlayer
5187,UCBPlayer,131,271,402,25,41,UCBPlayer
5188,UCBPlayer,105,210,315,10,65,UCBPlayer
5189,UCBPlayer,130,275,405,25,40,UCBPlayer
5190,UCBPlayer,105,210,315,10,65,UCBPlayer
5191,UCBPlayer,130,275,405,25,40,UCBPlayer
5192,UCBPlayer,103,203,306,10,68,UCBPlayer
5193,UCBPlayer,128,283,411,25,38,UCBPlayer
5194,UCBPlayer,111,186,297,10,71,UCBPlayer
5195,UCBPlayer,124,299,423,25,34,UCBPlayer
5196,UCBPlayer,115,170,285,10,75,UCBPlayer
5197,UCBPlayer,120,315,435,25,30,UCBPlayer
5198,UCBPlayer,119,154,273,10,79,UCBPlayer
5199,UCBPlayer,112,332,444,25,27,UCBPlayer
5200,UCBPlayer,127,137,264,10,82,UCBPlayer
5201,UCBPlayer,104,349,453,25,24,UCBPlayer
5202,UCBPlayer,126,126,252,7,85,Tie
5203,UCBPlayer,111,351,462,28,22,UCBPlayer
5204,UCBPlayer,116,126,242,3,87,UCBPlayer
5205,UCBPlayer,122,347,469,32,21,UCBPlayer
5206,UCBPlayer,107,132,239,0,87,UCBPlayer
5207,UCBPlayer,132,337,469,35,22,UCBPlayer
5208,UCBPlayer,103,148,251,0,83,UCBPlayer
5209,UCBPlayer,136,321,457,35,26,UCBPlayer
5210,UCBPlayer,99,164,263,0,79,UCBPlayer
5211,UCBPlayer,140,305,445,35,30,UCBPlayer
5212,UCBPlayer,95,180,275,0,75,UCBPlayer
5213,UCBPlayer,144,289,433,35,34,UCBPlayer
5214,UCBPlayer,91,196,287,0,71,UCBPlayer
5215,UCBPlayer,148,273,421,35,38,UCBPlayer
5216,UCBPlayer,87,212,299,0,67,UCBPlayer
5217,UCBPlayer,152,257,409,35,42,UCBPlayer
5218,UCBPlayer,84,224,308,0,64,UCBPlayer
5219,UCBPlayer,146,251,397,32,45,UCBPlayer
5220,UCBPlayer,89,234,323,3,60,UCBPlayer
5221,UCBPlayer,138,243,381,28,49,UCBPlayer
5222,UCBPlayer,97,242,339,7,56,UCBPlayer
5223,UCBPlayer,130,235,365,24,53,UCBPlayer
5224,UCBPlayer,105,250,355,11,52,UCBPlayer
5225,UCBPlayer,122,227,349,20,57,UCBPlayer
5226,UCBPlayer,109,259,368,15,49,UCBPlayer
5227,UCBPlayer,118,218,336,16,60,UCBPlayer
5228,UCBPlayer,117,267,384,19,45,UCBPlayer
5229,UCBPlayer,110,210,320,12,64,UCBPlayer
5230,UCBPlayer,126,271,397,23,42,UCBPlayer
5231,UCBPlayer,105,210,315,10,65,UCBPlayer
5232,UCBPlayer,130,275,405,25,40,UCBPlayer
5233,UCBPlayer,105,210,315,10,65,UCBPlayer
5234,UCBPlayer,130,275,405,25,40,UCBPlayer
5235,UCBPlayer,106,206,312,10,66,UCBPlayer
5236,UCBPlayer,130,275,405,25,40,UCBPlayer
5237,UCBPlayer,105,210,315,10,65,UCBPlayer
5238,UCBPlayer,131,271,402,25,41,UCBPlayer
5239,UCBPlayer,105,210,315,10,65,UCBPlayer
5240,UCBPlayer,130,275,405,25,40,UCBPlayer
5241,UCBPlayer,105,210,315,10,65,UCBPlayer
5242,UCBPlayer,130,275,405,25,40,UCBPlayer
5243,UCBPlayer,103,203,306,10,68,UCBPlayer
5244,UCBPlayer,128,283,411,25,38,UCBPlayer
5245,UCBPlayer,111,186,297,10,71,UCBPlayer
5246,UCBPlayer,124,299,423,25,34,UCBPlayer
5247,UCBPlayer,115,170,285,10,75,UCBPlayer
5248,UCBPlayer,120,315,435,25,30,UCBPlayer
5249,UCBPlayer,119,154,273,10,79,UCBPlayer
5250,UCBPlayer,112,332,444,25,27,UCBPlayer
5251,UCBPlayer,127,137,264,10,82,UCBPlayer
5252,UCBPlayer,104,349,453,25,24,UCBPlayer
5253,UCBPlayer,126,126,252,7,85,Tie
5254,UCBPlayer,111,351,462,28,22,UCBPlayer
5255,UCBPlayer,116,126,242,3,87,UCBPlayer
5256,UCBPlayer,122,347,469,32,21,UCBPlayer
5257,UCBPlayer,107,132,239,0,87,UCBPlayer
5258,UCBPlayer,132,337,469,35,22,UCBPlayer
5259,UCBPlayer,103,148,251,0,83,UCBPlayer
5260,UCBPlayer,136,321,457,35,26,UCBPlayer
5261,UCBPlayer,99,164,263,0,79,UCBPlayer
5262,UCBPlayer,140,305,445,35,30,UCBPlayer
5263,UCBPlayer,95,180,275,0,75,UCBPlayer
5264,UCBPlayer,144,289,433,35,34,UCBPlayer
5265,UCBPlayer,91,196,287,0,71,UCBPlayer
5266,UCBPlayer,148,273,421,35,38,UCBPlayer
5267,UCBPlayer,87,212,299,0,67,UCBPlayer
5268,UCBPlayer,152,257,409,35,42,UCBPlayer
5269,UCBPlayer,84,224,308,0,64,UCBPlayer
5270,UCBPlayer,146,251,397,32,45,UCBPlayer
5271,UCBPlayer,89,234,323,3,60,UCBPlayer
5272,UCBPlayer,138,243,381,28,49,UCBPlayer
5273,UCBPlayer,97,242,339,7,56,UCBPlayer
5274,UCBPlayer,130,235,365,24,53,UCBPlayer
5275,UCBPlayer,105,250,355,11,52,UCBPlayer
5276,UCBPlayer,122,227,349,20,57,UCBPlayer
5277,UCBPlayer,109,259,368,15,49,UCBPlayer
5278,UCBPlayer,118,218,336,16,60,UCBPlayer
5279,UCBPlayer,117,267,384,19,45,UCBPlayer
5280,UCBPlayer,110,210,320,12,64,UCBPlayer
5281,UCBPlayer,126,271,397,23,42,UCBPlayer
5282,UCBPlayer,105,210,315,10,65,UCBPlayer
5283,UCBPlayer,130,275,405,25,40,UCBPlayer
5284,UCBPlayer,105,210,315,10,65,UCBPlayer
5285,UCBPlayer,130,275,405,25,40,UCBPlayer
5286,UCBPlayer,106,206,312,10,66,UCBPlayer
5287,UCBPlayer,130,275,405,25,40,UCBPlayer
5288,UCBPlayer,105,210,315,10,65,UCBPlayer
5289,UCBPlayer,131,271,402,25,41,UCBPlayer
5290,UCBPlayer,105,210,315,10,65,UCBPlayer
5291,UCBPlayer,130,275,405,25,40,UCBPlayer
5292,UCBPlayer,105,210,315,10,65,UCBPlayer
5293,UCBPlayer,130,275,405,25,40,UCBPlayer
5294,UCBPlayer,103,203,306,10,68,UCBPlayer
5295,UCBPlayer,128,283,411,25,38,UCBPlayer
5296,UCBPlayer,111,186,297,10,71,UCBPlayer
5297,UCBPlayer,124,299,423,25,34,UCBPlayer
5298,UCBPlayer,115,170,285,10,75,UCBPlayer
5299,UCBPlayer,120,315,435,25,30,UCBPlayer
5300,UCBPlayer,119,154,273,10,79,UCBPlayer
5301,UCBPlayer,112,332,444,25,27,UCBPlayer
5302,UCBPlayer,127,137,264,10,82,UCBPlayer
5303,UCBPlayer,104,349,453,25,24,UCBPlayer
5304,UCBPlayer,126,126,252,7,85,Tie
5305,UCBPlayer,111,351,462,28,22,UCBPlayer
5306,UCBPlayer,116,126,242,3,87,UCBPlayer
5307,UCBPlayer,122,347,469,32,21,UCBPlayer
5308,UCBPlayer,107,132,239,0,87,UCBPlayer
5309,UCBPlayer,132,337,469,35,22,UCBPlayer
5310,UCBPlayer,103,148,251,0,83,UCBPlayer
5311,UCBPlayer,136,321,457,35,26,UCBPlayer
5312,UCBPlayer,99,164,263,0,79,UCBPlayer
5313,UCBPlayer,140,305,445,35,30,UCBPlayer
5314,UCBPlayer,95,180,275,0,75,UCBPlayer
5315,UCBPlayer,144,289,433,35,34,UCBPlayer
5316,UCBPlayer,91,196,287,0,71,UCBPlayer
5317,UCBPlayer,148,273,421,35,38,UCBPlayer
5318,UCBPlayer,87,212,299,0,67,UCBPlayer
5319,UCBPlayer,152,257,409,35,42,UCBPlayer
5320,UCBPlayer,84,224,308,0,64,UCBPlayer
5321,UCBPlayer,146,251,397,32,45,UCBPlayer
5322,UCBPlayer,89,234,323,3,60,UCBPlayer
5323,UCBPlayer,138,243,381,28,49,UCBPlayer
5324,UCBPlayer,97,242,339,7,56,UCBPlayer
5325,UCBPlayer,130,235,365,24,53,UCBPlayer
5326,UCBPlayer,105,250,355,11,52,UCBPlayer
5327,UCBPlayer,122,227,349,20,57,UCBPlayer
5328,UCBPlayer,109,259,368,15,49,UCBPlayer
5329,UCBPlayer,118,218,336,16,60,UCBPlayer
5330,UCBPlayer,117,267,384,19,45,UCBPlayer
5331,UCBPlayer,110,210,320,12,64,UCBPlayer
5332,UCBPlayer,126,271,397,23,42,UCBPlayer
5333,UCBPlayer,105,210,315,10,65,UCBPlayer
5334,UCBPlayer,130,275,405,25,40,UCBPlayer
5335,UCBPlayer,105,210,315,10,65,UCBPlayer
5336,UCBPlayer,130,275,405,25,40,UCBPlayer
5337,UCBPlayer,106,206,312,10,66,UCBPlayer
5338,UCBPlayer,130,275,405,25,40,UCBPlayer
5339,UCBPlayer,105,210,315,10,65,UCBPlayer
5340,UCBPlayer,131,271,402,25,41,UCBPlayer
5341,UCBPlayer,105,210,315,10,65,UCBPlayer
5342,UCBPlayer,130,275,405,25,40,UCBPlayer
5343,UCBPlayer,105,210,315,10,65,UCBPlayer
5344,UCBPlayer,130,275,405,25,40,UCBPlayer
5345,UCBPlayer,103,203,306,10,68,UCBPlayer
5346,UCBPlayer,128,283,411,25,38,UCBPlayer
5347,UCBPlayer,111,186,297,10,71,UCBPlayer
5348,UCBPlayer,124,299,423,25,34,UCBPlayer
5349,UCBPlayer,115,170,285,10,75,UCBPlayer
5350,UCBPlayer,120,315,435,25,30,UCBPlayer
5351,UCBPlayer,119,154,273,10,79,UCBPlayer
5352,UCBPlayer,112,332,444,25,27,UCBPlayer
5353,UCBPlayer,127,137,264,10,82,UCBPlayer
5354,UCBPlayer,104,349,453,25,24,UCBPlayer
5355,UCBPlayer,126,126,252,7,85,Tie
5356,UCBPlayer,111,351,462,28,22,UCBPlayer
5357,UCBPlayer,116,126,242,3,87,UCBPlayer
5358,UCBPlayer,122,347,469,32,21,UCBPlayer
5359,UCBPlayer,107,132,239,0,87,UCBPlayer
5360,UCBPlayer,132,337,469,35,22,UCBPlayer
5361,UCBPlayer,103,148,251,0,83,UCBPlayer
5362,UCBPlayer,136,321,457,35,26,UCBPlayer
5363,UCBPlayer,99,164,263,0,79,UCBPlayer
5364,UCBPlayer,140,305,445,35,30,UCBPlayer
5365,UCBPlayer,95,180,275,0,75,UCBPlayer
5366,UCBPlayer,144,289,433,35,34,UCBPlayer
5367,UCBPlayer,91,196,287,0,71,UCBPlayer
5368,UCBPlayer,148,273,421,35,38,UCBPlayer
5369,UCBPlayer,87,212,299,0,67,UCBPlayer
5370,UCBPlayer,152,257,409,35,42,UCBPlayer
5371,UCBPlayer,84,224,308,0,64,UCBPlayer
5372,UCBPlayer,146,251,397,32,45,UCBPlayer
5373,UCBPlayer,89,234,323,3,60,UCBPlayer
5374,UCBPlayer,138,243,381,28,49,UCBPlayer
5375,UCBPlayer,97,242,339,7,56,UCBPlayer
5376,UCBPlayer,130,235,365,24,53,UCBPlayer
5377,UCBPlayer,105,250,355,11,52,UCBPlayer
5378,UCBPlayer,122,227,349,20,57,UCBPlayer
5379,UCBPlayer,109,259,368,15,49,UCBPlayer
5380,UCBPlayer,118,218,336,16,60,UCBPlayer
5381,UCBPlayer,117,267,384,19,45,UCBPlayer
5382,UCBPlayer,110,210,320,12,64,UCBPlayer
5383,UCBPlayer,126,271,397,23,42,UCBPlayer
5384,UCBPlayer,105,210,315,10,65,UCBPlayer
5385,UCBPlayer,130,275,405,25,40,UCBPlayer
5386,UCBPlayer,105,210,315,10,65,UCBPlayer
5387,UCBPlayer,130,275,405,25,40,UCBPlayer
5388,UCBPlayer,106,206,312,10,66,UCBPlayer
5389,UCBPlayer,130,275,405,25,40,UCBPlayer
5390,UCBPlayer,105,210,315,10,65,UCBPlayer
5391,UCBPlayer,131,271,402,25,41,UCBPlayer
5392,UCBPlayer,105,210,315,10,65,UCBPlayer
5393,UCBPlayer,130,275,405,25,40,UCBPlayer
5394,UCBPlayer,105,210,315,10,65,UCBPlayer
5395,UCBPlayer,130,275,405,25,40,UCBPlayer
5396,UCBPlayer,103,203,306,10,68,UCBPlayer
5397,UCBPlayer,128,283,411,25,38,UCBPlayer
5398,UCBPlayer,111,186,297,10,71,UCBPlayer
5399,UCBPlayer,124,299,423,25,34,UCBPlayer
5400,UCBPlayer,115,170,285,10,75,UCBPlayer
5401,UCBPlayer,120,315,435,25,30,UCBPlayer
5402,UCBPlayer,119,154,273,10,79,UCBPlayer
5403,UCBPlayer,112,332,444,25,27,UCBPlayer
5404,UCBPlayer,127,137,264,10,82,UCBPlayer
5405,UCBPlayer,104,349,453,25,24,UCBPlayer
5406,UCBPlayer,126,126,252,7,85,Tie
5407,UCBPlayer,111,351,462,28,22,UCBPlayer
5408,UCBPlayer,116,126,242,3,87,UCBPlayer
5409,UCBPlayer,122,347,469,32,21,UCBPlayer
5410,UCBPlayer,107,132,239,0,87,UCBPlayer
5411,UCBPlayer,132,337,469,35,22,UCBPlayer
5412,UCBPlayer,103,148,251,0,83,UCBPlayer
5413,UCBPlayer,136,321,457,35,26,UCBPlayer
5414,UCBPlayer,99,164,263,0,79,UCBPlayer
5415,UCBPlayer,140,305,445,35,30,UCBPlayer
5416,UCBPlayer,95,180,275,0,75,UCBPlayer
5417,UCBPlayer,144,289,433,35,34,UCBPlayer
5418,UCBPlayer,91,196,287,0,71,UCBPlayer
5419,UCBPlayer,148,273,421,35,38,UCBPlayer
5420,UCBPlayer,87,212,299,0,67,UCBPlayer
5421,UCBPlayer,152,257,409,35,42,UCBPlayer
5422,UCBPlayer,84,224,308,0,64,UCBPlayer
5423,UCBPlayer,146,251,397,32,45,UCBPlayer
5424,UCBPlayer,89,234,323,3,60,UCBPlayer
5425,UCBPlayer,138,243,381,28,49,UCBPlayer
5426,UCBPlayer,97,242,339,7,56,UCBPlayer
5427,UCBPlayer,130,235,365,24,53,UCBPlayer
5428,UCBPlayer,105,250,355,11,52,UCBPlayer
5429,UCBPlayer,122,227,349,20,57,UCBPlayer
5430,UCBPlayer,109,259,368,15,49,UCBPlayer
5431,UCBPlayer,118,218,336,16,60,UCBPlayer
5432,UCBPlayer,117,267,384,19,45,UCBPlayer
5433,UCBPlayer,110,210,320,12,64,UCBPlayer
5434,UCBPlayer,126,271,397,23,42,UCBPlayer
5435,UCBPlayer,105,210,315,10,65,UCBPlayer
5436,UCBPlayer,130,275,405,25,40,UCBPlayer
5437,UCBPlayer,105,210,315,10,65,UCBPlayer
5438,UCBPlayer,130,275,405,25,40,UCBPlayer
5439,UCBPlayer,106,206,312,10,66,UCBPlayer
5440,UCBPlayer,130,275,405,25,40,UCBPlayer
5441,UCBPlayer,105,210,315,10,65,UCBPlayer
5442,UCBPlayer,131,271,402,25,41,UCBPlayer
5443,UCBPlayer,105,210,315,10,65,UCBPlayer
5444,UCBPlayer,130,275,405,25,40,UCBPlayer
5445,UCBPlayer,105,210,315,10,65,UCBPlayer
5446,UCBPlayer,130,275,405,25,40,UCBPlayer
5447,UCBPlayer,103,203,306,10,68,UCBPlayer
5448,UCBPlayer,128,283,411,25,38,UCBPlayer
5449,UCBPlayer,111,186,297,10,71,UCBPlayer
5450,UCBPlayer,124,299,423,25,34,UCBPlayer
5451,UCBPlayer,115,170,285,10,75,UCBPlayer
5452,UCBPlayer,120,315,435,25,30,UCBPlayer
5453,UCBPlayer,119,154,273,10,79,UCBPlayer
5454,UCBPlayer,112,332,444,25,27,UCBPlayer
5455,UCBPlayer,127,137,264,10,82,UCBPlayer
5456,UCBPlayer,104,349,453,25,24,UCBPlayer
5457,UCBPlayer,126,126,252,7,85,Tie
5458,UCBPlayer,111,351,462,28,22,UCBPlayer
5459,UCBPlayer,116,126,242,3,87,UCBPlayer
5460,UCBPlayer,122,347,469,32,21,UCBPlayer
5461,UCBPlayer,107,132,239,0,87,UCBPlayer
5462,UCBPlayer,132,337,469,35,22,UCBPlayer
5463,UCBPlayer,103,148,251,0,83,UCBPlayer
5464,UCBPlayer,136,321,457,35,26,UCBPlayer
5465,UCBPlayer,99,164,263,0,79,UCBPlayer
5466,UCBPlayer,140,305,445,35,30,UCBPlayer
5467,UCBPlayer,95,180,275,0,75,UCBPlayer
5468,UCBPlayer,144,289,433,35,34,UCBPlayer
5469,UCBPlayer,91,196,287,0,71,UCBPlayer
5470,UCBPlayer,148,273,421,35,38,UCBPlayer
5471,UCBPlayer,87,212,299,0,67,UCBPlayer
5472,UCBPlayer,152,257,409,35,42,UCBPlayer
5473,UCBPlayer,84,224,308,0,64,UCBPlayer
5474,UCBPlayer,146,251,397,32,45,UCBPlayer
5475,UCBPlayer,89,234,323,3,60,UCBPlayer
5476,UCBPlayer,138,243,381,28,49,UCBPlayer
5477,UCBPlayer,97,242,339,7,56,UCBPlayer
5478,UCBPlayer,130,235,365,24,53,UCBPlayer
5479,UCBPlayer,105,250,355,11,52,UCBPlayer
5480,UCBPlayer,122,227,349,20,57,UCBPlayer
5481,UCBPlayer,109,259,368,15,49,UCBPlayer
5482,UCBPlayer,118,218,336,16,60,UCBPlayer
5483,UCBPlayer,117,267,384,19,45,UCBPlayer
5484,UCBPlayer,110,210,320,12,64,UCBPlayer
5485,UCBPlayer,126,271,397,23,42,UCBPlayer
5486,UCBPlayer,105,210,315,10,65,UCBPlayer
5487,UCBPlayer,130,275,405,25,40,UCBPlayer
5488,UCBPlayer,105,210,315,10,65,UCBPlayer
5489,UCBPlayer,130,275,405,25,40,UCBPlayer
5490,UCBPlayer,106,206,312,10,66,UCBPlayer
5491,UCBPlayer,130,275,405,25,40,UCBPlayer
5492,UCBPlayer,105,210,315,10,65,UCBPlayer
5493,UCBPlayer,131,271,402,25,41,UCBPlayer
5494,UCBPlayer,105,210,315,10,65,UCBPlayer
5495,UCBPlayer,130,275,405,25,40,UCBPlayer
5496,UCBPlayer,105,210,315,10,65,UCBPlayer
5497,UCBPlayer,130,275,405,25,40,UCBPlayer
5498,UCBPlayer,103,203,306,10,68,UCBPlayer
5499,UCBPlayer,128,283,411,25,38,UCBPlayer
5500,UCBPlayer,111,186,297,10,71,UCBPlayer
5501,UCBPlayer,124,299,423,25,34,UCBPlayer
5502,UCBPlayer,115,170,285,10,75,UCBPlayer
5503,UCBPlayer,120,315,435,25,30,UCBPlayer
5504,UCBPlayer,119,154,273,10,79,UCBPlayer
5505,UCBPlayer,112,332,444,25,27,UCBPlayer
5506,UCBPlayer,127,137,264,10,82,UCBPlayer
5507,UCBPlayer,104,349,453,25,24,UCBPlayer
5508,UCBPlayer,126,126,252,7,85,Tie
5509,UCBPlayer,111,351,462,28,22,UCBPlayer
5510,UCBPlayer,116,126,242,3,87,UCBPlayer
5511,UCBPlayer,122,347,469,32,21,UCBPlayer
5512,UCBPlayer,107,132,239,0,87,UCBPlayer
5513,UCBPlayer,132,337,469,35,22,UCBPlayer
5514,UCBPlayer,103,148,251,0,83,UCBPlayer
5515,UCBPlayer,136,321,457,35,26,UCBPlayer
5516,UCBPlayer,99,164,263,0,79,UCBPlayer
5517,UCBPlayer,140,305,445,35,30,UCBPlayer
5518,UCBPlayer,95,180,275,0,75,UCBPlayer
5519,UCBPlayer,144,289,433,35,34,UCBPlayer
5520,UCBPlayer,91,196,287,0,71,UCBPlayer
5521,UCBPlayer,148,273,421,35,38,UCBPlayer
5522,UCBPlayer,87,212,299,0,67,UCBPlayer
5523,UCBPlayer,152,257,409,35,42,UCBPlayer
5524,UCBPlayer,84,224,308,0,64,UCBPlayer
5525,UCBPlayer,146,251,397,32,45,UCBPlayer
5526,UCBPlayer,89,234,323,3,60,UCBPlayer
5527,UCBPlayer,138,243,381,28,49,UCBPlayer
5528,UCBPlayer,97,242,339,7,56,UCBPlayer
5529,UCBPlayer,130,235,365,24,53,UCBPlayer
5530,UCBPlayer,105,250,355,11,52,UCBPlayer
5531,UCBPlayer,122,227,349,20,57,UCBPlayer
5532,UCBPlayer,109,259,368,15,49,UCBPlayer
5533,UCBPlayer,118,218,336,16,60,UCBPlayer
5534,UCBPlayer,117,267,384,19,45,UCBPlayer
5535,UCBPlayer,110,210,320,12,64,UCBPlayer
5536,UCBPlayer,126,271,397,23,42,UCBPlayer
5537,UCBPlayer,105,210,315,10,65,UCBPlayer
5538,UCBPlayer,130,275,405,25,40,UCBPlayer
5539,UCBPlayer,105,210,315,10,65,UCBPlayer
5540,UCBPlayer,130,275,405,25,40,UCBPlayer
5541,UCBPlayer,106,206,312,10,66,UCBPlayer
5542,UCBPlayer,130,275,405,25,40,UCBPlayer
5543,UCBPlayer,105,210,315,10,65,UCBPlayer
5544,UCBPlayer,131,271,402,25,41,UCBPlayer
5545,UCBPlayer,105,210,315,10,65,UCBPlayer
5546,UCBPlayer,130,275,405,25,40,UCBPlayer
5547,UCBPlayer,105,210,315,10,65,UCBPlayer
5548,UCBPlayer,130,275,405,25,40,UCBPlayer
5549,UCBPlayer,103,203,306,10,68,UCBPlayer
5550,UCBPlayer,128,283,411,25,38,UCBPlayer
5551,UCBPlayer,111,186,297,10,71,UCBPlayer
5552,UCBPlayer,124,299,423,25,34,UCBPlayer
5553,UCBPlayer,115,170,285,10,75,UCBPlayer
5554,UCBPlayer,120,315,435,25,30,UCBPlayer
5555,UCBPlayer,119,154,273,10,79,UCBPlayer
5556,UCBPlayer,112,332,444,25,27,UCBPlayer
5557,UCBPlayer,127,137,264,10,82,UCBPlayer
5558,UCBPlayer,104,349,453,25,24,UCBPlayer
5559,UCBPlayer,126,126,252,7,85,Tie
5560,UCBPlayer,111,351,462,28,22,UCBPlayer
5561,UCBPlayer,116,126,242,3,87,UCBPlayer
5562,UCBPlayer,122,347,469,32,21,UCBPlayer
5563,UCBPlayer,107,132,239,0,87,UCBPlayer
5564,UCBPlayer,132,337,469,35,22,UCBPlayer
5565,UCBPlayer,103,148,251,0,83,UCBPlayer
5566,UCBPlayer,136,321,457,35,26,UCBPlayer
5567,UCBPlayer,99,164,263,0,79,UCBPlayer
5568,UCBPlayer,140,305,445,35,30,UCBPlayer
5569,UCBPlayer,95,180,275,0,75,UCBPlayer
5570,UCBPlayer,144,289,433,35,34,UCBPlayer
5571,UCBPlayer,91,196,287,0,71,UCBPlayer
5572,UCBPlayer,148,273,421,35,38,UCBPlayer
5573,UCBPlayer,87,212,299,0,67,UCBPlayer
5574,UCBPlayer,152,257,409,35,42,UCBPlayer
5575,UCBPlayer,84,224,308,0,64,UCBPlayer
5576,UCBPlayer,146,251,397,32,45,UCBPlayer
5577,UCBPlayer,89,234,323,3,60,UCBPlayer
5578,UCBPlayer,138,243,381,28,49,UCBPlayer
5579,UCBPlayer,97,242,339,7,56,UCBPlayer
5580,UCBPlayer,130,235,365,24,53,UCBPlayer
5581,UCBPlayer,105,250,355,11,52,UCBPlayer
5582,UCBPlayer,122,227,349,20,57,UCBPlayer
5583,UCBPlayer,109,259,368,15,49,UCBPlayer
5584,UCBPlayer,118,218,336,16,60,UCBPlayer
5585,UCBPlayer,117,267,384,19,45,UCBPlayer
5586,UCBPlayer,110,210,320,12,64,UCBPlayer
5587,UCBPlayer,126,271,397,23,42,UCBPlayer
5588,UCBPlayer,105,210,315,10,65,UCBPlayer
5589,UCBPlayer,130,275,405,25,40,UCBPlayer
5590,UCBPlayer,105,210,315,10,65,UCBPlayer
5591,UCBPlayer,130,275,405,25,40,UCBPlayer
5592,UCBPlayer,106,206,312,10,66,UCBPlayer
5593,UCBPlayer,130,275,405,25,40,UCBPlayer
5594,UCBPlayer,105,210,315,10,65,UCBPlayer
5595,UCBPlayer,131,271,402,25,41,UCBPlayer
5596,UCBPlayer,105,210,315,10,65,UCBPlayer
5597,UCBPlayer,130,275,405,25,40,UCBPlayer
5598,UCBPlayer,105,210,315,10,65,UCBPlayer
5599,UCBPlayer,130,275,405,25,40,UCBPlayer
5600,UCBPlayer,103,203,306,10,68,UCBPlayer
5601,UCBPlayer,128,283,411,25,38,UCBPlayer
5602,UCBPlayer,111,186,297,10,71,UCBPlayer
5603,UCBPlayer,124,299,423,25,34,UCBPlayer
5604,UCBPlayer,115,170,285,10,75,UCBPlayer
5605,UCBPlayer,120,315,435,25,30,UCBPlayer
5606,UCBPlayer,119,154,273,10,79,UCBPlayer
5607,UCBPlayer,112,332,444,25,27,UCBPlayer
5608,UCBPlayer,127,137,264,10,82,UCBPlayer
5609,UCBPlayer,104,349,453,25,24,UCBPlayer
5610,UCBPlayer,126,126,252,7,85,Tie
5611,UCBPlayer,111,351,462,28,22,UCBPlayer
5612,UCBPlayer,116,126,242,3,87,UCBPlayer
5613,UCBPlayer,122,347,469,32,21,UCBPlayer
5614,UCBPlayer,107,132,239,0,87,UCBPlayer
5615,UCBPlayer,132,337,469,35,22,UCBPlayer
5616,UCBPlayer,103,148,251,0,83,UCBPlayer
5617,UCBPlayer,136,321,457,35,26,UCBPlayer
5618,UCBPlayer,99,164,263,0,79,UCBPlayer
5619,UCBPlayer,140,305,445,35,30,UCBPlayer
5620,UCBPlayer,95,180,275,0,75,UCBPlayer
5621,UCBPlayer,144,289,433,35,34,UCBPlayer
5622,UCBPlayer,91,196,287,0,71,UCBPlayer
5623,UCBPlayer,148,273,421,35,38,UCBPlayer
5624,UCBPlayer,87,212,299,0,67,UCBPlayer
5625,UCBPlayer,152,257,409,35,42,UCBPlayer
5626,UCBPlayer,84,224,308,0,64,UCBPlayer
5627,UCBPlayer,146,251,397,32,45,UCBPlayer
5628,UCBPlayer,89,234,323,3,60,UCBPlayer
5629,UCBPlayer,138,243,381,28,49,UCBPlayer
5630,UCBPlayer,97,242,339,7,56,UCBPlayer
5631,UCBPlayer,130,235,365,24,53,UCBPlayer
5632,UCBPlayer,105,250,355,11,52,UCBPlayer
5633,UCBPlayer,122,227,349,20,57,UCBPlayer
5634,UCBPlayer,109,259,368,15,49,UCBPlayer
5635,UCBPlayer,118,218,336,16,60,UCBPlayer
5636,UCBPlayer,117,267,384,19,45,UCBPlayer
5637,UCBPlayer,110,210,320,12,64,UCBPlayer
5638,UCBPlayer,126,271,397,23,42,UCBPlayer
5639,UCBPlayer,105,210,315,10,65,UCBPlayer
5640,UCBPlayer,130,275,405,25,40,UCBPlayer
5641,UCBPlayer,105,210,315,10,65,UCBPlayer
5642,UCBPlayer,130,275,405,25,40,UCBPlayer
5643,UCBPlayer,106,206,312,10,66,UCBPlayer
5644,UCBPlayer,130,275,405,25,40,UCBPlayer
5645,UCBPlayer,105,210,315,10,65,UCBPlayer
5646,UCBPlayer,131,271,402,25,41,UCBPlayer
5647,UCBPlayer,105,210,315,10,65,UCBPlayer
5648,UCBPlayer,130,275,405,25,40,UCBPlayer
5649,UCBPlayer,105,210,315,10,65,UCBPlayer
5650,UCBPlayer,130,275,405,25,40,UCBPlayer
5651,UCBPlayer,103,203,306,10,68,UCBPlayer
5652,UCBPlayer,128,283,411,25,38,UCBPlayer
5653,UCBPlayer,111,186,297,10,71,UCBPlayer
5654,UCBPlayer,124,299,423,25,34,UCBPlayer
5655,UCBPlayer,115,170,285,10,75,UCBPlayer
5656,UCBPlayer,120,315,435,25,30,UCBPlayer
5657,UCBPlayer,119,154,273,10,79,UCBPlayer
5658,UCBPlayer,112,332,444,25,27,UCBPlayer
5659,UCBPlayer,127,137,264,10,82,UCBPlayer
5660,UCBPlayer,104,349,453,25,24,UCBPlayer
5661,UCBPlayer,126,126,252,7,85,Tie
5662,UCBPlayer,111,351,462,28,22,UCBPlayer
5663,UCBPlayer,116,126,242,3,87,UCBPlayer
5664,UCBPlayer,122,347,469,32,21,UCBPlayer
5665,UCBPlayer,107,132,239,0,87,UCBPlayer
5666,UCBPlayer,132,337,469,35,22,UCBPlayer
5667,UCBPlayer,103,148,251,0,83,UCBPlayer
5668,UCBPlayer,136,321,457,35,26,UCBPlayer
5669,UCBPlayer,99,164,263,0,79,UCBPlayer
5670,UCBPlayer,140,305,445,35,30,UCBPlayer
5671,UCBPlayer,95,180,275,0,75,UCBPlayer
5672,UCBPlayer,144,289,433,35,34,UCBPlayer
5673,UCBPlayer,91,196,287,0,71,UCBPlayer
5674,UCBPlayer,148,273,421,35,38,UCBPlayer
5675,UCBPlayer,87,212,299,0,67,UCBPlayer
5676,UCBPlayer,152,257,409,35,42,UCBPlayer
5677,UCBPlayer,84,224,308,0,64,UCBPlayer
5678,UCBPlayer,146,251,397,32,45,UCBPlayer
5679,UCBPlayer,89,234,323,3,60,UCBPlayer
5680,UCBPlayer,138,243,381,28,49,UCBPlayer
5681,UCBPlayer,97,242,339,7,56,UCBPlayer
5682,UCBPlayer,130,235,365,24,53,UCBPlayer
5683,UCBPlayer,105,250,355,11,52,UCBPlayer
5684,UCBPlayer,122,227,349,20,57,UCBPlayer
5685,UCBPlayer,109,259,368,15,49,UCBPlayer
5686,UCBPlayer,118,218,336,16,60,UCBPlayer
5687,UCBPlayer,117,267,384,19,45,UCBPlayer
5688,UCBPlayer,110,210,320,12,64,UCBPlayer
5689,UCBPlayer,126,271,397,23,42,UCBPlayer
5690,UCBPlayer,105,210,315,10,65,UCBPlayer
5691,UCBPlayer,130,275,405,25,40,UCBPlayer
5692,UCBPlayer,105,210,315,10,65,UCBPlayer
5693,UCBPlayer,130,275,405,25,40,UCBPlayer
5694,UCBPlayer,106,206,312,10,66,UCBPlayer
5695,UCBPlayer,130,275,405,25,40,UCBPlayer
5696,UCBPlayer,105,210,315,10,65,UCBPlayer
5697,UCBPlayer,131,271,402,25,41,UCBPlayer
5698,UCBPlayer,105,210,315,10,65,UCBPlayer
5699,UCBPlayer,130,275,405,25,40,UCBPlayer
5700,UCBPlayer,105,210,315,10,65,UCBPlayer
5701,UCBPlayer,130,275,405,25,40,UCBPlayer
5702,UCBPlayer,103,203,306,10,68,UCBPlayer
5703,UCBPlayer,128,283,411,25,38,UCBPlayer
5704,UCBPlayer,111,186,297,10,71,UCBPlayer
5705,UCBPlayer,124,299,423,25,34,UCBPlayer
5706,UCBPlayer,115,170,285,10,75,UCBPlayer
5707,UCBPlayer,120,315,435,25,30,UCBPlayer
5708,UCBPlayer,119,154,273,10,79,UCBPlayer
5709,UCBPlayer,112,332,444,25,27,UCBPlayer
5710,UCBPlayer,127,137,264,10,82,UCBPlayer
5711,UCBPlayer,104,349,453,25,24,UCBPlayer
5712,UCBPlayer,126,126,252,7,85,Tie
5713,UCBPlayer,111,351,462,28,22,UCBPlayer
5714,UCBPlayer,116,126,242,3,87,UCBPlayer
5715,UCBPlayer,122,347,469,32,21,UCBPlayer
5716,UCBPlayer,107,132,239,0,87,UCBPlayer
5717,UCBPlayer,132,337,469,35,22,UCBPlayer
5718,UCBPlayer,103,148,251,0,83,UCBPlayer
5719,UCBPlayer,136,321,457,35,26,UCBPlayer
5720,UCBPlayer,99,164,263,0,79,UCBPlayer
5721,UCBPlayer,140,305,445,35,30,UCBPlayer
5722,UCBPlayer,95,180,275,0,75,UCBPlayer
5723,UCBPlayer,144,289,433,35,34,UCBPlayer
5724,UCBPlayer,91,196,287,0,71,UCBPlayer
5725,UCBPlayer,148,273,421,35,38,UCBPlayer
5726,UCBPlayer,87,212,299,0,67,UCBPlayer
5727,UCBPlayer,152,257,409,35,42,UCBPlayer
5728,UCBPlayer,84,224,308,0,64,UCBPlayer
5729,UCBPlayer,146,251,397,32,45,UCBPlayer
5730,UCBPlayer,89,234,323,3,60,UCBPlayer
5731,UCBPlayer,138,243,381,28,49,UCBPlayer
5732,UCBPlayer,97,242,339,7,56,UCBPlayer
5733,UCBPlayer,130,235,365,24,53,UCBPlayer
5734,UCBPlayer,105,250,355,11,52,UCBPlayer
5735,UCBPlayer,122,227,349,20,57,UCBPlayer
5736,UCBPlayer,109,259,368,15,49,UCBPlayer
5737,UCBPlayer,118,218,336,16,60,UCBPlayer
5738,UCBPlayer,117,267,384,19,45,UCBPlayer
5739,UCBPlayer,110,210,320,12,64,UCBPlayer
5740,UCBPlayer,126,271,397,23,42,UCBPlayer
5741,UCBPlayer,105,210,315,10,65,UCBPlayer
5742,UCBPlayer,130,275,405,25,40,UCBPlayer
5743,UCBPlayer,105,210,315,10,65,UCBPlayer
5744,UCBPlayer,130,275,405,25,40,UCBPlayer
5745,UCBPlayer,106,206,312,10,66,UCBPlayer
5746,UCBPlayer,130,275,405,25,40,UCBPlayer
5747,UCBPlayer,105,210,315,10,65,UCBPlayer
5748,UCBPlayer,131,271,402,25,41,UCBPlayer
5749,UCBPlayer,105,210,315,10,65,UCBPlayer
5750,UCBPlayer,130,275,405,25,40,UCBPlayer
5751,UCBPlayer,105,210,315,10,65,UCBPlayer
5752,UCBPlayer,130,275,405,25,40,UCBPlayer
5753,UCBPlayer,103,203,306,10,68,UCBPlayer
5754,UCBPlayer,128,283,411,25,38,UCBPlayer
5755,UCBPlayer,111,186,297,10,71,UCBPlayer
5756,UCBPlayer,124,299,423,25,34,UCBPlayer
5757,UCBPlayer,115,170,285,10,75,UCBPlayer
5758,UCBPlayer,120,315,435,25,30,UCBPlayer
5759,UCBPlayer,119,154,273,10,79,UCBPlayer
5760,UCBPlayer,112,332,444,25,27,UCBPlayer
5761,UCBPlayer,127,137,264,10,82,UCBPlayer
5762,UCBPlayer,104,349,453,25,24,UCBPlayer
5763,UCBPlayer,126,126,252,7,85,Tie
5764,UCBPlayer,111,351,462,28,22,UCBPlayer
5765,UCBPlayer,116,126,242,3,87,UCBPlayer
5766,UCBPlayer,122,347,469,32,21,UCBPlayer
5767,UCBPlayer,107,132,239,0,87,UCBPlayer
5768,UCBPlayer,132,337,469,35,22,UCBPlayer
5769,UCBPlayer,103,148,251,0,83,UCBPlayer
5770,UCBPlayer,136,321,457,35,26,UCBPlayer
5771,UCBPlayer,99,164,263,0,79,UCBPlayer
5772,UCBPlayer,140,305,445,35,30,UCBPlayer
5773,UCBPlayer,95,180,275,0,75,UCBPlayer
5774,UCBPlayer,144,289,433,35,34,UCBPlayer
5775,UCBPlayer,91,196,287,0,71,UCBPlayer
5776,UCBPlayer,148,273,421,35,38,UCBPlayer
5777,UCBPlayer,87,212,299,0,67,UCBPlayer
5778,UCBPlayer,152,257,409,35,42,UCBPlayer
5779,UCBPlayer,84,224,308,0,64,UCBPlayer
5780,UCBPlayer,146,251,397,32,45,UCBPlayer
5781,UCBPlayer,89,234,323,3,60,UCBPlayer
5782,UCBPlayer,138,243,381,28,49,UCBPlayer
5783,UCBPlayer,97,242,339,7,56,UCBPlayer
5784,UCBPlayer,130,235,365,24,53,UCBPlayer
5785,UCBPlayer,105,250,355,11,52,UCBPlayer
5786,UCBPlayer,122,227,349,20,57,UCBPlayer
5787,UCBPlayer,109,259,368,15,49,UCBPlayer
5788,UCBPlayer,118,218,336,16,60,UCBPlayer
5789,UCBPlayer,117,267,384,19,45,UCBPlayer
5790,UCBPlayer,110,210,320,12,64,UCBPlayer
5791,UCBPlayer,126,271,397,23,42,UCBPlayer
5792,UCBPlayer,105,210,315,10,65,UCBPlayer
5793,UCBPlayer,130,275,405,25,40,UCBPlayer
5794,UCBPlayer,105,210,315,10,65,UCBPlayer
5795,UCBPlayer,130,275,405,25,40,UCBPlayer
5796,UCBPlayer,106,206,312,10,66,UCBPlayer
5797,UCBPlayer,130,275,405,25,40,UCBPlayer
5798,UCBPlayer,105,210,315,10,65,UCBPlayer
5799,UCBPlayer,131,271,402,25,41,UCBPlayer
5800,UCBPlayer,105,210,315,10,65,UCBPlayer
5801,UCBPlayer,130,275,405,25,40,UCBPlayer
5802,UCBPlayer,105,210,315,10,65,UCBPlayer
5803,UCBPlayer,130,275,405,25,40,UCBPlayer
5804,UCBPlayer,103,203,306,10,68,UCBPlayer
5805,UCBPlayer,128,283,411,25,38,UCBPlayer
5806,UCBPlayer,111,186,297,10,71,UCBPlayer
5807,UCBPlayer,124,299,423,25,34,UCBPlayer
5808,UCBPlayer,115,170,285,10,75,UCBPlayer
5809,UCBPlayer,120,315,435,25,30,UCBPlayer
5810,UCBPlayer,119,154,273,10,79,UCBPlayer
5811,UCBPlayer,112,332,444,25,27,UCBPlayer
5812,UCBPlayer,127,137,264,10,82,UCBPlayer
5813,UCBPlayer,104,349,453,25,24,UCBPlayer
5814,UCBPlayer,126,126,252,7,85,Tie
5815,UCBPlayer,111,351,462,28,22,UCBPlayer
5816,UCBPlayer,116,126,242,3,87,UCBPlayer
5817,UCBPlayer,122,347,469,32,21,UCBPlayer
5818,UCBPlayer,107,132,239,0,87,UCBPlayer
5819,UCBPlayer,132,337,469,35,22,UCBPlayer
5820,UCBPlayer,103,148,251,0,83,UCBPlayer
5821,UCBPlayer,136,321,457,35,26,UCBPlayer
5822,UCBPlayer,99,164,263,0,79,UCBPlayer
5823,UCBPlayer,140,305,445,35,30,UCBPlayer
5824,UCBPlayer,95,180,275,0,75,UCBPlayer
5825,UCBPlayer,144,289,433,35,34,UCBPlayer
5826,UCBPlayer,91,196,287,0,71,UCBPlayer
5827,UCBPlayer,148,273,421,35,38,UCBPlayer
5828,UCBPlayer,87,212,299,0,67,UCBPlayer
5829,UCBPlayer,152,257,409,35,42,UCBPlayer
5830,UCBPlayer,84,224,308,0,64,UCBPlayer
5831,UCBPlayer,146,251,397,32,45,UCBPlayer
5832,UCBPlayer,89,234,323,3,60,UCBPlayer
5833,UCBPlayer,138,243,381,28,49,UCBPlayer
5834,UCBPlayer,97,242,339,7,56,UCBPlayer
5835,UCBPlayer,130,235,365,24,53,UCBPlayer
5836,UCBPlayer,105,250,355,11,52,UCBPlayer
5837,UCBPlayer,122,227,349,20,57,UCBPlayer
5838,UCBPlayer,109,259,368,15,49,UCBPlayer
5839,UCBPlayer,118,218,336,16,60,UCBPlayer
5840,UCBPlayer,117,267,384,19,45,UCBPlayer
5841,UCBPlayer,110,210,320,12,64,UCBPlayer
5842,UCBPlayer,126,271,397,23,42,UCBPlayer
5843,UCBPlayer,105,210,315,10,65,UCBPlayer
5844,UCBPlayer,130,275,405,25,40,UCBPlayer
5845,UCBPlayer,105,210,315,10,65,UCBPlayer
5846,UCBPlayer,130,275,405,25,40,UCBPlayer
5847,UCBPlayer,106,206,312,10,66,UCBPlayer
5848,UCBPlayer,130,275,405,25,40,UCBPlayer
5849,UCBPlayer,105,210,315,10,65,UCBPlayer
5850,UCBPlayer,131,271,402,25,41,UCBPlayer
5851,UCBPlayer,105,210,315,10,65,UCBPlayer
5852,UCBPlayer,130,275,405,25,40,UCBPlayer
5853,UCBPlayer,105,210,315,10,65,UCBPlayer
5854,UCBPlayer,130,275,405,25,40,UCBPlayer
5855,UCBPlayer,103,203,306,10,68,UCBPlayer
5856,UCBPlayer,128,283,411,25,38,UCBPlayer
5857,UCBPlayer,111,186,297,10,71,UCBPlayer
5858,UCBPlayer,124,299,423,25,34,UCBPlayer
5859,UCBPlayer,115,170,285,10,75,UCBPlayer
5860,UCBPlayer,120,315,435,25,30,UCBPlayer
5861,UCBPlayer,119,154,273,10,79,UCBPlayer
5862,UCBPlayer,112,332,444,25,27,UCBPlayer
5863,UCBPlayer,127,137,264,10,82,UCBPlayer
5864,UCBPlayer,104,349,453,25,24,UCBPlayer
5865,UCBPlayer,126,126,252,7,85,Tie
5866,UCBPlayer,111,351,462,28,22,UCBPlayer
5867,UCBPlayer,116,126,242,3,87,UCBPlayer
5868,UCBPlayer,122,347,469,32,21,UCBPlayer
5869,UCBPlayer,107,132,239,0,87,UCBPlayer
5870,UCBPlayer,132,337,469,35,22,UCBPlayer
5871,UCBPlayer,103,148,251,0,83,UCBPlayer
5872,UCBPlayer,136,321,457,35,26,UCBPlayer
5873,UCBPlayer,99,164,263,0,79,UCBPlayer
5874,UCBPlayer,140,305,445,35,30,UCBPlayer
5875,UCBPlayer,95,180,275,0,75,UCBPlayer
5876,UCBPlayer,144,289,433,35,34,UCBPlayer
5877,UCBPlayer,91,196,287,0,71,UCBPlayer
5878,UCBPlayer,148,273,421,35,38,UCBPlayer
5879,UCBPlayer,87,212,299,0,67,UCBPlayer
5880,UCBPlayer,152,257,409,35,42,UCBPlayer
5881,UCBPlayer,84,224,308,0,64,UCBPlayer
5882,UCBPlayer,146,251,397,32,45,UCBPlayer
5883,UCBPlayer,89,234,323,3,60,UCBPlayer
5884,UCBPlayer,138,243,381,28,49,UCBPlayer
5885,UCBPlayer,97,242,339,7,56,UCBPlayer
5886,UCBPlayer,130,235,365,24,53,UCBPlayer
5887,UCBPlayer,105,250,355,11,52,UCBPlayer
5888,UCBPlayer,122,227,349,20,57,UCBPlayer
5889,UCBPlayer,109,259,368,15,49,UCBPlayer
5890,UCBPlayer,118,218,336,16,60,UCBPlayer
5891,UCBPlayer,117,267,384,19,45,UCBPlayer
5892,UCBPlayer,110,210,320,12,64,UCBPlayer
5893,UCBPlayer,126,271,397,23,42,UCBPlayer
5894,UCBPlayer,105,210,315,10,65,UCBPlayer
5895,UCBPlayer,130,275,405,25,40,UCBPlayer
5896,UCBPlayer,105,210,315,10,65,UCBPlayer
5897,UCBPlayer,130,275,405,25,40,UCBPlayer
5898,UCBPlayer,106,206,312,10,66,UCBPlayer
5899,UCBPlayer,130,275,405,25,40,UCBPlayer
5900,UCBPlayer,105,210,315,10,65,UCBPlayer
5901,UCBPlayer,131,271,402,25,41,UCBPlayer
5902,UCBPlayer,105,210,315,10,65,UCBPlayer
5903,UCBPlayer,130,275,405,25,40,UCBPlayer
5904,UCBPlayer,105,210,315,10,65,UCBPlayer
5905,UCBPlayer,130,275,405,25,40,UCBPlayer
5906,UCBPlayer,103,203,306,10,68,UCBPlayer
5907,UCBPlayer,128,283,411,25,38,UCBPlayer
5908,UCBPlayer,111,186,297,10,71,UCBPlayer
5909,UCBPlayer,124,299,423,25,34,UCBPlayer
5910,UCBPlayer,115,170,285,10,75,UCBPlayer
5911,UCBPlayer,120,315,435,25,30,UCBPlayer
5912,UCBPlayer,119,154,273,10,79,UCBPlayer
5913,UCBPlayer,112,332,444,25,27,UCBPlayer
5914,UCBPlayer,127,137,264,10,82,UCBPlayer
5915,UCBPlayer,104,349,453,25,24,UCBPlayer
5916,UCBPlayer,126,126,252,7,85,Tie
5917,UCBPlayer,111,351,462,28,22,UCBPlayer
5918,UCBPlayer,116,126,242,3,87,UCBPlayer
5919,UCBPlayer,122,347,469,32,21,UCBPlayer
5920,UCBPlayer,107,132,239,0,87,UCBPlayer
5921,UCBPlayer,132,337,469,35,22,UCBPlayer
5922,UCBPlayer,103,148,251,0,83,UCBPlayer
5923,UCBPlayer,136,321,457,35,26,UCBPlayer
5924,UCBPlayer,99,164,263,0,79,UCBPlayer
5925,UCBPlayer,140,305,445,35,30,UCBPlayer
5926,UCBPlayer,95,180,275,0,75,UCBPlayer
5927,UCBPlayer,144,289,433,35,34,UCBPlayer
5928,UCBPlayer,91,196,287,0,71,UCBPlayer
5929,UCBPlayer,148,273,421,35,38,UCBPlayer
5930,UCBPlayer,87,212,299,0,67,UCBPlayer
5931,UCBPlayer,152,257,409,35,42,UCBPlayer
5932,UCBPlayer,84,224,308,0,64,UCBPlayer
5933,UCBPlayer,146,251,397,32,45,UCBPlayer
5934,UCBPlayer,89,234,323,3,60,UCBPlayer
5935,UCBPlayer,138,243,381,28,49,UCBPlayer
5936,UCBPlayer,97,242,339,7,56,UCBPlayer
5937,UCBPlayer,130,235,365,24,53,UCBPlayer
5938,UCBPlayer,105,250,355,11,52,UCBPlayer
5939,UCBPlayer,122,227,349,20,57,UCBPlayer
5940,UCBPlayer,109,259,368,15,49,UCBPlayer
5941,UCBPlayer,118,218,336,16,60,UCBPlayer
5942,UCBPlayer,117,267,384,19,45,UCBPlayer
5943,UCBPlayer,110,210,320,12,64,UCBPlayer
5944,UCBPlayer,126,271,397,23,42,UCBPlayer
5945,UCBPlayer,105,210,315,10,65,UCBPlayer
5946,UCBPlayer,130,275,405,25,40,UCBPlayer
5947,UCBPlayer,105,210,315,10,65,UCBPlayer
5948,UCBPlayer,130,275,405,25,40,UCBPlayer
5949,UCBPlayer,106,206,312,10,66,UCBPlayer
5950,UCBPlayer,130,275,405,25,40,UCBPlayer
5951,UCBPlayer,105,210,315,10,65,UCBPlayer
5952,UCBPlayer,131,271,402,25,41,UCBPlayer
5953,UCBPlayer,105,210,315,10,65,UCBPlayer
5954,UCBPlayer,130,275,405,25,40,UCBPlayer
5955,UCBPlayer,105,210,315,10,65,UCBPlayer
5956,UCBPlayer,130,275,405,25,40,UCBPlayer
5957,UCBPlayer,103,203,306,10,68,UCBPlayer
5958,UCBPlayer,128,283,411,25,38,UCBPlayer
5959,UCBPlayer,111,186,297,10,71,UCBPlayer
5960,UCBPlayer,124,299,423,25,34,UCBPlayer
5961,UCBPlayer,115,170,285,10,75,UCBPlayer
5962,UCBPlayer,120,315,435,25,30,UCBPlayer
5963,UCBPlayer,119,154,273,10,79,UCBPlayer
5964,UCBPlayer,112,332,444,25,27,UCBPlayer
5965,UCBPlayer,127,137,264,10,82,UCBPlayer
5966,UCBPlayer,104,349,453,25,24,UCBPlayer
5967,UCBPlayer,126,126,252,7,85,Tie
5968,UCBPlayer,111,351,462,28,22,UCBPlayer
5969,UCBPlayer,116,126,242,3,87,UCBPlayer
5970,UCBPlayer,122,347,469,32,21,UCBPlayer
5971,UCBPlayer,107,132,239,0,87,UCBPlayer
5972,UCBPlayer,132,337,469,35,22,UCBPlayer
5973,UCBPlayer,103,148,251,0,83,UCBPlayer
5974,UCBPlayer,136,321,457,35,26,UCBPlayer
5975,UCBPlayer,99,164,263,0,79,UCBPlayer
5976,UCBPlayer,140,305,445,35,30,UCBPlayer
5977,UCBPlayer,95,180,275,0,75,UCBPlayer
5978,UCBPlayer,144,289,433,35,34,UCBPlayer
5979,UCBPlayer,91,196,287,0,71,UCBPlayer
5980,UCBPlayer,148,273,421,35,38,UCBPlayer
5981,UCBPlayer,87,212,299,0,67,UCBPlayer
5982,UCBPlayer,152,257,409,35,42,UCBPlayer
5983,UCBPlayer,84,224,308,0,64,UCBPlayer
5984,UCBPlayer,146,251,397,32,45,UCBPlayer
5985,UCBPlayer,89,234,323,3,60,UCBPlayer
5986,UCBPlayer,138,243,381,28,49,UCBPlayer
5987,UCBPlayer,97,242,339,7,56,UCBPlayer
5988,UCBPlayer,130,235,365,24,53,UCBPlayer
5989,UCBPlayer,105,250,355,11,52,UCBPlayer
5990,UCBPlayer,122,227,349,20,57,UCBPlayer
5991,UCBPlayer,109,259,368,15,49,UCBPlayer
5992,UCBPlayer,118,218,336,16,60,UCBPlayer
5993,UCBPlayer,117,267,384,19,45,UCBPlayer
5994,UCBPlayer,110,210,320,12,64,UCBPlayer
5995,UCBPlayer,126,271,397,23,42,UCBPlayer
5996,UCBPlayer,105,210,315,10,65,UCBPlayer
5997,UCBPlayer,130,275,405,25,40,UCBPlayer
5998,UCBPlayer,105,210,315,10,65,UCBPlayer
5999,UCBPlayer,130,275,405,25,40,UCBPlayer
6000,UCBPlayer,106,206,312,10,66,UCBPlayer
6001,UCBPlayer,130,275,405,25,40,UCBPlayer
6002,UCBPlayer,105,210,315,10,65,UCBPlayer
6003,UCBPlayer,131,271,402,25,41,UCBPlayer
6004,UCBPlayer,105,210,315,10,65,UCBPlayer
6005,UCBPlayer,130,275,405,25,40,UCBPlayer
6006,UCBPlayer,105,210,315,10,65,UCBPlayer
6007,UCBPlayer,130,275,405,25,40,UCBPlayer
6008,UCBPlayer,103,203,306,10,68,UCBPlayer
6009,UCBPlayer,128,283,411,25,38,UCBPlayer
6010,UCBPlayer,111,186,297,10,71,UCBPlayer
6011,UCBPlayer,124,299,423,25,34,UCBPlayer
6012,UCBPlayer,115,170,285,10,75,UCBPlayer
6013,UCBPlayer,120,315,435,25,30,UCBPlayer
6014,UCBPlayer,119,154,273,10,79,UCBPlayer
6015,UCBPlayer,112,332,444,25,27,UCBPlayer
6016,UCBPlayer,127,137,264,10,82,UCBPlayer
6017,UCBPlayer,104,349,453,25,24,UCBPlayer
6018,UCBPlayer,126,126,252,7,85,Tie
6019,UCBPlayer,111,351,462,28,22,UCBPlayer
6020,UCBPlayer,116,126,242,3,87,UCBPlayer
6021,UCBPlayer,122,347,469,32,21,UCBPlayer
6022,UCBPlayer,107,132,239,0,87,UCBPlayer
6023,UCBPlayer,132,337,469,35,22,UCBPlayer
6024,UCBPlayer,103,148,251,0,83,UCBPlayer
6025,UCBPlayer,136,321,457,35,26,UCBPlayer
6026,UCBPlayer,99,164,263,0,79,UCBPlayer
6027,UCBPlayer,140,305,445,35,30,UCBPlayer
6028,UCBPlayer,95,180,275,0,75,UCBPlayer
6029,UCBPlayer,144,289,433,35,34,UCBPlayer
6030,UCBPlayer,91,196,287,0,71,UCBPlayer
6031,UCBPlayer,148,273,421,35,38,UCBPlayer
6032,UCBPlayer,87,212,299,0,67,UCBPlayer
6033,UCBPlayer,152,257,409,35,42,UCBPlayer
6034,UCBPlayer,84,224,308,0,64,UCBPlayer
6035,UCBPlayer,146,251,397,32,45,UCBPlayer
6036,UCBPlayer,89,234,323,3,60,UCBPlayer
6037,UCBPlayer,138,243,381,28,49,UCBPlayer
6038,UCBPlayer,97,242,339,7,56,UCBPlayer
6039,UCBPlayer,130,235,365,24,53,UCBPlayer
6040,UCBPlayer,105,250,355,11,52,UCBPlayer
6041,UCBPlayer,122,227,349,20,57,UCBPlayer
6042,UCBPlayer,109,259,368,15,49,UCBPlayer
6043,UCBPlayer,118,218,336,16,60,UCBPlayer
6044,UCBPlayer,117,267,384,19,45,UCBPlayer
6045,UCBPlayer,110,210,320,12,64,UCBPlayer
6046,UCBPlayer,126,271,397,23,42,UCBPlayer
6047,UCBPlayer,105,210,315,10,65,UCBPlayer
6048,UCBPlayer,130,275,405,25,40,UCBPlayer
6049,UCBPlayer,105,210,315,10,65,UCBPlayer
6050,UCBPlayer,130,275,405,25,40,UCBPlayer
6051,UCBPlayer,106,206,312,10,66,UCBPlayer
6052,UCBPlayer,130,275,405,25,40,UCBPlayer
6053,UCBPlayer,105,210,315,10,65,UCBPlayer
6054,UCBPlayer,131,271,402,25,41,UCBPlayer
6055,UCBPlayer,105,210,315,10,65,UCBPlayer
6056,UCBPlayer,130,275,405,25,40,UCBPlayer
6057,UCBPlayer,105,210,315,10,65,UCBPlayer
6058,UCBPlayer,130,275,405,25,40,UCBPlayer
6059,UCBPlayer,103,203,306,10,68,UCBPlayer
6060,UCBPlayer,128,283,411,25,38,UCBPlayer
6061,UCBPlayer,111,186,297,10,71,UCBPlayer
6062,UCBPlayer,124,299,423,25,34,UCBPlayer
6063,UCBPlayer,115,170,285,10,75,UCBPlayer
6064,UCBPlayer,120,315,435,25,30,UCBPlayer
6065,UCBPlayer,119,154,273,10,79,UCBPlayer
6066,UCBPlayer,112,332,444,25,27,UCBPlayer
6067,UCBPlayer,127,137,264,10,82,UCBPlayer
6068,UCBPlayer,104,349,453,25,24,UCBPlayer
6069,UCBPlayer,126,126,252,7,85,Tie
6070,UCBPlayer,111,351,462,28,22,UCBPlayer
6071,UCBPlayer,116,126,242,3,87,UCBPlayer
6072,UCBPlayer,122,347,469,32,21,UCBPlayer
6073,UCBPlayer,107,132,239,0,87,UCBPlayer
6074,UCBPlayer,132,337,469,35,22,UCBPlayer
6075,UCBPlayer,103,148,251,0,83,UCBPlayer
6076,UCBPlayer,136,321,457,35,26,UCBPlayer
6077,UCBPlayer,99,164,263,0,79,UCBPlayer
6078,UCBPlayer,140,305,445,35,30,UCBPlayer
6079,UCBPlayer,95,180,275,0,75,UCBPlayer
6080,UCBPlayer,144,289,433,35,34,UCBPlayer
6081,UCBPlayer,91,196,287,0,71,UCBPlayer
6082,UCBPlayer,148,273,421,35,38,UCBPlayer
6083,UCBPlayer,87,212,299,0,67,UCBPlayer
6084,UCBPlayer,152,257,409,35,42,UCBPlayer
6085,UCBPlayer,84,224,308,0,64,UCBPlayer
6086,UCBPlayer,146,251,397,32,45,UCBPlayer
6087,UCBPlayer,89,234,323,3,60,UCBPlayer
6088,UCBPlayer,138,243,381,28,49,UCBPlayer
6089,UCBPlayer,97,242,339,7,56,UCBPlayer
6090,UCBPlayer,130,235,365,24,53,UCBPlayer
6091,UCBPlayer,105,250,355,11,52,UCBPlayer
6092,UCBPlayer,122,227,349,20,57,UCBPlayer
6093,UCBPlayer,109,259,368,15,49,UCBPlayer
6094,UCBPlayer,118,218,336,16,60,UCBPlayer
6095,UCBPlayer,117,267,384,19,45,UCBPlayer
6096,UCBPlayer,110,210,320,12,64,UCBPlayer
6097,UCBPlayer,126,271,397,23,42,UCBPlayer
6098,UCBPlayer,105,210,315,10,65,UCBPlayer
6099,UCBPlayer,130,275,405,25,40,UCBPlayer
6100,UCBPlayer,105,210,315,10,65,UCBPlayer
6101,UCBPlayer,130,275,405,25,40,UCBPlayer
6102,UCBPlayer,106,206,312,10,66,UCBPlayer
6103,UCBPlayer,130,275,405,25,40,UCBPlayer
6104,UCBPlayer,105,210,315,10,65,UCBPlayer
6105,UCBPlayer,131,271,402,25,41,UCBPlayer
6106,UCBPlayer,105,210,315,10,65,UCBPlayer
6107,UCBPlayer,130,275,405,25,40,UCBPlayer
6108,UCBPlayer,105,210,315,10,65,UCBPlayer
6109,UCBPlayer,130,275,405,25,40,UCBPlayer
6110,UCBPlayer,103,203,306,10,68,UCBPlayer
6111,UCBPlayer,128,283,411,25,38,UCBPlayer
6112,UCBPlayer,111,186,297,10,71,UCBPlayer
6113,UCBPlayer,124,299,423,25,34,UCBPlayer
6114,UCBPlayer,115,170,285,10,75,UCBPlayer
6115,UCBPlayer,120,315,435,25,30,UCBPlayer
6116,UCBPlayer,119,154,273,10,79,UCBPlayer
6117,UCBPlayer,112,332,444,25,27,UCBPlayer
6118,UCBPlayer,127,137,264,10,82,UCBPlayer
6119,UCBPlayer,104,349,453,25,24,UCBPlayer
6120,UCBPlayer,126,126,252,7,85,Tie
6121,UCBPlayer,111,351,462,28,22,UCBPlayer
6122,UCBPlayer,116,126,242,3,87,UCBPlayer
6123,UCBPlayer,122,347,469,32,21,UCBPlayer
6124,UCBPlayer,107,132,239,0,87,UCBPlayer
6125,UCBPlayer,132,337,469,35,22,UCBPlayer
6126,UCBPlayer,103,148,251,0,83,UCBPlayer
6127,UCBPlayer,136,321,457,35,26,UCBPlayer
6128,UCBPlayer,99,164,263,0,79,UCBPlayer
6129,UCBPlayer,140,305,445,35,30,UCBPlayer
6130,UCBPlayer,95,180,275,0,75,UCBPlayer
6131,UCBPlayer,144,289,433,35,34,UCBPlayer
6132,UCBPlayer,91,196,287,0,71,UCBPlayer
6133,UCBPlayer,148,273,421,35,38,UCBPlayer
6134,UCBPlayer,87,212,299,0,67,UCBPlayer
6135,UCBPlayer,152,257,409,35,42,UCBPlayer
6136,UCBPlayer,84,224,308,0,64,UCBPlayer
6137,UCBPlayer,146,251,397,32,45,UCBPlayer
6138,UCBPlayer,89,234,323,3,60,UCBPlayer
6139,UCBPlayer,138,243,381,28,49,UCBPlayer
6140,UCBPlayer,97,242,339,7,56,UCBPlayer
6141,UCBPlayer,130,235,365,24,53,UCBPlayer
6142,UCBPlayer,105,250,355,11,52,UCBPlayer
6143,UCBPlayer,122,227,349,20,57,UCBPlayer
6144,UCBPlayer,109,259,368,15,49,UCBPlayer
6145,UCBPlayer,118,218,336,16,60,UCBPlayer
6146,UCBPlayer,117,267,384,19,45,UCBPlayer
6147,UCBPlayer,110,210,320,12,64,UCBPlayer
6148,UCBPlayer,126,271,397,23,42,UCBPlayer
6149,UCBPlayer,105,210,315,10,65,UCBPlayer
6150,UCBPlayer,130,275,405,25,40,UCBPlayer
6151,UCBPlayer,105,210,315,10,65,UCBPlayer
6152,UCBPlayer,130,275,405,25,40,UCBPlayer
6153,UCBPlayer,106,206,312,10,66,UCBPlayer
6154,UCBPlayer,130,275,405,25,40,UCBPlayer
6155,UCBPlayer,105,210,315,10,65,UCBPlayer
6156,UCBPlayer,131,271,402,25,41,UCBPlayer
6157,UCBPlayer,105,210,315,10,65,UCBPlayer
6158,UCBPlayer,130,275,405,25,40,UCBPlayer
6159,UCBPlayer,105,210,315,10,65,UCBPlayer
6160,UCBPlayer,130,275,405,25,40,UCBPlayer
6161,UCBPlayer,103,203,306,10,68,UCBPlayer
6162,UCBPlayer,128,283,411,25,38,UCBPlayer
6163,UCBPlayer,111,186,297,10,71,UCBPlayer
6164,UCBPlayer,124,299,423,25,34,UCBPlayer
6165,UCBPlayer,115,170,285,10,75,UCBPlayer
6166,UCBPlayer,120,315,435,25,30,UCBPlayer
6167,UCBPlayer,119,154,273,10,79,UCBPlayer
6168,UCBPlayer,112,332,444,25,27,UCBPlayer
6169,UCBPlayer,127,137,264,10,82,UCBPlayer
6170,UCBPlayer,104,349,453,25,24,UCBPlayer
6171,UCBPlayer,126,126,252,7,85,Tie
6172,UCBPlayer,111,351,462,28,22,UCBPlayer
6173,UCBPlayer,116,126,242,3,87,UCBPlayer
6174,UCBPlayer,122,347,469,32,21,UCBPlayer
6175,UCBPlayer,107,132,239,0,87,UCBPlayer
6176,UCBPlayer,132,337,469,35,22,UCBPlayer
6177,UCBPlayer,103,148,251,0,83,UCBPlayer
6178,UCBPlayer,136,321,457,35,26,UCBPlayer
6179,UCBPlayer,99,164,263,0,79,UCBPlayer
6180,UCBPlayer,140,305,445,35,30,UCBPlayer
6181,UCBPlayer,95,180,275,0,75,UCBPlayer
6182,UCBPlayer,144,289,433,35,34,UCBPlayer
6183,UCBPlayer,91,196,287,0,71,UCBPlayer
6184,UCBPlayer,148,273,421,35,38,UCBPlayer
6185,UCBPlayer,87,212,299,0,67,UCBPlayer
6186,UCBPlayer,152,257,409,35,42,UCBPlayer
6187,UCBPlayer,84,224,308,0,64,UCBPlayer
6188,UCBPlayer,146,251,397,32,45,UCBPlayer
6189,UCBPlayer,89,234,323,3,60,UCBPlayer
6190,UCBPlayer,138,243,381,28,49,UCBPlayer
6191,UCBPlayer,97,242,339,7,56,UCBPlayer
6192,UCBPlayer,130,235,365,24,53,UCBPlayer
6193,UCBPlayer,105,250,355,11,52,UCBPlayer
6194,UCBPlayer,122,227,349,20,57,UCBPlayer
6195,UCBPlayer,109,259,368,15,49,UCBPlayer
6196,UCBPlayer,118,218,336,16,60,UCBPlayer
6197,UCBPlayer,117,267,384,19,45,UCBPlayer
6198,UCBPlayer,110,210,320,12,64,UCBPlayer
6199,UCBPlayer,126,271,397,23,42,UCBPlayer
6200,UCBPlayer,105,210,315,10,65,UCBPlayer
6201,UCBPlayer,130,275,405,25,40,UCBPlayer
6202,UCBPlayer,105,210,315,10,65,UCBPlayer
6203,UCBPlayer,130,275,405,25,40,UCBPlayer
6204,UCBPlayer,106,206,312,10,66,UCBPlayer
6205,UCBPlayer,130,275,405,25,40,UCBPlayer
6206,UCBPlayer,105,210,315,10,65,UCBPlayer
6207,UCBPlayer,131,271,402,25,41,UCBPlayer
6208,UCBPlayer,105,210,315,10,65,UCBPlayer
6209,UCBPlayer,130,275,405,25,40,UCBPlayer
6210,UCBPlayer,105,210,315,10,65,UCBPlayer
6211,UCBPlayer,130,275,405,25,40,UCBPlayer
6212,UCBPlayer,103,203,306,10,68,UCBPlayer
6213,UCBPlayer,128,283,411,25,38,UCBPlayer
6214,UCBPlayer,111,186,297,10,71,UCBPlayer
6215,UCBPlayer,124,299,423,25,34,UCBPlayer
6216,UCBPlayer,115,170,285,10,75,UCBPlayer
6217,UCBPlayer,120,315,435,25,30,UCBPlayer
6218,UCBPlayer,119,154,273,10,79,UCBPlayer
6219,UCBPlayer,112,332,444,25,27,UCBPlayer
6220,UCBPlayer,127,137,264,10,82,UCBPlayer
6221,UCBPlayer,104,349,453,25,24,UCBPlayer
6222,UCBPlayer,126,126,252,7,85,Tie
6223,UCBPlayer,111,351,462,28,22,UCBPlayer
6224,UCBPlayer,116,126,242,3,87,UCBPlayer
6225,UCBPlayer,122,347,469,32,21,UCBPlayer
6226,UCBPlayer,107,132,239,0,87,UCBPlayer
6227,UCBPlayer,132,337,469,35,22,UCBPlayer
6228,UCBPlayer,103,148,251,0,83,UCBPlayer
6229,UCBPlayer,136,321,457,35,26,UCBPlayer
6230,UCBPlayer,99,164,263,0,79,UCBPlayer
6231,UCBPlayer,140,305,445,35,30,UCBPlayer
6232,UCBPlayer,95,180,275,0,75,UCBPlayer
6233,UCBPlayer,144,289,433,35,34,UCBPlayer
6234,UCBPlayer,91,196,287,0,71,UCBPlayer
6235,UCBPlayer,148,273,421,35,38,UCBPlayer
6236,UCBPlayer,87,212,299,0,67,UCBPlayer
6237,UCBPlayer,152,257,409,35,42,UCBPlayer
6238,UCBPlayer,84,224,308,0,64,UCBPlayer
6239,UCBPlayer,146,251,397,32,45,UCBPlayer
6240,UCBPlayer,89,234,323,3,60,UCBPlayer
6241,UCBPlayer,138,243,381,28,49,UCBPlayer
6242,UCBPlayer,97,242,339,7,56,UCBPlayer
6243,UCBPlayer,130,235,365,24,53,UCBPlayer
6244,UCBPlayer,105,250,355,11,52,UCBPlayer
6245,UCBPlayer,122,227,349,20,57,UCBPlayer
6246,UCBPlayer,109,259,368,15,49,UCBPlayer
6247,UCBPlayer,118,218,336,16,60,UCBPlayer
6248,UCBPlayer,117,267,384,19,45,UCBPlayer
6249,UCBPlayer,110,210,320,12,64,UCBPlayer
6250,UCBPlayer,126,271,397,23,42,UCBPlayer
6251,UCBPlayer,105,210,315,10,65,UCBPlayer
6252,UCBPlayer,130,275,405,25,40,UCBPlayer
6253,UCBPlayer,105,210,315,10,65,UCBPlayer
6254,UCBPlayer,130,275,405,25,40,UCBPlayer
6255,UCBPlayer,106,206,312,10,66,UCBPlayer
6256,UCBPlayer,130,275,405,25,40,UCBPlayer
6257,UCBPlayer,105,210,315,10,65,UCBPlayer
6258,UCBPlayer,131,271,402,25,41,UCBPlayer
6259,UCBPlayer,105,210,315,10,65,UCBPlayer
6260,UCBPlayer,130,275,405,25,40,UCBPlayer
6261,UCBPlayer,105,210,315,10,65,UCBPlayer
6262,UCBPlayer,130,275,405,25,40,UCBPlayer
6263,UCBPlayer,103,203,306,10,68,UCBPlayer
6264,UCBPlayer,128,283,411,25,38,UCBPlayer
6265,UCBPlayer,111,186,297,10,71,UCBPlayer
6266,UCBPlayer,124,299,423,25,34,UCBPlayer
6267,UCBPlayer,115,170,285,10,75,UCBPlayer
6268,UCBPlayer,120,315,435,25,30,UCBPlayer
6269,UCBPlayer,119,154,273,10,79,UCBPlayer
6270,UCBPlayer,112,332,444,25,27,UCBPlayer
6271,UCBPlayer,127,137,264,10,82,UCBPlayer
6272,UCBPlayer,104,349,453,25,24,UCBPlayer
6273,UCBPlayer,126,126,252,7,85,Tie
6274,UCBPlayer,111,351,462,28,22,UCBPlayer
6275,UCBPlayer,116,126,242,3,87,UCBPlayer
6276,UCBPlayer,122,347,469,32,21,UCBPlayer
6277,UCBPlayer,107,132,239,0,87,UCBPlayer
6278,UCBPlayer,132,337,469,35,22,UCBPlayer
6279,UCBPlayer,103,148,251,0,83,UCBPlayer
6280,UCBPlayer,136,321,457,35,26,UCBPlayer
6281,UCBPlayer,99,164,263,0,79,UCBPlayer
6282,UCBPlayer,140,305,445,35,30,UCBPlayer
6283,UCBPlayer,95,180,275,0,75,UCBPlayer
6284,UCBPlayer,144,289,433,35,34,UCBPlayer
6285,UCBPlayer,91,196,287,0,71,UCBPlayer
6286,UCBPlayer,148,273,421,35,38,UCBPlayer
6287,UCBPlayer,87,212,299,0,67,UCBPlayer
6288,UCBPlayer,152,257,409,35,42,UCBPlayer
6289,UCBPlayer,84,224,308,0,64,UCBPlayer
6290,UCBPlayer,146,251,397,32,45,UCBPlayer
6291,UCBPlayer,89,234,323,3,60,UCBPlayer
6292,UCBPlayer,138,243,381,28,49,UCBPlayer
6293,UCBPlayer,97,242,339,7,56,UCBPlayer
6294,UCBPlayer,130,235,365,24,53,UCBPlayer
6295,UCBPlayer,105,250,355,11,52,UCBPlayer
6296,UCBPlayer,122,227,349,20,57,UCBPlayer
6297,UCBPlayer,109,259,368,15,49,UCBPlayer
6298,UCBPlayer,118,218,336,16,60,UCBPlayer
6299,UCBPlayer,117,267,384,19,45,UCBPlayer
6300,UCBPlayer,110,210,320,12,64,UCBPlayer
6301,UCBPlayer,126,271,397,23,42,UCBPlayer
6302,UCBPlayer,105,210,315,10,65,UCBPlayer
6303,UCBPlayer,130,275,405,25,40,UCBPlayer
6304,UCBPlayer,105,210,315,10,65,UCBPlayer
6305,UCBPlayer,130,275,405,25,40,UCBPlayer
6306,UCBPlayer,106,206,312,10,66,UCBPlayer
6307,UCBPlayer,130,275,405,25,40,UCBPlayer
6308,UCBPlayer,105,210,315,10,65,UCBPlayer
6309,UCBPlayer,131,271,402,25,41,UCBPlayer
6310,UCBPlayer,105,210,315,10,65,UCBPlayer
6311,UCBPlayer,130,275,405,25,40,UCBPlayer
6312,UCBPlayer,105,210,315,10,65,UCBPlayer
6313,UCBPlayer,130,275,405,25,40,UCBPlayer
6314,UCBPlayer,103,203,306,10,68,UCBPlayer
6315,UCBPlayer,128,283,411,25,38,UCBPlayer
6316,UCBPlayer,111,186,297,10,71,UCBPlayer
6317,UCBPlayer,124,299,423,25,34,UCBPlayer
6318,UCBPlayer,115,170,285,10,75,UCBPlayer
6319,UCBPlayer,120,315,435,25,30,UCBPlayer
6320,UCBPlayer,119,154,273,10,79,UCBPlayer
6321,UCBPlayer,112,332,444,25,27,UCBPlayer
6322,UCBPlayer,127,137,264,10,82,UCBPlayer
6323,UCBPlayer,104,349,453,25,24,UCBPlayer
6324,UCBPlayer,126,126,252,7,85,Tie
6325,UCBPlayer,111,351,462,28,22,UCBPlayer
6326,UCBPlayer,116,126,242,3,87,UCBPlayer
6327,UCBPlayer,122,347,469,32,21,UCBPlayer
6328,UCBPlayer,107,132,239,0,87,UCBPlayer
6329,UCBPlayer,132,337,469,35,22,UCBPlayer
6330,UCBPlayer,103,148,251,0,83,UCBPlayer
6331,UCBPlayer,136,321,457,35,26,UCBPlayer
6332,UCBPlayer,99,164,263,0,79,UCBPlayer
6333,UCBPlayer,140,305,445,35,30,UCBPlayer
6334,UCBPlayer,95,180,275,0,75,UCBPlayer
6335,UCBPlayer,144,289,433,35,34,UCBPlayer
6336,UCBPlayer,91,196,287,0,71,UCBPlayer
6337,UCBPlayer,148,273,421,35,38,UCBPlayer
6338,UCBPlayer,87,212,299,0,67,UCBPlayer
6339,UCBPlayer,152,257,409,35,42,UCBPlayer
6340,UCBPlayer,84,224,308,0,64,UCBPlayer
6341,UCBPlayer,146,251,397,32,45,UCBPlayer
6342,UCBPlayer,89,234,323,3,60,UCBPlayer
6343,UCBPlayer,138,243,381,28,49,UCBPlayer
6344,UCBPlayer,97,242,339,7,56,UCBPlayer
6345,UCBPlayer,130,235,365,24,53,UCBPlayer
6346,UCBPlayer,105,250,355,11,52,UCBPlayer
6347,UCBPlayer,122,227,349,20,57,UCBPlayer
6348,UCBPlayer,109,259,368,15,49,UCBPlayer
6349,UCBPlayer,118,218,336,16,60,UCBPlayer
6350,UCBPlayer,117,267,384,19,45,UCBPlayer
6351,UCBPlayer,110,210,320,12,64,UCBPlayer
6352,UCBPlayer,126,271,397,23,42,UCBPlayer
6353,UCBPlayer,105,210,315,10,65,UCBPlayer
6354,UCBPlayer,130,275,405,25,40,UCBPlayer
6355,UCBPlayer,105,210,315,10,65,UCBPlayer
6356,UCBPlayer,130,275,405,25,40,UCBPlayer
6357,UCBPlayer,106,206,312,10,66,UCBPlayer
6358,UCBPlayer,130,275,405,25,40,UCBPlayer
6359,UCBPlayer,105,210,315,10,65,UCBPlayer
6360,UCBPlayer,131,271,402,25,41,UCBPlayer
6361,UCBPlayer,105,210,315,10,65,UCBPlayer
6362,UCBPlayer,130,275,405,25,40,UCBPlayer
6363,UCBPlayer,105,210,315,10,65,UCBPlayer
6364,UCBPlayer,130,275,405,25,40,UCBPlayer
6365,UCBPlayer,103,203,306,10,68,UCBPlayer
6366,UCBPlayer,128,283,411,25,38,UCBPlayer
6367,UCBPlayer,111,186,297,10,71,UCBPlayer
6368,UCBPlayer,124,299,423,25,34,UCBPlayer
6369,UCBPlayer,115,170,285,10,75,UCBPlayer
6370,UCBPlayer,120,315,435,25,30,UCBPlayer
6371,UCBPlayer,119,154,273,10,79,UCBPlayer
6372,UCBPlayer,112,332,444,25,27,UCBPlayer
6373,UCBPlayer,127,137,264,10,82,UCBPlayer
6374,UCBPlayer,104,349,453,25,24,UCBPlayer
6375,UCBPlayer,126,126,252,7,85,Tie
6376,UCBPlayer,111,351,462,28,22,UCBPlayer
6377,UCBPlayer,116,126,242,3,87,UCBPlayer
6378,UCBPlayer,122,347,469,32,21,UCBPlayer
6379,UCBPlayer,107,132,239,0,87,UCBPlayer
6380,UCBPlayer,132,337,469,35,22,UCBPlayer
6381,UCBPlayer,103,148,251,0,83,UCBPlayer
6382,UCBPlayer,136,321,457,35,26,UCBPlayer
6383,UCBPlayer,99,164,263,0,79,UCBPlayer
6384,UCBPlayer,140,305,445,35,30,UCBPlayer
6385,UCBPlayer,95,180,275,0,75,UCBPlayer
6386,UCBPlayer,144,289,433,35,34,UCBPlayer
6387,UCBPlayer,91,196,287,0,71,UCBPlayer
6388,UCBPlayer,148,273,421,35,38,UCBPlayer
6389,UCBPlayer,87,212,299,0,67,UCBPlayer
6390,UCBPlayer,152,257,409,35,42,UCBPlayer
6391,UCBPlayer,84,224,308,0,64,UCBPlayer
6392,UCBPlayer,146,251,397,32,45,UCBPlayer
6393,UCBPlayer,89,234,323,3,60,UCBPlayer
6394,UCBPlayer,138,243,381,28,49,UCBPlayer
6395,UCBPlayer,97,242,339,7,56,UCBPlayer
6396,UCBPlayer,130,235,365,24,53,UCBPlayer
6397,UCBPlayer,105,250,355,11,52,UCBPlayer
6398,UCBPlayer,122,227,349,20,57,UCBPlayer
6399,UCBPlayer,109,259,368,15,49,UCBPlayer
6400,UCBPlayer,118,218,336,16,60,UCBPlayer
6401,UCBPlayer,117,267,384,19,45,UCBPlayer
6402,UCBPlayer,110,210,320,12,64,UCBPlayer
6403,UCBPlayer,126,271,397,23,42,UCBPlayer
6404,UCBPlayer,105,210,315,10,65,UCBPlayer
6405,UCBPlayer,130,275,405,25,40,UCBPlayer
6406,UCBPlayer,105,210,315,10,65,UCBPlayer
6407,UCBPlayer,130,275,405,25,40,UCBPlayer
6408,UCBPlayer,106,206,312,10,66,UCBPlayer
6409,UCBPlayer,130,275,405,25,40,UCBPlayer
6410,UCBPlayer,105,210,315,10,65,UCBPlayer
6411,UCBPlayer,131,271,402,25,41,UCBPlayer
6412,UCBPlayer,105,210,315,10,65,UCBPlayer
6413,UCBPlayer,130,275,405,25,40,UCBPlayer
6414,UCBPlayer,105,210,315,10,65,UCBPlayer
6415,UCBPlayer,130,275,405,25,40,UCBPlayer
6416,UCBPlayer,103,203,306,10,68,UCBPlayer
6417,UCBPlayer,128,283,411,25,38,UCBPlayer
6418,UCBPlayer,111,186,297,10,71,UCBPlayer
6419,UCBPlayer,124,299,423,25,34,UCBPlayer
6420,UCBPlayer,115,170,285,10,75,UCBPlayer
6421,UCBPlayer,120,315,435,25,30,UCBPlayer
6422,UCBPlayer,119,154,273,10,79,UCBPlayer
6423,UCBPlayer,112,332,444,25,27,UCBPlayer
6424,UCBPlayer,127,137,264,10,82,UCBPlayer
6425,UCBPlayer,104,349,453,25,24,UCBPlayer
6426,UCBPlayer,126,126,252,7,85,Tie
6427,UCBPlayer,111,351,462,28,22,UCBPlayer
6428,UCBPlayer,116,126,242,3,87,UCBPlayer
6429,UCBPlayer,122,347,469,32,21,UCBPlayer
6430,UCBPlayer,107,132,239,0,87,UCBPlayer
6431,UCBPlayer,132,337,469,35,22,UCBPlayer
6432,UCBPlayer,103,148,251,0,83,UCBPlayer
6433,UCBPlayer,136,321,457,35,26,UCBPlayer
6434,UCBPlayer,99,164,263,0,79,UCBPlayer
6435,UCBPlayer,140,305,445,35,30,UCBPlayer
6436,UCBPlayer,95,180,275,0,75,UCBPlayer
6437,UCBPlayer,144,289,433,35,34,UCBPlayer
6438,UCBPlayer,91,196,287,0,71,UCBPlayer
6439,UCBPlayer,148,273,421,35,38,UCBPlayer
6440,UCBPlayer,87,212,299,0,67,UCBPlayer
6441,UCBPlayer,152,257,409,35,42,UCBPlayer
6442,UCBPlayer,84,224,308,0,64,UCBPlayer
6443,UCBPlayer,146,251,397,32,45,UCBPlayer
6444,UCBPlayer,89,234,323,3,60,UCBPlayer
6445,UCBPlayer,138,243,381,28,49,UCBPlayer
6446,UCBPlayer,97,242,339,7,56,UCBPlayer
6447,UCBPlayer,130,235,365,24,53,UCBPlayer
6448,UCBPlayer,105,250,355,11,52,UCBPlayer
6449,UCBPlayer,122,227,349,20,57,UCBPlayer
6450,UCBPlayer,109,259,368,15,49,UCBPlayer
6451,UCBPlayer,118,218,336,16,60,UCBPlayer
6452,UCBPlayer,117,267,384,19,45,UCBPlayer
6453,UCBPlayer,110,210,320,12,64,UCBPlayer
6454,UCBPlayer,126,271,397,23,42,UCBPlayer
6455,UCBPlayer,105,210,315,10,65,UCBPlayer
6456,UCBPlayer,130,275,405,25,40,UCBPlayer
6457,UCBPlayer,105,210,315,10,65,UCBPlayer
6458,UCBPlayer,130,275,405,25,40,UCBPlayer
6459,UCBPlayer,106,206,312,10,66,UCBPlayer
6460,UCBPlayer,130,275,405,25,40,UCBPlayer
6461,UCBPlayer,105,210,315,10,65,UCBPlayer
6462,UCBPlayer,131,271,402,25,41,UCBPlayer
6463,UCBPlayer,105,210,315,10,65,UCBPlayer
6464,UCBPlayer,130,275,405,25,40,UCBPlayer
6465,UCBPlayer,105,210,315,10,65,UCBPlayer
6466,UCBPlayer,130,275,405,25,40,UCBPlayer
6467,UCBPlayer,103,203,306,10,68,UCBPlayer
6468,UCBPlayer,128,283,411,25,38,UCBPlayer
6469,UCBPlayer,111,186,297,10,71,UCBPlayer
6470,UCBPlayer,124,299,423,25,34,UCBPlayer
6471,UCBPlayer,115,170,285,10,75,UCBPlayer
6472,UCBPlayer,120,315,435,25,30,UCBPlayer
6473,UCBPlayer,119,154,273,10,79,UCBPlayer
6474,UCBPlayer,112,332,444,25,27,UCBPlayer
6475,UCBPlayer,127,137,264,10,82,UCBPlayer
6476,UCBPlayer,104,349,453,25,24,UCBPlayer
6477,UCBPlayer,126,126,252,7,85,Tie
6478,UCBPlayer,111,351,462,28,22,UCBPlayer
6479,UCBPlayer,116,126,242,3,87,UCBPlayer
6480,UCBPlayer,122,347,469,32,21,UCBPlayer
6481,UCBPlayer,107,132,239,0,87,UCBPlayer
6482,UCBPlayer,132,337,469,35,22,UCBPlayer
6483,UCBPlayer,103,148,251,0,83,UCBPlayer
6484,UCBPlayer,136,321,457,35,26,UCBPlayer
6485,UCBPlayer,99,164,263,0,79,UCBPlayer
6486,UCBPlayer,140,305,445,35,30,UCBPlayer
6487,UCBPlayer,95,180,275,0,75,UCBPlayer
6488,UCBPlayer,144,289,433,35,34,UCBPlayer
6489,UCBPlayer,91,196,287,0,71,UCBPlayer
6490,UCBPlayer,148,273,421,35,38,UCBPlayer
6491,UCBPlayer,87,212,299,0,67,UCBPlayer
6492,UCBPlayer,152,257,409,35,42,UCBPlayer
6493,UCBPlayer,84,224,308,0,64,UCBPlayer
6494,UCBPlayer,146,251,397,32,45,UCBPlayer
6495,UCBPlayer,89,234,323,3,60,UCBPlayer
6496,UCBPlayer,138,243,381,28,49,UCBPlayer
6497,UCBPlayer,97,242,339,7,56,UCBPlayer
6498,UCBPlayer,130,235,365,24,53,UCBPlayer
6499,UCBPlayer,105,250,355,11,52,UCBPlayer
6500,UCBPlayer,122,227,349,20,57,UCBPlayer
6501,UCBPlayer,109,259,368,15,49,UCBPlayer
6502,UCBPlayer,118,218,336,16,60,UCBPlayer
6503,UCBPlayer,117,267,384,19,45,UCBPlayer
6504,UCBPlayer,110,210,320,12,64,UCBPlayer
6505,UCBPlayer,126,271,397,23,42,UCBPlayer
6506,UCBPlayer,105,210,315,10,65,UCBPlayer
6507,UCBPlayer,130,275,405,25,40,UCBPlayer
6508,UCBPlayer,105,210,315,10,65,UCBPlayer
6509,UCBPlayer,130,275,405,25,40,UCBPlayer
6510,UCBPlayer,106,206,312,10,66,UCBPlayer
6511,UCBPlayer,130,275,405,25,40,UCBPlayer
6512,UCBPlayer,105,210,315,10,65,UCBPlayer
6513,UCBPlayer,131,271,402,25,41,UCBPlayer
6514,UCBPlayer,105,210,315,10,65,UCBPlayer
6515,UCBPlayer,130,275,405,25,40,UCBPlayer
6516,UCBPlayer,105,210,315,10,65,UCBPlayer
6517,UCBPlayer,130,275,405,25,40,UCBPlayer
6518,UCBPlayer,103,203,306,10,68,UCBPlayer
6519,UCBPlayer,128,283,411,25,38,UCBPlayer
6520,UCBPlayer,111,186,297,10,71,UCBPlayer
6521,UCBPlayer,124,299,423,25,34,UCBPlayer
6522,UCBPlayer,115,170,285,10,75,UCBPlayer
6523,UCBPlayer,120,315,435,25,30,UCBPlayer
6524,UCBPlayer,119,154,273,10,79,UCBPlayer
6525,UCBPlayer,112,332,444,25,27,UCBPlayer
6526,UCBPlayer,127,137,264,10,82,UCBPlayer
6527,UCBPlayer,104,349,453,25,24,UCBPlayer
6528,UCBPlayer,126,126,252,7,85,Tie
6529,UCBPlayer,111,351,462,28,22,UCBPlayer
6530,UCBPlayer,116,126,242,3,87,UCBPlayer
6531,UCBPlayer,122,347,469,32,21,UCBPlayer
6532,UCBPlayer,107,132,239,0,87,UCBPlayer
6533,UCBPlayer,132,337,469,35,22,UCBPlayer
6534,UCBPlayer,103,148,251,0,83,UCBPlayer
6535,UCBPlayer,136,321,457,35,26,UCBPlayer
6536,UCBPlayer,99,164,263,0,79,UCBPlayer
6537,UCBPlayer,140,305,445,35,30,UCBPlayer
6538,UCBPlayer,95,180,275,0,75,UCBPlayer
6539,UCBPlayer,144,289,433,35,34,UCBPlayer
6540,UCBPlayer,91,196,287,0,71,UCBPlayer
6541,UCBPlayer,148,273,421,35,38,UCBPlayer
6542,UCBPlayer,87,212,299,0,67,UCBPlayer
6543,UCBPlayer,152,257,409,35,42,UCBPlayer
6544,UCBPlayer,84,224,308,0,64,UCBPlayer
6545,UCBPlayer,146,251,397,32,45,UCBPlayer
6546,UCBPlayer,89,234,323,3,60,UCBPlayer
6547,UCBPlayer,138,243,381,28,49,UCBPlayer
6548,UCBPlayer,97,242,339,7,56,UCBPlayer
6549,UCBPlayer,130,235,365,24,53,UCBPlayer
6550,UCBPlayer,105,250,355,11,52,UCBPlayer
6551,UCBPlayer,122,227,349,20,57,UCBPlayer
6552,UCBPlayer,109,259,368,15,49,UCBPlayer
6553,UCBPlayer,118,218,336,16,60,UCBPlayer
6554,UCBPlayer,117,267,384,19,45,UCBPlayer
6555,UCBPlayer,110,210,320,12,64,UCBPlayer
6556,UCBPlayer,126,271,397,23,42,UCBPlayer
6557,UCBPlayer,105,210,315,10,65,UCBPlayer
6558,UCBPlayer,130,275,405,25,40,UCBPlayer
6559,UCBPlayer,105,210,315,10,65,UCBPlayer
6560,UCBPlayer,130,275,405,25,40,UCBPlayer
6561,UCBPlayer,106,206,312,10,66,UCBPlayer
6562,UCBPlayer,130,275,405,25,40,UCBPlayer
6563,UCBPlayer,105,210,315,10,65,UCBPlayer
6564,UCBPlayer,131,271,402,25,41,UCBPlayer
6565,UCBPlayer,105,210,315,10,65,UCBPlayer
6566,UCBPlayer,130,275,405,25,40,UCBPlayer
6567,UCBPlayer,105,210,315,10,65,UCBPlayer
6568,UCBPlayer,130,275,405,25,40,UCBPlayer
6569,UCBPlayer,103,203,306,10,68,UCBPlayer
6570,UCBPlayer,128,283,411,25,38,UCBPlayer
6571,UCBPlayer,111,186,297,10,71,UCBPlayer
6572,UCBPlayer,124,299,423,25,34,UCBPlayer
6573,UCBPlayer,115,170,285,10,75,UCBPlayer
6574,UCBPlayer,120,315,435,25,30,UCBPlayer
6575,UCBPlayer,119,154,273,10,79,UCBPlayer
6576,UCBPlayer,112,332,444,25,27,UCBPlayer
6577,UCBPlayer,127,137,264,10,82,UCBPlayer
6578,UCBPlayer,104,349,453,25,24,UCBPlayer
6579,UCBPlayer,126,126,252,7,85,Tie
6580,UCBPlayer,111,351,462,28,22,UCBPlayer
6581,UCBPlayer,116,126,242,3,87,UCBPlayer
6582,UCBPlayer,122,347,469,32,21,UCBPlayer
6583,UCBPlayer,107,132,239,0,87,UCBPlayer
6584,UCBPlayer,132,337,469,35,22,UCBPlayer
6585,UCBPlayer,103,148,251,0,83,UCBPlayer
6586,UCBPlayer,136,321,457,35,26,UCBPlayer
6587,UCBPlayer,99,164,263,0,79,UCBPlayer
6588,UCBPlayer,140,305,445,35,30,UCBPlayer
6589,UCBPlayer,95,180,275,0,75,UCBPlayer
6590,UCBPlayer,144,289,433,35,34,UCBPlayer
6591,UCBPlayer,91,196,287,0,71,UCBPlayer
6592,UCBPlayer,148,273,421,35,38,UCBPlayer
6593,UCBPlayer,87,212,299,0,67,UCBPlayer
6594,UCBPlayer,152,257,409,35,42,UCBPlayer
6595,UCBPlayer,84,224,308,0,64,UCBPlayer
6596,UCBPlayer,146,251,397,32,45,UCBPlayer
6597,UCBPlayer,89,234,323,3,60,UCBPlayer
6598,UCBPlayer,138,243,381,28,49,UCBPlayer
6599,UCBPlayer,97,242,339,7,56,UCBPlayer
6600,UCBPlayer,130,235,365,24,53,UCBPlayer
6601,UCBPlayer,105,250,355,11,52,UCBPlayer
6602,UCBPlayer,122,227,349,20,57,UCBPlayer
6603,UCBPlayer,109,259,368,15,49,UCBPlayer
6604,UCBPlayer,118,218,336,16,60,UCBPlayer
6605,UCBPlayer,117,267,384,19,45,UCBPlayer
6606,UCBPlayer,110,210,320,12,64,UCBPlayer
6607,UCBPlayer,126,271,397,23,42,UCBPlayer
6608,UCBPlayer,105,210,315,10,65,UCBPlayer
6609,UCBPlayer,130,275,405,25,40,UCBPlayer
6610,UCBPlayer,105,210,315,10,65,UCBPlayer
6611,UCBPlayer,130,275,405,25,40,UCBPlayer
6612,UCBPlayer,106,206,312,10,66,UCBPlayer
6613,UCBPlayer,130,275,405,25,40,UCBPlayer
6614,UCBPlayer,105,210,315,10,65,UCBPlayer
6615,UCBPlayer,131,271,402,25,41,UCBPlayer
6616,UCBPlayer,105,210,315,10,65,UCBPlayer
6617,UCBPlayer,130,275,405,25,40,UCBPlayer
6618,UCBPlayer,105,210,315,10,65,UCBPlayer
6619,UCBPlayer,130,275,405,25,40,UCBPlayer
6620,UCBPlayer,103,203,306,10,68,UCBPlayer
6621,UCBPlayer,128,283,411,25,38,UCBPlayer
6622,UCBPlayer,111,186,297,10,71,UCBPlayer
6623,UCBPlayer,124,299,423,25,34,UCBPlayer
6624,UCBPlayer,115,170,285,10,75,UCBPlayer
6625,UCBPlayer,120,315,435,25,30,UCBPlayer
6626,UCBPlayer,119,154,273,10,79,UCBPlayer
6627,UCBPlayer,112,332,444,25,27,UCBPlayer
6628,UCBPlayer,127,137,264,10,82,UCBPlayer
6629,UCBPlayer,104,349,453,25,24,UCBPlayer
6630,UCBPlayer,126,126,252,7,85,Tie
6631,UCBPlayer,111,351,462,28,22,UCBPlayer
6632,UCBPlayer,116,126,242,3,87,UCBPlayer
6633,UCBPlayer,122,347,469,32,21,UCBPlayer
6634,UCBPlayer,107,132,239,0,87,UCBPlayer
6635,UCBPlayer,132,337,469,35,22,UCBPlayer
6636,UCBPlayer,103,148,251,0,83,UCBPlayer
6637,UCBPlayer,136,321,457,35,26,UCBPlayer
6638,UCBPlayer,99,164,263,0,79,UCBPlayer
6639,UCBPlayer,140,305,445,35,30,UCBPlayer
6640,UCBPlayer,95,180,275,0,75,UCBPlayer
6641,UCBPlayer,144,289,433,35,34,UCBPlayer
6642,UCBPlayer,91,196,287,0,71,UCBPlayer
6643,UCBPlayer,148,273,421,35,38,UCBPlayer
6644,UCBPlayer,87,212,299,0,67,UCBPlayer
6645,UCBPlayer,152,257,409,35,42,UCBPlayer
6646,UCBPlayer,84,224,308,0,64,UCBPlayer
6647,UCBPlayer,146,251,397,32,45,UCBPlayer
6648,UCBPlayer,89,234,323,3,60,UCBPlayer
6649,UCBPlayer,138,243,381,28,49,UCBPlayer
6650,UCBPlayer,97,242,339,7,56,UCBPlayer
6651,UCBPlayer,130,235,365,24,53,UCBPlayer
6652,UCBPlayer,105,250,355,11,52,UCBPlayer
6653,UCBPlayer,122,227,349,20,57,UCBPlayer
6654,UCBPlayer,109,259,368,15,49,UCBPlayer
6655,UCBPlayer,118,218,336,16,60,UCBPlayer
6656,UCBPlayer,117,267,384,19,45,UCBPlayer
6657,UCBPlayer,110,210,320,12,64,UCBPlayer
6658,UCBPlayer,126,271,397,23,42,UCBPlayer
6659,UCBPlayer,105,210,315,10,65,UCBPlayer
6660,UCBPlayer,130,275,405,25,40,UCBPlayer
6661,UCBPlayer,105,210,315,10,65,UCBPlayer
6662,UCBPlayer,130,275,405,25,40,UCBPlayer
6663,UCBPlayer,106,206,312,10,66,UCBPlayer
6664,UCBPlayer,130,275,405,25,40,UCBPlayer
6665,UCBPlayer,105,210,315,10,65,UCBPlayer
6666,UCBPlayer,131,271,402,25,41,UCBPlayer
6667,UCBPlayer,105,210,315,10,65,UCBPlayer
6668,UCBPlayer,130,275,405,25,40,UCBPlayer
6669,UCBPlayer,105,210,315,10,65,UCBPlayer
6670,UCBPlayer,130,275,405,25,40,UCBPlayer
6671,UCBPlayer,103,203,306,10,68,UCBPlayer
6672,UCBPlayer,128,283,411,25,38,UCBPlayer
6673,UCBPlayer,111,186,297,10,71,UCBPlayer
6674,UCBPlayer,124,299,423,25,34,UCBPlayer
6675,UCBPlayer,115,170,285,10,75,UCBPlayer
6676,UCBPlayer,120,315,435,25,30,UCBPlayer
6677,UCBPlayer,119,154,273,10,79,UCBPlayer
6678,UCBPlayer,112,332,444,25,27,UCBPlayer
6679,UCBPlayer,127,137,264,10,82,UCBPlayer
6680,UCBPlayer,104,349,453,25,24,UCBPlayer
6681,UCBPlayer,126,126,252,7,85,Tie
6682,UCBPlayer,111,351,462,28,22,UCBPlayer
6683,UCBPlayer,116,126,242,3,87,UCBPlayer
6684,UCBPlayer,122,347,469,32,21,UCBPlayer
6685,UCBPlayer,107,132,239,0,87,UCBPlayer
6686,UCBPlayer,132,337,469,35,22,UCBPlayer
6687,UCBPlayer,103,148,251,0,83,UCBPlayer
6688,UCBPlayer,136,321,457,35,26,UCBPlayer
6689,UCBPlayer,99,164,263,0,79,UCBPlayer
6690,UCBPlayer,140,305,445,35,30,UCBPlayer
6691,UCBPlayer,95,180,275,0,75,UCBPlayer
6692,UCBPlayer,144,289,433,35,34,UCBPlayer
6693,UCBPlayer,91,196,287,0,71,UCBPlayer
6694,UCBPlayer,148,273,421,35,38,UCBPlayer
6695,UCBPlayer,87,212,299,0,67,UCBPlayer
6696,UCBPlayer,152,257,409,35,42,UCBPlayer
6697,UCBPlayer,84,224,308,0,64,UCBPlayer
6698,UCBPlayer,146,251,397,32,45,UCBPlayer
6699,UCBPlayer,89,234,323,3,60,UCBPlayer
6700,UCBPlayer,138,243,381,28,49,UCBPlayer
6701,UCBPlayer,97,242,339,7,56,UCBPlayer
6702,UCBPlayer,130,235,365,24,53,UCBPlayer
6703,UCBPlayer,105,250,355,11,52,UCBPlayer
6704,UCBPlayer,122,227,349,20,57,UCBPlayer
6705,UCBPlayer,109,259,368,15,49,UCBPlayer
6706,UCBPlayer,118,218,336,16,60,UCBPlayer
6707,UCBPlayer,117,267,384,19,45,UCBPlayer
6708,UCBPlayer,110,210,320,12,64,UCBPlayer
6709,UCBPlayer,126,271,397,23,42,UCBPlayer
6710,UCBPlayer,105,210,315,10,65,UCBPlayer
6711,UCBPlayer,130,275,405,25,40,UCBPlayer
6712,UCBPlayer,105,210,315,10,65,UCBPlayer
6713,UCBPlayer,130,275,405,25,40,UCBPlayer
6714,UCBPlayer,106,206,312,10,66,UCBPlayer
6715,UCBPlayer,130,275,405,25,40,UCBPlayer
6716,UCBPlayer,105,210,315,10,65,UCBPlayer
6717,UCBPlayer,131,271,402,25,41,UCBPlayer
6718,UCBPlayer,105,210,315,10,65,UCBPlayer
6719,UCBPlayer,130,275,405,25,40,UCBPlayer
6720,UCBPlayer,105,210,315,10,65,UCBPlayer
6721,UCBPlayer,130,275,405,25,40,UCBPlayer
6722,UCBPlayer,103,203,306,10,68,UCBPlayer
6723,UCBPlayer,128,283,411,25,38,UCBPlayer
6724,UCBPlayer,111,186,297,10,71,UCBPlayer
6725,UCBPlayer,124,299,423,25,34,UCBPlayer
6726,UCBPlayer,115,170,285,10,75,UCBPlayer
6727,UCBPlayer,120,315,435,25,30,UCBPlayer
6728,UCBPlayer,119,154,273,10,79,UCBPlayer
6729,UCBPlayer,112,332,444,25,27,UCBPlayer
6730,UCBPlayer,127,137,264,10,82,UCBPlayer
6731,UCBPlayer,104,349,453,25,24,UCBPlayer
6732,UCBPlayer,126,126,252,7,85,Tie
6733,UCBPlayer,111,351,462,28,22,UCBPlayer
6734,UCBPlayer,116,126,242,3,87,UCBPlayer
6735,UCBPlayer,122,347,469,32,21,UCBPlayer
6736,UCBPlayer,107,132,239,0,87,UCBPlayer
6737,UCBPlayer,132,337,469,35,22,UCBPlayer
6738,UCBPlayer,103,148,251,0,83,UCBPlayer
6739,UCBPlayer,136,321,457,35,26,UCBPlayer
6740,UCBPlayer,99,164,263,0,79,UCBPlayer
6741,UCBPlayer,140,305,445,35,30,UCBPlayer
6742,UCBPlayer,95,180,275,0,75,UCBPlayer
6743,UCBPlayer,144,289,433,35,34,UCBPlayer
6744,UCBPlayer,91,196,287,0,71,UCBPlayer
6745,UCBPlayer,148,273,421,35,38,UCBPlayer
6746,UCBPlayer,87,212,299,0,67,UCBPlayer
6747,UCBPlayer,152,257,409,35,42,UCBPlayer
6748,UCBPlayer,84,224,308,0,64,UCBPlayer
6749,UCBPlayer,146,251,397,32,45,UCBPlayer
6750,UCBPlayer,89,234,323,3,60,UCBPlayer
6751,UCBPlayer,138,243,381,28,49,UCBPlayer
6752,UCBPlayer,97,242,339,7,56,UCBPlayer
6753,UCBPlayer,130,235,365,24,53,UCBPlayer
6754,UCBPlayer,105,250,355,11,52,UCBPlayer
6755,UCBPlayer,122,227,349,20,57,UCBPlayer
6756,UCBPlayer,109,259,368,15,49,UCBPlayer
6757,UCBPlayer,118,218,336,16,60,UCBPlayer
6758,UCBPlayer,117,267,384,19,45,UCBPlayer
6759,UCBPlayer,110,210,320,12,64,UCBPlayer
6760,UCBPlayer,126,271,397,23,42,UCBPlayer
6761,UCBPlayer,105,210,315,10,65,UCBPlayer
6762,UCBPlayer,130,275,405,25,40,UCBPlayer
6763,UCBPlayer,105,210,315,10,65,UCBPlayer
6764,UCBPlayer,130,275,405,25,40,UCBPlayer
6765,UCBPlayer,106,206,312,10,66,UCBPlayer
6766,UCBPlayer,130,275,405,25,40,UCBPlayer
6767,UCBPlayer,105,210,315,10,65,UCBPlayer
6768,UCBPlayer,131,271,402,25,41,UCBPlayer
6769,UCBPlayer,105,210,315,10,65,UCBPlayer
6770,UCBPlayer,130,275,405,25,40,UCBPlayer
6771,UCBPlayer,105,210,315,10,65,UCBPlayer
6772,UCBPlayer,130,275,405,25,40,UCBPlayer
6773,UCBPlayer,103,203,306,10,68,UCBPlayer
6774,UCBPlayer,128,283,411,25,38,UCBPlayer
6775,UCBPlayer,111,186,297,10,71,UCBPlayer
6776,UCBPlayer,124,299,423,25,34,UCBPlayer
6777,UCBPlayer,115,170,285,10,75,UCBPlayer
6778,UCBPlayer,120,315,435,25,30,UCBPlayer
6779,UCBPlayer,119,154,273,10,79,UCBPlayer
6780,UCBPlayer,112,332,444,25,27,UCBPlayer
6781,UCBPlayer,127,137,264,10,82,UCBPlayer
6782,UCBPlayer,104,349,453,25,24,UCBPlayer
6783,UCBPlayer,126,126,252,7,85,Tie
6784,UCBPlayer,111,351,462,28,22,UCBPlayer
6785,UCBPlayer,116,126,242,3,87,UCBPlayer
6786,UCBPlayer,122,347,469,32,21,UCBPlayer
6787,UCBPlayer,107,132,239,0,87,UCBPlayer
6788,UCBPlayer,132,337,469,35,22,UCBPlayer
6789,UCBPlayer,103,148,251,0,83,UCBPlayer
6790,UCBPlayer,136,321,457,35,26,UCBPlayer
6791,UCBPlayer,99,164,263,0,79,UCBPlayer
6792,UCBPlayer,140,305,445,35,30,UCBPlayer
6793,UCBPlayer,95,180,275,0,75,UCBPlayer
6794,UCBPlayer,144,289,433,35,34,UCBPlayer
6795,UCBPlayer,91,196,287,0,71,UCBPlayer
6796,UCBPlayer,148,273,421,35,38,UCBPlayer
6797,UCBPlayer,87,212,299,0,67,UCBPlayer
6798,UCBPlayer,152,257,409,35,42,UCBPlayer
6799,UCBPlayer,84,224,308,0,64,UCBPlayer
6800,UCBPlayer,146,251,397,32,45,UCBPlayer
6801,UCBPlayer,89,234,323,3,60,UCBPlayer
6802,UCBPlayer,138,243,381,28,49,UCBPlayer
6803,UCBPlayer,97,242,339,7,56,UCBPlayer
6804,UCBPlayer,130,235,365,24,53,UCBPlayer
6805,UCBPlayer,105,250,355,11,52,UCBPlayer
6806,UCBPlayer,122,227,349,20,57,UCBPlayer
6807,UCBPlayer,109,259,368,15,49,UCBPlayer
6808,UCBPlayer,118,218,336,16,60,UCBPlayer
6809,UCBPlayer,117,267,384,19,45,UCBPlayer
6810,UCBPlayer,110,210,320,12,64,UCBPlayer
6811,UCBPlayer,126,271,397,23,42,UCBPlayer
6812,UCBPlayer,105,210,315,10,65,UCBPlayer
6813,UCBPlayer,130,275,405,25,40,UCBPlayer
6814,UCBPlayer,105,210,315,10,65,UCBPlayer
6815,UCBPlayer,130,275,405,25,40,UCBPlayer
6816,UCBPlayer,106,206,312,10,66,UCBPlayer
6817,UCBPlayer,130,275,405,25,40,UCBPlayer
6818,UCBPlayer,105,210,315,10,65,UCBPlayer
6819,UCBPlayer,131,271,402,25,41,UCBPlayer
6820,UCBPlayer,105,210,315,10,65,UCBPlayer
6821,UCBPlayer,130,275,405,25,40,UCBPlayer
6822,UCBPlayer,105,210,315,10,65,UCBPlayer
6823,UCBPlayer,130,275,405,25,40,UCBPlayer
6824,UCBPlayer,103,203,306,10,68,UCBPlayer
6825,UCBPlayer,128,283,411,25,38,UCBPlayer
6826,UCBPlayer,111,186,297,10,71,UCBPlayer
6827,UCBPlayer,124,299,423,25,34,UCBPlayer
6828,UCBPlayer,115,170,285,10,75,UCBPlayer
6829,UCBPlayer,120,315,435,25,30,UCBPlayer
6830,UCBPlayer,119,154,273,10,79,UCBPlayer
6831,UCBPlayer,112,332,444,25,27,UCBPlayer
6832,UCBPlayer,127,137,264,10,82,UCBPlayer
6833,UCBPlayer,104,349,453,25,24,UCBPlayer
6834,UCBPlayer,126,126,252,7,85,Tie
6835,UCBPlayer,111,351,462,28,22,UCBPlayer
6836,UCBPlayer,116,126,242,3,87,UCBPlayer
6837,UCBPlayer,122,347,469,32,21,UCBPlayer
6838,UCBPlayer,107,132,239,0,87,UCBPlayer
6839,UCBPlayer,132,337,469,35,22,UCBPlayer
6840,UCBPlayer,103,148,251,0,83,UCBPlayer
6841,UCBPlayer,136,321,457,35,26,UCBPlayer
6842,UCBPlayer,99,164,263,0,79,UCBPlayer
6843,UCBPlayer,140,305,445,35,30,UCBPlayer
6844,UCBPlayer,95,180,275,0,75,UCBPlayer
6845,UCBPlayer,144,289,433,35,34,UCBPlayer
6846,UCBPlayer,91,196,287,0,71,UCBPlayer
6847,UCBPlayer,148,273,421,35,38,UCBPlayer
6848,UCBPlayer,87,212,299,0,67,UCBPlayer
6849,UCBPlayer,152,257,409,35,42,UCBPlayer
6850,UCBPlayer,84,224,308,0,64,UCBPlayer
6851,UCBPlayer,146,251,397,32,45,UCBPlayer
6852,UCBPlayer,89,234,323,3,60,UCBPlayer
6853,UCBPlayer,138,243,381,28,49,UCBPlayer
6854,UCBPlayer,97,242,339,7,56,UCBPlayer
6855,UCBPlayer,130,235,365,24,53,UCBPlayer
6856,UCBPlayer,105,250,355,11,52,UCBPlayer
6857,UCBPlayer,122,227,349,20,57,UCBPlayer
6858,UCBPlayer,109,259,368,15,49,UCBPlayer
6859,UCBPlayer,118,218,336,16,60,UCBPlayer
6860,UCBPlayer,117,267,384,19,45,UCBPlayer
6861,UCBPlayer,110,210,320,12,64,UCBPlayer
6862,UCBPlayer,126,271,397,23,42,UCBPlayer
6863,UCBPlayer,105,210,315,10,65,UCBPlayer
6864,UCBPlayer,130,275,405,25,40,UCBPlayer
6865,UCBPlayer,105,210,315,10,65,UCBPlayer
6866,UCBPlayer,130,275,405,25,40,UCBPlayer
6867,UCBPlayer,106,206,312,10,66,UCBPlayer
6868,UCBPlayer,130,275,405,25,40,UCBPlayer
6869,UCBPlayer,105,210,315,10,65,UCBPlayer
6870,UCBPlayer,131,271,402,25,41,UCBPlayer
6871,UCBPlayer,105,210,315,10,65,UCBPlayer
6872,UCBPlayer,130,275,405,25,40,UCBPlayer
6873,UCBPlayer,105,210,315,10,65,UCBPlayer
6874,UCBPlayer,130,275,405,25,40,UCBPlayer
6875,UCBPlayer,103,203,306,10,68,UCBPlayer
6876,UCBPlayer,128,283,411,25,38,UCBPlayer
6877,UCBPlayer,111,186,297,10,71,UCBPlayer
6878,UCBPlayer,124,299,423,25,34,UCBPlayer
6879,UCBPlayer,115,170,285,10,75,UCBPlayer
6880,UCBPlayer,120,315,435,25,30,UCBPlayer
6881,UCBPlayer,119,154,273,10,79,UCBPlayer
6882,UCBPlayer,112,332,444,25,27,UCBPlayer
6883,UCBPlayer,127,137,264,10,82,UCBPlayer
6884,UCBPlayer,104,349,453,25,24,UCBPlayer
6885,UCBPlayer,126,126,252,7,85,Tie
6886,UCBPlayer,111,351,462,28,22,UCBPlayer
6887,UCBPlayer,116,126,242,3,87,UCBPlayer
6888,UCBPlayer,122,347,469,32,21,UCBPlayer
6889,UCBPlayer,107,132,239,0,87,UCBPlayer
6890,UCBPlayer,132,337,469,35,22,UCBPlayer
6891,UCBPlayer,103,148,251,0,83,UCBPlayer
6892,UCBPlayer,136,321,457,35,26,UCBPlayer
6893,UCBPlayer,99,164,263,0,79,UCBPlayer
6894,UCBPlayer,140,305,445,35,30,UCBPlayer
6895,UCBPlayer,95,180,275,0,75,UCBPlayer
6896,UCBPlayer,144,289,433,35,34,UCBPlayer
6897,UCBPlayer,91,196,287,0,71,UCBPlayer
6898,UCBPlayer,148,273,421,35,38,UCBPlayer
6899,UCBPlayer,87,212,299,0,67,UCBPlayer
6900,UCBPlayer,152,257,409,35,42,UCBPlayer
6901,UCBPlayer,84,224,308,0,64,UCBPlayer
6902,UCBPlayer,146,251,397,32,45,UCBPlayer
6903,UCBPlayer,89,234,323,3,60,UCBPlayer
6904,UCBPlayer,138,243,381,28,49,UCBPlayer
6905,UCBPlayer,97,242,339,7,56,UCBPlayer
6906,UCBPlayer,130,235,365,24,53,UCBPlayer
6907,UCBPlayer,105,250,355,11,52,UCBPlayer
6908,UCBPlayer,122,227,349,20,57,UCBPlayer
6909,UCBPlayer,109,259,368,15,49,UCBPlayer
6910,UCBPlayer,118,218,336,16,60,UCBPlayer
6911,UCBPlayer,117,267,384,19,45,UCBPlayer
6912,UCBPlayer,110,210,320,12,64,UCBPlayer
6913,UCBPlayer,126,271,397,23,42,UCBPlayer
6914,UCBPlayer,105,210,315,10,65,UCBPlayer
6915,UCBPlayer,130,275,405,25,40,UCBPlayer
6916,UCBPlayer,105,210,315,10,65,UCBPlayer
6917,UCBPlayer,130,275,405,25,40,UCBPlayer
6918,UCBPlayer,106,206,312,10,66,UCBPlayer
6919,UCBPlayer,130,275,405,25,40,UCBPlayer
6920,UCBPlayer,105,210,315,10,65,UCBPlayer
6921,UCBPlayer,131,271,402,25,41,UCBPlayer
6922,UCBPlayer,105,210,315,10,65,UCBPlayer
6923,UCBPlayer,130,275,405,25,40,UCBPlayer
6924,UCBPlayer,105,210,315,10,65,UCBPlayer
6925,UCBPlayer,130,275,405,25,40,UCBPlayer
6926,UCBPlayer,103,203,306,10,68,UCBPlayer
6927,UCBPlayer,128,283,411,25,38,UCBPlayer
6928,UCBPlayer,111,186,297,10,71,UCBPlayer
6929,UCBPlayer,124,299,423,25,34,UCBPlayer
6930,UCBPlayer,115,170,285,10,75,UCBPlayer
6931,UCBPlayer,120,315,435,25,30,UCBPlayer
6932,UCBPlayer,119,154,273,10,79,UCBPlayer
6933,UCBPlayer,112,332,444,25,27,UCBPlayer
6934,UCBPlayer,127,137,264,10,82,UCBPlayer
6935,UCBPlayer,104,349,453,25,24,UCBPlayer
6936,UCBPlayer,126,126,252,7,85,Tie
6937,UCBPlayer,111,351,462,28,22,UCBPlayer
6938,UCBPlayer,116,126,242,3,87,UCBPlayer
6939,UCBPlayer,122,347,469,32,21,UCBPlayer
6940,UCBPlayer,107,132,239,0,87,UCBPlayer
6941,UCBPlayer,132,337,469,35,22,UCBPlayer
6942,UCBPlayer,103,148,251,0,83,UCBPlayer
6943,UCBPlayer,136,321,457,35,26,UCBPlayer
6944,UCBPlayer,99,164,263,0,79,UCBPlayer
6945,UCBPlayer,140,305,445,35,30,UCBPlayer
6946,UCBPlayer,95,180,275,0,75,UCBPlayer
6947,UCBPlayer,144,289,433,35,34,UCBPlayer
6948,UCBPlayer,91,196,287,0,71,UCBPlayer
6949,UCBPlayer,148,273,421,35,38,UCBPlayer
6950,UCBPlayer,87,212,299,0,67,UCBPlayer
6951,UCBPlayer,152,257,409,35,42,UCBPlayer
6952,UCBPlayer,84,224,308,0,64,UCBPlayer
6953,UCBPlayer,146,251,397,32,45,UCBPlayer
6954,UCBPlayer,89,234,323,3,60,UCBPlayer
6955,UCBPlayer,138,243,381,28,49,UCBPlayer
6956,UCBPlayer,97,242,339,7,56,UCBPlayer
6957,UCBPlayer,130,235,365,24,53,UCBPlayer
6958,UCBPlayer,105,250,355,11,52,UCBPlayer
6959,UCBPlayer,122,227,349,20,57,UCBPlayer
6960,UCBPlayer,109,259,368,15,49,UCBPlayer
6961,UCBPlayer,118,218,336,16,60,UCBPlayer
6962,UCBPlayer,117,267,384,19,45,UCBPlayer
6963,UCBPlayer,110,210,320,12,64,UCBPlayer
6964,UCBPlayer,126,271,397,23,42,UCBPlayer
6965,UCBPlayer,105,210,315,10,65,UCBPlayer
6966,UCBPlayer,130,275,405,25,40,UCBPlayer
6967,UCBPlayer,105,210,315,10,65,UCBPlayer
6968,UCBPlayer,130,275,405,25,40,UCBPlayer
6969,UCBPlayer,106,206,312,10,66,UCBPlayer
6970,UCBPlayer,130,275,405,25,40,UCBPlayer
6971,UCBPlayer,105,210,315,10,65,UCBPlayer
6972,UCBPlayer,131,271,402,25,41,UCBPlayer
6973,UCBPlayer,105,210,315,10,65,UCBPlayer
6974,UCBPlayer,130,275,405,25,40,UCBPlayer
6975,UCBPlayer,105,210,315,10,65,UCBPlayer
6976,UCBPlayer,130,275,405,25,40,UCBPlayer
6977,UCBPlayer,103,203,306,10,68,UCBPlayer
6978,UCBPlayer,128,283,411,25,38,UCBPlayer
6979,UCBPlayer,111,186,297,10,71,UCBPlayer
6980,UCBPlayer,124,299,423,25,34,UCBPlayer
6981,UCBPlayer,115,170,285,10,75,UCBPlayer
6982,UCBPlayer,120,315,435,25,30,UCBPlayer
6983,UCBPlayer,119,154,273,10,79,UCBPlayer
6984,UCBPlayer,112,332,444,25,27,UCBPlayer
6985,UCBPlayer,127,137,264,10,82,UCBPlayer
6986,UCBPlayer,104,349,453,25,24,UCBPlayer
6987,UCBPlayer,126,126,252,7,85,Tie
6988,UCBPlayer,111,351,462,28,22,UCBPlayer
6989,UCBPlayer,116,126,242,3,87,UCBPlayer
6990,UCBPlayer,122,347,469,32,21,UCBPlayer
6991,UCBPlayer,107,132,239,0,87,UCBPlayer
6992,UCBPlayer,132,337,469,35,22,UCBPlayer
6993,UCBPlayer,103,148,251,0,83,UCBPlayer
6994,UCBPlayer,136,321,457,35,26,UCBPlayer
6995,UCBPlayer,99,164,263,0,79,UCBPlayer
6996,UCBPlayer,140,305,445,35,30,UCBPlayer
6997,UCBPlayer,95,180,275,0,75,UCBPlayer
6998,UCBPlayer,144,289,433,35,34,UCBPlayer
6999,UCBPlayer,91,196,287,0,71,UCBPlayer
7000,UCBPlayer,148,273,421,35,38,UCBPlayer
7001,UCBPlayer,87,212,299,0,67,UCBPlayer
7002,UCBPlayer,152,257,409,35,42,UCBPlayer
7003,UCBPlayer,84,224,308,0,64,UCBPlayer
7004,UCBPlayer,146,251,397,32,45,UCBPlayer
7005,UCBPlayer,89,234,323,3,60,UCBPlayer
7006,UCBPlayer,138,243,381,28,49,UCBPlayer
7007,UCBPlayer,97,242,339,7,56,UCBPlayer
7008,UCBPlayer,130,235,365,24,53,UCBPlayer
7009,UCBPlayer,105,250,355,11,52,UCBPlayer
7010,UCBPlayer,122,227,349,20,57,UCBPlayer
7011,UCBPlayer,109,259,368,15,49,UCBPlayer
7012,UCBPlayer,118,218,336,16,60,UCBPlayer
7013,UCBPlayer,117,267,384,19,45,UCBPlayer
7014,UCBPlayer,110,210,320,12,64,UCBPlayer
7015,UCBPlayer,126,271,397,23,42,UCBPlayer
7016,UCBPlayer,105,210,315,10,65,UCBPlayer
7017,UCBPlayer,130,275,405,25,40,UCBPlayer
7018,UCBPlayer,105,210,315,10,65,UCBPlayer
7019,UCBPlayer,130,275,405,25,40,UCBPlayer
7020,UCBPlayer,106,206,312,10,66,UCBPlayer
7021,UCBPlayer,130,275,405,25,40,UCBPlayer
7022,UCBPlayer,105,210,315,10,65,UCBPlayer
7023,UCBPlayer,131,271,402,25,41,UCBPlayer
7024,UCBPlayer,105,210,315,10,65,UCBPlayer
7025,UCBPlayer,130,275,405,25,40,UCBPlayer
7026,UCBPlayer,105,210,315,10,65,UCBPlayer
7027,UCBPlayer,130,275,405,25,40,UCBPlayer
7028,UCBPlayer,103,203,306,10,68,UCBPlayer
7029,UCBPlayer,128,283,411,25,38,UCBPlayer
7030,UCBPlayer,111,186,297,10,71,UCBPlayer
7031,UCBPlayer,124,299,423,25,34,UCBPlayer
7032,UCBPlayer,115,170,285,10,75,UCBPlayer
7033,UCBPlayer,120,315,435,25,30,UCBPlayer
7034,UCBPlayer,119,154,273,10,79,UCBPlayer
7035,UCBPlayer,112,332,444,25,27,UCBPlayer
7036,UCBPlayer,127,137,264,10,82,UCBPlayer
7037,UCBPlayer,104,349,453,25,24,UCBPlayer
7038,UCBPlayer,126,126,252,7,85,Tie
7039,UCBPlayer,111,351,462,28,22,UCBPlayer
7040,UCBPlayer,116,126,242,3,87,UCBPlayer
7041,UCBPlayer,122,347,469,32,21,UCBPlayer
7042,UCBPlayer,107,132,239,0,87,UCBPlayer
7043,UCBPlayer,132,337,469,35,22,UCBPlayer
7044,UCBPlayer,103,148,251,0,83,UCBPlayer
7045,UCBPlayer,136,321,457,35,26,UCBPlayer
7046,UCBPlayer,99,164,263,0,79,UCBPlayer
7047,UCBPlayer,140,305,445,35,30,UCBPlayer
7048,UCBPlayer,95,180,275,0,75,UCBPlayer
7049,UCBPlayer,144,289,433,35,34,UCBPlayer
7050,UCBPlayer,91,196,287,0,71,UCBPlayer
7051,UCBPlayer,148,273,421,35,38,UCBPlayer
7052,UCBPlayer,87,212,299,0,67,UCBPlayer
7053,UCBPlayer,152,257,409,35,42,UCBPlayer
7054,UCBPlayer,84,224,308,0,64,UCBPlayer
7055,UCBPlayer,146,251,397,32,45,UCBPlayer
7056,UCBPlayer,89,234,323,3,60,UCBPlayer
7057,UCBPlayer,138,243,381,28,49,UCBPlayer
7058,UCBPlayer,97,242,339,7,56,UCBPlayer
7059,UCBPlayer,130,235,365,24,53,UCBPlayer
7060,UCBPlayer,105,250,355,11,52,UCBPlayer
7061,UCBPlayer,122,227,349,20,57,UCBPlayer
7062,UCBPlayer,109,259,368,15,49,UCBPlayer
7063,UCBPlayer,118,218,336,16,60,UCBPlayer
7064,UCBPlayer,117,267,384,19,45,UCBPlayer
7065,UCBPlayer,110,210,320,12,64,UCBPlayer
7066,UCBPlayer,126,271,397,23,42,UCBPlayer
7067,UCBPlayer,105,210,315,10,65,UCBPlayer
7068,UCBPlayer,130,275,405,25,40,UCBPlayer
7069,UCBPlayer,105,210,315,10,65,UCBPlayer
7070,UCBPlayer,130,275,405,25,40,UCBPlayer
7071,UCBPlayer,106,206,312,10,66,UCBPlayer
7072,UCBPlayer,130,275,405,25,40,UCBPlayer
7073,UCBPlayer,105,210,315,10,65,UCBPlayer
7074,UCBPlayer,131,271,402,25,41,UCBPlayer
7075,UCBPlayer,105,210,315,10,65,UCBPlayer
7076,UCBPlayer,130,275,405,25,40,UCBPlayer
7077,UCBPlayer,105,210,315,10,65,UCBPlayer
7078,UCBPlayer,130,275,405,25,40,UCBPlayer
7079,UCBPlayer,103,203,306,10,68,UCBPlayer
7080,UCBPlayer,128,283,411,25,38,UCBPlayer
7081,UCBPlayer,111,186,297,10,71,UCBPlayer
7082,UCBPlayer,124,299,423,25,34,UCBPlayer
7083,UCBPlayer,115,170,285,10,75,UCBPlayer
7084,UCBPlayer,120,315,435,25,30,UCBPlayer
7085,UCBPlayer,119,154,273,10,79,UCBPlayer
7086,UCBPlayer,112,332,444,25,27,UCBPlayer
7087,UCBPlayer,127,137,264,10,82,UCBPlayer
7088,UCBPlayer,104,349,453,25,24,UCBPlayer
7089,UCBPlayer,126,126,252,7,85,Tie
7090,UCBPlayer,111,351,462,28,22,UCBPlayer
7091,UCBPlayer,116,126,242,3,87,UCBPlayer
7092,UCBPlayer,122,347,469,32,21,UCBPlayer
7093,UCBPlayer,107,132,239,0,87,UCBPlayer
7094,UCBPlayer,132,337,469,35,22,UCBPlayer
7095,UCBPlayer,103,148,251,0,83,UCBPlayer
7096,UCBPlayer,136,321,457,35,26,UCBPlayer
7097,UCBPlayer,99,164,263,0,79,UCBPlayer
7098,UCBPlayer,140,305,445,35,30,UCBPlayer
7099,UCBPlayer,95,180,275,0,75,UCBPlayer
7100,UCBPlayer,144,289,433,35,34,UCBPlayer
7101,UCBPlayer,91,196,287,0,71,UCBPlayer
7102,UCBPlayer,148,273,421,35,38,UCBPlayer
7103,UCBPlayer,87,212,299,0,67,UCBPlayer
7104,UCBPlayer,152,257,409,35,42,UCBPlayer
7105,UCBPlayer,84,224,308,0,64,UCBPlayer
7106,UCBPlayer,146,251,397,32,45,UCBPlayer
7107,UCBPlayer,89,234,323,3,60,UCBPlayer
7108,UCBPlayer,138,243,381,28,49,UCBPlayer
7109,UCBPlayer,97,242,339,7,56,UCBPlayer
7110,UCBPlayer,130,235,365,24,53,UCBPlayer
7111,UCBPlayer,105,250,355,11,52,UCBPlayer
7112,UCBPlayer,122,227,349,20,57,UCBPlayer
7113,UCBPlayer,109,259,368,15,49,UCBPlayer
7114,UCBPlayer,118,218,336,16,60,UCBPlayer
7115,UCBPlayer,117,267,384,19,45,UCBPlayer
7116,UCBPlayer,110,210,320,12,64,UCBPlayer
7117,UCBPlayer,126,271,397,23,42,UCBPlayer
7118,UCBPlayer,105,210,315,10,65,UCBPlayer
7119,UCBPlayer,130,275,405,25,40,UCBPlayer
7120,UCBPlayer,105,210,315,10,65,UCBPlayer
7121,UCBPlayer,130,275,405,25,40,UCBPlayer
7122,UCBPlayer,106,206,312,10,66,UCBPlayer
7123,UCBPlayer,130,275,405,25,40,UCBPlayer
7124,UCBPlayer,105,210,315,10,65,UCBPlayer
7125,UCBPlayer,131,271,402,25,41,UCBPlayer
7126,UCBPlayer,105,210,315,10,65,UCBPlayer
7127,UCBPlayer,130,275,405,25,40,UCBPlayer
7128,UCBPlayer,105,210,315,10,65,UCBPlayer
7129,UCBPlayer,130,275,405,25,40,UCBPlayer
7130,UCBPlayer,103,203,306,10,68,UCBPlayer
7131,UCBPlayer,128,283,411,25,38,UCBPlayer
7132,UCBPlayer,111,186,297,10,71,UCBPlayer
7133,UCBPlayer,124,299,423,25,34,UCBPlayer
7134,UCBPlayer,115,170,285,10,75,UCBPlayer
7135,UCBPlayer,120,315,435,25,30,UCBPlayer
7136,UCBPlayer,119,154,273,10,79,UCBPlayer
7137,UCBPlayer,112,332,444,25,27,UCBPlayer
7138,UCBPlayer,127,137,264,10,82,UCBPlayer
7139,UCBPlayer,104,349,453,25,24,UCBPlayer
7140,UCBPlayer,126,126,252,7,85,Tie
7141,UCBPlayer,111,351,462,28,22,UCBPlayer
7142,UCBPlayer,116,126,242,3,87,UCBPlayer
7143,UCBPlayer,122,347,469,32,21,UCBPlayer
7144,UCBPlayer,107,132,239,0,87,UCBPlayer
7145,UCBPlayer,132,337,469,35,22,UCBPlayer
7146,UCBPlayer,103,148,251,0,83,UCBPlayer
7147,UCBPlayer,136,321,457,35,26,UCBPlayer
7148,UCBPlayer,99,164,263,0,79,UCBPlayer
7149,UCBPlayer,140,305,445,35,30,UCBPlayer
7150,UCBPlayer,95,180,275,0,75,UCBPlayer
7151,UCBPlayer,144,289,433,35,34,UCBPlayer
7152,UCBPlayer,91,196,287,0,71,UCBPlayer
7153,UCBPlayer,148,273,421,35,38,UCBPlayer
7154,UCBPlayer,87,212,299,0,67,UCBPlayer
7155,UCBPlayer,152,257,409,35,42,UCBPlayer
7156,UCBPlayer,84,224,308,0,64,UCBPlayer
7157,UCBPlayer,146,251,397,32,45,UCBPlayer
7158,UCBPlayer,89,234,323,3,60,UCBPlayer
7159,UCBPlayer,138,243,381,28,49,UCBPlayer
7160,UCBPlayer,97,242,339,7,56,UCBPlayer
7161,UCBPlayer,130,235,365,24,53,UCBPlayer
7162,UCBPlayer,105,250,355,11,52,UCBPlayer
7163,UCBPlayer,122,227,349,20,57,UCBPlayer
7164,UCBPlayer,109,259,368,15,49,UCBPlayer
7165,UCBPlayer,118,218,336,16,60,UCBPlayer
7166,UCBPlayer,117,267,384,19,45,UCBPlayer
7167,UCBPlayer,110,210,320,12,64,UCBPlayer
7168,UCBPlayer,126,271,397,23,42,UCBPlayer
7169,UCBPlayer,105,210,315,10,65,UCBPlayer
7170,UCBPlayer,130,275,405,25,40,UCBPlayer
7171,UCBPlayer,105,210,315,10,65,UCBPlayer
7172,UCBPlayer,130,275,405,25,40,UCBPlayer
7173,UCBPlayer,106,206,312,10,66,UCBPlayer
7174,UCBPlayer,130,275,405,25,40,UCBPlayer
7175,UCBPlayer,105,210,315,10,65,UCBPlayer
7176,UCBPlayer,131,271,402,25,41,UCBPlayer
7177,UCBPlayer,105,210,315,10,65,UCBPlayer
7178,UCBPlayer,130,275,405,25,40,UCBPlayer
7179,UCBPlayer,105,210,315,10,65,UCBPlayer
7180,UCBPlayer,130,275,405,25,40,UCBPlayer
7181,UCBPlayer,103,203,306,10,68,UCBPlayer
7182,UCBPlayer,128,283,411,25,38,UCBPlayer
7183,UCBPlayer,111,186,297,10,71,UCBPlayer
7184,UCBPlayer,124,299,423,25,34,UCBPlayer
7185,UCBPlayer,115,170,285,10,75,UCBPlayer
7186,UCBPlayer,120,315,435,25,30,UCBPlayer
7187,UCBPlayer,119,154,273,10,79,UCBPlayer
7188,UCBPlayer,112,332,444,25,27,UCBPlayer
7189,UCBPlayer,127,137,264,10,82,UCBPlayer
7190,UCBPlayer,104,349,453,25,24,UCBPlayer
7191,UCBPlayer,126,126,252,7,85,Tie
7192,UCBPlayer,111,351,462,28,22,UCBPlayer
7193,UCBPlayer,116,126,242,3,87,UCBPlayer
7194,UCBPlayer,122,347,469,32,21,UCBPlayer
7195,UCBPlayer,107,132,239,0,87,UCBPlayer
7196,UCBPlayer,132,337,469,35,22,UCBPlayer
7197,UCBPlayer,103,148,251,0,83,UCBPlayer
7198,UCBPlayer,136,321,457,35,26,UCBPlayer
7199,UCBPlayer,99,164,263,0,79,UCBPlayer
7200,UCBPlayer,140,305,445,35,30,UCBPlayer
7201,UCBPlayer,95,180,275,0,75,UCBPlayer
7202,UCBPlayer,144,289,433,35,34,UCBPlayer
7203,UCBPlayer,91,196,287,0,71,UCBPlayer
7204,UCBPlayer,148,273,421,35,38,UCBPlayer
7205,UCBPlayer,87,212,299,0,67,UCBPlayer
7206,UCBPlayer,152,257,409,35,42,UCBPlayer
7207,UCBPlayer,84,224,308,0,64,UCBPlayer
7208,UCBPlayer,146,251,397,32,45,UCBPlayer
7209,UCBPlayer,89,234,323,3,60,UCBPlayer
7210,UCBPlayer,138,243,381,28,49,UCBPlayer
7211,UCBPlayer,97,242,339,7,56,UCBPlayer
7212,UCBPlayer,130,235,365,24,53,UCBPlayer
7213,UCBPlayer,105,250,355,11,52,UCBPlayer
7214,UCBPlayer,122,227,349,20,57,UCBPlayer
7215,UCBPlayer,109,259,368,15,49,UCBPlayer
7216,UCBPlayer,118,218,336,16,60,UCBPlayer
7217,UCBPlayer,117,267,384,19,45,UCBPlayer
7218,UCBPlayer,110,210,320,12,64,UCBPlayer
7219,UCBPlayer,126,271,397,23,42,UCBPlayer
7220,UCBPlayer,105,210,315,10,65,UCBPlayer
7221,UCBPlayer,130,275,405,25,40,UCBPlayer
7222,UCBPlayer,105,210,315,10,65,UCBPlayer
7223,UCBPlayer,130,275,405,25,40,UCBPlayer
7224,UCBPlayer,106,206,312,10,66,UCBPlayer
7225,UCBPlayer,130,275,405,25,40,UCBPlayer
7226,UCBPlayer,105,210,315,10,65,UCBPlayer
7227,UCBPlayer,131,271,402,25,41,UCBPlayer
7228,UCBPlayer,105,210,315,10,65,UCBPlayer
7229,UCBPlayer,130,275,405,25,40,UCBPlayer
7230,UCBPlayer,105,210,315,10,65,UCBPlayer
7231,UCBPlayer,130,275,405,25,40,UCBPlayer
7232,UCBPlayer,103,203,306,10,68,UCBPlayer
7233,UCBPlayer,128,283,411,25,38,UCBPlayer
7234,UCBPlayer,111,186,297,10,71,UCBPlayer
7235,UCBPlayer,124,299,423,25,34,UCBPlayer
7236,UCBPlayer,115,170,285,10,75,UCBPlayer
7237,UCBPlayer,120,315,435,25,30,UCBPlayer
7238,UCBPlayer,119,154,273,10,79,UCBPlayer
7239,UCBPlayer,112,332,444,25,27,UCBPlayer
7240,UCBPlayer,127,137,264,10,82,UCBPlayer
7241,UCBPlayer,104,349,453,25,24,UCBPlayer
7242,UCBPlayer,126,126,252,7,85,Tie
7243,UCBPlayer,111,351,462,28,22,UCBPlayer
7244,UCBPlayer,116,126,242,3,87,UCBPlayer
7245,UCBPlayer,122,347,469,32,21,UCBPlayer
7246,UCBPlayer,107,132,239,0,87,UCBPlayer
7247,UCBPlayer,132,337,469,35,22,UCBPlayer
7248,UCBPlayer,103,148,251,0,83,UCBPlayer
7249,UCBPlayer,136,321,457,35,26,UCBPlayer
7250,UCBPlayer,99,164,263,0,79,UCBPlayer
7251,UCBPlayer,140,305,445,35,30,UCBPlayer
7252,UCBPlayer,95,180,275,0,75,UCBPlayer
7253,UCBPlayer,144,289,433,35,34,UCBPlayer
7254,UCBPlayer,91,196,287,0,71,UCBPlayer
7255,UCBPlayer,148,273,421,35,38,UCBPlayer
7256,UCBPlayer,87,212,299,0,67,UCBPlayer
7257,UCBPlayer,152,257,409,35,42,UCBPlayer
7258,UCBPlayer,84,224,308,0,64,UCBPlayer
7259,UCBPlayer,146,251,397,32,45,UCBPlayer
7260,UCBPlayer,89,234,323,3,60,UCBPlayer
7261,UCBPlayer,138,243,381,28,49,UCBPlayer
7262,UCBPlayer,97,242,339,7,56,UCBPlayer
7263,UCBPlayer,130,235,365,24,53,UCBPlayer
7264,UCBPlayer,105,250,355,11,52,UCBPlayer
7265,UCBPlayer,122,227,349,20,57,UCBPlayer
7266,UCBPlayer,109,259,368,15,49,UCBPlayer
7267,UCBPlayer,118,218,336,16,60,UCBPlayer
7268,UCBPlayer,117,267,384,19,45,UCBPlayer
7269,UCBPlayer,110,210,320,12,64,UCBPlayer
7270,UCBPlayer,126,271,397,23,42,UCBPlayer
7271,UCBPlayer,105,210,315,10,65,UCBPlayer
7272,UCBPlayer,130,275,405,25,40,UCBPlayer
7273,UCBPlayer,105,210,315,10,65,UCBPlayer
7274,UCBPlayer,130,275,405,25,40,UCBPlayer
7275,UCBPlayer,106,206,312,10,66,UCBPlayer
7276,UCBPlayer,130,275,405,25,40,UCBPlayer
7277,UCBPlayer,105,210,315,10,65,UCBPlayer
7278,UCBPlayer,131,271,402,25,41,UCBPlayer
7279,UCBPlayer,105,210,315,10,65,UCBPlayer
7280,UCBPlayer,130,275,405,25,40,UCBPlayer
7281,UCBPlayer,105,210,315,10,65,UCBPlayer
7282,UCBPlayer,130,275,405,25,40,UCBPlayer
7283,UCBPlayer,103,203,306,10,68,UCBPlayer
7284,UCBPlayer,128,283,411,25,38,UCBPlayer
7285,UCBPlayer,111,186,297,10,71,UCBPlayer
7286,UCBPlayer,124,299,423,25,34,UCBPlayer
7287,UCBPlayer,115,170,285,10,75,UCBPlayer
7288,UCBPlayer,120,315,435,25,30,UCBPlayer
7289,UCBPlayer,119,154,273,10,79,UCBPlayer
7290,UCBPlayer,112,332,444,25,27,UCBPlayer
7291,UCBPlayer,127,137,264,10,82,UCBPlayer
7292,UCBPlayer,104,349,453,25,24,UCBPlayer
7293,UCBPlayer,126,126,252,7,85,Tie
7294,UCBPlayer,111,351,462,28,22,UCBPlayer
7295,UCBPlayer,116,126,242,3,87,UCBPlayer
7296,UCBPlayer,122,347,469,32,21,UCBPlayer
7297,UCBPlayer,107,132,239,0,87,UCBPlayer
7298,UCBPlayer,132,337,469,35,22,UCBPlayer
7299,UCBPlayer,103,148,251,0,83,UCBPlayer
7300,UCBPlayer,136,321,457,35,26,UCBPlayer
7301,UCBPlayer,99,164,263,0,79,UCBPlayer
7302,UCBPlayer,140,305,445,35,30,UCBPlayer
7303,UCBPlayer,95,180,275,0,75,UCBPlayer
7304,UCBPlayer,144,289,433,35,34,UCBPlayer
7305,UCBPlayer,91,196,287,0,71,UCBPlayer
7306,UCBPlayer,148,273,421,35,38,UCBPlayer
7307,UCBPlayer,87,212,299,0,67,UCBPlayer
7308,UCBPlayer,152,257,409,35,42,UCBPlayer
7309,UCBPlayer,84,224,308,0,64,UCBPlayer
7310,UCBPlayer,146,251,397,32,45,UCBPlayer
7311,UCBPlayer,89,234,323,3,60,UCBPlayer
7312,UCBPlayer,138,243,381,28,49,UCBPlayer
7313,UCBPlayer,97,242,339,7,56,UCBPlayer
7314,UCBPlayer,130,235,365,24,53,UCBPlayer
7315,UCBPlayer,105,250,355,11,52,UCBPlayer
7316,UCBPlayer,122,227,349,20,57,UCBPlayer
7317,UCBPlayer,109,259,368,15,49,UCBPlayer
7318,UCBPlayer,118,218,336,16,60,UCBPlayer
7319,UCBPlayer,117,267,384,19,45,UCBPlayer
7320,UCBPlayer,110,210,320,12,64,UCBPlayer
7321,UCBPlayer,126,271,397,23,42,UCBPlayer
7322,UCBPlayer,105,210,315,10,65,UCBPlayer
7323,UCBPlayer,130,275,405,25,40,UCBPlayer
7324,UCBPlayer,105,210,315,10,65,UCBPlayer
7325,UCBPlayer,130,275,405,25,40,UCBPlayer
7326,UCBPlayer,106,206,312,10,66,UCBPlayer
7327,UCBPlayer,130,275,405,25,40,UCBPlayer
7328,UCBPlayer,105,210,315,10,65,UCBPlayer
7329,UCBPlayer,131,271,402,25,41,UCBPlayer
7330,UCBPlayer,105,210,315,10,65,UCBPlayer
7331,UCBPlayer,130,275,405,25,40,UCBPlayer
7332,UCBPlayer,105,210,315,10,65,UCBPlayer
7333,UCBPlayer,130,275,405,25,40,UCBPlayer
7334,UCBPlayer,103,203,306,10,68,UCBPlayer
7335,UCBPlayer,128,283,411,25,38,UCBPlayer
7336,UCBPlayer,111,186,297,10,71,UCBPlayer
7337,UCBPlayer,124,299,423,25,34,UCBPlayer
7338,UCBPlayer,115,170,285,10,75,UCBPlayer
7339,UCBPlayer,120,315,435,25,30,UCBPlayer
7340,UCBPlayer,119,154,273,10,79,UCBPlayer
7341,UCBPlayer,112,332,444,25,27,UCBPlayer
7342,UCBPlayer,127,137,264,10,82,UCBPlayer
7343,UCBPlayer,104,349,453,25,24,UCBPlayer
7344,UCBPlayer,126,126,252,7,85,Tie
7345,UCBPlayer,111,351,462,28,22,UCBPlayer
7346,UCBPlayer,116,126,242,3,87,UCBPlayer
7347,UCBPlayer,122,347,469,32,21,UCBPlayer
7348,UCBPlayer,107,132,239,0,87,UCBPlayer
7349,UCBPlayer,132,337,469,35,22,UCBPlayer
7350,UCBPlayer,103,148,251,0,83,UCBPlayer
7351,UCBPlayer,136,321,457,35,26,UCBPlayer
7352,UCBPlayer,99,164,263,0,79,UCBPlayer
7353,UCBPlayer,140,305,445,35,30,UCBPlayer
7354,UCBPlayer,95,180,275,0,75,UCBPlayer
7355,UCBPlayer,144,289,433,35,34,UCBPlayer
7356,UCBPlayer,91,196,287,0,71,UCBPlayer
7357,UCBPlayer,148,273,421,35,38,UCBPlayer
7358,UCBPlayer,87,212,299,0,67,UCBPlayer
7359,UCBPlayer,152,257,409,35,42,UCBPlayer
7360,UCBPlayer,84,224,308,0,64,UCBPlayer
7361,UCBPlayer,146,251,397,32,45,UCBPlayer
7362,UCBPlayer,89,234,323,3,60,UCBPlayer
7363,UCBPlayer,138,243,381,28,49,UCBPlayer
7364,UCBPlayer,97,242,339,7,56,UCBPlayer
7365,UCBPlayer,130,235,365,24,53,UCBPlayer
7366,UCBPlayer,105,250,355,11,52,UCBPlayer
7367,UCBPlayer,122,227,349,20,57,UCBPlayer
7368,UCBPlayer,109,259,368,15,49,UCBPlayer
7369,UCBPlayer,118,218,336,16,60,UCBPlayer
7370,UCBPlayer,117,267,384,19,45,UCBPlayer
7371,UCBPlayer,110,210,320,12,64,UCBPlayer
7372,UCBPlayer,126,271,397,23,42,UCBPlayer
7373,UCBPlayer,105,210,315,10,65,UCBPlayer
7374,UCBPlayer,130,275,405,25,40,UCBPlayer
7375,UCBPlayer,105,210,315,10,65,UCBPlayer
7376,UCBPlayer,130,275,405,25,40,UCBPlayer
7377,UCBPlayer,106,206,312,10,66,UCBPlayer
7378,UCBPlayer,130,275,405,25,40,UCBPlayer
7379,UCBPlayer,105,210,315,10,65,UCBPlayer
7380,UCBPlayer,131,271,402,25,41,UCBPlayer
7381,UCBPlayer,105,210,315,10,65,UCBPlayer
7382,UCBPlayer,130,275,405,25,40,UCBPlayer
7383,UCBPlayer,105,210,315,10,65,UCBPlayer
7384,UCBPlayer,130,275,405,25,40,UCBPlayer
7385,UCBPlayer,103,203,306,10,68,UCBPlayer
7386,UCBPlayer,128,283,411,25,38,UCBPlayer
7387,UCBPlayer,111,186,297,10,71,UCBPlayer
7388,UCBPlayer,124,299,423,25,34,UCBPlayer
7389,UCBPlayer,115,170,285,10,75,UCBPlayer
7390,UCBPlayer,120,315,435,25,30,UCBPlayer
7391,UCBPlayer,119,154,273,10,79,UCBPlayer
7392,UCBPlayer,112,332,444,25,27,UCBPlayer
7393,UCBPlayer,127,137,264,10,82,UCBPlayer
7394,UCBPlayer,104,349,453,25,24,UCBPlayer
7395,UCBPlayer,126,126,252,7,85,Tie
7396,UCBPlayer,111,351,462,28,22,UCBPlayer
7397,UCBPlayer,116,126,242,3,87,UCBPlayer
7398,UCBPlayer,122,347,469,32,21,UCBPlayer
7399,UCBPlayer,107,132,239,0,87,UCBPlayer
7400,UCBPlayer,132,337,469,35,22,UCBPlayer
7401,UCBPlayer,103,148,251,0,83,UCBPlayer
7402,UCBPlayer,136,321,457,35,26,UCBPlayer
7403,UCBPlayer,99,164,263,0,79,UCBPlayer
7404,UCBPlayer,140,305,445,35,30,UCBPlayer
7405,UCBPlayer,95,180,275,0,75,UCBPlayer
7406,UCBPlayer,144,289,433,35,34,UCBPlayer
7407,UCBPlayer,91,196,287,0,71,UCBPlayer
7408,UCBPlayer,148,273,421,35,38,UCBPlayer
7409,UCBPlayer,87,212,299,0,67,UCBPlayer
7410,UCBPlayer,152,257,409,35,42,UCBPlayer
7411,UCBPlayer,84,224,308,0,64,UCBPlayer
7412,UCBPlayer,146,251,397,32,45,UCBPlayer
7413,UCBPlayer,89,234,323,3,60,UCBPlayer
7414,UCBPlayer,138,243,381,28,49,UCBPlayer
7415,UCBPlayer,97,242,339,7,56,UCBPlayer
7416,UCBPlayer,130,235,365,24,53,UCBPlayer
7417,UCBPlayer,105,250,355,11,52,UCBPlayer
7418,UCBPlayer,122,227,349,20,57,UCBPlayer
7419,UCBPlayer,109,259,368,15,49,UCBPlayer
7420,UCBPlayer,118,218,336,16,60,UCBPlayer
7421,UCBPlayer,117,267,384,19,45,UCBPlayer
7422,UCBPlayer,110,210,320,12,64,UCBPlayer
7423,UCBPlayer,126,271,397,23,42,UCBPlayer
7424,UCBPlayer,105,210,315,10,65,UCBPlayer
7425,UCBPlayer,130,275,405,25,40,UCBPlayer
7426,UCBPlayer,105,210,315,10,65,UCBPlayer
7427,UCBPlayer,130,275,405,25,40,UCBPlayer
7428,UCBPlayer,106,206,312,10,66,UCBPlayer
7429,UCBPlayer,130,275,405,25,40,UCBPlayer
7430,UCBPlayer,105,210,315,10,65,UCBPlayer
7431,UCBPlayer,131,271,402,25,41,UCBPlayer
7432,UCBPlayer,105,210,315,10,65,UCBPlayer
7433,UCBPlayer,130,275,405,25,40,UCBPlayer
7434,UCBPlayer,105,210,315,10,65,UCBPlayer
7435,UCBPlayer,130,275,405,25,40,UCBPlayer
7436,UCBPlayer,103,203,306,10,68,UCBPlayer
7437,UCBPlayer,128,283,411,25,38,UCBPlayer
7438,UCBPlayer,111,186,297,10,71,UCBPlayer
7439,UCBPlayer,124,299,423,25,34,UCBPlayer
7440,UCBPlayer,115,170,285,10,75,UCBPlayer
7441,UCBPlayer,120,315,435,25,30,UCBPlayer
7442,UCBPlayer,119,154,273,10,79,UCBPlayer
7443,UCBPlayer,112,332,444,25,27,UCBPlayer
7444,UCBPlayer,127,137,264,10,82,UCBPlayer
7445,UCBPlayer,104,349,453,25,24,UCBPlayer
7446,UCBPlayer,126,126,252,7,85,Tie
7447,UCBPlayer,111,351,462,28,22,UCBPlayer
7448,UCBPlayer,116,126,242,3,87,UCBPlayer
7449,UCBPlayer,122,347,469,32,21,UCBPlayer
7450,UCBPlayer,107,132,239,0,87,UCBPlayer
7451,UCBPlayer,132,337,469,35,22,UCBPlayer
7452,UCBPlayer,103,148,251,0,83,UCBPlayer
7453,UCBPlayer,136,321,457,35,26,UCBPlayer
7454,UCBPlayer,99,164,263,0,79,UCBPlayer
7455,UCBPlayer,140,305,445,35,30,UCBPlayer
7456,UCBPlayer,95,180,275,0,75,UCBPlayer
7457,UCBPlayer,144,289,433,35,34,UCBPlayer
7458,UCBPlayer,91,196,287,0,71,UCBPlayer
7459,UCBPlayer,148,273,421,35,38,UCBPlayer
7460,UCBPlayer,87,212,299,0,67,UCBPlayer
7461,UCBPlayer,152,257,409,35,42,UCBPlayer
7462,UCBPlayer,84,224,308,0,64,UCBPlayer
7463,UCBPlayer,146,251,397,32,45,UCBPlayer
7464,UCBPlayer,89,234,323,3,60,UCBPlayer
7465,UCBPlayer,138,243,381,28,49,UCBPlayer
7466,UCBPlayer,97,242,339,7,56,UCBPlayer
7467,UCBPlayer,130,235,365,24,53,UCBPlayer
7468,UCBPlayer,105,250,355,11,52,UCBPlayer
7469,UCBPlayer,122,227,349,20,57,UCBPlayer
7470,UCBPlayer,109,259,368,15,49,UCBPlayer
7471,UCBPlayer,118,218,336,16,60,UCBPlayer
7472,UCBPlayer,117,267,384,19,45,UCBPlayer
7473,UCBPlayer,110,210,320,12,64,UCBPlayer
7474,UCBPlayer,126,271,397,23,42,UCBPlayer
7475,UCBPlayer,105,210,315,10,65,UCBPlayer
7476,UCBPlayer,130,275,405,25,40,UCBPlayer
7477,UCBPlayer,105,210,315,10,65,UCBPlayer
7478,UCBPlayer,130,275,405,25,40,UCBPlayer
7479,UCBPlayer,106,206,312,10,66,UCBPlayer
7480,UCBPlayer,130,275,405,25,40,UCBPlayer
7481,UCBPlayer,105,210,315,10,65,UCBPlayer
7482,UCBPlayer,131,271,402,25,41,UCBPlayer
7483,UCBPlayer,105,210,315,10,65,UCBPlayer
7484,UCBPlayer,130,275,405,25,40,UCBPlayer
7485,UCBPlayer,105,210,315,10,65,UCBPlayer
7486,UCBPlayer,130,275,405,25,40,UCBPlayer
7487,UCBPlayer,103,203,306,10,68,UCBPlayer
7488,UCBPlayer,128,283,411,25,38,UCBPlayer
7489,UCBPlayer,111,186,297,10,71,UCBPlayer
7490,UCBPlayer,124,299,423,25,34,UCBPlayer
7491,UCBPlayer,115,170,285,10,75,UCBPlayer
7492,UCBPlayer,120,315,435,25,30,UCBPlayer
7493,UCBPlayer,119,154,273,10,79,UCBPlayer
7494,UCBPlayer,112,332,444,25,27,UCBPlayer
7495,UCBPlayer,127,137,264,10,82,UCBPlayer
7496,UCBPlayer,104,349,453,25,24,UCBPlayer
7497,UCBPlayer,126,126,252,7,85,Tie
7498,UCBPlayer,111,351,462,28,22,UCBPlayer
7499,UCBPlayer,116,126,242,3,87,UCBPlayer
7500,UCBPlayer,122,347,469,32,21,UCBPlayer
7501,UCBPlayer,107,132,239,0,87,UCBPlayer
7502,UCBPlayer,132,337,469,35,22,UCBPlayer
7503,UCBPlayer,103,148,251,0,83,UCBPlayer
7504,UCBPlayer,136,321,457,35,26,UCBPlayer
7505,UCBPlayer,99,164,263,0,79,UCBPlayer
7506,UCBPlayer,140,305,445,35,30,UCBPlayer
7507,UCBPlayer,95,180,275,0,75,UCBPlayer
7508,UCBPlayer,144,289,433,35,34,UCBPlayer
7509,UCBPlayer,91,196,287,0,71,UCBPlayer
7510,UCBPlayer,148,273,421,35,38,UCBPlayer
7511,UCBPlayer,87,212,299,0,67,UCBPlayer
7512,UCBPlayer,152,257,409,35,42,UCBPlayer
7513,UCBPlayer,84,224,308,0,64,UCBPlayer
7514,UCBPlayer,146,251,397,32,45,UCBPlayer
7515,UCBPlayer,89,234,323,3,60,UCBPlayer
7516,UCBPlayer,138,243,381,28,49,UCBPlayer
7517,UCBPlayer,97,242,339,7,56,UCBPlayer
7518,UCBPlayer,130,235,365,24,53,UCBPlayer
7519,UCBPlayer,105,250,355,11,52,UCBPlayer
7520,UCBPlayer,122,227,349,20,57,UCBPlayer
7521,UCBPlayer,109,259,368,15,49,UCBPlayer
7522,UCBPlayer,118,218,336,16,60,UCBPlayer
7523,UCBPlayer,117,267,384,19,45,UCBPlayer
7524,UCBPlayer,110,210,320,12,64,UCBPlayer
7525,UCBPlayer,126,271,397,23,42,UCBPlayer
7526,UCBPlayer,105,210,315,10,65,UCBPlayer
7527,UCBPlayer,130,275,405,25,40,UCBPlayer
7528,UCBPlayer,105,210,315,10,65,UCBPlayer
7529,UCBPlayer,130,275,405,25,40,UCBPlayer
7530,UCBPlayer,106,206,312,10,66,UCBPlayer
7531,UCBPlayer,130,275,405,25,40,UCBPlayer
7532,UCBPlayer,105,210,315,10,65,UCBPlayer
7533,UCBPlayer,131,271,402,25,41,UCBPlayer
7534,UCBPlayer,105,210,315,10,65,UCBPlayer
7535,UCBPlayer,130,275,405,25,40,UCBPlayer
7536,UCBPlayer,105,210,315,10,65,UCBPlayer
7537,UCBPlayer,130,275,405,25,40,UCBPlayer
7538,UCBPlayer,103,203,306,10,68,UCBPlayer
7539,UCBPlayer,128,283,411,25,38,UCBPlayer
7540,UCBPlayer,111,186,297,10,71,UCBPlayer
7541,UCBPlayer,124,299,423,25,34,UCBPlayer
7542,UCBPlayer,115,170,285,10,75,UCBPlayer
7543,UCBPlayer,120,315,435,25,30,UCBPlayer
7544,UCBPlayer,119,154,273,10,79,UCBPlayer
7545,UCBPlayer,112,332,444,25,27,UCBPlayer
7546,UCBPlayer,127,137,264,10,82,UCBPlayer
7547,UCBPlayer,104,349,453,25,24,UCBPlayer
7548,UCBPlayer,126,126,252,7,85,Tie
7549,UCBPlayer,111,351,462,28,22,UCBPlayer
7550,UCBPlayer,116,126,242,3,87,UCBPlayer
7551,UCBPlayer,122,347,469,32,21,UCBPlayer
7552,UCBPlayer,107,132,239,0,87,UCBPlayer
7553,UCBPlayer,132,337,469,35,22,UCBPlayer
7554,UCBPlayer,103,148,251,0,83,UCBPlayer
7555,UCBPlayer,136,321,457,35,26,UCBPlayer
7556,UCBPlayer,99,164,263,0,79,UCBPlayer
7557,UCBPlayer,140,305,445,35,30,UCBPlayer
7558,UCBPlayer,95,180,275,0,75,UCBPlayer
7559,UCBPlayer,144,289,433,35,34,UCBPlayer
7560,UCBPlayer,91,196,287,0,71,UCBPlayer
7561,UCBPlayer,148,273,421,35,38,UCBPlayer
7562,UCBPlayer,87,212,299,0,67,UCBPlayer
7563,UCBPlayer,152,257,409,35,42,UCBPlayer
7564,UCBPlayer,84,224,308,0,64,UCBPlayer
7565,UCBPlayer,146,251,397,32,45,UCBPlayer
7566,UCBPlayer,89,234,323,3,60,UCBPlayer
7567,UCBPlayer,138,243,381,28,49,UCBPlayer
7568,UCBPlayer,97,242,339,7,56,UCBPlayer
7569,UCBPlayer,130,235,365,24,53,UCBPlayer
7570,UCBPlayer,105,250,355,11,52,UCBPlayer
7571,UCBPlayer,122,227,349,20,57,UCBPlayer
7572,UCBPlayer,109,259,368,15,49,UCBPlayer
7573,UCBPlayer,118,218,336,16,60,UCBPlayer
7574,UCBPlayer,117,267,384,19,45,UCBPlayer
7575,UCBPlayer,110,210,320,12,64,UCBPlayer
7576,UCBPlayer,126,271,397,23,42,UCBPlayer
7577,UCBPlayer,105,210,315,10,65,UCBPlayer
7578,UCBPlayer,130,275,405,25,40,UCBPlayer
7579,UCBPlayer,105,210,315,10,65,UCBPlayer
7580,UCBPlayer,130,275,405,25,40,UCBPlayer
7581,UCBPlayer,106,206,312,10,66,UCBPlayer
7582,UCBPlayer,130,275,405,25,40,UCBPlayer
7583,UCBPlayer,105,210,315,10,65,UCBPlayer
7584,UCBPlayer,131,271,402,25,41,UCBPlayer
7585,UCBPlayer,105,210,315,10,65,UCBPlayer
7586,UCBPlayer,130,275,405,25,40,UCBPlayer
7587,UCBPlayer,105,210,315,10,65,UCBPlayer
7588,UCBPlayer,130,275,405,25,40,UCBPlayer
7589,UCBPlayer,103,203,306,10,68,UCBPlayer
7590,UCBPlayer,128,283,411,25,38,UCBPlayer
7591,UCBPlayer,111,186,297,10,71,UCBPlayer
7592,UCBPlayer,124,299,423,25,34,UCBPlayer
7593,UCBPlayer,115,170,285,10,75,UCBPlayer
7594,UCBPlayer,120,315,435,25,30,UCBPlayer
7595,UCBPlayer,119,154,273,10,79,UCBPlayer
7596,UCBPlayer,112,332,444,25,27,UCBPlayer
7597,UCBPlayer,127,137,264,10,82,UCBPlayer
7598,UCBPlayer,104,349,453,25,24,UCBPlayer
7599,UCBPlayer,126,126,252,7,85,Tie
7600,UCBPlayer,111,351,462,28,22,UCBPlayer
7601,UCBPlayer,116,126,242,3,87,UCBPlayer
7602,UCBPlayer,122,347,469,32,21,UCBPlayer
7603,UCBPlayer,107,132,239,0,87,UCBPlayer
7604,UCBPlayer,132,337,469,35,22,UCBPlayer
7605,UCBPlayer,103,148,251,0,83,UCBPlayer
7606,UCBPlayer,136,321,457,35,26,UCBPlayer
7607,UCBPlayer,99,164,263,0,79,UCBPlayer
7608,UCBPlayer,140,305,445,35,30,UCBPlayer
7609,UCBPlayer,95,180,275,0,75,UCBPlayer
7610,UCBPlayer,144,289,433,35,34,UCBPlayer
7611,UCBPlayer,91,196,287,0,71,UCBPlayer
7612,UCBPlayer,148,273,421,35,38,UCBPlayer
7613,UCBPlayer,87,212,299,0,67,UCBPlayer
7614,UCBPlayer,152,257,409,35,42,UCBPlayer
7615,UCBPlayer,84,224,308,0,64,UCBPlayer
7616,UCBPlayer,146,251,397,32,45,UCBPlayer
7617,UCBPlayer,89,234,323,3,60,UCBPlayer
7618,UCBPlayer,138,243,381,28,49,UCBPlayer
7619,UCBPlayer,97,242,339,7,56,UCBPlayer
7620,UCBPlayer,130,235,365,24,53,UCBPlayer
7621,UCBPlayer,105,250,355,11,52,UCBPlayer
7622,UCBPlayer,122,227,349,20,57,UCBPlayer
7623,UCBPlayer,109,259,368,15,49,UCBPlayer
7624,UCBPlayer,118,218,336,16,60,UCBPlayer
7625,UCBPlayer,117,267,384,19,45,UCBPlayer
7626,UCBPlayer,110,210,320,12,64,UCBPlayer
7627,UCBPlayer,126,271,397,23,42,UCBPlayer
7628,UCBPlayer,105,210,315,10,65,UCBPlayer
7629,UCBPlayer,130,275,405,25,40,UCBPlayer
7630,UCBPlayer,105,210,315,10,65,UCBPlayer
7631,UCBPlayer,130,275,405,25,40,UCBPlayer
7632,UCBPlayer,106,206,312,10,66,UCBPlayer
7633,UCBPlayer,130,275,405,25,40,UCBPlayer
7634,UCBPlayer,105,210,315,10,65,UCBPlayer
7635,UCBPlayer,131,271,402,25,41,UCBPlayer
7636,UCBPlayer,105,210,315,10,65,UCBPlayer
7637,UCBPlayer,130,275,405,25,40,UCBPlayer
7638,UCBPlayer,105,210,315,10,65,UCBPlayer
7639,UCBPlayer,130,275,405,25,40,UCBPlayer
7640,UCBPlayer,103,203,306,10,68,UCBPlayer
7641,UCBPlayer,128,283,411,25,38,UCBPlayer
7642,UCBPlayer,111,186,297,10,71,UCBPlayer
7643,UCBPlayer,124,299,423,25,34,UCBPlayer
7644,UCBPlayer,115,170,285,10,75,UCBPlayer
7645,UCBPlayer,120,315,435,25,30,UCBPlayer
7646,UCBPlayer,119,154,273,10,79,UCBPlayer
7647,UCBPlayer,112,332,444,25,27,UCBPlayer
7648,UCBPlayer,127,137,264,10,82,UCBPlayer
7649,UCBPlayer,104,349,453,25,24,UCBPlayer
7650,UCBPlayer,126,126,252,7,85,Tie
7651,UCBPlayer,111,351,462,28,22,UCBPlayer
7652,UCBPlayer,116,126,242,3,87,UCBPlayer
7653,UCBPlayer,122,347,469,32,21,UCBPlayer
7654,UCBPlayer,107,132,239,0,87,UCBPlayer
7655,UCBPlayer,132,337,469,35,22,UCBPlayer
7656,UCBPlayer,103,148,251,0,83,UCBPlayer
7657,UCBPlayer,136,321,457,35,26,UCBPlayer
7658,UCBPlayer,99,164,263,0,79,UCBPlayer
7659,UCBPlayer,140,305,445,35,30,UCBPlayer
7660,UCBPlayer,95,180,275,0,75,UCBPlayer
7661,UCBPlayer,144,289,433,35,34,UCBPlayer
7662,UCBPlayer,91,196,287,0,71,UCBPlayer
7663,UCBPlayer,148,273,421,35,38,UCBPlayer
7664,UCBPlayer,87,212,299,0,67,UCBPlayer
7665,UCBPlayer,152,257,409,35,42,UCBPlayer
7666,UCBPlayer,84,224,308,0,64,UCBPlayer
7667,UCBPlayer,146,251,397,32,45,UCBPlayer
7668,UCBPlayer,89,234,323,3,60,UCBPlayer
7669,UCBPlayer,138,243,381,28,49,UCBPlayer
7670,UCBPlayer,97,242,339,7,56,UCBPlayer
7671,UCBPlayer,130,235,365,24,53,UCBPlayer
7672,UCBPlayer,105,250,355,11,52,UCBPlayer
7673,UCBPlayer,122,227,349,20,57,UCBPlayer
7674,UCBPlayer,109,259,368,15,49,UCBPlayer
7675,UCBPlayer,118,218,336,16,60,UCBPlayer
7676,UCBPlayer,117,267,384,19,45,UCBPlayer
7677,UCBPlayer,110,210,320,12,64,UCBPlayer
7678,UCBPlayer,126,271,397,23,42,UCBPlayer
7679,UCBPlayer,105,210,315,10,65,UCBPlayer
7680,UCBPlayer,130,275,405,25,40,UCBPlayer
7681,UCBPlayer,105,210,315,10,65,UCBPlayer
7682,UCBPlayer,130,275,405,25,40,UCBPlayer
7683,UCBPlayer,106,206,312,10,66,UCBPlayer
7684,UCBPlayer,130,275,405,25,40,UCBPlayer
7685,UCBPlayer,105,210,315,10,65,UCBPlayer
7686,UCBPlayer,131,271,402,25,41,UCBPlayer
7687,UCBPlayer,105,210,315,10,65,UCBPlayer
7688,UCBPlayer,130,275,405,25,40,UCBPlayer
7689,UCBPlayer,105,210,315,10,65,UCBPlayer
7690,UCBPlayer,130,275,405,25,40,UCBPlayer
7691,UCBPlayer,103,203,306,10,68,UCBPlayer
7692,UCBPlayer,128,283,411,25,38,UCBPlayer
7693,UCBPlayer,111,186,297,10,71,UCBPlayer
7694,UCBPlayer,124,299,423,25,34,UCBPlayer
7695,UCBPlayer,115,170,285,10,75,UCBPlayer
7696,UCBPlayer,120,315,435,25,30,UCBPlayer
7697,UCBPlayer,119,154,273,10,79,UCBPlayer
7698,UCBPlayer,112,332,444,25,27,UCBPlayer
7699,UCBPlayer,127,137,264,10,82,UCBPlayer
7700,UCBPlayer,104,349,453,25,24,UCBPlayer
7701,UCBPlayer,126,126,252,7,85,Tie
7702,UCBPlayer,111,351,462,28,22,UCBPlayer
7703,UCBPlayer,116,126,242,3,87,UCBPlayer
7704,UCBPlayer,122,347,469,32,21,UCBPlayer
7705,UCBPlayer,107,132,239,0,87,UCBPlayer
7706,UCBPlayer,132,337,469,35,22,UCBPlayer
7707,UCBPlayer,103,148,251,0,83,UCBPlayer
7708,UCBPlayer,136,321,457,35,26,UCBPlayer
7709,UCBPlayer,99,164,263,0,79,UCBPlayer
7710,UCBPlayer,140,305,445,35,30,UCBPlayer
7711,UCBPlayer,95,180,275,0,75,UCBPlayer
7712,UCBPlayer,144,289,433,35,34,UCBPlayer
7713,UCBPlayer,91,196,287,0,71,UCBPlayer
7714,UCBPlayer,148,273,421,35,38,UCBPlayer
7715,UCBPlayer,87,212,299,0,67,UCBPlayer
7716,UCBPlayer,152,257,409,35,42,UCBPlayer
7717,UCBPlayer,84,224,308,0,64,UCBPlayer
7718,UCBPlayer,146,251,397,32,45,UCBPlayer
7719,UCBPlayer,89,234,323,3,60,UCBPlayer
7720,UCBPlayer,138,243,381,28,49,UCBPlayer
7721,UCBPlayer,97,242,339,7,56,UCBPlayer
7722,UCBPlayer,130,235,365,24,53,UCBPlayer
7723,UCBPlayer,105,250,355,11,52,UCBPlayer
7724,UCBPlayer,122,227,349,20,57,UCBPlayer
7725,UCBPlayer,109,259,368,15,49,UCBPlayer
7726,UCBPlayer,118,218,336,16,60,UCBPlayer
7727,UCBPlayer,117,267,384,19,45,UCBPlayer
7728,UCBPlayer,110,210,320,12,64,UCBPlayer
7729,UCBPlayer,126,271,397,23,42,UCBPlayer
7730,UCBPlayer,105,210,315,10,65,UCBPlayer
7731,UCBPlayer,130,275,405,25,40,UCBPlayer
7732,UCBPlayer,105,210,315,10,65,UCBPlayer
7733,UCBPlayer,130,275,405,25,40,UCBPlayer
7734,UCBPlayer,106,206,312,10,66,UCBPlayer
7735,UCBPlayer,130,275,405,25,40,UCBPlayer
7736,UCBPlayer,105,210,315,10,65,UCBPlayer
7737,UCBPlayer,131,271,402,25,41,UCBPlayer
7738,UCBPlayer,105,210,315,10,65,UCBPlayer
7739,UCBPlayer,130,275,405,25,40,UCBPlayer
7740,UCBPlayer,105,210,315,10,65,UCBPlayer
7741,UCBPlayer,130,275,405,25,40,UCBPlayer
7742,UCBPlayer,103,203,306,10,68,UCBPlayer
7743,UCBPlayer,128,283,411,25,38,UCBPlayer
7744,UCBPlayer,111,186,297,10,71,UCBPlayer
7745,UCBPlayer,124,299,423,25,34,UCBPlayer
7746,UCBPlayer,115,170,285,10,75,UCBPlayer
7747,UCBPlayer,120,315,435,25,30,UCBPlayer
7748,UCBPlayer,119,154,273,10,79,UCBPlayer
7749,UCBPlayer,112,332,444,25,27,UCBPlayer
7750,UCBPlayer,127,137,264,10,82,UCBPlayer
7751,UCBPlayer,104,349,453,25,24,UCBPlayer
7752,UCBPlayer,126,126,252,7,85,Tie
7753,UCBPlayer,111,351,462,28,22,UCBPlayer
7754,UCBPlayer,116,126,242,3,87,UCBPlayer
7755,UCBPlayer,122,347,469,32,21,UCBPlayer
7756,UCBPlayer,107,132,239,0,87,UCBPlayer
7757,UCBPlayer,132,337,469,35,22,UCBPlayer
7758,UCBPlayer,103,148,251,0,83,UCBPlayer
7759,UCBPlayer,136,321,457,35,26,UCBPlayer
7760,UCBPlayer,99,164,263,0,79,UCBPlayer
7761,UCBPlayer,140,305,445,35,30,UCBPlayer
7762,UCBPlayer,95,180,275,0,75,UCBPlayer
7763,UCBPlayer,144,289,433,35,34,UCBPlayer
7764,UCBPlayer,91,196,287,0,71,UCBPlayer
7765,UCBPlayer,148,273,421,35,38,UCBPlayer
7766,UCBPlayer,87,212,299,0,67,UCBPlayer
7767,UCBPlayer,152,257,409,35,42,UCBPlayer
7768,UCBPlayer,84,224,308,0,64,UCBPlayer
7769,UCBPlayer,146,251,397,32,45,UCBPlayer
7770,UCBPlayer,89,234,323,3,60,UCBPlayer
7771,UCBPlayer,138,243,381,28,49,UCBPlayer
7772,UCBPlayer,97,242,339,7,56,UCBPlayer
7773,UCBPlayer,130,235,365,24,53,UCBPlayer
7774,UCBPlayer,105,250,355,11,52,UCBPlayer
7775,UCBPlayer,122,227,349,20,57,UCBPlayer
7776,UCBPlayer,109,259,368,15,49,UCBPlayer
7777,UCBPlayer,118,218,336,16,60,UCBPlayer
7778,UCBPlayer,117,267,384,19,45,UCBPlayer
7779,UCBPlayer,110,210,320,12,64,UCBPlayer
7780,UCBPlayer,126,271,397,23,42,UCBPlayer
7781,UCBPlayer,105,210,315,10,65,UCBPlayer
7782,UCBPlayer,130,275,405,25,40,UCBPlayer
7783,UCBPlayer,105,210,315,10,65,UCBPlayer
7784,UCBPlayer,130,275,405,25,40,UCBPlayer
7785,UCBPlayer,106,206,312,10,66,UCBPlayer
7786,UCBPlayer,130,275,405,25,40,UCBPlayer
7787,UCBPlayer,105,210,315,10,65,UCBPlayer
7788,UCBPlayer,131,271,402,25,41,UCBPlayer
7789,UCBPlayer,105,210,315,10,65,UCBPlayer
7790,UCBPlayer,130,275,405,25,40,UCBPlayer
7791,UCBPlayer,105,210,315,10,65,UCBPlayer
7792,UCBPlayer,130,275,405,25,40,UCBPlayer
7793,UCBPlayer,103,203,306,10,68,UCBPlayer
7794,UCBPlayer,128,283,411,25,38,UCBPlayer
7795,UCBPlayer,111,186,297,10,71,UCBPlayer
7796,UCBPlayer,124,299,423,25,34,UCBPlayer
7797,UCBPlayer,115,170,285,10,75,UCBPlayer
7798,UCBPlayer,120,315,435,25,30,UCBPlayer
7799,UCBPlayer,119,154,273,10,79,UCBPlayer
7800,UCBPlayer,112,332,444,25,27,UCBPlayer
7801,UCBPlayer,127,137,264,10,82,UCBPlayer
7802,UCBPlayer,104,349,453,25,24,UCBPlayer
7803,UCBPlayer,126,126,252,7,85,Tie
7804,UCBPlayer,111,351,462,28,22,UCBPlayer
7805,UCBPlayer,116,126,242,3,87,UCBPlayer
7806,UCBPlayer,122,347,469,32,21,UCBPlayer
7807,UCBPlayer,107,132,239,0,87,UCBPlayer
7808,UCBPlayer,132,337,469,35,22,UCBPlayer
7809,UCBPlayer,103,148,251,0,83,UCBPlayer
7810,UCBPlayer,136,321,457,35,26,UCBPlayer
7811,UCBPlayer,99,164,263,0,79,UCBPlayer
7812,UCBPlayer,140,305,445,35,30,UCBPlayer
7813,UCBPlayer,95,180,275,0,75,UCBPlayer
7814,UCBPlayer,144,289,433,35,34,UCBPlayer
7815,UCBPlayer,91,196,287,0,71,UCBPlayer
7816,UCBPlayer,148,273,421,35,38,UCBPlayer
7817,UCBPlayer,87,212,299,0,67,UCBPlayer
7818,UCBPlayer,152,257,409,35,42,UCBPlayer
7819,UCBPlayer,84,224,308,0,64,UCBPlayer
7820,UCBPlayer,146,251,397,32,45,UCBPlayer
7821,UCBPlayer,89,234,323,3,60,UCBPlayer
7822,UCBPlayer,138,243,381,28,49,UCBPlayer
7823,UCBPlayer,97,242,339,7,56,UCBPlayer
7824,UCBPlayer,130,235,365,24,53,UCBPlayer
7825,UCBPlayer,105,250,355,11,52,UCBPlayer
7826,UCBPlayer,122,227,349,20,57,UCBPlayer
7827,UCBPlayer,109,259,368,15,49,UCBPlayer
7828,UCBPlayer,118,218,336,16,60,UCBPlayer
7829,UCBPlayer,117,267,384,19,45,UCBPlayer
7830,UCBPlayer,110,210,320,12,64,UCBPlayer
7831,UCBPlayer,126,271,397,23,42,UCBPlayer
7832,UCBPlayer,105,210,315,10,65,UCBPlayer
7833,UCBPlayer,130,275,405,25,40,UCBPlayer
7834,UCBPlayer,105,210,315,10,65,UCBPlayer
7835,UCBPlayer,130,275,405,25,40,UCBPlayer
7836,UCBPlayer,106,206,312,10,66,UCBPlayer
7837,UCBPlayer,130,275,405,25,40,UCBPlayer
7838,UCBPlayer,105,210,315,10,65,UCBPlayer
7839,UCBPlayer,131,271,402,25,41,UCBPlayer
7840,UCBPlayer,105,210,315,10,65,UCBPlayer
7841,UCBPlayer,130,275,405,25,40,UCBPlayer
7842,UCBPlayer,105,210,315,10,65,UCBPlayer
7843,UCBPlayer,130,275,405,25,40,UCBPlayer
7844,UCBPlayer,103,203,306,10,68,UCBPlayer
7845,UCBPlayer,128,283,411,25,38,UCBPlayer
7846,UCBPlayer,111,186,297,10,71,UCBPlayer
7847,UCBPlayer,124,299,423,25,34,UCBPlayer
7848,UCBPlayer,115,170,285,10,75,UCBPlayer
7849,UCBPlayer,120,315,435,25,30,UCBPlayer
7850,UCBPlayer,119,154,273,10,79,UCBPlayer
7851,UCBPlayer,112,332,444,25,27,UCBPlayer
7852,UCBPlayer,127,137,264,10,82,UCBPlayer
7853,UCBPlayer,104,349,453,25,24,UCBPlayer
7854,UCBPlayer,126,126,252,7,85,Tie
7855,UCBPlayer,111,351,462,28,22,UCBPlayer
7856,UCBPlayer,116,126,242,3,87,UCBPlayer
7857,UCBPlayer,122,347,469,32,21,UCBPlayer
7858,UCBPlayer,107,132,239,0,87,UCBPlayer
7859,UCBPlayer,132,337,469,35,22,UCBPlayer
7860,UCBPlayer,103,148,251,0,83,UCBPlayer
7861,UCBPlayer,136,321,457,35,26,UCBPlayer
7862,UCBPlayer,99,164,263,0,79,UCBPlayer
7863,UCBPlayer,140,305,445,35,30,UCBPlayer
7864,UCBPlayer,95,180,275,0,75,UCBPlayer
7865,UCBPlayer,144,289,433,35,34,UCBPlayer
7866,UCBPlayer,91,196,287,0,71,UCBPlayer
7867,UCBPlayer,148,273,421,35,38,UCBPlayer
7868,UCBPlayer,87,212,299,0,67,UCBPlayer
7869,UCBPlayer,152,257,409,35,42,UCBPlayer
7870,UCBPlayer,84,224,308,0,64,UCBPlayer
7871,UCBPlayer,146,251,397,32,45,UCBPlayer
7872,UCBPlayer,89,234,323,3,60,UCBPlayer
7873,UCBPlayer,138,243,381,28,49,UCBPlayer
7874,UCBPlayer,97,242,339,7,56,UCBPlayer
7875,UCBPlayer,130,235,365,24,53,UCBPlayer
7876,UCBPlayer,105,250,355,11,52,UCBPlayer
7877,UCBPlayer,122,227,349,20,57,UCBPlayer
7878,UCBPlayer,109,259,368,15,49,UCBPlayer
7879,UCBPlayer,118,218,336,16,60,UCBPlayer
7880,UCBPlayer,117,267,384,19,45,UCBPlayer
7881,UCBPlayer,110,210,320,12,64,UCBPlayer
7882,UCBPlayer,126,271,397,23,42,UCBPlayer
7883,UCBPlayer,105,210,315,10,65,UCBPlayer
7884,UCBPlayer,130,275,405,25,40,UCBPlayer
7885,UCBPlayer,105,210,315,10,65,UCBPlayer
7886,UCBPlayer,130,275,405,25,40,UCBPlayer
7887,UCBPlayer,106,206,312,10,66,UCBPlayer
7888,UCBPlayer,130,275,405,25,40,UCBPlayer
7889,UCBPlayer,105,210,315,10,65,UCBPlayer
7890,UCBPlayer,131,271,402,25,41,UCBPlayer
7891,UCBPlayer,105,210,315,10,65,UCBPlayer
7892,UCBPlayer,130,275,405,25,40,UCBPlayer
7893,UCBPlayer,105,210,315,10,65,UCBPlayer
7894,UCBPlayer,130,275,405,25,40,UCBPlayer
7895,UCBPlayer,103,203,306,10,68,UCBPlayer
7896,UCBPlayer,128,283,411,25,38,UCBPlayer
7897,UCBPlayer,111,186,297,10,71,UCBPlayer
7898,UCBPlayer,124,299,423,25,34,UCBPlayer
7899,UCBPlayer,115,170,285,10,75,UCBPlayer
7900,UCBPlayer,120,315,435,25,30,UCBPlayer
7901,UCBPlayer,119,154,273,10,79,UCBPlayer
7902,UCBPlayer,112,332,444,25,27,UCBPlayer
7903,UCBPlayer,127,137,264,10,82,UCBPlayer
7904,UCBPlayer,104,349,453,25,24,UCBPlayer
7905,UCBPlayer,126,126,252,7,85,Tie
7906,UCBPlayer,111,351,462,28,22,UCBPlayer
7907,UCBPlayer,116,126,242,3,87,UCBPlayer
7908,UCBPlayer,122,347,469,32,21,UCBPlayer
7909,UCBPlayer,107,132,239,0,87,UCBPlayer
7910,UCBPlayer,132,337,469,35,22,UCBPlayer
7911,UCBPlayer,103,148,251,0,83,UCBPlayer
7912,UCBPlayer,136,321,457,35,26,UCBPlayer
7913,UCBPlayer,99,164,263,0,79,UCBPlayer
7914,UCBPlayer,140,305,445,35,30,UCBPlayer
7915,UCBPlayer,95,180,275,0,75,UCBPlayer
7916,UCBPlayer,144,289,433,35,34,UCBPlayer
7917,UCBPlayer,91,196,287,0,71,UCBPlayer
7918,UCBPlayer,148,273,421,35,38,UCBPlayer
7919,UCBPlayer,87,212,299,0,67,UCBPlayer
7920,UCBPlayer,152,257,409,35,42,UCBPlayer
7921,UCBPlayer,84,224,308,0,64,UCBPlayer
7922,UCBPlayer,146,251,397,32,45,UCBPlayer
7923,UCBPlayer,89,234,323,3,60,UCBPlayer
7924,UCBPlayer,138,243,381,28,49,UCBPlayer
7925,UCBPlayer,97,242,339,7,56,UCBPlayer
7926,UCBPlayer,130,235,365,24,53,UCBPlayer
7927,UCBPlayer,105,250,355,11,52,UCBPlayer
7928,UCBPlayer,122,227,349,20,57,UCBPlayer
7929,UCBPlayer,109,259,368,15,49,UCBPlayer
7930,UCBPlayer,118,218,336,16,60,UCBPlayer
7931,UCBPlayer,117,267,384,19,45,UCBPlayer
7932,UCBPlayer,110,210,320,12,64,UCBPlayer
7933,UCBPlayer,126,271,397,23,42,UCBPlayer
7934,UCBPlayer,105,210,315,10,65,UCBPlayer
7935,UCBPlayer,130,275,405,25,40,UCBPlayer
7936,UCBPlayer,105,210,315,10,65,UCBPlayer
7937,UCBPlayer,130,275,405,25,40,UCBPlayer
7938,UCBPlayer,106,206,312,10,66,UCBPlayer
7939,UCBPlayer,130,275,405,25,40,UCBPlayer
7940,UCBPlayer,105,210,315,10,65,UCBPlayer
7941,UCBPlayer,131,271,402,25,41,UCBPlayer
7942,UCBPlayer,105,210,315,10,65,UCBPlayer
7943,UCBPlayer,130,275,405,25,40,UCBPlayer
7944,UCBPlayer,105,210,315,10,65,UCBPlayer
7945,UCBPlayer,130,275,405,25,40,UCBPlayer
7946,UCBPlayer,103,203,306,10,68,UCBPlayer
7947,UCBPlayer,128,283,411,25,38,UCBPlayer
7948,UCBPlayer,111,186,297,10,71,UCBPlayer
7949,UCBPlayer,124,299,423,25,34,UCBPlayer
7950,UCBPlayer,115,170,285,10,75,UCBPlayer
7951,UCBPlayer,120,315,435,25,30,UCBPlayer
7952,UCBPlayer,119,154,273,10,79,UCBPlayer
7953,UCBPlayer,112,332,444,25,27,UCBPlayer
7954,UCBPlayer,127,137,264,10,82,UCBPlayer
7955,UCBPlayer,104,349,453,25,24,UCBPlayer
7956,UCBPlayer,126,126,252,7,85,Tie
7957,UCBPlayer,111,351,462,28,22,UCBPlayer
7958,UCBPlayer,116,126,242,3,87,UCBPlayer
7959,UCBPlayer,122,347,469,32,21,UCBPlayer
7960,UCBPlayer,107,132,239,0,87,UCBPlayer
7961,UCBPlayer,132,337,469,35,22,UCBPlayer
7962,UCBPlayer,103,148,251,0,83,UCBPlayer
7963,UCBPlayer,136,321,457,35,26,UCBPlayer
7964,UCBPlayer,99,164,263,0,79,UCBPlayer
7965,UCBPlayer,140,305,445,35,30,UCBPlayer
7966,UCBPlayer,95,180,275,0,75,UCBPlayer
7967,UCBPlayer,144,289,433,35,34,UCBPlayer
7968,UCBPlayer,91,196,287,0,71,UCBPlayer
7969,UCBPlayer,148,273,421,35,38,UCBPlayer
7970,UCBPlayer,87,212,299,0,67,UCBPlayer
7971,UCBPlayer,152,257,409,35,42,UCBPlayer
7972,UCBPlayer,84,224,308,0,64,UCBPlayer
7973,UCBPlayer,146,251,397,32,45,UCBPlayer
7974,UCBPlayer,89,234,323,3,60,UCBPlayer
7975,UCBPlayer,138,243,381,28,49,UCBPlayer
7976,UCBPlayer,97,242,339,7,56,UCBPlayer
7977,UCBPlayer,130,235,365,24,53,UCBPlayer
7978,UCBPlayer,105,250,355,11,52,UCBPlayer
7979,UCBPlayer,122,227,349,20,57,UCBPlayer
7980,UCBPlayer,109,259,368,15,49,UCBPlayer
7981,UCBPlayer,118,218,336,16,60,UCBPlayer
7982,UCBPlayer,117,267,384,19,45,UCBPlayer
7983,UCBPlayer,110,210,320,12,64,UCBPlayer
7984,UCBPlayer,126,271,397,23,42,UCBPlayer
7985,UCBPlayer,105,210,315,10,65,UCBPlayer
7986,UCBPlayer,130,275,405,25,40,UCBPlayer
7987,UCBPlayer,105,210,315,10,65,UCBPlayer
7988,UCBPlayer,130,275,405,25,40,UCBPlayer
7989,UCBPlayer,106,206,312,10,66,UCBPlayer
7990,UCBPlayer,130,275,405,25,40,UCBPlayer
7991,UCBPlayer,105,210,315,10,65,UCBPlayer
7992,UCBPlayer,131,271,402,25,41,UCBPlayer
7993,UCBPlayer,105,210,315,10,65,UCBPlayer
7994,UCBPlayer,130,275,405,25,40,UCBPlayer
7995,UCBPlayer,105,210,315,10,65,UCBPlayer
7996,UCBPlayer,130,275,405,25,40,UCBPlayer
7997,UCBPlayer,103,203,306,10,68,UCBPlayer
7998,UCBPlayer,128,283,411,25,38,UCBPlayer
7999,UCBPlayer,111,186,297,10,71,UCBPlayer
8000,UCBPlayer,124,299,423,25,34,UCBPlayer
8001,UCBPlayer,115,170,285,10,75,UCBPlayer
8002,UCBPlayer,120,315,435,25,30,UCBPlayer
8003,UCBPlayer,119,154,273,10,79,UCBPlayer
8004,UCBPlayer,112,332,444,25,27,UCBPlayer
8005,UCBPlayer,127,137,264,10,82,UCBPlayer
8006,UCBPlayer,104,349,453,25,24,UCBPlayer
8007,UCBPlayer,126,126,252,7,85,Tie
8008,UCBPlayer,111,351,462,28,22,UCBPlayer
8009,UCBPlayer,116,126,242,3,87,UCBPlayer
8010,UCBPlayer,122,347,469,32,21,UCBPlayer
8011,UCBPlayer,107,132,239,0,87,UCBPlayer
8012,UCBPlayer,132,337,469,35,22,UCBPlayer
8013,UCBPlayer,103,148,251,0,83,UCBPlayer
8014,UCBPlayer,136,321,457,35,26,UCBPlayer
8015,UCBPlayer,99,164,263,0,79,UCBPlayer
8016,UCBPlayer,140,305,445,35,30,UCBPlayer
8017,UCBPlayer,95,180,275,0,75,UCBPlayer
8018,UCBPlayer,144,289,433,35,34,UCBPlayer
8019,UCBPlayer,91,196,287,0,71,UCBPlayer
8020,UCBPlayer,148,273,421,35,38,UCBPlayer
8021,UCBPlayer,87,212,299,0,67,UCBPlayer
8022,UCBPlayer,152,257,409,35,42,UCBPlayer
8023,UCBPlayer,84,224,308,0,64,UCBPlayer
8024,UCBPlayer,146,251,397,32,45,UCBPlayer
8025,UCBPlayer,89,234,323,3,60,UCBPlayer
8026,UCBPlayer,138,243,381,28,49,UCBPlayer
8027,UCBPlayer,97,242,339,7,56,UCBPlayer
8028,UCBPlayer,130,235,365,24,53,UCBPlayer
8029,UCBPlayer,105,250,355,11,52,UCBPlayer
8030,UCBPlayer,122,227,349,20,57,UCBPlayer
8031,UCBPlayer,109,259,368,15,49,UCBPlayer
8032,UCBPlayer,118,218,336,16,60,UCBPlayer
8033,UCBPlayer,117,267,384,19,45,UCBPlayer
8034,UCBPlayer,110,210,320,12,64,UCBPlayer
8035,UCBPlayer,126,271,397,23,42,UCBPlayer
8036,UCBPlayer,105,210,315,10,65,UCBPlayer
8037,UCBPlayer,130,275,405,25,40,UCBPlayer
8038,UCBPlayer,105,210,315,10,65,UCBPlayer
8039,UCBPlayer,130,275,405,25,40,UCBPlayer
8040,UCBPlayer,106,206,312,10,66,UCBPlayer
8041,UCBPlayer,130,275,405,25,40,UCBPlayer
8042,UCBPlayer,105,210,315,10,65,UCBPlayer
8043,UCBPlayer,131,271,402,25,41,UCBPlayer
8044,UCBPlayer,105,210,315,10,65,UCBPlayer
8045,UCBPlayer,130,275,405,25,40,UCBPlayer
8046,UCBPlayer,105,210,315,10,65,UCBPlayer
8047,UCBPlayer,130,275,405,25,40,UCBPlayer
8048,UCBPlayer,103,203,306,10,68,UCBPlayer
8049,UCBPlayer,128,283,411,25,38,UCBPlayer
8050,UCBPlayer,111,186,297,10,71,UCBPlayer
8051,UCBPlayer,124,299,423,25,34,UCBPlayer
8052,UCBPlayer,115,170,285,10,75,UCBPlayer
8053,UCBPlayer,120,315,435,25,30,UCBPlayer
8054,UCBPlayer,119,154,273,10,79,UCBPlayer
8055,UCBPlayer,112,332,444,25,27,UCBPlayer
8056,UCBPlayer,127,137,264,10,82,UCBPlayer
8057,UCBPlayer,104,349,453,25,24,UCBPlayer
8058,UCBPlayer,126,126,252,7,85,Tie
8059,UCBPlayer,111,351,462,28,22,UCBPlayer
8060,UCBPlayer,116,126,242,3,87,UCBPlayer
8061,UCBPlayer,122,347,469,32,21,UCBPlayer
8062,UCBPlayer,107,132,239,0,87,UCBPlayer
8063,UCBPlayer,132,337,469,35,22,UCBPlayer
8064,UCBPlayer,103,148,251,0,83,UCBPlayer
8065,UCBPlayer,136,321,457,35,26,UCBPlayer
8066,UCBPlayer,99,164,263,0,79,UCBPlayer
8067,UCBPlayer,140,305,445,35,30,UCBPlayer
8068,UCBPlayer,95,180,275,0,75,UCBPlayer
8069,UCBPlayer,144,289,433,35,34,UCBPlayer
8070,UCBPlayer,91,196,287,0,71,UCBPlayer
8071,UCBPlayer,148,273,421,35,38,UCBPlayer
8072,UCBPlayer,87,212,299,0,67,UCBPlayer
8073,UCBPlayer,152,257,409,35,42,UCBPlayer
8074,UCBPlayer,84,224,308,0,64,UCBPlayer
8075,UCBPlayer,146,251,397,32,45,UCBPlayer
8076,UCBPlayer,89,234,323,3,60,UCBPlayer
8077,UCBPlayer,138,243,381,28,49,UCBPlayer
8078,UCBPlayer,97,242,339,7,56,UCBPlayer
8079,UCBPlayer,130,235,365,24,53,UCBPlayer
8080,UCBPlayer,105,250,355,11,52,UCBPlayer
8081,UCBPlayer,122,227,349,20,57,UCBPlayer
8082,UCBPlayer,109,259,368,15,49,UCBPlayer
8083,UCBPlayer,118,218,336,16,60,UCBPlayer
8084,UCBPlayer,117,267,384,19,45,UCBPlayer
8085,UCBPlayer,110,210,320,12,64,UCBPlayer
8086,UCBPlayer,126,271,397,23,42,UCBPlayer
8087,UCBPlayer,105,210,315,10,65,UCBPlayer
8088,UCBPlayer,130,275,405,25,40,UCBPlayer
8089,UCBPlayer,105,210,315,10,65,UCBPlayer
8090,UCBPlayer,130,275,405,25,40,UCBPlayer
8091,UCBPlayer,106,206,312,10,66,UCBPlayer
8092,UCBPlayer,130,275,405,25,40,UCBPlayer
8093,UCBPlayer,105,210,315,10,65,UCBPlayer
8094,UCBPlayer,131,271,402,25,41,UCBPlayer
8095,UCBPlayer,105,210,315,10,65,UCBPlayer
8096,UCBPlayer,130,275,405,25,40,UCBPlayer
8097,UCBPlayer,105,210,315,10,65,UCBPlayer
8098,UCBPlayer,130,275,405,25,40,UCBPlayer
8099,UCBPlayer,103,203,306,10,68,UCBPlayer
8100,UCBPlayer,128,283,411,25,38,UCBPlayer
8101,UCBPlayer,111,186,297,10,71,UCBPlayer
8102,UCBPlayer,124,299,423,25,34,UCBPlayer
8103,UCBPlayer,115,170,285,10,75,UCBPlayer
8104,UCBPlayer,120,315,435,25,30,UCBPlayer
8105,UCBPlayer,119,154,273,10,79,UCBPlayer
8106,UCBPlayer,112,332,444,25,27,UCBPlayer
8107,UCBPlayer,127,137,264,10,82,UCBPlayer
8108,UCBPlayer,104,349,453,25,24,UCBPlayer
8109,UCBPlayer,126,126,252,7,85,Tie
8110,UCBPlayer,111,351,462,28,22,UCBPlayer
8111,UCBPlayer,116,126,242,3,87,UCBPlayer
8112,UCBPlayer,122,347,469,32,21,UCBPlayer
8113,UCBPlayer,107,132,239,0,87,UCBPlayer
8114,UCBPlayer,132,337,469,35,22,UCBPlayer
8115,UCBPlayer,103,148,251,0,83,UCBPlayer
8116,UCBPlayer,136,321,457,35,26,UCBPlayer
8117,UCBPlayer,99,164,263,0,79,UCBPlayer
8118,UCBPlayer,140,305,445,35,30,UCBPlayer
8119,UCBPlayer,95,180,275,0,75,UCBPlayer
8120,UCBPlayer,144,289,433,35,34,UCBPlayer
8121,UCBPlayer,91,196,287,0,71,UCBPlayer
8122,UCBPlayer,148,273,421,35,38,UCBPlayer
8123,UCBPlayer,87,212,299,0,67,UCBPlayer
8124,UCBPlayer,152,257,409,35,42,UCBPlayer
8125,UCBPlayer,84,224,308,0,64,UCBPlayer
8126,UCBPlayer,146,251,397,32,45,UCBPlayer
8127,UCBPlayer,89,234,323,3,60,UCBPlayer
8128,UCBPlayer,138,243,381,28,49,UCBPlayer
8129,UCBPlayer,97,242,339,7,56,UCBPlayer
8130,UCBPlayer,130,235,365,24,53,UCBPlayer
8131,UCBPlayer,105,250,355,11,52,UCBPlayer
8132,UCBPlayer,122,227,349,20,57,UCBPlayer
8133,UCBPlayer,109,259,368,15,49,UCBPlayer
8134,UCBPlayer,118,218,336,16,60,UCBPlayer
8135,UCBPlayer,117,267,384,19,45,UCBPlayer
8136,UCBPlayer,110,210,320,12,64,UCBPlayer
8137,UCBPlayer,126,271,397,23,42,UCBPlayer
8138,UCBPlayer,105,210,315,10,65,UCBPlayer
8139,UCBPlayer,130,275,405,25,40,UCBPlayer
8140,UCBPlayer,105,210,315,10,65,UCBPlayer
8141,UCBPlayer,130,275,405,25,40,UCBPlayer
8142,UCBPlayer,106,206,312,10,66,UCBPlayer
8143,UCBPlayer,130,275,405,25,40,UCBPlayer
8144,UCBPlayer,105,210,315,10,65,UCBPlayer
8145,UCBPlayer,131,271,402,25,41,UCBPlayer
8146,UCBPlayer,105,210,315,10,65,UCBPlayer
8147,UCBPlayer,130,275,405,25,40,UCBPlayer
8148,UCBPlayer,105,210,315,10,65,UCBPlayer
8149,UCBPlayer,130,275,405,25,40,UCBPlayer
8150,UCBPlayer,103,203,306,10,68,UCBPlayer
8151,UCBPlayer,128,283,411,25,38,UCBPlayer
8152,UCBPlayer,111,186,297,10,71,UCBPlayer
8153,UCBPlayer,124,299,423,25,34,UCBPlayer
8154,UCBPlayer,115,170,285,10,75,UCBPlayer
8155,UCBPlayer,120,315,435,25,30,UCBPlayer
8156,UCBPlayer,119,154,273,10,79,UCBPlayer
8157,UCBPlayer,112,332,444,25,27,UCBPlayer
8158,UCBPlayer,127,137,264,10,82,UCBPlayer
8159,UCBPlayer,104,349,453,25,24,UCBPlayer
8160,UCBPlayer,126,126,252,7,85,Tie
8161,UCBPlayer,111,351,462,28,22,UCBPlayer
8162,UCBPlayer,116,126,242,3,87,UCBPlayer
8163,UCBPlayer,122,347,469,32,21,UCBPlayer
8164,UCBPlayer,107,132,239,0,87,UCBPlayer
8165,UCBPlayer,132,337,469,35,22,UCBPlayer
8166,UCBPlayer,103,148,251,0,83,UCBPlayer
8167,UCBPlayer,136,321,457,35,26,UCBPlayer
8168,UCBPlayer,99,164,263,0,79,UCBPlayer
8169,UCBPlayer,140,305,445,35,30,UCBPlayer
8170,UCBPlayer,95,180,275,0,75,UCBPlayer
8171,UCBPlayer,144,289,433,35,34,UCBPlayer
8172,UCBPlayer,91,196,287,0,71,UCBPlayer
8173,UCBPlayer,148,273,421,35,38,UCBPlayer
8174,UCBPlayer,87,212,299,0,67,UCBPlayer
8175,UCBPlayer,152,257,409,35,42,UCBPlayer
8176,UCBPlayer,84,224,308,0,64,UCBPlayer
8177,UCBPlayer,146,251,397,32,45,UCBPlayer
8178,UCBPlayer,89,234,323,3,60,UCBPlayer
8179,UCBPlayer,138,243,381,28,49,UCBPlayer
8180,UCBPlayer,97,242,339,7,56,UCBPlayer
8181,UCBPlayer,130,235,365,24,53,UCBPlayer
8182,UCBPlayer,105,250,355,11,52,UCBPlayer
8183,UCBPlayer,122,227,349,20,57,UCBPlayer
8184,UCBPlayer,109,259,368,15,49,UCBPlayer
8185,UCBPlayer,118,218,336,16,60,UCBPlayer
8186,UCBPlayer,117,267,384,19,45,UCBPlayer
8187,UCBPlayer,110,210,320,12,64,UCBPlayer
8188,UCBPlayer,126,271,397,23,42,UCBPlayer
8189,UCBPlayer,105,210,315,10,65,UCBPlayer
8190,UCBPlayer,130,275,405,25,40,UCBPlayer
8191,UCBPlayer,105,210,315,10,65,UCBPlayer
8192,UCBPlayer,130,275,405,25,40,UCBPlayer
8193,UCBPlayer,106,206,312,10,66,UCBPlayer
8194,UCBPlayer,130,275,405,25,40,UCBPlayer
8195,UCBPlayer,105,210,315,10,65,UCBPlayer
8196,UCBPlayer,131,271,402,25,41,UCBPlayer
8197,UCBPlayer,105,210,315,10,65,UCBPlayer
8198,UCBPlayer,130,275,405,25,40,UCBPlayer
8199,UCBPlayer,105,210,315,10,65,UCBPlayer
8200,UCBPlayer,130,275,405,25,40,UCBPlayer
8201,UCBPlayer,103,203,306,10,68,UCBPlayer
8202,UCBPlayer,128,283,411,25,38,UCBPlayer
8203,UCBPlayer,111,186,297,10,71,UCBPlayer
8204,UCBPlayer,124,299,423,25,34,UCBPlayer
8205,UCBPlayer,115,170,285,10,75,UCBPlayer
8206,UCBPlayer,120,315,435,25,30,UCBPlayer
8207,UCBPlayer,119,154,273,10,79,UCBPlayer
8208,UCBPlayer,112,332,444,25,27,UCBPlayer
8209,UCBPlayer,127,137,264,10,82,UCBPlayer
8210,UCBPlayer,104,349,453,25,24,UCBPlayer
8211,UCBPlayer,126,126,252,7,85,Tie
8212,UCBPlayer,111,351,462,28,22,UCBPlayer
8213,UCBPlayer,116,126,242,3,87,UCBPlayer
8214,UCBPlayer,122,347,469,32,21,UCBPlayer
8215,UCBPlayer,107,132,239,0,87,UCBPlayer
8216,UCBPlayer,132,337,469,35,22,UCBPlayer
8217,UCBPlayer,103,148,251,0,83,UCBPlayer
8218,UCBPlayer,136,321,457,35,26,UCBPlayer
8219,UCBPlayer,99,164,263,0,79,UCBPlayer
8220,UCBPlayer,140,305,445,35,30,UCBPlayer
8221,UCBPlayer,95,180,275,0,75,UCBPlayer
8222,UCBPlayer,144,289,433,35,34,UCBPlayer
8223,UCBPlayer,91,196,287,0,71,UCBPlayer
8224,UCBPlayer,148,273,421,35,38,UCBPlayer
8225,UCBPlayer,87,212,299,0,67,UCBPlayer
8226,UCBPlayer,152,257,409,35,42,UCBPlayer
8227,UCBPlayer,84,224,308,0,64,UCBPlayer
8228,UCBPlayer,146,251,397,32,45,UCBPlayer
8229,UCBPlayer,89,234,323,3,60,UCBPlayer
8230,UCBPlayer,138,243,381,28,49,UCBPlayer
8231,UCBPlayer,97,242,339,7,56,UCBPlayer
8232,UCBPlayer,130,235,365,24,53,UCBPlayer
8233,UCBPlayer,105,250,355,11,52,UCBPlayer
8234,UCBPlayer,122,227,349,20,57,UCBPlayer
8235,UCBPlayer,109,259,368,15,49,UCBPlayer
8236,UCBPlayer,118,218,336,16,60,UCBPlayer
8237,UCBPlayer,117,267,384,19,45,UCBPlayer
8238,UCBPlayer,110,210,320,12,64,UCBPlayer
8239,UCBPlayer,126,271,397,23,42,UCBPlayer
8240,UCBPlayer,105,210,315,10,65,UCBPlayer
8241,UCBPlayer,130,275,405,25,40,UCBPlayer
8242,UCBPlayer,105,210,315,10,65,UCBPlayer
8243,UCBPlayer,130,275,405,25,40,UCBPlayer
8244,UCBPlayer,106,206,312,10,66,UCBPlayer
8245,UCBPlayer,130,275,405,25,40,UCBPlayer
8246,UCBPlayer,105,210,315,10,65,UCBPlayer
8247,UCBPlayer,131,271,402,25,41,UCBPlayer
8248,UCBPlayer,105,210,315,10,65,UCBPlayer
8249,UCBPlayer,130,275,405,25,40,UCBPlayer
8250,UCBPlayer,105,210,315,10,65,UCBPlayer
8251,UCBPlayer,130,275,405,25,40,UCBPlayer
8252,UCBPlayer,103,203,306,10,68,UCBPlayer
8253,UCBPlayer,128,283,411,25,38,UCBPlayer
8254,UCBPlayer,111,186,297,10,71,UCBPlayer
8255,UCBPlayer,124,299,423,25,34,UCBPlayer
8256,UCBPlayer,115,170,285,10,75,UCBPlayer
8257,UCBPlayer,120,315,435,25,30,UCBPlayer
8258,UCBPlayer,119,154,273,10,79,UCBPlayer
8259,UCBPlayer,112,332,444,25,27,UCBPlayer
8260,UCBPlayer,127,137,264,10,82,UCBPlayer
8261,UCBPlayer,104,349,453,25,24,UCBPlayer
8262,UCBPlayer,126,126,252,7,85,Tie
8263,UCBPlayer,111,351,462,28,22,UCBPlayer
8264,UCBPlayer,116,126,242,3,87,UCBPlayer
8265,UCBPlayer,122,347,469,32,21,UCBPlayer
8266,UCBPlayer,107,132,239,0,87,UCBPlayer
8267,UCBPlayer,132,337,469,35,22,UCBPlayer
8268,UCBPlayer,103,148,251,0,83,UCBPlayer
8269,UCBPlayer,136,321,457,35,26,UCBPlayer
8270,UCBPlayer,99,164,263,0,79,UCBPlayer
8271,UCBPlayer,140,305,445,35,30,UCBPlayer
8272,UCBPlayer,95,180,275,0,75,UCBPlayer
8273,UCBPlayer,144,289,433,35,34,UCBPlayer
8274,UCBPlayer,91,196,287,0,71,UCBPlayer
8275,UCBPlayer,148,273,421,35,38,UCBPlayer
8276,UCBPlayer,87,212,299,0,67,UCBPlayer
8277,UCBPlayer,152,257,409,35,42,UCBPlayer
8278,UCBPlayer,84,224,308,0,64,UCBPlayer
8279,UCBPlayer,146,251,397,32,45,UCBPlayer
8280,UCBPlayer,89,234,323,3,60,UCBPlayer
8281,UCBPlayer,138,243,381,28,49,UCBPlayer
8282,UCBPlayer,97,242,339,7,56,UCBPlayer
8283,UCBPlayer,130,235,365,24,53,UCBPlayer
8284,UCBPlayer,105,250,355,11,52,UCBPlayer
8285,UCBPlayer,122,227,349,20,57,UCBPlayer
8286,UCBPlayer,109,259,368,15,49,UCBPlayer
8287,UCBPlayer,118,218,336,16,60,UCBPlayer
8288,UCBPlayer,117,267,384,19,45,UCBPlayer
8289,UCBPlayer,110,210,320,12,64,UCBPlayer
8290,UCBPlayer,126,271,397,23,42,UCBPlayer
8291,UCBPlayer,105,210,315,10,65,UCBPlayer
8292,UCBPlayer,130,275,405,25,40,UCBPlayer
8293,UCBPlayer,105,210,315,10,65,UCBPlayer
8294,UCBPlayer,130,275,405,25,40,UCBPlayer
8295,UCBPlayer,106,206,312,10,66,UCBPlayer
8296,UCBPlayer,130,275,405,25,40,UCBPlayer
8297,UCBPlayer,105,210,315,10,65,UCBPlayer
8298,UCBPlayer,131,271,402,25,41,UCBPlayer
8299,UCBPlayer,105,210,315,10,65,UCBPlayer
8300,UCBPlayer,130,275,405,25,40,UCBPlayer
8301,UCBPlayer,105,210,315,10,65,UCBPlayer
8302,UCBPlayer,130,275,405,25,40,UCBPlayer
8303,UCBPlayer,103,203,306,10,68,UCBPlayer
8304,UCBPlayer,128,283,411,25,38,UCBPlayer
8305,UCBPlayer,111,186,297,10,71,UCBPlayer
8306,UCBPlayer,124,299,423,25,34,UCBPlayer
8307,UCBPlayer,115,170,285,10,75,UCBPlayer
8308,UCBPlayer,120,315,435,25,30,UCBPlayer
8309,UCBPlayer,119,154,273,10,79,UCBPlayer
8310,UCBPlayer,112,332,444,25,27,UCBPlayer
8311,UCBPlayer,127,137,264,10,82,UCBPlayer
8312,UCBPlayer,104,349,453,25,24,UCBPlayer
8313,UCBPlayer,126,126,252,7,85,Tie
8314,UCBPlayer,111,351,462,28,22,UCBPlayer
8315,UCBPlayer,116,126,242,3,87,UCBPlayer
8316,UCBPlayer,122,347,469,32,21,UCBPlayer
8317,UCBPlayer,107,132,239,0,87,UCBPlayer
8318,UCBPlayer,132,337,469,35,22,UCBPlayer
8319,UCBPlayer,103,148,251,0,83,UCBPlayer
8320,UCBPlayer,136,321,457,35,26,UCBPlayer
8321,UCBPlayer,99,164,263,0,79,UCBPlayer
8322,UCBPlayer,140,305,445,35,30,UCBPlayer
8323,UCBPlayer,95,180,275,0,75,UCBPlayer
8324,UCBPlayer,144,289,433,35,34,UCBPlayer
8325,UCBPlayer,91,196,287,0,71,UCBPlayer
8326,UCBPlayer,148,273,421,35,38,UCBPlayer
8327,UCBPlayer,87,212,299,0,67,UCBPlayer
8328,UCBPlayer,152,257,409,35,42,UCBPlayer
8329,UCBPlayer,84,224,308,0,64,UCBPlayer
8330,UCBPlayer,146,251,397,32,45,UCBPlayer
8331,UCBPlayer,89,234,323,3,60,UCBPlayer
8332,UCBPlayer,138,243,381,28,49,UCBPlayer
8333,UCBPlayer,97,242,339,7,56,UCBPlayer
8334,UCBPlayer,130,235,365,24,53,UCBPlayer
8335,UCBPlayer,105,250,355,11,52,UCBPlayer
8336,UCBPlayer,122,227,349,20,57,UCBPlayer
8337,UCBPlayer,109,259,368,15,49,UCBPlayer
8338,UCBPlayer,118,218,336,16,60,UCBPlayer
8339,UCBPlayer,117,267,384,19,45,UCBPlayer
8340,UCBPlayer,110,210,320,12,64,UCBPlayer
8341,UCBPlayer,126,271,397,23,42,UCBPlayer
8342,UCBPlayer,105,210,315,10,65,UCBPlayer
8343,UCBPlayer,130,275,405,25,40,UCBPlayer
8344,UCBPlayer,105,210,315,10,65,UCBPlayer
8345,UCBPlayer,130,275,405,25,40,UCBPlayer
8346,UCBPlayer,106,206,312,10,66,UCBPlayer
8347,UCBPlayer,130,275,405,25,40,UCBPlayer
8348,UCBPlayer,105,210,315,10,65,UCBPlayer
8349,UCBPlayer,131,271,402,25,41,UCBPlayer
8350,UCBPlayer,105,210,315,10,65,UCBPlayer
8351,UCBPlayer,130,275,405,25,40,UCBPlayer
8352,UCBPlayer,105,210,315,10,65,UCBPlayer
8353,UCBPlayer,130,275,405,25,40,UCBPlayer
8354,UCBPlayer,103,203,306,10,68,UCBPlayer
8355,UCBPlayer,128,283,411,25,38,UCBPlayer
8356,UCBPlayer,111,186,297,10,71,UCBPlayer
8357,UCBPlayer,124,299,423,25,34,UCBPlayer
8358,UCBPlayer,115,170,285,10,75,UCBPlayer
8359,UCBPlayer,120,315,435,25,30,UCBPlayer
8360,UCBPlayer,119,154,273,10,79,UCBPlayer
8361,UCBPlayer,112,332,444,25,27,UCBPlayer
8362,UCBPlayer,127,137,264,10,82,UCBPlayer
8363,UCBPlayer,104,349,453,25,24,UCBPlayer
8364,UCBPlayer,126,126,252,7,85,Tie
8365,UCBPlayer,111,351,462,28,22,UCBPlayer
8366,UCBPlayer,116,126,242,3,87,UCBPlayer
8367,UCBPlayer,122,347,469,32,21,UCBPlayer
8368,UCBPlayer,107,132,239,0,87,UCBPlayer
8369,UCBPlayer,132,337,469,35,22,UCBPlayer
8370,UCBPlayer,103,148,251,0,83,UCBPlayer
8371,UCBPlayer,136,321,457,35,26,UCBPlayer
8372,UCBPlayer,99,164,263,0,79,UCBPlayer
8373,UCBPlayer,140,305,445,35,30,UCBPlayer
8374,UCBPlayer,95,180,275,0,75,UCBPlayer
8375,UCBPlayer,144,289,433,35,34,UCBPlayer
8376,UCBPlayer,91,196,287,0,71,UCBPlayer
8377,UCBPlayer,148,273,421,35,38,UCBPlayer
8378,UCBPlayer,87,212,299,0,67,UCBPlayer
8379,UCBPlayer,152,257,409,35,42,UCBPlayer
8380,UCBPlayer,84,224,308,0,64,UCBPlayer
8381,UCBPlayer,146,251,397,32,45,UCBPlayer
8382,UCBPlayer,89,234,323,3,60,UCBPlayer
8383,UCBPlayer,138,243,381,28,49,UCBPlayer
8384,UCBPlayer,97,242,339,7,56,UCBPlayer
8385,UCBPlayer,130,235,365,24,53,UCBPlayer
8386,UCBPlayer,105,250,355,11,52,UCBPlayer
8387,UCBPlayer,122,227,349,20,57,UCBPlayer
8388,UCBPlayer,109,259,368,15,49,UCBPlayer
8389,UCBPlayer,118,218,336,16,60,UCBPlayer
8390,UCBPlayer,117,267,384,19,45,UCBPlayer
8391,UCBPlayer,110,210,320,12,64,UCBPlayer
8392,UCBPlayer,126,271,397,23,42,UCBPlayer
8393,UCBPlayer,105,210,315,10,65,UCBPlayer
8394,UCBPlayer,130,275,405,25,40,UCBPlayer
8395,UCBPlayer,105,210,315,10,65,UCBPlayer
8396,UCBPlayer,130,275,405,25,40,UCBPlayer
8397,UCBPlayer,106,206,312,10,66,UCBPlayer
8398,UCBPlayer,130,275,405,25,40,UCBPlayer
8399,UCBPlayer,105,210,315,10,65,UCBPlayer
8400,UCBPlayer,131,271,402,25,41,UCBPlayer
8401,UCBPlayer,105,210,315,10,65,UCBPlayer
8402,UCBPlayer,130,275,405,25,40,UCBPlayer
8403,UCBPlayer,105,210,315,10,65,UCBPlayer
8404,UCBPlayer,130,275,405,25,40,UCBPlayer
8405,UCBPlayer,103,203,306,10,68,UCBPlayer
8406,UCBPlayer,128,283,411,25,38,UCBPlayer
8407,UCBPlayer,111,186,297,10,71,UCBPlayer
8408,UCBPlayer,124,299,423,25,34,UCBPlayer
8409,UCBPlayer,115,170,285,10,75,UCBPlayer
8410,UCBPlayer,120,315,435,25,30,UCBPlayer
8411,UCBPlayer,119,154,273,10,79,UCBPlayer
8412,UCBPlayer,112,332,444,25,27,UCBPlayer
8413,UCBPlayer,127,137,264,10,82,UCBPlayer
8414,UCBPlayer,104,349,453,25,24,UCBPlayer
8415,UCBPlayer,126,126,252,7,85,Tie
8416,UCBPlayer,111,351,462,28,22,UCBPlayer
8417,UCBPlayer,116,126,242,3,87,UCBPlayer
8418,UCBPlayer,122,347,469,32,21,UCBPlayer
8419,UCBPlayer,107,132,239,0,87,UCBPlayer
8420,UCBPlayer,132,337,469,35,22,UCBPlayer
8421,UCBPlayer,103,148,251,0,83,UCBPlayer
8422,UCBPlayer,136,321,457,35,26,UCBPlayer
8423,UCBPlayer,99,164,263,0,79,UCBPlayer
8424,UCBPlayer,140,305,445,35,30,UCBPlayer
8425,UCBPlayer,95,180,275,0,75,UCBPlayer
8426,UCBPlayer,144,289,433,35,34,UCBPlayer
8427,UCBPlayer,91,196,287,0,71,UCBPlayer
8428,UCBPlayer,148,273,421,35,38,UCBPlayer
8429,UCBPlayer,87,212,299,0,67,UCBPlayer
8430,UCBPlayer,152,257,409,35,42,UCBPlayer
8431,UCBPlayer,84,224,308,0,64,UCBPlayer
8432,UCBPlayer,146,251,397,32,45,UCBPlayer
8433,UCBPlayer,89,234,323,3,60,UCBPlayer
8434,UCBPlayer,138,243,381,28,49,UCBPlayer
8435,UCBPlayer,97,242,339,7,56,UCBPlayer
8436,UCBPlayer,130,235,365,24,53,UCBPlayer
8437,UCBPlayer,105,250,355,11,52,UCBPlayer
8438,UCBPlayer,122,227,349,20,57,UCBPlayer
8439,UCBPlayer,109,259,368,15,49,UCBPlayer
8440,UCBPlayer,118,218,336,16,60,UCBPlayer
8441,UCBPlayer,117,267,384,19,45,UCBPlayer
8442,UCBPlayer,110,210,320,12,64,UCBPlayer
8443,UCBPlayer,126,271,397,23,42,UCBPlayer
8444,UCBPlayer,105,210,315,10,65,UCBPlayer
8445,UCBPlayer,130,275,405,25,40,UCBPlayer
8446,UCBPlayer,105,210,315,10,65,UCBPlayer
8447,UCBPlayer,130,275,405,25,40,UCBPlayer
8448,UCBPlayer,106,206,312,10,66,UCBPlayer
8449,UCBPlayer,130,275,405,25,40,UCBPlayer
8450,UCBPlayer,105,210,315,10,65,UCBPlayer
8451,UCBPlayer,131,271,402,25,41,UCBPlayer
8452,UCBPlayer,105,210,315,10,65,UCBPlayer
8453,UCBPlayer,130,275,405,25,40,UCBPlayer
8454,UCBPlayer,105,210,315,10,65,UCBPlayer
8455,UCBPlayer,130,275,405,25,40,UCBPlayer
8456,UCBPlayer,103,203,306,10,68,UCBPlayer
8457,UCBPlayer,128,283,411,25,38,UCBPlayer
8458,UCBPlayer,111,186,297,10,71,UCBPlayer
8459,UCBPlayer,124,299,423,25,34,UCBPlayer
8460,UCBPlayer,115,170,285,10,75,UCBPlayer
8461,UCBPlayer,120,315,435,25,30,UCBPlayer
8462,UCBPlayer,119,154,273,10,79,UCBPlayer
8463,UCBPlayer,112,332,444,25,27,UCBPlayer
8464,UCBPlayer,127,137,264,10,82,UCBPlayer
8465,UCBPlayer,104,349,453,25,24,UCBPlayer
8466,UCBPlayer,126,126,252,7,85,Tie
8467,UCBPlayer,111,351,462,28,22,UCBPlayer
8468,UCBPlayer,116,126,242,3,87,UCBPlayer
8469,UCBPlayer,122,347,469,32,21,UCBPlayer
8470,UCBPlayer,107,132,239,0,87,UCBPlayer
8471,UCBPlayer,132,337,469,35,22,UCBPlayer
8472,UCBPlayer,103,148,251,0,83,UCBPlayer
8473,UCBPlayer,136,321,457,35,26,UCBPlayer
8474,UCBPlayer,99,164,263,0,79,UCBPlayer
8475,UCBPlayer,140,305,445,35,30,UCBPlayer
8476,UCBPlayer,95,180,275,0,75,UCBPlayer
8477,UCBPlayer,144,289,433,35,34,UCBPlayer
8478,UCBPlayer,91,196,287,0,71,UCBPlayer
8479,UCBPlayer,148,273,421,35,38,UCBPlayer
8480,UCBPlayer,87,212,299,0,67,UCBPlayer
8481,UCBPlayer,152,257,409,35,42,UCBPlayer
8482,UCBPlayer,84,224,308,0,64,UCBPlayer
8483,UCBPlayer,146,251,397,32,45,UCBPlayer
8484,UCBPlayer,89,234,323,3,60,UCBPlayer
8485,UCBPlayer,138,243,381,28,49,UCBPlayer
8486,UCBPlayer,97,242,339,7,56,UCBPlayer
8487,UCBPlayer,130,235,365,24,53,UCBPlayer
8488,UCBPlayer,105,250,355,11,52,UCBPlayer
8489,UCBPlayer,122,227,349,20,57,UCBPlayer
8490,UCBPlayer,109,259,368,15,49,UCBPlayer
8491,UCBPlayer,118,218,336,16,60,UCBPlayer
8492,UCBPlayer,117,267,384,19,45,UCBPlayer
8493,UCBPlayer,110,210,320,12,64,UCBPlayer
8494,UCBPlayer,126,271,397,23,42,UCBPlayer
8495,UCBPlayer,105,210,315,10,65,UCBPlayer
8496,UCBPlayer,130,275,405,25,40,UCBPlayer
8497,UCBPlayer,105,210,315,10,65,UCBPlayer
8498,UCBPlayer,130,275,405,25,40,UCBPlayer
8499,UCBPlayer,106,206,312,10,66,UCBPlayer
8500,UCBPlayer,130,275,405,25,40,UCBPlayer
8501,UCBPlayer,105,210,315,10,65,UCBPlayer
8502,UCBPlayer,131,271,402,25,41,UCBPlayer
8503,UCBPlayer,105,210,315,10,65,UCBPlayer
8504,UCBPlayer,130,275,405,25,40,UCBPlayer
8505,UCBPlayer,105,210,315,10,65,UCBPlayer
8506,UCBPlayer,130,275,405,25,40,UCBPlayer
8507,UCBPlayer,103,203,306,10,68,UCBPlayer
8508,UCBPlayer,128,283,411,25,38,UCBPlayer
8509,UCBPlayer,111,186,297,10,71,UCBPlayer
8510,UCBPlayer,124,299,423,25,34,UCBPlayer
8511,UCBPlayer,115,170,285,10,75,UCBPlayer
8512,UCBPlayer,120,315,435,25,30,UCBPlayer
8513,UCBPlayer,119,154,273,10,79,UCBPlayer
8514,UCBPlayer,112,332,444,25,27,UCBPlayer
8515,UCBPlayer,127,137,264,10,82,UCBPlayer
8516,UCBPlayer,104,349,453,25,24,UCBPlayer
8517,UCBPlayer,126,126,252,7,85,Tie
8518,UCBPlayer,111,351,462,28,22,UCBPlayer
8519,UCBPlayer,116,126,242,3,87,UCBPlayer
8520,UCBPlayer,122,347,469,32,21,UCBPlayer
8521,UCBPlayer,107,132,239,0,87,UCBPlayer
8522,UCBPlayer,132,337,469,35,22,UCBPlayer
8523,UCBPlayer,103,148,251,0,83,UCBPlayer
8524,UCBPlayer,136,321,457,35,26,UCBPlayer
8525,UCBPlayer,99,164,263,0,79,UCBPlayer
8526,UCBPlayer,140,305,445,35,30,UCBPlayer
8527,UCBPlayer,95,180,275,0,75,UCBPlayer
8528,UCBPlayer,144,289,433,35,34,UCBPlayer
8529,UCBPlayer,91,196,287,0,71,UCBPlayer
8530,UCBPlayer,148,273,421,35,38,UCBPlayer
8531,UCBPlayer,87,212,299,0,67,UCBPlayer
8532,UCBPlayer,152,257,409,35,42,UCBPlayer
8533,UCBPlayer,84,224,308,0,64,UCBPlayer
8534,UCBPlayer,146,251,397,32,45,UCBPlayer
8535,UCBPlayer,89,234,323,3,60,UCBPlayer
8536,UCBPlayer,138,243,381,28,49,UCBPlayer
8537,UCBPlayer,97,242,339,7,56,UCBPlayer
8538,UCBPlayer,130,235,365,24,53,UCBPlayer
8539,UCBPlayer,105,250,355,11,52,UCBPlayer
8540,UCBPlayer,122,227,349,20,57,UCBPlayer
8541,UCBPlayer,109,259,368,15,49,UCBPlayer
8542,UCBPlayer,118,218,336,16,60,UCBPlayer
8543,UCBPlayer,117,267,384,19,45,UCBPlayer
8544,UCBPlayer,110,210,320,12,64,UCBPlayer
8545,UCBPlayer,126,271,397,23,42,UCBPlayer
8546,UCBPlayer,105,210,315,10,65,UCBPlayer
8547,UCBPlayer,130,275,405,25,40,UCBPlayer
8548,UCBPlayer,105,210,315,10,65,UCBPlayer
8549,UCBPlayer,130,275,405,25,40,UCBPlayer
8550,UCBPlayer,106,206,312,10,66,UCBPlayer
8551,UCBPlayer,130,275,405,25,40,UCBPlayer
8552,UCBPlayer,105,210,315,10,65,UCBPlayer
8553,UCBPlayer,131,271,402,25,41,UCBPlayer
8554,UCBPlayer,105,210,315,10,65,UCBPlayer
8555,UCBPlayer,130,275,405,25,40,UCBPlayer
8556,UCBPlayer,105,210,315,10,65,UCBPlayer
8557,UCBPlayer,130,275,405,25,40,UCBPlayer
8558,UCBPlayer,103,203,306,10,68,UCBPlayer
8559,UCBPlayer,128,283,411,25,38,UCBPlayer
8560,UCBPlayer,111,186,297,10,71,UCBPlayer
8561,UCBPlayer,124,299,423,25,34,UCBPlayer
8562,UCBPlayer,115,170,285,10,75,UCBPlayer
8563,UCBPlayer,120,315,435,25,30,UCBPlayer
8564,UCBPlayer,119,154,273,10,79,UCBPlayer
8565,UCBPlayer,112,332,444,25,27,UCBPlayer
8566,UCBPlayer,127,137,264,10,82,UCBPlayer
8567,UCBPlayer,104,349,453,25,24,UCBPlayer
8568,UCBPlayer,126,126,252,7,85,Tie
8569,UCBPlayer,111,351,462,28,22,UCBPlayer
8570,UCBPlayer,116,126,242,3,87,UCBPlayer
8571,UCBPlayer,122,347,469,32,21,UCBPlayer
8572,UCBPlayer,107,132,239,0,87,UCBPlayer
8573,UCBPlayer,132,337,469,35,22,UCBPlayer
8574,UCBPlayer,103,148,251,0,83,UCBPlayer
8575,UCBPlayer,136,321,457,35,26,UCBPlayer
8576,UCBPlayer,99,164,263,0,79,UCBPlayer
8577,UCBPlayer,140,305,445,35,30,UCBPlayer
8578,UCBPlayer,95,180,275,0,75,UCBPlayer
8579,UCBPlayer,144,289,433,35,34,UCBPlayer
8580,UCBPlayer,91,196,287,0,71,UCBPlayer
8581,UCBPlayer,148,273,421,35,38,UCBPlayer
8582,UCBPlayer,87,212,299,0,67,UCBPlayer
8583,UCBPlayer,152,257,409,35,42,UCBPlayer
8584,UCBPlayer,84,224,308,0,64,UCBPlayer
8585,UCBPlayer,146,251,397,32,45,UCBPlayer
8586,UCBPlayer,89,234,323,3,60,UCBPlayer
8587,UCBPlayer,138,243,381,28,49,UCBPlayer
8588,UCBPlayer,97,242,339,7,56,UCBPlayer
8589,UCBPlayer,130,235,365,24,53,UCBPlayer
8590,UCBPlayer,105,250,355,11,52,UCBPlayer
8591,UCBPlayer,122,227,349,20,57,UCBPlayer
8592,UCBPlayer,109,259,368,15,49,UCBPlayer
8593,UCBPlayer,118,218,336,16,60,UCBPlayer
8594,UCBPlayer,117,267,384,19,45,UCBPlayer
8595,UCBPlayer,110,210,320,12,64,UCBPlayer
8596,UCBPlayer,126,271,397,23,42,UCBPlayer
8597,UCBPlayer,105,210,315,10,65,UCBPlayer
8598,UCBPlayer,130,275,405,25,40,UCBPlayer
8599,UCBPlayer,105,210,315,10,65,UCBPlayer
8600,UCBPlayer,130,275,405,25,40,UCBPlayer
8601,UCBPlayer,106,206,312,10,66,UCBPlayer
8602,UCBPlayer,130,275,405,25,40,UCBPlayer
8603,UCBPlayer,105,210,315,10,65,UCBPlayer
8604,UCBPlayer,131,271,402,25,41,UCBPlayer
8605,UCBPlayer,105,210,315,10,65,UCBPlayer
8606,UCBPlayer,130,275,405,25,40,UCBPlayer
8607,UCBPlayer,105,210,315,10,65,UCBPlayer
8608,UCBPlayer,130,275,405,25,40,UCBPlayer
8609,UCBPlayer,103,203,306,10,68,UCBPlayer
8610,UCBPlayer,128,283,411,25,38,UCBPlayer
8611,UCBPlayer,111,186,297,10,71,UCBPlayer
8612,UCBPlayer,124,299,423,25,34,UCBPlayer
8613,UCBPlayer,115,170,285,10,75,UCBPlayer
8614,UCBPlayer,120,315,435,25,30,UCBPlayer
8615,UCBPlayer,119,154,273,10,79,UCBPlayer
8616,UCBPlayer,112,332,444,25,27,UCBPlayer
8617,UCBPlayer,127,137,264,10,82,UCBPlayer
8618,UCBPlayer,104,349,453,25,24,UCBPlayer
8619,UCBPlayer,126,126,252,7,85,Tie
8620,UCBPlayer,111,351,462,28,22,UCBPlayer
8621,UCBPlayer,116,126,242,3,87,UCBPlayer
8622,UCBPlayer,122,347,469,32,21,UCBPlayer
8623,UCBPlayer,107,132,239,0,87,UCBPlayer
8624,UCBPlayer,132,337,469,35,22,UCBPlayer
8625,UCBPlayer,103,148,251,0,83,UCBPlayer
8626,UCBPlayer,136,321,457,35,26,UCBPlayer
8627,UCBPlayer,99,164,263,0,79,UCBPlayer
8628,UCBPlayer,140,305,445,35,30,UCBPlayer
8629,UCBPlayer,95,180,275,0,75,UCBPlayer
8630,UCBPlayer,144,289,433,35,34,UCBPlayer
8631,UCBPlayer,91,196,287,0,71,UCBPlayer
8632,UCBPlayer,148,273,421,35,38,UCBPlayer
8633,UCBPlayer,87,212,299,0,67,UCBPlayer
8634,UCBPlayer,152,257,409,35,42,UCBPlayer
8635,UCBPlayer,84,224,308,0,64,UCBPlayer
8636,UCBPlayer,146,251,397,32,45,UCBPlayer
8637,UCBPlayer,89,234,323,3,60,UCBPlayer
8638,UCBPlayer,138,243,381,28,49,UCBPlayer
8639,UCBPlayer,97,242,339,7,56,UCBPlayer
8640,UCBPlayer,130,235,365,24,53,UCBPlayer
8641,UCBPlayer,105,250,355,11,52,UCBPlayer
8642,UCBPlayer,122,227,349,20,57,UCBPlayer
8643,UCBPlayer,109,259,368,15,49,UCBPlayer
8644,UCBPlayer,118,218,336,16,60,UCBPlayer
8645,UCBPlayer,117,267,384,19,45,UCBPlayer
8646,UCBPlayer,110,210,320,12,64,UCBPlayer
8647,UCBPlayer,126,271,397,23,42,UCBPlayer
8648,UCBPlayer,105,210,315,10,65,UCBPlayer
8649,UCBPlayer,130,275,405,25,40,UCBPlayer
8650,UCBPlayer,105,210,315,10,65,UCBPlayer
8651,UCBPlayer,130,275,405,25,40,UCBPlayer
8652,UCBPlayer,106,206,312,10,66,UCBPlayer
8653,UCBPlayer,130,275,405,25,40,UCBPlayer
8654,UCBPlayer,105,210,315,10,65,UCBPlayer
8655,UCBPlayer,131,271,402,25,41,UCBPlayer
8656,UCBPlayer,105,210,315,10,65,UCBPlayer
8657,UCBPlayer,130,275,405,25,40,UCBPlayer
8658,UCBPlayer,105,210,315,10,65,UCBPlayer
8659,UCBPlayer,130,275,405,25,40,UCBPlayer
8660,UCBPlayer,103,203,306,10,68,UCBPlayer
8661,UCBPlayer,128,283,411,25,38,UCBPlayer
8662,UCBPlayer,111,186,297,10,71,UCBPlayer
8663,UCBPlayer,124,299,423,25,34,UCBPlayer
8664,UCBPlayer,115,170,285,10,75,UCBPlayer
8665,UCBPlayer,120,315,435,25,30,UCBPlayer
8666,UCBPlayer,119,154,273,10,79,UCBPlayer
8667,UCBPlayer,112,332,444,25,27,UCBPlayer
8668,UCBPlayer,127,137,264,10,82,UCBPlayer
8669,UCBPlayer,104,349,453,25,24,UCBPlayer
8670,UCBPlayer,126,126,252,7,85,Tie
8671,UCBPlayer,111,351,462,28,22,UCBPlayer
8672,UCBPlayer,116,126,242,3,87,UCBPlayer
8673,UCBPlayer,122,347,469,32,21,UCBPlayer
8674,UCBPlayer,107,132,239,0,87,UCBPlayer
8675,UCBPlayer,132,337,469,35,22,UCBPlayer
8676,UCBPlayer,103,148,251,0,83,UCBPlayer
8677,UCBPlayer,136,321,457,35,26,UCBPlayer
8678,UCBPlayer,99,164,263,0,79,UCBPlayer
8679,UCBPlayer,140,305,445,35,30,UCBPlayer
8680,UCBPlayer,95,180,275,0,75,UCBPlayer
8681,UCBPlayer,144,289,433,35,34,UCBPlayer
8682,UCBPlayer,91,196,287,0,71,UCBPlayer
8683,UCBPlayer,148,273,421,35,38,UCBPlayer
8684,UCBPlayer,87,212,299,0,67,UCBPlayer
8685,UCBPlayer,152,257,409,35,42,UCBPlayer
8686,UCBPlayer,84,224,308,0,64,UCBPlayer
8687,UCBPlayer,146,251,397,32,45,UCBPlayer
8688,UCBPlayer,89,234,323,3,60,UCBPlayer
8689,UCBPlayer,138,243,381,28,49,UCBPlayer
8690,UCBPlayer,97,242,339,7,56,UCBPlayer
8691,UCBPlayer,130,235,365,24,53,UCBPlayer
8692,UCBPlayer,105,250,355,11,52,UCBPlayer
8693,UCBPlayer,122,227,349,20,57,UCBPlayer
8694,UCBPlayer,109,259,368,15,49,UCBPlayer
8695,UCBPlayer,118,218,336,16,60,UCBPlayer
8696,UCBPlayer,117,267,384,19,45,UCBPlayer
8697,UCBPlayer,110,210,320,12,64,UCBPlayer
8698,UCBPlayer,126,271,397,23,42,UCBPlayer
8699,UCBPlayer,105,210,315,10,65,UCBPlayer
8700,UCBPlayer,130,275,405,25,40,UCBPlayer
8701,UCBPlayer,105,210,315,10,65,UCBPlayer
8702,UCBPlayer,130,275,405,25,40,UCBPlayer
8703,UCBPlayer,106,206,312,10,66,UCBPlayer
8704,UCBPlayer,130,275,405,25,40,UCBPlayer
8705,UCBPlayer,105,210,315,10,65,UCBPlayer
8706,UCBPlayer,131,271,402,25,41,UCBPlayer
8707,UCBPlayer,105,210,315,10,65,UCBPlayer
8708,UCBPlayer,130,275,405,25,40,UCBPlayer
8709,UCBPlayer,105,210,315,10,65,UCBPlayer
8710,UCBPlayer,130,275,405,25,40,UCBPlayer
8711,UCBPlayer,103,203,306,10,68,UCBPlayer
8712,UCBPlayer,128,283,411,25,38,UCBPlayer
8713,UCBPlayer,111,186,297,10,71,UCBPlayer
8714,UCBPlayer,124,299,423,25,34,UCBPlayer
8715,UCBPlayer,115,170,285,10,75,UCBPlayer
8716,UCBPlayer,120,315,435,25,30,UCBPlayer
8717,UCBPlayer,119,154,273,10,79,UCBPlayer
8718,UCBPlayer,112,332,444,25,27,UCBPlayer
8719,UCBPlayer,127,137,264,10,82,UCBPlayer
8720,UCBPlayer,104,349,453,25,24,UCBPlayer
8721,UCBPlayer,126,126,252,7,85,Tie
8722,UCBPlayer,111,351,462,28,22,UCBPlayer
8723,UCBPlayer,116,126,242,3,87,UCBPlayer
8724,UCBPlayer,122,347,469,32,21,UCBPlayer
8725,UCBPlayer,107,132,239,0,87,UCBPlayer
8726,UCBPlayer,132,337,469,35,22,UCBPlayer
8727,UCBPlayer,103,148,251,0,83,UCBPlayer
8728,UCBPlayer,136,321,457,35,26,UCBPlayer
8729,UCBPlayer,99,164,263,0,79,UCBPlayer
8730,UCBPlayer,140,305,445,35,30,UCBPlayer
8731,UCBPlayer,95,180,275,0,75,UCBPlayer
8732,UCBPlayer,144,289,433,35,34,UCBPlayer
8733,UCBPlayer,91,196,287,0,71,UCBPlayer
8734,UCBPlayer,148,273,421,35,38,UCBPlayer
8735,UCBPlayer,87,212,299,0,67,UCBPlayer
8736,UCBPlayer,152,257,409,35,42,UCBPlayer
8737,UCBPlayer,84,224,308,0,64,UCBPlayer
8738,UCBPlayer,146,251,397,32,45,UCBPlayer
8739,UCBPlayer,89,234,323,3,60,UCBPlayer
8740,UCBPlayer,138,243,381,28,49,UCBPlayer
8741,UCBPlayer,97,242,339,7,56,UCBPlayer
8742,UCBPlayer,130,235,365,24,53,UCBPlayer
8743,UCBPlayer,105,250,355,11,52,UCBPlayer
8744,UCBPlayer,122,227,349,20,57,UCBPlayer
8745,UCBPlayer,109,259,368,15,49,UCBPlayer
8746,UCBPlayer,118,218,336,16,60,UCBPlayer
8747,UCBPlayer,117,267,384,19,45,UCBPlayer
8748,UCBPlayer,110,210,320,12,64,UCBPlayer
8749,UCBPlayer,126,271,397,23,42,UCBPlayer
8750,UCBPlayer,105,210,315,10,65,UCBPlayer
8751,UCBPlayer,130,275,405,25,40,UCBPlayer
8752,UCBPlayer,105,210,315,10,65,UCBPlayer
8753,UCBPlayer,130,275,405,25,40,UCBPlayer
8754,UCBPlayer,106,206,312,10,66,UCBPlayer
8755,UCBPlayer,130,275,405,25,40,UCBPlayer
8756,UCBPlayer,105,210,315,10,65,UCBPlayer
8757,UCBPlayer,131,271,402,25,41,UCBPlayer
8758,UCBPlayer,105,210,315,10,65,UCBPlayer
8759,UCBPlayer,130,275,405,25,40,UCBPlayer
8760,UCBPlayer,105,210,315,10,65,UCBPlayer
8761,UCBPlayer,130,275,405,25,40,UCBPlayer
8762,UCBPlayer,103,203,306,10,68,UCBPlayer
8763,UCBPlayer,128,283,411,25,38,UCBPlayer
8764,UCBPlayer,111,186,297,10,71,UCBPlayer
8765,UCBPlayer,124,299,423,25,34,UCBPlayer
8766,UCBPlayer,115,170,285,10,75,UCBPlayer
8767,UCBPlayer,120,315,435,25,30,UCBPlayer
8768,UCBPlayer,119,154,273,10,79,UCBPlayer
8769,UCBPlayer,112,332,444,25,27,UCBPlayer
8770,UCBPlayer,127,137,264,10,82,UCBPlayer
8771,UCBPlayer,104,349,453,25,24,UCBPlayer
8772,UCBPlayer,126,126,252,7,85,Tie
8773,UCBPlayer,111,351,462,28,22,UCBPlayer
8774,UCBPlayer,116,126,242,3,87,UCBPlayer
8775,UCBPlayer,122,347,469,32,21,UCBPlayer
8776,UCBPlayer,107,132,239,0,87,UCBPlayer
8777,UCBPlayer,132,337,469,35,22,UCBPlayer
8778,UCBPlayer,103,148,251,0,83,UCBPlayer
8779,UCBPlayer,136,321,457,35,26,UCBPlayer
8780,UCBPlayer,99,164,263,0,79,UCBPlayer
8781,UCBPlayer,140,305,445,35,30,UCBPlayer
8782,UCBPlayer,95,180,275,0,75,UCBPlayer
8783,UCBPlayer,144,289,433,35,34,UCBPlayer
8784,UCBPlayer,91,196,287,0,71,UCBPlayer
8785,UCBPlayer,148,273,421,35,38,UCBPlayer
8786,UCBPlayer,87,212,299,0,67,UCBPlayer
8787,UCBPlayer,152,257,409,35,42,UCBPlayer
8788,UCBPlayer,84,224,308,0,64,UCBPlayer
8789,UCBPlayer,146,251,397,32,45,UCBPlayer
8790,UCBPlayer,89,234,323,3,60,UCBPlayer
8791,UCBPlayer,138,243,381,28,49,UCBPlayer
8792,UCBPlayer,97,242,339,7,56,UCBPlayer
8793,UCBPlayer,130,235,365,24,53,UCBPlayer
8794,UCBPlayer,105,250,355,11,52,UCBPlayer
8795,UCBPlayer,122,227,349,20,57,UCBPlayer
8796,UCBPlayer,109,259,368,15,49,UCBPlayer
8797,UCBPlayer,118,218,336,16,60,UCBPlayer
8798,UCBPlayer,117,267,384,19,45,UCBPlayer
8799,UCBPlayer,110,210,320,12,64,UCBPlayer
8800,UCBPlayer,126,271,397,23,42,UCBPlayer
8801,UCBPlayer,105,210,315,10,65,UCBPlayer
8802,UCBPlayer,130,275,405,25,40,UCBPlayer
8803,UCBPlayer,105,210,315,10,65,UCBPlayer
8804,UCBPlayer,130,275,405,25,40,UCBPlayer
8805,UCBPlayer,106,206,312,10,66,UCBPlayer
8806,UCBPlayer,130,275,405,25,40,UCBPlayer
8807,UCBPlayer,105,210,315,10,65,UCBPlayer
8808,UCBPlayer,131,271,402,25,41,UCBPlayer
8809,UCBPlayer,105,210,315,10,65,UCBPlayer
8810,UCBPlayer,130,275,405,25,40,UCBPlayer
8811,UCBPlayer,105,210,315,10,65,UCBPlayer
8812,UCBPlayer,130,275,405,25,40,UCBPlayer
8813,UCBPlayer,103,203,306,10,68,UCBPlayer
8814,UCBPlayer,128,283,411,25,38,UCBPlayer
8815,UCBPlayer,111,186,297,10,71,UCBPlayer
8816,UCBPlayer,124,299,423,25,34,UCBPlayer
8817,UCBPlayer,115,170,285,10,75,UCBPlayer
8818,UCBPlayer,120,315,435,25,30,UCBPlayer
8819,UCBPlayer,119,154,273,10,79,UCBPlayer
8820,UCBPlayer,112,332,444,25,27,UCBPlayer
8821,UCBPlayer,127,137,264,10,82,UCBPlayer
8822,UCBPlayer,104,349,453,25,24,UCBPlayer
8823,UCBPlayer,126,126,252,7,85,Tie
8824,UCBPlayer,111,351,462,28,22,UCBPlayer
8825,UCBPlayer,116,126,242,3,87,UCBPlayer
8826,UCBPlayer,122,347,469,32,21,UCBPlayer
8827,UCBPlayer,107,132,239,0,87,UCBPlayer
8828,UCBPlayer,132,337,469,35,22,UCBPlayer
8829,UCBPlayer,103,148,251,0,83,UCBPlayer
8830,UCBPlayer,136,321,457,35,26,UCBPlayer
8831,UCBPlayer,99,164,263,0,79,UCBPlayer
8832,UCBPlayer,140,305,445,35,30,UCBPlayer
8833,UCBPlayer,95,180,275,0,75,UCBPlayer
8834,UCBPlayer,144,289,433,35,34,UCBPlayer
8835,UCBPlayer,91,196,287,0,71,UCBPlayer
8836,UCBPlayer,148,273,421,35,38,UCBPlayer
8837,UCBPlayer,87,212,299,0,67,UCBPlayer
8838,UCBPlayer,152,257,409,35,42,UCBPlayer
8839,UCBPlayer,84,224,308,0,64,UCBPlayer
8840,UCBPlayer,146,251,397,32,45,UCBPlayer
8841,UCBPlayer,89,234,323,3,60,UCBPlayer
8842,UCBPlayer,138,243,381,28,49,UCBPlayer
8843,UCBPlayer,97,242,339,7,56,UCBPlayer
8844,UCBPlayer,130,235,365,24,53,UCBPlayer
8845,UCBPlayer,105,250,355,11,52,UCBPlayer
8846,UCBPlayer,122,227,349,20,57,UCBPlayer
8847,UCBPlayer,109,259,368,15,49,UCBPlayer
8848,UCBPlayer,118,218,336,16,60,UCBPlayer
8849,UCBPlayer,117,267,384,19,45,UCBPlayer
8850,UCBPlayer,110,210,320,12,64,UCBPlayer
8851,UCBPlayer,126,271,397,23,42,UCBPlayer
8852,UCBPlayer,105,210,315,10,65,UCBPlayer
8853,UCBPlayer,130,275,405,25,40,UCBPlayer
8854,UCBPlayer,105,210,315,10,65,UCBPlayer
8855,UCBPlayer,130,275,405,25,40,UCBPlayer
8856,UCBPlayer,106,206,312,10,66,UCBPlayer
8857,UCBPlayer,130,275,405,25,40,UCBPlayer
8858,UCBPlayer,105,210,315,10,65,UCBPlayer
8859,UCBPlayer,131,271,402,25,41,UCBPlayer
8860,UCBPlayer,105,210,315,10,65,UCBPlayer
8861,UCBPlayer,130,275,405,25,40,UCBPlayer
8862,UCBPlayer,105,210,315,10,65,UCBPlayer
8863,UCBPlayer,130,275,405,25,40,UCBPlayer
8864,UCBPlayer,103,203,306,10,68,UCBPlayer
8865,UCBPlayer,128,283,411,25,38,UCBPlayer
8866,UCBPlayer,111,186,297,10,71,UCBPlayer
8867,UCBPlayer,124,299,423,25,34,UCBPlayer
8868,UCBPlayer,115,170,285,10,75,UCBPlayer
8869,UCBPlayer,120,315,435,25,30,UCBPlayer
8870,UCBPlayer,119,154,273,10,79,UCBPlayer
8871,UCBPlayer,112,332,444,25,27,UCBPlayer
8872,UCBPlayer,127,137,264,10,82,UCBPlayer
8873,UCBPlayer,104,349,453,25,24,UCBPlayer
8874,UCBPlayer,126,126,252,7,85,Tie
8875,UCBPlayer,111,351,462,28,22,UCBPlayer
8876,UCBPlayer,116,126,242,3,87,UCBPlayer
8877,UCBPlayer,122,347,469,32,21,UCBPlayer
8878,UCBPlayer,107,132,239,0,87,UCBPlayer
8879,UCBPlayer,132,337,469,35,22,UCBPlayer
8880,UCBPlayer,103,148,251,0,83,UCBPlayer
8881,UCBPlayer,136,321,457,35,26,UCBPlayer
8882,UCBPlayer,99,164,263,0,79,UCBPlayer
8883,UCBPlayer,140,305,445,35,30,UCBPlayer
8884,UCBPlayer,95,180,275,0,75,UCBPlayer
8885,UCBPlayer,144,289,433,35,34,UCBPlayer
8886,UCBPlayer,91,196,287,0,71,UCBPlayer
8887,UCBPlayer,148,273,421,35,38,UCBPlayer
8888,UCBPlayer,87,212,299,0,67,UCBPlayer
8889,UCBPlayer,152,257,409,35,42,UCBPlayer
8890,UCBPlayer,84,224,308,0,64,UCBPlayer
8891,UCBPlayer,146,251,397,32,45,UCBPlayer
8892,UCBPlayer,89,234,323,3,60,UCBPlayer
8893,UCBPlayer,138,243,381,28,49,UCBPlayer
8894,UCBPlayer,97,242,339,7,56,UCBPlayer
8895,UCBPlayer,130,235,365,24,53,UCBPlayer
8896,UCBPlayer,105,250,355,11,52,UCBPlayer
8897,UCBPlayer,122,227,349,20,57,UCBPlayer
8898,UCBPlayer,109,259,368,15,49,UCBPlayer
8899,UCBPlayer,118,218,336,16,60,UCBPlayer
8900,UCBPlayer,117,267,384,19,45,UCBPlayer
8901,UCBPlayer,110,210,320,12,64,UCBPlayer
8902,UCBPlayer,126,271,397,23,42,UCBPlayer
8903,UCBPlayer,105,210,315,10,65,UCBPlayer
8904,UCBPlayer,130,275,405,25,40,UCBPlayer
8905,UCBPlayer,105,210,315,10,65,UCBPlayer
8906,UCBPlayer,130,275,405,25,40,UCBPlayer
8907,UCBPlayer,106,206,312,10,66,UCBPlayer
8908,UCBPlayer,130,275,405,25,40,UCBPlayer
8909,UCBPlayer,105,210,315,10,65,UCBPlayer
8910,UCBPlayer,131,271,402,25,41,UCBPlayer
8911,UCBPlayer,105,210,315,10,65,UCBPlayer
8912,UCBPlayer,130,275,405,25,40,UCBPlayer
8913,UCBPlayer,105,210,315,10,65,UCBPlayer
8914,UCBPlayer,130,275,405,25,40,UCBPlayer
8915,UCBPlayer,103,203,306,10,68,UCBPlayer
8916,UCBPlayer,128,283,411,25,38,UCBPlayer
8917,UCBPlayer,111,186,297,10,71,UCBPlayer
8918,UCBPlayer,124,299,423,25,34,UCBPlayer
8919,UCBPlayer,115,170,285,10,75,UCBPlayer
8920,UCBPlayer,120,315,435,25,30,UCBPlayer
8921,UCBPlayer,119,154,273,10,79,UCBPlayer
8922,UCBPlayer,112,332,444,25,27,UCBPlayer
8923,UCBPlayer,127,137,264,10,82,UCBPlayer
8924,UCBPlayer,104,349,453,25,24,UCBPlayer
8925,UCBPlayer,126,126,252,7,85,Tie
8926,UCBPlayer,111,351,462,28,22,UCBPlayer
8927,UCBPlayer,116,126,242,3,87,UCBPlayer
8928,UCBPlayer,122,347,469,32,21,UCBPlayer
8929,UCBPlayer,107,132,239,0,87,UCBPlayer
8930,UCBPlayer,132,337,469,35,22,UCBPlayer
8931,UCBPlayer,103,148,251,0,83,UCBPlayer
8932,UCBPlayer,136,321,457,35,26,UCBPlayer
8933,UCBPlayer,99,164,263,0,79,UCBPlayer
8934,UCBPlayer,140,305,445,35,30,UCBPlayer
8935,UCBPlayer,95,180,275,0,75,UCBPlayer
8936,UCBPlayer,144,289,433,35,34,UCBPlayer
8937,UCBPlayer,91,196,287,0,71,UCBPlayer
8938,UCBPlayer,148,273,421,35,38,UCBPlayer
8939,UCBPlayer,87,212,299,0,67,UCBPlayer
8940,UCBPlayer,152,257,409,35,42,UCBPlayer
8941,UCBPlayer,84,224,308,0,64,UCBPlayer
8942,UCBPlayer,146,251,397,32,45,UCBPlayer
8943,UCBPlayer,89,234,323,3,60,UCBPlayer
8944,UCBPlayer,138,243,381,28,49,UCBPlayer
8945,UCBPlayer,97,242,339,7,56,UCBPlayer
8946,UCBPlayer,130,235,365,24,53,UCBPlayer
8947,UCBPlayer,105,250,355,11,52,UCBPlayer
8948,UCBPlayer,122,227,349,20,57,UCBPlayer
8949,UCBPlayer,109,259,368,15,49,UCBPlayer
8950,UCBPlayer,118,218,336,16,60,UCBPlayer
8951,UCBPlayer,117,267,384,19,45,UCBPlayer
8952,UCBPlayer,110,210,320,12,64,UCBPlayer
8953,UCBPlayer,126,271,397,23,42,UCBPlayer
8954,UCBPlayer,105,210,315,10,65,UCBPlayer
8955,UCBPlayer,130,275,405,25,40,UCBPlayer
8956,UCBPlayer,105,210,315,10,65,UCBPlayer
8957,UCBPlayer,130,275,405,25,40,UCBPlayer
8958,UCBPlayer,106,206,312,10,66,UCBPlayer
8959,UCBPlayer,130,275,405,25,40,UCBPlayer
8960,UCBPlayer,105,210,315,10,65,UCBPlayer
8961,UCBPlayer,131,271,402,25,41,UCBPlayer
8962,UCBPlayer,105,210,315,10,65,UCBPlayer
8963,UCBPlayer,130,275,405,25,40,UCBPlayer
8964,UCBPlayer,105,210,315,10,65,UCBPlayer
8965,UCBPlayer,130,275,405,25,40,UCBPlayer
8966,UCBPlayer,103,203,306,10,68,UCBPlayer
8967,UCBPlayer,128,283,411,25,38,UCBPlayer
8968,UCBPlayer,111,186,297,10,71,UCBPlayer
8969,UCBPlayer,124,299,423,25,34,UCBPlayer
8970,UCBPlayer,115,170,285,10,75,UCBPlayer
8971,UCBPlayer,120,315,435,25,30,UCBPlayer
8972,UCBPlayer,119,154,273,10,79,UCBPlayer
8973,UCBPlayer,112,332,444,25,27,UCBPlayer
8974,UCBPlayer,127,137,264,10,82,UCBPlayer
8975,UCBPlayer,104,349,453,25,24,UCBPlayer
8976,UCBPlayer,126,126,252,7,85,Tie
8977,UCBPlayer,111,351,462,28,22,UCBPlayer
8978,UCBPlayer,116,126,242,3,87,UCBPlayer
8979,UCBPlayer,122,347,469,32,21,UCBPlayer
8980,UCBPlayer,107,132,239,0,87,UCBPlayer
8981,UCBPlayer,132,337,469,35,22,UCBPlayer
8982,UCBPlayer,103,148,251,0,83,UCBPlayer
8983,UCBPlayer,136,321,457,35,26,UCBPlayer
8984,UCBPlayer,99,164,263,0,79,UCBPlayer
8985,UCBPlayer,140,305,445,35,30,UCBPlayer
8986,UCBPlayer,95,180,275,0,75,UCBPlayer
8987,UCBPlayer,144,289,433,35,34,UCBPlayer
8988,UCBPlayer,91,196,287,0,71,UCBPlayer
8989,UCBPlayer,148,273,421,35,38,UCBPlayer
8990,UCBPlayer,87,212,299,0,67,UCBPlayer
8991,UCBPlayer,152,257,409,35,42,UCBPlayer
8992,UCBPlayer,84,224,308,0,64,UCBPlayer
8993,UCBPlayer,146,251,397,32,45,UCBPlayer
8994,UCBPlayer,89,234,323,3,60,UCBPlayer
8995,UCBPlayer,138,243,381,28,49,UCBPlayer
8996,UCBPlayer,97,242,339,7,56,UCBPlayer
8997,UCBPlayer,130,235,365,24,53,UCBPlayer
8998,UCBPlayer,105,250,355,11,52,UCBPlayer
8999,UCBPlayer,122,227,349,20,57,UCBPlayer
9000,UCBPlayer,109,259,368,15,49,UCBPlayer
9001,UCBPlayer,118,218,336,16,60,UCBPlayer
9002,UCBPlayer,117,267,384,19,45,UCBPlayer
9003,UCBPlayer,110,210,320,12,64,UCBPlayer
9004,UCBPlayer,126,271,397,23,42,UCBPlayer
9005,UCBPlayer,105,210,315,10,65,UCBPlayer
9006,UCBPlayer,130,275,405,25,40,UCBPlayer
9007,UCBPlayer,105,210,315,10,65,UCBPlayer
9008,UCBPlayer,130,275,405,25,40,UCBPlayer
9009,UCBPlayer,106,206,312,10,66,UCBPlayer
9010,UCBPlayer,130,275,405,25,40,UCBPlayer
9011,UCBPlayer,105,210,315,10,65,UCBPlayer
9012,UCBPlayer,131,271,402,25,41,UCBPlayer
9013,UCBPlayer,105,210,315,10,65,UCBPlayer
9014,UCBPlayer,130,275,405,25,40,UCBPlayer
9015,UCBPlayer,105,210,315,10,65,UCBPlayer
9016,UCBPlayer,130,275,405,25,40,UCBPlayer
9017,UCBPlayer,103,203,306,10,68,UCBPlayer
9018,UCBPlayer,128,283,411,25,38,UCBPlayer
9019,UCBPlayer,111,186,297,10,71,UCBPlayer
9020,UCBPlayer,124,299,423,25,34,UCBPlayer
9021,UCBPlayer,115,170,285,10,75,UCBPlayer
9022,UCBPlayer,120,315,435,25,30,UCBPlayer
9023,UCBPlayer,119,154,273,10,79,UCBPlayer
9024,UCBPlayer,112,332,444,25,27,UCBPlayer
9025,UCBPlayer,127,137,264,10,82,UCBPlayer
9026,UCBPlayer,104,349,453,25,24,UCBPlayer
9027,UCBPlayer,126,126,252,7,85,Tie
9028,UCBPlayer,111,351,462,28,22,UCBPlayer
9029,UCBPlayer,116,126,242,3,87,UCBPlayer
9030,UCBPlayer,122,347,469,32,21,UCBPlayer
9031,UCBPlayer,107,132,239,0,87,UCBPlayer
9032,UCBPlayer,132,337,469,35,22,UCBPlayer
9033,UCBPlayer,103,148,251,0,83,UCBPlayer
9034,UCBPlayer,136,321,457,35,26,UCBPlayer
9035,UCBPlayer,99,164,263,0,79,UCBPlayer
9036,UCBPlayer,140,305,445,35,30,UCBPlayer
9037,UCBPlayer,95,180,275,0,75,UCBPlayer
9038,UCBPlayer,144,289,433,35,34,UCBPlayer
9039,UCBPlayer,91,196,287,0,71,UCBPlayer
9040,UCBPlayer,148,273,421,35,38,UCBPlayer
9041,UCBPlayer,87,212,299,0,67,UCBPlayer
9042,UCBPlayer,152,257,409,35,42,UCBPlayer
9043,UCBPlayer,84,224,308,0,64,UCBPlayer
9044,UCBPlayer,146,251,397,32,45,UCBPlayer
9045,UCBPlayer,89,234,323,3,60,UCBPlayer
9046,UCBPlayer,138,243,381,28,49,UCBPlayer
9047,UCBPlayer,97,242,339,7,56,UCBPlayer
9048,UCBPlayer,130,235,365,24,53,UCBPlayer
9049,UCBPlayer,105,250,355,11,52,UCBPlayer
9050,UCBPlayer,122,227,349,20,57,UCBPlayer
9051,UCBPlayer,109,259,368,15,49,UCBPlayer
9052,UCBPlayer,118,218,336,16,60,UCBPlayer
9053,UCBPlayer,117,267,384,19,45,UCBPlayer
9054,UCBPlayer,110,210,320,12,64,UCBPlayer
9055,UCBPlayer,126,271,397,23,42,UCBPlayer
9056,UCBPlayer,105,210,315,10,65,UCBPlayer
9057,UCBPlayer,130,275,405,25,40,UCBPlayer
9058,UCBPlayer,105,210,315,10,65,UCBPlayer
9059,UCBPlayer,130,275,405,25,40,UCBPlayer
9060,UCBPlayer,106,206,312,10,66,UCBPlayer
9061,UCBPlayer,130,275,405,25,40,UCBPlayer
9062,UCBPlayer,105,210,315,10,65,UCBPlayer
9063,UCBPlayer,131,271,402,25,41,UCBPlayer
9064,UCBPlayer,105,210,315,10,65,UCBPlayer
9065,UCBPlayer,130,275,405,25,40,UCBPlayer
9066,UCBPlayer,105,210,315,10,65,UCBPlayer
9067,UCBPlayer,130,275,405,25,40,UCBPlayer
9068,UCBPlayer,103,203,306,10,68,UCBPlayer
9069,UCBPlayer,128,283,411,25,38,UCBPlayer
9070,UCBPlayer,111,186,297,10,71,UCBPlayer
9071,UCBPlayer,124,299,423,25,34,UCBPlayer
9072,UCBPlayer,115,170,285,10,75,UCBPlayer
9073,UCBPlayer,120,315,435,25,30,UCBPlayer
9074,UCBPlayer,119,154,273,10,79,UCBPlayer
9075,UCBPlayer,112,332,444,25,27,UCBPlayer
9076,UCBPlayer,127,137,264,10,82,UCBPlayer
9077,UCBPlayer,104,349,453,25,24,UCBPlayer
9078,UCBPlayer,126,126,252,7,85,Tie
9079,UCBPlayer,111,351,462,28,22,UCBPlayer
9080,UCBPlayer,116,126,242,3,87,UCBPlayer
9081,UCBPlayer,122,347,469,32,21,UCBPlayer
9082,UCBPlayer,107,132,239,0,87,UCBPlayer
9083,UCBPlayer,132,337,469,35,22,UCBPlayer
9084,UCBPlayer,103,148,251,0,83,UCBPlayer
9085,UCBPlayer,136,321,457,35,26,UCBPlayer
9086,UCBPlayer,99,164,263,0,79,UCBPlayer
9087,UCBPlayer,140,305,445,35,30,UCBPlayer
9088,UCBPlayer,95,180,275,0,75,UCBPlayer
9089,UCBPlayer,144,289,433,35,34,UCBPlayer
9090,UCBPlayer,91,196,287,0,71,UCBPlayer
9091,UCBPlayer,148,273,421,35,38,UCBPlayer
9092,UCBPlayer,87,212,299,0,67,UCBPlayer
9093,UCBPlayer,152,257,409,35,42,UCBPlayer
9094,UCBPlayer,84,224,308,0,64,UCBPlayer
9095,UCBPlayer,146,251,397,32,45,UCBPlayer
9096,UCBPlayer,89,234,323,3,60,UCBPlayer
9097,UCBPlayer,138,243,381,28,49,UCBPlayer
9098,UCBPlayer,97,242,339,7,56,UCBPlayer
9099,UCBPlayer,130,235,365,24,53,UCBPlayer
9100,UCBPlayer,105,250,355,11,52,UCBPlayer
9101,UCBPlayer,122,227,349,20,57,UCBPlayer
9102,UCBPlayer,109,259,368,15,49,UCBPlayer
9103,UCBPlayer,118,218,336,16,60,UCBPlayer
9104,UCBPlayer,117,267,384,19,45,UCBPlayer
9105,UCBPlayer,110,210,320,12,64,UCBPlayer
9106,UCBPlayer,126,271,397,23,42,UCBPlayer
9107,UCBPlayer,105,210,315,10,65,UCBPlayer
9108,UCBPlayer,130,275,405,25,40,UCBPlayer
9109,UCBPlayer,105,210,315,10,65,UCBPlayer
9110,UCBPlayer,130,275,405,25,40,UCBPlayer
9111,UCBPlayer,106,206,312,10,66,UCBPlayer
9112,UCBPlayer,130,275,405,25,40,UCBPlayer
9113,UCBPlayer,105,210,315,10,65,UCBPlayer
9114,UCBPlayer,131,271,402,25,41,UCBPlayer
9115,UCBPlayer,105,210,315,10,65,UCBPlayer
9116,UCBPlayer,130,275,405,25,40,UCBPlayer
9117,UCBPlayer,105,210,315,10,65,UCBPlayer
9118,UCBPlayer,130,275,405,25,40,UCBPlayer
9119,UCBPlayer,103,203,306,10,68,UCBPlayer
9120,UCBPlayer,128,283,411,25,38,UCBPlayer
9121,UCBPlayer,111,186,297,10,71,UCBPlayer
9122,UCBPlayer,124,299,423,25,34,UCBPlayer
9123,UCBPlayer,115,170,285,10,75,UCBPlayer
9124,UCBPlayer,120,315,435,25,30,UCBPlayer
9125,UCBPlayer,119,154,273,10,79,UCBPlayer
9126,UCBPlayer,112,332,444,25,27,UCBPlayer
9127,UCBPlayer,127,137,264,10,82,UCBPlayer
9128,UCBPlayer,104,349,453,25,24,UCBPlayer
9129,UCBPlayer,126,126,252,7,85,Tie
9130,UCBPlayer,111,351,462,28,22,UCBPlayer
9131,UCBPlayer,116,126,242,3,87,UCBPlayer
9132,UCBPlayer,122,347,469,32,21,UCBPlayer
9133,UCBPlayer,107,132,239,0,87,UCBPlayer
9134,UCBPlayer,132,337,469,35,22,UCBPlayer
9135,UCBPlayer,103,148,251,0,83,UCBPlayer
9136,UCBPlayer,136,321,457,35,26,UCBPlayer
9137,UCBPlayer,99,164,263,0,79,UCBPlayer
9138,UCBPlayer,140,305,445,35,30,UCBPlayer
9139,UCBPlayer,95,180,275,0,75,UCBPlayer
9140,UCBPlayer,144,289,433,35,34,UCBPlayer
9141,UCBPlayer,91,196,287,0,71,UCBPlayer
9142,UCBPlayer,148,273,421,35,38,UCBPlayer
9143,UCBPlayer,87,212,299,0,67,UCBPlayer
9144,UCBPlayer,152,257,409,35,42,UCBPlayer
9145,UCBPlayer,84,224,308,0,64,UCBPlayer
9146,UCBPlayer,146,251,397,32,45,UCBPlayer
9147,UCBPlayer,89,234,323,3,60,UCBPlayer
9148,UCBPlayer,138,243,381,28,49,UCBPlayer
9149,UCBPlayer,97,242,339,7,56,UCBPlayer
9150,UCBPlayer,130,235,365,24,53,UCBPlayer
9151,UCBPlayer,105,250,355,11,52,UCBPlayer
9152,UCBPlayer,122,227,349,20,57,UCBPlayer
9153,UCBPlayer,109,259,368,15,49,UCBPlayer
9154,UCBPlayer,118,218,336,16,60,UCBPlayer
9155,UCBPlayer,117,267,384,19,45,UCBPlayer
9156,UCBPlayer,110,210,320,12,64,UCBPlayer
9157,UCBPlayer,126,271,397,23,42,UCBPlayer
9158,UCBPlayer,105,210,315,10,65,UCBPlayer
9159,UCBPlayer,130,275,405,25,40,UCBPlayer
9160,UCBPlayer,105,210,315,10,65,UCBPlayer
9161,UCBPlayer,130,275,405,25,40,UCBPlayer
9162,UCBPlayer,106,206,312,10,66,UCBPlayer
9163,UCBPlayer,130,275,405,25,40,UCBPlayer
9164,UCBPlayer,105,210,315,10,65,UCBPlayer
9165,UCBPlayer,131,271,402,25,41,UCBPlayer
9166,UCBPlayer,105,210,315,10,65,UCBPlayer
9167,UCBPlayer,130,275,405,25,40,UCBPlayer
9168,UCBPlayer,105,210,315,10,65,UCBPlayer
9169,UCBPlayer,130,275,405,25,40,UCBPlayer
9170,UCBPlayer,103,203,306,10,68,UCBPlayer
9171,UCBPlayer,128,283,411,25,38,UCBPlayer
9172,UCBPlayer,111,186,297,10,71,UCBPlayer
9173,UCBPlayer,124,299,423,25,34,UCBPlayer
9174,UCBPlayer,115,170,285,10,75,UCBPlayer
9175,UCBPlayer,120,315,435,25,30,UCBPlayer
9176,UCBPlayer,119,154,273,10,79,UCBPlayer
9177,UCBPlayer,112,332,444,25,27,UCBPlayer
9178,UCBPlayer,127,137,264,10,82,UCBPlayer
9179,UCBPlayer,104,349,453,25,24,UCBPlayer
9180,UCBPlayer,126,126,252,7,85,Tie
9181,UCBPlayer,111,351,462,28,22,UCBPlayer
9182,UCBPlayer,116,126,242,3,87,UCBPlayer
9183,UCBPlayer,122,347,469,32,21,UCBPlayer
9184,UCBPlayer,107,132,239,0,87,UCBPlayer
9185,UCBPlayer,132,337,469,35,22,UCBPlayer
9186,UCBPlayer,103,148,251,0,83,UCBPlayer
9187,UCBPlayer,136,321,457,35,26,UCBPlayer
9188,UCBPlayer,99,164,263,0,79,UCBPlayer
9189,UCBPlayer,140,305,445,35,30,UCBPlayer
9190,UCBPlayer,95,180,275,0,75,UCBPlayer
9191,UCBPlayer,144,289,433,35,34,UCBPlayer
9192,UCBPlayer,91,196,287,0,71,UCBPlayer
9193,UCBPlayer,148,273,421,35,38,UCBPlayer
9194,UCBPlayer,87,212,299,0,67,UCBPlayer
9195,UCBPlayer,152,257,409,35,42,UCBPlayer
9196,UCBPlayer,84,224,308,0,64,UCBPlayer
9197,UCBPlayer,146,251,397,32,45,UCBPlayer
9198,UCBPlayer,89,234,323,3,60,UCBPlayer
9199,UCBPlayer,138,243,381,28,49,UCBPlayer
9200,UCBPlayer,97,242,339,7,56,UCBPlayer
9201,UCBPlayer,130,235,365,24,53,UCBPlayer
9202,UCBPlayer,105,250,355,11,52,UCBPlayer
9203,UCBPlayer,122,227,349,20,57,UCBPlayer
9204,UCBPlayer,109,259,368,15,49,UCBPlayer
9205,UCBPlayer,118,218,336,16,60,UCBPlayer
9206,UCBPlayer,117,267,384,19,45,UCBPlayer
9207,UCBPlayer,110,210,320,12,64,UCBPlayer
9208,UCBPlayer,126,271,397,23,42,UCBPlayer
9209,UCBPlayer,105,210,315,10,65,UCBPlayer
9210,UCBPlayer,130,275,405,25,40,UCBPlayer
9211,UCBPlayer,105,210,315,10,65,UCBPlayer
9212,UCBPlayer,130,275,405,25,40,UCBPlayer
9213,UCBPlayer,106,206,312,10,66,UCBPlayer
9214,UCBPlayer,130,275,405,25,40,UCBPlayer
9215,UCBPlayer,105,210,315,10,65,UCBPlayer
9216,UCBPlayer,131,271,402,25,41,UCBPlayer
9217,UCBPlayer,105,210,315,10,65,UCBPlayer
9218,UCBPlayer,130,275,405,25,40,UCBPlayer
9219,UCBPlayer,105,210,315,10,65,UCBPlayer
9220,UCBPlayer,130,275,405,25,40,UCBPlayer
9221,UCBPlayer,103,203,306,10,68,UCBPlayer
9222,UCBPlayer,128,283,411,25,38,UCBPlayer
9223,UCBPlayer,111,186,297,10,71,UCBPlayer
9224,UCBPlayer,124,299,423,25,34,UCBPlayer
9225,UCBPlayer,115,170,285,10,75,UCBPlayer
9226,UCBPlayer,120,315,435,25,30,UCBPlayer
9227,UCBPlayer,119,154,273,10,79,UCBPlayer
9228,UCBPlayer,112,332,444,25,27,UCBPlayer
9229,UCBPlayer,127,137,264,10,82,UCBPlayer
9230,UCBPlayer,104,349,453,25,24,UCBPlayer
9231,UCBPlayer,126,126,252,7,85,Tie
9232,UCBPlayer,111,351,462,28,22,UCBPlayer
9233,UCBPlayer,116,126,242,3,87,UCBPlayer
9234,UCBPlayer,122,347,469,32,21,UCBPlayer
9235,UCBPlayer,107,132,239,0,87,UCBPlayer
9236,UCBPlayer,132,337,469,35,22,UCBPlayer
9237,UCBPlayer,103,148,251,0,83,UCBPlayer
9238,UCBPlayer,136,321,457,35,26,UCBPlayer
9239,UCBPlayer,99,164,263,0,79,UCBPlayer
9240,UCBPlayer,140,305,445,35,30,UCBPlayer
9241,UCBPlayer,95,180,275,0,75,UCBPlayer
9242,UCBPlayer,144,289,433,35,34,UCBPlayer
9243,UCBPlayer,91,196,287,0,71,UCBPlayer
9244,UCBPlayer,148,273,421,35,38,UCBPlayer
9245,UCBPlayer,87,212,299,0,67,UCBPlayer
9246,UCBPlayer,152,257,409,35,42,UCBPlayer
9247,UCBPlayer,84,224,308,0,64,UCBPlayer
9248,UCBPlayer,146,251,397,32,45,UCBPlayer
9249,UCBPlayer,89,234,323,3,60,UCBPlayer
9250,UCBPlayer,138,243,381,28,49,UCBPlayer
9251,UCBPlayer,97,242,339,7,56,UCBPlayer
9252,UCBPlayer,130,235,365,24,53,UCBPlayer
9253,UCBPlayer,105,250,355,11,52,UCBPlayer
9254,UCBPlayer,122,227,349,20,57,UCBPlayer
9255,UCBPlayer,109,259,368,15,49,UCBPlayer
9256,UCBPlayer,118,218,336,16,60,UCBPlayer
9257,UCBPlayer,117,267,384,19,45,UCBPlayer
9258,UCBPlayer,110,210,320,12,64,UCBPlayer
9259,UCBPlayer,126,271,397,23,42,UCBPlayer
9260,UCBPlayer,105,210,315,10,65,UCBPlayer
9261,UCBPlayer,130,275,405,25,40,UCBPlayer
9262,UCBPlayer,105,210,315,10,65,UCBPlayer
9263,UCBPlayer,130,275,405,25,40,UCBPlayer
9264,UCBPlayer,106,206,312,10,66,UCBPlayer
9265,UCBPlayer,130,275,405,25,40,UCBPlayer
9266,UCBPlayer,105,210,315,10,65,UCBPlayer
9267,UCBPlayer,131,271,402,25,41,UCBPlayer
9268,UCBPlayer,105,210,315,10,65,UCBPlayer
9269,UCBPlayer,130,275,405,25,40,UCBPlayer
9270,UCBPlayer,105,210,315,10,65,UCBPlayer
9271,UCBPlayer,130,275,405,25,40,UCBPlayer
9272,UCBPlayer,103,203,306,10,68,UCBPlayer
9273,UCBPlayer,128,283,411,25,38,UCBPlayer
9274,UCBPlayer,111,186,297,10,71,UCBPlayer
9275,UCBPlayer,124,299,423,25,34,UCBPlayer
9276,UCBPlayer,115,170,285,10,75,UCBPlayer
9277,UCBPlayer,120,315,435,25,30,UCBPlayer
9278,UCBPlayer,119,154,273,10,79,UCBPlayer
9279,UCBPlayer,112,332,444,25,27,UCBPlayer
9280,UCBPlayer,127,137,264,10,82,UCBPlayer
9281,UCBPlayer,104,349,453,25,24,UCBPlayer
9282,UCBPlayer,126,126,252,7,85,Tie
9283,UCBPlayer,111,351,462,28,22,UCBPlayer
9284,UCBPlayer,116,126,242,3,87,UCBPlayer
9285,UCBPlayer,122,347,469,32,21,UCBPlayer
9286,UCBPlayer,107,132,239,0,87,UCBPlayer
9287,UCBPlayer,132,337,469,35,22,UCBPlayer
9288,UCBPlayer,103,148,251,0,83,UCBPlayer
9289,UCBPlayer,136,321,457,35,26,UCBPlayer
9290,UCBPlayer,99,164,263,0,79,UCBPlayer
9291,UCBPlayer,140,305,445,35,30,UCBPlayer
9292,UCBPlayer,95,180,275,0,75,UCBPlayer
9293,UCBPlayer,144,289,433,35,34,UCBPlayer
9294,UCBPlayer,91,196,287,0,71,UCBPlayer
9295,UCBPlayer,148,273,421,35,38,UCBPlayer
9296,UCBPlayer,87,212,299,0,67,UCBPlayer
9297,UCBPlayer,152,257,409,35,42,UCBPlayer
9298,UCBPlayer,84,224,308,0,64,UCBPlayer
9299,UCBPlayer,146,251,397,32,45,UCBPlayer
9300,UCBPlayer,89,234,323,3,60,UCBPlayer
9301,UCBPlayer,138,243,381,28,49,UCBPlayer
9302,UCBPlayer,97,242,339,7,56,UCBPlayer
9303,UCBPlayer,130,235,365,24,53,UCBPlayer
9304,UCBPlayer,105,250,355,11,52,UCBPlayer
9305,UCBPlayer,122,227,349,20,57,UCBPlayer
9306,UCBPlayer,109,259,368,15,49,UCBPlayer
9307,UCBPlayer,118,218,336,16,60,UCBPlayer
9308,UCBPlayer,117,267,384,19,45,UCBPlayer
9309,UCBPlayer,110,210,320,12,64,UCBPlayer
9310,UCBPlayer,126,271,397,23,42,UCBPlayer
9311,UCBPlayer,105,210,315,10,65,UCBPlayer
9312,UCBPlayer,130,275,405,25,40,UCBPlayer
9313,UCBPlayer,105,210,315,10,65,UCBPlayer
9314,UCBPlayer,130,275,405,25,40,UCBPlayer
9315,UCBPlayer,106,206,312,10,66,UCBPlayer
9316,UCBPlayer,130,275,405,25,40,UCBPlayer
9317,UCBPlayer,105,210,315,10,65,UCBPlayer
9318,UCBPlayer,131,271,402,25,41,UCBPlayer
9319,UCBPlayer,105,210,315,10,65,UCBPlayer
9320,UCBPlayer,130,275,405,25,40,UCBPlayer
9321,UCBPlayer,105,210,315,10,65,UCBPlayer
9322,UCBPlayer,130,275,405,25,40,UCBPlayer
9323,UCBPlayer,103,203,306,10,68,UCBPlayer
9324,UCBPlayer,128,283,411,25,38,UCBPlayer
9325,UCBPlayer,111,186,297,10,71,UCBPlayer
9326,UCBPlayer,124,299,423,25,34,UCBPlayer
9327,UCBPlayer,115,170,285,10,75,UCBPlayer
9328,UCBPlayer,120,315,435,25,30,UCBPlayer
9329,UCBPlayer,119,154,273,10,79,UCBPlayer
9330,UCBPlayer,112,332,444,25,27,UCBPlayer
9331,UCBPlayer,127,137,264,10,82,UCBPlayer
9332,UCBPlayer,104,349,453,25,24,UCBPlayer
9333,UCBPlayer,126,126,252,7,85,Tie
9334,UCBPlayer,111,351,462,28,22,UCBPlayer
9335,UCBPlayer,116,126,242,3,87,UCBPlayer
9336,UCBPlayer,122,347,469,32,21,UCBPlayer
9337,UCBPlayer,107,132,239,0,87,UCBPlayer
9338,UCBPlayer,132,337,469,35,22,UCBPlayer
9339,UCBPlayer,103,148,251,0,83,UCBPlayer
9340,UCBPlayer,136,321,457,35,26,UCBPlayer
9341,UCBPlayer,99,164,263,0,79,UCBPlayer
9342,UCBPlayer,140,305,445,35,30,UCBPlayer
9343,UCBPlayer,95,180,275,0,75,UCBPlayer
9344,UCBPlayer,144,289,433,35,34,UCBPlayer
9345,UCBPlayer,91,196,287,0,71,UCBPlayer
9346,UCBPlayer,148,273,421,35,38,UCBPlayer
9347,UCBPlayer,87,212,299,0,67,UCBPlayer
9348,UCBPlayer,152,257,409,35,42,UCBPlayer
9349,UCBPlayer,84,224,308,0,64,UCBPlayer
9350,UCBPlayer,146,251,397,32,45,UCBPlayer
9351,UCBPlayer,89,234,323,3,60,UCBPlayer
9352,UCBPlayer,138,243,381,28,49,UCBPlayer
9353,UCBPlayer,97,242,339,7,56,UCBPlayer
9354,UCBPlayer,130,235,365,24,53,UCBPlayer
9355,UCBPlayer,105,250,355,11,52,UCBPlayer
9356,UCBPlayer,122,227,349,20,57,UCBPlayer
9357,UCBPlayer,109,259,368,15,49,UCBPlayer
9358,UCBPlayer,118,218,336,16,60,UCBPlayer
9359,UCBPlayer,117,267,384,19,45,UCBPlayer
9360,UCBPlayer,110,210,320,12,64,UCBPlayer
9361,UCBPlayer,126,271,397,23,42,UCBPlayer
9362,UCBPlayer,105,210,315,10,65,UCBPlayer
9363,UCBPlayer,130,275,405,25,40,UCBPlayer
9364,UCBPlayer,105,210,315,10,65,UCBPlayer
9365,UCBPlayer,130,275,405,25,40,UCBPlayer
9366,UCBPlayer,106,206,312,10,66,UCBPlayer
9367,UCBPlayer,130,275,405,25,40,UCBPlayer
9368,UCBPlayer,105,210,315,10,65,UCBPlayer
9369,UCBPlayer,131,271,402,25,41,UCBPlayer
9370,UCBPlayer,105,210,315,10,65,UCBPlayer
9371,UCBPlayer,130,275,405,25,40,UCBPlayer
9372,UCBPlayer,105,210,315,10,65,UCBPlayer
9373,UCBPlayer,130,275,405,25,40,UCBPlayer
9374,UCBPlayer,103,203,306,10,68,UCBPlayer
9375,UCBPlayer,128,283,411,25,38,UCBPlayer
9376,UCBPlayer,111,186,297,10,71,UCBPlayer
9377,UCBPlayer,124,299,423,25,34,UCBPlayer
9378,UCBPlayer,115,170,285,10,75,UCBPlayer
9379,UCBPlayer,120,315,435,25,30,UCBPlayer
9380,UCBPlayer,119,154,273,10,79,UCBPlayer
9381,UCBPlayer,112,332,444,25,27,UCBPlayer
9382,UCBPlayer,127,137,264,10,82,UCBPlayer
9383,UCBPlayer,104,349,453,25,24,UCBPlayer
9384,UCBPlayer,126,126,252,7,85,Tie
9385,UCBPlayer,111,351,462,28,22,UCBPlayer
9386,UCBPlayer,116,126,242,3,87,UCBPlayer
9387,UCBPlayer,122,347,469,32,21,UCBPlayer
9388,UCBPlayer,107,132,239,0,87,UCBPlayer
9389,UCBPlayer,132,337,469,35,22,UCBPlayer
9390,UCBPlayer,103,148,251,0,83,UCBPlayer
9391,UCBPlayer,136,321,457,35,26,UCBPlayer
9392,UCBPlayer,99,164,263,0,79,UCBPlayer
9393,UCBPlayer,140,305,445,35,30,UCBPlayer
9394,UCBPlayer,95,180,275,0,75,UCBPlayer
9395,UCBPlayer,144,289,433,35,34,UCBPlayer
9396,UCBPlayer,91,196,287,0,71,UCBPlayer
9397,UCBPlayer,148,273,421,35,38,UCBPlayer
9398,UCBPlayer,87,212,299,0,67,UCBPlayer
9399,UCBPlayer,152,257,409,35,42,UCBPlayer
9400,UCBPlayer,84,224,308,0,64,UCBPlayer
9401,UCBPlayer,146,251,397,32,45,UCBPlayer
9402,UCBPlayer,89,234,323,3,60,UCBPlayer
9403,UCBPlayer,138,243,381,28,49,UCBPlayer
9404,UCBPlayer,97,242,339,7,56,UCBPlayer
9405,UCBPlayer,130,235,365,24,53,UCBPlayer
9406,UCBPlayer,105,250,355,11,52,UCBPlayer
9407,UCBPlayer,122,227,349,20,57,UCBPlayer
9408,UCBPlayer,109,259,368,15,49,UCBPlayer
9409,UCBPlayer,118,218,336,16,60,UCBPlayer
9410,UCBPlayer,117,267,384,19,45,UCBPlayer
9411,UCBPlayer,110,210,320,12,64,UCBPlayer
9412,UCBPlayer,126,271,397,23,42,UCBPlayer
9413,UCBPlayer,105,210,315,10,65,UCBPlayer
9414,UCBPlayer,130,275,405,25,40,UCBPlayer
9415,UCBPlayer,105,210,315,10,65,UCBPlayer
9416,UCBPlayer,130,275,405,25,40,UCBPlayer
9417,UCBPlayer,106,206,312,10,66,UCBPlayer
9418,UCBPlayer,130,275,405,25,40,UCBPlayer
9419,UCBPlayer,105,210,315,10,65,UCBPlayer
9420,UCBPlayer,131,271,402,25,41,UCBPlayer
9421,UCBPlayer,105,210,315,10,65,UCBPlayer
9422,UCBPlayer,130,275,405,25,40,UCBPlayer
9423,UCBPlayer,105,210,315,10,65,UCBPlayer
9424,UCBPlayer,130,275,405,25,40,UCBPlayer
9425,UCBPlayer,103,203,306,10,68,UCBPlayer
9426,UCBPlayer,128,283,411,25,38,UCBPlayer
9427,UCBPlayer,111,186,297,10,71,UCBPlayer
9428,UCBPlayer,124,299,423,25,34,UCBPlayer
9429,UCBPlayer,115,170,285,10,75,UCBPlayer
9430,UCBPlayer,120,315,435,25,30,UCBPlayer
9431,UCBPlayer,119,154,273,10,79,UCBPlayer
9432,UCBPlayer,112,332,444,25,27,UCBPlayer
9433,UCBPlayer,127,137,264,10,82,UCBPlayer
9434,UCBPlayer,104,349,453,25,24,UCBPlayer
9435,UCBPlayer,126,126,252,7,85,Tie
9436,UCBPlayer,111,351,462,28,22,UCBPlayer
9437,UCBPlayer,116,126,242,3,87,UCBPlayer
9438,UCBPlayer,122,347,469,32,21,UCBPlayer
9439,UCBPlayer,107,132,239,0,87,UCBPlayer
9440,UCBPlayer,132,337,469,35,22,UCBPlayer
9441,UCBPlayer,103,148,251,0,83,UCBPlayer
9442,UCBPlayer,136,321,457,35,26,UCBPlayer
9443,UCBPlayer,99,164,263,0,79,UCBPlayer
9444,UCBPlayer,140,305,445,35,30,UCBPlayer
9445,UCBPlayer,95,180,275,0,75,UCBPlayer
9446,UCBPlayer,144,289,433,35,34,UCBPlayer
9447,UCBPlayer,91,196,287,0,71,UCBPlayer
9448,UCBPlayer,148,273,421,35,38,UCBPlayer
9449,UCBPlayer,87,212,299,0,67,UCBPlayer
9450,UCBPlayer,152,257,409,35,42,UCBPlayer
9451,UCBPlayer,84,224,308,0,64,UCBPlayer
9452,UCBPlayer,146,251,397,32,45,UCBPlayer
9453,UCBPlayer,89,234,323,3,60,UCBPlayer
9454,UCBPlayer,138,243,381,28,49,UCBPlayer
9455,UCBPlayer,97,242,339,7,56,UCBPlayer
9456,UCBPlayer,130,235,365,24,53,UCBPlayer
9457,UCBPlayer,105,250,355,11,52,UCBPlayer
9458,UCBPlayer,122,227,349,20,57,UCBPlayer
9459,UCBPlayer,109,259,368,15,49,UCBPlayer
9460,UCBPlayer,118,218,336,16,60,UCBPlayer
9461,UCBPlayer,117,267,384,19,45,UCBPlayer
9462,UCBPlayer,110,210,320,12,64,UCBPlayer
9463,UCBPlayer,126,271,397,23,42,UCBPlayer
9464,UCBPlayer,105,210,315,10,65,UCBPlayer
9465,UCBPlayer,130,275,405,25,40,UCBPlayer
9466,UCBPlayer,105,210,315,10,65,UCBPlayer
9467,UCBPlayer,130,275,405,25,40,UCBPlayer
9468,UCBPlayer,106,206,312,10,66,UCBPlayer
9469,UCBPlayer,130,275,405,25,40,UCBPlayer
9470,UCBPlayer,105,210,315,10,65,UCBPlayer
9471,UCBPlayer,131,271,402,25,41,UCBPlayer
9472,UCBPlayer,105,210,315,10,65,UCBPlayer
9473,UCBPlayer,130,275,405,25,40,UCBPlayer
9474,UCBPlayer,105,210,315,10,65,UCBPlayer
9475,UCBPlayer,130,275,405,25,40,UCBPlayer
9476,UCBPlayer,103,203,306,10,68,UCBPlayer
9477,UCBPlayer,128,283,411,25,38,UCBPlayer
9478,UCBPlayer,111,186,297,10,71,UCBPlayer
9479,UCBPlayer,124,299,423,25,34,UCBPlayer
9480,UCBPlayer,115,170,285,10,75,UCBPlayer
9481,UCBPlayer,120,315,435,25,30,UCBPlayer
9482,UCBPlayer,119,154,273,10,79,UCBPlayer
9483,UCBPlayer,112,332,444,25,27,UCBPlayer
9484,UCBPlayer,127,137,264,10,82,UCBPlayer
9485,UCBPlayer,104,349,453,25,24,UCBPlayer
9486,UCBPlayer,126,126,252,7,85,Tie
9487,UCBPlayer,111,351,462,28,22,UCBPlayer
9488,UCBPlayer,116,126,242,3,87,UCBPlayer
9489,UCBPlayer,122,347,469,32,21,UCBPlayer
9490,UCBPlayer,107,132,239,0,87,UCBPlayer
9491,UCBPlayer,132,337,469,35,22,UCBPlayer
9492,UCBPlayer,103,148,251,0,83,UCBPlayer
9493,UCBPlayer,136,321,457,35,26,UCBPlayer
9494,UCBPlayer,99,164,263,0,79,UCBPlayer
9495,UCBPlayer,140,305,445,35,30,UCBPlayer
9496,UCBPlayer,95,180,275,0,75,UCBPlayer
9497,UCBPlayer,144,289,433,35,34,UCBPlayer
9498,UCBPlayer,91,196,287,0,71,UCBPlayer
9499,UCBPlayer,148,273,421,35,38,UCBPlayer
9500,UCBPlayer,87,212,299,0,67,UCBPlayer
9501,UCBPlayer,152,257,409,35,42,UCBPlayer
9502,UCBPlayer,84,224,308,0,64,UCBPlayer
9503,UCBPlayer,146,251,397,32,45,UCBPlayer
9504,UCBPlayer,89,234,323,3,60,UCBPlayer
9505,UCBPlayer,138,243,381,28,49,UCBPlayer
9506,UCBPlayer,97,242,339,7,56,UCBPlayer
9507,UCBPlayer,130,235,365,24,53,UCBPlayer
9508,UCBPlayer,105,250,355,11,52,UCBPlayer
9509,UCBPlayer,122,227,349,20,57,UCBPlayer
9510,UCBPlayer,109,259,368,15,49,UCBPlayer
9511,UCBPlayer,118,218,336,16,60,UCBPlayer
9512,UCBPlayer,117,267,384,19,45,UCBPlayer
9513,UCBPlayer,110,210,320,12,64,UCBPlayer
9514,UCBPlayer,126,271,397,23,42,UCBPlayer
9515,UCBPlayer,105,210,315,10,65,UCBPlayer
9516,UCBPlayer,130,275,405,25,40,UCBPlayer
9517,UCBPlayer,105,210,315,10,65,UCBPlayer
9518,UCBPlayer,130,275,405,25,40,UCBPlayer
9519,UCBPlayer,106,206,312,10,66,UCBPlayer
9520,UCBPlayer,130,275,405,25,40,UCBPlayer
9521,UCBPlayer,105,210,315,10,65,UCBPlayer
9522,UCBPlayer,131,271,402,25,41,UCBPlayer
9523,UCBPlayer,105,210,315,10,65,UCBPlayer
9524,UCBPlayer,130,275,405,25,40,UCBPlayer
9525,UCBPlayer,105,210,315,10,65,UCBPlayer
9526,UCBPlayer,130,275,405,25,40,UCBPlayer
9527,UCBPlayer,103,203,306,10,68,UCBPlayer
9528,UCBPlayer,128,283,411,25,38,UCBPlayer
9529,UCBPlayer,111,186,297,10,71,UCBPlayer
9530,UCBPlayer,124,299,423,25,34,UCBPlayer
9531,UCBPlayer,115,170,285,10,75,UCBPlayer
9532,UCBPlayer,120,315,435,25,30,UCBPlayer
9533,UCBPlayer,119,154,273,10,79,UCBPlayer
9534,UCBPlayer,112,332,444,25,27,UCBPlayer
9535,UCBPlayer,127,137,264,10,82,UCBPlayer
9536,UCBPlayer,104,349,453,25,24,UCBPlayer
9537,UCBPlayer,126,126,252,7,85,Tie
9538,UCBPlayer,111,351,462,28,22,UCBPlayer
9539,UCBPlayer,116,126,242,3,87,UCBPlayer
9540,UCBPlayer,122,347,469,32,21,UCBPlayer
9541,UCBPlayer,107,132,239,0,87,UCBPlayer
9542,UCBPlayer,132,337,469,35,22,UCBPlayer
9543,UCBPlayer,103,148,251,0,83,UCBPlayer
9544,UCBPlayer,136,321,457,35,26,UCBPlayer
9545,UCBPlayer,99,164,263,0,79,UCBPlayer
9546,UCBPlayer,140,305,445,35,30,UCBPlayer
9547,UCBPlayer,95,180,275,0,75,UCBPlayer
9548,UCBPlayer,144,289,433,35,34,UCBPlayer
9549,UCBPlayer,91,196,287,0,71,UCBPlayer
9550,UCBPlayer,148,273,421,35,38,UCBPlayer
9551,UCBPlayer,87,212,299,0,67,UCBPlayer
9552,UCBPlayer,152,257,409,35,42,UCBPlayer
9553,UCBPlayer,84,224,308,0,64,UCBPlayer
9554,UCBPlayer,146,251,397,32,45,UCBPlayer
9555,UCBPlayer,89,234,323,3,60,UCBPlayer
9556,UCBPlayer,138,243,381,28,49,UCBPlayer
9557,UCBPlayer,97,242,339,7,56,UCBPlayer
9558,UCBPlayer,130,235,365,24,53,UCBPlayer
9559,UCBPlayer,105,250,355,11,52,UCBPlayer
9560,UCBPlayer,122,227,349,20,57,UCBPlayer
9561,UCBPlayer,109,259,368,15,49,UCBPlayer
9562,UCBPlayer,118,218,336,16,60,UCBPlayer
9563,UCBPlayer,117,267,384,19,45,UCBPlayer
9564,UCBPlayer,110,210,320,12,64,UCBPlayer
9565,UCBPlayer,126,271,397,23,42,UCBPlayer
9566,UCBPlayer,105,210,315,10,65,UCBPlayer
9567,UCBPlayer,130,275,405,25,40,UCBPlayer
9568,UCBPlayer,105,210,315,10,65,UCBPlayer
9569,UCBPlayer,130,275,405,25,40,UCBPlayer
9570,UCBPlayer,106,206,312,10,66,UCBPlayer
9571,UCBPlayer,130,275,405,25,40,UCBPlayer
9572,UCBPlayer,105,210,315,10,65,UCBPlayer
9573,UCBPlayer,131,271,402,25,41,UCBPlayer
9574,UCBPlayer,105,210,315,10,65,UCBPlayer
9575,UCBPlayer,130,275,405,25,40,UCBPlayer
9576,UCBPlayer,105,210,315,10,65,UCBPlayer
9577,UCBPlayer,130,275,405,25,40,UCBPlayer
9578,UCBPlayer,103,203,306,10,68,UCBPlayer
9579,UCBPlayer,128,283,411,25,38,UCBPlayer
9580,UCBPlayer,111,186,297,10,71,UCBPlayer
9581,UCBPlayer,124,299,423,25,34,UCBPlayer
9582,UCBPlayer,115,170,285,10,75,UCBPlayer
9583,UCBPlayer,120,315,435,25,30,UCBPlayer
9584,UCBPlayer,119,154,273,10,79,UCBPlayer
9585,UCBPlayer,112,332,444,25,27,UCBPlayer
9586,UCBPlayer,127,137,264,10,82,UCBPlayer
9587,UCBPlayer,104,349,453,25,24,UCBPlayer
9588,UCBPlayer,126,126,252,7,85,Tie
9589,UCBPlayer,111,351,462,28,22,UCBPlayer
9590,UCBPlayer,116,126,242,3,87,UCBPlayer
9591,UCBPlayer,122,347,469,32,21,UCBPlayer
9592,UCBPlayer,107,132,239,0,87,UCBPlayer
9593,UCBPlayer,132,337,469,35,22,UCBPlayer
9594,UCBPlayer,103,148,251,0,83,UCBPlayer
9595,UCBPlayer,136,321,457,35,26,UCBPlayer
9596,UCBPlayer,99,164,263,0,79,UCBPlayer
9597,UCBPlayer,140,305,445,35,30,UCBPlayer
9598,UCBPlayer,95,180,275,0,75,UCBPlayer
9599,UCBPlayer,144,289,433,35,34,UCBPlayer
9600,UCBPlayer,91,196,287,0,71,UCBPlayer
9601,UCBPlayer,148,273,421,35,38,UCBPlayer
9602,UCBPlayer,87,212,299,0,67,UCBPlayer
9603,UCBPlayer,152,257,409,35,42,UCBPlayer
9604,UCBPlayer,84,224,308,0,64,UCBPlayer
9605,UCBPlayer,146,251,397,32,45,UCBPlayer
9606,UCBPlayer,89,234,323,3,60,UCBPlayer
9607,UCBPlayer,138,243,381,28,49,UCBPlayer
9608,UCBPlayer,97,242,339,7,56,UCBPlayer
9609,UCBPlayer,130,235,365,24,53,UCBPlayer
9610,UCBPlayer,105,250,355,11,52,UCBPlayer
9611,UCBPlayer,122,227,349,20,57,UCBPlayer
9612,UCBPlayer,109,259,368,15,49,UCBPlayer
9613,UCBPlayer,118,218,336,16,60,UCBPlayer
9614,UCBPlayer,117,267,384,19,45,UCBPlayer
9615,UCBPlayer,110,210,320,12,64,UCBPlayer
9616,UCBPlayer,126,271,397,23,42,UCBPlayer
9617,UCBPlayer,105,210,315,10,65,UCBPlayer
9618,UCBPlayer,130,275,405,25,40,UCBPlayer
9619,UCBPlayer,105,210,315,10,65,UCBPlayer
9620,UCBPlayer,130,275,405,25,40,UCBPlayer
9621,UCBPlayer,106,206,312,10,66,UCBPlayer
9622,UCBPlayer,130,275,405,25,40,UCBPlayer
9623,UCBPlayer,105,210,315,10,65,UCBPlayer
9624,UCBPlayer,131,271,402,25,41,UCBPlayer
9625,UCBPlayer,105,210,315,10,65,UCBPlayer
9626,UCBPlayer,130,275,405,25,40,UCBPlayer
9627,UCBPlayer,105,210,315,10,65,UCBPlayer
9628,UCBPlayer,130,275,405,25,40,UCBPlayer
9629,UCBPlayer,103,203,306,10,68,UCBPlayer
9630,UCBPlayer,128,283,411,25,38,UCBPlayer
9631,UCBPlayer,111,186,297,10,71,UCBPlayer
9632,UCBPlayer,124,299,423,25,34,UCBPlayer
9633,UCBPlayer,115,170,285,10,75,UCBPlayer
9634,UCBPlayer,120,315,435,25,30,UCBPlayer
9635,UCBPlayer,119,154,273,10,79,UCBPlayer
9636,UCBPlayer,112,332,444,25,27,UCBPlayer
9637,UCBPlayer,127,137,264,10,82,UCBPlayer
9638,UCBPlayer,104,349,453,25,24,UCBPlayer
9639,UCBPlayer,126,126,252,7,85,Tie
9640,UCBPlayer,111,351,462,28,22,UCBPlayer
9641,UCBPlayer,116,126,242,3,87,UCBPlayer
9642,UCBPlayer,122,347,469,32,21,UCBPlayer
9643,UCBPlayer,107,132,239,0,87,UCBPlayer
9644,UCBPlayer,132,337,469,35,22,UCBPlayer
9645,UCBPlayer,103,148,251,0,83,UCBPlayer
9646,UCBPlayer,136,321,457,35,26,UCBPlayer
9647,UCBPlayer,99,164,263,0,79,UCBPlayer
9648,UCBPlayer,140,305,445,35,30,UCBPlayer
9649,UCBPlayer,95,180,275,0,75,UCBPlayer
9650,UCBPlayer,144,289,433,35,34,UCBPlayer
9651,UCBPlayer,91,196,287,0,71,UCBPlayer
9652,UCBPlayer,148,273,421,35,38,UCBPlayer
9653,UCBPlayer,87,212,299,0,67,UCBPlayer
9654,UCBPlayer,152,257,409,35,42,UCBPlayer
9655,UCBPlayer,84,224,308,0,64,UCBPlayer
9656,UCBPlayer,146,251,397,32,45,UCBPlayer
9657,UCBPlayer,89,234,323,3,60,UCBPlayer
9658,UCBPlayer,138,243,381,28,49,UCBPlayer
9659,UCBPlayer,97,242,339,7,56,UCBPlayer
9660,UCBPlayer,130,235,365,24,53,UCBPlayer
9661,UCBPlayer,105,250,355,11,52,UCBPlayer
9662,UCBPlayer,122,227,349,20,57,UCBPlayer
9663,UCBPlayer,109,259,368,15,49,UCBPlayer
9664,UCBPlayer,118,218,336,16,60,UCBPlayer
9665,UCBPlayer,117,267,384,19,45,UCBPlayer
9666,UCBPlayer,110,210,320,12,64,UCBPlayer
9667,UCBPlayer,126,271,397,23,42,UCBPlayer
9668,UCBPlayer,105,210,315,10,65,UCBPlayer
9669,UCBPlayer,130,275,405,25,40,UCBPlayer
9670,UCBPlayer,105,210,315,10,65,UCBPlayer
9671,UCBPlayer,130,275,405,25,40,UCBPlayer
9672,UCBPlayer,106,206,312,10,66,UCBPlayer
9673,UCBPlayer,130,275,405,25,40,UCBPlayer
9674,UCBPlayer,105,210,315,10,65,UCBPlayer
9675,UCBPlayer,131,271,402,25,41,UCBPlayer
9676,UCBPlayer,105,210,315,10,65,UCBPlayer
9677,UCBPlayer,130,275,405,25,40,UCBPlayer
9678,UCBPlayer,105,210,315,10,65,UCBPlayer
9679,UCBPlayer,130,275,405,25,40,UCBPlayer
9680,UCBPlayer,103,203,306,10,68,UCBPlayer
9681,UCBPlayer,128,283,411,25,38,UCBPlayer
9682,UCBPlayer,111,186,297,10,71,UCBPlayer
9683,UCBPlayer,124,299,423,25,34,UCBPlayer
9684,UCBPlayer,115,170,285,10,75,UCBPlayer
9685,UCBPlayer,120,315,435,25,30,UCBPlayer
9686,UCBPlayer,119,154,273,10,79,UCBPlayer
9687,UCBPlayer,112,332,444,25,27,UCBPlayer
9688,UCBPlayer,127,137,264,10,82,UCBPlayer
9689,UCBPlayer,104,349,453,25,24,UCBPlayer
9690,UCBPlayer,126,126,252,7,85,Tie
9691,UCBPlayer,111,351,462,28,22,UCBPlayer
9692,UCBPlayer,116,126,242,3,87,UCBPlayer
9693,UCBPlayer,122,347,469,32,21,UCBPlayer
9694,UCBPlayer,107,132,239,0,87,UCBPlayer
9695,UCBPlayer,132,337,469,35,22,UCBPlayer
9696,UCBPlayer,103,148,251,0,83,UCBPlayer
9697,UCBPlayer,136,321,457,35,26,UCBPlayer
9698,UCBPlayer,99,164,263,0,79,UCBPlayer
9699,UCBPlayer,140,305,445,35,30,UCBPlayer
9700,UCBPlayer,95,180,275,0,75,UCBPlayer
9701,UCBPlayer,144,289,433,35,34,UCBPlayer
9702,UCBPlayer,91,196,287,0,71,UCBPlayer
9703,UCBPlayer,148,273,421,35,38,UCBPlayer
9704,UCBPlayer,87,212,299,0,67,UCBPlayer
9705,UCBPlayer,152,257,409,35,42,UCBPlayer
9706,UCBPlayer,84,224,308,0,64,UCBPlayer
9707,UCBPlayer,146,251,397,32,45,UCBPlayer
9708,UCBPlayer,89,234,323,3,60,UCBPlayer
9709,UCBPlayer,138,243,381,28,49,UCBPlayer
9710,UCBPlayer,97,242,339,7,56,UCBPlayer
9711,UCBPlayer,130,235,365,24,53,UCBPlayer
9712,UCBPlayer,105,250,355,11,52,UCBPlayer
9713,UCBPlayer,122,227,349,20,57,UCBPlayer
9714,UCBPlayer,109,259,368,15,49,UCBPlayer
9715,UCBPlayer,118,218,336,16,60,UCBPlayer
9716,UCBPlayer,117,267,384,19,45,UCBPlayer
9717,UCBPlayer,110,210,320,12,64,UCBPlayer
9718,UCBPlayer,126,271,397,23,42,UCBPlayer
9719,UCBPlayer,105,210,315,10,65,UCBPlayer
9720,UCBPlayer,130,275,405,25,40,UCBPlayer
9721,UCBPlayer,105,210,315,10,65,UCBPlayer
9722,UCBPlayer,130,275,405,25,40,UCBPlayer
9723,UCBPlayer,106,206,312,10,66,UCBPlayer
9724,UCBPlayer,130,275,405,25,40,UCBPlayer
9725,UCBPlayer,105,210,315,10,65,UCBPlayer
9726,UCBPlayer,131,271,402,25,41,UCBPlayer
9727,UCBPlayer,105,210,315,10,65,UCBPlayer
9728,UCBPlayer,130,275,405,25,40,UCBPlayer
9729,UCBPlayer,105,210,315,10,65,UCBPlayer
9730,UCBPlayer,130,275,405,25,40,UCBPlayer
9731,UCBPlayer,103,203,306,10,68,UCBPlayer
9732,UCBPlayer,128,283,411,25,38,UCBPlayer
9733,UCBPlayer,111,186,297,10,71,UCBPlayer
9734,UCBPlayer,124,299,423,25,34,UCBPlayer
9735,UCBPlayer,115,170,285,10,75,UCBPlayer
9736,UCBPlayer,120,315,435,25,30,UCBPlayer
9737,UCBPlayer,119,154,273,10,79,UCBPlayer
9738,UCBPlayer,112,332,444,25,27,UCBPlayer
9739,UCBPlayer,127,137,264,10,82,UCBPlayer
9740,UCBPlayer,104,349,453,25,24,UCBPlayer
9741,UCBPlayer,126,126,252,7,85,Tie
9742,UCBPlayer,111,351,462,28,22,UCBPlayer
9743,UCBPlayer,116,126,242,3,87,UCBPlayer
9744,UCBPlayer,122,347,469,32,21,UCBPlayer
9745,UCBPlayer,107,132,239,0,87,UCBPlayer
9746,UCBPlayer,132,337,469,35,22,UCBPlayer
9747,UCBPlayer,103,148,251,0,83,UCBPlayer
9748,UCBPlayer,136,321,457,35,26,UCBPlayer
9749,UCBPlayer,99,164,263,0,79,UCBPlayer
9750,UCBPlayer,140,305,445,35,30,UCBPlayer
9751,UCBPlayer,95,180,275,0,75,UCBPlayer
9752,UCBPlayer,144,289,433,35,34,UCBPlayer
9753,UCBPlayer,91,196,287,0,71,UCBPlayer
9754,UCBPlayer,148,273,421,35,38,UCBPlayer
9755,UCBPlayer,87,212,299,0,67,UCBPlayer
9756,UCBPlayer,152,257,409,35,42,UCBPlayer
9757,UCBPlayer,84,224,308,0,64,UCBPlayer
9758,UCBPlayer,146,251,397,32,45,UCBPlayer
9759,UCBPlayer,89,234,323,3,60,UCBPlayer
9760,UCBPlayer,138,243,381,28,49,UCBPlayer
9761,UCBPlayer,97,242,339,7,56,UCBPlayer
9762,UCBPlayer,130,235,365,24,53,UCBPlayer
9763,UCBPlayer,105,250,355,11,52,UCBPlayer
9764,UCBPlayer,122,227,349,20,57,UCBPlayer
9765,UCBPlayer,109,259,368,15,49,UCBPlayer
9766,UCBPlayer,118,218,336,16,60,UCBPlayer
9767,UCBPlayer,117,267,384,19,45,UCBPlayer
9768,UCBPlayer,110,210,320,12,64,UCBPlayer
9769,UCBPlayer,126,271,397,23,42,UCBPlayer
9770,UCBPlayer,105,210,315,10,65,UCBPlayer
9771,UCBPlayer,130,275,405,25,40,UCBPlayer
9772,UCBPlayer,105,210,315,10,65,UCBPlayer
9773,UCBPlayer,130,275,405,25,40,UCBPlayer
9774,UCBPlayer,106,206,312,10,66,UCBPlayer
9775,UCBPlayer,130,275,405,25,40,UCBPlayer
9776,UCBPlayer,105,210,315,10,65,UCBPlayer
9777,UCBPlayer,131,271,402,25,41,UCBPlayer
9778,UCBPlayer,105,210,315,10,65,UCBPlayer
9779,UCBPlayer,130,275,405,25,40,UCBPlayer
9780,UCBPlayer,105,210,315,10,65,UCBPlayer
9781,UCBPlayer,130,275,405,25,40,UCBPlayer
9782,UCBPlayer,103,203,306,10,68,UCBPlayer
9783,UCBPlayer,128,283,411,25,38,UCBPlayer
9784,UCBPlayer,111,186,297,10,71,UCBPlayer
9785,UCBPlayer,124,299,423,25,34,UCBPlayer
9786,UCBPlayer,115,170,285,10,75,UCBPlayer
9787,UCBPlayer,120,315,435,25,30,UCBPlayer
9788,UCBPlayer,119,154,273,10,79,UCBPlayer
9789,UCBPlayer,112,332,444,25,27,UCBPlayer
9790,UCBPlayer,127,137,264,10,82,UCBPlayer
9791,UCBPlayer,104,349,453,25,24,UCBPlayer
9792,UCBPlayer,126,126,252,7,85,Tie
9793,UCBPlayer,111,351,462,28,22,UCBPlayer
9794,UCBPlayer,116,126,242,3,87,UCBPlayer
9795,UCBPlayer,122,347,469,32,21,UCBPlayer
9796,UCBPlayer,107,132,239,0,87,UCBPlayer
9797,UCBPlayer,132,337,469,35,22,UCBPlayer
9798,UCBPlayer,103,148,251,0,83,UCBPlayer
9799,UCBPlayer,136,321,457,35,26,UCBPlayer
9800,UCBPlayer,99,164,263,0,79,UCBPlayer
9801,UCBPlayer,140,305,445,35,30,UCBPlayer
9802,UCBPlayer,95,180,275,0,75,UCBPlayer
9803,UCBPlayer,144,289,433,35,34,UCBPlayer
9804,UCBPlayer,91,196,287,0,71,UCBPlayer
9805,UCBPlayer,148,273,421,35,38,UCBPlayer
9806,UCBPlayer,87,212,299,0,67,UCBPlayer
9807,UCBPlayer,152,257,409,35,42,UCBPlayer
9808,UCBPlayer,84,224,308,0,64,UCBPlayer
9809,UCBPlayer,146,251,397,32,45,UCBPlayer
9810,UCBPlayer,89,234,323,3,60,UCBPlayer
9811,UCBPlayer,138,243,381,28,49,UCBPlayer
9812,UCBPlayer,97,242,339,7,56,UCBPlayer
9813,UCBPlayer,130,235,365,24,53,UCBPlayer
9814,UCBPlayer,105,250,355,11,52,UCBPlayer
9815,UCBPlayer,122,227,349,20,57,UCBPlayer
9816,UCBPlayer,109,259,368,15,49,UCBPlayer
9817,UCBPlayer,118,218,336,16,60,UCBPlayer
9818,UCBPlayer,117,267,384,19,45,UCBPlayer
9819,UCBPlayer,110,210,320,12,64,UCBPlayer
9820,UCBPlayer,126,271,397,23,42,UCBPlayer
9821,UCBPlayer,105,210,315,10,65,UCBPlayer
9822,UCBPlayer,130,275,405,25,40,UCBPlayer
9823,UCBPlayer,105,210,315,10,65,UCBPlayer
9824,UCBPlayer,130,275,405,25,40,UCBPlayer
9825,UCBPlayer,106,206,312,10,66,UCBPlayer
9826,UCBPlayer,130,275,405,25,40,UCBPlayer
9827,UCBPlayer,105,210,315,10,65,UCBPlayer
9828,UCBPlayer,131,271,402,25,41,UCBPlayer
9829,UCBPlayer,105,210,315,10,65,UCBPlayer
9830,UCBPlayer,130,275,405,25,40,UCBPlayer
9831,UCBPlayer,105,210,315,10,65,UCBPlayer
9832,UCBPlayer,130,275,405,25,40,UCBPlayer
9833,UCBPlayer,103,203,306,10,68,UCBPlayer
9834,UCBPlayer,128,283,411,25,38,UCBPlayer
9835,UCBPlayer,111,186,297,10,71,UCBPlayer
9836,UCBPlayer,124,299,423,25,34,UCBPlayer
9837,UCBPlayer,115,170,285,10,75,UCBPlayer
9838,UCBPlayer,120,315,435,25,30,UCBPlayer
9839,UCBPlayer,119,154,273,10,79,UCBPlayer
9840,UCBPlayer,112,332,444,25,27,UCBPlayer
9841,UCBPlayer,127,137,264,10,82,UCBPlayer
9842,UCBPlayer,104,349,453,25,24,UCBPlayer
9843,UCBPlayer,126,126,252,7,85,Tie
9844,UCBPlayer,111,351,462,28,22,UCBPlayer
9845,UCBPlayer,116,126,242,3,87,UCBPlayer
9846,UCBPlayer,122,347,469,32,21,UCBPlayer
9847,UCBPlayer,107,132,239,0,87,UCBPlayer
9848,UCBPlayer,132,337,469,35,22,UCBPlayer
9849,UCBPlayer,103,148,251,0,83,UCBPlayer
9850,UCBPlayer,136,321,457,35,26,UCBPlayer
9851,UCBPlayer,99,164,263,0,79,UCBPlayer
9852,UCBPlayer,140,305,445,35,30,UCBPlayer
9853,UCBPlayer,95,180,275,0,75,UCBPlayer
9854,UCBPlayer,144,289,433,35,34,UCBPlayer
9855,UCBPlayer,91,196,287,0,71,UCBPlayer
9856,UCBPlayer,148,273,421,35,38,UCBPlayer
9857,UCBPlayer,87,212,299,0,67,UCBPlayer
9858,UCBPlayer,152,257,409,35,42,UCBPlayer
9859,UCBPlayer,84,224,308,0,64,UCBPlayer
9860,UCBPlayer,146,251,397,32,45,UCBPlayer
9861,UCBPlayer,89,234,323,3,60,UCBPlayer
9862,UCBPlayer,138,243,381,28,49,UCBPlayer
9863,UCBPlayer,97,242,339,7,56,UCBPlayer
9864,UCBPlayer,130,235,365,24,53,UCBPlayer
9865,UCBPlayer,105,250,355,11,52,UCBPlayer
9866,UCBPlayer,122,227,349,20,57,UCBPlayer
9867,UCBPlayer,109,259,368,15,49,UCBPlayer
9868,UCBPlayer,118,218,336,16,60,UCBPlayer
9869,UCBPlayer,117,267,384,19,45,UCBPlayer
9870,UCBPlayer,110,210,320,12,64,UCBPlayer
9871,UCBPlayer,126,271,397,23,42,UCBPlayer
9872,UCBPlayer,105,210,315,10,65,UCBPlayer
9873,UCBPlayer,130,275,405,25,40,UCBPlayer
9874,UCBPlayer,105,210,315,10,65,UCBPlayer
9875,UCBPlayer,130,275,405,25,40,UCBPlayer
9876,UCBPlayer,106,206,312,10,66,UCBPlayer
9877,UCBPlayer,130,275,405,25,40,UCBPlayer
9878,UCBPlayer,105,210,315,10,65,UCBPlayer
9879,UCBPlayer,131,271,402,25,41,UCBPlayer
9880,UCBPlayer,105,210,315,10,65,UCBPlayer
9881,UCBPlayer,130,275,405,25,40,UCBPlayer
9882,UCBPlayer,105,210,315,10,65,UCBPlayer
9883,UCBPlayer,130,275,405,25,40,UCBPlayer
9884,UCBPlayer,103,203,306,10,68,UCBPlayer
9885,UCBPlayer,128,283,411,25,38,UCBPlayer
9886,UCBPlayer,111,186,297,10,71,UCBPlayer
9887,UCBPlayer,124,299,423,25,34,UCBPlayer
9888,UCBPlayer,115,170,285,10,75,UCBPlayer
9889,UCBPlayer,120,315,435,25,30,UCBPlayer
9890,UCBPlayer,119,154,273,10,79,UCBPlayer
9891,UCBPlayer,112,332,444,25,27,UCBPlayer
9892,UCBPlayer,127,137,264,10,82,UCBPlayer
9893,UCBPlayer,104,349,453,25,24,UCBPlayer
9894,UCBPlayer,126,126,252,7,85,Tie
9895,UCBPlayer,111,351,462,28,22,UCBPlayer
9896,UCBPlayer,116,126,242,3,87,UCBPlayer
9897,UCBPlayer,122,347,469,32,21,UCBPlayer
9898,UCBPlayer,107,132,239,0,87,UCBPlayer
9899,UCBPlayer,132,337,469,35,22,UCBPlayer
9900,UCBPlayer,103,148,251,0,83,UCBPlayer
9901,UCBPlayer,136,321,457,35,26,UCBPlayer
9902,UCBPlayer,99,164,263,0,79,UCBPlayer
9903,UCBPlayer,140,305,445,35,30,UCBPlayer
9904,UCBPlayer,95,180,275,0,75,UCBPlayer
9905,UCBPlayer,144,289,433,35,34,UCBPlayer
9906,UCBPlayer,91,196,287,0,71,UCBPlayer
9907,UCBPlayer,148,273,421,35,38,UCBPlayer
9908,UCBPlayer,87,212,299,0,67,UCBPlayer
9909,UCBPlayer,152,257,409,35,42,UCBPlayer
9910,UCBPlayer,84,224,308,0,64,UCBPlayer
9911,UCBPlayer,146,251,397,32,45,UCBPlayer
9912,UCBPlayer,89,234,323,3,60,UCBPlayer
9913,UCBPlayer,138,243,381,28,49,UCBPlayer
9914,UCBPlayer,97,242,339,7,56,UCBPlayer
9915,UCBPlayer,130,235,365,24,53,UCBPlayer
9916,UCBPlayer,105,250,355,11,52,UCBPlayer
9917,UCBPlayer,122,227,349,20,57,UCBPlayer
9918,UCBPlayer,109,259,368,15,49,UCBPlayer
9919,UCBPlayer,118,218,336,16,60,UCBPlayer
9920,UCBPlayer,117,267,384,19,45,UCBPlayer
9921,UCBPlayer,110,210,320,12,64,UCBPlayer
9922,UCBPlayer,126,271,397,23,42,UCBPlayer
9923,UCBPlayer,105,210,315,10,65,UCBPlayer
9924,UCBPlayer,130,275,405,25,40,UCBPlayer
9925,UCBPlayer,105,210,315,10,65,UCBPlayer
9926,UCBPlayer,130,275,405,25,40,UCBPlayer
9927,UCBPlayer,106,206,312,10,66,UCBPlayer
9928,UCBPlayer,130,275,405,25,40,UCBPlayer
9929,UCBPlayer,105,210,315,10,65,UCBPlayer
9930,UCBPlayer,131,271,402,25,41,UCBPlayer
9931,UCBPlayer,105,210,315,10,65,UCBPlayer
9932,UCBPlayer,130,275,405,25,40,UCBPlayer
9933,UCBPlayer,105,210,315,10,65,UCBPlayer
9934,UCBPlayer,130,275,405,25,40,UCBPlayer
9935,UCBPlayer,103,203,306,10,68,UCBPlayer
9936,UCBPlayer,128,283,411,25,38,UCBPlayer
9937,UCBPlayer,111,186,297,10,71,UCBPlayer
9938,UCBPlayer,124,299,423,25,34,UCBPlayer
9939,UCBPlayer,115,170,285,10,75,UCBPlayer
9940,UCBPlayer,120,315,435,25,30,UCBPlayer
9941,UCBPlayer,119,154,273,10,79,UCBPlayer
9942,UCBPlayer,112,332,444,25,27,UCBPlayer
9943,UCBPlayer,127,137,264,10,82,UCBPlayer
9944,UCBPlayer,104,349,453,25,24,UCBPlayer
9945,UCBPlayer,126,126,252,7,85,Tie
9946,UCBPlayer,111,351,462,28,22,UCBPlayer
9947,UCBPlayer,116,126,242,3,87,UCBPlayer
9948,UCBPlayer,122,347,469,32,21,UCBPlayer
9949,UCBPlayer,107,132,239,0,87,UCBPlayer
9950,UCBPlayer,132,337,469,35,22,UCBPlayer
9951,UCBPlayer,103,148,251,0,83,UCBPlayer
9952,UCBPlayer,136,321,457,35,26,UCBPlayer
9953,UCBPlayer,99,164,263,0,79,UCBPlayer
9954,UCBPlayer,140,305,445,35,30,UCBPlayer
9955,UCBPlayer,95,180,275,0,75,UCBPlayer
9956,UCBPlayer,144,289,433,35,34,UCBPlayer
9957,UCBPlayer,91,196,287,0,71,UCBPlayer
9958,UCBPlayer,148,273,421,35,38,UCBPlayer
9959,UCBPlayer,87,212,299,0,67,UCBPlayer
9960,UCBPlayer,152,257,409,35,42,UCBPlayer
9961,UCBPlayer,84,224,308,0,64,UCBPlayer
9962,UCBPlayer,146,251,397,32,45,UCBPlayer
9963,UCBPlayer,89,234,323,3,60,UCBPlayer
9964,UCBPlayer,138,243,381,28,49,UCBPlayer
9965,UCBPlayer,97,242,339,7,56,UCBPlayer
9966,UCBPlayer,130,235,365,24,53,UCBPlayer
9967,UCBPlayer,105,250,355,11,52,UCBPlayer
9968,UCBPlayer,122,227,349,20,57,UCBPlayer
9969,UCBPlayer,109,259,368,15,49,UCBPlayer
9970,UCBPlayer,118,218,336,16,60,UCBPlayer
9971,UCBPlayer,117,267,384,19,45,UCBPlayer
9972,UCBPlayer,110,210,320,12,64,UCBPlayer
9973,UCBPlayer,126,271,397,23,42,UCBPlayer
9974,UCBPlayer,105,210,315,10,65,UCBPlayer
9975,UCBPlayer,130,275,405,25,40,UCBPlayer
9976,UCBPlayer,105,210,315,10,65,UCBPlayer
9977,UCBPlayer,130,275,405,25,40,UCBPlayer
9978,UCBPlayer,106,206,312,10,66,UCBPlayer
9979,UCBPlayer,130,275,405,25,40,UCBPlayer
9980,UCBPlayer,105,210,315,10,65,UCBPlayer
9981,UCBPlayer,131,271,402,25,41,UCBPlayer
9982,UCBPlayer,105,210,315,10,65,UCBPlayer
9983,UCBPlayer,130,275,405,25,40,UCBPlayer
9984,UCBPlayer,105,210,315,10,65,UCBPlayer
9985,UCBPlayer,130,275,405,25,40,UCBPlayer
9986,UCBPlayer,103,203,306,10,68,UCBPlayer
9987,UCBPlayer,128,283,411,25,38,UCBPlayer
9988,UCBPlayer,111,186,297,10,71,UCBPlayer
9989,UCBPlayer,124,299,423,25,34,UCBPlayer
9990,UCBPlayer,115,170,285,10,75,UCBPlayer
9991,UCBPlayer,120,315,435,25,30,UCBPlayer
9992,UCBPlayer,119,154,273,10,79,UCBPlayer
9993,UCBPlayer,112,332,444,25,27,UCBPlayer
9994,UCBPlayer,127,137,264,10,82,UCBPlayer
9995,UCBPlayer,104,349,453,25,24,UCBPlayer
9996,UCBPlayer,126,126,252,7,85,Tie
9997,UCBPlayer,111,351,462,28,22,UCBPlayer
9998,UCBPlayer,116,126,242,3,87,UCBPlayer
9999,UCBPlayer,122,347,469,32,21,UCBPlayer
10000,UCBPlayer,107,132,239,0,87,UCBPlayer
10001,UCBPlayer,132,337,469,35,22,UCBPlayer
10002,UCBPlayer,103,148,251,0,83,UCBPlayer
10003,UCBPlayer,136,321,457,35,26,UCBPlayer
10004,UCBPlayer,99,164,263,0,79,UCBPlayer
10005,UCBPlayer,140,305,445,35,30,UCBPlayer
10006,UCBPlayer,95,180,275,0,75,UCBPlayer
10007,UCBPlayer,144,289,433,35,34,UCBPlayer
10008,UCBPlayer,91,196,287,0,71,UCBPlayer
10009,UCBPlayer,148,273,421,35,38,UCBPlayer
10010,UCBPlayer,87,212,299,0,67,UCBPlayer
10011,UCBPlayer,152,257,409,35,42,UCBPlayer
10012,UCBPlayer,84,224,308,0,64,UCBPlayer
10013,UCBPlayer,146,251,397,32,45,UCBPlayer
10014,UCBPlayer,89,234,323,3,60,UCBPlayer
10015,UCBPlayer,138,243,381,28,49,UCBPlayer
10016,UCBPlayer,97,242,339,7,56,UCBPlayer
10017,UCBPlayer,130,235,365,24,53,UCBPlayer
10018,UCBPlayer,105,250,355,11,52,UCBPlayer
10019,UCBPlayer,122,227,349,20,57,UCBPlayer
10020,UCBPlayer,109,259,368,15,49,UCBPlayer
10021,UCBPlayer,118,218,336,16,60,UCBPlayer
10022,UCBPlayer,117,267,384,19,45,UCBPlayer
10023,UCBPlayer,110,210,320,12,64,UCBPlayer
10024,UCBPlayer,126,271,397,23,42,UCBPlayer
10025,UCBPlayer,105,210,315,10,65,UCBPlayer
10026,UCBPlayer,130,275,405,25,40,UCBPlayer
10027,UCBPlayer,105,210,315,10,65,UCBPlayer
10028,UCBPlayer,130,275,405,25,40,UCBPlayer
10029,UCBPlayer,106,206,312,10,66,UCBPlayer
10030,UCBPlayer,130,275,405,25,40,UCBPlayer
10031,UCBPlayer,105,210,315,10,65,UCBPlayer
10032,UCBPlayer,131,271,402,25,41,UCBPlayer
10033,UCBPlayer,105,210,315,10,65,UCBPlayer
10034,UCBPlayer,130,275,405,25,40,UCBPlayer
10035,UCBPlayer,105,210,315,10,65,UCBPlayer
10036,UCBPlayer,130,275,405,25,40,UCBPlayer
10037,UCBPlayer,103,203,306,10,68,UCBPlayer
10038,UCBPlayer,128,283,411,25,38,UCBPlayer
10039,UCBPlayer,111,186,297,10,71,UCBPlayer
10040,UCBPlayer,124,299,423,25,34,UCBPlayer
10041,UCBPlayer,115,170,285,10,75,UCBPlayer
10042,UCBPlayer,120,315,435,25,30,UCBPlayer
10043,UCBPlayer,119,154,273,10,79,UCBPlayer
10044,UCBPlayer,112,332,444,25,27,UCBPlayer
10045,UCBPlayer,127,137,264,10,82,UCBPlayer
10046,UCBPlayer,104,349,453,25,24,UCBPlayer
10047,UCBPlayer,126,126,252,7,85,Tie
10048,UCBPlayer,111,351,462,28,22,UCBPlayer
10049,UCBPlayer,116,126,242,3,87,UCBPlayer
10050,UCBPlayer,122,347,469,32,21,UCBPlayer
10051,UCBPlayer,107,132,239,0,87,UCBPlayer
10052,UCBPlayer,132,337,469,35,22,UCBPlayer
10053,UCBPlayer,103,148,251,0,83,UCBPlayer
10054,UCBPlayer,136,321,457,35,26,UCBPlayer
10055,UCBPlayer,99,164,263,0,79,UCBPlayer
10056,UCBPlayer,140,305,445,35,30,UCBPlayer
10057,UCBPlayer,95,180,275,0,75,UCBPlayer
10058,UCBPlayer,144,289,433,35,34,UCBPlayer
10059,UCBPlayer,91,196,287,0,71,UCBPlayer
10060,UCBPlayer,148,273,421,35,38,UCBPlayer
10061,UCBPlayer,87,212,299,0,67,UCBPlayer
10062,UCBPlayer,152,257,409,35,42,UCBPlayer
10063,UCBPlayer,84,224,308,0,64,UCBPlayer
10064,UCBPlayer,146,251,397,32,45,UCBPlayer
10065,UCBPlayer,89,234,323,3,60,UCBPlayer
10066,UCBPlayer,138,243,381,28,49,UCBPlayer
10067,UCBPlayer,97,242,339,7,56,UCBPlayer
10068,UCBPlayer,130,235,365,24,53,UCBPlayer
10069,UCBPlayer,105,250,355,11,52,UCBPlayer
10070,UCBPlayer,122,227,349,20,57,UCBPlayer
10071,UCBPlayer,109,259,368,15,49,UCBPlayer
10072,UCBPlayer,118,218,336,16,60,UCBPlayer
10073,UCBPlayer,117,267,384,19,45,UCBPlayer
10074,UCBPlayer,110,210,320,12,64,UCBPlayer
10075,UCBPlayer,126,271,397,23,42,UCBPlayer
10076,UCBPlayer,105,210,315,10,65,UCBPlayer
10077,UCBPlayer,130,275,405,25,40,UCBPlayer
10078,UCBPlayer,105,210,315,10,65,UCBPlayer
10079,UCBPlayer,130,275,405,25,40,UCBPlayer
10080,UCBPlayer,106,206,312,10,66,UCBPlayer
10081,UCBPlayer,130,275,405,25,40,UCBPlayer
10082,UCBPlayer,105,210,315,10,65,UCBPlayer
10083,UCBPlayer,131,271,402,25,41,UCBPlayer
10084,UCBPlayer,105,210,315,10,65,UCBPlayer
10085,UCBPlayer,130,275,405,25,40,UCBPlayer
10086,UCBPlayer,105,210,315,10,65,UCBPlayer
10087,UCBPlayer,130,275,405,25,40,UCBPlayer
10088,UCBPlayer,103,203,306,10,68,UCBPlayer
10089,UCBPlayer,128,283,411,25,38,UCBPlayer
10090,UCBPlayer,111,186,297,10,71,UCBPlayer
10091,UCBPlayer,124,299,423,25,34,UCBPlayer
10092,UCBPlayer,115,170,285,10,75,UCBPlayer
10093,UCBPlayer,120,315,435,25,30,UCBPlayer
10094,UCBPlayer,119,154,273,10,79,UCBPlayer
10095,UCBPlayer,112,332,444,25,27,UCBPlayer
10096,UCBPlayer,127,137,264,10,82,UCBPlayer
10097,UCBPlayer,104,349,453,25,24,UCBPlayer
10098,UCBPlayer,126,126,252,7,85,Tie
10099,UCBPlayer,111,351,462,28,22,UCBPlayer
10100,UCBPlayer,116,126,242,3,87,UCBPlayer
10101,UCBPlayer,122,347,469,32,21,UCBPlayer
10102,UCBPlayer,107,132,239,0,87,UCBPlayer
10103,UCBPlayer,132,337,469,35,22,UCBPlayer
10104,UCBPlayer,103,148,251,0,83,UCBPlayer
10105,UCBPlayer,136,321,457,35,26,UCBPlayer
10106,UCBPlayer,99,164,263,0,79,UCBPlayer
10107,UCBPlayer,140,305,445,35,30,UCBPlayer
10108,UCBPlayer,95,180,275,0,75,UCBPlayer
10109,UCBPlayer,144,289,433,35,34,UCBPlayer
10110,UCBPlayer,91,196,287,0,71,UCBPlayer
10111,UCBPlayer,148,273,421,35,38,UCBPlayer
10112,UCBPlayer,87,212,299,0,67,UCBPlayer
10113,UCBPlayer,152,257,409,35,42,UCBPlayer
10114,UCBPlayer,84,224,308,0,64,UCBPlayer
10115,UCBPlayer,146,251,397,32,45,UCBPlayer
10116,UCBPlayer,89,234,323,3,60,UCBPlayer
10117,UCBPlayer,138,243,381,28,49,UCBPlayer
10118,UCBPlayer,97,242,339,7,56,UCBPlayer
10119,UCBPlayer,130,235,365,24,53,UCBPlayer
10120,UCBPlayer,105,250,355,11,52,UCBPlayer
10121,UCBPlayer,122,227,349,20,57,UCBPlayer
10122,UCBPlayer,109,259,368,15,49,UCBPlayer
10123,UCBPlayer,118,218,336,16,60,UCBPlayer
10124,UCBPlayer,117,267,384,19,45,UCBPlayer
10125,UCBPlayer,110,210,320,12,64,UCBPlayer
10126,UCBPlayer,126,271,397,23,42,UCBPlayer
10127,UCBPlayer,105,210,315,10,65,UCBPlayer
10128,UCBPlayer,130,275,405,25,40,UCBPlayer
10129,UCBPlayer,105,210,315,10,65,UCBPlayer
10130,UCBPlayer,130,275,405,25,40,UCBPlayer
10131,UCBPlayer,106,206,312,10,66,UCBPlayer
10132,UCBPlayer,130,275,405,25,40,UCBPlayer
10133,UCBPlayer,105,210,315,10,65,UCBPlayer
10134,UCBPlayer,131,271,402,25,41,UCBPlayer
10135,UCBPlayer,105,210,315,10,65,UCBPlayer
10136,UCBPlayer,130,275,405,25,40,UCBPlayer
10137,UCBPlayer,105,210,315,10,65,UCBPlayer
10138,UCBPlayer,130,275,405,25,40,UCBPlayer
10139,UCBPlayer,103,203,306,10,68,UCBPlayer
10140,UCBPlayer,128,283,411,25,38,UCBPlayer
10141,UCBPlayer,111,186,297,10,71,UCBPlayer
10142,UCBPlayer,124,299,423,25,34,UCBPlayer
10143,UCBPlayer,115,170,285,10,75,UCBPlayer
10144,UCBPlayer,120,315,435,25,30,UCBPlayer
10145,UCBPlayer,119,154,273,10,79,UCBPlayer
10146,UCBPlayer,112,332,444,25,27,UCBPlayer
10147,UCBPlayer,127,137,264,10,82,UCBPlayer
10148,UCBPlayer,104,349,453,25,24,UCBPlayer
10149,UCBPlayer,126,126,252,7,85,Tie
10150,UCBPlayer,111,351,462,28,22,UCBPlayer
10151,UCBPlayer,116,126,242,3,87,UCBPlayer
10152,UCBPlayer,122,347,469,32,21,UCBPlayer
10153,UCBPlayer,107,132,239,0,87,UCBPlayer
10154,UCBPlayer,132,337,469,35,22,UCBPlayer
10155,UCBPlayer,103,148,251,0,83,UCBPlayer
10156,UCBPlayer,136,321,457,35,26,UCBPlayer
10157,UCBPlayer,99,164,263,0,79,UCBPlayer
10158,UCBPlayer,140,305,445,35,30,UCBPlayer
10159,UCBPlayer,95,180,275,0,75,UCBPlayer
10160,UCBPlayer,144,289,433,35,34,UCBPlayer
10161,UCBPlayer,91,196,287,0,71,UCBPlayer
10162,UCBPlayer,148,273,421,35,38,UCBPlayer
10163,UCBPlayer,87,212,299,0,67,UCBPlayer
10164,UCBPlayer,152,257,409,35,42,UCBPlayer
10165,UCBPlayer,84,224,308,0,64,UCBPlayer
10166,UCBPlayer,146,251,397,32,45,UCBPlayer
10167,UCBPlayer,89,234,323,3,60,UCBPlayer
10168,UCBPlayer,138,243,381,28,49,UCBPlayer
10169,UCBPlayer,97,242,339,7,56,UCBPlayer
10170,UCBPlayer,130,235,365,24,53,UCBPlayer
10171,UCBPlayer,105,250,355,11,52,UCBPlayer
10172,UCBPlayer,122,227,349,20,57,UCBPlayer
10173,UCBPlayer,109,259,368,15,49,UCBPlayer
10174,UCBPlayer,118,218,336,16,60,UCBPlayer
10175,UCBPlayer,117,267,384,19,45,UCBPlayer
10176,UCBPlayer,110,210,320,12,64,UCBPlayer
10177,UCBPlayer,126,271,397,23,42,UCBPlayer
10178,UCBPlayer,105,210,315,10,65,UCBPlayer
10179,UCBPlayer,130,275,405,25,40,UCBPlayer
10180,UCBPlayer,105,210,315,10,65,UCBPlayer
10181,UCBPlayer,130,275,405,25,40,UCBPlayer
10182,UCBPlayer,106,206,312,10,66,UCBPlayer
10183,UCBPlayer,130,275,405,25,40,UCBPlayer
10184,UCBPlayer,105,210,315,10,65,UCBPlayer
10185,UCBPlayer,131,271,402,25,41,UCBPlayer
10186,UCBPlayer,105,210,315,10,65,UCBPlayer
10187,UCBPlayer,130,275,405,25,40,UCBPlayer
10188,UCBPlayer,105,210,315,10,65,UCBPlayer
10189,UCBPlayer,130,275,405,25,40,UCBPlayer
10190,UCBPlayer,103,203,306,10,68,UCBPlayer
10191,UCBPlayer,128,283,411,25,38,UCBPlayer
10192,UCBPlayer,111,186,297,10,71,UCBPlayer
10193,UCBPlayer,124,299,423,25,34,UCBPlayer
10194,UCBPlayer,115,170,285,10,75,UCBPlayer
10195,UCBPlayer,120,315,435,25,30,UCBPlayer
10196,UCBPlayer,119,154,273,10,79,UCBPlayer
10197,UCBPlayer,112,332,444,25,27,UCBPlayer
10198,UCBPlayer,127,137,264,10,82,UCBPlayer
10199,UCBPlayer,104,349,453,25,24,UCBPlayer
10200,UCBPlayer,126,126,252,7,85,Tie
10201,UCBPlayer,111,351,462,28,22,UCBPlayer
10202,UCBPlayer,116,126,242,3,87,UCBPlayer
10203,UCBPlayer,122,347,469,32,21,UCBPlayer
10204,UCBPlayer,107,132,239,0,87,UCBPlayer
10205,UCBPlayer,132,337,469,35,22,UCBPlayer
10206,UCBPlayer,103,148,251,0,83,UCBPlayer
10207,UCBPlayer,136,321,457,35,26,UCBPlayer
10208,UCBPlayer,99,164,263,0,79,UCBPlayer
10209,UCBPlayer,140,305,445,35,30,UCBPlayer
10210,UCBPlayer,95,180,275,0,75,UCBPlayer
10211,UCBPlayer,144,289,433,35,34,UCBPlayer
10212,UCBPlayer,91,196,287,0,71,UCBPlayer
10213,UCBPlayer,148,273,421,35,38,UCBPlayer
10214,UCBPlayer,87,212,299,0,67,UCBPlayer
10215,UCBPlayer,152,257,409,35,42,UCBPlayer
10216,UCBPlayer,84,224,308,0,64,UCBPlayer
10217,UCBPlayer,146,251,397,32,45,UCBPlayer
10218,UCBPlayer,89,234,323,3,60,UCBPlayer
10219,UCBPlayer,138,243,381,28,49,UCBPlayer
10220,UCBPlayer,97,242,339,7,56,UCBPlayer
10221,UCBPlayer,130,235,365,24,53,UCBPlayer
10222,UCBPlayer,105,250,355,11,52,UCBPlayer
10223,UCBPlayer,122,227,349,20,57,UCBPlayer
10224,UCBPlayer,109,259,368,15,49,UCBPlayer
10225,UCBPlayer,118,218,336,16,60,UCBPlayer
10226,UCBPlayer,117,267,384,19,45,UCBPlayer
10227,UCBPlayer,110,210,320,12,64,UCBPlayer
10228,UCBPlayer,126,271,397,23,42,UCBPlayer
10229,UCBPlayer,105,210,315,10,65,UCBPlayer
10230,UCBPlayer,130,275,405,25,40,UCBPlayer
10231,UCBPlayer,105,210,315,10,65,UCBPlayer
10232,UCBPlayer,130,275,405,25,40,UCBPlayer
10233,UCBPlayer,106,206,312,10,66,UCBPlayer
10234,UCBPlayer,130,275,405,25,40,UCBPlayer
10235,UCBPlayer,105,210,315,10,65,UCBPlayer
10236,UCBPlayer,131,271,402,25,41,UCBPlayer
10237,UCBPlayer,105,210,315,10,65,UCBPlayer
10238,UCBPlayer,130,275,405,25,40,UCBPlayer
10239,UCBPlayer,105,210,315,10,65,UCBPlayer
10240,UCBPlayer,130,275,405,25,40,UCBPlayer
10241,UCBPlayer,103,203,306,10,68,UCBPlayer
10242,UCBPlayer,128,283,411,25,38,UCBPlayer
10243,UCBPlayer,111,186,297,10,71,UCBPlayer
10244,UCBPlayer,124,299,423,25,34,UCBPlayer
10245,UCBPlayer,115,170,285,10,75,UCBPlayer
10246,UCBPlayer,120,315,435,25,30,UCBPlayer
10247,UCBPlayer,119,154,273,10,79,UCBPlayer
10248,UCBPlayer,112,332,444,25,27,UCBPlayer
10249,UCBPlayer,127,137,264,10,82,UCBPlayer
10250,UCBPlayer,104,349,453,25,24,UCBPlayer
10251,UCBPlayer,126,126,252,7,85,Tie
10252,UCBPlayer,111,351,462,28,22,UCBPlayer
10253,UCBPlayer,116,126,242,3,87,UCBPlayer
10254,UCBPlayer,122,347,469,32,21,UCBPlayer
10255,UCBPlayer,107,132,239,0,87,UCBPlayer
10256,UCBPlayer,132,337,469,35,22,UCBPlayer
10257,UCBPlayer,103,148,251,0,83,UCBPlayer
10258,UCBPlayer,136,321,457,35,26,UCBPlayer
10259,UCBPlayer,99,164,263,0,79,UCBPlayer
10260,UCBPlayer,140,305,445,35,30,UCBPlayer
10261,UCBPlayer,95,180,275,0,75,UCBPlayer
10262,UCBPlayer,144,289,433,35,34,UCBPlayer
10263,UCBPlayer,91,196,287,0,71,UCBPlayer
10264,UCBPlayer,148,273,421,35,38,UCBPlayer
10265,UCBPlayer,87,212,299,0,67,UCBPlayer
10266,UCBPlayer,152,257,409,35,42,UCBPlayer
10267,UCBPlayer,84,224,308,0,64,UCBPlayer
10268,UCBPlayer,146,251,397,32,45,UCBPlayer
10269,UCBPlayer,89,234,323,3,60,UCBPlayer
10270,UCBPlayer,138,243,381,28,49,UCBPlayer
10271,UCBPlayer,97,242,339,7,56,UCBPlayer
10272,UCBPlayer,130,235,365,24,53,UCBPlayer
10273,UCBPlayer,105,250,355,11,52,UCBPlayer
10274,UCBPlayer,122,227,349,20,57,UCBPlayer
10275,UCBPlayer,109,259,368,15,49,UCBPlayer
10276,UCBPlayer,118,218,336,16,60,UCBPlayer
10277,UCBPlayer,117,267,384,19,45,UCBPlayer
10278,UCBPlayer,110,210,320,12,64,UCBPlayer
10279,UCBPlayer,126,271,397,23,42,UCBPlayer
10280,UCBPlayer,105,210,315,10,65,UCBPlayer
10281,UCBPlayer,130,275,405,25,40,UCBPlayer
10282,UCBPlayer,105,210,315,10,65,UCBPlayer
10283,UCBPlayer,130,275,405,25,40,UCBPlayer
10284,UCBPlayer,106,206,312,10,66,UCBPlayer
10285,UCBPlayer,130,275,405,25,40,UCBPlayer
10286,UCBPlayer,105,210,315,10,65,UCBPlayer
10287,UCBPlayer,131,271,402,25,41,UCBPlayer
10288,UCBPlayer,105,210,315,10,65,UCBPlayer
10289,UCBPlayer,130,275,405,25,40,UCBPlayer
10290,UCBPlayer,105,210,315,10,65,UCBPlayer
10291,UCBPlayer,130,275,405,25,40,UCBPlayer
10292,UCBPlayer,103,203,306,10,68,UCBPlayer
10293,UCBPlayer,128,283,411,25,38,UCBPlayer
10294,UCBPlayer,111,186,297,10,71,UCBPlayer
10295,UCBPlayer,124,299,423,25,34,UCBPlayer
10296,UCBPlayer,115,170,285,10,75,UCBPlayer
10297,UCBPlayer,120,315,435,25,30,UCBPlayer
10298,UCBPlayer,119,154,273,10,79,UCBPlayer
10299,UCBPlayer,112,332,444,25,27,UCBPlayer
10300,UCBPlayer,127,137,264,10,82,UCBPlayer
10301,UCBPlayer,104,349,453,25,24,UCBPlayer
10302,UCBPlayer,126,126,252,7,85,Tie
10303,UCBPlayer,111,351,462,28,22,UCBPlayer
10304,UCBPlayer,116,126,242,3,87,UCBPlayer
10305,UCBPlayer,122,347,469,32,21,UCBPlayer
10306,UCBPlayer,107,132,239,0,87,UCBPlayer
10307,UCBPlayer,132,337,469,35,22,UCBPlayer
10308,UCBPlayer,103,148,251,0,83,UCBPlayer
10309,UCBPlayer,136,321,457,35,26,UCBPlayer
10310,UCBPlayer,99,164,263,0,79,UCBPlayer
10311,UCBPlayer,140,305,445,35,30,UCBPlayer
10312,UCBPlayer,95,180,275,0,75,UCBPlayer
10313,UCBPlayer,144,289,433,35,34,UCBPlayer
10314,UCBPlayer,91,196,287,0,71,UCBPlayer
10315,UCBPlayer,148,273,421,35,38,UCBPlayer
10316,UCBPlayer,87,212,299,0,67,UCBPlayer
10317,UCBPlayer,152,257,409,35,42,UCBPlayer
10318,UCBPlayer,84,224,308,0,64,UCBPlayer
10319,UCBPlayer,146,251,397,32,45,UCBPlayer
10320,UCBPlayer,89,234,323,3,60,UCBPlayer
10321,UCBPlayer,138,243,381,28,49,UCBPlayer
10322,UCBPlayer,97,242,339,7,56,UCBPlayer
10323,UCBPlayer,130,235,365,24,53,UCBPlayer
10324,UCBPlayer,105,250,355,11,52,UCBPlayer
10325,UCBPlayer,122,227,349,20,57,UCBPlayer
10326,UCBPlayer,109,259,368,15,49,UCBPlayer
10327,UCBPlayer,118,218,336,16,60,UCBPlayer
10328,UCBPlayer,117,267,384,19,45,UCBPlayer
10329,UCBPlayer,110,210,320,12,64,UCBPlayer
10330,UCBPlayer,126,271,397,23,42,UCBPlayer
10331,UCBPlayer,105,210,315,10,65,UCBPlayer
10332,UCBPlayer,130,275,405,25,40,UCBPlayer
10333,UCBPlayer,105,210,315,10,65,UCBPlayer
10334,UCBPlayer,130,275,405,25,40,UCBPlayer
10335,UCBPlayer,106,206,312,10,66,UCBPlayer
10336,UCBPlayer,130,275,405,25,40,UCBPlayer
10337,UCBPlayer,105,210,315,10,65,UCBPlayer
10338,UCBPlayer,131,271,402,25,41,UCBPlayer
10339,UCBPlayer,105,210,315,10,65,UCBPlayer
10340,UCBPlayer,130,275,405,25,40,UCBPlayer
10341,UCBPlayer,105,210,315,10,65,UCBPlayer
10342,UCBPlayer,130,275,405,25,40,UCBPlayer
10343,UCBPlayer,103,203,306,10,68,UCBPlayer
10344,UCBPlayer,128,283,411,25,38,UCBPlayer
10345,UCBPlayer,111,186,297,10,71,UCBPlayer
10346,UCBPlayer,124,299,423,25,34,UCBPlayer
10347,UCBPlayer,115,170,285,10,75,UCBPlayer
10348,UCBPlayer,120,315,435,25,30,UCBPlayer
10349,UCBPlayer,119,154,273,10,79,UCBPlayer
10350,UCBPlayer,112,332,444,25,27,UCBPlayer
10351,UCBPlayer,127,137,264,10,82,UCBPlayer
10352,UCBPlayer,104,349,453,25,24,UCBPlayer
10353,UCBPlayer,126,126,252,7,85,Tie
10354,UCBPlayer,111,351,462,28,22,UCBPlayer
10355,UCBPlayer,116,126,242,3,87,UCBPlayer
10356,UCBPlayer,122,347,469,32,21,UCBPlayer
10357,UCBPlayer,107,132,239,0,87,UCBPlayer
10358,UCBPlayer,132,337,469,35,22,UCBPlayer
10359,UCBPlayer,103,148,251,0,83,UCBPlayer
10360,UCBPlayer,136,321,457,35,26,UCBPlayer
10361,UCBPlayer,99,164,263,0,79,UCBPlayer
10362,UCBPlayer,140,305,445,35,30,UCBPlayer
10363,UCBPlayer,95,180,275,0,75,UCBPlayer
10364,UCBPlayer,144,289,433,35,34,UCBPlayer
10365,UCBPlayer,91,196,287,0,71,UCBPlayer
10366,UCBPlayer,148,273,421,35,38,UCBPlayer
10367,UCBPlayer,87,212,299,0,67,UCBPlayer
10368,UCBPlayer,152,257,409,35,42,UCBPlayer
10369,UCBPlayer,84,224,308,0,64,UCBPlayer
10370,UCBPlayer,146,251,397,32,45,UCBPlayer
10371,UCBPlayer,89,234,323,3,60,UCBPlayer
10372,UCBPlayer,138,243,381,28,49,UCBPlayer
10373,UCBPlayer,97,242,339,7,56,UCBPlayer
10374,UCBPlayer,130,235,365,24,53,UCBPlayer
10375,UCBPlayer,105,250,355,11,52,UCBPlayer
10376,UCBPlayer,122,227,349,20,57,UCBPlayer
10377,UCBPlayer,109,259,368,15,49,UCBPlayer
10378,UCBPlayer,118,218,336,16,60,UCBPlayer
10379,UCBPlayer,117,267,384,19,45,UCBPlayer
10380,UCBPlayer,110,210,320,12,64,UCBPlayer
10381,UCBPlayer,126,271,397,23,42,UCBPlayer
10382,UCBPlayer,105,210,315,10,65,UCBPlayer
10383,UCBPlayer,130,275,405,25,40,UCBPlayer
10384,UCBPlayer,105,210,315,10,65,UCBPlayer
10385,UCBPlayer,130,275,405,25,40,UCBPlayer
10386,UCBPlayer,106,206,312,10,66,UCBPlayer
10387,UCBPlayer,130,275,405,25,40,UCBPlayer
10388,UCBPlayer,105,210,315,10,65,UCBPlayer
10389,UCBPlayer,131,271,402,25,41,UCBPlayer
10390,UCBPlayer,105,210,315,10,65,UCBPlayer
10391,UCBPlayer,130,275,405,25,40,UCBPlayer
10392,UCBPlayer,105,210,315,10,65,UCBPlayer
10393,UCBPlayer,130,275,405,25,40,UCBPlayer
10394,UCBPlayer,103,203,306,10,68,UCBPlayer
10395,UCBPlayer,128,283,411,25,38,UCBPlayer
10396,UCBPlayer,111,186,297,10,71,UCBPlayer
10397,UCBPlayer,124,299,423,25,34,UCBPlayer
10398,UCBPlayer,115,170,285,10,75,UCBPlayer
10399,UCBPlayer,120,315,435,25,30,UCBPlayer
10400,UCBPlayer,119,154,273,10,79,UCBPlayer
10401,UCBPlayer,112,332,444,25,27,UCBPlayer
10402,UCBPlayer,127,137,264,10,82,UCBPlayer
10403,UCBPlayer,104,349,453,25,24,UCBPlayer
10404,UCBPlayer,126,126,252,7,85,Tie
10405,UCBPlayer,111,351,462,28,22,UCBPlayer
10406,UCBPlayer,116,126,242,3,87,UCBPlayer
10407,UCBPlayer,122,347,469,32,21,UCBPlayer
10408,UCBPlayer,107,132,239,0,87,UCBPlayer
10409,UCBPlayer,132,337,469,35,22,UCBPlayer
10410,UCBPlayer,103,148,251,0,83,UCBPlayer
10411,UCBPlayer,136,321,457,35,26,UCBPlayer
10412,UCBPlayer,99,164,263,0,79,UCBPlayer
10413,UCBPlayer,140,305,445,35,30,UCBPlayer
10414,UCBPlayer,95,180,275,0,75,UCBPlayer
10415,UCBPlayer,144,289,433,35,34,UCBPlayer
10416,UCBPlayer,91,196,287,0,71,UCBPlayer
10417,UCBPlayer,148,273,421,35,38,UCBPlayer
10418,UCBPlayer,87,212,299,0,67,UCBPlayer
10419,UCBPlayer,152,257,409,35,42,UCBPlayer
10420,UCBPlayer,84,224,308,0,64,UCBPlayer
10421,UCBPlayer,146,251,397,32,45,UCBPlayer
10422,UCBPlayer,89,234,323,3,60,UCBPlayer
10423,UCBPlayer,138,243,381,28,49,UCBPlayer
10424,UCBPlayer,97,242,339,7,56,UCBPlayer
10425,UCBPlayer,130,235,365,24,53,UCBPlayer
10426,UCBPlayer,105,250,355,11,52,UCBPlayer
10427,UCBPlayer,122,227,349,20,57,UCBPlayer
10428,UCBPlayer,109,259,368,15,49,UCBPlayer
10429,UCBPlayer,118,218,336,16,60,UCBPlayer
10430,UCBPlayer,117,267,384,19,45,UCBPlayer
10431,UCBPlayer,110,210,320,12,64,UCBPlayer
10432,UCBPlayer,126,271,397,23,42,UCBPlayer
10433,UCBPlayer,105,210,315,10,65,UCBPlayer
10434,UCBPlayer,130,275,405,25,40,UCBPlayer
10435,UCBPlayer,105,210,315,10,65,UCBPlayer
10436,UCBPlayer,130,275,405,25,40,UCBPlayer
10437,UCBPlayer,106,206,312,10,66,UCBPlayer
10438,UCBPlayer,130,275,405,25,40,UCBPlayer
10439,UCBPlayer,105,210,315,10,65,UCBPlayer
10440,UCBPlayer,131,271,402,25,41,UCBPlayer
10441,UCBPlayer,105,210,315,10,65,UCBPlayer
10442,UCBPlayer,130,275,405,25,40,UCBPlayer
10443,UCBPlayer,105,210,315,10,65,UCBPlayer
10444,UCBPlayer,130,275,405,25,40,UCBPlayer
10445,UCBPlayer,103,203,306,10,68,UCBPlayer
10446,UCBPlayer,128,283,411,25,38,UCBPlayer
10447,UCBPlayer,111,186,297,10,71,UCBPlayer
10448,UCBPlayer,124,299,423,25,34,UCBPlayer
10449,UCBPlayer,115,170,285,10,75,UCBPlayer
10450,UCBPlayer,120,315,435,25,30,UCBPlayer
10451,UCBPlayer,119,154,273,10,79,UCBPlayer
10452,UCBPlayer,112,332,444,25,27,UCBPlayer
10453,UCBPlayer,127,137,264,10,82,UCBPlayer
10454,UCBPlayer,104,349,453,25,24,UCBPlayer
10455,UCBPlayer,126,126,252,7,85,Tie
10456,UCBPlayer,111,351,462,28,22,UCBPlayer
10457,UCBPlayer,116,126,242,3,87,UCBPlayer
10458,UCBPlayer,122,347,469,32,21,UCBPlayer
10459,UCBPlayer,107,132,239,0,87,UCBPlayer
10460,UCBPlayer,132,337,469,35,22,UCBPlayer
10461,UCBPlayer,103,148,251,0,83,UCBPlayer
10462,UCBPlayer,136,321,457,35,26,UCBPlayer
10463,UCBPlayer,99,164,263,0,79,UCBPlayer
10464,UCBPlayer,140,305,445,35,30,UCBPlayer
10465,UCBPlayer,95,180,275,0,75,UCBPlayer
10466,UCBPlayer,144,289,433,35,34,UCBPlayer
10467,UCBPlayer,91,196,287,0,71,UCBPlayer
10468,UCBPlayer,148,273,421,35,38,UCBPlayer
10469,UCBPlayer,87,212,299,0,67,UCBPlayer
10470,UCBPlayer,152,257,409,35,42,UCBPlayer
10471,UCBPlayer,84,224,308,0,64,UCBPlayer
10472,UCBPlayer,146,251,397,32,45,UCBPlayer
10473,UCBPlayer,89,234,323,3,60,UCBPlayer
10474,UCBPlayer,138,243,381,28,49,UCBPlayer
10475,UCBPlayer,97,242,339,7,56,UCBPlayer
10476,UCBPlayer,130,235,365,24,53,UCBPlayer
10477,UCBPlayer,105,250,355,11,52,UCBPlayer
10478,UCBPlayer,122,227,349,20,57,UCBPlayer
10479,UCBPlayer,109,259,368,15,49,UCBPlayer
10480,UCBPlayer,118,218,336,16,60,UCBPlayer
10481,UCBPlayer,117,267,384,19,45,UCBPlayer
10482,UCBPlayer,110,210,320,12,64,UCBPlayer
10483,UCBPlayer,126,271,397,23,42,UCBPlayer
10484,UCBPlayer,105,210,315,10,65,UCBPlayer
10485,UCBPlayer,130,275,405,25,40,UCBPlayer
10486,UCBPlayer,105,210,315,10,65,UCBPlayer
10487,UCBPlayer,130,275,405,25,40,UCBPlayer
10488,UCBPlayer,106,206,312,10,66,UCBPlayer
10489,UCBPlayer,130,275,405,25,40,UCBPlayer
10490,UCBPlayer,105,210,315,10,65,UCBPlayer
10491,UCBPlayer,131,271,402,25,41,UCBPlayer
10492,UCBPlayer,105,210,315,10,65,UCBPlayer
10493,UCBPlayer,130,275,405,25,40,UCBPlayer
10494,UCBPlayer,105,210,315,10,65,UCBPlayer
10495,UCBPlayer,130,275,405,25,40,UCBPlayer
10496,UCBPlayer,103,203,306,10,68,UCBPlayer
10497,UCBPlayer,128,283,411,25,38,UCBPlayer
10498,UCBPlayer,111,186,297,10,71,UCBPlayer
10499,UCBPlayer,124,299,423,25,34,UCBPlayer
10500,UCBPlayer,115,170,285,10,75,UCBPlayer
10501,UCBPlayer,120,315,435,25,30,UCBPlayer
10502,UCBPlayer,119,154,273,10,79,UCBPlayer
10503,UCBPlayer,112,332,444,25,27,UCBPlayer
10504,UCBPlayer,127,137,264,10,82,UCBPlayer
10505,UCBPlayer,104,349,453,25,24,UCBPlayer
10506,UCBPlayer,126,126,252,7,85,Tie
10507,UCBPlayer,111,351,462,28,22,UCBPlayer
10508,UCBPlayer,116,126,242,3,87,UCBPlayer
10509,UCBPlayer,122,347,469,32,21,UCBPlayer
10510,UCBPlayer,107,132,239,0,87,UCBPlayer
10511,UCBPlayer,132,337,469,35,22,UCBPlayer
10512,UCBPlayer,103,148,251,0,83,UCBPlayer
10513,UCBPlayer,136,321,457,35,26,UCBPlayer
10514,UCBPlayer,99,164,263,0,79,UCBPlayer
10515,UCBPlayer,140,305,445,35,30,UCBPlayer
10516,UCBPlayer,95,180,275,0,75,UCBPlayer
10517,UCBPlayer,144,289,433,35,34,UCBPlayer
10518,UCBPlayer,91,196,287,0,71,UCBPlayer
10519,UCBPlayer,148,273,421,35,38,UCBPlayer
10520,UCBPlayer,87,212,299,0,67,UCBPlayer
10521,UCBPlayer,152,257,409,35,42,UCBPlayer
10522,UCBPlayer,84,224,308,0,64,UCBPlayer
10523,UCBPlayer,146,251,397,32,45,UCBPlayer
10524,UCBPlayer,89,234,323,3,60,UCBPlayer
10525,UCBPlayer,138,243,381,28,49,UCBPlayer
10526,UCBPlayer,97,242,339,7,56,UCBPlayer
10527,UCBPlayer,130,235,365,24,53,UCBPlayer
10528,UCBPlayer,105,250,355,11,52,UCBPlayer
10529,UCBPlayer,122,227,349,20,57,UCBPlayer
10530,UCBPlayer,109,259,368,15,49,UCBPlayer
10531,UCBPlayer,118,218,336,16,60,UCBPlayer
10532,UCBPlayer,117,267,384,19,45,UCBPlayer
10533,UCBPlayer,110,210,320,12,64,UCBPlayer
10534,UCBPlayer,126,271,397,23,42,UCBPlayer
10535,UCBPlayer,105,210,315,10,65,UCBPlayer
10536,UCBPlayer,130,275,405,25,40,UCBPlayer
10537,UCBPlayer,105,210,315,10,65,UCBPlayer
10538,UCBPlayer,130,275,405,25,40,UCBPlayer
10539,UCBPlayer,106,206,312,10,66,UCBPlayer
10540,UCBPlayer,130,275,405,25,40,UCBPlayer
10541,UCBPlayer,105,210,315,10,65,UCBPlayer
10542,UCBPlayer,131,271,402,25,41,UCBPlayer
10543,UCBPlayer,105,210,315,10,65,UCBPlayer
10544,UCBPlayer,130,275,405,25,40,UCBPlayer
10545,UCBPlayer,105,210,315,10,65,UCBPlayer
10546,UCBPlayer,130,275,405,25,40,UCBPlayer
10547,UCBPlayer,103,203,306,10,68,UCBPlayer
10548,UCBPlayer,128,283,411,25,38,UCBPlayer
10549,UCBPlayer,111,186,297,10,71,UCBPlayer
10550,UCBPlayer,124,299,423,25,34,UCBPlayer
10551,UCBPlayer,115,170,285,10,75,UCBPlayer
10552,UCBPlayer,120,315,435,25,30,UCBPlayer
10553,UCBPlayer,119,154,273,10,79,UCBPlayer
10554,UCBPlayer,112,332,444,25,27,UCBPlayer
10555,UCBPlayer,127,137,264,10,82,UCBPlayer
10556,UCBPlayer,104,349,453,25,24,UCBPlayer
10557,UCBPlayer,126,126,252,7,85,Tie
10558,UCBPlayer,111,351,462,28,22,UCBPlayer
10559,UCBPlayer,116,126,242,3,87,UCBPlayer
10560,UCBPlayer,122,347,469,32,21,UCBPlayer
10561,UCBPlayer,107,132,239,0,87,UCBPlayer
10562,UCBPlayer,132,337,469,35,22,UCBPlayer
10563,UCBPlayer,103,148,251,0,83,UCBPlayer
10564,UCBPlayer,136,321,457,35,26,UCBPlayer
10565,UCBPlayer,99,164,263,0,79,UCBPlayer
10566,UCBPlayer,140,305,445,35,30,UCBPlayer
10567,UCBPlayer,95,180,275,0,75,UCBPlayer
10568,UCBPlayer,144,289,433,35,34,UCBPlayer
10569,UCBPlayer,91,196,287,0,71,UCBPlayer
10570,UCBPlayer,148,273,421,35,38,UCBPlayer
10571,UCBPlayer,87,212,299,0,67,UCBPlayer
10572,UCBPlayer,152,257,409,35,42,UCBPlayer
10573,UCBPlayer,84,224,308,0,64,UCBPlayer
10574,UCBPlayer,146,251,397,32,45,UCBPlayer
10575,UCBPlayer,89,234,323,3,60,UCBPlayer
10576,UCBPlayer,138,243,381,28,49,UCBPlayer
10577,UCBPlayer,97,242,339,7,56,UCBPlayer
10578,UCBPlayer,130,235,365,24,53,UCBPlayer
10579,UCBPlayer,105,250,355,11,52,UCBPlayer
10580,UCBPlayer,122,227,349,20,57,UCBPlayer
10581,UCBPlayer,109,259,368,15,49,UCBPlayer
10582,UCBPlayer,118,218,336,16,60,UCBPlayer
10583,UCBPlayer,117,267,384,19,45,UCBPlayer
10584,UCBPlayer,110,210,320,12,64,UCBPlayer
10585,UCBPlayer,126,271,397,23,42,UCBPlayer
10586,UCBPlayer,105,210,315,10,65,UCBPlayer
10587,UCBPlayer,130,275,405,25,40,UCBPlayer
10588,UCBPlayer,105,210,315,10,65,UCBPlayer
10589,UCBPlayer,130,275,405,25,40,UCBPlayer
10590,UCBPlayer,106,206,312,10,66,UCBPlayer
10591,UCBPlayer,130,275,405,25,40,UCBPlayer
10592,UCBPlayer,105,210,315,10,65,UCBPlayer
10593,UCBPlayer,131,271,402,25,41,UCBPlayer
10594,UCBPlayer,105,210,315,10,65,UCBPlayer
10595,UCBPlayer,130,275,405,25,40,UCBPlayer
10596,UCBPlayer,105,210,315,10,65,UCBPlayer
10597,UCBPlayer,130,275,405,25,40,UCBPlayer
10598,UCBPlayer,103,203,306,10,68,UCBPlayer
10599,UCBPlayer,128,283,411,25,38,UCBPlayer
10600,UCBPlayer,111,186,297,10,71,UCBPlayer
10601,UCBPlayer,124,299,423,25,34,UCBPlayer
10602,UCBPlayer,115,170,285,10,75,UCBPlayer
10603,UCBPlayer,120,315,435,25,30,UCBPlayer
10604,UCBPlayer,119,154,273,10,79,UCBPlayer
10605,UCBPlayer,112,332,444,25,27,UCBPlayer
10606,UCBPlayer,127,137,264,10,82,UCBPlayer
10607,UCBPlayer,104,349,453,25,24,UCBPlayer
10608,UCBPlayer,126,126,252,7,85,Tie
10609,UCBPlayer,111,351,462,28,22,UCBPlayer
10610,UCBPlayer,116,126,242,3,87,UCBPlayer
10611,UCBPlayer,122,347,469,32,21,UCBPlayer
10612,UCBPlayer,107,132,239,0,87,UCBPlayer
10613,UCBPlayer,132,337,469,35,22,UCBPlayer
10614,UCBPlayer,103,148,251,0,83,UCBPlayer
10615,UCBPlayer,136,321,457,35,26,UCBPlayer
10616,UCBPlayer,99,164,263,0,79,UCBPlayer
10617,UCBPlayer,140,305,445,35,30,UCBPlayer
10618,UCBPlayer,95,180,275,0,75,UCBPlayer
10619,UCBPlayer,144,289,433,35,34,UCBPlayer
10620,UCBPlayer,91,196,287,0,71,UCBPlayer
10621,UCBPlayer,148,273,421,35,38,UCBPlayer
10622,UCBPlayer,87,212,299,0,67,UCBPlayer
10623,UCBPlayer,152,257,409,35,42,UCBPlayer
10624,UCBPlayer,84,224,308,0,64,UCBPlayer
10625,UCBPlayer,146,251,397,32,45,UCBPlayer
10626,UCBPlayer,89,234,323,3,60,UCBPlayer
10627,UCBPlayer,138,243,381,28,49,UCBPlayer
10628,UCBPlayer,97,242,339,7,56,UCBPlayer
10629,UCBPlayer,130,235,365,24,53,UCBPlayer
10630,UCBPlayer,105,250,355,11,52,UCBPlayer
10631,UCBPlayer,122,227,349,20,57,UCBPlayer
10632,UCBPlayer,109,259,368,15,49,UCBPlayer
10633,UCBPlayer,118,218,336,16,60,UCBPlayer
10634,UCBPlayer,117,267,384,19,45,UCBPlayer
10635,UCBPlayer,110,210,320,12,64,UCBPlayer
10636,UCBPlayer,126,271,397,23,42,UCBPlayer
10637,UCBPlayer,105,210,315,10,65,UCBPlayer
10638,UCBPlayer,130,275,405,25,40,UCBPlayer
10639,UCBPlayer,105,210,315,10,65,UCBPlayer
10640,UCBPlayer,130,275,405,25,40,UCBPlayer
10641,UCBPlayer,106,206,312,10,66,UCBPlayer
10642,UCBPlayer,130,275,405,25,40,UCBPlayer
10643,UCBPlayer,105,210,315,10,65,UCBPlayer
10644,UCBPlayer,131,271,402,25,41,UCBPlayer
10645,UCBPlayer,105,210,315,10,65,UCBPlayer
10646,UCBPlayer,130,275,405,25,40,UCBPlayer
10647,UCBPlayer,105,210,315,10,65,UCBPlayer
10648,UCBPlayer,130,275,405,25,40,UCBPlayer
10649,UCBPlayer,103,203,306,10,68,UCBPlayer
10650,UCBPlayer,128,283,411,25,38,UCBPlayer
10651,UCBPlayer,111,186,297,10,71,UCBPlayer
10652,UCBPlayer,124,299,423,25,34,UCBPlayer
10653,UCBPlayer,115,170,285,10,75,UCBPlayer
10654,UCBPlayer,120,315,435,25,30,UCBPlayer
10655,UCBPlayer,119,154,273,10,79,UCBPlayer
10656,UCBPlayer,112,332,444,25,27,UCBPlayer
10657,UCBPlayer,127,137,264,10,82,UCBPlayer
10658,UCBPlayer,104,349,453,25,24,UCBPlayer
10659,UCBPlayer,126,126,252,7,85,Tie
10660,UCBPlayer,111,351,462,28,22,UCBPlayer
10661,UCBPlayer,116,126,242,3,87,UCBPlayer
10662,UCBPlayer,122,347,469,32,21,UCBPlayer
10663,UCBPlayer,107,132,239,0,87,UCBPlayer
10664,UCBPlayer,132,337,469,35,22,UCBPlayer
10665,UCBPlayer,103,148,251,0,83,UCBPlayer
10666,UCBPlayer,136,321,457,35,26,UCBPlayer
10667,UCBPlayer,99,164,263,0,79,UCBPlayer
10668,UCBPlayer,140,305,445,35,30,UCBPlayer
10669,UCBPlayer,95,180,275,0,75,UCBPlayer
10670,UCBPlayer,144,289,433,35,34,UCBPlayer
10671,UCBPlayer,91,196,287,0,71,UCBPlayer
10672,UCBPlayer,148,273,421,35,38,UCBPlayer
10673,UCBPlayer,87,212,299,0,67,UCBPlayer
10674,UCBPlayer,152,257,409,35,42,UCBPlayer
10675,UCBPlayer,84,224,308,0,64,UCBPlayer
10676,UCBPlayer,146,251,397,32,45,UCBPlayer
10677,UCBPlayer,89,234,323,3,60,UCBPlayer
10678,UCBPlayer,138,243,381,28,49,UCBPlayer
10679,UCBPlayer,97,242,339,7,56,UCBPlayer
10680,UCBPlayer,130,235,365,24,53,UCBPlayer
10681,UCBPlayer,105,250,355,11,52,UCBPlayer
10682,UCBPlayer,122,227,349,20,57,UCBPlayer
10683,UCBPlayer,109,259,368,15,49,UCBPlayer
10684,UCBPlayer,118,218,336,16,60,UCBPlayer
10685,UCBPlayer,117,267,384,19,45,UCBPlayer
10686,UCBPlayer,110,210,320,12,64,UCBPlayer
10687,UCBPlayer,126,271,397,23,42,UCBPlayer
10688,UCBPlayer,105,210,315,10,65,UCBPlayer
10689,UCBPlayer,130,275,405,25,40,UCBPlayer
10690,UCBPlayer,105,210,315,10,65,UCBPlayer
10691,UCBPlayer,130,275,405,25,40,UCBPlayer
10692,UCBPlayer,106,206,312,10,66,UCBPlayer
10693,UCBPlayer,130,275,405,25,40,UCBPlayer
10694,UCBPlayer,105,210,315,10,65,UCBPlayer
10695,UCBPlayer,131,271,402,25,41,UCBPlayer
10696,UCBPlayer,105,210,315,10,65,UCBPlayer
10697,UCBPlayer,130,275,405,25,40,UCBPlayer
10698,UCBPlayer,105,210,315,10,65,UCBPlayer
10699,UCBPlayer,130,275,405,25,40,UCBPlayer
10700,UCBPlayer,103,203,306,10,68,UCBPlayer
10701,UCBPlayer,128,283,411,25,38,UCBPlayer
10702,UCBPlayer,111,186,297,10,71,UCBPlayer
10703,UCBPlayer,124,299,423,25,34,UCBPlayer
10704,UCBPlayer,115,170,285,10,75,UCBPlayer
10705,UCBPlayer,120,315,435,25,30,UCBPlayer
10706,UCBPlayer,119,154,273,10,79,UCBPlayer
10707,UCBPlayer,112,332,444,25,27,UCBPlayer
10708,UCBPlayer,127,137,264,10,82,UCBPlayer
10709,UCBPlayer,104,349,453,25,24,UCBPlayer
10710,UCBPlayer,126,126,252,7,85,Tie
10711,UCBPlayer,111,351,462,28,22,UCBPlayer
10712,UCBPlayer,116,126,242,3,87,UCBPlayer
10713,UCBPlayer,122,347,469,32,21,UCBPlayer
10714,UCBPlayer,107,132,239,0,87,UCBPlayer
10715,UCBPlayer,132,337,469,35,22,UCBPlayer
10716,UCBPlayer,103,148,251,0,83,UCBPlayer
10717,UCBPlayer,136,321,457,35,26,UCBPlayer
10718,UCBPlayer,99,164,263,0,79,UCBPlayer
10719,UCBPlayer,140,305,445,35,30,UCBPlayer
10720,UCBPlayer,95,180,275,0,75,UCBPlayer
10721,UCBPlayer,144,289,433,35,34,UCBPlayer
10722,UCBPlayer,91,196,287,0,71,UCBPlayer
10723,UCBPlayer,148,273,421,35,38,UCBPlayer
10724,UCBPlayer,87,212,299,0,67,UCBPlayer
10725,UCBPlayer,152,257,409,35,42,UCBPlayer
10726,UCBPlayer,84,224,308,0,64,UCBPlayer
10727,UCBPlayer,146,251,397,32,45,UCBPlayer
10728,UCBPlayer,89,234,323,3,60,UCBPlayer
10729,UCBPlayer,138,243,381,28,49,UCBPlayer
10730,UCBPlayer,97,242,339,7,56,UCBPlayer
10731,UCBPlayer,130,235,365,24,53,UCBPlayer
10732,UCBPlayer,105,250,355,11,52,UCBPlayer
10733,UCBPlayer,122,227,349,20,57,UCBPlayer
10734,UCBPlayer,109,259,368,15,49,UCBPlayer
10735,UCBPlayer,118,218,336,16,60,UCBPlayer
10736,UCBPlayer,117,267,384,19,45,UCBPlayer
10737,UCBPlayer,110,210,320,12,64,UCBPlayer
10738,UCBPlayer,126,271,397,23,42,UCBPlayer
10739,UCBPlayer,105,210,315,10,65,UCBPlayer
10740,UCBPlayer,130,275,405,25,40,UCBPlayer
10741,UCBPlayer,105,210,315,10,65,UCBPlayer
10742,UCBPlayer,130,275,405,25,40,UCBPlayer
10743,UCBPlayer,106,206,312,10,66,UCBPlayer
10744,UCBPlayer,130,275,405,25,40,UCBPlayer
10745,UCBPlayer,105,210,315,10,65,UCBPlayer
10746,UCBPlayer,131,271,402,25,41,UCBPlayer
10747,UCBPlayer,105,210,315,10,65,UCBPlayer
10748,UCBPlayer,130,275,405,25,40,UCBPlayer
10749,UCBPlayer,105,210,315,10,65,UCBPlayer
10750,UCBPlayer,130,275,405,25,40,UCBPlayer
10751,UCBPlayer,103,203,306,10,68,UCBPlayer
10752,UCBPlayer,128,283,411,25,38,UCBPlayer
10753,UCBPlayer,111,186,297,10,71,UCBPlayer
10754,UCBPlayer,124,299,423,25,34,UCBPlayer
10755,UCBPlayer,115,170,285,10,75,UCBPlayer
10756,UCBPlayer,120,315,435,25,30,UCBPlayer
10757,UCBPlayer,119,154,273,10,79,UCBPlayer
10758,UCBPlayer,112,332,444,25,27,UCBPlayer
10759,UCBPlayer,127,137,264,10,82,UCBPlayer
10760,UCBPlayer,104,349,453,25,24,UCBPlayer
10761,UCBPlayer,126,126,252,7,85,Tie
10762,UCBPlayer,111,351,462,28,22,UCBPlayer
10763,UCBPlayer,116,126,242,3,87,UCBPlayer
10764,UCBPlayer,122,347,469,32,21,UCBPlayer
10765,UCBPlayer,107,132,239,0,87,UCBPlayer
10766,UCBPlayer,132,337,469,35,22,UCBPlayer
10767,UCBPlayer,103,148,251,0,83,UCBPlayer
10768,UCBPlayer,136,321,457,35,26,UCBPlayer
10769,UCBPlayer,99,164,263,0,79,UCBPlayer
10770,UCBPlayer,140,305,445,35,30,UCBPlayer
10771,UCBPlayer,95,180,275,0,75,UCBPlayer
10772,UCBPlayer,144,289,433,35,34,UCBPlayer
10773,UCBPlayer,91,196,287,0,71,UCBPlayer
10774,UCBPlayer,148,273,421,35,38,UCBPlayer
10775,UCBPlayer,87,212,299,0,67,UCBPlayer
10776,UCBPlayer,152,257,409,35,42,UCBPlayer
10777,UCBPlayer,84,224,308,0,64,UCBPlayer
10778,UCBPlayer,146,251,397,32,45,UCBPlayer
10779,UCBPlayer,89,234,323,3,60,UCBPlayer
10780,UCBPlayer,138,243,381,28,49,UCBPlayer
10781,UCBPlayer,97,242,339,7,56,UCBPlayer
10782,UCBPlayer,130,235,365,24,53,UCBPlayer
10783,UCBPlayer,105,250,355,11,52,UCBPlayer
10784,UCBPlayer,122,227,349,20,57,UCBPlayer
10785,UCBPlayer,109,259,368,15,49,UCBPlayer
10786,UCBPlayer,118,218,336,16,60,UCBPlayer
10787,UCBPlayer,117,267,384,19,45,UCBPlayer
10788,UCBPlayer,110,210,320,12,64,UCBPlayer
10789,UCBPlayer,126,271,397,23,42,UCBPlayer
10790,UCBPlayer,105,210,315,10,65,UCBPlayer
10791,UCBPlayer,130,275,405,25,40,UCBPlayer
10792,UCBPlayer,105,210,315,10,65,UCBPlayer
10793,UCBPlayer,130,275,405,25,40,UCBPlayer
10794,UCBPlayer,106,206,312,10,66,UCBPlayer
10795,UCBPlayer,130,275,405,25,40,UCBPlayer
10796,UCBPlayer,105,210,315,10,65,UCBPlayer
10797,UCBPlayer,131,271,402,25,41,UCBPlayer
10798,UCBPlayer,105,210,315,10,65,UCBPlayer
10799,UCBPlayer,130,275,405,25,40,UCBPlayer
10800,UCBPlayer,105,210,315,10,65,UCBPlayer
10801,UCBPlayer,130,275,405,25,40,UCBPlayer
10802,UCBPlayer,103,203,306,10,68,UCBPlayer
10803,UCBPlayer,128,283,411,25,38,UCBPlayer
10804,UCBPlayer,111,186,297,10,71,UCBPlayer
10805,UCBPlayer,124,299,423,25,34,UCBPlayer
10806,UCBPlayer,115,170,285,10,75,UCBPlayer
10807,UCBPlayer,120,315,435,25,30,UCBPlayer
10808,UCBPlayer,119,154,273,10,79,UCBPlayer
10809,UCBPlayer,112,332,444,25,27,UCBPlayer
10810,UCBPlayer,127,137,264,10,82,UCBPlayer
10811,UCBPlayer,104,349,453,25,24,UCBPlayer
10812,UCBPlayer,126,126,252,7,85,Tie
10813,UCBPlayer,111,351,462,28,22,UCBPlayer
10814,UCBPlayer,116,126,242,3,87,UCBPlayer
10815,UCBPlayer,122,347,469,32,21,UCBPlayer
10816,UCBPlayer,107,132,239,0,87,UCBPlayer
10817,UCBPlayer,132,337,469,35,22,UCBPlayer
10818,UCBPlayer,103,148,251,0,83,UCBPlayer
10819,UCBPlayer,136,321,457,35,26,UCBPlayer
10820,UCBPlayer,99,164,263,0,79,UCBPlayer
10821,UCBPlayer,140,305,445,35,30,UCBPlayer
10822,UCBPlayer,95,180,275,0,75,UCBPlayer
10823,UCBPlayer,144,289,433,35,34,UCBPlayer
10824,UCBPlayer,91,196,287,0,71,UCBPlayer
10825,UCBPlayer,148,273,421,35,38,UCBPlayer
10826,UCBPlayer,87,212,299,0,67,UCBPlayer
10827,UCBPlayer,152,257,409,35,42,UCBPlayer
10828,UCBPlayer,84,224,308,0,64,UCBPlayer
10829,UCBPlayer,146,251,397,32,45,UCBPlayer
10830,UCBPlayer,89,234,323,3,60,UCBPlayer
10831,UCBPlayer,138,243,381,28,49,UCBPlayer
10832,UCBPlayer,97,242,339,7,56,UCBPlayer
10833,UCBPlayer,130,235,365,24,53,UCBPlayer
10834,UCBPlayer,105,250,355,11,52,UCBPlayer
10835,UCBPlayer,122,227,349,20,57,UCBPlayer
10836,UCBPlayer,109,259,368,15,49,UCBPlayer
10837,UCBPlayer,118,218,336,16,60,UCBPlayer
10838,UCBPlayer,117,267,384,19,45,UCBPlayer
10839,UCBPlayer,110,210,320,12,64,UCBPlayer
10840,UCBPlayer,126,271,397,23,42,UCBPlayer
10841,UCBPlayer,105,210,315,10,65,UCBPlayer
10842,UCBPlayer,130,275,405,25,40,UCBPlayer
10843,UCBPlayer,105,210,315,10,65,UCBPlayer
10844,UCBPlayer,130,275,405,25,40,UCBPlayer
10845,UCBPlayer,106,206,312,10,66,UCBPlayer
10846,UCBPlayer,130,275,405,25,40,UCBPlayer
10847,UCBPlayer,105,210,315,10,65,UCBPlayer
10848,UCBPlayer,131,271,402,25,41,UCBPlayer
10849,UCBPlayer,105,210,315,10,65,UCBPlayer
10850,UCBPlayer,130,275,405,25,40,UCBPlayer
10851,UCBPlayer,105,210,315,10,65,UCBPlayer
10852,UCBPlayer,130,275,405,25,40,UCBPlayer
10853,UCBPlayer,103,203,306,10,68,UCBPlayer
10854,UCBPlayer,128,283,411,25,38,UCBPlayer
10855,UCBPlayer,111,186,297,10,71,UCBPlayer
10856,UCBPlayer,124,299,423,25,34,UCBPlayer
10857,UCBPlayer,115,170,285,10,75,UCBPlayer
10858,UCBPlayer,120,315,435,25,30,UCBPlayer
10859,UCBPlayer,119,154,273,10,79,UCBPlayer
10860,UCBPlayer,112,332,444,25,27,UCBPlayer
10861,UCBPlayer,127,137,264,10,82,UCBPlayer
10862,UCBPlayer,104,349,453,25,24,UCBPlayer
10863,UCBPlayer,126,126,252,7,85,Tie
10864,UCBPlayer,111,351,462,28,22,UCBPlayer
10865,UCBPlayer,116,126,242,3,87,UCBPlayer
10866,UCBPlayer,122,347,469,32,21,UCBPlayer
10867,UCBPlayer,107,132,239,0,87,UCBPlayer
10868,UCBPlayer,132,337,469,35,22,UCBPlayer
10869,UCBPlayer,103,148,251,0,83,UCBPlayer
10870,UCBPlayer,136,321,457,35,26,UCBPlayer
10871,UCBPlayer,99,164,263,0,79,UCBPlayer
10872,UCBPlayer,140,305,445,35,30,UCBPlayer
10873,UCBPlayer,95,180,275,0,75,UCBPlayer
10874,UCBPlayer,144,289,433,35,34,UCBPlayer
10875,UCBPlayer,91,196,287,0,71,UCBPlayer
10876,UCBPlayer,148,273,421,35,38,UCBPlayer
10877,UCBPlayer,87,212,299,0,67,UCBPlayer
10878,UCBPlayer,152,257,409,35,42,UCBPlayer
10879,UCBPlayer,84,224,308,0,64,UCBPlayer
10880,UCBPlayer,146,251,397,32,45,UCBPlayer
10881,UCBPlayer,89,234,323,3,60,UCBPlayer
10882,UCBPlayer,138,243,381,28,49,UCBPlayer
10883,UCBPlayer,97,242,339,7,56,UCBPlayer
10884,UCBPlayer,130,235,365,24,53,UCBPlayer
10885,UCBPlayer,105,250,355,11,52,UCBPlayer
10886,UCBPlayer,122,227,349,20,57,UCBPlayer
10887,UCBPlayer,109,259,368,15,49,UCBPlayer
10888,UCBPlayer,118,218,336,16,60,UCBPlayer
10889,UCBPlayer,117,267,384,19,45,UCBPlayer
10890,UCBPlayer,110,210,320,12,64,UCBPlayer
10891,UCBPlayer,126,271,397,23,42,UCBPlayer
10892,UCBPlayer,105,210,315,10,65,UCBPlayer
10893,UCBPlayer,130,275,405,25,40,UCBPlayer
10894,UCBPlayer,105,210,315,10,65,UCBPlayer
10895,UCBPlayer,130,275,405,25,40,UCBPlayer
10896,UCBPlayer,106,206,312,10,66,UCBPlayer
10897,UCBPlayer,130,275,405,25,40,UCBPlayer
10898,UCBPlayer,105,210,315,10,65,UCBPlayer
10899,UCBPlayer,131,271,402,25,41,UCBPlayer
10900,UCBPlayer,105,210,315,10,65,UCBPlayer
10901,UCBPlayer,130,275,405,25,40,UCBPlayer
10902,UCBPlayer,105,210,315,10,65,UCBPlayer
10903,UCBPlayer,130,275,405,25,40,UCBPlayer
10904,UCBPlayer,103,203,306,10,68,UCBPlayer
10905,UCBPlayer,128,283,411,25,38,UCBPlayer
10906,UCBPlayer,111,186,297,10,71,UCBPlayer
10907,UCBPlayer,124,299,423,25,34,UCBPlayer
10908,UCBPlayer,115,170,285,10,75,UCBPlayer
10909,UCBPlayer,120,315,435,25,30,UCBPlayer
10910,UCBPlayer,119,154,273,10,79,UCBPlayer
10911,UCBPlayer,112,332,444,25,27,UCBPlayer
10912,UCBPlayer,127,137,264,10,82,UCBPlayer
10913,UCBPlayer,104,349,453,25,24,UCBPlayer
10914,UCBPlayer,126,126,252,7,85,Tie
10915,UCBPlayer,111,351,462,28,22,UCBPlayer
10916,UCBPlayer,116,126,242,3,87,UCBPlayer
10917,UCBPlayer,122,347,469,32,21,UCBPlayer
10918,UCBPlayer,107,132,239,0,87,UCBPlayer
10919,UCBPlayer,132,337,469,35,22,UCBPlayer
10920,UCBPlayer,103,148,251,0,83,UCBPlayer
10921,UCBPlayer,136,321,457,35,26,UCBPlayer
10922,UCBPlayer,99,164,263,0,79,UCBPlayer
10923,UCBPlayer,140,305,445,35,30,UCBPlayer
10924,UCBPlayer,95,180,275,0,75,UCBPlayer
10925,UCBPlayer,144,289,433,35,34,UCBPlayer
10926,UCBPlayer,91,196,287,0,71,UCBPlayer
10927,UCBPlayer,148,273,421,35,38,UCBPlayer
10928,UCBPlayer,87,212,299,0,67,UCBPlayer
10929,UCBPlayer,152,257,409,35,42,UCBPlayer
10930,UCBPlayer,84,224,308,0,64,UCBPlayer
10931,UCBPlayer,146,251,397,32,45,UCBPlayer
10932,UCBPlayer,89,234,323,3,60,UCBPlayer
10933,UCBPlayer,138,243,381,28,49,UCBPlayer
10934,UCBPlayer,97,242,339,7,56,UCBPlayer
10935,UCBPlayer,130,235,365,24,53,UCBPlayer
10936,UCBPlayer,105,250,355,11,52,UCBPlayer
10937,UCBPlayer,122,227,349,20,57,UCBPlayer
10938,UCBPlayer,109,259,368,15,49,UCBPlayer
10939,UCBPlayer,118,218,336,16,60,UCBPlayer
10940,UCBPlayer,117,267,384,19,45,UCBPlayer
10941,UCBPlayer,110,210,320,12,64,UCBPlayer
10942,UCBPlayer,126,271,397,23,42,UCBPlayer
10943,UCBPlayer,105,210,315,10,65,UCBPlayer
10944,UCBPlayer,130,275,405,25,40,UCBPlayer
10945,UCBPlayer,105,210,315,10,65,UCBPlayer
10946,UCBPlayer,130,275,405,25,40,UCBPlayer
10947,UCBPlayer,106,206,312,10,66,UCBPlayer
10948,UCBPlayer,130,275,405,25,40,UCBPlayer
10949,UCBPlayer,105,210,315,10,65,UCBPlayer
10950,UCBPlayer,131,271,402,25,41,UCBPlayer
10951,UCBPlayer,105,210,315,10,65,UCBPlayer
10952,UCBPlayer,130,275,405,25,40,UCBPlayer
10953,UCBPlayer,105,210,315,10,65,UCBPlayer
10954,UCBPlayer,130,275,405,25,40,UCBPlayer
10955,UCBPlayer,103,203,306,10,68,UCBPlayer
10956,UCBPlayer,128,283,411,25,38,UCBPlayer
10957,UCBPlayer,111,186,297,10,71,UCBPlayer
10958,UCBPlayer,124,299,423,25,34,UCBPlayer
10959,UCBPlayer,115,170,285,10,75,UCBPlayer
10960,UCBPlayer,120,315,435,25,30,UCBPlayer
10961,UCBPlayer,119,154,273,10,79,UCBPlayer
10962,UCBPlayer,112,332,444,25,27,UCBPlayer
10963,UCBPlayer,127,137,264,10,82,UCBPlayer
10964,UCBPlayer,104,349,453,25,24,UCBPlayer
10965,UCBPlayer,126,126,252,7,85,Tie
10966,UCBPlayer,111,351,462,28,22,UCBPlayer
10967,UCBPlayer,116,126,242,3,87,UCBPlayer
10968,UCBPlayer,122,347,469,32,21,UCBPlayer
10969,UCBPlayer,107,132,239,0,87,UCBPlayer
10970,UCBPlayer,132,337,469,35,22,UCBPlayer
10971,UCBPlayer,103,148,251,0,83,UCBPlayer
10972,UCBPlayer,136,321,457,35,26,UCBPlayer
10973,UCBPlayer,99,164,263,0,79,UCBPlayer
10974,UCBPlayer,140,305,445,35,30,UCBPlayer
10975,UCBPlayer,95,180,275,0,75,UCBPlayer
10976,UCBPlayer,144,289,433,35,34,UCBPlayer
10977,UCBPlayer,91,196,287,0,71,UCBPlayer
10978,UCBPlayer,148,273,421,35,38,UCBPlayer
10979,UCBPlayer,87,212,299,0,67,UCBPlayer
10980,UCBPlayer,152,257,409,35,42,UCBPlayer
10981,UCBPlayer,84,224,308,0,64,UCBPlayer
10982,UCBPlayer,146,251,397,32,45,UCBPlayer
10983,UCBPlayer,89,234,323,3,60,UCBPlayer
10984,UCBPlayer,138,243,381,28,49,UCBPlayer
10985,UCBPlayer,97,242,339,7,56,UCBPlayer
10986,UCBPlayer,130,235,365,24,53,UCBPlayer
10987,UCBPlayer,105,250,355,11,52,UCBPlayer
10988,UCBPlayer,122,227,349,20,57,UCBPlayer
10989,UCBPlayer,109,259,368,15,49,UCBPlayer
10990,UCBPlayer,118,218,336,16,60,UCBPlayer
10991,UCBPlayer,117,267,384,19,45,UCBPlayer
10992,UCBPlayer,110,210,320,12,64,UCBPlayer
10993,UCBPlayer,126,271,397,23,42,UCBPlayer
10994,UCBPlayer,105,210,315,10,65,UCBPlayer
10995,UCBPlayer,130,275,405,25,40,UCBPlayer
10996,UCBPlayer,105,210,315,10,65,UCBPlayer
10997,UCBPlayer,130,275,405,25,40,UCBPlayer
10998,UCBPlayer,106,206,312,10,66,UCBPlayer
10999,UCBPlayer,130,275,405,25,40,UCBPlayer
11000,UCBPlayer,105,210,315,10,65,UCBPlayer
11001,UCBPlayer,131,271,402,25,41,UCBPlayer
11002,UCBPlayer,105,210,315,10,65,UCBPlayer
11003,UCBPlayer,130,275,405,25,40,UCBPlayer
11004,UCBPlayer,105,210,315,10,65,UCBPlayer
11005,UCBPlayer,130,275,405,25,40,UCBPlayer
11006,UCBPlayer,103,203,306,10,68,UCBPlayer
11007,UCBPlayer,128,283,411,25,38,UCBPlayer
11008,UCBPlayer,111,186,297,10,71,UCBPlayer
11009,UCBPlayer,124,299,423,25,34,UCBPlayer
11010,UCBPlayer,115,170,285,10,75,UCBPlayer
11011,UCBPlayer,120,315,435,25,30,UCBPlayer
11012,UCBPlayer,119,154,273,10,79,UCBPlayer
11013,UCBPlayer,112,332,444,25,27,UCBPlayer
11014,UCBPlayer,127,137,264,10,82,UCBPlayer
11015,UCBPlayer,104,349,453,25,24,UCBPlayer
11016,UCBPlayer,126,126,252,7,85,Tie
11017,UCBPlayer,111,351,462,28,22,UCBPlayer
11018,UCBPlayer,116,126,242,3,87,UCBPlayer
11019,UCBPlayer,122,347,469,32,21,UCBPlayer
11020,UCBPlayer,107,132,239,0,87,UCBPlayer
11021,UCBPlayer,132,337,469,35,22,UCBPlayer
11022,UCBPlayer,103,148,251,0,83,UCBPlayer
11023,UCBPlayer,136,321,457,35,26,UCBPlayer
11024,UCBPlayer,99,164,263,0,79,UCBPlayer
11025,UCBPlayer,140,305,445,35,30,UCBPlayer
11026,UCBPlayer,95,180,275,0,75,UCBPlayer
11027,UCBPlayer,144,289,433,35,34,UCBPlayer
11028,UCBPlayer,91,196,287,0,71,UCBPlayer
11029,UCBPlayer,148,273,421,35,38,UCBPlayer
11030,UCBPlayer,87,212,299,0,67,UCBPlayer
11031,UCBPlayer,152,257,409,35,42,UCBPlayer
11032,UCBPlayer,84,224,308,0,64,UCBPlayer
11033,UCBPlayer,146,251,397,32,45,UCBPlayer
11034,UCBPlayer,89,234,323,3,60,UCBPlayer
11035,UCBPlayer,138,243,381,28,49,UCBPlayer
11036,UCBPlayer,97,242,339,7,56,UCBPlayer
11037,UCBPlayer,130,235,365,24,53,UCBPlayer
11038,UCBPlayer,105,250,355,11,52,UCBPlayer
11039,UCBPlayer,122,227,349,20,57,UCBPlayer
11040,UCBPlayer,109,259,368,15,49,UCBPlayer
11041,UCBPlayer,118,218,336,16,60,UCBPlayer
11042,UCBPlayer,117,267,384,19,45,UCBPlayer
11043,UCBPlayer,110,210,320,12,64,UCBPlayer
11044,UCBPlayer,126,271,397,23,42,UCBPlayer
11045,UCBPlayer,105,210,315,10,65,UCBPlayer
11046,UCBPlayer,130,275,405,25,40,UCBPlayer
11047,UCBPlayer,105,210,315,10,65,UCBPlayer
11048,UCBPlayer,130,275,405,25,40,UCBPlayer
11049,UCBPlayer,106,206,312,10,66,UCBPlayer
11050,UCBPlayer,130,275,405,25,40,UCBPlayer
11051,UCBPlayer,105,210,315,10,65,UCBPlayer
11052,UCBPlayer,131,271,402,25,41,UCBPlayer
11053,UCBPlayer,105,210,315,10,65,UCBPlayer
11054,UCBPlayer,130,275,405,25,40,UCBPlayer
11055,UCBPlayer,105,210,315,10,65,UCBPlayer
11056,UCBPlayer,130,275,405,25,40,UCBPlayer
11057,UCBPlayer,103,203,306,10,68,UCBPlayer
11058,UCBPlayer,128,283,411,25,38,UCBPlayer
11059,UCBPlayer,111,186,297,10,71,UCBPlayer
11060,UCBPlayer,124,299,423,25,34,UCBPlayer
11061,UCBPlayer,115,170,285,10,75,UCBPlayer
11062,UCBPlayer,120,315,435,25,30,UCBPlayer
11063,UCBPlayer,119,154,273,10,79,UCBPlayer
11064,UCBPlayer,112,332,444,25,27,UCBPlayer
11065,UCBPlayer,127,137,264,10,82,UCBPlayer
11066,UCBPlayer,104,349,453,25,24,UCBPlayer
11067,UCBPlayer,126,126,252,7,85,Tie
11068,UCBPlayer,111,351,462,28,22,UCBPlayer
11069,UCBPlayer,116,126,242,3,87,UCBPlayer
11070,UCBPlayer,122,347,469,32,21,UCBPlayer
11071,UCBPlayer,107,132,239,0,87,UCBPlayer
11072,UCBPlayer,132,337,469,35,22,UCBPlayer
11073,UCBPlayer,103,148,251,0,83,UCBPlayer
11074,UCBPlayer,136,321,457,35,26,UCBPlayer
11075,UCBPlayer,99,164,263,0,79,UCBPlayer
11076,UCBPlayer,140,305,445,35,30,UCBPlayer
11077,UCBPlayer,95,180,275,0,75,UCBPlayer
11078,UCBPlayer,144,289,433,35,34,UCBPlayer
11079,UCBPlayer,91,196,287,0,71,UCBPlayer
11080,UCBPlayer,148,273,421,35,38,UCBPlayer
11081,UCBPlayer,87,212,299,0,67,UCBPlayer
11082,UCBPlayer,152,257,409,35,42,UCBPlayer
11083,UCBPlayer,84,224,308,0,64,UCBPlayer
11084,UCBPlayer,146,251,397,32,45,UCBPlayer
11085,UCBPlayer,89,234,323,3,60,UCBPlayer
11086,UCBPlayer,138,243,381,28,49,UCBPlayer
11087,UCBPlayer,97,242,339,7,56,UCBPlayer
11088,UCBPlayer,130,235,365,24,53,UCBPlayer
11089,UCBPlayer,105,250,355,11,52,UCBPlayer
11090,UCBPlayer,122,227,349,20,57,UCBPlayer
11091,UCBPlayer,109,259,368,15,49,UCBPlayer
11092,UCBPlayer,118,218,336,16,60,UCBPlayer
11093,UCBPlayer,117,267,384,19,45,UCBPlayer
11094,UCBPlayer,110,210,320,12,64,UCBPlayer
11095,UCBPlayer,126,271,397,23,42,UCBPlayer
11096,UCBPlayer,105,210,315,10,65,UCBPlayer
11097,UCBPlayer,130,275,405,25,40,UCBPlayer
11098,UCBPlayer,105,210,315,10,65,UCBPlayer
11099,UCBPlayer,130,275,405,25,40,UCBPlayer
11100,UCBPlayer,106,206,312,10,66,UCBPlayer
11101,UCBPlayer,130,275,405,25,40,UCBPlayer
11102,UCBPlayer,105,210,315,10,65,UCBPlayer
11103,UCBPlayer,131,271,402,25,41,UCBPlayer
11104,UCBPlayer,105,210,315,10,65,UCBPlayer
11105,UCBPlayer,130,275,405,25,40,UCBPlayer
11106,UCBPlayer,105,210,315,10,65,UCBPlayer
11107,UCBPlayer,130,275,405,25,40,UCBPlayer
11108,UCBPlayer,103,203,306,10,68,UCBPlayer
11109,UCBPlayer,128,283,411,25,38,UCBPlayer
11110,UCBPlayer,111,186,297,10,71,UCBPlayer
11111,UCBPlayer,124,299,423,25,34,UCBPlayer
11112,UCBPlayer,115,170,285,10,75,UCBPlayer
11113,UCBPlayer,120,315,435,25,30,UCBPlayer
11114,UCBPlayer,119,154,273,10,79,UCBPlayer
11115,UCBPlayer,112,332,444,25,27,UCBPlayer
11116,UCBPlayer,127,137,264,10,82,UCBPlayer
11117,UCBPlayer,104,349,453,25,24,UCBPlayer
11118,UCBPlayer,126,126,252,7,85,Tie
11119,UCBPlayer,111,351,462,28,22,UCBPlayer
11120,UCBPlayer,116,126,242,3,87,UCBPlayer
11121,UCBPlayer,122,347,469,32,21,UCBPlayer
11122,UCBPlayer,107,132,239,0,87,UCBPlayer
11123,UCBPlayer,132,337,469,35,22,UCBPlayer
11124,UCBPlayer,103,148,251,0,83,UCBPlayer
11125,UCBPlayer,136,321,457,35,26,UCBPlayer
11126,UCBPlayer,99,164,263,0,79,UCBPlayer
11127,UCBPlayer,140,305,445,35,30,UCBPlayer
11128,UCBPlayer,95,180,275,0,75,UCBPlayer
11129,UCBPlayer,144,289,433,35,34,UCBPlayer
11130,UCBPlayer,91,196,287,0,71,UCBPlayer
11131,UCBPlayer,148,273,421,35,38,UCBPlayer
11132,UCBPlayer,87,212,299,0,67,UCBPlayer
11133,UCBPlayer,152,257,409,35,42,UCBPlayer
11134,UCBPlayer,84,224,308,0,64,UCBPlayer
11135,UCBPlayer,146,251,397,32,45,UCBPlayer
11136,UCBPlayer,89,234,323,3,60,UCBPlayer
11137,UCBPlayer,138,243,381,28,49,UCBPlayer
11138,UCBPlayer,97,242,339,7,56,UCBPlayer
11139,UCBPlayer,130,235,365,24,53,UCBPlayer
11140,UCBPlayer,105,250,355,11,52,UCBPlayer
11141,UCBPlayer,122,227,349,20,57,UCBPlayer
11142,UCBPlayer,109,259,368,15,49,UCBPlayer
11143,UCBPlayer,118,218,336,16,60,UCBPlayer
11144,UCBPlayer,117,267,384,19,45,UCBPlayer
11145,UCBPlayer,110,210,320,12,64,UCBPlayer
11146,UCBPlayer,126,271,397,23,42,UCBPlayer
11147,UCBPlayer,105,210,315,10,65,UCBPlayer
11148,UCBPlayer,130,275,405,25,40,UCBPlayer
11149,UCBPlayer,105,210,315,10,65,UCBPlayer
11150,UCBPlayer,130,275,405,25,40,UCBPlayer
11151,UCBPlayer,106,206,312,10,66,UCBPlayer
11152,UCBPlayer,130,275,405,25,40,UCBPlayer
11153,UCBPlayer,105,210,315,10,65,UCBPlayer
11154,UCBPlayer,131,271,402,25,41,UCBPlayer
11155,UCBPlayer,105,210,315,10,65,UCBPlayer
11156,UCBPlayer,130,275,405,25,40,UCBPlayer
11157,UCBPlayer,105,210,315,10,65,UCBPlayer
11158,UCBPlayer,130,275,405,25,40,UCBPlayer
11159,UCBPlayer,103,203,306,10,68,UCBPlayer
11160,UCBPlayer,128,283,411,25,38,UCBPlayer
11161,UCBPlayer,111,186,297,10,71,UCBPlayer
11162,UCBPlayer,124,299,423,25,34,UCBPlayer
11163,UCBPlayer,115,170,285,10,75,UCBPlayer
11164,UCBPlayer,120,315,435,25,30,UCBPlayer
11165,UCBPlayer,119,154,273,10,79,UCBPlayer
11166,UCBPlayer,112,332,444,25,27,UCBPlayer
11167,UCBPlayer,127,137,264,10,82,UCBPlayer
11168,UCBPlayer,104,349,453,25,24,UCBPlayer
11169,UCBPlayer,126,126,252,7,85,Tie
11170,UCBPlayer,111,351,462,28,22,UCBPlayer
11171,UCBPlayer,116,126,242,3,87,UCBPlayer
11172,UCBPlayer,122,347,469,32,21,UCBPlayer
11173,UCBPlayer,107,132,239,0,87,UCBPlayer
11174,UCBPlayer,132,337,469,35,22,UCBPlayer
11175,UCBPlayer,103,148,251,0,83,UCBPlayer
11176,UCBPlayer,136,321,457,35,26,UCBPlayer
11177,UCBPlayer,99,164,263,0,79,UCBPlayer
11178,UCBPlayer,140,305,445,35,30,UCBPlayer
11179,UCBPlayer,95,180,275,0,75,UCBPlayer
11180,UCBPlayer,144,289,433,35,34,UCBPlayer
11181,UCBPlayer,91,196,287,0,71,UCBPlayer
11182,UCBPlayer,148,273,421,35,38,UCBPlayer
11183,UCBPlayer,87,212,299,0,67,UCBPlayer
11184,UCBPlayer,152,257,409,35,42,UCBPlayer
11185,UCBPlayer,84,224,308,0,64,UCBPlayer
11186,UCBPlayer,146,251,397,32,45,UCBPlayer
11187,UCBPlayer,89,234,323,3,60,UCBPlayer
11188,UCBPlayer,138,243,381,28,49,UCBPlayer
11189,UCBPlayer,97,242,339,7,56,UCBPlayer
11190,UCBPlayer,130,235,365,24,53,UCBPlayer
11191,UCBPlayer,105,250,355,11,52,UCBPlayer
11192,UCBPlayer,122,227,349,20,57,UCBPlayer
11193,UCBPlayer,109,259,368,15,49,UCBPlayer
11194,UCBPlayer,118,218,336,16,60,UCBPlayer
11195,UCBPlayer,117,267,384,19,45,UCBPlayer
11196,UCBPlayer,110,210,320,12,64,UCBPlayer
11197,UCBPlayer,126,271,397,23,42,UCBPlayer
11198,UCBPlayer,105,210,315,10,65,UCBPlayer
11199,UCBPlayer,130,275,405,25,40,UCBPlayer
11200,UCBPlayer,105,210,315,10,65,UCBPlayer
11201,UCBPlayer,130,275,405,25,40,UCBPlayer
11202,UCBPlayer,106,206,312,10,66,UCBPlayer
11203,UCBPlayer,130,275,405,25,40,UCBPlayer
11204,UCBPlayer,105,210,315,10,65,UCBPlayer
11205,UCBPlayer,131,271,402,25,41,UCBPlayer
11206,UCBPlayer,105,210,315,10,65,UCBPlayer
11207,UCBPlayer,130,275,405,25,40,UCBPlayer
11208,UCBPlayer,105,210,315,10,65,UCBPlayer
11209,UCBPlayer,130,275,405,25,40,UCBPlayer
11210,UCBPlayer,103,203,306,10,68,UCBPlayer
11211,UCBPlayer,128,283,411,25,38,UCBPlayer
11212,UCBPlayer,111,186,297,10,71,UCBPlayer
11213,UCBPlayer,124,299,423,25,34,UCBPlayer
11214,UCBPlayer,115,170,285,10,75,UCBPlayer
11215,UCBPlayer,120,315,435,25,30,UCBPlayer
11216,UCBPlayer,119,154,273,10,79,UCBPlayer
11217,UCBPlayer,112,332,444,25,27,UCBPlayer
11218,UCBPlayer,127,137,264,10,82,UCBPlayer
11219,UCBPlayer,104,349,453,25,24,UCBPlayer
11220,UCBPlayer,126,126,252,7,85,Tie
11221,UCBPlayer,111,351,462,28,22,UCBPlayer
11222,UCBPlayer,116,126,242,3,87,UCBPlayer
11223,UCBPlayer,122,347,469,32,21,UCBPlayer
11224,UCBPlayer,107,132,239,0,87,UCBPlayer
11225,UCBPlayer,132,337,469,35,22,UCBPlayer
11226,UCBPlayer,103,148,251,0,83,UCBPlayer
11227,UCBPlayer,136,321,457,35,26,UCBPlayer
11228,UCBPlayer,99,164,263,0,79,UCBPlayer
11229,UCBPlayer,140,305,445,35,30,UCBPlayer
11230,UCBPlayer,95,180,275,0,75,UCBPlayer
11231,UCBPlayer,144,289,433,35,34,UCBPlayer
11232,UCBPlayer,91,196,287,0,71,UCBPlayer
11233,UCBPlayer,148,273,421,35,38,UCBPlayer
11234,UCBPlayer,87,212,299,0,67,UCBPlayer
11235,UCBPlayer,152,257,409,35,42,UCBPlayer
11236,UCBPlayer,84,224,308,0,64,UCBPlayer
11237,UCBPlayer,146,251,397,32,45,UCBPlayer
11238,UCBPlayer,89,234,323,3,60,UCBPlayer
11239,UCBPlayer,138,243,381,28,49,UCBPlayer
11240,UCBPlayer,97,242,339,7,56,UCBPlayer
11241,UCBPlayer,130,235,365,24,53,UCBPlayer
11242,UCBPlayer,105,250,355,11,52,UCBPlayer
11243,UCBPlayer,122,227,349,20,57,UCBPlayer
11244,UCBPlayer,109,259,368,15,49,UCBPlayer
11245,UCBPlayer,118,218,336,16,60,UCBPlayer
11246,UCBPlayer,117,267,384,19,45,UCBPlayer
11247,UCBPlayer,110,210,320,12,64,UCBPlayer
11248,UCBPlayer,126,271,397,23,42,UCBPlayer
11249,UCBPlayer,105,210,315,10,65,UCBPlayer
11250,UCBPlayer,130,275,405,25,40,UCBPlayer
11251,UCBPlayer,105,210,315,10,65,UCBPlayer
11252,UCBPlayer,130,275,405,25,40,UCBPlayer
11253,UCBPlayer,106,206,312,10,66,UCBPlayer
11254,UCBPlayer,130,275,405,25,40,UCBPlayer
11255,UCBPlayer,105,210,315,10,65,UCBPlayer
11256,UCBPlayer,131,271,402,25,41,UCBPlayer
11257,UCBPlayer,105,210,315,10,65,UCBPlayer
11258,UCBPlayer,130,275,405,25,40,UCBPlayer
11259,UCBPlayer,105,210,315,10,65,UCBPlayer
11260,UCBPlayer,130,275,405,25,40,UCBPlayer
11261,UCBPlayer,103,203,306,10,68,UCBPlayer
11262,UCBPlayer,128,283,411,25,38,UCBPlayer
11263,UCBPlayer,111,186,297,10,71,UCBPlayer
11264,UCBPlayer,124,299,423,25,34,UCBPlayer
11265,UCBPlayer,115,170,285,10,75,UCBPlayer
11266,UCBPlayer,120,315,435,25,30,UCBPlayer
11267,UCBPlayer,119,154,273,10,79,UCBPlayer
11268,UCBPlayer,112,332,444,25,27,UCBPlayer
11269,UCBPlayer,127,137,264,10,82,UCBPlayer
11270,UCBPlayer,104,349,453,25,24,UCBPlayer
11271,UCBPlayer,126,126,252,7,85,Tie
11272,UCBPlayer,111,351,462,28,22,UCBPlayer
11273,UCBPlayer,116,126,242,3,87,UCBPlayer
11274,UCBPlayer,122,347,469,32,21,UCBPlayer
11275,UCBPlayer,107,132,239,0,87,UCBPlayer
11276,UCBPlayer,132,337,469,35,22,UCBPlayer
11277,UCBPlayer,103,148,251,0,83,UCBPlayer
11278,UCBPlayer,136,321,457,35,26,UCBPlayer
11279,UCBPlayer,99,164,263,0,79,UCBPlayer
11280,UCBPlayer,140,305,445,35,30,UCBPlayer
11281,UCBPlayer,95,180,275,0,75,UCBPlayer
11282,UCBPlayer,144,289,433,35,34,UCBPlayer
11283,UCBPlayer,91,196,287,0,71,UCBPlayer
11284,UCBPlayer,148,273,421,35,38,UCBPlayer
11285,UCBPlayer,87,212,299,0,67,UCBPlayer
11286,UCBPlayer,152,257,409,35,42,UCBPlayer
11287,UCBPlayer,84,224,308,0,64,UCBPlayer
11288,UCBPlayer,146,251,397,32,45,UCBPlayer
11289,UCBPlayer,89,234,323,3,60,UCBPlayer
11290,UCBPlayer,138,243,381,28,49,UCBPlayer
11291,UCBPlayer,97,242,339,7,56,UCBPlayer
11292,UCBPlayer,130,235,365,24,53,UCBPlayer
11293,UCBPlayer,105,250,355,11,52,UCBPlayer
11294,UCBPlayer,122,227,349,20,57,UCBPlayer
11295,UCBPlayer,109,259,368,15,49,UCBPlayer
11296,UCBPlayer,118,218,336,16,60,UCBPlayer
11297,UCBPlayer,117,267,384,19,45,UCBPlayer
11298,UCBPlayer,110,210,320,12,64,UCBPlayer
11299,UCBPlayer,126,271,397,23,42,UCBPlayer
11300,UCBPlayer,105,210,315,10,65,UCBPlayer
11301,UCBPlayer,130,275,405,25,40,UCBPlayer
11302,UCBPlayer,105,210,315,10,65,UCBPlayer
11303,UCBPlayer,130,275,405,25,40,UCBPlayer
11304,UCBPlayer,106,206,312,10,66,UCBPlayer
11305,UCBPlayer,130,275,405,25,40,UCBPlayer
11306,UCBPlayer,105,210,315,10,65,UCBPlayer
11307,UCBPlayer,131,271,402,25,41,UCBPlayer
11308,UCBPlayer,105,210,315,10,65,UCBPlayer
11309,UCBPlayer,130,275,405,25,40,UCBPlayer
11310,UCBPlayer,105,210,315,10,65,UCBPlayer
11311,UCBPlayer,130,275,405,25,40,UCBPlayer
11312,UCBPlayer,103,203,306,10,68,UCBPlayer
11313,UCBPlayer,128,283,411,25,38,UCBPlayer
11314,UCBPlayer,111,186,297,10,71,UCBPlayer
11315,UCBPlayer,124,299,423,25,34,UCBPlayer
11316,UCBPlayer,115,170,285,10,75,UCBPlayer
11317,UCBPlayer,120,315,435,25,30,UCBPlayer
11318,UCBPlayer,119,154,273,10,79,UCBPlayer
11319,UCBPlayer,112,332,444,25,27,UCBPlayer
11320,UCBPlayer,127,137,264,10,82,UCBPlayer
11321,UCBPlayer,104,349,453,25,24,UCBPlayer
11322,UCBPlayer,126,126,252,7,85,Tie
11323,UCBPlayer,111,351,462,28,22,UCBPlayer
11324,UCBPlayer,116,126,242,3,87,UCBPlayer
11325,UCBPlayer,122,347,469,32,21,UCBPlayer
11326,UCBPlayer,107,132,239,0,87,UCBPlayer
11327,UCBPlayer,132,337,469,35,22,UCBPlayer
11328,UCBPlayer,103,148,251,0,83,UCBPlayer
11329,UCBPlayer,136,321,457,35,26,UCBPlayer
11330,UCBPlayer,99,164,263,0,79,UCBPlayer
11331,UCBPlayer,140,305,445,35,30,UCBPlayer
11332,UCBPlayer,95,180,275,0,75,UCBPlayer
11333,UCBPlayer,144,289,433,35,34,UCBPlayer
11334,UCBPlayer,91,196,287,0,71,UCBPlayer
11335,UCBPlayer,148,273,421,35,38,UCBPlayer
11336,UCBPlayer,87,212,299,0,67,UCBPlayer
11337,UCBPlayer,152,257,409,35,42,UCBPlayer
11338,UCBPlayer,84,224,308,0,64,UCBPlayer
11339,UCBPlayer,146,251,397,32,45,UCBPlayer
11340,UCBPlayer,89,234,323,3,60,UCBPlayer
11341,UCBPlayer,138,243,381,28,49,UCBPlayer
11342,UCBPlayer,97,242,339,7,56,UCBPlayer
11343,UCBPlayer,130,235,365,24,53,UCBPlayer
11344,UCBPlayer,105,250,355,11,52,UCBPlayer
11345,UCBPlayer,122,227,349,20,57,UCBPlayer
11346,UCBPlayer,109,259,368,15,49,UCBPlayer
11347,UCBPlayer,118,218,336,16,60,UCBPlayer
11348,UCBPlayer,117,267,384,19,45,UCBPlayer
11349,UCBPlayer,110,210,320,12,64,UCBPlayer
11350,UCBPlayer,126,271,397,23,42,UCBPlayer
11351,UCBPlayer,105,210,315,10,65,UCBPlayer
11352,UCBPlayer,130,275,405,25,40,UCBPlayer
11353,UCBPlayer,105,210,315,10,65,UCBPlayer
11354,UCBPlayer,130,275,405,25,40,UCBPlayer
11355,UCBPlayer,106,206,312,10,66,UCBPlayer
11356,UCBPlayer,130,275,405,25,40,UCBPlayer
11357,UCBPlayer,105,210,315,10,65,UCBPlayer
11358,UCBPlayer,131,271,402,25,41,UCBPlayer
11359,UCBPlayer,105,210,315,10,65,UCBPlayer
11360,UCBPlayer,130,275,405,25,40,UCBPlayer
11361,UCBPlayer,105,210,315,10,65,UCBPlayer
11362,UCBPlayer,130,275,405,25,40,UCBPlayer
11363,UCBPlayer,103,203,306,10,68,UCBPlayer
11364,UCBPlayer,128,283,411,25,38,UCBPlayer
11365,UCBPlayer,111,186,297,10,71,UCBPlayer
11366,UCBPlayer,124,299,423,25,34,UCBPlayer
11367,UCBPlayer,115,170,285,10,75,UCBPlayer
11368,UCBPlayer,120,315,435,25,30,UCBPlayer
11369,UCBPlayer,119,154,273,10,79,UCBPlayer
11370,UCBPlayer,112,332,444,25,27,UCBPlayer
11371,UCBPlayer,127,137,264,10,82,UCBPlayer
11372,UCBPlayer,104,349,453,25,24,UCBPlayer
11373,UCBPlayer,126,126,252,7,85,Tie
11374,UCBPlayer,111,351,462,28,22,UCBPlayer
11375,UCBPlayer,116,126,242,3,87,UCBPlayer
11376,UCBPlayer,122,347,469,32,21,UCBPlayer
11377,UCBPlayer,107,132,239,0,87,UCBPlayer
11378,UCBPlayer,132,337,469,35,22,UCBPlayer
11379,UCBPlayer,103,148,251,0,83,UCBPlayer
11380,UCBPlayer,136,321,457,35,26,UCBPlayer
11381,UCBPlayer,99,164,263,0,79,UCBPlayer
11382,UCBPlayer,140,305,445,35,30,UCBPlayer
11383,UCBPlayer,95,180,275,0,75,UCBPlayer
11384,UCBPlayer,144,289,433,35,34,UCBPlayer
11385,UCBPlayer,91,196,287,0,71,UCBPlayer
11386,UCBPlayer,148,273,421,35,38,UCBPlayer
11387,UCBPlayer,87,212,299,0,67,UCBPlayer
11388,UCBPlayer,152,257,409,35,42,UCBPlayer
11389,UCBPlayer,84,224,308,0,64,UCBPlayer
11390,UCBPlayer,146,251,397,32,45,UCBPlayer
11391,UCBPlayer,89,234,323,3,60,UCBPlayer
11392,UCBPlayer,138,243,381,28,49,UCBPlayer
11393,UCBPlayer,97,242,339,7,56,UCBPlayer
11394,UCBPlayer,130,235,365,24,53,UCBPlayer
11395,UCBPlayer,105,250,355,11,52,UCBPlayer
11396,UCBPlayer,122,227,349,20,57,UCBPlayer
11397,UCBPlayer,109,259,368,15,49,UCBPlayer
11398,UCBPlayer,118,218,336,16,60,UCBPlayer
11399,UCBPlayer,117,267,384,19,45,UCBPlayer
11400,UCBPlayer,110,210,320,12,64,UCBPlayer
11401,UCBPlayer,126,271,397,23,42,UCBPlayer
11402,UCBPlayer,105,210,315,10,65,UCBPlayer
11403,UCBPlayer,130,275,405,25,40,UCBPlayer
11404,UCBPlayer,105,210,315,10,65,UCBPlayer
11405,UCBPlayer,130,275,405,25,40,UCBPlayer
11406,UCBPlayer,106,206,312,10,66,UCBPlayer
11407,UCBPlayer,130,275,405,25,40,UCBPlayer
11408,UCBPlayer,105,210,315,10,65,UCBPlayer
11409,UCBPlayer,131,271,402,25,41,UCBPlayer
11410,UCBPlayer,105,210,315,10,65,UCBPlayer
11411,UCBPlayer,130,275,405,25,40,UCBPlayer
11412,UCBPlayer,105,210,315,10,65,UCBPlayer
11413,UCBPlayer,130,275,405,25,40,UCBPlayer
11414,UCBPlayer,103,203,306,10,68,UCBPlayer
11415,UCBPlayer,128,283,411,25,38,UCBPlayer
11416,UCBPlayer,111,186,297,10,71,UCBPlayer
11417,UCBPlayer,124,299,423,25,34,UCBPlayer
11418,UCBPlayer,115,170,285,10,75,UCBPlayer
11419,UCBPlayer,120,315,435,25,30,UCBPlayer
11420,UCBPlayer,119,154,273,10,79,UCBPlayer
11421,UCBPlayer,112,332,444,25,27,UCBPlayer
11422,UCBPlayer,127,137,264,10,82,UCBPlayer
11423,UCBPlayer,104,349,453,25,24,UCBPlayer
11424,UCBPlayer,126,126,252,7,85,Tie
11425,UCBPlayer,111,351,462,28,22,UCBPlayer
11426,UCBPlayer,116,126,242,3,87,UCBPlayer
11427,UCBPlayer,122,347,469,32,21,UCBPlayer
11428,UCBPlayer,107,132,239,0,87,UCBPlayer
11429,UCBPlayer,132,337,469,35,22,UCBPlayer
11430,UCBPlayer,103,148,251,0,83,UCBPlayer
11431,UCBPlayer,136,321,457,35,26,UCBPlayer
11432,UCBPlayer,99,164,263,0,79,UCBPlayer
11433,UCBPlayer,140,305,445,35,30,UCBPlayer
11434,UCBPlayer,95,180,275,0,75,UCBPlayer
11435,UCBPlayer,144,289,433,35,34,UCBPlayer
11436,UCBPlayer,91,196,287,0,71,UCBPlayer
11437,UCBPlayer,148,273,421,35,38,UCBPlayer
11438,UCBPlayer,87,212,299,0,67,UCBPlayer
11439,UCBPlayer,152,257,409,35,42,UCBPlayer
11440,UCBPlayer,84,224,308,0,64,UCBPlayer
11441,UCBPlayer,146,251,397,32,45,UCBPlayer
11442,UCBPlayer,89,234,323,3,60,UCBPlayer
11443,UCBPlayer,138,243,381,28,49,UCBPlayer
11444,UCBPlayer,97,242,339,7,56,UCBPlayer
11445,UCBPlayer,130,235,365,24,53,UCBPlayer
11446,UCBPlayer,105,250,355,11,52,UCBPlayer
11447,UCBPlayer,122,227,349,20,57,UCBPlayer
11448,UCBPlayer,109,259,368,15,49,UCBPlayer
11449,UCBPlayer,118,218,336,16,60,UCBPlayer
11450,UCBPlayer,117,267,384,19,45,UCBPlayer
11451,UCBPlayer,110,210,320,12,64,UCBPlayer
11452,UCBPlayer,126,271,397,23,42,UCBPlayer
11453,UCBPlayer,105,210,315,10,65,UCBPlayer
11454,UCBPlayer,130,275,405,25,40,UCBPlayer
11455,UCBPlayer,105,210,315,10,65,UCBPlayer
11456,UCBPlayer,130,275,405,25,40,UCBPlayer
11457,UCBPlayer,106,206,312,10,66,UCBPlayer
11458,UCBPlayer,130,275,405,25,40,UCBPlayer
11459,UCBPlayer,105,210,315,10,65,UCBPlayer
11460,UCBPlayer,131,271,402,25,41,UCBPlayer
11461,UCBPlayer,105,210,315,10,65,UCBPlayer
11462,UCBPlayer,130,275,405,25,40,UCBPlayer
11463,UCBPlayer,105,210,315,10,65,UCBPlayer
11464,UCBPlayer,130,275,405,25,40,UCBPlayer
11465,UCBPlayer,103,203,306,10,68,UCBPlayer
11466,UCBPlayer,128,283,411,25,38,UCBPlayer
11467,UCBPlayer,111,186,297,10,71,UCBPlayer
11468,UCBPlayer,124,299,423,25,34,UCBPlayer
11469,UCBPlayer,115,170,285,10,75,UCBPlayer
11470,UCBPlayer,120,315,435,25,30,UCBPlayer
11471,UCBPlayer,119,154,273,10,79,UCBPlayer
11472,UCBPlayer,112,332,444,25,27,UCBPlayer
11473,UCBPlayer,127,137,264,10,82,UCBPlayer
11474,UCBPlayer,104,349,453,25,24,UCBPlayer
11475,UCBPlayer,126,126,252,7,85,Tie
11476,UCBPlayer,111,351,462,28,22,UCBPlayer
11477,UCBPlayer,116,126,242,3,87,UCBPlayer
11478,UCBPlayer,122,347,469,32,21,UCBPlayer
11479,UCBPlayer,107,132,239,0,87,UCBPlayer
11480,UCBPlayer,132,337,469,35,22,UCBPlayer
11481,UCBPlayer,103,148,251,0,83,UCBPlayer
11482,UCBPlayer,136,321,457,35,26,UCBPlayer
11483,UCBPlayer,99,164,263,0,79,UCBPlayer
11484,UCBPlayer,140,305,445,35,30,UCBPlayer
11485,UCBPlayer,95,180,275,0,75,UCBPlayer
11486,UCBPlayer,144,289,433,35,34,UCBPlayer
11487,UCBPlayer,91,196,287,0,71,UCBPlayer
11488,UCBPlayer,148,273,421,35,38,UCBPlayer
11489,UCBPlayer,87,212,299,0,67,UCBPlayer
11490,UCBPlayer,152,257,409,35,42,UCBPlayer
11491,UCBPlayer,84,224,308,0,64,UCBPlayer
11492,UCBPlayer,146,251,397,32,45,UCBPlayer
11493,UCBPlayer,89,234,323,3,60,UCBPlayer
11494,UCBPlayer,138,243,381,28,49,UCBPlayer
11495,UCBPlayer,97,242,339,7,56,UCBPlayer
11496,UCBPlayer,130,235,365,24,53,UCBPlayer
11497,UCBPlayer,105,250,355,11,52,UCBPlayer
11498,UCBPlayer,122,227,349,20,57,UCBPlayer
11499,UCBPlayer,109,259,368,15,49,UCBPlayer
11500,UCBPlayer,118,218,336,16,60,UCBPlayer
11501,UCBPlayer,117,267,384,19,45,UCBPlayer
11502,UCBPlayer,110,210,320,12,64,UCBPlayer
11503,UCBPlayer,126,271,397,23,42,UCBPlayer
11504,UCBPlayer,105,210,315,10,65,UCBPlayer
11505,UCBPlayer,130,275,405,25,40,UCBPlayer
11506,UCBPlayer,105,210,315,10,65,UCBPlayer
11507,UCBPlayer,130,275,405,25,40,UCBPlayer
11508,UCBPlayer,106,206,312,10,66,UCBPlayer
11509,UCBPlayer,130,275,405,25,40,UCBPlayer
11510,UCBPlayer,105,210,315,10,65,UCBPlayer
11511,UCBPlayer,131,271,402,25,41,UCBPlayer
11512,UCBPlayer,105,210,315,10,65,UCBPlayer
11513,UCBPlayer,130,275,405,25,40,UCBPlayer
11514,UCBPlayer,105,210,315,10,65,UCBPlayer
11515,UCBPlayer,130,275,405,25,40,UCBPlayer
11516,UCBPlayer,103,203,306,10,68,UCBPlayer
11517,UCBPlayer,128,283,411,25,38,UCBPlayer
11518,UCBPlayer,111,186,297,10,71,UCBPlayer
11519,UCBPlayer,124,299,423,25,34,UCBPlayer
11520,UCBPlayer,115,170,285,10,75,UCBPlayer
11521,UCBPlayer,120,315,435,25,30,UCBPlayer
11522,UCBPlayer,119,154,273,10,79,UCBPlayer
11523,UCBPlayer,112,332,444,25,27,UCBPlayer
11524,UCBPlayer,127,137,264,10,82,UCBPlayer
11525,UCBPlayer,104,349,453,25,24,UCBPlayer
11526,UCBPlayer,126,126,252,7,85,Tie
11527,UCBPlayer,111,351,462,28,22,UCBPlayer
11528,UCBPlayer,116,126,242,3,87,UCBPlayer
11529,UCBPlayer,122,347,469,32,21,UCBPlayer
11530,UCBPlayer,107,132,239,0,87,UCBPlayer
11531,UCBPlayer,132,337,469,35,22,UCBPlayer
11532,UCBPlayer,103,148,251,0,83,UCBPlayer
11533,UCBPlayer,136,321,457,35,26,UCBPlayer
11534,UCBPlayer,99,164,263,0,79,UCBPlayer
11535,UCBPlayer,140,305,445,35,30,UCBPlayer
11536,UCBPlayer,95,180,275,0,75,UCBPlayer
11537,UCBPlayer,144,289,433,35,34,UCBPlayer
11538,UCBPlayer,91,196,287,0,71,UCBPlayer
11539,UCBPlayer,148,273,421,35,38,UCBPlayer
11540,UCBPlayer,87,212,299,0,67,UCBPlayer
11541,UCBPlayer,152,257,409,35,42,UCBPlayer
11542,UCBPlayer,84,224,308,0,64,UCBPlayer
11543,UCBPlayer,146,251,397,32,45,UCBPlayer
11544,UCBPlayer,89,234,323,3,60,UCBPlayer
11545,UCBPlayer,138,243,381,28,49,UCBPlayer
11546,UCBPlayer,97,242,339,7,56,UCBPlayer
11547,UCBPlayer,130,235,365,24,53,UCBPlayer
11548,UCBPlayer,105,250,355,11,52,UCBPlayer
11549,UCBPlayer,122,227,349,20,57,UCBPlayer
11550,UCBPlayer,109,259,368,15,49,UCBPlayer
11551,UCBPlayer,118,218,336,16,60,UCBPlayer
11552,UCBPlayer,117,267,384,19,45,UCBPlayer
11553,UCBPlayer,110,210,320,12,64,UCBPlayer
11554,UCBPlayer,126,271,397,23,42,UCBPlayer
11555,UCBPlayer,105,210,315,10,65,UCBPlayer
11556,UCBPlayer,130,275,405,25,40,UCBPlayer
11557,UCBPlayer,105,210,315,10,65,UCBPlayer
11558,UCBPlayer,130,275,405,25,40,UCBPlayer
11559,UCBPlayer,106,206,312,10,66,UCBPlayer
11560,UCBPlayer,130,275,405,25,40,UCBPlayer
11561,UCBPlayer,105,210,315,10,65,UCBPlayer
11562,UCBPlayer,131,271,402,25,41,UCBPlayer
11563,UCBPlayer,105,210,315,10,65,UCBPlayer
11564,UCBPlayer,130,275,405,25,40,UCBPlayer
11565,UCBPlayer,105,210,315,10,65,UCBPlayer
11566,UCBPlayer,130,275,405,25,40,UCBPlayer
11567,UCBPlayer,103,203,306,10,68,UCBPlayer
11568,UCBPlayer,128,283,411,25,38,UCBPlayer
11569,UCBPlayer,111,186,297,10,71,UCBPlayer
11570,UCBPlayer,124,299,423,25,34,UCBPlayer
11571,UCBPlayer,115,170,285,10,75,UCBPlayer
11572,UCBPlayer,120,315,435,25,30,UCBPlayer
11573,UCBPlayer,119,154,273,10,79,UCBPlayer
11574,UCBPlayer,112,332,444,25,27,UCBPlayer
11575,UCBPlayer,127,137,264,10,82,UCBPlayer
11576,UCBPlayer,104,349,453,25,24,UCBPlayer
11577,UCBPlayer,126,126,252,7,85,Tie
11578,UCBPlayer,111,351,462,28,22,UCBPlayer
11579,UCBPlayer,116,126,242,3,87,UCBPlayer
11580,UCBPlayer,122,347,469,32,21,UCBPlayer
11581,UCBPlayer,107,132,239,0,87,UCBPlayer
11582,UCBPlayer,132,337,469,35,22,UCBPlayer
11583,UCBPlayer,103,148,251,0,83,UCBPlayer
11584,UCBPlayer,136,321,457,35,26,UCBPlayer
11585,UCBPlayer,99,164,263,0,79,UCBPlayer
11586,UCBPlayer,140,305,445,35,30,UCBPlayer
11587,UCBPlayer,95,180,275,0,75,UCBPlayer
11588,UCBPlayer,144,289,433,35,34,UCBPlayer
11589,UCBPlayer,91,196,287,0,71,UCBPlayer
11590,UCBPlayer,148,273,421,35,38,UCBPlayer
11591,UCBPlayer,87,212,299,0,67,UCBPlayer
11592,UCBPlayer,152,257,409,35,42,UCBPlayer
11593,UCBPlayer,84,224,308,0,64,UCBPlayer
11594,UCBPlayer,146,251,397,32,45,UCBPlayer
11595,UCBPlayer,89,234,323,3,60,UCBPlayer
11596,UCBPlayer,138,243,381,28,49,UCBPlayer
11597,UCBPlayer,97,242,339,7,56,UCBPlayer
11598,UCBPlayer,130,235,365,24,53,UCBPlayer
11599,UCBPlayer,105,250,355,11,52,UCBPlayer
11600,UCBPlayer,122,227,349,20,57,UCBPlayer
11601,UCBPlayer,109,259,368,15,49,UCBPlayer
11602,UCBPlayer,118,218,336,16,60,UCBPlayer
11603,UCBPlayer,117,267,384,19,45,UCBPlayer
11604,UCBPlayer,110,210,320,12,64,UCBPlayer
11605,UCBPlayer,126,271,397,23,42,UCBPlayer
11606,UCBPlayer,105,210,315,10,65,UCBPlayer
11607,UCBPlayer,130,275,405,25,40,UCBPlayer
11608,UCBPlayer,105,210,315,10,65,UCBPlayer
11609,UCBPlayer,130,275,405,25,40,UCBPlayer
11610,UCBPlayer,106,206,312,10,66,UCBPlayer
11611,UCBPlayer,130,275,405,25,40,UCBPlayer
11612,UCBPlayer,105,210,315,10,65,UCBPlayer
11613,UCBPlayer,131,271,402,25,41,UCBPlayer
11614,UCBPlayer,105,210,315,10,65,UCBPlayer
11615,UCBPlayer,130,275,405,25,40,UCBPlayer
11616,UCBPlayer,105,210,315,10,65,UCBPlayer
11617,UCBPlayer,130,275,405,25,40,UCBPlayer
11618,UCBPlayer,103,203,306,10,68,UCBPlayer
11619,UCBPlayer,128,283,411,25,38,UCBPlayer
11620,UCBPlayer,111,186,297,10,71,UCBPlayer
11621,UCBPlayer,124,299,423,25,34,UCBPlayer
11622,UCBPlayer,115,170,285,10,75,UCBPlayer
11623,UCBPlayer,120,315,435,25,30,UCBPlayer
11624,UCBPlayer,119,154,273,10,79,UCBPlayer
11625,UCBPlayer,112,332,444,25,27,UCBPlayer
11626,UCBPlayer,127,137,264,10,82,UCBPlayer
11627,UCBPlayer,104,349,453,25,24,UCBPlayer
11628,UCBPlayer,126,126,252,7,85,Tie
11629,UCBPlayer,111,351,462,28,22,UCBPlayer
11630,UCBPlayer,116,126,242,3,87,UCBPlayer
11631,UCBPlayer,122,347,469,32,21,UCBPlayer
11632,UCBPlayer,107,132,239,0,87,UCBPlayer
11633,UCBPlayer,132,337,469,35,22,UCBPlayer
11634,UCBPlayer,103,148,251,0,83,UCBPlayer
11635,UCBPlayer,136,321,457,35,26,UCBPlayer
11636,UCBPlayer,99,164,263,0,79,UCBPlayer
11637,UCBPlayer,140,305,445,35,30,UCBPlayer
11638,UCBPlayer,95,180,275,0,75,UCBPlayer
11639,UCBPlayer,144,289,433,35,34,UCBPlayer
11640,UCBPlayer,91,196,287,0,71,UCBPlayer
11641,UCBPlayer,148,273,421,35,38,UCBPlayer
11642,UCBPlayer,87,212,299,0,67,UCBPlayer
11643,UCBPlayer,152,257,409,35,42,UCBPlayer
11644,UCBPlayer,84,224,308,0,64,UCBPlayer
11645,UCBPlayer,146,251,397,32,45,UCBPlayer
11646,UCBPlayer,89,234,323,3,60,UCBPlayer
11647,UCBPlayer,138,243,381,28,49,UCBPlayer
11648,UCBPlayer,97,242,339,7,56,UCBPlayer
11649,UCBPlayer,130,235,365,24,53,UCBPlayer
11650,UCBPlayer,105,250,355,11,52,UCBPlayer
11651,UCBPlayer,122,227,349,20,57,UCBPlayer
11652,UCBPlayer,109,259,368,15,49,UCBPlayer
11653,UCBPlayer,118,218,336,16,60,UCBPlayer
11654,UCBPlayer,117,267,384,19,45,UCBPlayer
11655,UCBPlayer,110,210,320,12,64,UCBPlayer
11656,UCBPlayer,126,271,397,23,42,UCBPlayer
11657,UCBPlayer,105,210,315,10,65,UCBPlayer
11658,UCBPlayer,130,275,405,25,40,UCBPlayer
11659,UCBPlayer,105,210,315,10,65,UCBPlayer
11660,UCBPlayer,130,275,405,25,40,UCBPlayer
11661,UCBPlayer,106,206,312,10,66,UCBPlayer
11662,UCBPlayer,130,275,405,25,40,UCBPlayer
11663,UCBPlayer,105,210,315,10,65,UCBPlayer
11664,UCBPlayer,131,271,402,25,41,UCBPlayer
11665,UCBPlayer,105,210,315,10,65,UCBPlayer
11666,UCBPlayer,130,275,405,25,40,UCBPlayer
11667,UCBPlayer,105,210,315,10,65,UCBPlayer
11668,UCBPlayer,130,275,405,25,40,UCBPlayer
11669,UCBPlayer,103,203,306,10,68,UCBPlayer
11670,UCBPlayer,128,283,411,25,38,UCBPlayer
11671,UCBPlayer,111,186,297,10,71,UCBPlayer
11672,UCBPlayer,124,299,423,25,34,UCBPlayer
11673,UCBPlayer,115,170,285,10,75,UCBPlayer
11674,UCBPlayer,120,315,435,25,30,UCBPlayer
11675,UCBPlayer,119,154,273,10,79,UCBPlayer
11676,UCBPlayer,112,332,444,25,27,UCBPlayer
11677,UCBPlayer,127,137,264,10,82,UCBPlayer
11678,UCBPlayer,104,349,453,25,24,UCBPlayer
11679,UCBPlayer,126,126,252,7,85,Tie
11680,UCBPlayer,111,351,462,28,22,UCBPlayer
11681,UCBPlayer,116,126,242,3,87,UCBPlayer
11682,UCBPlayer,122,347,469,32,21,UCBPlayer
11683,UCBPlayer,107,132,239,0,87,UCBPlayer
11684,UCBPlayer,132,337,469,35,22,UCBPlayer
11685,UCBPlayer,103,148,251,0,83,UCBPlayer
11686,UCBPlayer,136,321,457,35,26,UCBPlayer
11687,UCBPlayer,99,164,263,0,79,UCBPlayer
11688,UCBPlayer,140,305,445,35,30,UCBPlayer
11689,UCBPlayer,95,180,275,0,75,UCBPlayer
11690,UCBPlayer,144,289,433,35,34,UCBPlayer
11691,UCBPlayer,91,196,287,0,71,UCBPlayer
11692,UCBPlayer,148,273,421,35,38,UCBPlayer
11693,UCBPlayer,87,212,299,0,67,UCBPlayer
11694,UCBPlayer,152,257,409,35,42,UCBPlayer
11695,UCBPlayer,84,224,308,0,64,UCBPlayer
11696,UCBPlayer,146,251,397,32,45,UCBPlayer
11697,UCBPlayer,89,234,323,3,60,UCBPlayer
11698,UCBPlayer,138,243,381,28,49,UCBPlayer
11699,UCBPlayer,97,242,339,7,56,UCBPlayer
11700,UCBPlayer,130,235,365,24,53,UCBPlayer
11701,UCBPlayer,105,250,355,11,52,UCBPlayer
11702,UCBPlayer,122,227,349,20,57,UCBPlayer
11703,UCBPlayer,109,259,368,15,49,UCBPlayer
11704,UCBPlayer,118,218,336,16,60,UCBPlayer
11705,UCBPlayer,117,267,384,19,45,UCBPlayer
11706,UCBPlayer,110,210,320,12,64,UCBPlayer
11707,UCBPlayer,126,271,397,23,42,UCBPlayer
11708,UCBPlayer,105,210,315,10,65,UCBPlayer
11709,UCBPlayer,130,275,405,25,40,UCBPlayer
11710,UCBPlayer,105,210,315,10,65,UCBPlayer
11711,UCBPlayer,130,275,405,25,40,UCBPlayer
11712,UCBPlayer,106,206,312,10,66,UCBPlayer
11713,UCBPlayer,130,275,405,25,40,UCBPlayer
11714,UCBPlayer,105,210,315,10,65,UCBPlayer
11715,UCBPlayer,131,271,402,25,41,UCBPlayer
11716,UCBPlayer,105,210,315,10,65,UCBPlayer
11717,UCBPlayer,130,275,405,25,40,UCBPlayer
11718,UCBPlayer,105,210,315,10,65,UCBPlayer
11719,UCBPlayer,130,275,405,25,40,UCBPlayer
11720,UCBPlayer,103,203,306,10,68,UCBPlayer
11721,UCBPlayer,128,283,411,25,38,UCBPlayer
11722,UCBPlayer,111,186,297,10,71,UCBPlayer
11723,UCBPlayer,124,299,423,25,34,UCBPlayer
11724,UCBPlayer,115,170,285,10,75,UCBPlayer
11725,UCBPlayer,120,315,435,25,30,UCBPlayer
11726,UCBPlayer,119,154,273,10,79,UCBPlayer
11727,UCBPlayer,112,332,444,25,27,UCBPlayer
11728,UCBPlayer,127,137,264,10,82,UCBPlayer
11729,UCBPlayer,104,349,453,25,24,UCBPlayer
11730,UCBPlayer,126,126,252,7,85,Tie
11731,UCBPlayer,111,351,462,28,22,UCBPlayer
11732,UCBPlayer,116,126,242,3,87,UCBPlayer
11733,UCBPlayer,122,347,469,32,21,UCBPlayer
11734,UCBPlayer,107,132,239,0,87,UCBPlayer
11735,UCBPlayer,132,337,469,35,22,UCBPlayer
11736,UCBPlayer,103,148,251,0,83,UCBPlayer
11737,UCBPlayer,136,321,457,35,26,UCBPlayer
11738,UCBPlayer,99,164,263,0,79,UCBPlayer
11739,UCBPlayer,140,305,445,35,30,UCBPlayer
11740,UCBPlayer,95,180,275,0,75,UCBPlayer
11741,UCBPlayer,144,289,433,35,34,UCBPlayer
11742,UCBPlayer,91,196,287,0,71,UCBPlayer
11743,UCBPlayer,148,273,421,35,38,UCBPlayer
11744,UCBPlayer,87,212,299,0,67,UCBPlayer
11745,UCBPlayer,152,257,409,35,42,UCBPlayer
11746,UCBPlayer,84,224,308,0,64,UCBPlayer
11747,UCBPlayer,146,251,397,32,45,UCBPlayer
11748,UCBPlayer,89,234,323,3,60,UCBPlayer
11749,UCBPlayer,138,243,381,28,49,UCBPlayer
11750,UCBPlayer,97,242,339,7,56,UCBPlayer
11751,UCBPlayer,130,235,365,24,53,UCBPlayer
11752,UCBPlayer,105,250,355,11,52,UCBPlayer
11753,UCBPlayer,122,227,349,20,57,UCBPlayer
11754,UCBPlayer,109,259,368,15,49,UCBPlayer
11755,UCBPlayer,118,218,336,16,60,UCBPlayer
11756,UCBPlayer,117,267,384,19,45,UCBPlayer
11757,UCBPlayer,110,210,320,12,64,UCBPlayer
11758,UCBPlayer,126,271,397,23,42,UCBPlayer
11759,UCBPlayer,105,210,315,10,65,UCBPlayer
11760,UCBPlayer,130,275,405,25,40,UCBPlayer
11761,UCBPlayer,105,210,315,10,65,UCBPlayer
11762,UCBPlayer,130,275,405,25,40,UCBPlayer
11763,UCBPlayer,106,206,312,10,66,UCBPlayer
11764,UCBPlayer,130,275,405,25,40,UCBPlayer
11765,UCBPlayer,105,210,315,10,65,UCBPlayer
11766,UCBPlayer,131,271,402,25,41,UCBPlayer
11767,UCBPlayer,105,210,315,10,65,UCBPlayer
11768,UCBPlayer,130,275,405,25,40,UCBPlayer
11769,UCBPlayer,105,210,315,10,65,UCBPlayer
11770,UCBPlayer,130,275,405,25,40,UCBPlayer
11771,UCBPlayer,103,203,306,10,68,UCBPlayer
11772,UCBPlayer,128,283,411,25,38,UCBPlayer
11773,UCBPlayer,111,186,297,10,71,UCBPlayer
11774,UCBPlayer,124,299,423,25,34,UCBPlayer
11775,UCBPlayer,115,170,285,10,75,UCBPlayer
11776,UCBPlayer,120,315,435,25,30,UCBPlayer
11777,UCBPlayer,119,154,273,10,79,UCBPlayer
11778,UCBPlayer,112,332,444,25,27,UCBPlayer
11779,UCBPlayer,127,137,264,10,82,UCBPlayer
11780,UCBPlayer,104,349,453,25,24,UCBPlayer
11781,UCBPlayer,126,126,252,7,85,Tie
11782,UCBPlayer,111,351,462,28,22,UCBPlayer
11783,UCBPlayer,116,126,242,3,87,UCBPlayer
11784,UCBPlayer,122,347,469,32,21,UCBPlayer
11785,UCBPlayer,107,132,239,0,87,UCBPlayer
11786,UCBPlayer,132,337,469,35,22,UCBPlayer
11787,UCBPlayer,103,148,251,0,83,UCBPlayer
11788,UCBPlayer,136,321,457,35,26,UCBPlayer
11789,UCBPlayer,99,164,263,0,79,UCBPlayer
11790,UCBPlayer,140,305,445,35,30,UCBPlayer
11791,UCBPlayer,95,180,275,0,75,UCBPlayer
11792,UCBPlayer,144,289,433,35,34,UCBPlayer
11793,UCBPlayer,91,196,287,0,71,UCBPlayer
11794,UCBPlayer,148,273,421,35,38,UCBPlayer
11795,UCBPlayer,87,212,299,0,67,UCBPlayer
11796,UCBPlayer,152,257,409,35,42,UCBPlayer
11797,UCBPlayer,84,224,308,0,64,UCBPlayer
11798,UCBPlayer,146,251,397,32,45,UCBPlayer
11799,UCBPlayer,89,234,323,3,60,UCBPlayer
11800,UCBPlayer,138,243,381,28,49,UCBPlayer
11801,UCBPlayer,97,242,339,7,56,UCBPlayer
11802,UCBPlayer,130,235,365,24,53,UCBPlayer
11803,UCBPlayer,105,250,355,11,52,UCBPlayer
11804,UCBPlayer,122,227,349,20,57,UCBPlayer
11805,UCBPlayer,109,259,368,15,49,UCBPlayer
11806,UCBPlayer,118,218,336,16,60,UCBPlayer
11807,UCBPlayer,117,267,384,19,45,UCBPlayer
11808,UCBPlayer,110,210,320,12,64,UCBPlayer
11809,UCBPlayer,126,271,397,23,42,UCBPlayer
11810,UCBPlayer,105,210,315,10,65,UCBPlayer
11811,UCBPlayer,130,275,405,25,40,UCBPlayer
11812,UCBPlayer,105,210,315,10,65,UCBPlayer
11813,UCBPlayer,130,275,405,25,40,UCBPlayer
11814,UCBPlayer,106,206,312,10,66,UCBPlayer
11815,UCBPlayer,130,275,405,25,40,UCBPlayer
11816,UCBPlayer,105,210,315,10,65,UCBPlayer
11817,UCBPlayer,131,271,402,25,41,UCBPlayer
11818,UCBPlayer,105,210,315,10,65,UCBPlayer
11819,UCBPlayer,130,275,405,25,40,UCBPlayer
11820,UCBPlayer,105,210,315,10,65,UCBPlayer
11821,UCBPlayer,130,275,405,25,40,UCBPlayer
11822,UCBPlayer,103,203,306,10,68,UCBPlayer
11823,UCBPlayer,128,283,411,25,38,UCBPlayer
11824,UCBPlayer,111,186,297,10,71,UCBPlayer
11825,UCBPlayer,124,299,423,25,34,UCBPlayer
11826,UCBPlayer,115,170,285,10,75,UCBPlayer
11827,UCBPlayer,120,315,435,25,30,UCBPlayer
11828,UCBPlayer,119,154,273,10,79,UCBPlayer
11829,UCBPlayer,112,332,444,25,27,UCBPlayer
11830,UCBPlayer,127,137,264,10,82,UCBPlayer
11831,UCBPlayer,104,349,453,25,24,UCBPlayer
11832,UCBPlayer,126,126,252,7,85,Tie
11833,UCBPlayer,111,351,462,28,22,UCBPlayer
11834,UCBPlayer,116,126,242,3,87,UCBPlayer
11835,UCBPlayer,122,347,469,32,21,UCBPlayer
11836,UCBPlayer,107,132,239,0,87,UCBPlayer
11837,UCBPlayer,132,337,469,35,22,UCBPlayer
11838,UCBPlayer,103,148,251,0,83,UCBPlayer
11839,UCBPlayer,136,321,457,35,26,UCBPlayer
11840,UCBPlayer,99,164,263,0,79,UCBPlayer
11841,UCBPlayer,140,305,445,35,30,UCBPlayer
11842,UCBPlayer,95,180,275,0,75,UCBPlayer
11843,UCBPlayer,144,289,433,35,34,UCBPlayer
11844,UCBPlayer,91,196,287,0,71,UCBPlayer
11845,UCBPlayer,148,273,421,35,38,UCBPlayer
11846,UCBPlayer,87,212,299,0,67,UCBPlayer
11847,UCBPlayer,152,257,409,35,42,UCBPlayer
11848,UCBPlayer,84,224,308,0,64,UCBPlayer
11849,UCBPlayer,146,251,397,32,45,UCBPlayer
11850,UCBPlayer,89,234,323,3,60,UCBPlayer
11851,UCBPlayer,138,243,381,28,49,UCBPlayer
11852,UCBPlayer,97,242,339,7,56,UCBPlayer
11853,UCBPlayer,130,235,365,24,53,UCBPlayer
11854,UCBPlayer,105,250,355,11,52,UCBPlayer
11855,UCBPlayer,122,227,349,20,57,UCBPlayer
11856,UCBPlayer,109,259,368,15,49,UCBPlayer
11857,UCBPlayer,118,218,336,16,60,UCBPlayer
11858,UCBPlayer,117,267,384,19,45,UCBPlayer
11859,UCBPlayer,110,210,320,12,64,UCBPlayer
11860,UCBPlayer,126,271,397,23,42,UCBPlayer
11861,UCBPlayer,105,210,315,10,65,UCBPlayer
11862,UCBPlayer,130,275,405,25,40,UCBPlayer
11863,UCBPlayer,105,210,315,10,65,UCBPlayer
11864,UCBPlayer,130,275,405,25,40,UCBPlayer
11865,UCBPlayer,106,206,312,10,66,UCBPlayer
11866,UCBPlayer,130,275,405,25,40,UCBPlayer
11867,UCBPlayer,105,210,315,10,65,UCBPlayer
11868,UCBPlayer,131,271,402,25,41,UCBPlayer
11869,UCBPlayer,105,210,315,10,65,UCBPlayer
11870,UCBPlayer,130,275,405,25,40,UCBPlayer
11871,UCBPlayer,105,210,315,10,65,UCBPlayer
11872,UCBPlayer,130,275,405,25,40,UCBPlayer
11873,UCBPlayer,103,203,306,10,68,UCBPlayer
11874,UCBPlayer,128,283,411,25,38,UCBPlayer
11875,UCBPlayer,111,186,297,10,71,UCBPlayer
11876,UCBPlayer,124,299,423,25,34,UCBPlayer
11877,UCBPlayer,115,170,285,10,75,UCBPlayer
11878,UCBPlayer,120,315,435,25,30,UCBPlayer
11879,UCBPlayer,119,154,273,10,79,UCBPlayer
11880,UCBPlayer,112,332,444,25,27,UCBPlayer
11881,UCBPlayer,127,137,264,10,82,UCBPlayer
11882,UCBPlayer,104,349,453,25,24,UCBPlayer
11883,UCBPlayer,126,126,252,7,85,Tie
11884,UCBPlayer,111,351,462,28,22,UCBPlayer
11885,UCBPlayer,116,126,242,3,87,UCBPlayer
11886,UCBPlayer,122,347,469,32,21,UCBPlayer
11887,UCBPlayer,107,132,239,0,87,UCBPlayer
11888,UCBPlayer,132,337,469,35,22,UCBPlayer
11889,UCBPlayer,103,148,251,0,83,UCBPlayer
11890,UCBPlayer,136,321,457,35,26,UCBPlayer
11891,UCBPlayer,99,164,263,0,79,UCBPlayer
11892,UCBPlayer,140,305,445,35,30,UCBPlayer
11893,UCBPlayer,95,180,275,0,75,UCBPlayer
11894,UCBPlayer,144,289,433,35,34,UCBPlayer
11895,UCBPlayer,91,196,287,0,71,UCBPlayer
11896,UCBPlayer,148,273,421,35,38,UCBPlayer
11897,UCBPlayer,87,212,299,0,67,UCBPlayer
11898,UCBPlayer,152,257,409,35,42,UCBPlayer
11899,UCBPlayer,84,224,308,0,64,UCBPlayer
11900,UCBPlayer,146,251,397,32,45,UCBPlayer
11901,UCBPlayer,89,234,323,3,60,UCBPlayer
11902,UCBPlayer,138,243,381,28,49,UCBPlayer
11903,UCBPlayer,97,242,339,7,56,UCBPlayer
11904,UCBPlayer,130,235,365,24,53,UCBPlayer
11905,UCBPlayer,105,250,355,11,52,UCBPlayer
11906,UCBPlayer,122,227,349,20,57,UCBPlayer
11907,UCBPlayer,109,259,368,15,49,UCBPlayer
11908,UCBPlayer,118,218,336,16,60,UCBPlayer
11909,UCBPlayer,117,267,384,19,45,UCBPlayer
11910,UCBPlayer,110,210,320,12,64,UCBPlayer
11911,UCBPlayer,126,271,397,23,42,UCBPlayer
11912,UCBPlayer,105,210,315,10,65,UCBPlayer
11913,UCBPlayer,130,275,405,25,40,UCBPlayer
11914,UCBPlayer,105,210,315,10,65,UCBPlayer
11915,UCBPlayer,130,275,405,25,40,UCBPlayer
11916,UCBPlayer,106,206,312,10,66,UCBPlayer
11917,UCBPlayer,130,275,405,25,40,UCBPlayer
11918,UCBPlayer,105,210,315,10,65,UCBPlayer
11919,UCBPlayer,131,271,402,25,41,UCBPlayer
11920,UCBPlayer,105,210,315,10,65,UCBPlayer
11921,UCBPlayer,130,275,405,25,40,UCBPlayer
11922,UCBPlayer,105,210,315,10,65,UCBPlayer
11923,UCBPlayer,130,275,405,25,40,UCBPlayer
11924,UCBPlayer,103,203,306,10,68,UCBPlayer
11925,UCBPlayer,128,283,411,25,38,UCBPlayer
11926,UCBPlayer,111,186,297,10,71,UCBPlayer
11927,UCBPlayer,124,299,423,25,34,UCBPlayer
11928,UCBPlayer,115,170,285,10,75,UCBPlayer
11929,UCBPlayer,120,315,435,25,30,UCBPlayer
11930,UCBPlayer,119,154,273,10,79,UCBPlayer
11931,UCBPlayer,112,332,444,25,27,UCBPlayer
11932,UCBPlayer,127,137,264,10,82,UCBPlayer
11933,UCBPlayer,104,349,453,25,24,UCBPlayer
11934,UCBPlayer,126,126,252,7,85,Tie
11935,UCBPlayer,111,351,462,28,22,UCBPlayer
11936,UCBPlayer,116,126,242,3,87,UCBPlayer
11937,UCBPlayer,122,347,469,32,21,UCBPlayer
11938,UCBPlayer,107,132,239,0,87,UCBPlayer
11939,UCBPlayer,132,337,469,35,22,UCBPlayer
11940,UCBPlayer,103,148,251,0,83,UCBPlayer
11941,UCBPlayer,136,321,457,35,26,UCBPlayer
11942,UCBPlayer,99,164,263,0,79,UCBPlayer
11943,UCBPlayer,140,305,445,35,30,UCBPlayer
11944,UCBPlayer,95,180,275,0,75,UCBPlayer
11945,UCBPlayer,144,289,433,35,34,UCBPlayer
11946,UCBPlayer,91,196,287,0,71,UCBPlayer
11947,UCBPlayer,148,273,421,35,38,UCBPlayer
11948,UCBPlayer,87,212,299,0,67,UCBPlayer
11949,UCBPlayer,152,257,409,35,42,UCBPlayer
11950,UCBPlayer,84,224,308,0,64,UCBPlayer
11951,UCBPlayer,146,251,397,32,45,UCBPlayer
11952,UCBPlayer,89,234,323,3,60,UCBPlayer
11953,UCBPlayer,138,243,381,28,49,UCBPlayer
11954,UCBPlayer,97,242,339,7,56,UCBPlayer
11955,UCBPlayer,130,235,365,24,53,UCBPlayer
11956,UCBPlayer,105,250,355,11,52,UCBPlayer
11957,UCBPlayer,122,227,349,20,57,UCBPlayer
11958,UCBPlayer,109,259,368,15,49,UCBPlayer
11959,UCBPlayer,118,218,336,16,60,UCBPlayer
11960,UCBPlayer,117,267,384,19,45,UCBPlayer
11961,UCBPlayer,110,210,320,12,64,UCBPlayer
11962,UCBPlayer,126,271,397,23,42,UCBPlayer
11963,UCBPlayer,105,210,315,10,65,UCBPlayer
11964,UCBPlayer,130,275,405,25,40,UCBPlayer
11965,UCBPlayer,105,210,315,10,65,UCBPlayer
11966,UCBPlayer,130,275,405,25,40,UCBPlayer
11967,UCBPlayer,106,206,312,10,66,UCBPlayer
11968,UCBPlayer,130,275,405,25,40,UCBPlayer
11969,UCBPlayer,105,210,315,10,65,UCBPlayer
11970,UCBPlayer,131,271,402,25,41,UCBPlayer
11971,UCBPlayer,105,210,315,10,65,UCBPlayer
11972,UCBPlayer,130,275,405,25,40,UCBPlayer
11973,UCBPlayer,105,210,315,10,65,UCBPlayer
11974,UCBPlayer,130,275,405,25,40,UCBPlayer
11975,UCBPlayer,103,203,306,10,68,UCBPlayer
11976,UCBPlayer,128,283,411,25,38,UCBPlayer
11977,UCBPlayer,111,186,297,10,71,UCBPlayer
11978,UCBPlayer,124,299,423,25,34,UCBPlayer
11979,UCBPlayer,115,170,285,10,75,UCBPlayer
11980,UCBPlayer,120,315,435,25,30,UCBPlayer
11981,UCBPlayer,119,154,273,10,79,UCBPlayer
11982,UCBPlayer,112,332,444,25,27,UCBPlayer
11983,UCBPlayer,127,137,264,10,82,UCBPlayer
11984,UCBPlayer,104,349,453,25,24,UCBPlayer
11985,UCBPlayer,126,126,252,7,85,Tie
11986,UCBPlayer,111,351,462,28,22,UCBPlayer
11987,UCBPlayer,116,126,242,3,87,UCBPlayer
11988,UCBPlayer,122,347,469,32,21,UCBPlayer
11989,UCBPlayer,107,132,239,0,87,UCBPlayer
11990,UCBPlayer,132,337,469,35,22,UCBPlayer
11991,UCBPlayer,103,148,251,0,83,UCBPlayer
11992,UCBPlayer,136,321,457,35,26,UCBPlayer
11993,UCBPlayer,99,164,263,0,79,UCBPlayer
11994,UCBPlayer,140,305,445,35,30,UCBPlayer
11995,UCBPlayer,95,180,275,0,75,UCBPlayer
11996,UCBPlayer,144,289,433,35,34,UCBPlayer
11997,UCBPlayer,91,196,287,0,71,UCBPlayer
11998,UCBPlayer,148,273,421,35,38,UCBPlayer
11999,UCBPlayer,87,212,299,0,67,UCBPlayer
12000,UCBPlayer,152,257,409,35,42,UCBPlayer
12001,UCBPlayer,84,224,308,0,64,UCBPlayer
12002,UCBPlayer,146,251,397,32,45,UCBPlayer
12003,UCBPlayer,89,234,323,3,60,UCBPlayer
12004,UCBPlayer,138,243,381,28,49,UCBPlayer
12005,UCBPlayer,97,242,339,7,56,UCBPlayer
12006,UCBPlayer,130,235,365,24,53,UCBPlayer
12007,UCBPlayer,105,250,355,11,52,UCBPlayer
12008,UCBPlayer,122,227,349,20,57,UCBPlayer
12009,UCBPlayer,109,259,368,15,49,UCBPlayer
12010,UCBPlayer,118,218,336,16,60,UCBPlayer
12011,UCBPlayer,117,267,384,19,45,UCBPlayer
12012,UCBPlayer,110,210,320,12,64,UCBPlayer
12013,UCBPlayer,126,271,397,23,42,UCBPlayer
12014,UCBPlayer,105,210,315,10,65,UCBPlayer
12015,UCBPlayer,130,275,405,25,40,UCBPlayer
12016,UCBPlayer,105,210,315,10,65,UCBPlayer
12017,UCBPlayer,130,275,405,25,40,UCBPlayer
12018,UCBPlayer,106,206,312,10,66,UCBPlayer
12019,UCBPlayer,130,275,405,25,40,UCBPlayer
12020,UCBPlayer,105,210,315,10,65,UCBPlayer
12021,UCBPlayer,131,271,402,25,41,UCBPlayer
12022,UCBPlayer,105,210,315,10,65,UCBPlayer
12023,UCBPlayer,130,275,405,25,40,UCBPlayer
12024,UCBPlayer,105,210,315,10,65,UCBPlayer
12025,UCBPlayer,130,275,405,25,40,UCBPlayer
12026,UCBPlayer,103,203,306,10,68,UCBPlayer
12027,UCBPlayer,128,283,411,25,38,UCBPlayer
12028,UCBPlayer,111,186,297,10,71,UCBPlayer
12029,UCBPlayer,124,299,423,25,34,UCBPlayer
12030,UCBPlayer,115,170,285,10,75,UCBPlayer
12031,UCBPlayer,120,315,435,25,30,UCBPlayer
12032,UCBPlayer,119,154,273,10,79,UCBPlayer
12033,UCBPlayer,112,332,444,25,27,UCBPlayer
12034,UCBPlayer,127,137,264,10,82,UCBPlayer
12035,UCBPlayer,104,349,453,25,24,UCBPlayer
12036,UCBPlayer,126,126,252,7,85,Tie
12037,UCBPlayer,111,351,462,28,22,UCBPlayer
12038,UCBPlayer,116,126,242,3,87,UCBPlayer
12039,UCBPlayer,122,347,469,32,21,UCBPlayer
12040,UCBPlayer,107,132,239,0,87,UCBPlayer
12041,UCBPlayer,132,337,469,35,22,UCBPlayer
12042,UCBPlayer,103,148,251,0,83,UCBPlayer
12043,UCBPlayer,136,321,457,35,26,UCBPlayer
12044,UCBPlayer,99,164,263,0,79,UCBPlayer
12045,UCBPlayer,140,305,445,35,30,UCBPlayer
12046,UCBPlayer,95,180,275,0,75,UCBPlayer
12047,UCBPlayer,144,289,433,35,34,UCBPlayer
12048,UCBPlayer,91,196,287,0,71,UCBPlayer
12049,UCBPlayer,148,273,421,35,38,UCBPlayer
12050,UCBPlayer,87,212,299,0,67,UCBPlayer
12051,UCBPlayer,152,257,409,35,42,UCBPlayer
12052,UCBPlayer,84,224,308,0,64,UCBPlayer
12053,UCBPlayer,146,251,397,32,45,UCBPlayer
12054,UCBPlayer,89,234,323,3,60,UCBPlayer
12055,UCBPlayer,138,243,381,28,49,UCBPlayer
12056,UCBPlayer,97,242,339,7,56,UCBPlayer
12057,UCBPlayer,130,235,365,24,53,UCBPlayer
12058,UCBPlayer,105,250,355,11,52,UCBPlayer
12059,UCBPlayer,122,227,349,20,57,UCBPlayer
12060,UCBPlayer,109,259,368,15,49,UCBPlayer
12061,UCBPlayer,118,218,336,16,60,UCBPlayer
12062,UCBPlayer,117,267,384,19,45,UCBPlayer
12063,UCBPlayer,110,210,320,12,64,UCBPlayer
12064,UCBPlayer,126,271,397,23,42,UCBPlayer
12065,UCBPlayer,105,210,315,10,65,UCBPlayer
12066,UCBPlayer,130,275,405,25,40,UCBPlayer
12067,UCBPlayer,105,210,315,10,65,UCBPlayer
12068,UCBPlayer,130,275,405,25,40,UCBPlayer
12069,UCBPlayer,106,206,312,10,66,UCBPlayer
12070,UCBPlayer,130,275,405,25,40,UCBPlayer
12071,UCBPlayer,105,210,315,10,65,UCBPlayer
12072,UCBPlayer,131,271,402,25,41,UCBPlayer
12073,UCBPlayer,105,210,315,10,65,UCBPlayer
12074,UCBPlayer,130,275,405,25,40,UCBPlayer
12075,UCBPlayer,105,210,315,10,65,UCBPlayer
12076,UCBPlayer,130,275,405,25,40,UCBPlayer
12077,UCBPlayer,103,203,306,10,68,UCBPlayer
12078,UCBPlayer,128,283,411,25,38,UCBPlayer
12079,UCBPlayer,111,186,297,10,71,UCBPlayer
12080,UCBPlayer,124,299,423,25,34,UCBPlayer
12081,UCBPlayer,115,170,285,10,75,UCBPlayer
12082,UCBPlayer,120,315,435,25,30,UCBPlayer
12083,UCBPlayer,119,154,273,10,79,UCBPlayer
12084,UCBPlayer,112,332,444,25,27,UCBPlayer
12085,UCBPlayer,127,137,264,10,82,UCBPlayer
12086,UCBPlayer,104,349,453,25,24,UCBPlayer
12087,UCBPlayer,126,126,252,7,85,Tie
12088,UCBPlayer,111,351,462,28,22,UCBPlayer
12089,UCBPlayer,116,126,242,3,87,UCBPlayer
12090,UCBPlayer,122,347,469,32,21,UCBPlayer
12091,UCBPlayer,107,132,239,0,87,UCBPlayer
12092,UCBPlayer,132,337,469,35,22,UCBPlayer
12093,UCBPlayer,103,148,251,0,83,UCBPlayer
12094,UCBPlayer,136,321,457,35,26,UCBPlayer
12095,UCBPlayer,99,164,263,0,79,UCBPlayer
12096,UCBPlayer,140,305,445,35,30,UCBPlayer
12097,UCBPlayer,95,180,275,0,75,UCBPlayer
12098,UCBPlayer,144,289,433,35,34,UCBPlayer
12099,UCBPlayer,91,196,287,0,71,UCBPlayer
12100,UCBPlayer,148,273,421,35,38,UCBPlayer
12101,UCBPlayer,87,212,299,0,67,UCBPlayer
12102,UCBPlayer,152,257,409,35,42,UCBPlayer
12103,UCBPlayer,84,224,308,0,64,UCBPlayer
12104,UCBPlayer,146,251,397,32,45,UCBPlayer
12105,UCBPlayer,89,234,323,3,60,UCBPlayer
12106,UCBPlayer,138,243,381,28,49,UCBPlayer
12107,UCBPlayer,97,242,339,7,56,UCBPlayer
12108,UCBPlayer,130,235,365,24,53,UCBPlayer
12109,UCBPlayer,105,250,355,11,52,UCBPlayer
12110,UCBPlayer,122,227,349,20,57,UCBPlayer
12111,UCBPlayer,109,259,368,15,49,UCBPlayer
12112,UCBPlayer,118,218,336,16,60,UCBPlayer
12113,UCBPlayer,117,267,384,19,45,UCBPlayer
12114,UCBPlayer,110,210,320,12,64,UCBPlayer
12115,UCBPlayer,126,271,397,23,42,UCBPlayer
12116,UCBPlayer,105,210,315,10,65,UCBPlayer
12117,UCBPlayer,130,275,405,25,40,UCBPlayer
12118,UCBPlayer,105,210,315,10,65,UCBPlayer
12119,UCBPlayer,130,275,405,25,40,UCBPlayer
12120,UCBPlayer,106,206,312,10,66,UCBPlayer
12121,UCBPlayer,130,275,405,25,40,UCBPlayer
12122,UCBPlayer,105,210,315,10,65,UCBPlayer
12123,UCBPlayer,131,271,402,25,41,UCBPlayer
12124,UCBPlayer,105,210,315,10,65,UCBPlayer
12125,UCBPlayer,130,275,405,25,40,UCBPlayer
12126,UCBPlayer,105,210,315,10,65,UCBPlayer
12127,UCBPlayer,130,275,405,25,40,UCBPlayer
12128,UCBPlayer,103,203,306,10,68,UCBPlayer
12129,UCBPlayer,128,283,411,25,38,UCBPlayer
12130,UCBPlayer,111,186,297,10,71,UCBPlayer
12131,UCBPlayer,124,299,423,25,34,UCBPlayer
12132,UCBPlayer,115,170,285,10,75,UCBPlayer
12133,UCBPlayer,120,315,435,25,30,UCBPlayer
12134,UCBPlayer,119,154,273,10,79,UCBPlayer
12135,UCBPlayer,112,332,444,25,27,UCBPlayer
12136,UCBPlayer,127,137,264,10,82,UCBPlayer
12137,UCBPlayer,104,349,453,25,24,UCBPlayer
12138,UCBPlayer,126,126,252,7,85,Tie
12139,UCBPlayer,111,351,462,28,22,UCBPlayer
12140,UCBPlayer,116,126,242,3,87,UCBPlayer
12141,UCBPlayer,122,347,469,32,21,UCBPlayer
12142,UCBPlayer,107,132,239,0,87,UCBPlayer
12143,UCBPlayer,132,337,469,35,22,UCBPlayer
12144,UCBPlayer,103,148,251,0,83,UCBPlayer
12145,UCBPlayer,136,321,457,35,26,UCBPlayer
12146,UCBPlayer,99,164,263,0,79,UCBPlayer
12147,UCBPlayer,140,305,445,35,30,UCBPlayer
12148,UCBPlayer,95,180,275,0,75,UCBPlayer
12149,UCBPlayer,144,289,433,35,34,UCBPlayer
12150,UCBPlayer,91,196,287,0,71,UCBPlayer
12151,UCBPlayer,148,273,421,35,38,UCBPlayer
12152,UCBPlayer,87,212,299,0,67,UCBPlayer
12153,UCBPlayer,152,257,409,35,42,UCBPlayer
12154,UCBPlayer,84,224,308,0,64,UCBPlayer
12155,UCBPlayer,146,251,397,32,45,UCBPlayer
12156,UCBPlayer,89,234,323,3,60,UCBPlayer
12157,UCBPlayer,138,243,381,28,49,UCBPlayer
12158,UCBPlayer,97,242,339,7,56,UCBPlayer
12159,UCBPlayer,130,235,365,24,53,UCBPlayer
12160,UCBPlayer,105,250,355,11,52,UCBPlayer
12161,UCBPlayer,122,227,349,20,57,UCBPlayer
12162,UCBPlayer,109,259,368,15,49,UCBPlayer
12163,UCBPlayer,118,218,336,16,60,UCBPlayer
12164,UCBPlayer,117,267,384,19,45,UCBPlayer
12165,UCBPlayer,110,210,320,12,64,UCBPlayer
12166,UCBPlayer,126,271,397,23,42,UCBPlayer
12167,UCBPlayer,105,210,315,10,65,UCBPlayer
12168,UCBPlayer,130,275,405,25,40,UCBPlayer
12169,UCBPlayer,105,210,315,10,65,UCBPlayer
12170,UCBPlayer,130,275,405,25,40,UCBPlayer
12171,UCBPlayer,106,206,312,10,66,UCBPlayer
12172,UCBPlayer,130,275,405,25,40,UCBPlayer
12173,UCBPlayer,105,210,315,10,65,UCBPlayer
12174,UCBPlayer,131,271,402,25,41,UCBPlayer
12175,UCBPlayer,105,210,315,10,65,UCBPlayer
12176,UCBPlayer,130,275,405,25,40,UCBPlayer
12177,UCBPlayer,105,210,315,10,65,UCBPlayer
12178,UCBPlayer,130,275,405,25,40,UCBPlayer
12179,UCBPlayer,103,203,306,10,68,UCBPlayer
12180,UCBPlayer,128,283,411,25,38,UCBPlayer
12181,UCBPlayer,111,186,297,10,71,UCBPlayer
12182,UCBPlayer,124,299,423,25,34,UCBPlayer
12183,UCBPlayer,115,170,285,10,75,UCBPlayer
12184,UCBPlayer,120,315,435,25,30,UCBPlayer
12185,UCBPlayer,119,154,273,10,79,UCBPlayer
12186,UCBPlayer,112,332,444,25,27,UCBPlayer
12187,UCBPlayer,127,137,264,10,82,UCBPlayer
12188,UCBPlayer,104,349,453,25,24,UCBPlayer
12189,UCBPlayer,126,126,252,7,85,Tie
12190,UCBPlayer,111,351,462,28,22,UCBPlayer
12191,UCBPlayer,116,126,242,3,87,UCBPlayer
12192,UCBPlayer,122,347,469,32,21,UCBPlayer
12193,UCBPlayer,107,132,239,0,87,UCBPlayer
12194,UCBPlayer,132,337,469,35,22,UCBPlayer
12195,UCBPlayer,103,148,251,0,83,UCBPlayer
12196,UCBPlayer,136,321,457,35,26,UCBPlayer
12197,UCBPlayer,99,164,263,0,79,UCBPlayer
12198,UCBPlayer,140,305,445,35,30,UCBPlayer
12199,UCBPlayer,95,180,275,0,75,UCBPlayer
12200,UCBPlayer,144,289,433,35,34,UCBPlayer
12201,UCBPlayer,91,196,287,0,71,UCBPlayer
12202,UCBPlayer,148,273,421,35,38,UCBPlayer
12203,UCBPlayer,87,212,299,0,67,UCBPlayer
12204,UCBPlayer,152,257,409,35,42,UCBPlayer
12205,UCBPlayer,84,224,308,0,64,UCBPlayer
12206,UCBPlayer,146,251,397,32,45,UCBPlayer
12207,UCBPlayer,89,234,323,3,60,UCBPlayer
12208,UCBPlayer,138,243,381,28,49,UCBPlayer
12209,UCBPlayer,97,242,339,7,56,UCBPlayer
12210,UCBPlayer,130,235,365,24,53,UCBPlayer
12211,UCBPlayer,105,250,355,11,52,UCBPlayer
12212,UCBPlayer,122,227,349,20,57,UCBPlayer
12213,UCBPlayer,109,259,368,15,49,UCBPlayer
12214,UCBPlayer,118,218,336,16,60,UCBPlayer
12215,UCBPlayer,117,267,384,19,45,UCBPlayer
12216,UCBPlayer,110,210,320,12,64,UCBPlayer
12217,UCBPlayer,126,271,397,23,42,UCBPlayer
12218,UCBPlayer,105,210,315,10,65,UCBPlayer
12219,UCBPlayer,130,275,405,25,40,UCBPlayer
12220,UCBPlayer,105,210,315,10,65,UCBPlayer
12221,UCBPlayer,130,275,405,25,40,UCBPlayer
12222,UCBPlayer,106,206,312,10,66,UCBPlayer
12223,UCBPlayer,130,275,405,25,40,UCBPlayer
12224,UCBPlayer,105,210,315,10,65,UCBPlayer
12225,UCBPlayer,131,271,402,25,41,UCBPlayer
12226,UCBPlayer,105,210,315,10,65,UCBPlayer
12227,UCBPlayer,130,275,405,25,40,UCBPlayer
12228,UCBPlayer,105,210,315,10,65,UCBPlayer
12229,UCBPlayer,130,275,405,25,40,UCBPlayer
12230,UCBPlayer,103,203,306,10,68,UCBPlayer
12231,UCBPlayer,128,283,411,25,38,UCBPlayer
12232,UCBPlayer,111,186,297,10,71,UCBPlayer
12233,UCBPlayer,124,299,423,25,34,UCBPlayer
12234,UCBPlayer,115,170,285,10,75,UCBPlayer
12235,UCBPlayer,120,315,435,25,30,UCBPlayer
12236,UCBPlayer,119,154,273,10,79,UCBPlayer
12237,UCBPlayer,112,332,444,25,27,UCBPlayer
12238,UCBPlayer,127,137,264,10,82,UCBPlayer
12239,UCBPlayer,104,349,453,25,24,UCBPlayer
12240,UCBPlayer,126,126,252,7,85,Tie
12241,UCBPlayer,111,351,462,28,22,UCBPlayer
12242,UCBPlayer,116,126,242,3,87,UCBPlayer
12243,UCBPlayer,122,347,469,32,21,UCBPlayer
12244,UCBPlayer,107,132,239,0,87,UCBPlayer
12245,UCBPlayer,132,337,469,35,22,UCBPlayer
12246,UCBPlayer,103,148,251,0,83,UCBPlayer
12247,UCBPlayer,136,321,457,35,26,UCBPlayer
12248,UCBPlayer,99,164,263,0,79,UCBPlayer
12249,UCBPlayer,140,305,445,35,30,UCBPlayer
12250,UCBPlayer,95,180,275,0,75,UCBPlayer
12251,UCBPlayer,144,289,433,35,34,UCBPlayer
12252,UCBPlayer,91,196,287,0,71,UCBPlayer
12253,UCBPlayer,148,273,421,35,38,UCBPlayer
12254,UCBPlayer,87,212,299,0,67,UCBPlayer
12255,UCBPlayer,152,257,409,35,42,UCBPlayer
12256,UCBPlayer,84,224,308,0,64,UCBPlayer
12257,UCBPlayer,146,251,397,32,45,UCBPlayer
12258,UCBPlayer,89,234,323,3,60,UCBPlayer
12259,UCBPlayer,138,243,381,28,49,UCBPlayer
12260,UCBPlayer,97,242,339,7,56,UCBPlayer
12261,UCBPlayer,130,235,365,24,53,UCBPlayer
12262,UCBPlayer,105,250,355,11,52,UCBPlayer
12263,UCBPlayer,122,227,349,20,57,UCBPlayer
12264,UCBPlayer,109,259,368,15,49,UCBPlayer
12265,UCBPlayer,118,218,336,16,60,UCBPlayer
12266,UCBPlayer,117,267,384,19,45,UCBPlayer
12267,UCBPlayer,110,210,320,12,64,UCBPlayer
12268,UCBPlayer,126,271,397,23,42,UCBPlayer
12269,UCBPlayer,105,210,315,10,65,UCBPlayer
12270,UCBPlayer,130,275,405,25,40,UCBPlayer
12271,UCBPlayer,105,210,315,10,65,UCBPlayer
12272,UCBPlayer,130,275,405,25,40,UCBPlayer
12273,UCBPlayer,106,206,312,10,66,UCBPlayer
12274,UCBPlayer,130,275,405,25,40,UCBPlayer
12275,UCBPlayer,105,210,315,10,65,UCBPlayer
12276,UCBPlayer,131,271,402,25,41,UCBPlayer
12277,UCBPlayer,105,210,315,10,65,UCBPlayer
12278,UCBPlayer,130,275,405,25,40,UCBPlayer
12279,UCBPlayer,105,210,315,10,65,UCBPlayer
12280,UCBPlayer,130,275,405,25,40,UCBPlayer
12281,UCBPlayer,103,203,306,10,68,UCBPlayer
12282,UCBPlayer,128,283,411,25,38,UCBPlayer
12283,UCBPlayer,111,186,297,10,71,UCBPlayer
12284,UCBPlayer,124,299,423,25,34,UCBPlayer
12285,UCBPlayer,115,170,285,10,75,UCBPlayer
12286,UCBPlayer,120,315,435,25,30,UCBPlayer
12287,UCBPlayer,119,154,273,10,79,UCBPlayer
12288,UCBPlayer,112,332,444,25,27,UCBPlayer
12289,UCBPlayer,127,137,264,10,82,UCBPlayer
12290,UCBPlayer,104,349,453,25,24,UCBPlayer
12291,UCBPlayer,126,126,252,7,85,Tie
12292,UCBPlayer,111,351,462,28,22,UCBPlayer
12293,UCBPlayer,116,126,242,3,87,UCBPlayer
12294,UCBPlayer,122,347,469,32,21,UCBPlayer
12295,UCBPlayer,107,132,239,0,87,UCBPlayer
12296,UCBPlayer,132,337,469,35,22,UCBPlayer
12297,UCBPlayer,103,148,251,0,83,UCBPlayer
12298,UCBPlayer,136,321,457,35,26,UCBPlayer
12299,UCBPlayer,99,164,263,0,79,UCBPlayer
12300,UCBPlayer,140,305,445,35,30,UCBPlayer
12301,UCBPlayer,95,180,275,0,75,UCBPlayer
12302,UCBPlayer,144,289,433,35,34,UCBPlayer
12303,UCBPlayer,91,196,287,0,71,UCBPlayer
12304,UCBPlayer,148,273,421,35,38,UCBPlayer
12305,UCBPlayer,87,212,299,0,67,UCBPlayer
12306,UCBPlayer,152,257,409,35,42,UCBPlayer
12307,UCBPlayer,84,224,308,0,64,UCBPlayer
12308,UCBPlayer,146,251,397,32,45,UCBPlayer
12309,UCBPlayer,89,234,323,3,60,UCBPlayer
12310,UCBPlayer,138,243,381,28,49,UCBPlayer
12311,UCBPlayer,97,242,339,7,56,UCBPlayer
12312,UCBPlayer,130,235,365,24,53,UCBPlayer
12313,UCBPlayer,105,250,355,11,52,UCBPlayer
12314,UCBPlayer,122,227,349,20,57,UCBPlayer
12315,UCBPlayer,109,259,368,15,49,UCBPlayer
12316,UCBPlayer,118,218,336,16,60,UCBPlayer
12317,UCBPlayer,117,267,384,19,45,UCBPlayer
12318,UCBPlayer,110,210,320,12,64,UCBPlayer
12319,UCBPlayer,126,271,397,23,42,UCBPlayer
12320,UCBPlayer,105,210,315,10,65,UCBPlayer
12321,UCBPlayer,130,275,405,25,40,UCBPlayer
12322,UCBPlayer,105,210,315,10,65,UCBPlayer
12323,UCBPlayer,130,275,405,25,40,UCBPlayer
12324,UCBPlayer,106,206,312,10,66,UCBPlayer
12325,UCBPlayer,130,275,405,25,40,UCBPlayer
12326,UCBPlayer,105,210,315,10,65,UCBPlayer
12327,UCBPlayer,131,271,402,25,41,UCBPlayer
12328,UCBPlayer,105,210,315,10,65,UCBPlayer
12329,UCBPlayer,130,275,405,25,40,UCBPlayer
12330,UCBPlayer,105,210,315,10,65,UCBPlayer
12331,UCBPlayer,130,275,405,25,40,UCBPlayer
12332,UCBPlayer,103,203,306,10,68,UCBPlayer
12333,UCBPlayer,128,283,411,25,38,UCBPlayer
12334,UCBPlayer,111,186,297,10,71,UCBPlayer
12335,UCBPlayer,124,299,423,25,34,UCBPlayer
12336,UCBPlayer,115,170,285,10,75,UCBPlayer
12337,UCBPlayer,120,315,435,25,30,UCBPlayer
12338,UCBPlayer,119,154,273,10,79,UCBPlayer
12339,UCBPlayer,112,332,444,25,27,UCBPlayer
12340,UCBPlayer,127,137,264,10,82,UCBPlayer
12341,UCBPlayer,104,349,453,25,24,UCBPlayer
12342,UCBPlayer,126,126,252,7,85,Tie
12343,UCBPlayer,111,351,462,28,22,UCBPlayer
12344,UCBPlayer,116,126,242,3,87,UCBPlayer
12345,UCBPlayer,122,347,469,32,21,UCBPlayer
12346,UCBPlayer,107,132,239,0,87,UCBPlayer
12347,UCBPlayer,132,337,469,35,22,UCBPlayer
12348,UCBPlayer,103,148,251,0,83,UCBPlayer
12349,UCBPlayer,136,321,457,35,26,UCBPlayer
12350,UCBPlayer,99,164,263,0,79,UCBPlayer
12351,UCBPlayer,140,305,445,35,30,UCBPlayer
12352,UCBPlayer,95,180,275,0,75,UCBPlayer
12353,UCBPlayer,144,289,433,35,34,UCBPlayer
12354,UCBPlayer,91,196,287,0,71,UCBPlayer
12355,UCBPlayer,148,273,421,35,38,UCBPlayer
12356,UCBPlayer,87,212,299,0,67,UCBPlayer
12357,UCBPlayer,152,257,409,35,42,UCBPlayer
12358,UCBPlayer,84,224,308,0,64,UCBPlayer
12359,UCBPlayer,146,251,397,32,45,UCBPlayer
12360,UCBPlayer,89,234,323,3,60,UCBPlayer
12361,UCBPlayer,138,243,381,28,49,UCBPlayer
12362,UCBPlayer,97,242,339,7,56,UCBPlayer
12363,UCBPlayer,130,235,365,24,53,UCBPlayer
12364,UCBPlayer,105,250,355,11,52,UCBPlayer
12365,UCBPlayer,122,227,349,20,57,UCBPlayer
12366,UCBPlayer,109,259,368,15,49,UCBPlayer
12367,UCBPlayer,118,218,336,16,60,UCBPlayer
12368,UCBPlayer,117,267,384,19,45,UCBPlayer
12369,UCBPlayer,110,210,320,12,64,UCBPlayer
12370,UCBPlayer,126,271,397,23,42,UCBPlayer
12371,UCBPlayer,105,210,315,10,65,UCBPlayer
12372,UCBPlayer,130,275,405,25,40,UCBPlayer
12373,UCBPlayer,105,210,315,10,65,UCBPlayer
12374,UCBPlayer,130,275,405,25,40,UCBPlayer
12375,UCBPlayer,106,206,312,10,66,UCBPlayer
12376,UCBPlayer,130,275,405,25,40,UCBPlayer
12377,UCBPlayer,105,210,315,10,65,UCBPlayer
12378,UCBPlayer,131,271,402,25,41,UCBPlayer
12379,UCBPlayer,105,210,315,10,65,UCBPlayer
12380,UCBPlayer,130,275,405,25,40,UCBPlayer
12381,UCBPlayer,105,210,315,10,65,UCBPlayer
12382,UCBPlayer,130,275,405,25,40,UCBPlayer
12383,UCBPlayer,103,203,306,10,68,UCBPlayer
12384,UCBPlayer,128,283,411,25,38,UCBPlayer
12385,UCBPlayer,111,186,297,10,71,UCBPlayer
12386,UCBPlayer,124,299,423,25,34,UCBPlayer
12387,UCBPlayer,115,170,285,10,75,UCBPlayer
12388,UCBPlayer,120,315,435,25,30,UCBPlayer
12389,UCBPlayer,119,154,273,10,79,UCBPlayer
12390,UCBPlayer,112,332,444,25,27,UCBPlayer
12391,UCBPlayer,127,137,264,10,82,UCBPlayer
12392,UCBPlayer,104,349,453,25,24,UCBPlayer
12393,UCBPlayer,126,126,252,7,85,Tie
12394,UCBPlayer,111,351,462,28,22,UCBPlayer
12395,UCBPlayer,116,126,242,3,87,UCBPlayer
12396,UCBPlayer,122,347,469,32,21,UCBPlayer
12397,UCBPlayer,107,132,239,0,87,UCBPlayer
12398,UCBPlayer,132,337,469,35,22,UCBPlayer
12399,UCBPlayer,103,148,251,0,83,UCBPlayer
12400,UCBPlayer,136,321,457,35,26,UCBPlayer
12401,UCBPlayer,99,164,263,0,79,UCBPlayer
12402,UCBPlayer,140,305,445,35,30,UCBPlayer
12403,UCBPlayer,95,180,275,0,75,UCBPlayer
12404,UCBPlayer,144,289,433,35,34,UCBPlayer
12405,UCBPlayer,91,196,287,0,71,UCBPlayer
12406,UCBPlayer,148,273,421,35,38,UCBPlayer
12407,UCBPlayer,87,212,299,0,67,UCBPlayer
12408,UCBPlayer,152,257,409,35,42,UCBPlayer
12409,UCBPlayer,84,224,308,0,64,UCBPlayer
12410,UCBPlayer,146,251,397,32,45,UCBPlayer
12411,UCBPlayer,89,234,323,3,60,UCBPlayer
12412,UCBPlayer,138,243,381,28,49,UCBPlayer
12413,UCBPlayer,97,242,339,7,56,UCBPlayer
12414,UCBPlayer,130,235,365,24,53,UCBPlayer
12415,UCBPlayer,105,250,355,11,52,UCBPlayer
12416,UCBPlayer,122,227,349,20,57,UCBPlayer
12417,UCBPlayer,109,259,368,15,49,UCBPlayer
12418,UCBPlayer,118,218,336,16,60,UCBPlayer
12419,UCBPlayer,117,267,384,19,45,UCBPlayer
12420,UCBPlayer,110,210,320,12,64,UCBPlayer
12421,UCBPlayer,126,271,397,23,42,UCBPlayer
12422,UCBPlayer,105,210,315,10,65,UCBPlayer
12423,UCBPlayer,130,275,405,25,40,UCBPlayer
12424,UCBPlayer,105,210,315,10,65,UCBPlayer
12425,UCBPlayer,130,275,405,25,40,UCBPlayer
12426,UCBPlayer,106,206,312,10,66,UCBPlayer
12427,UCBPlayer,130,275,405,25,40,UCBPlayer
12428,UCBPlayer,105,210,315,10,65,UCBPlayer
12429,UCBPlayer,131,271,402,25,41,UCBPlayer
12430,UCBPlayer,105,210,315,10,65,UCBPlayer
12431,UCBPlayer,130,275,405,25,40,UCBPlayer
12432,UCBPlayer,105,210,315,10,65,UCBPlayer
12433,UCBPlayer,130,275,405,25,40,UCBPlayer
12434,UCBPlayer,103,203,306,10,68,UCBPlayer
12435,UCBPlayer,128,283,411,25,38,UCBPlayer
12436,UCBPlayer,111,186,297,10,71,UCBPlayer
12437,UCBPlayer,124,299,423,25,34,UCBPlayer
12438,UCBPlayer,115,170,285,10,75,UCBPlayer
12439,UCBPlayer,120,315,435,25,30,UCBPlayer
12440,UCBPlayer,119,154,273,10,79,UCBPlayer
12441,UCBPlayer,112,332,444,25,27,UCBPlayer
12442,UCBPlayer,127,137,264,10,82,UCBPlayer
12443,UCBPlayer,104,349,453,25,24,UCBPlayer
12444,UCBPlayer,126,126,252,7,85,Tie
12445,UCBPlayer,111,351,462,28,22,UCBPlayer
12446,UCBPlayer,116,126,242,3,87,UCBPlayer
12447,UCBPlayer,122,347,469,32,21,UCBPlayer
12448,UCBPlayer,107,132,239,0,87,UCBPlayer
12449,UCBPlayer,132,337,469,35,22,UCBPlayer
12450,UCBPlayer,103,148,251,0,83,UCBPlayer
12451,UCBPlayer,136,321,457,35,26,UCBPlayer
12452,UCBPlayer,99,164,263,0,79,UCBPlayer
12453,UCBPlayer,140,305,445,35,30,UCBPlayer
12454,UCBPlayer,95,180,275,0,75,UCBPlayer
12455,UCBPlayer,144,289,433,35,34,UCBPlayer
12456,UCBPlayer,91,196,287,0,71,UCBPlayer
12457,UCBPlayer,148,273,421,35,38,UCBPlayer
12458,UCBPlayer,87,212,299,0,67,UCBPlayer
12459,UCBPlayer,152,257,409,35,42,UCBPlayer
12460,UCBPlayer,84,224,308,0,64,UCBPlayer
12461,UCBPlayer,146,251,397,32,45,UCBPlayer
12462,UCBPlayer,89,234,323,3,60,UCBPlayer
12463,UCBPlayer,138,243,381,28,49,UCBPlayer
12464,UCBPlayer,97,242,339,7,56,UCBPlayer
12465,UCBPlayer,130,235,365,24,53,UCBPlayer
12466,UCBPlayer,105,250,355,11,52,UCBPlayer
12467,UCBPlayer,122,227,349,20,57,UCBPlayer
12468,UCBPlayer,109,259,368,15,49,UCBPlayer
12469,UCBPlayer,118,218,336,16,60,UCBPlayer
12470,UCBPlayer,117,267,384,19,45,UCBPlayer
12471,UCBPlayer,110,210,320,12,64,UCBPlayer
12472,UCBPlayer,126,271,397,23,42,UCBPlayer
12473,UCBPlayer,105,210,315,10,65,UCBPlayer
12474,UCBPlayer,130,275,405,25,40,UCBPlayer
12475,UCBPlayer,105,210,315,10,65,UCBPlayer
12476,UCBPlayer,130,275,405,25,40,UCBPlayer
12477,UCBPlayer,106,206,312,10,66,UCBPlayer
12478,UCBPlayer,130,275,405,25,40,UCBPlayer
12479,UCBPlayer,105,210,315,10,65,UCBPlayer
12480,UCBPlayer,131,271,402,25,41,UCBPlayer
12481,UCBPlayer,105,210,315,10,65,UCBPlayer
12482,UCBPlayer,130,275,405,25,40,UCBPlayer
12483,UCBPlayer,105,210,315,10,65,UCBPlayer
12484,UCBPlayer,130,275,405,25,40,UCBPlayer
12485,UCBPlayer,103,203,306,10,68,UCBPlayer
12486,UCBPlayer,128,283,411,25,38,UCBPlayer
12487,UCBPlayer,111,186,297,10,71,UCBPlayer
12488,UCBPlayer,124,299,423,25,34,UCBPlayer
12489,UCBPlayer,115,170,285,10,75,UCBPlayer
12490,UCBPlayer,120,315,435,25,30,UCBPlayer
12491,UCBPlayer,119,154,273,10,79,UCBPlayer
12492,UCBPlayer,112,332,444,25,27,UCBPlayer
12493,UCBPlayer,127,137,264,10,82,UCBPlayer
12494,UCBPlayer,104,349,453,25,24,UCBPlayer
12495,UCBPlayer,126,126,252,7,85,Tie
12496,UCBPlayer,111,351,462,28,22,UCBPlayer
12497,UCBPlayer,116,126,242,3,87,UCBPlayer
12498,UCBPlayer,122,347,469,32,21,UCBPlayer
12499,UCBPlayer,107,132,239,0,87,UCBPlayer
12500,UCBPlayer,132,337,469,35,22,UCBPlayer
12501,UCBPlayer,103,148,251,0,83,UCBPlayer
12502,UCBPlayer,136,321,457,35,26,UCBPlayer
12503,UCBPlayer,99,164,263,0,79,UCBPlayer
12504,UCBPlayer,140,305,445,35,30,UCBPlayer
12505,UCBPlayer,95,180,275,0,75,UCBPlayer
12506,UCBPlayer,144,289,433,35,34,UCBPlayer
12507,UCBPlayer,91,196,287,0,71,UCBPlayer
12508,UCBPlayer,148,273,421,35,38,UCBPlayer
12509,UCBPlayer,87,212,299,0,67,UCBPlayer
12510,UCBPlayer,152,257,409,35,42,UCBPlayer
12511,UCBPlayer,84,224,308,0,64,UCBPlayer
12512,UCBPlayer,146,251,397,32,45,UCBPlayer
12513,UCBPlayer,89,234,323,3,60,UCBPlayer
12514,UCBPlayer,138,243,381,28,49,UCBPlayer
12515,UCBPlayer,97,242,339,7,56,UCBPlayer
12516,UCBPlayer,130,235,365,24,53,UCBPlayer
12517,UCBPlayer,105,250,355,11,52,UCBPlayer
12518,UCBPlayer,122,227,349,20,57,UCBPlayer
12519,UCBPlayer,109,259,368,15,49,UCBPlayer
12520,UCBPlayer,118,218,336,16,60,UCBPlayer
12521,UCBPlayer,117,267,384,19,45,UCBPlayer
12522,UCBPlayer,110,210,320,12,64,UCBPlayer
12523,UCBPlayer,126,271,397,23,42,UCBPlayer
12524,UCBPlayer,105,210,315,10,65,UCBPlayer
12525,UCBPlayer,130,275,405,25,40,UCBPlayer
12526,UCBPlayer,105,210,315,10,65,UCBPlayer
12527,UCBPlayer,130,275,405,25,40,UCBPlayer
12528,UCBPlayer,106,206,312,10,66,UCBPlayer
12529,UCBPlayer,130,275,405,25,40,UCBPlayer
12530,UCBPlayer,105,210,315,10,65,UCBPlayer
12531,UCBPlayer,131,271,402,25,41,UCBPlayer
12532,UCBPlayer,105,210,315,10,65,UCBPlayer
12533,UCBPlayer,130,275,405,25,40,UCBPlayer
12534,UCBPlayer,105,210,315,10,65,UCBPlayer
12535,UCBPlayer,130,275,405,25,40,UCBPlayer
12536,UCBPlayer,103,203,306,10,68,UCBPlayer
12537,UCBPlayer,128,283,411,25,38,UCBPlayer
12538,UCBPlayer,111,186,297,10,71,UCBPlayer
12539,UCBPlayer,124,299,423,25,34,UCBPlayer
12540,UCBPlayer,115,170,285,10,75,UCBPlayer
12541,UCBPlayer,120,315,435,25,30,UCBPlayer
12542,UCBPlayer,119,154,273,10,79,UCBPlayer
12543,UCBPlayer,112,332,444,25,27,UCBPlayer
12544,UCBPlayer,127,137,264,10,82,UCBPlayer
12545,UCBPlayer,104,349,453,25,24,UCBPlayer
12546,UCBPlayer,126,126,252,7,85,Tie
12547,UCBPlayer,111,351,462,28,22,UCBPlayer
12548,UCBPlayer,116,126,242,3,87,UCBPlayer
12549,UCBPlayer,122,347,469,32,21,UCBPlayer
12550,UCBPlayer,107,132,239,0,87,UCBPlayer
12551,UCBPlayer,132,337,469,35,22,UCBPlayer
12552,UCBPlayer,103,148,251,0,83,UCBPlayer
12553,UCBPlayer,136,321,457,35,26,UCBPlayer
12554,UCBPlayer,99,164,263,0,79,UCBPlayer
12555,UCBPlayer,140,305,445,35,30,UCBPlayer
12556,UCBPlayer,95,180,275,0,75,UCBPlayer
12557,UCBPlayer,144,289,433,35,34,UCBPlayer
12558,UCBPlayer,91,196,287,0,71,UCBPlayer
12559,UCBPlayer,148,273,421,35,38,UCBPlayer
12560,UCBPlayer,87,212,299,0,67,UCBPlayer
12561,UCBPlayer,152,257,409,35,42,UCBPlayer
12562,UCBPlayer,84,224,308,0,64,UCBPlayer
12563,UCBPlayer,146,251,397,32,45,UCBPlayer
12564,UCBPlayer,89,234,323,3,60,UCBPlayer
12565,UCBPlayer,138,243,381,28,49,UCBPlayer
12566,UCBPlayer,97,242,339,7,56,UCBPlayer
12567,UCBPlayer,130,235,365,24,53,UCBPlayer
12568,UCBPlayer,105,250,355,11,52,UCBPlayer
12569,UCBPlayer,122,227,349,20,57,UCBPlayer
12570,UCBPlayer,109,259,368,15,49,UCBPlayer
12571,UCBPlayer,118,218,336,16,60,UCBPlayer
12572,UCBPlayer,117,267,384,19,45,UCBPlayer
12573,UCBPlayer,110,210,320,12,64,UCBPlayer
12574,UCBPlayer,126,271,397,23,42,UCBPlayer
12575,UCBPlayer,105,210,315,10,65,UCBPlayer
12576,UCBPlayer,130,275,405,25,40,UCBPlayer
12577,UCBPlayer,105,210,315,10,65,UCBPlayer
12578,UCBPlayer,130,275,405,25,40,UCBPlayer
12579,UCBPlayer,106,206,312,10,66,UCBPlayer
12580,UCBPlayer,130,275,405,25,40,UCBPlayer
12581,UCBPlayer,105,210,315,10,65,UCBPlayer
12582,UCBPlayer,131,271,402,25,41,UCBPlayer
12583,UCBPlayer,105,210,315,10,65,UCBPlayer
12584,UCBPlayer,130,275,405,25,40,UCBPlayer
12585,UCBPlayer,105,210,315,10,65,UCBPlayer
12586,UCBPlayer,130,275,405,25,40,UCBPlayer
12587,UCBPlayer,103,203,306,10,68,UCBPlayer
12588,UCBPlayer,128,283,411,25,38,UCBPlayer
12589,UCBPlayer,111,186,297,10,71,UCBPlayer
12590,UCBPlayer,124,299,423,25,34,UCBPlayer
12591,UCBPlayer,115,170,285,10,75,UCBPlayer
12592,UCBPlayer,120,315,435,25,30,UCBPlayer
12593,UCBPlayer,119,154,273,10,79,UCBPlayer
12594,UCBPlayer,112,332,444,25,27,UCBPlayer
12595,UCBPlayer,127,137,264,10,82,UCBPlayer
12596,UCBPlayer,104,349,453,25,24,UCBPlayer
12597,UCBPlayer,126,126,252,7,85,Tie
12598,UCBPlayer,111,351,462,28,22,UCBPlayer
12599,UCBPlayer,116,126,242,3,87,UCBPlayer
12600,UCBPlayer,122,347,469,32,21,UCBPlayer
12601,UCBPlayer,107,132,239,0,87,UCBPlayer
12602,UCBPlayer,132,337,469,35,22,UCBPlayer
12603,UCBPlayer,103,148,251,0,83,UCBPlayer
12604,UCBPlayer,136,321,457,35,26,UCBPlayer
12605,UCBPlayer,99,164,263,0,79,UCBPlayer
12606,UCBPlayer,140,305,445,35,30,UCBPlayer
12607,UCBPlayer,95,180,275,0,75,UCBPlayer
12608,UCBPlayer,144,289,433,35,34,UCBPlayer
12609,UCBPlayer,91,196,287,0,71,UCBPlayer
12610,UCBPlayer,148,273,421,35,38,UCBPlayer
12611,UCBPlayer,87,212,299,0,67,UCBPlayer
12612,UCBPlayer,152,257,409,35,42,UCBPlayer
12613,UCBPlayer,84,224,308,0,64,UCBPlayer
12614,UCBPlayer,146,251,397,32,45,UCBPlayer
12615,UCBPlayer,89,234,323,3,60,UCBPlayer
12616,UCBPlayer,138,243,381,28,49,UCBPlayer
12617,UCBPlayer,97,242,339,7,56,UCBPlayer
12618,UCBPlayer,130,235,365,24,53,UCBPlayer
12619,UCBPlayer,105,250,355,11,52,UCBPlayer
12620,UCBPlayer,122,227,349,20,57,UCBPlayer
12621,UCBPlayer,109,259,368,15,49,UCBPlayer
12622,UCBPlayer,118,218,336,16,60,UCBPlayer
12623,UCBPlayer,117,267,384,19,45,UCBPlayer
12624,UCBPlayer,110,210,320,12,64,UCBPlayer
12625,UCBPlayer,126,271,397,23,42,UCBPlayer
12626,UCBPlayer,105,210,315,10,65,UCBPlayer
12627,UCBPlayer,130,275,405,25,40,UCBPlayer
12628,UCBPlayer,105,210,315,10,65,UCBPlayer
12629,UCBPlayer,130,275,405,25,40,UCBPlayer
12630,UCBPlayer,106,206,312,10,66,UCBPlayer
12631,UCBPlayer,130,275,405,25,40,UCBPlayer
12632,UCBPlayer,105,210,315,10,65,UCBPlayer
12633,UCBPlayer,131,271,402,25,41,UCBPlayer
12634,UCBPlayer,105,210,315,10,65,UCBPlayer
12635,UCBPlayer,130,275,405,25,40,UCBPlayer
12636,UCBPlayer,105,210,315,10,65,UCBPlayer
12637,UCBPlayer,130,275,405,25,40,UCBPlayer
12638,UCBPlayer,103,203,306,10,68,UCBPlayer
12639,UCBPlayer,128,283,411,25,38,UCBPlayer
12640,UCBPlayer,111,186,297,10,71,UCBPlayer
12641,UCBPlayer,124,299,423,25,34,UCBPlayer
12642,UCBPlayer,115,170,285,10,75,UCBPlayer
12643,UCBPlayer,120,315,435,25,30,UCBPlayer
12644,UCBPlayer,119,154,273,10,79,UCBPlayer
12645,UCBPlayer,112,332,444,25,27,UCBPlayer
12646,UCBPlayer,127,137,264,10,82,UCBPlayer
12647,UCBPlayer,104,349,453,25,24,UCBPlayer
12648,UCBPlayer,126,126,252,7,85,Tie
12649,UCBPlayer,111,351,462,28,22,UCBPlayer
12650,UCBPlayer,116,126,242,3,87,UCBPlayer
12651,UCBPlayer,122,347,469,32,21,UCBPlayer
12652,UCBPlayer,107,132,239,0,87,UCBPlayer
12653,UCBPlayer,132,337,469,35,22,UCBPlayer
12654,UCBPlayer,103,148,251,0,83,UCBPlayer
12655,UCBPlayer,136,321,457,35,26,UCBPlayer
12656,UCBPlayer,99,164,263,0,79,UCBPlayer
12657,UCBPlayer,140,305,445,35,30,UCBPlayer
12658,UCBPlayer,95,180,275,0,75,UCBPlayer
12659,UCBPlayer,144,289,433,35,34,UCBPlayer
12660,UCBPlayer,91,196,287,0,71,UCBPlayer
12661,UCBPlayer,148,273,421,35,38,UCBPlayer
12662,UCBPlayer,87,212,299,0,67,UCBPlayer
12663,UCBPlayer,152,257,409,35,42,UCBPlayer
12664,UCBPlayer,84,224,308,0,64,UCBPlayer
12665,UCBPlayer,146,251,397,32,45,UCBPlayer
12666,UCBPlayer,89,234,323,3,60,UCBPlayer
12667,UCBPlayer,138,243,381,28,49,UCBPlayer
12668,UCBPlayer,97,242,339,7,56,UCBPlayer
12669,UCBPlayer,130,235,365,24,53,UCBPlayer
12670,UCBPlayer,105,250,355,11,52,UCBPlayer
12671,UCBPlayer,122,227,349,20,57,UCBPlayer
12672,UCBPlayer,109,259,368,15,49,UCBPlayer
12673,UCBPlayer,118,218,336,16,60,UCBPlayer
12674,UCBPlayer,117,267,384,19,45,UCBPlayer
12675,UCBPlayer,110,210,320,12,64,UCBPlayer
12676,UCBPlayer,126,271,397,23,42,UCBPlayer
12677,UCBPlayer,105,210,315,10,65,UCBPlayer
12678,UCBPlayer,130,275,405,25,40,UCBPlayer
12679,UCBPlayer,105,210,315,10,65,UCBPlayer
12680,UCBPlayer,130,275,405,25,40,UCBPlayer
12681,UCBPlayer,106,206,312,10,66,UCBPlayer
12682,UCBPlayer,130,275,405,25,40,UCBPlayer
12683,UCBPlayer,105,210,315,10,65,UCBPlayer
12684,UCBPlayer,131,271,402,25,41,UCBPlayer
12685,UCBPlayer,105,210,315,10,65,UCBPlayer
12686,UCBPlayer,130,275,405,25,40,UCBPlayer
12687,UCBPlayer,105,210,315,10,65,UCBPlayer
12688,UCBPlayer,130,275,405,25,40,UCBPlayer
12689,UCBPlayer,103,203,306,10,68,UCBPlayer
12690,UCBPlayer,128,283,411,25,38,UCBPlayer
12691,UCBPlayer,111,186,297,10,71,UCBPlayer
12692,UCBPlayer,124,299,423,25,34,UCBPlayer
12693,UCBPlayer,115,170,285,10,75,UCBPlayer
12694,UCBPlayer,120,315,435,25,30,UCBPlayer
12695,UCBPlayer,119,154,273,10,79,UCBPlayer
12696,UCBPlayer,112,332,444,25,27,UCBPlayer
12697,UCBPlayer,127,137,264,10,82,UCBPlayer
12698,UCBPlayer,104,349,453,25,24,UCBPlayer
12699,UCBPlayer,126,126,252,7,85,Tie
12700,UCBPlayer,111,351,462,28,22,UCBPlayer
12701,UCBPlayer,116,126,242,3,87,UCBPlayer
12702,UCBPlayer,122,347,469,32,21,UCBPlayer
12703,UCBPlayer,107,132,239,0,87,UCBPlayer
12704,UCBPlayer,132,337,469,35,22,UCBPlayer
12705,UCBPlayer,103,148,251,0,83,UCBPlayer
12706,UCBPlayer,136,321,457,35,26,UCBPlayer
12707,UCBPlayer,99,164,263,0,79,UCBPlayer
12708,UCBPlayer,140,305,445,35,30,UCBPlayer
12709,UCBPlayer,95,180,275,0,75,UCBPlayer
12710,UCBPlayer,144,289,433,35,34,UCBPlayer
12711,UCBPlayer,91,196,287,0,71,UCBPlayer
12712,UCBPlayer,148,273,421,35,38,UCBPlayer
12713,UCBPlayer,87,212,299,0,67,UCBPlayer
12714,UCBPlayer,152,257,409,35,42,UCBPlayer
12715,UCBPlayer,84,224,308,0,64,UCBPlayer
12716,UCBPlayer,146,251,397,32,45,UCBPlayer
12717,UCBPlayer,89,234,323,3,60,UCBPlayer
12718,UCBPlayer,138,243,381,28,49,UCBPlayer
12719,UCBPlayer,97,242,339,7,56,UCBPlayer
12720,UCBPlayer,130,235,365,24,53,UCBPlayer
12721,UCBPlayer,105,250,355,11,52,UCBPlayer
12722,UCBPlayer,122,227,349,20,57,UCBPlayer
12723,UCBPlayer,109,259,368,15,49,UCBPlayer
12724,UCBPlayer,118,218,336,16,60,UCBPlayer
12725,UCBPlayer,117,267,384,19,45,UCBPlayer
12726,UCBPlayer,110,210,320,12,64,UCBPlayer
12727,UCBPlayer,126,271,397,23,42,UCBPlayer
12728,UCBPlayer,105,210,315,10,65,UCBPlayer
12729,UCBPlayer,130,275,405,25,40,UCBPlayer
12730,UCBPlayer,105,210,315,10,65,UCBPlayer
12731,UCBPlayer,130,275,405,25,40,UCBPlayer
12732,UCBPlayer,106,206,312,10,66,UCBPlayer
12733,UCBPlayer,130,275,405,25,40,UCBPlayer
12734,UCBPlayer,105,210,315,10,65,UCBPlayer
12735,UCBPlayer,131,271,402,25,41,UCBPlayer
12736,UCBPlayer,105,210,315,10,65,UCBPlayer
12737,UCBPlayer,130,275,405,25,40,UCBPlayer
12738,UCBPlayer,105,210,315,10,65,UCBPlayer
12739,UCBPlayer,130,275,405,25,40,UCBPlayer
12740,UCBPlayer,103,203,306,10,68,UCBPlayer
12741,UCBPlayer,128,283,411,25,38,UCBPlayer
12742,UCBPlayer,111,186,297,10,71,UCBPlayer
12743,UCBPlayer,124,299,423,25,34,UCBPlayer
12744,UCBPlayer,115,170,285,10,75,UCBPlayer
12745,UCBPlayer,120,315,435,25,30,UCBPlayer
12746,UCBPlayer,119,154,273,10,79,UCBPlayer
12747,UCBPlayer,112,332,444,25,27,UCBPlayer
12748,UCBPlayer,127,137,264,10,82,UCBPlayer
12749,UCBPlayer,104,349,453,25,24,UCBPlayer
12750,UCBPlayer,126,126,252,7,85,Tie
12751,UCBPlayer,111,351,462,28,22,UCBPlayer
12752,UCBPlayer,116,126,242,3,87,UCBPlayer
12753,UCBPlayer,122,347,469,32,21,UCBPlayer
12754,UCBPlayer,107,132,239,0,87,UCBPlayer
12755,UCBPlayer,132,337,469,35,22,UCBPlayer
12756,UCBPlayer,103,148,251,0,83,UCBPlayer
12757,UCBPlayer,136,321,457,35,26,UCBPlayer
12758,UCBPlayer,99,164,263,0,79,UCBPlayer
12759,UCBPlayer,140,305,445,35,30,UCBPlayer
12760,UCBPlayer,95,180,275,0,75,UCBPlayer
12761,UCBPlayer,144,289,433,35,34,UCBPlayer
12762,UCBPlayer,91,196,287,0,71,UCBPlayer
12763,UCBPlayer,148,273,421,35,38,UCBPlayer
12764,UCBPlayer,87,212,299,0,67,UCBPlayer
12765,UCBPlayer,152,257,409,35,42,UCBPlayer
12766,UCBPlayer,84,224,308,0,64,UCBPlayer
12767,UCBPlayer,146,251,397,32,45,UCBPlayer
12768,UCBPlayer,89,234,323,3,60,UCBPlayer
12769,UCBPlayer,138,243,381,28,49,UCBPlayer
12770,UCBPlayer,97,242,339,7,56,UCBPlayer
12771,UCBPlayer,130,235,365,24,53,UCBPlayer
12772,UCBPlayer,105,250,355,11,52,UCBPlayer
12773,UCBPlayer,122,227,349,20,57,UCBPlayer
12774,UCBPlayer,109,259,368,15,49,UCBPlayer
12775,UCBPlayer,118,218,336,16,60,UCBPlayer
12776,UCBPlayer,117,267,384,19,45,UCBPlayer
12777,UCBPlayer,110,210,320,12,64,UCBPlayer
12778,UCBPlayer,126,271,397,23,42,UCBPlayer
12779,UCBPlayer,105,210,315,10,65,UCBPlayer
12780,UCBPlayer,130,275,405,25,40,UCBPlayer
12781,UCBPlayer,105,210,315,10,65,UCBPlayer
12782,UCBPlayer,130,275,405,25,40,UCBPlayer
12783,UCBPlayer,106,206,312,10,66,UCBPlayer
12784,UCBPlayer,130,275,405,25,40,UCBPlayer
12785,UCBPlayer,105,210,315,10,65,UCBPlayer
12786,UCBPlayer,131,271,402,25,41,UCBPlayer
12787,UCBPlayer,105,210,315,10,65,UCBPlayer
12788,UCBPlayer,130,275,405,25,40,UCBPlayer
12789,UCBPlayer,105,210,315,10,65,UCBPlayer
12790,UCBPlayer,130,275,405,25,40,UCBPlayer
12791,UCBPlayer,103,203,306,10,68,UCBPlayer
12792,UCBPlayer,128,283,411,25,38,UCBPlayer
12793,UCBPlayer,111,186,297,10,71,UCBPlayer
12794,UCBPlayer,124,299,423,25,34,UCBPlayer
12795,UCBPlayer,115,170,285,10,75,UCBPlayer
12796,UCBPlayer,120,315,435,25,30,UCBPlayer
12797,UCBPlayer,119,154,273,10,79,UCBPlayer
12798,UCBPlayer,112,332,444,25,27,UCBPlayer
12799,UCBPlayer,127,137,264,10,82,UCBPlayer
12800,UCBPlayer,104,349,453,25,24,UCBPlayer
12801,UCBPlayer,126,126,252,7,85,Tie
12802,UCBPlayer,111,351,462,28,22,UCBPlayer
12803,UCBPlayer,116,126,242,3,87,UCBPlayer
12804,UCBPlayer,122,347,469,32,21,UCBPlayer
12805,UCBPlayer,107,132,239,0,87,UCBPlayer
12806,UCBPlayer,132,337,469,35,22,UCBPlayer
12807,UCBPlayer,103,148,251,0,83,UCBPlayer
12808,UCBPlayer,136,321,457,35,26,UCBPlayer
12809,UCBPlayer,99,164,263,0,79,UCBPlayer
12810,UCBPlayer,140,305,445,35,30,UCBPlayer
12811,UCBPlayer,95,180,275,0,75,UCBPlayer
12812,UCBPlayer,144,289,433,35,34,UCBPlayer
12813,UCBPlayer,91,196,287,0,71,UCBPlayer
12814,UCBPlayer,148,273,421,35,38,UCBPlayer
12815,UCBPlayer,87,212,299,0,67,UCBPlayer
12816,UCBPlayer,152,257,409,35,42,UCBPlayer
12817,UCBPlayer,84,224,308,0,64,UCBPlayer
12818,UCBPlayer,146,251,397,32,45,UCBPlayer
12819,UCBPlayer,89,234,323,3,60,UCBPlayer
12820,UCBPlayer,138,243,381,28,49,UCBPlayer
12821,UCBPlayer,97,242,339,7,56,UCBPlayer
12822,UCBPlayer,130,235,365,24,53,UCBPlayer
12823,UCBPlayer,105,250,355,11,52,UCBPlayer
12824,UCBPlayer,122,227,349,20,57,UCBPlayer
12825,UCBPlayer,109,259,368,15,49,UCBPlayer
12826,UCBPlayer,118,218,336,16,60,UCBPlayer
12827,UCBPlayer,117,267,384,19,45,UCBPlayer
12828,UCBPlayer,110,210,320,12,64,UCBPlayer
12829,UCBPlayer,126,271,397,23,42,UCBPlayer
12830,UCBPlayer,105,210,315,10,65,UCBPlayer
12831,UCBPlayer,130,275,405,25,40,UCBPlayer
12832,UCBPlayer,105,210,315,10,65,UCBPlayer
12833,UCBPlayer,130,275,405,25,40,UCBPlayer
12834,UCBPlayer,106,206,312,10,66,UCBPlayer
12835,UCBPlayer,130,275,405,25,40,UCBPlayer
12836,UCBPlayer,105,210,315,10,65,UCBPlayer
12837,UCBPlayer,131,271,402,25,41,UCBPlayer
12838,UCBPlayer,105,210,315,10,65,UCBPlayer
12839,UCBPlayer,130,275,405,25,40,UCBPlayer
12840,UCBPlayer,105,210,315,10,65,UCBPlayer
12841,UCBPlayer,130,275,405,25,40,UCBPlayer
12842,UCBPlayer,103,203,306,10,68,UCBPlayer
12843,UCBPlayer,128,283,411,25,38,UCBPlayer
12844,UCBPlayer,111,186,297,10,71,UCBPlayer
12845,UCBPlayer,124,299,423,25,34,UCBPlayer
12846,UCBPlayer,115,170,285,10,75,UCBPlayer
12847,UCBPlayer,120,315,435,25,30,UCBPlayer
12848,UCBPlayer,119,154,273,10,79,UCBPlayer
12849,UCBPlayer,112,332,444,25,27,UCBPlayer
12850,UCBPlayer,127,137,264,10,82,UCBPlayer
12851,UCBPlayer,104,349,453,25,24,UCBPlayer
12852,UCBPlayer,126,126,252,7,85,Tie
12853,UCBPlayer,111,351,462,28,22,UCBPlayer
12854,UCBPlayer,116,126,242,3,87,UCBPlayer
12855,UCBPlayer,122,347,469,32,21,UCBPlayer
12856,UCBPlayer,107,132,239,0,87,UCBPlayer
12857,UCBPlayer,132,337,469,35,22,UCBPlayer
12858,UCBPlayer,103,148,251,0,83,UCBPlayer
12859,UCBPlayer,136,321,457,35,26,UCBPlayer
12860,UCBPlayer,99,164,263,0,79,UCBPlayer
12861,UCBPlayer,140,305,445,35,30,UCBPlayer
12862,UCBPlayer,95,180,275,0,75,UCBPlayer
12863,UCBPlayer,144,289,433,35,34,UCBPlayer
12864,UCBPlayer,91,196,287,0,71,UCBPlayer
12865,UCBPlayer,148,273,421,35,38,UCBPlayer
12866,UCBPlayer,87,212,299,0,67,UCBPlayer
12867,UCBPlayer,152,257,409,35,42,UCBPlayer
12868,UCBPlayer,84,224,308,0,64,UCBPlayer
12869,UCBPlayer,146,251,397,32,45,UCBPlayer
12870,UCBPlayer,89,234,323,3,60,UCBPlayer
12871,UCBPlayer,138,243,381,28,49,UCBPlayer
12872,UCBPlayer,97,242,339,7,56,UCBPlayer
12873,UCBPlayer,130,235,365,24,53,UCBPlayer
12874,UCBPlayer,105,250,355,11,52,UCBPlayer
12875,UCBPlayer,122,227,349,20,57,UCBPlayer
12876,UCBPlayer,109,259,368,15,49,UCBPlayer
12877,UCBPlayer,118,218,336,16,60,UCBPlayer
12878,UCBPlayer,117,267,384,19,45,UCBPlayer
12879,UCBPlayer,110,210,320,12,64,UCBPlayer
12880,UCBPlayer,126,271,397,23,42,UCBPlayer
12881,UCBPlayer,105,210,315,10,65,UCBPlayer
12882,UCBPlayer,130,275,405,25,40,UCBPlayer
12883,UCBPlayer,105,210,315,10,65,UCBPlayer
12884,UCBPlayer,130,275,405,25,40,UCBPlayer
12885,UCBPlayer,106,206,312,10,66,UCBPlayer
12886,UCBPlayer,130,275,405,25,40,UCBPlayer
12887,UCBPlayer,105,210,315,10,65,UCBPlayer
12888,UCBPlayer,131,271,402,25,41,UCBPlayer
12889,UCBPlayer,105,210,315,10,65,UCBPlayer
12890,UCBPlayer,130,275,405,25,40,UCBPlayer
12891,UCBPlayer,105,210,315,10,65,UCBPlayer
12892,UCBPlayer,130,275,405,25,40,UCBPlayer
12893,UCBPlayer,103,203,306,10,68,UCBPlayer
12894,UCBPlayer,128,283,411,25,38,UCBPlayer
12895,UCBPlayer,111,186,297,10,71,UCBPlayer
12896,UCBPlayer,124,299,423,25,34,UCBPlayer
12897,UCBPlayer,115,170,285,10,75,UCBPlayer
12898,UCBPlayer,120,315,435,25,30,UCBPlayer
12899,UCBPlayer,119,154,273,10,79,UCBPlayer
12900,UCBPlayer,112,332,444,25,27,UCBPlayer
12901,UCBPlayer,127,137,264,10,82,UCBPlayer
12902,UCBPlayer,104,349,453,25,24,UCBPlayer
12903,UCBPlayer,126,126,252,7,85,Tie
12904,UCBPlayer,111,351,462,28,22,UCBPlayer
12905,UCBPlayer,116,126,242,3,87,UCBPlayer
12906,UCBPlayer,122,347,469,32,21,UCBPlayer
12907,UCBPlayer,107,132,239,0,87,UCBPlayer
12908,UCBPlayer,132,337,469,35,22,UCBPlayer
12909,UCBPlayer,103,148,251,0,83,UCBPlayer
12910,UCBPlayer,136,321,457,35,26,UCBPlayer
12911,UCBPlayer,99,164,263,0,79,UCBPlayer
12912,UCBPlayer,140,305,445,35,30,UCBPlayer
12913,UCBPlayer,95,180,275,0,75,UCBPlayer
12914,UCBPlayer,144,289,433,35,34,UCBPlayer
12915,UCBPlayer,91,196,287,0,71,UCBPlayer
12916,UCBPlayer,148,273,421,35,38,UCBPlayer
12917,UCBPlayer,87,212,299,0,67,UCBPlayer
12918,UCBPlayer,152,257,409,35,42,UCBPlayer
12919,UCBPlayer,84,224,308,0,64,UCBPlayer
12920,UCBPlayer,146,251,397,32,45,UCBPlayer
12921,UCBPlayer,89,234,323,3,60,UCBPlayer
12922,UCBPlayer,138,243,381,28,49,UCBPlayer
12923,UCBPlayer,97,242,339,7,56,UCBPlayer
12924,UCBPlayer,130,235,365,24,53,UCBPlayer
12925,UCBPlayer,105,250,355,11,52,UCBPlayer
12926,UCBPlayer,122,227,349,20,57,UCBPlayer
12927,UCBPlayer,109,259,368,15,49,UCBPlayer
12928,UCBPlayer,118,218,336,16,60,UCBPlayer
12929,UCBPlayer,117,267,384,19,45,UCBPlayer
12930,UCBPlayer,110,210,320,12,64,UCBPlayer
12931,UCBPlayer,126,271,397,23,42,UCBPlayer
12932,UCBPlayer,105,210,315,10,65,UCBPlayer
12933,UCBPlayer,130,275,405,25,40,UCBPlayer
12934,UCBPlayer,105,210,315,10,65,UCBPlayer
12935,UCBPlayer,130,275,405,25,40,UCBPlayer
12936,UCBPlayer,106,206,312,10,66,UCBPlayer
12937,UCBPlayer,130,275,405,25,40,UCBPlayer
12938,UCBPlayer,105,210,315,10,65,UCBPlayer
12939,UCBPlayer,131,271,402,25,41,UCBPlayer
12940,UCBPlayer,105,210,315,10,65,UCBPlayer
12941,UCBPlayer,130,275,405,25,40,UCBPlayer
12942,UCBPlayer,105,210,315,10,65,UCBPlayer
12943,UCBPlayer,130,275,405,25,40,UCBPlayer
12944,UCBPlayer,103,203,306,10,68,UCBPlayer
12945,UCBPlayer,128,283,411,25,38,UCBPlayer
12946,UCBPlayer,111,186,297,10,71,UCBPlayer
12947,UCBPlayer,124,299,423,25,34,UCBPlayer
12948,UCBPlayer,115,170,285,10,75,UCBPlayer
12949,UCBPlayer,120,315,435,25,30,UCBPlayer
12950,UCBPlayer,119,154,273,10,79,UCBPlayer
12951,UCBPlayer,112,332,444,25,27,UCBPlayer
12952,UCBPlayer,127,137,264,10,82,UCBPlayer
12953,UCBPlayer,104,349,453,25,24,UCBPlayer
12954,UCBPlayer,126,126,252,7,85,Tie
12955,UCBPlayer,111,351,462,28,22,UCBPlayer
12956,UCBPlayer,116,126,242,3,87,UCBPlayer
12957,UCBPlayer,122,347,469,32,21,UCBPlayer
12958,UCBPlayer,107,132,239,0,87,UCBPlayer
12959,UCBPlayer,132,337,469,35,22,UCBPlayer
12960,UCBPlayer,103,148,251,0,83,UCBPlayer
12961,UCBPlayer,136,321,457,35,26,UCBPlayer
12962,UCBPlayer,99,164,263,0,79,UCBPlayer
12963,UCBPlayer,140,305,445,35,30,UCBPlayer
12964,UCBPlayer,95,180,275,0,75,UCBPlayer
12965,UCBPlayer,144,289,433,35,34,UCBPlayer
12966,UCBPlayer,91,196,287,0,71,UCBPlayer
12967,UCBPlayer,148,273,421,35,38,UCBPlayer
12968,UCBPlayer,87,212,299,0,67,UCBPlayer
12969,UCBPlayer,152,257,409,35,42,UCBPlayer
12970,UCBPlayer,84,224,308,0,64,UCBPlayer
12971,UCBPlayer,146,251,397,32,45,UCBPlayer
12972,UCBPlayer,89,234,323,3,60,UCBPlayer
12973,UCBPlayer,138,243,381,28,49,UCBPlayer
12974,UCBPlayer,97,242,339,7,56,UCBPlayer
12975,UCBPlayer,130,235,365,24,53,UCBPlayer
12976,UCBPlayer,105,250,355,11,52,UCBPlayer
12977,UCBPlayer,122,227,349,20,57,UCBPlayer
12978,UCBPlayer,109,259,368,15,49,UCBPlayer
12979,UCBPlayer,118,218,336,16,60,UCBPlayer
12980,UCBPlayer,117,267,384,19,45,UCBPlayer
12981,UCBPlayer,110,210,320,12,64,UCBPlayer
12982,UCBPlayer,126,271,397,23,42,UCBPlayer
12983,UCBPlayer,105,210,315,10,65,UCBPlayer
12984,UCBPlayer,130,275,405,25,40,UCBPlayer
12985,UCBPlayer,105,210,315,10,65,UCBPlayer
12986,UCBPlayer,130,275,405,25,40,UCBPlayer
12987,UCBPlayer,106,206,312,10,66,UCBPlayer
12988,UCBPlayer,130,275,405,25,40,UCBPlayer
12989,UCBPlayer,105,210,315,10,65,UCBPlayer
12990,UCBPlayer,131,271,402,25,41,UCBPlayer
12991,UCBPlayer,105,210,315,10,65,UCBPlayer
12992,UCBPlayer,130,275,405,25,40,UCBPlayer
12993,UCBPlayer,105,210,315,10,65,UCBPlayer
12994,UCBPlayer,130,275,405,25,40,UCBPlayer
12995,UCBPlayer,103,203,306,10,68,UCBPlayer
12996,UCBPlayer,128,283,411,25,38,UCBPlayer
12997,UCBPlayer,111,186,297,10,71,UCBPlayer
12998,UCBPlayer,124,299,423,25,34,UCBPlayer
12999,UCBPlayer,115,170,285,10,75,UCBPlayer
13000,UCBPlayer,120,315,435,25,30,UCBPlayer
13001,UCBPlayer,119,154,273,10,79,UCBPlayer
13002,UCBPlayer,112,332,444,25,27,UCBPlayer
13003,UCBPlayer,127,137,264,10,82,UCBPlayer
13004,UCBPlayer,104,349,453,25,24,UCBPlayer
13005,UCBPlayer,126,126,252,7,85,Tie
13006,UCBPlayer,111,351,462,28,22,UCBPlayer
13007,UCBPlayer,116,126,242,3,87,UCBPlayer
13008,UCBPlayer,122,347,469,32,21,UCBPlayer
13009,UCBPlayer,107,132,239,0,87,UCBPlayer
13010,UCBPlayer,132,337,469,35,22,UCBPlayer
13011,UCBPlayer,103,148,251,0,83,UCBPlayer
13012,UCBPlayer,136,321,457,35,26,UCBPlayer
13013,UCBPlayer,99,164,263,0,79,UCBPlayer
13014,UCBPlayer,140,305,445,35,30,UCBPlayer
13015,UCBPlayer,95,180,275,0,75,UCBPlayer
13016,UCBPlayer,144,289,433,35,34,UCBPlayer
13017,UCBPlayer,91,196,287,0,71,UCBPlayer
13018,UCBPlayer,148,273,421,35,38,UCBPlayer
13019,UCBPlayer,87,212,299,0,67,UCBPlayer
13020,UCBPlayer,152,257,409,35,42,UCBPlayer
13021,UCBPlayer,84,224,308,0,64,UCBPlayer
13022,UCBPlayer,146,251,397,32,45,UCBPlayer
13023,UCBPlayer,89,234,323,3,60,UCBPlayer
13024,UCBPlayer,138,243,381,28,49,UCBPlayer
13025,UCBPlayer,97,242,339,7,56,UCBPlayer
13026,UCBPlayer,130,235,365,24,53,UCBPlayer
13027,UCBPlayer,105,250,355,11,52,UCBPlayer
13028,UCBPlayer,122,227,349,20,57,UCBPlayer
13029,UCBPlayer,109,259,368,15,49,UCBPlayer
13030,UCBPlayer,118,218,336,16,60,UCBPlayer
13031,UCBPlayer,117,267,384,19,45,UCBPlayer
13032,UCBPlayer,110,210,320,12,64,UCBPlayer
13033,UCBPlayer,126,271,397,23,42,UCBPlayer
13034,UCBPlayer,105,210,315,10,65,UCBPlayer
13035,UCBPlayer,130,275,405,25,40,UCBPlayer
13036,UCBPlayer,105,210,315,10,65,UCBPlayer
13037,UCBPlayer,130,275,405,25,40,UCBPlayer
13038,UCBPlayer,106,206,312,10,66,UCBPlayer
13039,UCBPlayer,130,275,405,25,40,UCBPlayer
13040,UCBPlayer,105,210,315,10,65,UCBPlayer
13041,UCBPlayer,131,271,402,25,41,UCBPlayer
13042,UCBPlayer,105,210,315,10,65,UCBPlayer
13043,UCBPlayer,130,275,405,25,40,UCBPlayer
13044,UCBPlayer,105,210,315,10,65,UCBPlayer
13045,UCBPlayer,130,275,405,25,40,UCBPlayer
13046,UCBPlayer,103,203,306,10,68,UCBPlayer
13047,UCBPlayer,128,283,411,25,38,UCBPlayer
13048,UCBPlayer,111,186,297,10,71,UCBPlayer
13049,UCBPlayer,124,299,423,25,34,UCBPlayer
13050,UCBPlayer,115,170,285,10,75,UCBPlayer
13051,UCBPlayer,120,315,435,25,30,UCBPlayer
13052,UCBPlayer,119,154,273,10,79,UCBPlayer
13053,UCBPlayer,112,332,444,25,27,UCBPlayer
13054,UCBPlayer,127,137,264,10,82,UCBPlayer
13055,UCBPlayer,104,349,453,25,24,UCBPlayer
13056,UCBPlayer,126,126,252,7,85,Tie
13057,UCBPlayer,111,351,462,28,22,UCBPlayer
13058,UCBPlayer,116,126,242,3,87,UCBPlayer
13059,UCBPlayer,122,347,469,32,21,UCBPlayer
13060,UCBPlayer,107,132,239,0,87,UCBPlayer
13061,UCBPlayer,132,337,469,35,22,UCBPlayer
13062,UCBPlayer,103,148,251,0,83,UCBPlayer
13063,UCBPlayer,136,321,457,35,26,UCBPlayer
13064,UCBPlayer,99,164,263,0,79,UCBPlayer
13065,UCBPlayer,140,305,445,35,30,UCBPlayer
13066,UCBPlayer,95,180,275,0,75,UCBPlayer
13067,UCBPlayer,144,289,433,35,34,UCBPlayer
13068,UCBPlayer,91,196,287,0,71,UCBPlayer
13069,UCBPlayer,148,273,421,35,38,UCBPlayer
13070,UCBPlayer,87,212,299,0,67,UCBPlayer
13071,UCBPlayer,152,257,409,35,42,UCBPlayer
13072,UCBPlayer,84,224,308,0,64,UCBPlayer
13073,UCBPlayer,146,251,397,32,45,UCBPlayer
13074,UCBPlayer,89,234,323,3,60,UCBPlayer
13075,UCBPlayer,138,243,381,28,49,UCBPlayer
13076,UCBPlayer,97,242,339,7,56,UCBPlayer
13077,UCBPlayer,130,235,365,24,53,UCBPlayer
13078,UCBPlayer,105,250,355,11,52,UCBPlayer
13079,UCBPlayer,122,227,349,20,57,UCBPlayer
13080,UCBPlayer,109,259,368,15,49,UCBPlayer
13081,UCBPlayer,118,218,336,16,60,UCBPlayer
13082,UCBPlayer,117,267,384,19,45,UCBPlayer
13083,UCBPlayer,110,210,320,12,64,UCBPlayer
13084,UCBPlayer,126,271,397,23,42,UCBPlayer
13085,UCBPlayer,105,210,315,10,65,UCBPlayer
13086,UCBPlayer,130,275,405,25,40,UCBPlayer
13087,UCBPlayer,105,210,315,10,65,UCBPlayer
13088,UCBPlayer,130,275,405,25,40,UCBPlayer
13089,UCBPlayer,106,206,312,10,66,UCBPlayer
13090,UCBPlayer,130,275,405,25,40,UCBPlayer
13091,UCBPlayer,105,210,315,10,65,UCBPlayer
13092,UCBPlayer,131,271,402,25,41,UCBPlayer
13093,UCBPlayer,105,210,315,10,65,UCBPlayer
13094,UCBPlayer,130,275,405,25,40,UCBPlayer
13095,UCBPlayer,105,210,315,10,65,UCBPlayer
13096,UCBPlayer,130,275,405,25,40,UCBPlayer
13097,UCBPlayer,103,203,306,10,68,UCBPlayer
13098,UCBPlayer,128,283,411,25,38,UCBPlayer
13099,UCBPlayer,111,186,297,10,71,UCBPlayer
13100,UCBPlayer,124,299,423,25,34,UCBPlayer
13101,UCBPlayer,115,170,285,10,75,UCBPlayer
13102,UCBPlayer,120,315,435,25,30,UCBPlayer
13103,UCBPlayer,119,154,273,10,79,UCBPlayer
13104,UCBPlayer,112,332,444,25,27,UCBPlayer
13105,UCBPlayer,127,137,264,10,82,UCBPlayer
13106,UCBPlayer,104,349,453,25,24,UCBPlayer
13107,UCBPlayer,126,126,252,7,85,Tie
13108,UCBPlayer,111,351,462,28,22,UCBPlayer
13109,UCBPlayer,116,126,242,3,87,UCBPlayer
13110,UCBPlayer,122,347,469,32,21,UCBPlayer
13111,UCBPlayer,107,132,239,0,87,UCBPlayer
13112,UCBPlayer,132,337,469,35,22,UCBPlayer
13113,UCBPlayer,103,148,251,0,83,UCBPlayer
13114,UCBPlayer,136,321,457,35,26,UCBPlayer
13115,UCBPlayer,99,164,263,0,79,UCBPlayer
13116,UCBPlayer,140,305,445,35,30,UCBPlayer
13117,UCBPlayer,95,180,275,0,75,UCBPlayer
13118,UCBPlayer,144,289,433,35,34,UCBPlayer
13119,UCBPlayer,91,196,287,0,71,UCBPlayer
13120,UCBPlayer,148,273,421,35,38,UCBPlayer
13121,UCBPlayer,87,212,299,0,67,UCBPlayer
13122,UCBPlayer,152,257,409,35,42,UCBPlayer
13123,UCBPlayer,84,224,308,0,64,UCBPlayer
13124,UCBPlayer,146,251,397,32,45,UCBPlayer
13125,UCBPlayer,89,234,323,3,60,UCBPlayer
13126,UCBPlayer,138,243,381,28,49,UCBPlayer
13127,UCBPlayer,97,242,339,7,56,UCBPlayer
13128,UCBPlayer,130,235,365,24,53,UCBPlayer
13129,UCBPlayer,105,250,355,11,52,UCBPlayer
13130,UCBPlayer,122,227,349,20,57,UCBPlayer
13131,UCBPlayer,109,259,368,15,49,UCBPlayer
13132,UCBPlayer,118,218,336,16,60,UCBPlayer
13133,UCBPlayer,117,267,384,19,45,UCBPlayer
13134,UCBPlayer,110,210,320,12,64,UCBPlayer
13135,UCBPlayer,126,271,397,23,42,UCBPlayer
13136,UCBPlayer,105,210,315,10,65,UCBPlayer
13137,UCBPlayer,130,275,405,25,40,UCBPlayer
13138,UCBPlayer,105,210,315,10,65,UCBPlayer
13139,UCBPlayer,130,275,405,25,40,UCBPlayer
13140,UCBPlayer,106,206,312,10,66,UCBPlayer
13141,UCBPlayer,130,275,405,25,40,UCBPlayer
13142,UCBPlayer,105,210,315,10,65,UCBPlayer
13143,UCBPlayer,131,271,402,25,41,UCBPlayer
13144,UCBPlayer,105,210,315,10,65,UCBPlayer
13145,UCBPlayer,130,275,405,25,40,UCBPlayer
13146,UCBPlayer,105,210,315,10,65,UCBPlayer
13147,UCBPlayer,130,275,405,25,40,UCBPlayer
13148,UCBPlayer,103,203,306,10,68,UCBPlayer
13149,UCBPlayer,128,283,411,25,38,UCBPlayer
13150,UCBPlayer,111,186,297,10,71,UCBPlayer
13151,UCBPlayer,124,299,423,25,34,UCBPlayer
13152,UCBPlayer,115,170,285,10,75,UCBPlayer
13153,UCBPlayer,120,315,435,25,30,UCBPlayer
13154,UCBPlayer,119,154,273,10,79,UCBPlayer
13155,UCBPlayer,112,332,444,25,27,UCBPlayer
13156,UCBPlayer,127,137,264,10,82,UCBPlayer
13157,UCBPlayer,104,349,453,25,24,UCBPlayer
13158,UCBPlayer,126,126,252,7,85,Tie
13159,UCBPlayer,111,351,462,28,22,UCBPlayer
13160,UCBPlayer,116,126,242,3,87,UCBPlayer
13161,UCBPlayer,122,347,469,32,21,UCBPlayer
13162,UCBPlayer,107,132,239,0,87,UCBPlayer
13163,UCBPlayer,132,337,469,35,22,UCBPlayer
13164,UCBPlayer,103,148,251,0,83,UCBPlayer
13165,UCBPlayer,136,321,457,35,26,UCBPlayer
13166,UCBPlayer,99,164,263,0,79,UCBPlayer
13167,UCBPlayer,140,305,445,35,30,UCBPlayer
13168,UCBPlayer,95,180,275,0,75,UCBPlayer
13169,UCBPlayer,144,289,433,35,34,UCBPlayer
13170,UCBPlayer,91,196,287,0,71,UCBPlayer
13171,UCBPlayer,148,273,421,35,38,UCBPlayer
13172,UCBPlayer,87,212,299,0,67,UCBPlayer
13173,UCBPlayer,152,257,409,35,42,UCBPlayer
13174,UCBPlayer,84,224,308,0,64,UCBPlayer
13175,UCBPlayer,146,251,397,32,45,UCBPlayer
13176,UCBPlayer,89,234,323,3,60,UCBPlayer
13177,UCBPlayer,138,243,381,28,49,UCBPlayer
13178,UCBPlayer,97,242,339,7,56,UCBPlayer
13179,UCBPlayer,130,235,365,24,53,UCBPlayer
13180,UCBPlayer,105,250,355,11,52,UCBPlayer
13181,UCBPlayer,122,227,349,20,57,UCBPlayer
13182,UCBPlayer,109,259,368,15,49,UCBPlayer
13183,UCBPlayer,118,218,336,16,60,UCBPlayer
13184,UCBPlayer,117,267,384,19,45,UCBPlayer
13185,UCBPlayer,110,210,320,12,64,UCBPlayer
13186,UCBPlayer,126,271,397,23,42,UCBPlayer
13187,UCBPlayer,105,210,315,10,65,UCBPlayer
13188,UCBPlayer,130,275,405,25,40,UCBPlayer
13189,UCBPlayer,105,210,315,10,65,UCBPlayer
13190,UCBPlayer,130,275,405,25,40,UCBPlayer
13191,UCBPlayer,106,206,312,10,66,UCBPlayer
13192,UCBPlayer,130,275,405,25,40,UCBPlayer
13193,UCBPlayer,105,210,315,10,65,UCBPlayer
13194,UCBPlayer,131,271,402,25,41,UCBPlayer
13195,UCBPlayer,105,210,315,10,65,UCBPlayer
13196,UCBPlayer,130,275,405,25,40,UCBPlayer
13197,UCBPlayer,105,210,315,10,65,UCBPlayer
13198,UCBPlayer,130,275,405,25,40,UCBPlayer
13199,UCBPlayer,103,203,306,10,68,UCBPlayer
13200,UCBPlayer,128,283,411,25,38,UCBPlayer
13201,UCBPlayer,111,186,297,10,71,UCBPlayer
13202,UCBPlayer,124,299,423,25,34,UCBPlayer
13203,UCBPlayer,115,170,285,10,75,UCBPlayer
13204,UCBPlayer,120,315,435,25,30,UCBPlayer
13205,UCBPlayer,119,154,273,10,79,UCBPlayer
13206,UCBPlayer,112,332,444,25,27,UCBPlayer
13207,UCBPlayer,127,137,264,10,82,UCBPlayer
13208,UCBPlayer,104,349,453,25,24,UCBPlayer
13209,UCBPlayer,126,126,252,7,85,Tie
13210,UCBPlayer,111,351,462,28,22,UCBPlayer
13211,UCBPlayer,116,126,242,3,87,UCBPlayer
13212,UCBPlayer,122,347,469,32,21,UCBPlayer
13213,UCBPlayer,107,132,239,0,87,UCBPlayer
13214,UCBPlayer,132,337,469,35,22,UCBPlayer
13215,UCBPlayer,103,148,251,0,83,UCBPlayer
13216,UCBPlayer,136,321,457,35,26,UCBPlayer
13217,UCBPlayer,99,164,263,0,79,UCBPlayer
13218,UCBPlayer,140,305,445,35,30,UCBPlayer
13219,UCBPlayer,95,180,275,0,75,UCBPlayer
13220,UCBPlayer,144,289,433,35,34,UCBPlayer
13221,UCBPlayer,91,196,287,0,71,UCBPlayer
13222,UCBPlayer,148,273,421,35,38,UCBPlayer
13223,UCBPlayer,87,212,299,0,67,UCBPlayer
13224,UCBPlayer,152,257,409,35,42,UCBPlayer
13225,UCBPlayer,84,224,308,0,64,UCBPlayer
13226,UCBPlayer,146,251,397,32,45,UCBPlayer
13227,UCBPlayer,89,234,323,3,60,UCBPlayer
13228,UCBPlayer,138,243,381,28,49,UCBPlayer
13229,UCBPlayer,97,242,339,7,56,UCBPlayer
13230,UCBPlayer,130,235,365,24,53,UCBPlayer
13231,UCBPlayer,105,250,355,11,52,UCBPlayer
13232,UCBPlayer,122,227,349,20,57,UCBPlayer
13233,UCBPlayer,109,259,368,15,49,UCBPlayer
13234,UCBPlayer,118,218,336,16,60,UCBPlayer
13235,UCBPlayer,117,267,384,19,45,UCBPlayer
13236,UCBPlayer,110,210,320,12,64,UCBPlayer
13237,UCBPlayer,126,271,397,23,42,UCBPlayer
13238,UCBPlayer,105,210,315,10,65,UCBPlayer
13239,UCBPlayer,130,275,405,25,40,UCBPlayer
13240,UCBPlayer,105,210,315,10,65,UCBPlayer
13241,UCBPlayer,130,275,405,25,40,UCBPlayer
13242,UCBPlayer,106,206,312,10,66,UCBPlayer
13243,UCBPlayer,130,275,405,25,40,UCBPlayer
13244,UCBPlayer,105,210,315,10,65,UCBPlayer
13245,UCBPlayer,131,271,402,25,41,UCBPlayer
13246,UCBPlayer,105,210,315,10,65,UCBPlayer
13247,UCBPlayer,130,275,405,25,40,UCBPlayer
13248,UCBPlayer,105,210,315,10,65,UCBPlayer
13249,UCBPlayer,130,275,405,25,40,UCBPlayer
13250,UCBPlayer,103,203,306,10,68,UCBPlayer
13251,UCBPlayer,128,283,411,25,38,UCBPlayer
13252,UCBPlayer,111,186,297,10,71,UCBPlayer
13253,UCBPlayer,124,299,423,25,34,UCBPlayer
13254,UCBPlayer,115,170,285,10,75,UCBPlayer
13255,UCBPlayer,120,315,435,25,30,UCBPlayer
13256,UCBPlayer,119,154,273,10,79,UCBPlayer
13257,UCBPlayer,112,332,444,25,27,UCBPlayer
13258,UCBPlayer,127,137,264,10,82,UCBPlayer
13259,UCBPlayer,104,349,453,25,24,UCBPlayer
13260,UCBPlayer,126,126,252,7,85,Tie
13261,UCBPlayer,111,351,462,28,22,UCBPlayer
13262,UCBPlayer,116,126,242,3,87,UCBPlayer
13263,UCBPlayer,122,347,469,32,21,UCBPlayer
13264,UCBPlayer,107,132,239,0,87,UCBPlayer
13265,UCBPlayer,132,337,469,35,22,UCBPlayer
13266,UCBPlayer,103,148,251,0,83,UCBPlayer
13267,UCBPlayer,136,321,457,35,26,UCBPlayer
13268,UCBPlayer,99,164,263,0,79,UCBPlayer
13269,UCBPlayer,140,305,445,35,30,UCBPlayer
13270,UCBPlayer,95,180,275,0,75,UCBPlayer
13271,UCBPlayer,144,289,433,35,34,UCBPlayer
13272,UCBPlayer,91,196,287,0,71,UCBPlayer
13273,UCBPlayer,148,273,421,35,38,UCBPlayer
13274,UCBPlayer,87,212,299,0,67,UCBPlayer
13275,UCBPlayer,152,257,409,35,42,UCBPlayer
13276,UCBPlayer,84,224,308,0,64,UCBPlayer
13277,UCBPlayer,146,251,397,32,45,UCBPlayer
13278,UCBPlayer,89,234,323,3,60,UCBPlayer
13279,UCBPlayer,138,243,381,28,49,UCBPlayer
13280,UCBPlayer,97,242,339,7,56,UCBPlayer
13281,UCBPlayer,130,235,365,24,53,UCBPlayer
13282,UCBPlayer,105,250,355,11,52,UCBPlayer
13283,UCBPlayer,122,227,349,20,57,UCBPlayer
13284,UCBPlayer,109,259,368,15,49,UCBPlayer
13285,UCBPlayer,118,218,336,16,60,UCBPlayer
13286,UCBPlayer,117,267,384,19,45,UCBPlayer
13287,UCBPlayer,110,210,320,12,64,UCBPlayer
13288,UCBPlayer,126,271,397,23,42,UCBPlayer
13289,UCBPlayer,105,210,315,10,65,UCBPlayer
13290,UCBPlayer,130,275,405,25,40,UCBPlayer
13291,UCBPlayer,105,210,315,10,65,UCBPlayer
13292,UCBPlayer,130,275,405,25,40,UCBPlayer
13293,UCBPlayer,106,206,312,10,66,UCBPlayer
13294,UCBPlayer,130,275,405,25,40,UCBPlayer
13295,UCBPlayer,105,210,315,10,65,UCBPlayer
13296,UCBPlayer,131,271,402,25,41,UCBPlayer
13297,UCBPlayer,105,210,315,10,65,UCBPlayer
13298,UCBPlayer,130,275,405,25,40,UCBPlayer
13299,UCBPlayer,105,210,315,10,65,UCBPlayer
13300,UCBPlayer,130,275,405,25,40,UCBPlayer
13301,UCBPlayer,103,203,306,10,68,UCBPlayer
13302,UCBPlayer,128,283,411,25,38,UCBPlayer
13303,UCBPlayer,111,186,297,10,71,UCBPlayer
13304,UCBPlayer,124,299,423,25,34,UCBPlayer
13305,UCBPlayer,115,170,285,10,75,UCBPlayer
13306,UCBPlayer,120,315,435,25,30,UCBPlayer
13307,UCBPlayer,119,154,273,10,79,UCBPlayer
13308,UCBPlayer,112,332,444,25,27,UCBPlayer
13309,UCBPlayer,127,137,264,10,82,UCBPlayer
13310,UCBPlayer,104,349,453,25,24,UCBPlayer
13311,UCBPlayer,126,126,252,7,85,Tie
13312,UCBPlayer,111,351,462,28,22,UCBPlayer
13313,UCBPlayer,116,126,242,3,87,UCBPlayer
13314,UCBPlayer,122,347,469,32,21,UCBPlayer
13315,UCBPlayer,107,132,239,0,87,UCBPlayer
13316,UCBPlayer,132,337,469,35,22,UCBPlayer
13317,UCBPlayer,103,148,251,0,83,UCBPlayer
13318,UCBPlayer,136,321,457,35,26,UCBPlayer
13319,UCBPlayer,99,164,263,0,79,UCBPlayer
13320,UCBPlayer,140,305,445,35,30,UCBPlayer
13321,UCBPlayer,95,180,275,0,75,UCBPlayer
13322,UCBPlayer,144,289,433,35,34,UCBPlayer
13323,UCBPlayer,91,196,287,0,71,UCBPlayer
13324,UCBPlayer,148,273,421,35,38,UCBPlayer
13325,UCBPlayer,87,212,299,0,67,UCBPlayer
13326,UCBPlayer,152,257,409,35,42,UCBPlayer
13327,UCBPlayer,84,224,308,0,64,UCBPlayer
13328,UCBPlayer,146,251,397,32,45,UCBPlayer
13329,UCBPlayer,89,234,323,3,60,UCBPlayer
13330,UCBPlayer,138,243,381,28,49,UCBPlayer
13331,UCBPlayer,97,242,339,7,56,UCBPlayer
13332,UCBPlayer,130,235,365,24,53,UCBPlayer
13333,UCBPlayer,105,250,355,11,52,UCBPlayer
13334,UCBPlayer,122,227,349,20,57,UCBPlayer
13335,UCBPlayer,109,259,368,15,49,UCBPlayer
13336,UCBPlayer,118,218,336,16,60,UCBPlayer
13337,UCBPlayer,117,267,384,19,45,UCBPlayer
13338,UCBPlayer,110,210,320,12,64,UCBPlayer
13339,UCBPlayer,126,271,397,23,42,UCBPlayer
13340,UCBPlayer,105,210,315,10,65,UCBPlayer
13341,UCBPlayer,130,275,405,25,40,UCBPlayer
13342,UCBPlayer,105,210,315,10,65,UCBPlayer
13343,UCBPlayer,130,275,405,25,40,UCBPlayer
13344,UCBPlayer,106,206,312,10,66,UCBPlayer
13345,UCBPlayer,130,275,405,25,40,UCBPlayer
13346,UCBPlayer,105,210,315,10,65,UCBPlayer
13347,UCBPlayer,131,271,402,25,41,UCBPlayer
13348,UCBPlayer,105,210,315,10,65,UCBPlayer
13349,UCBPlayer,130,275,405,25,40,UCBPlayer
13350,UCBPlayer,105,210,315,10,65,UCBPlayer
13351,UCBPlayer,130,275,405,25,40,UCBPlayer
13352,UCBPlayer,103,203,306,10,68,UCBPlayer
13353,UCBPlayer,128,283,411,25,38,UCBPlayer
13354,UCBPlayer,111,186,297,10,71,UCBPlayer
13355,UCBPlayer,124,299,423,25,34,UCBPlayer
13356,UCBPlayer,115,170,285,10,75,UCBPlayer
13357,UCBPlayer,120,315,435,25,30,UCBPlayer
13358,UCBPlayer,119,154,273,10,79,UCBPlayer
13359,UCBPlayer,112,332,444,25,27,UCBPlayer
13360,UCBPlayer,127,137,264,10,82,UCBPlayer
13361,UCBPlayer,104,349,453,25,24,UCBPlayer
13362,UCBPlayer,126,126,252,7,85,Tie
13363,UCBPlayer,111,351,462,28,22,UCBPlayer
13364,UCBPlayer,116,126,242,3,87,UCBPlayer
13365,UCBPlayer,122,347,469,32,21,UCBPlayer
13366,UCBPlayer,107,132,239,0,87,UCBPlayer
13367,UCBPlayer,132,337,469,35,22,UCBPlayer
13368,UCBPlayer,103,148,251,0,83,UCBPlayer
13369,UCBPlayer,136,321,457,35,26,UCBPlayer
13370,UCBPlayer,99,164,263,0,79,UCBPlayer
13371,UCBPlayer,140,305,445,35,30,UCBPlayer
13372,UCBPlayer,95,180,275,0,75,UCBPlayer
13373,UCBPlayer,144,289,433,35,34,UCBPlayer
13374,UCBPlayer,91,196,287,0,71,UCBPlayer
13375,UCBPlayer,148,273,421,35,38,UCBPlayer
13376,UCBPlayer,87,212,299,0,67,UCBPlayer
13377,UCBPlayer,152,257,409,35,42,UCBPlayer
13378,UCBPlayer,84,224,308,0,64,UCBPlayer
13379,UCBPlayer,146,251,397,32,45,UCBPlayer
13380,UCBPlayer,89,234,323,3,60,UCBPlayer
13381,UCBPlayer,138,243,381,28,49,UCBPlayer
13382,UCBPlayer,97,242,339,7,56,UCBPlayer
13383,UCBPlayer,130,235,365,24,53,UCBPlayer
13384,UCBPlayer,105,250,355,11,52,UCBPlayer
13385,UCBPlayer,122,227,349,20,57,UCBPlayer
13386,UCBPlayer,109,259,368,15,49,UCBPlayer
13387,UCBPlayer,118,218,336,16,60,UCBPlayer
13388,UCBPlayer,117,267,384,19,45,UCBPlayer
13389,UCBPlayer,110,210,320,12,64,UCBPlayer
13390,UCBPlayer,126,271,397,23,42,UCBPlayer
13391,UCBPlayer,105,210,315,10,65,UCBPlayer
13392,UCBPlayer,130,275,405,25,40,UCBPlayer
13393,UCBPlayer,105,210,315,10,65,UCBPlayer
13394,UCBPlayer,130,275,405,25,40,UCBPlayer
13395,UCBPlayer,106,206,312,10,66,UCBPlayer
13396,UCBPlayer,130,275,405,25,40,UCBPlayer
13397,UCBPlayer,105,210,315,10,65,UCBPlayer
13398,UCBPlayer,131,271,402,25,41,UCBPlayer
13399,UCBPlayer,105,210,315,10,65,UCBPlayer
13400,UCBPlayer,130,275,405,25,40,UCBPlayer
13401,UCBPlayer,105,210,315,10,65,UCBPlayer
13402,UCBPlayer,130,275,405,25,40,UCBPlayer
13403,UCBPlayer,103,203,306,10,68,UCBPlayer
13404,UCBPlayer,128,283,411,25,38,UCBPlayer
13405,UCBPlayer,111,186,297,10,71,UCBPlayer
13406,UCBPlayer,124,299,423,25,34,UCBPlayer
13407,UCBPlayer,115,170,285,10,75,UCBPlayer
13408,UCBPlayer,120,315,435,25,30,UCBPlayer
13409,UCBPlayer,119,154,273,10,79,UCBPlayer
13410,UCBPlayer,112,332,444,25,27,UCBPlayer
13411,UCBPlayer,127,137,264,10,82,UCBPlayer
13412,UCBPlayer,104,349,453,25,24,UCBPlayer
13413,UCBPlayer,126,126,252,7,85,Tie
13414,UCBPlayer,111,351,462,28,22,UCBPlayer
13415,UCBPlayer,116,126,242,3,87,UCBPlayer
13416,UCBPlayer,122,347,469,32,21,UCBPlayer
13417,UCBPlayer,107,132,239,0,87,UCBPlayer
13418,UCBPlayer,132,337,469,35,22,UCBPlayer
13419,UCBPlayer,103,148,251,0,83,UCBPlayer
13420,UCBPlayer,136,321,457,35,26,UCBPlayer
13421,UCBPlayer,99,164,263,0,79,UCBPlayer
13422,UCBPlayer,140,305,445,35,30,UCBPlayer
13423,UCBPlayer,95,180,275,0,75,UCBPlayer
13424,UCBPlayer,144,289,433,35,34,UCBPlayer
13425,UCBPlayer,91,196,287,0,71,UCBPlayer
13426,UCBPlayer,148,273,421,35,38,UCBPlayer
13427,UCBPlayer,87,212,299,0,67,UCBPlayer
13428,UCBPlayer,152,257,409,35,42,UCBPlayer
13429,UCBPlayer,84,224,308,0,64,UCBPlayer
13430,UCBPlayer,146,251,397,32,45,UCBPlayer
13431,UCBPlayer,89,234,323,3,60,UCBPlayer
13432,UCBPlayer,138,243,381,28,49,UCBPlayer
13433,UCBPlayer,97,242,339,7,56,UCBPlayer
13434,UCBPlayer,130,235,365,24,53,UCBPlayer
13435,UCBPlayer,105,250,355,11,52,UCBPlayer
13436,UCBPlayer,122,227,349,20,57,UCBPlayer
13437,UCBPlayer,109,259,368,15,49,UCBPlayer
13438,UCBPlayer,118,218,336,16,60,UCBPlayer
13439,UCBPlayer,117,267,384,19,45,UCBPlayer
13440,UCBPlayer,110,210,320,12,64,UCBPlayer
13441,UCBPlayer,126,271,397,23,42,UCBPlayer
13442,UCBPlayer,105,210,315,10,65,UCBPlayer
13443,UCBPlayer,130,275,405,25,40,UCBPlayer
13444,UCBPlayer,105,210,315,10,65,UCBPlayer
13445,UCBPlayer,130,275,405,25,40,UCBPlayer
13446,UCBPlayer,106,206,312,10,66,UCBPlayer
13447,UCBPlayer,130,275,405,25,40,UCBPlayer
13448,UCBPlayer,105,210,315,10,65,UCBPlayer
13449,UCBPlayer,131,271,402,25,41,UCBPlayer
13450,UCBPlayer,105,210,315,10,65,UCBPlayer
13451,UCBPlayer,130,275,405,25,40,UCBPlayer
13452,UCBPlayer,105,210,315,10,65,UCBPlayer
13453,UCBPlayer,130,275,405,25,40,UCBPlayer
13454,UCBPlayer,103,203,306,10,68,UCBPlayer
13455,UCBPlayer,128,283,411,25,38,UCBPlayer
13456,UCBPlayer,111,186,297,10,71,UCBPlayer
13457,UCBPlayer,124,299,423,25,34,UCBPlayer
13458,UCBPlayer,115,170,285,10,75,UCBPlayer
13459,UCBPlayer,120,315,435,25,30,UCBPlayer
13460,UCBPlayer,119,154,273,10,79,UCBPlayer
13461,UCBPlayer,112,332,444,25,27,UCBPlayer
13462,UCBPlayer,127,137,264,10,82,UCBPlayer
13463,UCBPlayer,104,349,453,25,24,UCBPlayer
13464,UCBPlayer,126,126,252,7,85,Tie
13465,UCBPlayer,111,351,462,28,22,UCBPlayer
13466,UCBPlayer,116,126,242,3,87,UCBPlayer
13467,UCBPlayer,122,347,469,32,21,UCBPlayer
13468,UCBPlayer,107,132,239,0,87,UCBPlayer
13469,UCBPlayer,132,337,469,35,22,UCBPlayer
13470,UCBPlayer,103,148,251,0,83,UCBPlayer
13471,UCBPlayer,136,321,457,35,26,UCBPlayer
13472,UCBPlayer,99,164,263,0,79,UCBPlayer
13473,UCBPlayer,140,305,445,35,30,UCBPlayer
13474,UCBPlayer,95,180,275,0,75,UCBPlayer
13475,UCBPlayer,144,289,433,35,34,UCBPlayer
13476,UCBPlayer,91,196,287,0,71,UCBPlayer
13477,UCBPlayer,148,273,421,35,38,UCBPlayer
13478,UCBPlayer,87,212,299,0,67,UCBPlayer
13479,UCBPlayer,152,257,409,35,42,UCBPlayer
13480,UCBPlayer,84,224,308,0,64,UCBPlayer
13481,UCBPlayer,146,251,397,32,45,UCBPlayer
13482,UCBPlayer,89,234,323,3,60,UCBPlayer
13483,UCBPlayer,138,243,381,28,49,UCBPlayer
13484,UCBPlayer,97,242,339,7,56,UCBPlayer
13485,UCBPlayer,130,235,365,24,53,UCBPlayer
13486,UCBPlayer,105,250,355,11,52,UCBPlayer
13487,UCBPlayer,122,227,349,20,57,UCBPlayer
13488,UCBPlayer,109,259,368,15,49,UCBPlayer
13489,UCBPlayer,118,218,336,16,60,UCBPlayer
13490,UCBPlayer,117,267,384,19,45,UCBPlayer
13491,UCBPlayer,110,210,320,12,64,UCBPlayer
13492,UCBPlayer,126,271,397,23,42,UCBPlayer
13493,UCBPlayer,105,210,315,10,65,UCBPlayer
13494,UCBPlayer,130,275,405,25,40,UCBPlayer
13495,UCBPlayer,105,210,315,10,65,UCBPlayer
13496,UCBPlayer,130,275,405,25,40,UCBPlayer
13497,UCBPlayer,106,206,312,10,66,UCBPlayer
13498,UCBPlayer,130,275,405,25,40,UCBPlayer
13499,UCBPlayer,105,210,315,10,65,UCBPlayer
13500,UCBPlayer,131,271,402,25,41,UCBPlayer
13501,UCBPlayer,105,210,315,10,65,UCBPlayer
13502,UCBPlayer,130,275,405,25,40,UCBPlayer
13503,UCBPlayer,105,210,315,10,65,UCBPlayer
13504,UCBPlayer,130,275,405,25,40,UCBPlayer
13505,UCBPlayer,103,203,306,10,68,UCBPlayer
13506,UCBPlayer,128,283,411,25,38,UCBPlayer
13507,UCBPlayer,111,186,297,10,71,UCBPlayer
13508,UCBPlayer,124,299,423,25,34,UCBPlayer
13509,UCBPlayer,115,170,285,10,75,UCBPlayer
13510,UCBPlayer,120,315,435,25,30,UCBPlayer
13511,UCBPlayer,119,154,273,10,79,UCBPlayer
13512,UCBPlayer,112,332,444,25,27,UCBPlayer
13513,UCBPlayer,127,137,264,10,82,UCBPlayer
13514,UCBPlayer,104,349,453,25,24,UCBPlayer
13515,UCBPlayer,126,126,252,7,85,Tie
13516,UCBPlayer,111,351,462,28,22,UCBPlayer
13517,UCBPlayer,116,126,242,3,87,UCBPlayer
13518,UCBPlayer,122,347,469,32,21,UCBPlayer
13519,UCBPlayer,107,132,239,0,87,UCBPlayer
13520,UCBPlayer,132,337,469,35,22,UCBPlayer
13521,UCBPlayer,103,148,251,0,83,UCBPlayer
13522,UCBPlayer,136,321,457,35,26,UCBPlayer
13523,UCBPlayer,99,164,263,0,79,UCBPlayer
13524,UCBPlayer,140,305,445,35,30,UCBPlayer
13525,UCBPlayer,95,180,275,0,75,UCBPlayer
13526,UCBPlayer,144,289,433,35,34,UCBPlayer
13527,UCBPlayer,91,196,287,0,71,UCBPlayer
13528,UCBPlayer,148,273,421,35,38,UCBPlayer
13529,UCBPlayer,87,212,299,0,67,UCBPlayer
13530,UCBPlayer,152,257,409,35,42,UCBPlayer
13531,UCBPlayer,84,224,308,0,64,UCBPlayer
13532,UCBPlayer,146,251,397,32,45,UCBPlayer
13533,UCBPlayer,89,234,323,3,60,UCBPlayer
13534,UCBPlayer,138,243,381,28,49,UCBPlayer
13535,UCBPlayer,97,242,339,7,56,UCBPlayer
13536,UCBPlayer,130,235,365,24,53,UCBPlayer
13537,UCBPlayer,105,250,355,11,52,UCBPlayer
13538,UCBPlayer,122,227,349,20,57,UCBPlayer
13539,UCBPlayer,109,259,368,15,49,UCBPlayer
13540,UCBPlayer,118,218,336,16,60,UCBPlayer
13541,UCBPlayer,117,267,384,19,45,UCBPlayer
13542,UCBPlayer,110,210,320,12,64,UCBPlayer
13543,UCBPlayer,126,271,397,23,42,UCBPlayer
13544,UCBPlayer,105,210,315,10,65,UCBPlayer
13545,UCBPlayer,130,275,405,25,40,UCBPlayer
13546,UCBPlayer,105,210,315,10,65,UCBPlayer
13547,UCBPlayer,130,275,405,25,40,UCBPlayer
13548,UCBPlayer,106,206,312,10,66,UCBPlayer
13549,UCBPlayer,130,275,405,25,40,UCBPlayer
13550,UCBPlayer,105,210,315,10,65,UCBPlayer
13551,UCBPlayer,131,271,402,25,41,UCBPlayer
13552,UCBPlayer,105,210,315,10,65,UCBPlayer
13553,UCBPlayer,130,275,405,25,40,UCBPlayer
13554,UCBPlayer,105,210,315,10,65,UCBPlayer
13555,UCBPlayer,130,275,405,25,40,UCBPlayer
13556,UCBPlayer,103,203,306,10,68,UCBPlayer
13557,UCBPlayer,128,283,411,25,38,UCBPlayer
13558,UCBPlayer,111,186,297,10,71,UCBPlayer
13559,UCBPlayer,124,299,423,25,34,UCBPlayer
13560,UCBPlayer,115,170,285,10,75,UCBPlayer
13561,UCBPlayer,120,315,435,25,30,UCBPlayer
13562,UCBPlayer,119,154,273,10,79,UCBPlayer
13563,UCBPlayer,112,332,444,25,27,UCBPlayer
13564,UCBPlayer,127,137,264,10,82,UCBPlayer
13565,UCBPlayer,104,349,453,25,24,UCBPlayer
13566,UCBPlayer,126,126,252,7,85,Tie
13567,UCBPlayer,111,351,462,28,22,UCBPlayer
13568,UCBPlayer,116,126,242,3,87,UCBPlayer
13569,UCBPlayer,122,347,469,32,21,UCBPlayer
13570,UCBPlayer,107,132,239,0,87,UCBPlayer
13571,UCBPlayer,132,337,469,35,22,UCBPlayer
13572,UCBPlayer,103,148,251,0,83,UCBPlayer
13573,UCBPlayer,136,321,457,35,26,UCBPlayer
13574,UCBPlayer,99,164,263,0,79,UCBPlayer
13575,UCBPlayer,140,305,445,35,30,UCBPlayer
13576,UCBPlayer,95,180,275,0,75,UCBPlayer
13577,UCBPlayer,144,289,433,35,34,UCBPlayer
13578,UCBPlayer,91,196,287,0,71,UCBPlayer
13579,UCBPlayer,148,273,421,35,38,UCBPlayer
13580,UCBPlayer,87,212,299,0,67,UCBPlayer
13581,UCBPlayer,152,257,409,35,42,UCBPlayer
13582,UCBPlayer,84,224,308,0,64,UCBPlayer
13583,UCBPlayer,146,251,397,32,45,UCBPlayer
13584,UCBPlayer,89,234,323,3,60,UCBPlayer
13585,UCBPlayer,138,243,381,28,49,UCBPlayer
13586,UCBPlayer,97,242,339,7,56,UCBPlayer
13587,UCBPlayer,130,235,365,24,53,UCBPlayer
13588,UCBPlayer,105,250,355,11,52,UCBPlayer
13589,UCBPlayer,122,227,349,20,57,UCBPlayer
13590,UCBPlayer,109,259,368,15,49,UCBPlayer
13591,UCBPlayer,118,218,336,16,60,UCBPlayer
13592,UCBPlayer,117,267,384,19,45,UCBPlayer
13593,UCBPlayer,110,210,320,12,64,UCBPlayer
13594,UCBPlayer,126,271,397,23,42,UCBPlayer
13595,UCBPlayer,105,210,315,10,65,UCBPlayer
13596,UCBPlayer,130,275,405,25,40,UCBPlayer
13597,UCBPlayer,105,210,315,10,65,UCBPlayer
13598,UCBPlayer,130,275,405,25,40,UCBPlayer
13599,UCBPlayer,106,206,312,10,66,UCBPlayer
13600,UCBPlayer,130,275,405,25,40,UCBPlayer
13601,UCBPlayer,105,210,315,10,65,UCBPlayer
13602,UCBPlayer,131,271,402,25,41,UCBPlayer
13603,UCBPlayer,105,210,315,10,65,UCBPlayer
13604,UCBPlayer,130,275,405,25,40,UCBPlayer
13605,UCBPlayer,105,210,315,10,65,UCBPlayer
13606,UCBPlayer,130,275,405,25,40,UCBPlayer
13607,UCBPlayer,103,203,306,10,68,UCBPlayer
13608,UCBPlayer,128,283,411,25,38,UCBPlayer
13609,UCBPlayer,111,186,297,10,71,UCBPlayer
13610,UCBPlayer,124,299,423,25,34,UCBPlayer
13611,UCBPlayer,115,170,285,10,75,UCBPlayer
13612,UCBPlayer,120,315,435,25,30,UCBPlayer
13613,UCBPlayer,119,154,273,10,79,UCBPlayer
13614,UCBPlayer,112,332,444,25,27,UCBPlayer
13615,UCBPlayer,127,137,264,10,82,UCBPlayer
13616,UCBPlayer,104,349,453,25,24,UCBPlayer
13617,UCBPlayer,126,126,252,7,85,Tie
13618,UCBPlayer,111,351,462,28,22,UCBPlayer
13619,UCBPlayer,116,126,242,3,87,UCBPlayer
13620,UCBPlayer,122,347,469,32,21,UCBPlayer
13621,UCBPlayer,107,132,239,0,87,UCBPlayer
13622,UCBPlayer,132,337,469,35,22,UCBPlayer
13623,UCBPlayer,103,148,251,0,83,UCBPlayer
13624,UCBPlayer,136,321,457,35,26,UCBPlayer
13625,UCBPlayer,99,164,263,0,79,UCBPlayer
13626,UCBPlayer,140,305,445,35,30,UCBPlayer
13627,UCBPlayer,95,180,275,0,75,UCBPlayer
13628,UCBPlayer,144,289,433,35,34,UCBPlayer
13629,UCBPlayer,91,196,287,0,71,UCBPlayer
13630,UCBPlayer,148,273,421,35,38,UCBPlayer
13631,UCBPlayer,87,212,299,0,67,UCBPlayer
13632,UCBPlayer,152,257,409,35,42,UCBPlayer
13633,UCBPlayer,84,224,308,0,64,UCBPlayer
13634,UCBPlayer,146,251,397,32,45,UCBPlayer
13635,UCBPlayer,89,234,323,3,60,UCBPlayer
13636,UCBPlayer,138,243,381,28,49,UCBPlayer
13637,UCBPlayer,97,242,339,7,56,UCBPlayer
13638,UCBPlayer,130,235,365,24,53,UCBPlayer
13639,UCBPlayer,105,250,355,11,52,UCBPlayer
13640,UCBPlayer,122,227,349,20,57,UCBPlayer
13641,UCBPlayer,109,259,368,15,49,UCBPlayer
13642,UCBPlayer,118,218,336,16,60,UCBPlayer
13643,UCBPlayer,117,267,384,19,45,UCBPlayer
13644,UCBPlayer,110,210,320,12,64,UCBPlayer
13645,UCBPlayer,126,271,397,23,42,UCBPlayer
13646,UCBPlayer,105,210,315,10,65,UCBPlayer
13647,UCBPlayer,130,275,405,25,40,UCBPlayer
13648,UCBPlayer,105,210,315,10,65,UCBPlayer
13649,UCBPlayer,130,275,405,25,40,UCBPlayer
13650,UCBPlayer,106,206,312,10,66,UCBPlayer
13651,UCBPlayer,130,275,405,25,40,UCBPlayer
13652,UCBPlayer,105,210,315,10,65,UCBPlayer
13653,UCBPlayer,131,271,402,25,41,UCBPlayer
13654,UCBPlayer,105,210,315,10,65,UCBPlayer
13655,UCBPlayer,130,275,405,25,40,UCBPlayer
13656,UCBPlayer,105,210,315,10,65,UCBPlayer
13657,UCBPlayer,130,275,405,25,40,UCBPlayer
13658,UCBPlayer,103,203,306,10,68,UCBPlayer
13659,UCBPlayer,128,283,411,25,38,UCBPlayer
13660,UCBPlayer,111,186,297,10,71,UCBPlayer
13661,UCBPlayer,124,299,423,25,34,UCBPlayer
13662,UCBPlayer,115,170,285,10,75,UCBPlayer
13663,UCBPlayer,120,315,435,25,30,UCBPlayer
13664,UCBPlayer,119,154,273,10,79,UCBPlayer
13665,UCBPlayer,112,332,444,25,27,UCBPlayer
13666,UCBPlayer,127,137,264,10,82,UCBPlayer
13667,UCBPlayer,104,349,453,25,24,UCBPlayer
13668,UCBPlayer,126,126,252,7,85,Tie
13669,UCBPlayer,111,351,462,28,22,UCBPlayer
13670,UCBPlayer,116,126,242,3,87,UCBPlayer
13671,UCBPlayer,122,347,469,32,21,UCBPlayer
13672,UCBPlayer,107,132,239,0,87,UCBPlayer
13673,UCBPlayer,132,337,469,35,22,UCBPlayer
13674,UCBPlayer,103,148,251,0,83,UCBPlayer
13675,UCBPlayer,136,321,457,35,26,UCBPlayer
13676,UCBPlayer,99,164,263,0,79,UCBPlayer
13677,UCBPlayer,140,305,445,35,30,UCBPlayer
13678,UCBPlayer,95,180,275,0,75,UCBPlayer
13679,UCBPlayer,144,289,433,35,34,UCBPlayer
13680,UCBPlayer,91,196,287,0,71,UCBPlayer
13681,UCBPlayer,148,273,421,35,38,UCBPlayer
13682,UCBPlayer,87,212,299,0,67,UCBPlayer
13683,UCBPlayer,152,257,409,35,42,UCBPlayer
13684,UCBPlayer,84,224,308,0,64,UCBPlayer
13685,UCBPlayer,146,251,397,32,45,UCBPlayer
13686,UCBPlayer,89,234,323,3,60,UCBPlayer
13687,UCBPlayer,138,243,381,28,49,UCBPlayer
13688,UCBPlayer,97,242,339,7,56,UCBPlayer
13689,UCBPlayer,130,235,365,24,53,UCBPlayer
13690,UCBPlayer,105,250,355,11,52,UCBPlayer
13691,UCBPlayer,122,227,349,20,57,UCBPlayer
13692,UCBPlayer,109,259,368,15,49,UCBPlayer
13693,UCBPlayer,118,218,336,16,60,UCBPlayer
13694,UCBPlayer,117,267,384,19,45,UCBPlayer
13695,UCBPlayer,110,210,320,12,64,UCBPlayer
13696,UCBPlayer,126,271,397,23,42,UCBPlayer
13697,UCBPlayer,105,210,315,10,65,UCBPlayer
13698,UCBPlayer,130,275,405,25,40,UCBPlayer
13699,UCBPlayer,105,210,315,10,65,UCBPlayer
13700,UCBPlayer,130,275,405,25,40,UCBPlayer
13701,UCBPlayer,106,206,312,10,66,UCBPlayer
13702,UCBPlayer,130,275,405,25,40,UCBPlayer
13703,UCBPlayer,105,210,315,10,65,UCBPlayer
13704,UCBPlayer,131,271,402,25,41,UCBPlayer
13705,UCBPlayer,105,210,315,10,65,UCBPlayer
13706,UCBPlayer,130,275,405,25,40,UCBPlayer
13707,UCBPlayer,105,210,315,10,65,UCBPlayer
13708,UCBPlayer,130,275,405,25,40,UCBPlayer
13709,UCBPlayer,103,203,306,10,68,UCBPlayer
13710,UCBPlayer,128,283,411,25,38,UCBPlayer
13711,UCBPlayer,111,186,297,10,71,UCBPlayer
13712,UCBPlayer,124,299,423,25,34,UCBPlayer
13713,UCBPlayer,115,170,285,10,75,UCBPlayer
13714,UCBPlayer,120,315,435,25,30,UCBPlayer
13715,UCBPlayer,119,154,273,10,79,UCBPlayer
13716,UCBPlayer,112,332,444,25,27,UCBPlayer
13717,UCBPlayer,127,137,264,10,82,UCBPlayer
13718,UCBPlayer,104,349,453,25,24,UCBPlayer
13719,UCBPlayer,126,126,252,7,85,Tie
13720,UCBPlayer,111,351,462,28,22,UCBPlayer
13721,UCBPlayer,116,126,242,3,87,UCBPlayer
13722,UCBPlayer,122,347,469,32,21,UCBPlayer
13723,UCBPlayer,107,132,239,0,87,UCBPlayer
13724,UCBPlayer,132,337,469,35,22,UCBPlayer
13725,UCBPlayer,103,148,251,0,83,UCBPlayer
13726,UCBPlayer,136,321,457,35,26,UCBPlayer
13727,UCBPlayer,99,164,263,0,79,UCBPlayer
13728,UCBPlayer,140,305,445,35,30,UCBPlayer
13729,UCBPlayer,95,180,275,0,75,UCBPlayer
13730,UCBPlayer,144,289,433,35,34,UCBPlayer
13731,UCBPlayer,91,196,287,0,71,UCBPlayer
13732,UCBPlayer,148,273,421,35,38,UCBPlayer
13733,UCBPlayer,87,212,299,0,67,UCBPlayer
13734,UCBPlayer,152,257,409,35,42,UCBPlayer
13735,UCBPlayer,84,224,308,0,64,UCBPlayer
13736,UCBPlayer,146,251,397,32,45,UCBPlayer
13737,UCBPlayer,89,234,323,3,60,UCBPlayer
13738,UCBPlayer,138,243,381,28,49,UCBPlayer
13739,UCBPlayer,97,242,339,7,56,UCBPlayer
13740,UCBPlayer,130,235,365,24,53,UCBPlayer
13741,UCBPlayer,105,250,355,11,52,UCBPlayer
13742,UCBPlayer,122,227,349,20,57,UCBPlayer
13743,UCBPlayer,109,259,368,15,49,UCBPlayer
13744,UCBPlayer,118,218,336,16,60,UCBPlayer
13745,UCBPlayer,117,267,384,19,45,UCBPlayer
13746,UCBPlayer,110,210,320,12,64,UCBPlayer
13747,UCBPlayer,126,271,397,23,42,UCBPlayer
13748,UCBPlayer,105,210,315,10,65,UCBPlayer
13749,UCBPlayer,130,275,405,25,40,UCBPlayer
13750,UCBPlayer,105,210,315,10,65,UCBPlayer
13751,UCBPlayer,130,275,405,25,40,UCBPlayer
13752,UCBPlayer,106,206,312,10,66,UCBPlayer
13753,UCBPlayer,130,275,405,25,40,UCBPlayer
13754,UCBPlayer,105,210,315,10,65,UCBPlayer
13755,UCBPlayer,131,271,402,25,41,UCBPlayer
13756,UCBPlayer,105,210,315,10,65,UCBPlayer
13757,UCBPlayer,130,275,405,25,40,UCBPlayer
13758,UCBPlayer,105,210,315,10,65,UCBPlayer
13759,UCBPlayer,130,275,405,25,40,UCBPlayer
13760,UCBPlayer,103,203,306,10,68,UCBPlayer
13761,UCBPlayer,128,283,411,25,38,UCBPlayer
13762,UCBPlayer,111,186,297,10,71,UCBPlayer
13763,UCBPlayer,124,299,423,25,34,UCBPlayer
13764,UCBPlayer,115,170,285,10,75,UCBPlayer
13765,UCBPlayer,120,315,435,25,30,UCBPlayer
13766,UCBPlayer,119,154,273,10,79,UCBPlayer
13767,UCBPlayer,112,332,444,25,27,UCBPlayer
13768,UCBPlayer,127,137,264,10,82,UCBPlayer
13769,UCBPlayer,104,349,453,25,24,UCBPlayer
13770,UCBPlayer,126,126,252,7,85,Tie
13771,UCBPlayer,111,351,462,28,22,UCBPlayer
13772,UCBPlayer,116,126,242,3,87,UCBPlayer
13773,UCBPlayer,122,347,469,32,21,UCBPlayer
13774,UCBPlayer,107,132,239,0,87,UCBPlayer
13775,UCBPlayer,132,337,469,35,22,UCBPlayer
13776,UCBPlayer,103,148,251,0,83,UCBPlayer
13777,UCBPlayer,136,321,457,35,26,UCBPlayer
13778,UCBPlayer,99,164,263,0,79,UCBPlayer
13779,UCBPlayer,140,305,445,35,30,UCBPlayer
13780,UCBPlayer,95,180,275,0,75,UCBPlayer
13781,UCBPlayer,144,289,433,35,34,UCBPlayer
13782,UCBPlayer,91,196,287,0,71,UCBPlayer
13783,UCBPlayer,148,273,421,35,38,UCBPlayer
13784,UCBPlayer,87,212,299,0,67,UCBPlayer
13785,UCBPlayer,152,257,409,35,42,UCBPlayer
13786,UCBPlayer,84,224,308,0,64,UCBPlayer
13787,UCBPlayer,146,251,397,32,45,UCBPlayer
13788,UCBPlayer,89,234,323,3,60,UCBPlayer
13789,UCBPlayer,138,243,381,28,49,UCBPlayer
13790,UCBPlayer,97,242,339,7,56,UCBPlayer
13791,UCBPlayer,130,235,365,24,53,UCBPlayer
13792,UCBPlayer,105,250,355,11,52,UCBPlayer
13793,UCBPlayer,122,227,349,20,57,UCBPlayer
13794,UCBPlayer,109,259,368,15,49,UCBPlayer
13795,UCBPlayer,118,218,336,16,60,UCBPlayer
13796,UCBPlayer,117,267,384,19,45,UCBPlayer
13797,UCBPlayer,110,210,320,12,64,UCBPlayer
13798,UCBPlayer,126,271,397,23,42,UCBPlayer
13799,UCBPlayer,105,210,315,10,65,UCBPlayer
13800,UCBPlayer,130,275,405,25,40,UCBPlayer
13801,UCBPlayer,105,210,315,10,65,UCBPlayer
13802,UCBPlayer,130,275,405,25,40,UCBPlayer
13803,UCBPlayer,106,206,312,10,66,UCBPlayer
13804,UCBPlayer,130,275,405,25,40,UCBPlayer
13805,UCBPlayer,105,210,315,10,65,UCBPlayer
13806,UCBPlayer,131,271,402,25,41,UCBPlayer
13807,UCBPlayer,105,210,315,10,65,UCBPlayer
13808,UCBPlayer,130,275,405,25,40,UCBPlayer
13809,UCBPlayer,105,210,315,10,65,UCBPlayer
13810,UCBPlayer,130,275,405,25,40,UCBPlayer
13811,UCBPlayer,103,203,306,10,68,UCBPlayer
13812,UCBPlayer,128,283,411,25,38,UCBPlayer
13813,UCBPlayer,111,186,297,10,71,UCBPlayer
13814,UCBPlayer,124,299,423,25,34,UCBPlayer
13815,UCBPlayer,115,170,285,10,75,UCBPlayer
13816,UCBPlayer,120,315,435,25,30,UCBPlayer
13817,UCBPlayer,119,154,273,10,79,UCBPlayer
13818,UCBPlayer,112,332,444,25,27,UCBPlayer
13819,UCBPlayer,127,137,264,10,82,UCBPlayer
13820,UCBPlayer,104,349,453,25,24,UCBPlayer
13821,UCBPlayer,126,126,252,7,85,Tie
13822,UCBPlayer,111,351,462,28,22,UCBPlayer
13823,UCBPlayer,116,126,242,3,87,UCBPlayer
13824,UCBPlayer,122,347,469,32,21,UCBPlayer
13825,UCBPlayer,107,132,239,0,87,UCBPlayer
13826,UCBPlayer,132,337,469,35,22,UCBPlayer
13827,UCBPlayer,103,148,251,0,83,UCBPlayer
13828,UCBPlayer,136,321,457,35,26,UCBPlayer
13829,UCBPlayer,99,164,263,0,79,UCBPlayer
13830,UCBPlayer,140,305,445,35,30,UCBPlayer
13831,UCBPlayer,95,180,275,0,75,UCBPlayer
13832,UCBPlayer,144,289,433,35,34,UCBPlayer
13833,UCBPlayer,91,196,287,0,71,UCBPlayer
13834,UCBPlayer,148,273,421,35,38,UCBPlayer
13835,UCBPlayer,87,212,299,0,67,UCBPlayer
13836,UCBPlayer,152,257,409,35,42,UCBPlayer
13837,UCBPlayer,84,224,308,0,64,UCBPlayer
13838,UCBPlayer,146,251,397,32,45,UCBPlayer
13839,UCBPlayer,89,234,323,3,60,UCBPlayer
13840,UCBPlayer,138,243,381,28,49,UCBPlayer
13841,UCBPlayer,97,242,339,7,56,UCBPlayer
13842,UCBPlayer,130,235,365,24,53,UCBPlayer
13843,UCBPlayer,105,250,355,11,52,UCBPlayer
13844,UCBPlayer,122,227,349,20,57,UCBPlayer
13845,UCBPlayer,109,259,368,15,49,UCBPlayer
13846,UCBPlayer,118,218,336,16,60,UCBPlayer
13847,UCBPlayer,117,267,384,19,45,UCBPlayer
13848,UCBPlayer,110,210,320,12,64,UCBPlayer
13849,UCBPlayer,126,271,397,23,42,UCBPlayer
13850,UCBPlayer,105,210,315,10,65,UCBPlayer
13851,UCBPlayer,130,275,405,25,40,UCBPlayer
13852,UCBPlayer,105,210,315,10,65,UCBPlayer
13853,UCBPlayer,130,275,405,25,40,UCBPlayer
13854,UCBPlayer,106,206,312,10,66,UCBPlayer
13855,UCBPlayer,130,275,405,25,40,UCBPlayer
13856,UCBPlayer,105,210,315,10,65,UCBPlayer
13857,UCBPlayer,131,271,402,25,41,UCBPlayer
13858,UCBPlayer,105,210,315,10,65,UCBPlayer
13859,UCBPlayer,130,275,405,25,40,UCBPlayer
13860,UCBPlayer,105,210,315,10,65,UCBPlayer
13861,UCBPlayer,130,275,405,25,40,UCBPlayer
13862,UCBPlayer,103,203,306,10,68,UCBPlayer
13863,UCBPlayer,128,283,411,25,38,UCBPlayer
13864,UCBPlayer,111,186,297,10,71,UCBPlayer
13865,UCBPlayer,124,299,423,25,34,UCBPlayer
13866,UCBPlayer,115,170,285,10,75,UCBPlayer
13867,UCBPlayer,120,315,435,25,30,UCBPlayer
13868,UCBPlayer,119,154,273,10,79,UCBPlayer
13869,UCBPlayer,112,332,444,25,27,UCBPlayer
13870,UCBPlayer,127,137,264,10,82,UCBPlayer
13871,UCBPlayer,104,349,453,25,24,UCBPlayer
13872,UCBPlayer,126,126,252,7,85,Tie
13873,UCBPlayer,111,351,462,28,22,UCBPlayer
13874,UCBPlayer,116,126,242,3,87,UCBPlayer
13875,UCBPlayer,122,347,469,32,21,UCBPlayer
13876,UCBPlayer,107,132,239,0,87,UCBPlayer
13877,UCBPlayer,132,337,469,35,22,UCBPlayer
13878,UCBPlayer,103,148,251,0,83,UCBPlayer
13879,UCBPlayer,136,321,457,35,26,UCBPlayer
13880,UCBPlayer,99,164,263,0,79,UCBPlayer
13881,UCBPlayer,140,305,445,35,30,UCBPlayer
13882,UCBPlayer,95,180,275,0,75,UCBPlayer
13883,UCBPlayer,144,289,433,35,34,UCBPlayer
13884,UCBPlayer,91,196,287,0,71,UCBPlayer
13885,UCBPlayer,148,273,421,35,38,UCBPlayer
13886,UCBPlayer,87,212,299,0,67,UCBPlayer
13887,UCBPlayer,152,257,409,35,42,UCBPlayer
13888,UCBPlayer,84,224,308,0,64,UCBPlayer
13889,UCBPlayer,146,251,397,32,45,UCBPlayer
13890,UCBPlayer,89,234,323,3,60,UCBPlayer
13891,UCBPlayer,138,243,381,28,49,UCBPlayer
13892,UCBPlayer,97,242,339,7,56,UCBPlayer
13893,UCBPlayer,130,235,365,24,53,UCBPlayer
13894,UCBPlayer,105,250,355,11,52,UCBPlayer
13895,UCBPlayer,122,227,349,20,57,UCBPlayer
13896,UCBPlayer,109,259,368,15,49,UCBPlayer
13897,UCBPlayer,118,218,336,16,60,UCBPlayer
13898,UCBPlayer,117,267,384,19,45,UCBPlayer
13899,UCBPlayer,110,210,320,12,64,UCBPlayer
13900,UCBPlayer,126,271,397,23,42,UCBPlayer
13901,UCBPlayer,105,210,315,10,65,UCBPlayer
13902,UCBPlayer,130,275,405,25,40,UCBPlayer
13903,UCBPlayer,105,210,315,10,65,UCBPlayer
13904,UCBPlayer,130,275,405,25,40,UCBPlayer
13905,UCBPlayer,106,206,312,10,66,UCBPlayer
13906,UCBPlayer,130,275,405,25,40,UCBPlayer
13907,UCBPlayer,105,210,315,10,65,UCBPlayer
13908,UCBPlayer,131,271,402,25,41,UCBPlayer
13909,UCBPlayer,105,210,315,10,65,UCBPlayer
13910,UCBPlayer,130,275,405,25,40,UCBPlayer
13911,UCBPlayer,105,210,315,10,65,UCBPlayer
13912,UCBPlayer,130,275,405,25,40,UCBPlayer
13913,UCBPlayer,103,203,306,10,68,UCBPlayer
13914,UCBPlayer,128,283,411,25,38,UCBPlayer
13915,UCBPlayer,111,186,297,10,71,UCBPlayer
13916,UCBPlayer,124,299,423,25,34,UCBPlayer
13917,UCBPlayer,115,170,285,10,75,UCBPlayer
13918,UCBPlayer,120,315,435,25,30,UCBPlayer
13919,UCBPlayer,119,154,273,10,79,UCBPlayer
13920,UCBPlayer,112,332,444,25,27,UCBPlayer
13921,UCBPlayer,127,137,264,10,82,UCBPlayer
13922,UCBPlayer,104,349,453,25,24,UCBPlayer
13923,UCBPlayer,126,126,252,7,85,Tie
13924,UCBPlayer,111,351,462,28,22,UCBPlayer
13925,UCBPlayer,116,126,242,3,87,UCBPlayer
13926,UCBPlayer,122,347,469,32,21,UCBPlayer
13927,UCBPlayer,107,132,239,0,87,UCBPlayer
13928,UCBPlayer,132,337,469,35,22,UCBPlayer
13929,UCBPlayer,103,148,251,0,83,UCBPlayer
13930,UCBPlayer,136,321,457,35,26,UCBPlayer
13931,UCBPlayer,99,164,263,0,79,UCBPlayer
13932,UCBPlayer,140,305,445,35,30,UCBPlayer
13933,UCBPlayer,95,180,275,0,75,UCBPlayer
13934,UCBPlayer,144,289,433,35,34,UCBPlayer
13935,UCBPlayer,91,196,287,0,71,UCBPlayer
13936,UCBPlayer,148,273,421,35,38,UCBPlayer
13937,UCBPlayer,87,212,299,0,67,UCBPlayer
13938,UCBPlayer,152,257,409,35,42,UCBPlayer
13939,UCBPlayer,84,224,308,0,64,UCBPlayer
13940,UCBPlayer,146,251,397,32,45,UCBPlayer
13941,UCBPlayer,89,234,323,3,60,UCBPlayer
13942,UCBPlayer,138,243,381,28,49,UCBPlayer
13943,UCBPlayer,97,242,339,7,56,UCBPlayer
13944,UCBPlayer,130,235,365,24,53,UCBPlayer
13945,UCBPlayer,105,250,355,11,52,UCBPlayer
13946,UCBPlayer,122,227,349,20,57,UCBPlayer
13947,UCBPlayer,109,259,368,15,49,UCBPlayer
13948,UCBPlayer,118,218,336,16,60,UCBPlayer
13949,UCBPlayer,117,267,384,19,45,UCBPlayer
13950,UCBPlayer,110,210,320,12,64,UCBPlayer
13951,UCBPlayer,126,271,397,23,42,UCBPlayer
13952,UCBPlayer,105,210,315,10,65,UCBPlayer
13953,UCBPlayer,130,275,405,25,40,UCBPlayer
13954,UCBPlayer,105,210,315,10,65,UCBPlayer
13955,UCBPlayer,130,275,405,25,40,UCBPlayer
13956,UCBPlayer,106,206,312,10,66,UCBPlayer
13957,UCBPlayer,130,275,405,25,40,UCBPlayer
13958,UCBPlayer,105,210,315,10,65,UCBPlayer
13959,UCBPlayer,131,271,402,25,41,UCBPlayer
13960,UCBPlayer,105,210,315,10,65,UCBPlayer
13961,UCBPlayer,130,275,405,25,40,UCBPlayer
13962,UCBPlayer,105,210,315,10,65,UCBPlayer
13963,UCBPlayer,130,275,405,25,40,UCBPlayer
13964,UCBPlayer,103,203,306,10,68,UCBPlayer
13965,UCBPlayer,128,283,411,25,38,UCBPlayer
13966,UCBPlayer,111,186,297,10,71,UCBPlayer
13967,UCBPlayer,124,299,423,25,34,UCBPlayer
13968,UCBPlayer,115,170,285,10,75,UCBPlayer
13969,UCBPlayer,120,315,435,25,30,UCBPlayer
13970,UCBPlayer,119,154,273,10,79,UCBPlayer
13971,UCBPlayer,112,332,444,25,27,UCBPlayer
13972,UCBPlayer,127,137,264,10,82,UCBPlayer
13973,UCBPlayer,104,349,453,25,24,UCBPlayer
13974,UCBPlayer,126,126,252,7,85,Tie
13975,UCBPlayer,111,351,462,28,22,UCBPlayer
13976,UCBPlayer,116,126,242,3,87,UCBPlayer
13977,UCBPlayer,122,347,469,32,21,UCBPlayer
13978,UCBPlayer,107,132,239,0,87,UCBPlayer
13979,UCBPlayer,132,337,469,35,22,UCBPlayer
13980,UCBPlayer,103,148,251,0,83,UCBPlayer
13981,UCBPlayer,136,321,457,35,26,UCBPlayer
13982,UCBPlayer,99,164,263,0,79,UCBPlayer
13983,UCBPlayer,140,305,445,35,30,UCBPlayer
13984,UCBPlayer,95,180,275,0,75,UCBPlayer
13985,UCBPlayer,144,289,433,35,34,UCBPlayer
13986,UCBPlayer,91,196,287,0,71,UCBPlayer
13987,UCBPlayer,148,273,421,35,38,UCBPlayer
13988,UCBPlayer,87,212,299,0,67,UCBPlayer
13989,UCBPlayer,152,257,409,35,42,UCBPlayer
13990,UCBPlayer,84,224,308,0,64,UCBPlayer
13991,UCBPlayer,146,251,397,32,45,UCBPlayer
13992,UCBPlayer,89,234,323,3,60,UCBPlayer
13993,UCBPlayer,138,243,381,28,49,UCBPlayer
13994,UCBPlayer,97,242,339,7,56,UCBPlayer
13995,UCBPlayer,130,235,365,24,53,UCBPlayer
13996,UCBPlayer,105,250,355,11,52,UCBPlayer
13997,UCBPlayer,122,227,349,20,57,UCBPlayer
13998,UCBPlayer,109,259,368,15,49,UCBPlayer
13999,UCBPlayer,118,218,336,16,60,UCBPlayer
14000,UCBPlayer,117,267,384,19,45,UCBPlayer
14001,UCBPlayer,110,210,320,12,64,UCBPlayer
14002,UCBPlayer,126,271,397,23,42,UCBPlayer
14003,UCBPlayer,105,210,315,10,65,UCBPlayer
14004,UCBPlayer,130,275,405,25,40,UCBPlayer
14005,UCBPlayer,105,210,315,10,65,UCBPlayer
14006,UCBPlayer,130,275,405,25,40,UCBPlayer
14007,UCBPlayer,106,206,312,10,66,UCBPlayer
14008,UCBPlayer,130,275,405,25,40,UCBPlayer
14009,UCBPlayer,105,210,315,10,65,UCBPlayer
14010,UCBPlayer,131,271,402,25,41,UCBPlayer
14011,UCBPlayer,105,210,315,10,65,UCBPlayer
14012,UCBPlayer,130,275,405,25,40,UCBPlayer
14013,UCBPlayer,105,210,315,10,65,UCBPlayer
14014,UCBPlayer,130,275,405,25,40,UCBPlayer
14015,UCBPlayer,103,203,306,10,68,UCBPlayer
14016,UCBPlayer,128,283,411,25,38,UCBPlayer
14017,UCBPlayer,111,186,297,10,71,UCBPlayer
14018,UCBPlayer,124,299,423,25,34,UCBPlayer
14019,UCBPlayer,115,170,285,10,75,UCBPlayer
14020,UCBPlayer,120,315,435,25,30,UCBPlayer
14021,UCBPlayer,119,154,273,10,79,UCBPlayer
14022,UCBPlayer,112,332,444,25,27,UCBPlayer
14023,UCBPlayer,127,137,264,10,82,UCBPlayer
14024,UCBPlayer,104,349,453,25,24,UCBPlayer
14025,UCBPlayer,126,126,252,7,85,Tie
14026,UCBPlayer,111,351,462,28,22,UCBPlayer
14027,UCBPlayer,116,126,242,3,87,UCBPlayer
14028,UCBPlayer,122,347,469,32,21,UCBPlayer
14029,UCBPlayer,107,132,239,0,87,UCBPlayer
14030,UCBPlayer,132,337,469,35,22,UCBPlayer
14031,UCBPlayer,103,148,251,0,83,UCBPlayer
14032,UCBPlayer,136,321,457,35,26,UCBPlayer
14033,UCBPlayer,99,164,263,0,79,UCBPlayer
14034,UCBPlayer,140,305,445,35,30,UCBPlayer
14035,UCBPlayer,95,180,275,0,75,UCBPlayer
14036,UCBPlayer,144,289,433,35,34,UCBPlayer
14037,UCBPlayer,91,196,287,0,71,UCBPlayer
14038,UCBPlayer,148,273,421,35,38,UCBPlayer
14039,UCBPlayer,87,212,299,0,67,UCBPlayer
14040,UCBPlayer,152,257,409,35,42,UCBPlayer
14041,UCBPlayer,84,224,308,0,64,UCBPlayer
14042,UCBPlayer,146,251,397,32,45,UCBPlayer
14043,UCBPlayer,89,234,323,3,60,UCBPlayer
14044,UCBPlayer,138,243,381,28,49,UCBPlayer
14045,UCBPlayer,97,242,339,7,56,UCBPlayer
14046,UCBPlayer,130,235,365,24,53,UCBPlayer
14047,UCBPlayer,105,250,355,11,52,UCBPlayer
14048,UCBPlayer,122,227,349,20,57,UCBPlayer
14049,UCBPlayer,109,259,368,15,49,UCBPlayer
14050,UCBPlayer,118,218,336,16,60,UCBPlayer
14051,UCBPlayer,117,267,384,19,45,UCBPlayer
14052,UCBPlayer,110,210,320,12,64,UCBPlayer
14053,UCBPlayer,126,271,397,23,42,UCBPlayer
14054,UCBPlayer,105,210,315,10,65,UCBPlayer
14055,UCBPlayer,130,275,405,25,40,UCBPlayer
14056,UCBPlayer,105,210,315,10,65,UCBPlayer
14057,UCBPlayer,130,275,405,25,40,UCBPlayer
14058,UCBPlayer,106,206,312,10,66,UCBPlayer
14059,UCBPlayer,130,275,405,25,40,UCBPlayer
14060,UCBPlayer,105,210,315,10,65,UCBPlayer
14061,UCBPlayer,131,271,402,25,41,UCBPlayer
14062,UCBPlayer,105,210,315,10,65,UCBPlayer
14063,UCBPlayer,130,275,405,25,40,UCBPlayer
14064,UCBPlayer,105,210,315,10,65,UCBPlayer
14065,UCBPlayer,130,275,405,25,40,UCBPlayer
14066,UCBPlayer,103,203,306,10,68,UCBPlayer
14067,UCBPlayer,128,283,411,25,38,UCBPlayer
14068,UCBPlayer,111,186,297,10,71,UCBPlayer
14069,UCBPlayer,124,299,423,25,34,UCBPlayer
14070,UCBPlayer,115,170,285,10,75,UCBPlayer
14071,UCBPlayer,120,315,435,25,30,UCBPlayer
14072,UCBPlayer,119,154,273,10,79,UCBPlayer
14073,UCBPlayer,112,332,444,25,27,UCBPlayer
14074,UCBPlayer,127,137,264,10,82,UCBPlayer
14075,UCBPlayer,104,349,453,25,24,UCBPlayer
14076,UCBPlayer,126,126,252,7,85,Tie
14077,UCBPlayer,111,351,462,28,22,UCBPlayer
14078,UCBPlayer,116,126,242,3,87,UCBPlayer
14079,UCBPlayer,122,347,469,32,21,UCBPlayer
14080,UCBPlayer,107,132,239,0,87,UCBPlayer
14081,UCBPlayer,132,337,469,35,22,UCBPlayer
14082,UCBPlayer,103,148,251,0,83,UCBPlayer
14083,UCBPlayer,136,321,457,35,26,UCBPlayer
14084,UCBPlayer,99,164,263,0,79,UCBPlayer
14085,UCBPlayer,140,305,445,35,30,UCBPlayer
14086,UCBPlayer,95,180,275,0,75,UCBPlayer
14087,UCBPlayer,144,289,433,35,34,UCBPlayer
14088,UCBPlayer,91,196,287,0,71,UCBPlayer
14089,UCBPlayer,148,273,421,35,38,UCBPlayer
14090,UCBPlayer,87,212,299,0,67,UCBPlayer
14091,UCBPlayer,152,257,409,35,42,UCBPlayer
14092,UCBPlayer,84,224,308,0,64,UCBPlayer
14093,UCBPlayer,146,251,397,32,45,UCBPlayer
14094,UCBPlayer,89,234,323,3,60,UCBPlayer
14095,UCBPlayer,138,243,381,28,49,UCBPlayer
14096,UCBPlayer,97,242,339,7,56,UCBPlayer
14097,UCBPlayer,130,235,365,24,53,UCBPlayer
14098,UCBPlayer,105,250,355,11,52,UCBPlayer
14099,UCBPlayer,122,227,349,20,57,UCBPlayer
14100,UCBPlayer,109,259,368,15,49,UCBPlayer
14101,UCBPlayer,118,218,336,16,60,UCBPlayer
14102,UCBPlayer,117,267,384,19,45,UCBPlayer
14103,UCBPlayer,110,210,320,12,64,UCBPlayer
14104,UCBPlayer,126,271,397,23,42,UCBPlayer
14105,UCBPlayer,105,210,315,10,65,UCBPlayer
14106,UCBPlayer,130,275,405,25,40,UCBPlayer
14107,UCBPlayer,105,210,315,10,65,UCBPlayer
14108,UCBPlayer,130,275,405,25,40,UCBPlayer
14109,UCBPlayer,106,206,312,10,66,UCBPlayer
14110,UCBPlayer,130,275,405,25,40,UCBPlayer
14111,UCBPlayer,105,210,315,10,65,UCBPlayer
14112,UCBPlayer,131,271,402,25,41,UCBPlayer
14113,UCBPlayer,105,210,315,10,65,UCBPlayer
14114,UCBPlayer,130,275,405,25,40,UCBPlayer
14115,UCBPlayer,105,210,315,10,65,UCBPlayer
14116,UCBPlayer,130,275,405,25,40,UCBPlayer
14117,UCBPlayer,103,203,306,10,68,UCBPlayer
14118,UCBPlayer,128,283,411,25,38,UCBPlayer
14119,UCBPlayer,111,186,297,10,71,UCBPlayer
14120,UCBPlayer,124,299,423,25,34,UCBPlayer
14121,UCBPlayer,115,170,285,10,75,UCBPlayer
14122,UCBPlayer,120,315,435,25,30,UCBPlayer
14123,UCBPlayer,119,154,273,10,79,UCBPlayer
14124,UCBPlayer,112,332,444,25,27,UCBPlayer
14125,UCBPlayer,127,137,264,10,82,UCBPlayer
14126,UCBPlayer,104,349,453,25,24,UCBPlayer
14127,UCBPlayer,126,126,252,7,85,Tie
14128,UCBPlayer,111,351,462,28,22,UCBPlayer
14129,UCBPlayer,116,126,242,3,87,UCBPlayer
14130,UCBPlayer,122,347,469,32,21,UCBPlayer
14131,UCBPlayer,107,132,239,0,87,UCBPlayer
14132,UCBPlayer,132,337,469,35,22,UCBPlayer
14133,UCBPlayer,103,148,251,0,83,UCBPlayer
14134,UCBPlayer,136,321,457,35,26,UCBPlayer
14135,UCBPlayer,99,164,263,0,79,UCBPlayer
14136,UCBPlayer,140,305,445,35,30,UCBPlayer
14137,UCBPlayer,95,180,275,0,75,UCBPlayer
14138,UCBPlayer,144,289,433,35,34,UCBPlayer
14139,UCBPlayer,91,196,287,0,71,UCBPlayer
14140,UCBPlayer,148,273,421,35,38,UCBPlayer
14141,UCBPlayer,87,212,299,0,67,UCBPlayer
14142,UCBPlayer,152,257,409,35,42,UCBPlayer
14143,UCBPlayer,84,224,308,0,64,UCBPlayer
14144,UCBPlayer,146,251,397,32,45,UCBPlayer
14145,UCBPlayer,89,234,323,3,60,UCBPlayer
14146,UCBPlayer,138,243,381,28,49,UCBPlayer
14147,UCBPlayer,97,242,339,7,56,UCBPlayer
14148,UCBPlayer,130,235,365,24,53,UCBPlayer
14149,UCBPlayer,105,250,355,11,52,UCBPlayer
14150,UCBPlayer,122,227,349,20,57,UCBPlayer
14151,UCBPlayer,109,259,368,15,49,UCBPlayer
14152,UCBPlayer,118,218,336,16,60,UCBPlayer
14153,UCBPlayer,117,267,384,19,45,UCBPlayer
14154,UCBPlayer,110,210,320,12,64,UCBPlayer
14155,UCBPlayer,126,271,397,23,42,UCBPlayer
14156,UCBPlayer,105,210,315,10,65,UCBPlayer
14157,UCBPlayer,130,275,405,25,40,UCBPlayer
14158,UCBPlayer,105,210,315,10,65,UCBPlayer
14159,UCBPlayer,130,275,405,25,40,UCBPlayer
14160,UCBPlayer,106,206,312,10,66,UCBPlayer
14161,UCBPlayer,130,275,405,25,40,UCBPlayer
14162,UCBPlayer,105,210,315,10,65,UCBPlayer
14163,UCBPlayer,131,271,402,25,41,UCBPlayer
14164,UCBPlayer,105,210,315,10,65,UCBPlayer
14165,UCBPlayer,130,275,405,25,40,UCBPlayer
14166,UCBPlayer,105,210,315,10,65,UCBPlayer
14167,UCBPlayer,130,275,405,25,40,UCBPlayer
14168,UCBPlayer,103,203,306,10,68,UCBPlayer
14169,UCBPlayer,128,283,411,25,38,UCBPlayer
14170,UCBPlayer,111,186,297,10,71,UCBPlayer
14171,UCBPlayer,124,299,423,25,34,UCBPlayer
14172,UCBPlayer,115,170,285,10,75,UCBPlayer
14173,UCBPlayer,120,315,435,25,30,UCBPlayer
14174,UCBPlayer,119,154,273,10,79,UCBPlayer
14175,UCBPlayer,112,332,444,25,27,UCBPlayer
14176,UCBPlayer,127,137,264,10,82,UCBPlayer
14177,UCBPlayer,104,349,453,25,24,UCBPlayer
14178,UCBPlayer,126,126,252,7,85,Tie
14179,UCBPlayer,111,351,462,28,22,UCBPlayer
14180,UCBPlayer,116,126,242,3,87,UCBPlayer
14181,UCBPlayer,122,347,469,32,21,UCBPlayer
14182,UCBPlayer,107,132,239,0,87,UCBPlayer
14183,UCBPlayer,132,337,469,35,22,UCBPlayer
14184,UCBPlayer,103,148,251,0,83,UCBPlayer
14185,UCBPlayer,136,321,457,35,26,UCBPlayer
14186,UCBPlayer,99,164,263,0,79,UCBPlayer
14187,UCBPlayer,140,305,445,35,30,UCBPlayer
14188,UCBPlayer,95,180,275,0,75,UCBPlayer
14189,UCBPlayer,144,289,433,35,34,UCBPlayer
14190,UCBPlayer,91,196,287,0,71,UCBPlayer
14191,UCBPlayer,148,273,421,35,38,UCBPlayer
14192,UCBPlayer,87,212,299,0,67,UCBPlayer
14193,UCBPlayer,152,257,409,35,42,UCBPlayer
14194,UCBPlayer,84,224,308,0,64,UCBPlayer
14195,UCBPlayer,146,251,397,32,45,UCBPlayer
14196,UCBPlayer,89,234,323,3,60,UCBPlayer
14197,UCBPlayer,138,243,381,28,49,UCBPlayer
14198,UCBPlayer,97,242,339,7,56,UCBPlayer
14199,UCBPlayer,130,235,365,24,53,UCBPlayer
14200,UCBPlayer,105,250,355,11,52,UCBPlayer
14201,UCBPlayer,122,227,349,20,57,UCBPlayer
14202,UCBPlayer,109,259,368,15,49,UCBPlayer
14203,UCBPlayer,118,218,336,16,60,UCBPlayer
14204,UCBPlayer,117,267,384,19,45,UCBPlayer
14205,UCBPlayer,110,210,320,12,64,UCBPlayer
14206,UCBPlayer,126,271,397,23,42,UCBPlayer
14207,UCBPlayer,105,210,315,10,65,UCBPlayer
14208,UCBPlayer,130,275,405,25,40,UCBPlayer
14209,UCBPlayer,105,210,315,10,65,UCBPlayer
14210,UCBPlayer,130,275,405,25,40,UCBPlayer
14211,UCBPlayer,106,206,312,10,66,UCBPlayer
14212,UCBPlayer,130,275,405,25,40,UCBPlayer
14213,UCBPlayer,105,210,315,10,65,UCBPlayer
14214,UCBPlayer,131,271,402,25,41,UCBPlayer
14215,UCBPlayer,105,210,315,10,65,UCBPlayer
14216,UCBPlayer,130,275,405,25,40,UCBPlayer
14217,UCBPlayer,105,210,315,10,65,UCBPlayer
14218,UCBPlayer,130,275,405,25,40,UCBPlayer
14219,UCBPlayer,103,203,306,10,68,UCBPlayer
14220,UCBPlayer,128,283,411,25,38,UCBPlayer
14221,UCBPlayer,111,186,297,10,71,UCBPlayer
14222,UCBPlayer,124,299,423,25,34,UCBPlayer
14223,UCBPlayer,115,170,285,10,75,UCBPlayer
14224,UCBPlayer,120,315,435,25,30,UCBPlayer
14225,UCBPlayer,119,154,273,10,79,UCBPlayer
14226,UCBPlayer,112,332,444,25,27,UCBPlayer
14227,UCBPlayer,127,137,264,10,82,UCBPlayer
14228,UCBPlayer,104,349,453,25,24,UCBPlayer
14229,UCBPlayer,126,126,252,7,85,Tie
14230,UCBPlayer,111,351,462,28,22,UCBPlayer
14231,UCBPlayer,116,126,242,3,87,UCBPlayer
14232,UCBPlayer,122,347,469,32,21,UCBPlayer
14233,UCBPlayer,107,132,239,0,87,UCBPlayer
14234,UCBPlayer,132,337,469,35,22,UCBPlayer
14235,UCBPlayer,103,148,251,0,83,UCBPlayer
14236,UCBPlayer,136,321,457,35,26,UCBPlayer
14237,UCBPlayer,99,164,263,0,79,UCBPlayer
14238,UCBPlayer,140,305,445,35,30,UCBPlayer
14239,UCBPlayer,95,180,275,0,75,UCBPlayer
14240,UCBPlayer,144,289,433,35,34,UCBPlayer
14241,UCBPlayer,91,196,287,0,71,UCBPlayer
14242,UCBPlayer,148,273,421,35,38,UCBPlayer
14243,UCBPlayer,87,212,299,0,67,UCBPlayer
14244,UCBPlayer,152,257,409,35,42,UCBPlayer
14245,UCBPlayer,84,224,308,0,64,UCBPlayer
14246,UCBPlayer,146,251,397,32,45,UCBPlayer
14247,UCBPlayer,89,234,323,3,60,UCBPlayer
14248,UCBPlayer,138,243,381,28,49,UCBPlayer
14249,UCBPlayer,97,242,339,7,56,UCBPlayer
14250,UCBPlayer,130,235,365,24,53,UCBPlayer
14251,UCBPlayer,105,250,355,11,52,UCBPlayer
14252,UCBPlayer,122,227,349,20,57,UCBPlayer
14253,UCBPlayer,109,259,368,15,49,UCBPlayer
14254,UCBPlayer,118,218,336,16,60,UCBPlayer
14255,UCBPlayer,117,267,384,19,45,UCBPlayer
14256,UCBPlayer,110,210,320,12,64,UCBPlayer
14257,UCBPlayer,126,271,397,23,42,UCBPlayer
14258,UCBPlayer,105,210,315,10,65,UCBPlayer
14259,UCBPlayer,130,275,405,25,40,UCBPlayer
14260,UCBPlayer,105,210,315,10,65,UCBPlayer
14261,UCBPlayer,130,275,405,25,40,UCBPlayer
14262,UCBPlayer,106,206,312,10,66,UCBPlayer
14263,UCBPlayer,130,275,405,25,40,UCBPlayer
14264,UCBPlayer,105,210,315,10,65,UCBPlayer
14265,UCBPlayer,131,271,402,25,41,UCBPlayer
14266,UCBPlayer,105,210,315,10,65,UCBPlayer
14267,UCBPlayer,130,275,405,25,40,UCBPlayer
14268,UCBPlayer,105,210,315,10,65,UCBPlayer
14269,UCBPlayer,130,275,405,25,40,UCBPlayer
14270,UCBPlayer,103,203,306,10,68,UCBPlayer
14271,UCBPlayer,128,283,411,25,38,UCBPlayer
14272,UCBPlayer,111,186,297,10,71,UCBPlayer
14273,UCBPlayer,124,299,423,25,34,UCBPlayer
14274,UCBPlayer,115,170,285,10,75,UCBPlayer
14275,UCBPlayer,120,315,435,25,30,UCBPlayer
14276,UCBPlayer,119,154,273,10,79,UCBPlayer
14277,UCBPlayer,112,332,444,25,27,UCBPlayer
14278,UCBPlayer,127,137,264,10,82,UCBPlayer
14279,UCBPlayer,104,349,453,25,24,UCBPlayer
14280,UCBPlayer,126,126,252,7,85,Tie
14281,UCBPlayer,111,351,462,28,22,UCBPlayer
14282,UCBPlayer,116,126,242,3,87,UCBPlayer
14283,UCBPlayer,122,347,469,32,21,UCBPlayer
14284,UCBPlayer,107,132,239,0,87,UCBPlayer
14285,UCBPlayer,132,337,469,35,22,UCBPlayer
14286,UCBPlayer,103,148,251,0,83,UCBPlayer
14287,UCBPlayer,136,321,457,35,26,UCBPlayer
14288,UCBPlayer,99,164,263,0,79,UCBPlayer
14289,UCBPlayer,140,305,445,35,30,UCBPlayer
14290,UCBPlayer,95,180,275,0,75,UCBPlayer
14291,UCBPlayer,144,289,433,35,34,UCBPlayer
14292,UCBPlayer,91,196,287,0,71,UCBPlayer
14293,UCBPlayer,148,273,421,35,38,UCBPlayer
14294,UCBPlayer,87,212,299,0,67,UCBPlayer
14295,UCBPlayer,152,257,409,35,42,UCBPlayer
14296,UCBPlayer,84,224,308,0,64,UCBPlayer
14297,UCBPlayer,146,251,397,32,45,UCBPlayer
14298,UCBPlayer,89,234,323,3,60,UCBPlayer
14299,UCBPlayer,138,243,381,28,49,UCBPlayer
14300,UCBPlayer,97,242,339,7,56,UCBPlayer
14301,UCBPlayer,130,235,365,24,53,UCBPlayer
14302,UCBPlayer,105,250,355,11,52,UCBPlayer
14303,UCBPlayer,122,227,349,20,57,UCBPlayer
14304,UCBPlayer,109,259,368,15,49,UCBPlayer
14305,UCBPlayer,118,218,336,16,60,UCBPlayer
14306,UCBPlayer,117,267,384,19,45,UCBPlayer
14307,UCBPlayer,110,210,320,12,64,UCBPlayer
14308,UCBPlayer,126,271,397,23,42,UCBPlayer
14309,UCBPlayer,105,210,315,10,65,UCBPlayer
14310,UCBPlayer,130,275,405,25,40,UCBPlayer
14311,UCBPlayer,105,210,315,10,65,UCBPlayer
14312,UCBPlayer,130,275,405,25,40,UCBPlayer
14313,UCBPlayer,106,206,312,10,66,UCBPlayer
14314,UCBPlayer,130,275,405,25,40,UCBPlayer
14315,UCBPlayer,105,210,315,10,65,UCBPlayer
14316,UCBPlayer,131,271,402,25,41,UCBPlayer
14317,UCBPlayer,105,210,315,10,65,UCBPlayer
14318,UCBPlayer,130,275,405,25,40,UCBPlayer
14319,UCBPlayer,105,210,315,10,65,UCBPlayer
14320,UCBPlayer,130,275,405,25,40,UCBPlayer
14321,UCBPlayer,103,203,306,10,68,UCBPlayer
14322,UCBPlayer,128,283,411,25,38,UCBPlayer
14323,UCBPlayer,111,186,297,10,71,UCBPlayer
14324,UCBPlayer,124,299,423,25,34,UCBPlayer
14325,UCBPlayer,115,170,285,10,75,UCBPlayer
14326,UCBPlayer,120,315,435,25,30,UCBPlayer
14327,UCBPlayer,119,154,273,10,79,UCBPlayer
14328,UCBPlayer,112,332,444,25,27,UCBPlayer
14329,UCBPlayer,127,137,264,10,82,UCBPlayer
14330,UCBPlayer,104,349,453,25,24,UCBPlayer
14331,UCBPlayer,126,126,252,7,85,Tie
14332,UCBPlayer,111,351,462,28,22,UCBPlayer
14333,UCBPlayer,116,126,242,3,87,UCBPlayer
14334,UCBPlayer,122,347,469,32,21,UCBPlayer
14335,UCBPlayer,107,132,239,0,87,UCBPlayer
14336,UCBPlayer,132,337,469,35,22,UCBPlayer
14337,UCBPlayer,103,148,251,0,83,UCBPlayer
14338,UCBPlayer,136,321,457,35,26,UCBPlayer
14339,UCBPlayer,99,164,263,0,79,UCBPlayer
14340,UCBPlayer,140,305,445,35,30,UCBPlayer
14341,UCBPlayer,95,180,275,0,75,UCBPlayer
14342,UCBPlayer,144,289,433,35,34,UCBPlayer
14343,UCBPlayer,91,196,287,0,71,UCBPlayer
14344,UCBPlayer,148,273,421,35,38,UCBPlayer
14345,UCBPlayer,87,212,299,0,67,UCBPlayer
14346,UCBPlayer,152,257,409,35,42,UCBPlayer
14347,UCBPlayer,84,224,308,0,64,UCBPlayer
14348,UCBPlayer,146,251,397,32,45,UCBPlayer
14349,UCBPlayer,89,234,323,3,60,UCBPlayer
14350,UCBPlayer,138,243,381,28,49,UCBPlayer
14351,UCBPlayer,97,242,339,7,56,UCBPlayer
14352,UCBPlayer,130,235,365,24,53,UCBPlayer
14353,UCBPlayer,105,250,355,11,52,UCBPlayer
14354,UCBPlayer,122,227,349,20,57,UCBPlayer
14355,UCBPlayer,109,259,368,15,49,UCBPlayer
14356,UCBPlayer,118,218,336,16,60,UCBPlayer
14357,UCBPlayer,117,267,384,19,45,UCBPlayer
14358,UCBPlayer,110,210,320,12,64,UCBPlayer
14359,UCBPlayer,126,271,397,23,42,UCBPlayer
14360,UCBPlayer,105,210,315,10,65,UCBPlayer
14361,UCBPlayer,130,275,405,25,40,UCBPlayer
14362,UCBPlayer,105,210,315,10,65,UCBPlayer
14363,UCBPlayer,130,275,405,25,40,UCBPlayer
14364,UCBPlayer,106,206,312,10,66,UCBPlayer
14365,UCBPlayer,130,275,405,25,40,UCBPlayer
14366,UCBPlayer,105,210,315,10,65,UCBPlayer
14367,UCBPlayer,131,271,402,25,41,UCBPlayer
14368,UCBPlayer,105,210,315,10,65,UCBPlayer
14369,UCBPlayer,130,275,405,25,40,UCBPlayer
14370,UCBPlayer,105,210,315,10,65,UCBPlayer
14371,UCBPlayer,130,275,405,25,40,UCBPlayer
14372,UCBPlayer,103,203,306,10,68,UCBPlayer
14373,UCBPlayer,128,283,411,25,38,UCBPlayer
14374,UCBPlayer,111,186,297,10,71,UCBPlayer
14375,UCBPlayer,124,299,423,25,34,UCBPlayer
14376,UCBPlayer,115,170,285,10,75,UCBPlayer
14377,UCBPlayer,120,315,435,25,30,UCBPlayer
14378,UCBPlayer,119,154,273,10,79,UCBPlayer
14379,UCBPlayer,112,332,444,25,27,UCBPlayer
14380,UCBPlayer,127,137,264,10,82,UCBPlayer
14381,UCBPlayer,104,349,453,25,24,UCBPlayer
14382,UCBPlayer,126,126,252,7,85,Tie
14383,UCBPlayer,111,351,462,28,22,UCBPlayer
14384,UCBPlayer,116,126,242,3,87,UCBPlayer
14385,UCBPlayer,122,347,469,32,21,UCBPlayer
14386,UCBPlayer,107,132,239,0,87,UCBPlayer
14387,UCBPlayer,132,337,469,35,22,UCBPlayer
14388,UCBPlayer,103,148,251,0,83,UCBPlayer
14389,UCBPlayer,136,321,457,35,26,UCBPlayer
14390,UCBPlayer,99,164,263,0,79,UCBPlayer
14391,UCBPlayer,140,305,445,35,30,UCBPlayer
14392,UCBPlayer,95,180,275,0,75,UCBPlayer
14393,UCBPlayer,144,289,433,35,34,UCBPlayer
14394,UCBPlayer,91,196,287,0,71,UCBPlayer
14395,UCBPlayer,148,273,421,35,38,UCBPlayer
14396,UCBPlayer,87,212,299,0,67,UCBPlayer
14397,UCBPlayer,152,257,409,35,42,UCBPlayer
14398,UCBPlayer,84,224,308,0,64,UCBPlayer
14399,UCBPlayer,146,251,397,32,45,UCBPlayer
14400,UCBPlayer,89,234,323,3,60,UCBPlayer
14401,UCBPlayer,138,243,381,28,49,UCBPlayer
14402,UCBPlayer,97,242,339,7,56,UCBPlayer
14403,UCBPlayer,130,235,365,24,53,UCBPlayer
14404,UCBPlayer,105,250,355,11,52,UCBPlayer
14405,UCBPlayer,122,227,349,20,57,UCBPlayer
14406,UCBPlayer,109,259,368,15,49,UCBPlayer
14407,UCBPlayer,118,218,336,16,60,UCBPlayer
14408,UCBPlayer,117,267,384,19,45,UCBPlayer
14409,UCBPlayer,110,210,320,12,64,UCBPlayer
14410,UCBPlayer,126,271,397,23,42,UCBPlayer
14411,UCBPlayer,105,210,315,10,65,UCBPlayer
14412,UCBPlayer,130,275,405,25,40,UCBPlayer
14413,UCBPlayer,105,210,315,10,65,UCBPlayer
14414,UCBPlayer,130,275,405,25,40,UCBPlayer
14415,UCBPlayer,106,206,312,10,66,UCBPlayer
14416,UCBPlayer,130,275,405,25,40,UCBPlayer
14417,UCBPlayer,105,210,315,10,65,UCBPlayer
14418,UCBPlayer,131,271,402,25,41,UCBPlayer
14419,UCBPlayer,105,210,315,10,65,UCBPlayer
14420,UCBPlayer,130,275,405,25,40,UCBPlayer
14421,UCBPlayer,105,210,315,10,65,UCBPlayer
14422,UCBPlayer,130,275,405,25,40,UCBPlayer
14423,UCBPlayer,103,203,306,10,68,UCBPlayer
14424,UCBPlayer,128,283,411,25,38,UCBPlayer
14425,UCBPlayer,111,186,297,10,71,UCBPlayer
14426,UCBPlayer,124,299,423,25,34,UCBPlayer
14427,UCBPlayer,115,170,285,10,75,UCBPlayer
14428,UCBPlayer,120,315,435,25,30,UCBPlayer
14429,UCBPlayer,119,154,273,10,79,UCBPlayer
14430,UCBPlayer,112,332,444,25,27,UCBPlayer
14431,UCBPlayer,127,137,264,10,82,UCBPlayer
14432,UCBPlayer,104,349,453,25,24,UCBPlayer
14433,UCBPlayer,126,126,252,7,85,Tie
14434,UCBPlayer,111,351,462,28,22,UCBPlayer
14435,UCBPlayer,116,126,242,3,87,UCBPlayer
14436,UCBPlayer,122,347,469,32,21,UCBPlayer
14437,UCBPlayer,107,132,239,0,87,UCBPlayer
14438,UCBPlayer,132,337,469,35,22,UCBPlayer
14439,UCBPlayer,103,148,251,0,83,UCBPlayer
14440,UCBPlayer,136,321,457,35,26,UCBPlayer
14441,UCBPlayer,99,164,263,0,79,UCBPlayer
14442,UCBPlayer,140,305,445,35,30,UCBPlayer
14443,UCBPlayer,95,180,275,0,75,UCBPlayer
14444,UCBPlayer,144,289,433,35,34,UCBPlayer
14445,UCBPlayer,91,196,287,0,71,UCBPlayer
14446,UCBPlayer,148,273,421,35,38,UCBPlayer
14447,UCBPlayer,87,212,299,0,67,UCBPlayer
14448,UCBPlayer,152,257,409,35,42,UCBPlayer
14449,UCBPlayer,84,224,308,0,64,UCBPlayer
14450,UCBPlayer,146,251,397,32,45,UCBPlayer
14451,UCBPlayer,89,234,323,3,60,UCBPlayer
14452,UCBPlayer,138,243,381,28,49,UCBPlayer
14453,UCBPlayer,97,242,339,7,56,UCBPlayer
14454,UCBPlayer,130,235,365,24,53,UCBPlayer
14455,UCBPlayer,105,250,355,11,52,UCBPlayer
14456,UCBPlayer,122,227,349,20,57,UCBPlayer
14457,UCBPlayer,109,259,368,15,49,UCBPlayer
14458,UCBPlayer,118,218,336,16,60,UCBPlayer
14459,UCBPlayer,117,267,384,19,45,UCBPlayer
14460,UCBPlayer,110,210,320,12,64,UCBPlayer
14461,UCBPlayer,126,271,397,23,42,UCBPlayer
14462,UCBPlayer,105,210,315,10,65,UCBPlayer
14463,UCBPlayer,130,275,405,25,40,UCBPlayer
14464,UCBPlayer,105,210,315,10,65,UCBPlayer
14465,UCBPlayer,130,275,405,25,40,UCBPlayer
14466,UCBPlayer,106,206,312,10,66,UCBPlayer
14467,UCBPlayer,130,275,405,25,40,UCBPlayer
14468,UCBPlayer,105,210,315,10,65,UCBPlayer
14469,UCBPlayer,131,271,402,25,41,UCBPlayer
14470,UCBPlayer,105,210,315,10,65,UCBPlayer
14471,UCBPlayer,130,275,405,25,40,UCBPlayer
14472,UCBPlayer,105,210,315,10,65,UCBPlayer
14473,UCBPlayer,130,275,405,25,40,UCBPlayer
14474,UCBPlayer,103,203,306,10,68,UCBPlayer
14475,UCBPlayer,128,283,411,25,38,UCBPlayer
14476,UCBPlayer,111,186,297,10,71,UCBPlayer
14477,UCBPlayer,124,299,423,25,34,UCBPlayer
14478,UCBPlayer,115,170,285,10,75,UCBPlayer
14479,UCBPlayer,120,315,435,25,30,UCBPlayer
14480,UCBPlayer,119,154,273,10,79,UCBPlayer
14481,UCBPlayer,112,332,444,25,27,UCBPlayer
14482,UCBPlayer,127,137,264,10,82,UCBPlayer
14483,UCBPlayer,104,349,453,25,24,UCBPlayer
14484,UCBPlayer,126,126,252,7,85,Tie
14485,UCBPlayer,111,351,462,28,22,UCBPlayer
14486,UCBPlayer,116,126,242,3,87,UCBPlayer
14487,UCBPlayer,122,347,469,32,21,UCBPlayer
14488,UCBPlayer,107,132,239,0,87,UCBPlayer
14489,UCBPlayer,132,337,469,35,22,UCBPlayer
14490,UCBPlayer,103,148,251,0,83,UCBPlayer
14491,UCBPlayer,136,321,457,35,26,UCBPlayer
14492,UCBPlayer,99,164,263,0,79,UCBPlayer
14493,UCBPlayer,140,305,445,35,30,UCBPlayer
14494,UCBPlayer,95,180,275,0,75,UCBPlayer
14495,UCBPlayer,144,289,433,35,34,UCBPlayer
14496,UCBPlayer,91,196,287,0,71,UCBPlayer
14497,UCBPlayer,148,273,421,35,38,UCBPlayer
14498,UCBPlayer,87,212,299,0,67,UCBPlayer
14499,UCBPlayer,152,257,409,35,42,UCBPlayer
14500,UCBPlayer,84,224,308,0,64,UCBPlayer
14501,UCBPlayer,146,251,397,32,45,UCBPlayer
14502,UCBPlayer,89,234,323,3,60,UCBPlayer
14503,UCBPlayer,138,243,381,28,49,UCBPlayer
14504,UCBPlayer,97,242,339,7,56,UCBPlayer
14505,UCBPlayer,130,235,365,24,53,UCBPlayer
14506,UCBPlayer,105,250,355,11,52,UCBPlayer
14507,UCBPlayer,122,227,349,20,57,UCBPlayer
14508,UCBPlayer,109,259,368,15,49,UCBPlayer
14509,UCBPlayer,118,218,336,16,60,UCBPlayer
14510,UCBPlayer,117,267,384,19,45,UCBPlayer
14511,UCBPlayer,110,210,320,12,64,UCBPlayer
14512,UCBPlayer,126,271,397,23,42,UCBPlayer
14513,UCBPlayer,105,210,315,10,65,UCBPlayer
14514,UCBPlayer,130,275,405,25,40,UCBPlayer
14515,UCBPlayer,105,210,315,10,65,UCBPlayer
14516,UCBPlayer,130,275,405,25,40,UCBPlayer
14517,UCBPlayer,106,206,312,10,66,UCBPlayer
14518,UCBPlayer,130,275,405,25,40,UCBPlayer
14519,UCBPlayer,105,210,315,10,65,UCBPlayer
14520,UCBPlayer,131,271,402,25,41,UCBPlayer
14521,UCBPlayer,105,210,315,10,65,UCBPlayer
14522,UCBPlayer,130,275,405,25,40,UCBPlayer
14523,UCBPlayer,105,210,315,10,65,UCBPlayer
14524,UCBPlayer,130,275,405,25,40,UCBPlayer
14525,UCBPlayer,103,203,306,10,68,UCBPlayer
14526,UCBPlayer,128,283,411,25,38,UCBPlayer
14527,UCBPlayer,111,186,297,10,71,UCBPlayer
14528,UCBPlayer,124,299,423,25,34,UCBPlayer
14529,UCBPlayer,115,170,285,10,75,UCBPlayer
14530,UCBPlayer,120,315,435,25,30,UCBPlayer
14531,UCBPlayer,119,154,273,10,79,UCBPlayer
14532,UCBPlayer,112,332,444,25,27,UCBPlayer
14533,UCBPlayer,127,137,264,10,82,UCBPlayer
14534,UCBPlayer,104,349,453,25,24,UCBPlayer
14535,UCBPlayer,126,126,252,7,85,Tie
14536,UCBPlayer,111,351,462,28,22,UCBPlayer
14537,UCBPlayer,116,126,242,3,87,UCBPlayer
14538,UCBPlayer,122,347,469,32,21,UCBPlayer
14539,UCBPlayer,107,132,239,0,87,UCBPlayer
14540,UCBPlayer,132,337,469,35,22,UCBPlayer
14541,UCBPlayer,103,148,251,0,83,UCBPlayer
14542,UCBPlayer,136,321,457,35,26,UCBPlayer
14543,UCBPlayer,99,164,263,0,79,UCBPlayer
14544,UCBPlayer,140,305,445,35,30,UCBPlayer
14545,UCBPlayer,95,180,275,0,75,UCBPlayer
14546,UCBPlayer,144,289,433,35,34,UCBPlayer
14547,UCBPlayer,91,196,287,0,71,UCBPlayer
14548,UCBPlayer,148,273,421,35,38,UCBPlayer
14549,UCBPlayer,87,212,299,0,67,UCBPlayer
14550,UCBPlayer,152,257,409,35,42,UCBPlayer
14551,UCBPlayer,84,224,308,0,64,UCBPlayer
14552,UCBPlayer,146,251,397,32,45,UCBPlayer
14553,UCBPlayer,89,234,323,3,60,UCBPlayer
14554,UCBPlayer,138,243,381,28,49,UCBPlayer
14555,UCBPlayer,97,242,339,7,56,UCBPlayer
14556,UCBPlayer,130,235,365,24,53,UCBPlayer
14557,UCBPlayer,105,250,355,11,52,UCBPlayer
14558,UCBPlayer,122,227,349,20,57,UCBPlayer
14559,UCBPlayer,109,259,368,15,49,UCBPlayer
14560,UCBPlayer,118,218,336,16,60,UCBPlayer
14561,UCBPlayer,117,267,384,19,45,UCBPlayer
14562,UCBPlayer,110,210,320,12,64,UCBPlayer
14563,UCBPlayer,126,271,397,23,42,UCBPlayer
14564,UCBPlayer,105,210,315,10,65,UCBPlayer
14565,UCBPlayer,130,275,405,25,40,UCBPlayer
14566,UCBPlayer,105,210,315,10,65,UCBPlayer
14567,UCBPlayer,130,275,405,25,40,UCBPlayer
14568,UCBPlayer,106,206,312,10,66,UCBPlayer
14569,UCBPlayer,130,275,405,25,40,UCBPlayer
14570,UCBPlayer,105,210,315,10,65,UCBPlayer
14571,UCBPlayer,131,271,402,25,41,UCBPlayer
14572,UCBPlayer,105,210,315,10,65,UCBPlayer
14573,UCBPlayer,130,275,405,25,40,UCBPlayer
14574,UCBPlayer,105,210,315,10,65,UCBPlayer
14575,UCBPlayer,130,275,405,25,40,UCBPlayer
14576,UCBPlayer,103,203,306,10,68,UCBPlayer
14577,UCBPlayer,128,283,411,25,38,UCBPlayer
14578,UCBPlayer,111,186,297,10,71,UCBPlayer
14579,UCBPlayer,124,299,423,25,34,UCBPlayer
14580,UCBPlayer,115,170,285,10,75,UCBPlayer
14581,UCBPlayer,120,315,435,25,30,UCBPlayer
14582,UCBPlayer,119,154,273,10,79,UCBPlayer
14583,UCBPlayer,112,332,444,25,27,UCBPlayer
14584,UCBPlayer,127,137,264,10,82,UCBPlayer
14585,UCBPlayer,104,349,453,25,24,UCBPlayer
14586,UCBPlayer,126,126,252,7,85,Tie
14587,UCBPlayer,111,351,462,28,22,UCBPlayer
14588,UCBPlayer,116,126,242,3,87,UCBPlayer
14589,UCBPlayer,122,347,469,32,21,UCBPlayer
14590,UCBPlayer,107,132,239,0,87,UCBPlayer
14591,UCBPlayer,132,337,469,35,22,UCBPlayer
14592,UCBPlayer,103,148,251,0,83,UCBPlayer
14593,UCBPlayer,136,321,457,35,26,UCBPlayer
14594,UCBPlayer,99,164,263,0,79,UCBPlayer
14595,UCBPlayer,140,305,445,35,30,UCBPlayer
14596,UCBPlayer,95,180,275,0,75,UCBPlayer
14597,UCBPlayer,144,289,433,35,34,UCBPlayer
14598,UCBPlayer,91,196,287,0,71,UCBPlayer
14599,UCBPlayer,148,273,421,35,38,UCBPlayer
14600,UCBPlayer,87,212,299,0,67,UCBPlayer
14601,UCBPlayer,152,257,409,35,42,UCBPlayer
14602,UCBPlayer,84,224,308,0,64,UCBPlayer
14603,UCBPlayer,146,251,397,32,45,UCBPlayer
14604,UCBPlayer,89,234,323,3,60,UCBPlayer
14605,UCBPlayer,138,243,381,28,49,UCBPlayer
14606,UCBPlayer,97,242,339,7,56,UCBPlayer
14607,UCBPlayer,130,235,365,24,53,UCBPlayer
14608,UCBPlayer,105,250,355,11,52,UCBPlayer
14609,UCBPlayer,122,227,349,20,57,UCBPlayer
14610,UCBPlayer,109,259,368,15,49,UCBPlayer
14611,UCBPlayer,118,218,336,16,60,UCBPlayer
14612,UCBPlayer,117,267,384,19,45,UCBPlayer
14613,UCBPlayer,110,210,320,12,64,UCBPlayer
14614,UCBPlayer,126,271,397,23,42,UCBPlayer
14615,UCBPlayer,105,210,315,10,65,UCBPlayer
14616,UCBPlayer,130,275,405,25,40,UCBPlayer
14617,UCBPlayer,105,210,315,10,65,UCBPlayer
14618,UCBPlayer,130,275,405,25,40,UCBPlayer
14619,UCBPlayer,106,206,312,10,66,UCBPlayer
14620,UCBPlayer,130,275,405,25,40,UCBPlayer
14621,UCBPlayer,105,210,315,10,65,UCBPlayer
14622,UCBPlayer,131,271,402,25,41,UCBPlayer
14623,UCBPlayer,105,210,315,10,65,UCBPlayer
14624,UCBPlayer,130,275,405,25,40,UCBPlayer
14625,UCBPlayer,105,210,315,10,65,UCBPlayer
14626,UCBPlayer,130,275,405,25,40,UCBPlayer
14627,UCBPlayer,103,203,306,10,68,UCBPlayer
14628,UCBPlayer,128,283,411,25,38,UCBPlayer
14629,UCBPlayer,111,186,297,10,71,UCBPlayer
14630,UCBPlayer,124,299,423,25,34,UCBPlayer
14631,UCBPlayer,115,170,285,10,75,UCBPlayer
14632,UCBPlayer,120,315,435,25,30,UCBPlayer
14633,UCBPlayer,119,154,273,10,79,UCBPlayer
14634,UCBPlayer,112,332,444,25,27,UCBPlayer
14635,UCBPlayer,127,137,264,10,82,UCBPlayer
14636,UCBPlayer,104,349,453,25,24,UCBPlayer
14637,UCBPlayer,126,126,252,7,85,Tie
14638,UCBPlayer,111,351,462,28,22,UCBPlayer
14639,UCBPlayer,116,126,242,3,87,UCBPlayer
14640,UCBPlayer,122,347,469,32,21,UCBPlayer
14641,UCBPlayer,107,132,239,0,87,UCBPlayer
14642,UCBPlayer,132,337,469,35,22,UCBPlayer
14643,UCBPlayer,103,148,251,0,83,UCBPlayer
14644,UCBPlayer,136,321,457,35,26,UCBPlayer
14645,UCBPlayer,99,164,263,0,79,UCBPlayer
14646,UCBPlayer,140,305,445,35,30,UCBPlayer
14647,UCBPlayer,95,180,275,0,75,UCBPlayer
14648,UCBPlayer,144,289,433,35,34,UCBPlayer
14649,UCBPlayer,91,196,287,0,71,UCBPlayer
14650,UCBPlayer,148,273,421,35,38,UCBPlayer
14651,UCBPlayer,87,212,299,0,67,UCBPlayer
14652,UCBPlayer,152,257,409,35,42,UCBPlayer
14653,UCBPlayer,84,224,308,0,64,UCBPlayer
14654,UCBPlayer,146,251,397,32,45,UCBPlayer
14655,UCBPlayer,89,234,323,3,60,UCBPlayer
14656,UCBPlayer,138,243,381,28,49,UCBPlayer
14657,UCBPlayer,97,242,339,7,56,UCBPlayer
14658,UCBPlayer,130,235,365,24,53,UCBPlayer
14659,UCBPlayer,105,250,355,11,52,UCBPlayer
14660,UCBPlayer,122,227,349,20,57,UCBPlayer
14661,UCBPlayer,109,259,368,15,49,UCBPlayer
14662,UCBPlayer,118,218,336,16,60,UCBPlayer
14663,UCBPlayer,117,267,384,19,45,UCBPlayer
14664,UCBPlayer,110,210,320,12,64,UCBPlayer
14665,UCBPlayer,126,271,397,23,42,UCBPlayer
14666,UCBPlayer,105,210,315,10,65,UCBPlayer
14667,UCBPlayer,130,275,405,25,40,UCBPlayer
14668,UCBPlayer,105,210,315,10,65,UCBPlayer
14669,UCBPlayer,130,275,405,25,40,UCBPlayer
14670,UCBPlayer,106,206,312,10,66,UCBPlayer
14671,UCBPlayer,130,275,405,25,40,UCBPlayer
14672,UCBPlayer,105,210,315,10,65,UCBPlayer
14673,UCBPlayer,131,271,402,25,41,UCBPlayer
14674,UCBPlayer,105,210,315,10,65,UCBPlayer
14675,UCBPlayer,130,275,405,25,40,UCBPlayer
14676,UCBPlayer,105,210,315,10,65,UCBPlayer
14677,UCBPlayer,130,275,405,25,40,UCBPlayer
14678,UCBPlayer,103,203,306,10,68,UCBPlayer
14679,UCBPlayer,128,283,411,25,38,UCBPlayer
14680,UCBPlayer,111,186,297,10,71,UCBPlayer
14681,UCBPlayer,124,299,423,25,34,UCBPlayer
14682,UCBPlayer,115,170,285,10,75,UCBPlayer
14683,UCBPlayer,120,315,435,25,30,UCBPlayer
14684,UCBPlayer,119,154,273,10,79,UCBPlayer
14685,UCBPlayer,112,332,444,25,27,UCBPlayer
14686,UCBPlayer,127,137,264,10,82,UCBPlayer
14687,UCBPlayer,104,349,453,25,24,UCBPlayer
14688,UCBPlayer,126,126,252,7,85,Tie
14689,UCBPlayer,111,351,462,28,22,UCBPlayer
14690,UCBPlayer,116,126,242,3,87,UCBPlayer
14691,UCBPlayer,122,347,469,32,21,UCBPlayer
14692,UCBPlayer,107,132,239,0,87,UCBPlayer
14693,UCBPlayer,132,337,469,35,22,UCBPlayer
14694,UCBPlayer,103,148,251,0,83,UCBPlayer
14695,UCBPlayer,136,321,457,35,26,UCBPlayer
14696,UCBPlayer,99,164,263,0,79,UCBPlayer
14697,UCBPlayer,140,305,445,35,30,UCBPlayer
14698,UCBPlayer,95,180,275,0,75,UCBPlayer
14699,UCBPlayer,144,289,433,35,34,UCBPlayer
14700,UCBPlayer,91,196,287,0,71,UCBPlayer
14701,UCBPlayer,148,273,421,35,38,UCBPlayer
14702,UCBPlayer,87,212,299,0,67,UCBPlayer
14703,UCBPlayer,152,257,409,35,42,UCBPlayer
14704,UCBPlayer,84,224,308,0,64,UCBPlayer
14705,UCBPlayer,146,251,397,32,45,UCBPlayer
14706,UCBPlayer,89,234,323,3,60,UCBPlayer
14707,UCBPlayer,138,243,381,28,49,UCBPlayer
14708,UCBPlayer,97,242,339,7,56,UCBPlayer
14709,UCBPlayer,130,235,365,24,53,UCBPlayer
14710,UCBPlayer,105,250,355,11,52,UCBPlayer
14711,UCBPlayer,122,227,349,20,57,UCBPlayer
14712,UCBPlayer,109,259,368,15,49,UCBPlayer
14713,UCBPlayer,118,218,336,16,60,UCBPlayer
14714,UCBPlayer,117,267,384,19,45,UCBPlayer
14715,UCBPlayer,110,210,320,12,64,UCBPlayer
14716,UCBPlayer,126,271,397,23,42,UCBPlayer
14717,UCBPlayer,105,210,315,10,65,UCBPlayer
14718,UCBPlayer,130,275,405,25,40,UCBPlayer
14719,UCBPlayer,105,210,315,10,65,UCBPlayer
14720,UCBPlayer,130,275,405,25,40,UCBPlayer
14721,UCBPlayer,106,206,312,10,66,UCBPlayer
14722,UCBPlayer,130,275,405,25,40,UCBPlayer
14723,UCBPlayer,105,210,315,10,65,UCBPlayer
14724,UCBPlayer,131,271,402,25,41,UCBPlayer
14725,UCBPlayer,105,210,315,10,65,UCBPlayer
14726,UCBPlayer,130,275,405,25,40,UCBPlayer
14727,UCBPlayer,105,210,315,10,65,UCBPlayer
14728,UCBPlayer,130,275,405,25,40,UCBPlayer
14729,UCBPlayer,103,203,306,10,68,UCBPlayer
14730,UCBPlayer,128,283,411,25,38,UCBPlayer
14731,UCBPlayer,111,186,297,10,71,UCBPlayer
14732,UCBPlayer,124,299,423,25,34,UCBPlayer
14733,UCBPlayer,115,170,285,10,75,UCBPlayer
14734,UCBPlayer,120,315,435,25,30,UCBPlayer
14735,UCBPlayer,119,154,273,10,79,UCBPlayer
14736,UCBPlayer,112,332,444,25,27,UCBPlayer
14737,UCBPlayer,127,137,264,10,82,UCBPlayer
14738,UCBPlayer,104,349,453,25,24,UCBPlayer
14739,UCBPlayer,126,126,252,7,85,Tie
14740,UCBPlayer,111,351,462,28,22,UCBPlayer
14741,UCBPlayer,116,126,242,3,87,UCBPlayer
14742,UCBPlayer,122,347,469,32,21,UCBPlayer
14743,UCBPlayer,107,132,239,0,87,UCBPlayer
14744,UCBPlayer,132,337,469,35,22,UCBPlayer
14745,UCBPlayer,103,148,251,0,83,UCBPlayer
14746,UCBPlayer,136,321,457,35,26,UCBPlayer
14747,UCBPlayer,99,164,263,0,79,UCBPlayer
14748,UCBPlayer,140,305,445,35,30,UCBPlayer
14749,UCBPlayer,95,180,275,0,75,UCBPlayer
14750,UCBPlayer,144,289,433,35,34,UCBPlayer
14751,UCBPlayer,91,196,287,0,71,UCBPlayer
14752,UCBPlayer,148,273,421,35,38,UCBPlayer
14753,UCBPlayer,87,212,299,0,67,UCBPlayer
14754,UCBPlayer,152,257,409,35,42,UCBPlayer
14755,UCBPlayer,84,224,308,0,64,UCBPlayer
14756,UCBPlayer,146,251,397,32,45,UCBPlayer
14757,UCBPlayer,89,234,323,3,60,UCBPlayer
14758,UCBPlayer,138,243,381,28,49,UCBPlayer
14759,UCBPlayer,97,242,339,7,56,UCBPlayer
14760,UCBPlayer,130,235,365,24,53,UCBPlayer
14761,UCBPlayer,105,250,355,11,52,UCBPlayer
14762,UCBPlayer,122,227,349,20,57,UCBPlayer
14763,UCBPlayer,109,259,368,15,49,UCBPlayer
14764,UCBPlayer,118,218,336,16,60,UCBPlayer
14765,UCBPlayer,117,267,384,19,45,UCBPlayer
14766,UCBPlayer,110,210,320,12,64,UCBPlayer
14767,UCBPlayer,126,271,397,23,42,UCBPlayer
14768,UCBPlayer,105,210,315,10,65,UCBPlayer
14769,UCBPlayer,130,275,405,25,40,UCBPlayer
14770,UCBPlayer,105,210,315,10,65,UCBPlayer
14771,UCBPlayer,130,275,405,25,40,UCBPlayer
14772,UCBPlayer,106,206,312,10,66,UCBPlayer
14773,UCBPlayer,130,275,405,25,40,UCBPlayer
14774,UCBPlayer,105,210,315,10,65,UCBPlayer
14775,UCBPlayer,131,271,402,25,41,UCBPlayer
14776,UCBPlayer,105,210,315,10,65,UCBPlayer
14777,UCBPlayer,130,275,405,25,40,UCBPlayer
14778,UCBPlayer,105,210,315,10,65,UCBPlayer
14779,UCBPlayer,130,275,405,25,40,UCBPlayer
14780,UCBPlayer,103,203,306,10,68,UCBPlayer
14781,UCBPlayer,128,283,411,25,38,UCBPlayer
14782,UCBPlayer,111,186,297,10,71,UCBPlayer
14783,UCBPlayer,124,299,423,25,34,UCBPlayer
14784,UCBPlayer,115,170,285,10,75,UCBPlayer
14785,UCBPlayer,120,315,435,25,30,UCBPlayer
14786,UCBPlayer,119,154,273,10,79,UCBPlayer
14787,UCBPlayer,112,332,444,25,27,UCBPlayer
14788,UCBPlayer,127,137,264,10,82,UCBPlayer
14789,UCBPlayer,104,349,453,25,24,UCBPlayer
14790,UCBPlayer,126,126,252,7,85,Tie
14791,UCBPlayer,111,351,462,28,22,UCBPlayer
14792,UCBPlayer,116,126,242,3,87,UCBPlayer
14793,UCBPlayer,122,347,469,32,21,UCBPlayer
14794,UCBPlayer,107,132,239,0,87,UCBPlayer
14795,UCBPlayer,132,337,469,35,22,UCBPlayer
14796,UCBPlayer,103,148,251,0,83,UCBPlayer
14797,UCBPlayer,136,321,457,35,26,UCBPlayer
14798,UCBPlayer,99,164,263,0,79,UCBPlayer
14799,UCBPlayer,140,305,445,35,30,UCBPlayer
14800,UCBPlayer,95,180,275,0,75,UCBPlayer
14801,UCBPlayer,144,289,433,35,34,UCBPlayer
14802,UCBPlayer,91,196,287,0,71,UCBPlayer
14803,UCBPlayer,148,273,421,35,38,UCBPlayer
14804,UCBPlayer,87,212,299,0,67,UCBPlayer
14805,UCBPlayer,152,257,409,35,42,UCBPlayer
14806,UCBPlayer,84,224,308,0,64,UCBPlayer
14807,UCBPlayer,146,251,397,32,45,UCBPlayer
14808,UCBPlayer,89,234,323,3,60,UCBPlayer
14809,UCBPlayer,138,243,381,28,49,UCBPlayer
14810,UCBPlayer,97,242,339,7,56,UCBPlayer
14811,UCBPlayer,130,235,365,24,53,UCBPlayer
14812,UCBPlayer,105,250,355,11,52,UCBPlayer
14813,UCBPlayer,122,227,349,20,57,UCBPlayer
14814,UCBPlayer,109,259,368,15,49,UCBPlayer
14815,UCBPlayer,118,218,336,16,60,UCBPlayer
14816,UCBPlayer,117,267,384,19,45,UCBPlayer
14817,UCBPlayer,110,210,320,12,64,UCBPlayer
14818,UCBPlayer,126,271,397,23,42,UCBPlayer
14819,UCBPlayer,105,210,315,10,65,UCBPlayer
14820,UCBPlayer,130,275,405,25,40,UCBPlayer
14821,UCBPlayer,105,210,315,10,65,UCBPlayer
14822,UCBPlayer,130,275,405,25,40,UCBPlayer
14823,UCBPlayer,106,206,312,10,66,UCBPlayer
14824,UCBPlayer,130,275,405,25,40,UCBPlayer
14825,UCBPlayer,105,210,315,10,65,UCBPlayer
14826,UCBPlayer,131,271,402,25,41,UCBPlayer
14827,UCBPlayer,105,210,315,10,65,UCBPlayer
14828,UCBPlayer,130,275,405,25,40,UCBPlayer
14829,UCBPlayer,105,210,315,10,65,UCBPlayer
14830,UCBPlayer,130,275,405,25,40,UCBPlayer
14831,UCBPlayer,103,203,306,10,68,UCBPlayer
14832,UCBPlayer,128,283,411,25,38,UCBPlayer
14833,UCBPlayer,111,186,297,10,71,UCBPlayer
14834,UCBPlayer,124,299,423,25,34,UCBPlayer
14835,UCBPlayer,115,170,285,10,75,UCBPlayer
14836,UCBPlayer,120,315,435,25,30,UCBPlayer
14837,UCBPlayer,119,154,273,10,79,UCBPlayer
14838,UCBPlayer,112,332,444,25,27,UCBPlayer
14839,UCBPlayer,127,137,264,10,82,UCBPlayer
14840,UCBPlayer,104,349,453,25,24,UCBPlayer
14841,UCBPlayer,126,126,252,7,85,Tie
14842,UCBPlayer,111,351,462,28,22,UCBPlayer
14843,UCBPlayer,116,126,242,3,87,UCBPlayer
14844,UCBPlayer,122,347,469,32,21,UCBPlayer
14845,UCBPlayer,107,132,239,0,87,UCBPlayer
14846,UCBPlayer,132,337,469,35,22,UCBPlayer
14847,UCBPlayer,103,148,251,0,83,UCBPlayer
14848,UCBPlayer,136,321,457,35,26,UCBPlayer
14849,UCBPlayer,99,164,263,0,79,UCBPlayer
14850,UCBPlayer,140,305,445,35,30,UCBPlayer
14851,UCBPlayer,95,180,275,0,75,UCBPlayer
14852,UCBPlayer,144,289,433,35,34,UCBPlayer
14853,UCBPlayer,91,196,287,0,71,UCBPlayer
14854,UCBPlayer,148,273,421,35,38,UCBPlayer
14855,UCBPlayer,87,212,299,0,67,UCBPlayer
14856,UCBPlayer,152,257,409,35,42,UCBPlayer
14857,UCBPlayer,84,224,308,0,64,UCBPlayer
14858,UCBPlayer,146,251,397,32,45,UCBPlayer
14859,UCBPlayer,89,234,323,3,60,UCBPlayer
14860,UCBPlayer,138,243,381,28,49,UCBPlayer
14861,UCBPlayer,97,242,339,7,56,UCBPlayer
14862,UCBPlayer,130,235,365,24,53,UCBPlayer
14863,UCBPlayer,105,250,355,11,52,UCBPlayer
14864,UCBPlayer,122,227,349,20,57,UCBPlayer
14865,UCBPlayer,109,259,368,15,49,UCBPlayer
14866,UCBPlayer,118,218,336,16,60,UCBPlayer
14867,UCBPlayer,117,267,384,19,45,UCBPlayer
14868,UCBPlayer,110,210,320,12,64,UCBPlayer
14869,UCBPlayer,126,271,397,23,42,UCBPlayer
14870,UCBPlayer,105,210,315,10,65,UCBPlayer
14871,UCBPlayer,130,275,405,25,40,UCBPlayer
14872,UCBPlayer,105,210,315,10,65,UCBPlayer
14873,UCBPlayer,130,275,405,25,40,UCBPlayer
14874,UCBPlayer,106,206,312,10,66,UCBPlayer
14875,UCBPlayer,130,275,405,25,40,UCBPlayer
14876,UCBPlayer,105,210,315,10,65,UCBPlayer
14877,UCBPlayer,131,271,402,25,41,UCBPlayer
14878,UCBPlayer,105,210,315,10,65,UCBPlayer
14879,UCBPlayer,130,275,405,25,40,UCBPlayer
14880,UCBPlayer,105,210,315,10,65,UCBPlayer
14881,UCBPlayer,130,275,405,25,40,UCBPlayer
14882,UCBPlayer,103,203,306,10,68,UCBPlayer
14883,UCBPlayer,128,283,411,25,38,UCBPlayer
14884,UCBPlayer,111,186,297,10,71,UCBPlayer
14885,UCBPlayer,124,299,423,25,34,UCBPlayer
14886,UCBPlayer,115,170,285,10,75,UCBPlayer
14887,UCBPlayer,120,315,435,25,30,UCBPlayer
14888,UCBPlayer,119,154,273,10,79,UCBPlayer
14889,UCBPlayer,112,332,444,25,27,UCBPlayer
14890,UCBPlayer,127,137,264,10,82,UCBPlayer
14891,UCBPlayer,104,349,453,25,24,UCBPlayer
14892,UCBPlayer,126,126,252,7,85,Tie
14893,UCBPlayer,111,351,462,28,22,UCBPlayer
14894,UCBPlayer,116,126,242,3,87,UCBPlayer
14895,UCBPlayer,122,347,469,32,21,UCBPlayer
14896,UCBPlayer,107,132,239,0,87,UCBPlayer
14897,UCBPlayer,132,337,469,35,22,UCBPlayer
14898,UCBPlayer,103,148,251,0,83,UCBPlayer
14899,UCBPlayer,136,321,457,35,26,UCBPlayer
14900,UCBPlayer,99,164,263,0,79,UCBPlayer
14901,UCBPlayer,140,305,445,35,30,UCBPlayer
14902,UCBPlayer,95,180,275,0,75,UCBPlayer
14903,UCBPlayer,144,289,433,35,34,UCBPlayer
14904,UCBPlayer,91,196,287,0,71,UCBPlayer
14905,UCBPlayer,148,273,421,35,38,UCBPlayer
14906,UCBPlayer,87,212,299,0,67,UCBPlayer
14907,UCBPlayer,152,257,409,35,42,UCBPlayer
14908,UCBPlayer,84,224,308,0,64,UCBPlayer
14909,UCBPlayer,146,251,397,32,45,UCBPlayer
14910,UCBPlayer,89,234,323,3,60,UCBPlayer
14911,UCBPlayer,138,243,381,28,49,UCBPlayer
14912,UCBPlayer,97,242,339,7,56,UCBPlayer
14913,UCBPlayer,130,235,365,24,53,UCBPlayer
14914,UCBPlayer,105,250,355,11,52,UCBPlayer
14915,UCBPlayer,122,227,349,20,57,UCBPlayer
14916,UCBPlayer,109,259,368,15,49,UCBPlayer
14917,UCBPlayer,118,218,336,16,60,UCBPlayer
14918,UCBPlayer,117,267,384,19,45,UCBPlayer
14919,UCBPlayer,110,210,320,12,64,UCBPlayer
14920,UCBPlayer,126,271,397,23,42,UCBPlayer
14921,UCBPlayer,105,210,315,10,65,UCBPlayer
14922,UCBPlayer,130,275,405,25,40,UCBPlayer
14923,UCBPlayer,105,210,315,10,65,UCBPlayer
14924,UCBPlayer,130,275,405,25,40,UCBPlayer
14925,UCBPlayer,106,206,312,10,66,UCBPlayer
14926,UCBPlayer,130,275,405,25,40,UCBPlayer
14927,UCBPlayer,105,210,315,10,65,UCBPlayer
14928,UCBPlayer,131,271,402,25,41,UCBPlayer
14929,UCBPlayer,105,210,315,10,65,UCBPlayer
14930,UCBPlayer,130,275,405,25,40,UCBPlayer
14931,UCBPlayer,105,210,315,10,65,UCBPlayer
14932,UCBPlayer,130,275,405,25,40,UCBPlayer
14933,UCBPlayer,103,203,306,10,68,UCBPlayer
14934,UCBPlayer,128,283,411,25,38,UCBPlayer
14935,UCBPlayer,111,186,297,10,71,UCBPlayer
14936,UCBPlayer,124,299,423,25,34,UCBPlayer
14937,UCBPlayer,115,170,285,10,75,UCBPlayer
14938,UCBPlayer,120,315,435,25,30,UCBPlayer
14939,UCBPlayer,119,154,273,10,79,UCBPlayer
14940,UCBPlayer,112,332,444,25,27,UCBPlayer
14941,UCBPlayer,127,137,264,10,82,UCBPlayer
14942,UCBPlayer,104,349,453,25,24,UCBPlayer
14943,UCBPlayer,126,126,252,7,85,Tie
14944,UCBPlayer,111,351,462,28,22,UCBPlayer
14945,UCBPlayer,116,126,242,3,87,UCBPlayer
14946,UCBPlayer,122,347,469,32,21,UCBPlayer
14947,UCBPlayer,107,132,239,0,87,UCBPlayer
14948,UCBPlayer,132,337,469,35,22,UCBPlayer
14949,UCBPlayer,103,148,251,0,83,UCBPlayer
14950,UCBPlayer,136,321,457,35,26,UCBPlayer
14951,UCBPlayer,99,164,263,0,79,UCBPlayer
14952,UCBPlayer,140,305,445,35,30,UCBPlayer
14953,UCBPlayer,95,180,275,0,75,UCBPlayer
14954,UCBPlayer,144,289,433,35,34,UCBPlayer
14955,UCBPlayer,91,196,287,0,71,UCBPlayer
14956,UCBPlayer,148,273,421,35,38,UCBPlayer
14957,UCBPlayer,87,212,299,0,67,UCBPlayer
14958,UCBPlayer,152,257,409,35,42,UCBPlayer
14959,UCBPlayer,84,224,308,0,64,UCBPlayer
14960,UCBPlayer,146,251,397,32,45,UCBPlayer
14961,UCBPlayer,89,234,323,3,60,UCBPlayer
14962,UCBPlayer,138,243,381,28,49,UCBPlayer
14963,UCBPlayer,97,242,339,7,56,UCBPlayer
14964,UCBPlayer,130,235,365,24,53,UCBPlayer
14965,UCBPlayer,105,250,355,11,52,UCBPlayer
14966,UCBPlayer,122,227,349,20,57,UCBPlayer
14967,UCBPlayer,109,259,368,15,49,UCBPlayer
14968,UCBPlayer,118,218,336,16,60,UCBPlayer
14969,UCBPlayer,117,267,384,19,45,UCBPlayer
14970,UCBPlayer,110,210,320,12,64,UCBPlayer
14971,UCBPlayer,126,271,397,23,42,UCBPlayer
14972,UCBPlayer,105,210,315,10,65,UCBPlayer
14973,UCBPlayer,130,275,405,25,40,UCBPlayer
14974,UCBPlayer,105,210,315,10,65,UCBPlayer
14975,UCBPlayer,130,275,405,25,40,UCBPlayer
14976,UCBPlayer,106,206,312,10,66,UCBPlayer
14977,UCBPlayer,130,275,405,25,40,UCBPlayer
14978,UCBPlayer,105,210,315,10,65,UCBPlayer
14979,UCBPlayer,131,271,402,25,41,UCBPlayer
14980,UCBPlayer,105,210,315,10,65,UCBPlayer
14981,UCBPlayer,130,275,405,25,40,UCBPlayer
14982,UCBPlayer,105,210,315,10,65,UCBPlayer
14983,UCBPlayer,130,275,405,25,40,UCBPlayer
14984,UCBPlayer,103,203,306,10,68,UCBPlayer
14985,UCBPlayer,128,283,411,25,38,UCBPlayer
14986,UCBPlayer,111,186,297,10,71,UCBPlayer
14987,UCBPlayer,124,299,423,25,34,UCBPlayer
14988,UCBPlayer,115,170,285,10,75,UCBPlayer
14989,UCBPlayer,120,315,435,25,30,UCBPlayer
14990,UCBPlayer,119,154,273,10,79,UCBPlayer
14991,UCBPlayer,112,332,444,25,27,UCBPlayer
14992,UCBPlayer,127,137,264,10,82,UCBPlayer
14993,UCBPlayer,104,349,453,25,24,UCBPlayer
14994,UCBPlayer,126,126,252,7,85,Tie
14995,UCBPlayer,111,351,462,28,22,UCBPlayer
14996,UCBPlayer,116,126,242,3,87,UCBPlayer
14997,UCBPlayer,122,347,469,32,21,UCBPlayer
14998,UCBPlayer,107,132,239,0,87,UCBPlayer
14999,UCBPlayer,132,337,469,35,22,UCBPlayer
15000,UCBPlayer,103,148,251,0,83,UCBPlayer
15001,UCBPlayer,136,321,457,35,26,UCBPlayer
15002,UCBPlayer,99,164,263,0,79,UCBPlayer
15003,UCBPlayer,140,305,445,35,30,UCBPlayer
15004,UCBPlayer,95,180,275,0,75,UCBPlayer
15005,UCBPlayer,144,289,433,35,34,UCBPlayer
15006,UCBPlayer,91,196,287,0,71,UCBPlayer
15007,UCBPlayer,148,273,421,35,38,UCBPlayer
15008,UCBPlayer,87,212,299,0,67,UCBPlayer
15009,UCBPlayer,152,257,409,35,42,UCBPlayer
15010,UCBPlayer,84,224,308,0,64,UCBPlayer
15011,UCBPlayer,146,251,397,32,45,UCBPlayer
15012,UCBPlayer,89,234,323,3,60,UCBPlayer
15013,UCBPlayer,138,243,381,28,49,UCBPlayer
15014,UCBPlayer,97,242,339,7,56,UCBPlayer
15015,UCBPlayer,130,235,365,24,53,UCBPlayer
15016,UCBPlayer,105,250,355,11,52,UCBPlayer
15017,UCBPlayer,122,227,349,20,57,UCBPlayer
15018,UCBPlayer,109,259,368,15,49,UCBPlayer
15019,UCBPlayer,118,218,336,16,60,UCBPlayer
15020,UCBPlayer,117,267,384,19,45,UCBPlayer
15021,UCBPlayer,110,210,320,12,64,UCBPlayer
15022,UCBPlayer,126,271,397,23,42,UCBPlayer
15023,UCBPlayer,105,210,315,10,65,UCBPlayer
15024,UCBPlayer,130,275,405,25,40,UCBPlayer
15025,UCBPlayer,105,210,315,10,65,UCBPlayer
15026,UCBPlayer,130,275,405,25,40,UCBPlayer
15027,UCBPlayer,106,206,312,10,66,UCBPlayer
15028,UCBPlayer,130,275,405,25,40,UCBPlayer
15029,UCBPlayer,105,210,315,10,65,UCBPlayer
15030,UCBPlayer,131,271,402,25,41,UCBPlayer
15031,UCBPlayer,105,210,315,10,65,UCBPlayer
15032,UCBPlayer,130,275,405,25,40,UCBPlayer
15033,UCBPlayer,105,210,315,10,65,UCBPlayer
15034,UCBPlayer,130,275,405,25,40,UCBPlayer
15035,UCBPlayer,103,203,306,10,68,UCBPlayer
15036,UCBPlayer,128,283,411,25,38,UCBPlayer
15037,UCBPlayer,111,186,297,10,71,UCBPlayer
15038,UCBPlayer,124,299,423,25,34,UCBPlayer
15039,UCBPlayer,115,170,285,10,75,UCBPlayer
15040,UCBPlayer,120,315,435,25,30,UCBPlayer
15041,UCBPlayer,119,154,273,10,79,UCBPlayer
15042,UCBPlayer,112,332,444,25,27,UCBPlayer
15043,UCBPlayer,127,137,264,10,82,UCBPlayer
15044,UCBPlayer,104,349,453,25,24,UCBPlayer
15045,UCBPlayer,126,126,252,7,85,Tie
15046,UCBPlayer,111,351,462,28,22,UCBPlayer
15047,UCBPlayer,116,126,242,3,87,UCBPlayer
15048,UCBPlayer,122,347,469,32,21,UCBPlayer
15049,UCBPlayer,107,132,239,0,87,UCBPlayer
15050,UCBPlayer,132,337,469,35,22,UCBPlayer
15051,UCBPlayer,103,148,251,0,83,UCBPlayer
15052,UCBPlayer,136,321,457,35,26,UCBPlayer
15053,UCBPlayer,99,164,263,0,79,UCBPlayer
15054,UCBPlayer,140,305,445,35,30,UCBPlayer
15055,UCBPlayer,95,180,275,0,75,UCBPlayer
15056,UCBPlayer,144,289,433,35,34,UCBPlayer
15057,UCBPlayer,91,196,287,0,71,UCBPlayer
15058,UCBPlayer,148,273,421,35,38,UCBPlayer
15059,UCBPlayer,87,212,299,0,67,UCBPlayer
15060,UCBPlayer,152,257,409,35,42,UCBPlayer
15061,UCBPlayer,84,224,308,0,64,UCBPlayer
15062,UCBPlayer,146,251,397,32,45,UCBPlayer
15063,UCBPlayer,89,234,323,3,60,UCBPlayer
15064,UCBPlayer,138,243,381,28,49,UCBPlayer
15065,UCBPlayer,97,242,339,7,56,UCBPlayer
15066,UCBPlayer,130,235,365,24,53,UCBPlayer
15067,UCBPlayer,105,250,355,11,52,UCBPlayer
15068,UCBPlayer,122,227,349,20,57,UCBPlayer
15069,UCBPlayer,109,259,368,15,49,UCBPlayer
15070,UCBPlayer,118,218,336,16,60,UCBPlayer
15071,UCBPlayer,117,267,384,19,45,UCBPlayer
15072,UCBPlayer,110,210,320,12,64,UCBPlayer
15073,UCBPlayer,126,271,397,23,42,UCBPlayer
15074,UCBPlayer,105,210,315,10,65,UCBPlayer
15075,UCBPlayer,130,275,405,25,40,UCBPlayer
15076,UCBPlayer,105,210,315,10,65,UCBPlayer
15077,UCBPlayer,130,275,405,25,40,UCBPlayer
15078,UCBPlayer,106,206,312,10,66,UCBPlayer
15079,UCBPlayer,130,275,405,25,40,UCBPlayer
15080,UCBPlayer,105,210,315,10,65,UCBPlayer
15081,UCBPlayer,131,271,402,25,41,UCBPlayer
15082,UCBPlayer,105,210,315,10,65,UCBPlayer
15083,UCBPlayer,130,275,405,25,40,UCBPlayer
15084,UCBPlayer,105,210,315,10,65,UCBPlayer
15085,UCBPlayer,130,275,405,25,40,UCBPlayer
15086,UCBPlayer,103,203,306,10,68,UCBPlayer
15087,UCBPlayer,128,283,411,25,38,UCBPlayer
15088,UCBPlayer,111,186,297,10,71,UCBPlayer
15089,UCBPlayer,124,299,423,25,34,UCBPlayer
15090,UCBPlayer,115,170,285,10,75,UCBPlayer
15091,UCBPlayer,120,315,435,25,30,UCBPlayer
15092,UCBPlayer,119,154,273,10,79,UCBPlayer
15093,UCBPlayer,112,332,444,25,27,UCBPlayer
15094,UCBPlayer,127,137,264,10,82,UCBPlayer
15095,UCBPlayer,104,349,453,25,24,UCBPlayer
15096,UCBPlayer,126,126,252,7,85,Tie
15097,UCBPlayer,111,351,462,28,22,UCBPlayer
15098,UCBPlayer,116,126,242,3,87,UCBPlayer
15099,UCBPlayer,122,347,469,32,21,UCBPlayer
15100,UCBPlayer,107,132,239,0,87,UCBPlayer
15101,UCBPlayer,132,337,469,35,22,UCBPlayer
15102,UCBPlayer,103,148,251,0,83,UCBPlayer
15103,UCBPlayer,136,321,457,35,26,UCBPlayer
15104,UCBPlayer,99,164,263,0,79,UCBPlayer
15105,UCBPlayer,140,305,445,35,30,UCBPlayer
15106,UCBPlayer,95,180,275,0,75,UCBPlayer
15107,UCBPlayer,144,289,433,35,34,UCBPlayer
15108,UCBPlayer,91,196,287,0,71,UCBPlayer
15109,UCBPlayer,148,273,421,35,38,UCBPlayer
15110,UCBPlayer,87,212,299,0,67,UCBPlayer
15111,UCBPlayer,152,257,409,35,42,UCBPlayer
15112,UCBPlayer,84,224,308,0,64,UCBPlayer
15113,UCBPlayer,146,251,397,32,45,UCBPlayer
15114,UCBPlayer,89,234,323,3,60,UCBPlayer
15115,UCBPlayer,138,243,381,28,49,UCBPlayer
15116,UCBPlayer,97,242,339,7,56,UCBPlayer
15117,UCBPlayer,130,235,365,24,53,UCBPlayer
15118,UCBPlayer,105,250,355,11,52,UCBPlayer
15119,UCBPlayer,122,227,349,20,57,UCBPlayer
15120,UCBPlayer,109,259,368,15,49,UCBPlayer
15121,UCBPlayer,118,218,336,16,60,UCBPlayer
15122,UCBPlayer,117,267,384,19,45,UCBPlayer
15123,UCBPlayer,110,210,320,12,64,UCBPlayer
15124,UCBPlayer,126,271,397,23,42,UCBPlayer
15125,UCBPlayer,105,210,315,10,65,UCBPlayer
15126,UCBPlayer,130,275,405,25,40,UCBPlayer
15127,UCBPlayer,105,210,315,10,65,UCBPlayer
15128,UCBPlayer,130,275,405,25,40,UCBPlayer
15129,UCBPlayer,106,206,312,10,66,UCBPlayer
15130,UCBPlayer,130,275,405,25,40,UCBPlayer
15131,UCBPlayer,105,210,315,10,65,UCBPlayer
15132,UCBPlayer,131,271,402,25,41,UCBPlayer
15133,UCBPlayer,105,210,315,10,65,UCBPlayer
15134,UCBPlayer,130,275,405,25,40,UCBPlayer
15135,UCBPlayer,105,210,315,10,65,UCBPlayer
15136,UCBPlayer,130,275,405,25,40,UCBPlayer
15137,UCBPlayer,103,203,306,10,68,UCBPlayer
15138,UCBPlayer,128,283,411,25,38,UCBPlayer
15139,UCBPlayer,111,186,297,10,71,UCBPlayer
15140,UCBPlayer,124,299,423,25,34,UCBPlayer
15141,UCBPlayer,115,170,285,10,75,UCBPlayer
15142,UCBPlayer,120,315,435,25,30,UCBPlayer
15143,UCBPlayer,119,154,273,10,79,UCBPlayer
15144,UCBPlayer,112,332,444,25,27,UCBPlayer
15145,UCBPlayer,127,137,264,10,82,UCBPlayer
15146,UCBPlayer,104,349,453,25,24,UCBPlayer
15147,UCBPlayer,126,126,252,7,85,Tie
15148,UCBPlayer,111,351,462,28,22,UCBPlayer
15149,UCBPlayer,116,126,242,3,87,UCBPlayer
15150,UCBPlayer,122,347,469,32,21,UCBPlayer
15151,UCBPlayer,107,132,239,0,87,UCBPlayer
15152,UCBPlayer,132,337,469,35,22,UCBPlayer
15153,UCBPlayer,103,148,251,0,83,UCBPlayer
15154,UCBPlayer,136,321,457,35,26,UCBPlayer
15155,UCBPlayer,99,164,263,0,79,UCBPlayer
15156,UCBPlayer,140,305,445,35,30,UCBPlayer
15157,UCBPlayer,95,180,275,0,75,UCBPlayer
15158,UCBPlayer,144,289,433,35,34,UCBPlayer
15159,UCBPlayer,91,196,287,0,71,UCBPlayer
15160,UCBPlayer,148,273,421,35,38,UCBPlayer
15161,UCBPlayer,87,212,299,0,67,UCBPlayer
15162,UCBPlayer,152,257,409,35,42,UCBPlayer
15163,UCBPlayer,84,224,308,0,64,UCBPlayer
15164,UCBPlayer,146,251,397,32,45,UCBPlayer
15165,UCBPlayer,89,234,323,3,60,UCBPlayer
15166,UCBPlayer,138,243,381,28,49,UCBPlayer
15167,UCBPlayer,97,242,339,7,56,UCBPlayer
15168,UCBPlayer,130,235,365,24,53,UCBPlayer
15169,UCBPlayer,105,250,355,11,52,UCBPlayer
15170,UCBPlayer,122,227,349,20,57,UCBPlayer
15171,UCBPlayer,109,259,368,15,49,UCBPlayer
15172,UCBPlayer,118,218,336,16,60,UCBPlayer
15173,UCBPlayer,117,267,384,19,45,UCBPlayer
15174,UCBPlayer,110,210,320,12,64,UCBPlayer
15175,UCBPlayer,126,271,397,23,42,UCBPlayer
15176,UCBPlayer,105,210,315,10,65,UCBPlayer
15177,UCBPlayer,130,275,405,25,40,UCBPlayer
15178,UCBPlayer,105,210,315,10,65,UCBPlayer
15179,UCBPlayer,130,275,405,25,40,UCBPlayer
15180,UCBPlayer,106,206,312,10,66,UCBPlayer
15181,UCBPlayer,130,275,405,25,40,UCBPlayer
15182,UCBPlayer,105,210,315,10,65,UCBPlayer
15183,UCBPlayer,131,271,402,25,41,UCBPlayer
15184,UCBPlayer,105,210,315,10,65,UCBPlayer
15185,UCBPlayer,130,275,405,25,40,UCBPlayer
15186,UCBPlayer,105,210,315,10,65,UCBPlayer
15187,UCBPlayer,130,275,405,25,40,UCBPlayer
15188,UCBPlayer,103,203,306,10,68,UCBPlayer
15189,UCBPlayer,128,283,411,25,38,UCBPlayer
15190,UCBPlayer,111,186,297,10,71,UCBPlayer
15191,UCBPlayer,124,299,423,25,34,UCBPlayer
15192,UCBPlayer,115,170,285,10,75,UCBPlayer
15193,UCBPlayer,120,315,435,25,30,UCBPlayer
15194,UCBPlayer,119,154,273,10,79,UCBPlayer
15195,UCBPlayer,112,332,444,25,27,UCBPlayer
15196,UCBPlayer,127,137,264,10,82,UCBPlayer
15197,UCBPlayer,104,349,453,25,24,UCBPlayer
15198,UCBPlayer,126,126,252,7,85,Tie
15199,UCBPlayer,111,351,462,28,22,UCBPlayer
15200,UCBPlayer,116,126,242,3,87,UCBPlayer
15201,UCBPlayer,122,347,469,32,21,UCBPlayer
15202,UCBPlayer,107,132,239,0,87,UCBPlayer
15203,UCBPlayer,132,337,469,35,22,UCBPlayer
15204,UCBPlayer,103,148,251,0,83,UCBPlayer
15205,UCBPlayer,136,321,457,35,26,UCBPlayer
15206,UCBPlayer,99,164,263,0,79,UCBPlayer
15207,UCBPlayer,140,305,445,35,30,UCBPlayer
15208,UCBPlayer,95,180,275,0,75,UCBPlayer
15209,UCBPlayer,144,289,433,35,34,UCBPlayer
15210,UCBPlayer,91,196,287,0,71,UCBPlayer
15211,UCBPlayer,148,273,421,35,38,UCBPlayer
15212,UCBPlayer,87,212,299,0,67,UCBPlayer
15213,UCBPlayer,152,257,409,35,42,UCBPlayer
15214,UCBPlayer,84,224,308,0,64,UCBPlayer
15215,UCBPlayer,146,251,397,32,45,UCBPlayer
15216,UCBPlayer,89,234,323,3,60,UCBPlayer
15217,UCBPlayer,138,243,381,28,49,UCBPlayer
15218,UCBPlayer,97,242,339,7,56,UCBPlayer
15219,UCBPlayer,130,235,365,24,53,UCBPlayer
15220,UCBPlayer,105,250,355,11,52,UCBPlayer
15221,UCBPlayer,122,227,349,20,57,UCBPlayer
15222,UCBPlayer,109,259,368,15,49,UCBPlayer
15223,UCBPlayer,118,218,336,16,60,UCBPlayer
15224,UCBPlayer,117,267,384,19,45,UCBPlayer
15225,UCBPlayer,110,210,320,12,64,UCBPlayer
15226,UCBPlayer,126,271,397,23,42,UCBPlayer
15227,UCBPlayer,105,210,315,10,65,UCBPlayer
15228,UCBPlayer,130,275,405,25,40,UCBPlayer
15229,UCBPlayer,105,210,315,10,65,UCBPlayer
15230,UCBPlayer,130,275,405,25,40,UCBPlayer
15231,UCBPlayer,106,206,312,10,66,UCBPlayer
15232,UCBPlayer,130,275,405,25,40,UCBPlayer
15233,UCBPlayer,105,210,315,10,65,UCBPlayer
15234,UCBPlayer,131,271,402,25,41,UCBPlayer
15235,UCBPlayer,105,210,315,10,65,UCBPlayer
15236,UCBPlayer,130,275,405,25,40,UCBPlayer
15237,UCBPlayer,105,210,315,10,65,UCBPlayer
15238,UCBPlayer,130,275,405,25,40,UCBPlayer
15239,UCBPlayer,103,203,306,10,68,UCBPlayer
15240,UCBPlayer,128,283,411,25,38,UCBPlayer
15241,UCBPlayer,111,186,297,10,71,UCBPlayer
15242,UCBPlayer,124,299,423,25,34,UCBPlayer
15243,UCBPlayer,115,170,285,10,75,UCBPlayer
15244,UCBPlayer,120,315,435,25,30,UCBPlayer
15245,UCBPlayer,119,154,273,10,79,UCBPlayer
15246,UCBPlayer,112,332,444,25,27,UCBPlayer
15247,UCBPlayer,127,137,264,10,82,UCBPlayer
15248,UCBPlayer,104,349,453,25,24,UCBPlayer
15249,UCBPlayer,126,126,252,7,85,Tie
15250,UCBPlayer,111,351,462,28,22,UCBPlayer
15251,UCBPlayer,116,126,242,3,87,UCBPlayer
15252,UCBPlayer,122,347,469,32,21,UCBPlayer
15253,UCBPlayer,107,132,239,0,87,UCBPlayer
15254,UCBPlayer,132,337,469,35,22,UCBPlayer
15255,UCBPlayer,103,148,251,0,83,UCBPlayer
15256,UCBPlayer,136,321,457,35,26,UCBPlayer
15257,UCBPlayer,99,164,263,0,79,UCBPlayer
15258,UCBPlayer,140,305,445,35,30,UCBPlayer
15259,UCBPlayer,95,180,275,0,75,UCBPlayer
15260,UCBPlayer,144,289,433,35,34,UCBPlayer
15261,UCBPlayer,91,196,287,0,71,UCBPlayer
15262,UCBPlayer,148,273,421,35,38,UCBPlayer
15263,UCBPlayer,87,212,299,0,67,UCBPlayer
15264,UCBPlayer,152,257,409,35,42,UCBPlayer
15265,UCBPlayer,84,224,308,0,64,UCBPlayer
15266,UCBPlayer,146,251,397,32,45,UCBPlayer
15267,UCBPlayer,89,234,323,3,60,UCBPlayer
15268,UCBPlayer,138,243,381,28,49,UCBPlayer
15269,UCBPlayer,97,242,339,7,56,UCBPlayer
15270,UCBPlayer,130,235,365,24,53,UCBPlayer
15271,UCBPlayer,105,250,355,11,52,UCBPlayer
15272,UCBPlayer,122,227,349,20,57,UCBPlayer
15273,UCBPlayer,109,259,368,15,49,UCBPlayer
15274,UCBPlayer,118,218,336,16,60,UCBPlayer
15275,UCBPlayer,117,267,384,19,45,UCBPlayer
15276,UCBPlayer,110,210,320,12,64,UCBPlayer
15277,UCBPlayer,126,271,397,23,42,UCBPlayer
15278,UCBPlayer,105,210,315,10,65,UCBPlayer
15279,UCBPlayer,130,275,405,25,40,UCBPlayer
15280,UCBPlayer,105,210,315,10,65,UCBPlayer
15281,UCBPlayer,130,275,405,25,40,UCBPlayer
15282,UCBPlayer,106,206,312,10,66,UCBPlayer
15283,UCBPlayer,130,275,405,25,40,UCBPlayer
15284,UCBPlayer,105,210,315,10,65,UCBPlayer
15285,UCBPlayer,131,271,402,25,41,UCBPlayer
15286,UCBPlayer,105,210,315,10,65,UCBPlayer
15287,UCBPlayer,130,275,405,25,40,UCBPlayer
15288,UCBPlayer,105,210,315,10,65,UCBPlayer
15289,UCBPlayer,130,275,405,25,40,UCBPlayer
15290,UCBPlayer,103,203,306,10,68,UCBPlayer
15291,UCBPlayer,128,283,411,25,38,UCBPlayer
15292,UCBPlayer,111,186,297,10,71,UCBPlayer
15293,UCBPlayer,124,299,423,25,34,UCBPlayer
15294,UCBPlayer,115,170,285,10,75,UCBPlayer
15295,UCBPlayer,120,315,435,25,30,UCBPlayer
15296,UCBPlayer,119,154,273,10,79,UCBPlayer
15297,UCBPlayer,112,332,444,25,27,UCBPlayer
15298,UCBPlayer,127,137,264,10,82,UCBPlayer
15299,UCBPlayer,104,349,453,25,24,UCBPlayer
15300,UCBPlayer,126,126,252,7,85,Tie
15301,UCBPlayer,111,351,462,28,22,UCBPlayer
15302,UCBPlayer,116,126,242,3,87,UCBPlayer
15303,UCBPlayer,122,347,469,32,21,UCBPlayer
15304,UCBPlayer,107,132,239,0,87,UCBPlayer
15305,UCBPlayer,132,337,469,35,22,UCBPlayer
15306,UCBPlayer,103,148,251,0,83,UCBPlayer
15307,UCBPlayer,136,321,457,35,26,UCBPlayer
15308,UCBPlayer,99,164,263,0,79,UCBPlayer
15309,UCBPlayer,140,305,445,35,30,UCBPlayer
15310,UCBPlayer,95,180,275,0,75,UCBPlayer
15311,UCBPlayer,144,289,433,35,34,UCBPlayer
15312,UCBPlayer,91,196,287,0,71,UCBPlayer
15313,UCBPlayer,148,273,421,35,38,UCBPlayer
15314,UCBPlayer,87,212,299,0,67,UCBPlayer
15315,UCBPlayer,152,257,409,35,42,UCBPlayer
15316,UCBPlayer,84,224,308,0,64,UCBPlayer
15317,UCBPlayer,146,251,397,32,45,UCBPlayer
15318,UCBPlayer,89,234,323,3,60,UCBPlayer
15319,UCBPlayer,138,243,381,28,49,UCBPlayer
15320,UCBPlayer,97,242,339,7,56,UCBPlayer
15321,UCBPlayer,130,235,365,24,53,UCBPlayer
15322,UCBPlayer,105,250,355,11,52,UCBPlayer
15323,UCBPlayer,122,227,349,20,57,UCBPlayer
15324,UCBPlayer,109,259,368,15,49,UCBPlayer
15325,UCBPlayer,118,218,336,16,60,UCBPlayer
15326,UCBPlayer,117,267,384,19,45,UCBPlayer
15327,UCBPlayer,110,210,320,12,64,UCBPlayer
15328,UCBPlayer,126,271,397,23,42,UCBPlayer
15329,UCBPlayer,105,210,315,10,65,UCBPlayer
15330,UCBPlayer,130,275,405,25,40,UCBPlayer
15331,UCBPlayer,105,210,315,10,65,UCBPlayer
15332,UCBPlayer,130,275,405,25,40,UCBPlayer
15333,UCBPlayer,106,206,312,10,66,UCBPlayer
15334,UCBPlayer,130,275,405,25,40,UCBPlayer
15335,UCBPlayer,105,210,315,10,65,UCBPlayer
15336,UCBPlayer,131,271,402,25,41,UCBPlayer
15337,UCBPlayer,105,210,315,10,65,UCBPlayer
15338,UCBPlayer,130,275,405,25,40,UCBPlayer
15339,UCBPlayer,105,210,315,10,65,UCBPlayer
15340,UCBPlayer,130,275,405,25,40,UCBPlayer
15341,UCBPlayer,103,203,306,10,68,UCBPlayer
15342,UCBPlayer,128,283,411,25,38,UCBPlayer
15343,UCBPlayer,111,186,297,10,71,UCBPlayer
15344,UCBPlayer,124,299,423,25,34,UCBPlayer
15345,UCBPlayer,115,170,285,10,75,UCBPlayer
15346,UCBPlayer,120,315,435,25,30,UCBPlayer
15347,UCBPlayer,119,154,273,10,79,UCBPlayer
15348,UCBPlayer,112,332,444,25,27,UCBPlayer
15349,UCBPlayer,127,137,264,10,82,UCBPlayer
15350,UCBPlayer,104,349,453,25,24,UCBPlayer
15351,UCBPlayer,126,126,252,7,85,Tie
15352,UCBPlayer,111,351,462,28,22,UCBPlayer
15353,UCBPlayer,116,126,242,3,87,UCBPlayer
15354,UCBPlayer,122,347,469,32,21,UCBPlayer
15355,UCBPlayer,107,132,239,0,87,UCBPlayer
15356,UCBPlayer,132,337,469,35,22,UCBPlayer
15357,UCBPlayer,103,148,251,0,83,UCBPlayer
15358,UCBPlayer,136,321,457,35,26,UCBPlayer
15359,UCBPlayer,99,164,263,0,79,UCBPlayer
15360,UCBPlayer,140,305,445,35,30,UCBPlayer
15361,UCBPlayer,95,180,275,0,75,UCBPlayer
15362,UCBPlayer,144,289,433,35,34,UCBPlayer
15363,UCBPlayer,91,196,287,0,71,UCBPlayer
15364,UCBPlayer,148,273,421,35,38,UCBPlayer
15365,UCBPlayer,87,212,299,0,67,UCBPlayer
15366,UCBPlayer,152,257,409,35,42,UCBPlayer
15367,UCBPlayer,84,224,308,0,64,UCBPlayer
15368,UCBPlayer,146,251,397,32,45,UCBPlayer
15369,UCBPlayer,89,234,323,3,60,UCBPlayer
15370,UCBPlayer,138,243,381,28,49,UCBPlayer
15371,UCBPlayer,97,242,339,7,56,UCBPlayer
15372,UCBPlayer,130,235,365,24,53,UCBPlayer
15373,UCBPlayer,105,250,355,11,52,UCBPlayer
15374,UCBPlayer,122,227,349,20,57,UCBPlayer
15375,UCBPlayer,109,259,368,15,49,UCBPlayer
15376,UCBPlayer,118,218,336,16,60,UCBPlayer
15377,UCBPlayer,117,267,384,19,45,UCBPlayer
15378,UCBPlayer,110,210,320,12,64,UCBPlayer
15379,UCBPlayer,126,271,397,23,42,UCBPlayer
15380,UCBPlayer,105,210,315,10,65,UCBPlayer
15381,UCBPlayer,130,275,405,25,40,UCBPlayer
15382,UCBPlayer,105,210,315,10,65,UCBPlayer
15383,UCBPlayer,130,275,405,25,40,UCBPlayer
15384,UCBPlayer,106,206,312,10,66,UCBPlayer
15385,UCBPlayer,130,275,405,25,40,UCBPlayer
15386,UCBPlayer,105,210,315,10,65,UCBPlayer
15387,UCBPlayer,131,271,402,25,41,UCBPlayer
15388,UCBPlayer,105,210,315,10,65,UCBPlayer
15389,UCBPlayer,130,275,405,25,40,UCBPlayer
15390,UCBPlayer,105,210,315,10,65,UCBPlayer
15391,UCBPlayer,130,275,405,25,40,UCBPlayer
15392,UCBPlayer,103,203,306,10,68,UCBPlayer
15393,UCBPlayer,128,283,411,25,38,UCBPlayer
15394,UCBPlayer,111,186,297,10,71,UCBPlayer
15395,UCBPlayer,124,299,423,25,34,UCBPlayer
15396,UCBPlayer,115,170,285,10,75,UCBPlayer
15397,UCBPlayer,120,315,435,25,30,UCBPlayer
15398,UCBPlayer,119,154,273,10,79,UCBPlayer
15399,UCBPlayer,112,332,444,25,27,UCBPlayer
15400,UCBPlayer,127,137,264,10,82,UCBPlayer
15401,UCBPlayer,104,349,453,25,24,UCBPlayer
15402,UCBPlayer,126,126,252,7,85,Tie
15403,UCBPlayer,111,351,462,28,22,UCBPlayer
15404,UCBPlayer,116,126,242,3,87,UCBPlayer
15405,UCBPlayer,122,347,469,32,21,UCBPlayer
15406,UCBPlayer,107,132,239,0,87,UCBPlayer
15407,UCBPlayer,132,337,469,35,22,UCBPlayer
15408,UCBPlayer,103,148,251,0,83,UCBPlayer
15409,UCBPlayer,136,321,457,35,26,UCBPlayer
15410,UCBPlayer,99,164,263,0,79,UCBPlayer
15411,UCBPlayer,140,305,445,35,30,UCBPlayer
15412,UCBPlayer,95,180,275,0,75,UCBPlayer
15413,UCBPlayer,144,289,433,35,34,UCBPlayer
15414,UCBPlayer,91,196,287,0,71,UCBPlayer
15415,UCBPlayer,148,273,421,35,38,UCBPlayer
15416,UCBPlayer,87,212,299,0,67,UCBPlayer
15417,UCBPlayer,152,257,409,35,42,UCBPlayer
15418,UCBPlayer,84,224,308,0,64,UCBPlayer
15419,UCBPlayer,146,251,397,32,45,UCBPlayer
15420,UCBPlayer,89,234,323,3,60,UCBPlayer
15421,UCBPlayer,138,243,381,28,49,UCBPlayer
15422,UCBPlayer,97,242,339,7,56,UCBPlayer
15423,UCBPlayer,130,235,365,24,53,UCBPlayer
15424,UCBPlayer,105,250,355,11,52,UCBPlayer
15425,UCBPlayer,122,227,349,20,57,UCBPlayer
15426,UCBPlayer,109,259,368,15,49,UCBPlayer
15427,UCBPlayer,118,218,336,16,60,UCBPlayer
15428,UCBPlayer,117,267,384,19,45,UCBPlayer
15429,UCBPlayer,110,210,320,12,64,UCBPlayer
15430,UCBPlayer,126,271,397,23,42,UCBPlayer
15431,UCBPlayer,105,210,315,10,65,UCBPlayer
15432,UCBPlayer,130,275,405,25,40,UCBPlayer
15433,UCBPlayer,105,210,315,10,65,UCBPlayer
15434,UCBPlayer,130,275,405,25,40,UCBPlayer
15435,UCBPlayer,106,206,312,10,66,UCBPlayer
15436,UCBPlayer,130,275,405,25,40,UCBPlayer
15437,UCBPlayer,105,210,315,10,65,UCBPlayer
15438,UCBPlayer,131,271,402,25,41,UCBPlayer
15439,UCBPlayer,105,210,315,10,65,UCBPlayer
15440,UCBPlayer,130,275,405,25,40,UCBPlayer
15441,UCBPlayer,105,210,315,10,65,UCBPlayer
15442,UCBPlayer,130,275,405,25,40,UCBPlayer
15443,UCBPlayer,103,203,306,10,68,UCBPlayer
15444,UCBPlayer,128,283,411,25,38,UCBPlayer
15445,UCBPlayer,111,186,297,10,71,UCBPlayer
15446,UCBPlayer,124,299,423,25,34,UCBPlayer
15447,UCBPlayer,115,170,285,10,75,UCBPlayer
15448,UCBPlayer,120,315,435,25,30,UCBPlayer
15449,UCBPlayer,119,154,273,10,79,UCBPlayer
15450,UCBPlayer,112,332,444,25,27,UCBPlayer
15451,UCBPlayer,127,137,264,10,82,UCBPlayer
15452,UCBPlayer,104,349,453,25,24,UCBPlayer
15453,UCBPlayer,126,126,252,7,85,Tie
15454,UCBPlayer,111,351,462,28,22,UCBPlayer
15455,UCBPlayer,116,126,242,3,87,UCBPlayer
15456,UCBPlayer,122,347,469,32,21,UCBPlayer
15457,UCBPlayer,107,132,239,0,87,UCBPlayer
15458,UCBPlayer,132,337,469,35,22,UCBPlayer
15459,UCBPlayer,103,148,251,0,83,UCBPlayer
15460,UCBPlayer,136,321,457,35,26,UCBPlayer
15461,UCBPlayer,99,164,263,0,79,UCBPlayer
15462,UCBPlayer,140,305,445,35,30,UCBPlayer
15463,UCBPlayer,95,180,275,0,75,UCBPlayer
15464,UCBPlayer,144,289,433,35,34,UCBPlayer
15465,UCBPlayer,91,196,287,0,71,UCBPlayer
15466,UCBPlayer,148,273,421,35,38,UCBPlayer
15467,UCBPlayer,87,212,299,0,67,UCBPlayer
15468,UCBPlayer,152,257,409,35,42,UCBPlayer
15469,UCBPlayer,84,224,308,0,64,UCBPlayer
15470,UCBPlayer,146,251,397,32,45,UCBPlayer
15471,UCBPlayer,89,234,323,3,60,UCBPlayer
15472,UCBPlayer,138,243,381,28,49,UCBPlayer
15473,UCBPlayer,97,242,339,7,56,UCBPlayer
15474,UCBPlayer,130,235,365,24,53,UCBPlayer
15475,UCBPlayer,105,250,355,11,52,UCBPlayer
15476,UCBPlayer,122,227,349,20,57,UCBPlayer
15477,UCBPlayer,109,259,368,15,49,UCBPlayer
15478,UCBPlayer,118,218,336,16,60,UCBPlayer
15479,UCBPlayer,117,267,384,19,45,UCBPlayer
15480,UCBPlayer,110,210,320,12,64,UCBPlayer
15481,UCBPlayer,126,271,397,23,42,UCBPlayer
15482,UCBPlayer,105,210,315,10,65,UCBPlayer
15483,UCBPlayer,130,275,405,25,40,UCBPlayer
15484,UCBPlayer,105,210,315,10,65,UCBPlayer
15485,UCBPlayer,130,275,405,25,40,UCBPlayer
15486,UCBPlayer,106,206,312,10,66,UCBPlayer
15487,UCBPlayer,130,275,405,25,40,UCBPlayer
15488,UCBPlayer,105,210,315,10,65,UCBPlayer
15489,UCBPlayer,131,271,402,25,41,UCBPlayer
15490,UCBPlayer,105,210,315,10,65,UCBPlayer
15491,UCBPlayer,130,275,405,25,40,UCBPlayer
15492,UCBPlayer,105,210,315,10,65,UCBPlayer
15493,UCBPlayer,130,275,405,25,40,UCBPlayer
15494,UCBPlayer,103,203,306,10,68,UCBPlayer
15495,UCBPlayer,128,283,411,25,38,UCBPlayer
15496,UCBPlayer,111,186,297,10,71,UCBPlayer
15497,UCBPlayer,124,299,423,25,34,UCBPlayer
15498,UCBPlayer,115,170,285,10,75,UCBPlayer
15499,UCBPlayer,120,315,435,25,30,UCBPlayer
15500,UCBPlayer,119,154,273,10,79,UCBPlayer
15501,UCBPlayer,112,332,444,25,27,UCBPlayer
15502,UCBPlayer,127,137,264,10,82,UCBPlayer
15503,UCBPlayer,104,349,453,25,24,UCBPlayer
15504,UCBPlayer,126,126,252,7,85,Tie
15505,UCBPlayer,111,351,462,28,22,UCBPlayer
15506,UCBPlayer,116,126,242,3,87,UCBPlayer
15507,UCBPlayer,122,347,469,32,21,UCBPlayer
15508,UCBPlayer,107,132,239,0,87,UCBPlayer
15509,UCBPlayer,132,337,469,35,22,UCBPlayer
15510,UCBPlayer,103,148,251,0,83,UCBPlayer
15511,UCBPlayer,136,321,457,35,26,UCBPlayer
15512,UCBPlayer,99,164,263,0,79,UCBPlayer
15513,UCBPlayer,140,305,445,35,30,UCBPlayer
15514,UCBPlayer,95,180,275,0,75,UCBPlayer
15515,UCBPlayer,144,289,433,35,34,UCBPlayer
15516,UCBPlayer,91,196,287,0,71,UCBPlayer
15517,UCBPlayer,148,273,421,35,38,UCBPlayer
15518,UCBPlayer,87,212,299,0,67,UCBPlayer
15519,UCBPlayer,152,257,409,35,42,UCBPlayer
15520,UCBPlayer,84,224,308,0,64,UCBPlayer
15521,UCBPlayer,146,251,397,32,45,UCBPlayer
15522,UCBPlayer,89,234,323,3,60,UCBPlayer
15523,UCBPlayer,138,243,381,28,49,UCBPlayer
15524,UCBPlayer,97,242,339,7,56,UCBPlayer
15525,UCBPlayer,130,235,365,24,53,UCBPlayer
15526,UCBPlayer,105,250,355,11,52,UCBPlayer
15527,UCBPlayer,122,227,349,20,57,UCBPlayer
15528,UCBPlayer,109,259,368,15,49,UCBPlayer
15529,UCBPlayer,118,218,336,16,60,UCBPlayer
15530,UCBPlayer,117,267,384,19,45,UCBPlayer
15531,UCBPlayer,110,210,320,12,64,UCBPlayer
15532,UCBPlayer,126,271,397,23,42,UCBPlayer
15533,UCBPlayer,105,210,315,10,65,UCBPlayer
15534,UCBPlayer,130,275,405,25,40,UCBPlayer
15535,UCBPlayer,105,210,315,10,65,UCBPlayer
15536,UCBPlayer,130,275,405,25,40,UCBPlayer
15537,UCBPlayer,106,206,312,10,66,UCBPlayer
15538,UCBPlayer,130,275,405,25,40,UCBPlayer
15539,UCBPlayer,105,210,315,10,65,UCBPlayer
15540,UCBPlayer,131,271,402,25,41,UCBPlayer
15541,UCBPlayer,105,210,315,10,65,UCBPlayer
15542,UCBPlayer,130,275,405,25,40,UCBPlayer
15543,UCBPlayer,105,210,315,10,65,UCBPlayer
15544,UCBPlayer,130,275,405,25,40,UCBPlayer
15545,UCBPlayer,103,203,306,10,68,UCBPlayer
15546,UCBPlayer,128,283,411,25,38,UCBPlayer
15547,UCBPlayer,111,186,297,10,71,UCBPlayer
15548,UCBPlayer,124,299,423,25,34,UCBPlayer
15549,UCBPlayer,115,170,285,10,75,UCBPlayer
15550,UCBPlayer,120,315,435,25,30,UCBPlayer
15551,UCBPlayer,119,154,273,10,79,UCBPlayer
15552,UCBPlayer,112,332,444,25,27,UCBPlayer
15553,UCBPlayer,127,137,264,10,82,UCBPlayer
15554,UCBPlayer,104,349,453,25,24,UCBPlayer
15555,UCBPlayer,126,126,252,7,85,Tie
15556,UCBPlayer,111,351,462,28,22,UCBPlayer
15557,UCBPlayer,116,126,242,3,87,UCBPlayer
15558,UCBPlayer,122,347,469,32,21,UCBPlayer
15559,UCBPlayer,107,132,239,0,87,UCBPlayer
15560,UCBPlayer,132,337,469,35,22,UCBPlayer
15561,UCBPlayer,103,148,251,0,83,UCBPlayer
15562,UCBPlayer,136,321,457,35,26,UCBPlayer
15563,UCBPlayer,99,164,263,0,79,UCBPlayer
15564,UCBPlayer,140,305,445,35,30,UCBPlayer
15565,UCBPlayer,95,180,275,0,75,UCBPlayer
15566,UCBPlayer,144,289,433,35,34,UCBPlayer
15567,UCBPlayer,91,196,287,0,71,UCBPlayer
15568,UCBPlayer,148,273,421,35,38,UCBPlayer
15569,UCBPlayer,87,212,299,0,67,UCBPlayer
15570,UCBPlayer,152,257,409,35,42,UCBPlayer
15571,UCBPlayer,84,224,308,0,64,UCBPlayer
15572,UCBPlayer,146,251,397,32,45,UCBPlayer
15573,UCBPlayer,89,234,323,3,60,UCBPlayer
15574,UCBPlayer,138,243,381,28,49,UCBPlayer
15575,UCBPlayer,97,242,339,7,56,UCBPlayer
15576,UCBPlayer,130,235,365,24,53,UCBPlayer
15577,UCBPlayer,105,250,355,11,52,UCBPlayer
15578,UCBPlayer,122,227,349,20,57,UCBPlayer
15579,UCBPlayer,109,259,368,15,49,UCBPlayer
15580,UCBPlayer,118,218,336,16,60,UCBPlayer
15581,UCBPlayer,117,267,384,19,45,UCBPlayer
15582,UCBPlayer,110,210,320,12,64,UCBPlayer
15583,UCBPlayer,126,271,397,23,42,UCBPlayer
15584,UCBPlayer,105,210,315,10,65,UCBPlayer
15585,UCBPlayer,130,275,405,25,40,UCBPlayer
15586,UCBPlayer,105,210,315,10,65,UCBPlayer
15587,UCBPlayer,130,275,405,25,40,UCBPlayer
15588,UCBPlayer,106,206,312,10,66,UCBPlayer
15589,UCBPlayer,130,275,405,25,40,UCBPlayer
15590,UCBPlayer,105,210,315,10,65,UCBPlayer
15591,UCBPlayer,131,271,402,25,41,UCBPlayer
15592,UCBPlayer,105,210,315,10,65,UCBPlayer
15593,UCBPlayer,130,275,405,25,40,UCBPlayer
15594,UCBPlayer,105,210,315,10,65,UCBPlayer
15595,UCBPlayer,130,275,405,25,40,UCBPlayer
15596,UCBPlayer,103,203,306,10,68,UCBPlayer
15597,UCBPlayer,128,283,411,25,38,UCBPlayer
15598,UCBPlayer,111,186,297,10,71,UCBPlayer
15599,UCBPlayer,124,299,423,25,34,UCBPlayer
15600,UCBPlayer,115,170,285,10,75,UCBPlayer
15601,UCBPlayer,120,315,435,25,30,UCBPlayer
15602,UCBPlayer,119,154,273,10,79,UCBPlayer
15603,UCBPlayer,112,332,444,25,27,UCBPlayer
15604,UCBPlayer,127,137,264,10,82,UCBPlayer
15605,UCBPlayer,104,349,453,25,24,UCBPlayer
15606,UCBPlayer,126,126,252,7,85,Tie
15607,UCBPlayer,111,351,462,28,22,UCBPlayer
15608,UCBPlayer,116,126,242,3,87,UCBPlayer
15609,UCBPlayer,122,347,469,32,21,UCBPlayer
15610,UCBPlayer,107,132,239,0,87,UCBPlayer
15611,UCBPlayer,132,337,469,35,22,UCBPlayer
15612,UCBPlayer,103,148,251,0,83,UCBPlayer
15613,UCBPlayer,136,321,457,35,26,UCBPlayer
15614,UCBPlayer,99,164,263,0,79,UCBPlayer
15615,UCBPlayer,140,305,445,35,30,UCBPlayer
15616,UCBPlayer,95,180,275,0,75,UCBPlayer
15617,UCBPlayer,144,289,433,35,34,UCBPlayer
15618,UCBPlayer,91,196,287,0,71,UCBPlayer
15619,UCBPlayer,148,273,421,35,38,UCBPlayer
15620,UCBPlayer,87,212,299,0,67,UCBPlayer
15621,UCBPlayer,152,257,409,35,42,UCBPlayer
15622,UCBPlayer,84,224,308,0,64,UCBPlayer
15623,UCBPlayer,146,251,397,32,45,UCBPlayer
15624,UCBPlayer,89,234,323,3,60,UCBPlayer
15625,UCBPlayer,138,243,381,28,49,UCBPlayer
15626,UCBPlayer,97,242,339,7,56,UCBPlayer
15627,UCBPlayer,130,235,365,24,53,UCBPlayer
15628,UCBPlayer,105,250,355,11,52,UCBPlayer
15629,UCBPlayer,122,227,349,20,57,UCBPlayer
15630,UCBPlayer,109,259,368,15,49,UCBPlayer
15631,UCBPlayer,118,218,336,16,60,UCBPlayer
15632,UCBPlayer,117,267,384,19,45,UCBPlayer
15633,UCBPlayer,110,210,320,12,64,UCBPlayer
15634,UCBPlayer,126,271,397,23,42,UCBPlayer
15635,UCBPlayer,105,210,315,10,65,UCBPlayer
15636,UCBPlayer,130,275,405,25,40,UCBPlayer
15637,UCBPlayer,105,210,315,10,65,UCBPlayer
15638,UCBPlayer,130,275,405,25,40,UCBPlayer
15639,UCBPlayer,106,206,312,10,66,UCBPlayer
15640,UCBPlayer,130,275,405,25,40,UCBPlayer
15641,UCBPlayer,105,210,315,10,65,UCBPlayer
15642,UCBPlayer,131,271,402,25,41,UCBPlayer
15643,UCBPlayer,105,210,315,10,65,UCBPlayer
15644,UCBPlayer,130,275,405,25,40,UCBPlayer
15645,UCBPlayer,105,210,315,10,65,UCBPlayer
15646,UCBPlayer,130,275,405,25,40,UCBPlayer
15647,UCBPlayer,103,203,306,10,68,UCBPlayer
15648,UCBPlayer,128,283,411,25,38,UCBPlayer
15649,UCBPlayer,111,186,297,10,71,UCBPlayer
15650,UCBPlayer,124,299,423,25,34,UCBPlayer
15651,UCBPlayer,115,170,285,10,75,UCBPlayer
15652,UCBPlayer,120,315,435,25,30,UCBPlayer
15653,UCBPlayer,119,154,273,10,79,UCBPlayer
15654,UCBPlayer,112,332,444,25,27,UCBPlayer
15655,UCBPlayer,127,137,264,10,82,UCBPlayer
15656,UCBPlayer,104,349,453,25,24,UCBPlayer
15657,UCBPlayer,126,126,252,7,85,Tie
15658,UCBPlayer,111,351,462,28,22,UCBPlayer
15659,UCBPlayer,116,126,242,3,87,UCBPlayer
15660,UCBPlayer,122,347,469,32,21,UCBPlayer
15661,UCBPlayer,107,132,239,0,87,UCBPlayer
15662,UCBPlayer,132,337,469,35,22,UCBPlayer
15663,UCBPlayer,103,148,251,0,83,UCBPlayer
15664,UCBPlayer,136,321,457,35,26,UCBPlayer
15665,UCBPlayer,99,164,263,0,79,UCBPlayer
15666,UCBPlayer,140,305,445,35,30,UCBPlayer
15667,UCBPlayer,95,180,275,0,75,UCBPlayer
15668,UCBPlayer,144,289,433,35,34,UCBPlayer
15669,UCBPlayer,91,196,287,0,71,UCBPlayer
15670,UCBPlayer,148,273,421,35,38,UCBPlayer
15671,UCBPlayer,87,212,299,0,67,UCBPlayer
15672,UCBPlayer,152,257,409,35,42,UCBPlayer
15673,UCBPlayer,84,224,308,0,64,UCBPlayer
15674,UCBPlayer,146,251,397,32,45,UCBPlayer
15675,UCBPlayer,89,234,323,3,60,UCBPlayer
15676,UCBPlayer,138,243,381,28,49,UCBPlayer
15677,UCBPlayer,97,242,339,7,56,UCBPlayer
15678,UCBPlayer,130,235,365,24,53,UCBPlayer
15679,UCBPlayer,105,250,355,11,52,UCBPlayer
15680,UCBPlayer,122,227,349,20,57,UCBPlayer
15681,UCBPlayer,109,259,368,15,49,UCBPlayer
15682,UCBPlayer,118,218,336,16,60,UCBPlayer
15683,UCBPlayer,117,267,384,19,45,UCBPlayer
15684,UCBPlayer,110,210,320,12,64,UCBPlayer
15685,UCBPlayer,126,271,397,23,42,UCBPlayer
15686,UCBPlayer,105,210,315,10,65,UCBPlayer
15687,UCBPlayer,130,275,405,25,40,UCBPlayer
15688,UCBPlayer,105,210,315,10,65,UCBPlayer
15689,UCBPlayer,130,275,405,25,40,UCBPlayer
15690,UCBPlayer,106,206,312,10,66,UCBPlayer
15691,UCBPlayer,130,275,405,25,40,UCBPlayer
15692,UCBPlayer,105,210,315,10,65,UCBPlayer
15693,UCBPlayer,131,271,402,25,41,UCBPlayer
15694,UCBPlayer,105,210,315,10,65,UCBPlayer
15695,UCBPlayer,130,275,405,25,40,UCBPlayer
15696,UCBPlayer,105,210,315,10,65,UCBPlayer
15697,UCBPlayer,130,275,405,25,40,UCBPlayer
15698,UCBPlayer,103,203,306,10,68,UCBPlayer
15699,UCBPlayer,128,283,411,25,38,UCBPlayer
15700,UCBPlayer,111,186,297,10,71,UCBPlayer
15701,UCBPlayer,124,299,423,25,34,UCBPlayer
15702,UCBPlayer,115,170,285,10,75,UCBPlayer
15703,UCBPlayer,120,315,435,25,30,UCBPlayer
15704,UCBPlayer,119,154,273,10,79,UCBPlayer
15705,UCBPlayer,112,332,444,25,27,UCBPlayer
15706,UCBPlayer,127,137,264,10,82,UCBPlayer
15707,UCBPlayer,104,349,453,25,24,UCBPlayer
15708,UCBPlayer,126,126,252,7,85,Tie
15709,UCBPlayer,111,351,462,28,22,UCBPlayer
15710,UCBPlayer,116,126,242,3,87,UCBPlayer
15711,UCBPlayer,122,347,469,32,21,UCBPlayer
15712,UCBPlayer,107,132,239,0,87,UCBPlayer
15713,UCBPlayer,132,337,469,35,22,UCBPlayer
15714,UCBPlayer,103,148,251,0,83,UCBPlayer
15715,UCBPlayer,136,321,457,35,26,UCBPlayer
15716,UCBPlayer,99,164,263,0,79,UCBPlayer
15717,UCBPlayer,140,305,445,35,30,UCBPlayer
15718,UCBPlayer,95,180,275,0,75,UCBPlayer
15719,UCBPlayer,144,289,433,35,34,UCBPlayer
15720,UCBPlayer,91,196,287,0,71,UCBPlayer
15721,UCBPlayer,148,273,421,35,38,UCBPlayer
15722,UCBPlayer,87,212,299,0,67,UCBPlayer
15723,UCBPlayer,152,257,409,35,42,UCBPlayer
15724,UCBPlayer,84,224,308,0,64,UCBPlayer
15725,UCBPlayer,146,251,397,32,45,UCBPlayer
15726,UCBPlayer,89,234,323,3,60,UCBPlayer
15727,UCBPlayer,138,243,381,28,49,UCBPlayer
15728,UCBPlayer,97,242,339,7,56,UCBPlayer
15729,UCBPlayer,130,235,365,24,53,UCBPlayer
15730,UCBPlayer,105,250,355,11,52,UCBPlayer
15731,UCBPlayer,122,227,349,20,57,UCBPlayer
15732,UCBPlayer,109,259,368,15,49,UCBPlayer
15733,UCBPlayer,118,218,336,16,60,UCBPlayer
15734,UCBPlayer,117,267,384,19,45,UCBPlayer
15735,UCBPlayer,110,210,320,12,64,UCBPlayer
15736,UCBPlayer,126,271,397,23,42,UCBPlayer
15737,UCBPlayer,105,210,315,10,65,UCBPlayer
15738,UCBPlayer,130,275,405,25,40,UCBPlayer
15739,UCBPlayer,105,210,315,10,65,UCBPlayer
15740,UCBPlayer,130,275,405,25,40,UCBPlayer
15741,UCBPlayer,106,206,312,10,66,UCBPlayer
15742,UCBPlayer,130,275,405,25,40,UCBPlayer
15743,UCBPlayer,105,210,315,10,65,UCBPlayer
15744,UCBPlayer,131,271,402,25,41,UCBPlayer
15745,UCBPlayer,105,210,315,10,65,UCBPlayer
15746,UCBPlayer,130,275,405,25,40,UCBPlayer
15747,UCBPlayer,105,210,315,10,65,UCBPlayer
15748,UCBPlayer,130,275,405,25,40,UCBPlayer
15749,UCBPlayer,103,203,306,10,68,UCBPlayer
15750,UCBPlayer,128,283,411,25,38,UCBPlayer
15751,UCBPlayer,111,186,297,10,71,UCBPlayer
15752,UCBPlayer,124,299,423,25,34,UCBPlayer
15753,UCBPlayer,115,170,285,10,75,UCBPlayer
15754,UCBPlayer,120,315,435,25,30,UCBPlayer
15755,UCBPlayer,119,154,273,10,79,UCBPlayer
15756,UCBPlayer,112,332,444,25,27,UCBPlayer
15757,UCBPlayer,127,137,264,10,82,UCBPlayer
15758,UCBPlayer,104,349,453,25,24,UCBPlayer
15759,UCBPlayer,126,126,252,7,85,Tie
15760,UCBPlayer,111,351,462,28,22,UCBPlayer
15761,UCBPlayer,116,126,242,3,87,UCBPlayer
15762,UCBPlayer,122,347,469,32,21,UCBPlayer
15763,UCBPlayer,107,132,239,0,87,UCBPlayer
15764,UCBPlayer,132,337,469,35,22,UCBPlayer
15765,UCBPlayer,103,148,251,0,83,UCBPlayer
15766,UCBPlayer,136,321,457,35,26,UCBPlayer
15767,UCBPlayer,99,164,263,0,79,UCBPlayer
15768,UCBPlayer,140,305,445,35,30,UCBPlayer
15769,UCBPlayer,95,180,275,0,75,UCBPlayer
15770,UCBPlayer,144,289,433,35,34,UCBPlayer
15771,UCBPlayer,91,196,287,0,71,UCBPlayer
15772,UCBPlayer,148,273,421,35,38,UCBPlayer
15773,UCBPlayer,87,212,299,0,67,UCBPlayer
15774,UCBPlayer,152,257,409,35,42,UCBPlayer
15775,UCBPlayer,84,224,308,0,64,UCBPlayer
15776,UCBPlayer,146,251,397,32,45,UCBPlayer
15777,UCBPlayer,89,234,323,3,60,UCBPlayer
15778,UCBPlayer,138,243,381,28,49,UCBPlayer
15779,UCBPlayer,97,242,339,7,56,UCBPlayer
15780,UCBPlayer,130,235,365,24,53,UCBPlayer
15781,UCBPlayer,105,250,355,11,52,UCBPlayer
15782,UCBPlayer,122,227,349,20,57,UCBPlayer
15783,UCBPlayer,109,259,368,15,49,UCBPlayer
15784,UCBPlayer,118,218,336,16,60,UCBPlayer
15785,UCBPlayer,117,267,384,19,45,UCBPlayer
15786,UCBPlayer,110,210,320,12,64,UCBPlayer
15787,UCBPlayer,126,271,397,23,42,UCBPlayer
15788,UCBPlayer,105,210,315,10,65,UCBPlayer
15789,UCBPlayer,130,275,405,25,40,UCBPlayer
15790,UCBPlayer,105,210,315,10,65,UCBPlayer
15791,UCBPlayer,130,275,405,25,40,UCBPlayer
15792,UCBPlayer,106,206,312,10,66,UCBPlayer
15793,UCBPlayer,130,275,405,25,40,UCBPlayer
15794,UCBPlayer,105,210,315,10,65,UCBPlayer
15795,UCBPlayer,131,271,402,25,41,UCBPlayer
15796,UCBPlayer,105,210,315,10,65,UCBPlayer
15797,UCBPlayer,130,275,405,25,40,UCBPlayer
15798,UCBPlayer,105,210,315,10,65,UCBPlayer
15799,UCBPlayer,130,275,405,25,40,UCBPlayer
15800,UCBPlayer,103,203,306,10,68,UCBPlayer
15801,UCBPlayer,128,283,411,25,38,UCBPlayer
15802,UCBPlayer,111,186,297,10,71,UCBPlayer
15803,UCBPlayer,124,299,423,25,34,UCBPlayer
15804,UCBPlayer,115,170,285,10,75,UCBPlayer
15805,UCBPlayer,120,315,435,25,30,UCBPlayer
15806,UCBPlayer,119,154,273,10,79,UCBPlayer
15807,UCBPlayer,112,332,444,25,27,UCBPlayer
15808,UCBPlayer,127,137,264,10,82,UCBPlayer
15809,UCBPlayer,104,349,453,25,24,UCBPlayer
15810,UCBPlayer,126,126,252,7,85,Tie
15811,UCBPlayer,111,351,462,28,22,UCBPlayer
15812,UCBPlayer,116,126,242,3,87,UCBPlayer
15813,UCBPlayer,122,347,469,32,21,UCBPlayer
15814,UCBPlayer,107,132,239,0,87,UCBPlayer
15815,UCBPlayer,132,337,469,35,22,UCBPlayer
15816,UCBPlayer,103,148,251,0,83,UCBPlayer
15817,UCBPlayer,136,321,457,35,26,UCBPlayer
15818,UCBPlayer,99,164,263,0,79,UCBPlayer
15819,UCBPlayer,140,305,445,35,30,UCBPlayer
15820,UCBPlayer,95,180,275,0,75,UCBPlayer
15821,UCBPlayer,144,289,433,35,34,UCBPlayer
15822,UCBPlayer,91,196,287,0,71,UCBPlayer
15823,UCBPlayer,148,273,421,35,38,UCBPlayer
15824,UCBPlayer,87,212,299,0,67,UCBPlayer
15825,UCBPlayer,152,257,409,35,42,UCBPlayer
15826,UCBPlayer,84,224,308,0,64,UCBPlayer
15827,UCBPlayer,146,251,397,32,45,UCBPlayer
15828,UCBPlayer,89,234,323,3,60,UCBPlayer
15829,UCBPlayer,138,243,381,28,49,UCBPlayer
15830,UCBPlayer,97,242,339,7,56,UCBPlayer
15831,UCBPlayer,130,235,365,24,53,UCBPlayer
15832,UCBPlayer,105,250,355,11,52,UCBPlayer
15833,UCBPlayer,122,227,349,20,57,UCBPlayer
15834,UCBPlayer,109,259,368,15,49,UCBPlayer
15835,UCBPlayer,118,218,336,16,60,UCBPlayer
15836,UCBPlayer,117,267,384,19,45,UCBPlayer
15837,UCBPlayer,110,210,320,12,64,UCBPlayer
15838,UCBPlayer,126,271,397,23,42,UCBPlayer
15839,UCBPlayer,105,210,315,10,65,UCBPlayer
15840,UCBPlayer,130,275,405,25,40,UCBPlayer
15841,UCBPlayer,105,210,315,10,65,UCBPlayer
15842,UCBPlayer,130,275,405,25,40,UCBPlayer
15843,UCBPlayer,106,206,312,10,66,UCBPlayer
15844,UCBPlayer,130,275,405,25,40,UCBPlayer
15845,UCBPlayer,105,210,315,10,65,UCBPlayer
15846,UCBPlayer,131,271,402,25,41,UCBPlayer
15847,UCBPlayer,105,210,315,10,65,UCBPlayer
15848,UCBPlayer,130,275,405,25,40,UCBPlayer
15849,UCBPlayer,105,210,315,10,65,UCBPlayer
15850,UCBPlayer,130,275,405,25,40,UCBPlayer
15851,UCBPlayer,103,203,306,10,68,UCBPlayer
15852,UCBPlayer,128,283,411,25,38,UCBPlayer
15853,UCBPlayer,111,186,297,10,71,UCBPlayer
15854,UCBPlayer,124,299,423,25,34,UCBPlayer
15855,UCBPlayer,115,170,285,10,75,UCBPlayer
15856,UCBPlayer,120,315,435,25,30,UCBPlayer
15857,UCBPlayer,119,154,273,10,79,UCBPlayer
15858,UCBPlayer,112,332,444,25,27,UCBPlayer
15859,UCBPlayer,127,137,264,10,82,UCBPlayer
15860,UCBPlayer,104,349,453,25,24,UCBPlayer
15861,UCBPlayer,126,126,252,7,85,Tie
15862,UCBPlayer,111,351,462,28,22,UCBPlayer
15863,UCBPlayer,116,126,242,3,87,UCBPlayer
15864,UCBPlayer,122,347,469,32,21,UCBPlayer
15865,UCBPlayer,107,132,239,0,87,UCBPlayer
15866,UCBPlayer,132,337,469,35,22,UCBPlayer
15867,UCBPlayer,103,148,251,0,83,UCBPlayer
15868,UCBPlayer,136,321,457,35,26,UCBPlayer
15869,UCBPlayer,99,164,263,0,79,UCBPlayer
15870,UCBPlayer,140,305,445,35,30,UCBPlayer
15871,UCBPlayer,95,180,275,0,75,UCBPlayer
15872,UCBPlayer,144,289,433,35,34,UCBPlayer
15873,UCBPlayer,91,196,287,0,71,UCBPlayer
15874,UCBPlayer,148,273,421,35,38,UCBPlayer
15875,UCBPlayer,87,212,299,0,67,UCBPlayer
15876,UCBPlayer,152,257,409,35,42,UCBPlayer
15877,UCBPlayer,84,224,308,0,64,UCBPlayer
15878,UCBPlayer,146,251,397,32,45,UCBPlayer
15879,UCBPlayer,89,234,323,3,60,UCBPlayer
15880,UCBPlayer,138,243,381,28,49,UCBPlayer
15881,UCBPlayer,97,242,339,7,56,UCBPlayer
15882,UCBPlayer,130,235,365,24,53,UCBPlayer
15883,UCBPlayer,105,250,355,11,52,UCBPlayer
15884,UCBPlayer,122,227,349,20,57,UCBPlayer
15885,UCBPlayer,109,259,368,15,49,UCBPlayer
15886,UCBPlayer,118,218,336,16,60,UCBPlayer
15887,UCBPlayer,117,267,384,19,45,UCBPlayer
15888,UCBPlayer,110,210,320,12,64,UCBPlayer
15889,UCBPlayer,126,271,397,23,42,UCBPlayer
15890,UCBPlayer,105,210,315,10,65,UCBPlayer
15891,UCBPlayer,130,275,405,25,40,UCBPlayer
15892,UCBPlayer,105,210,315,10,65,UCBPlayer
15893,UCBPlayer,130,275,405,25,40,UCBPlayer
15894,UCBPlayer,106,206,312,10,66,UCBPlayer
15895,UCBPlayer,130,275,405,25,40,UCBPlayer
15896,UCBPlayer,105,210,315,10,65,UCBPlayer
15897,UCBPlayer,131,271,402,25,41,UCBPlayer
15898,UCBPlayer,105,210,315,10,65,UCBPlayer
15899,UCBPlayer,130,275,405,25,40,UCBPlayer
15900,UCBPlayer,105,210,315,10,65,UCBPlayer
15901,UCBPlayer,130,275,405,25,40,UCBPlayer
15902,UCBPlayer,103,203,306,10,68,UCBPlayer
15903,UCBPlayer,128,283,411,25,38,UCBPlayer
15904,UCBPlayer,111,186,297,10,71,UCBPlayer
15905,UCBPlayer,124,299,423,25,34,UCBPlayer
15906,UCBPlayer,115,170,285,10,75,UCBPlayer
15907,UCBPlayer,120,315,435,25,30,UCBPlayer
15908,UCBPlayer,119,154,273,10,79,UCBPlayer
15909,UCBPlayer,112,332,444,25,27,UCBPlayer
15910,UCBPlayer,127,137,264,10,82,UCBPlayer
15911,UCBPlayer,104,349,453,25,24,UCBPlayer
15912,UCBPlayer,126,126,252,7,85,Tie
15913,UCBPlayer,111,351,462,28,22,UCBPlayer
15914,UCBPlayer,116,126,242,3,87,UCBPlayer
15915,UCBPlayer,122,347,469,32,21,UCBPlayer
15916,UCBPlayer,107,132,239,0,87,UCBPlayer
15917,UCBPlayer,132,337,469,35,22,UCBPlayer
15918,UCBPlayer,103,148,251,0,83,UCBPlayer
15919,UCBPlayer,136,321,457,35,26,UCBPlayer
15920,UCBPlayer,99,164,263,0,79,UCBPlayer
15921,UCBPlayer,140,305,445,35,30,UCBPlayer
15922,UCBPlayer,95,180,275,0,75,UCBPlayer
15923,UCBPlayer,144,289,433,35,34,UCBPlayer
15924,UCBPlayer,91,196,287,0,71,UCBPlayer
15925,UCBPlayer,148,273,421,35,38,UCBPlayer
15926,UCBPlayer,87,212,299,0,67,UCBPlayer
15927,UCBPlayer,152,257,409,35,42,UCBPlayer
15928,UCBPlayer,84,224,308,0,64,UCBPlayer
15929,UCBPlayer,146,251,397,32,45,UCBPlayer
15930,UCBPlayer,89,234,323,3,60,UCBPlayer
15931,UCBPlayer,138,243,381,28,49,UCBPlayer
15932,UCBPlayer,97,242,339,7,56,UCBPlayer
15933,UCBPlayer,130,235,365,24,53,UCBPlayer
15934,UCBPlayer,105,250,355,11,52,UCBPlayer
15935,UCBPlayer,122,227,349,20,57,UCBPlayer
15936,UCBPlayer,109,259,368,15,49,UCBPlayer
15937,UCBPlayer,118,218,336,16,60,UCBPlayer
15938,UCBPlayer,117,267,384,19,45,UCBPlayer
15939,UCBPlayer,110,210,320,12,64,UCBPlayer
15940,UCBPlayer,126,271,397,23,42,UCBPlayer
15941,UCBPlayer,105,210,315,10,65,UCBPlayer
15942,UCBPlayer,130,275,405,25,40,UCBPlayer
15943,UCBPlayer,105,210,315,10,65,UCBPlayer
15944,UCBPlayer,130,275,405,25,40,UCBPlayer
15945,UCBPlayer,106,206,312,10,66,UCBPlayer
15946,UCBPlayer,130,275,405,25,40,UCBPlayer
15947,UCBPlayer,105,210,315,10,65,UCBPlayer
15948,UCBPlayer,131,271,402,25,41,UCBPlayer
15949,UCBPlayer,105,210,315,10,65,UCBPlayer
15950,UCBPlayer,130,275,405,25,40,UCBPlayer
15951,UCBPlayer,105,210,315,10,65,UCBPlayer
15952,UCBPlayer,130,275,405,25,40,UCBPlayer
15953,UCBPlayer,103,203,306,10,68,UCBPlayer
15954,UCBPlayer,128,283,411,25,38,UCBPlayer
15955,UCBPlayer,111,186,297,10,71,UCBPlayer
15956,UCBPlayer,124,299,423,25,34,UCBPlayer
15957,UCBPlayer,115,170,285,10,75,UCBPlayer
15958,UCBPlayer,120,315,435,25,30,UCBPlayer
15959,UCBPlayer,119,154,273,10,79,UCBPlayer
15960,UCBPlayer,112,332,444,25,27,UCBPlayer
15961,UCBPlayer,127,137,264,10,82,UCBPlayer
15962,UCBPlayer,104,349,453,25,24,UCBPlayer
15963,UCBPlayer,126,126,252,7,85,Tie
15964,UCBPlayer,111,351,462,28,22,UCBPlayer
15965,UCBPlayer,116,126,242,3,87,UCBPlayer
15966,UCBPlayer,122,347,469,32,21,UCBPlayer
15967,UCBPlayer,107,132,239,0,87,UCBPlayer
15968,UCBPlayer,132,337,469,35,22,UCBPlayer
15969,UCBPlayer,103,148,251,0,83,UCBPlayer
15970,UCBPlayer,136,321,457,35,26,UCBPlayer
15971,UCBPlayer,99,164,263,0,79,UCBPlayer
15972,UCBPlayer,140,305,445,35,30,UCBPlayer
15973,UCBPlayer,95,180,275,0,75,UCBPlayer
15974,UCBPlayer,144,289,433,35,34,UCBPlayer
15975,UCBPlayer,91,196,287,0,71,UCBPlayer
15976,UCBPlayer,148,273,421,35,38,UCBPlayer
15977,UCBPlayer,87,212,299,0,67,UCBPlayer
15978,UCBPlayer,152,257,409,35,42,UCBPlayer
15979,UCBPlayer,84,224,308,0,64,UCBPlayer
15980,UCBPlayer,146,251,397,32,45,UCBPlayer
15981,UCBPlayer,89,234,323,3,60,UCBPlayer
15982,UCBPlayer,138,243,381,28,49,UCBPlayer
15983,UCBPlayer,97,242,339,7,56,UCBPlayer
15984,UCBPlayer,130,235,365,24,53,UCBPlayer
15985,UCBPlayer,105,250,355,11,52,UCBPlayer
15986,UCBPlayer,122,227,349,20,57,UCBPlayer
15987,UCBPlayer,109,259,368,15,49,UCBPlayer
15988,UCBPlayer,118,218,336,16,60,UCBPlayer
15989,UCBPlayer,117,267,384,19,45,UCBPlayer
15990,UCBPlayer,110,210,320,12,64,UCBPlayer
15991,UCBPlayer,126,271,397,23,42,UCBPlayer
15992,UCBPlayer,105,210,315,10,65,UCBPlayer
15993,UCBPlayer,130,275,405,25,40,UCBPlayer
15994,UCBPlayer,105,210,315,10,65,UCBPlayer
15995,UCBPlayer,130,275,405,25,40,UCBPlayer
15996,UCBPlayer,106,206,312,10,66,UCBPlayer
15997,UCBPlayer,130,275,405,25,40,UCBPlayer
15998,UCBPlayer,105,210,315,10,65,UCBPlayer
15999,UCBPlayer,131,271,402,25,41,UCBPlayer
16000,UCBPlayer,105,210,315,10,65,UCBPlayer
16001,UCBPlayer,130,275,405,25,40,UCBPlayer
16002,UCBPlayer,105,210,315,10,65,UCBPlayer
16003,UCBPlayer,130,275,405,25,40,UCBPlayer
16004,UCBPlayer,103,203,306,10,68,UCBPlayer
16005,UCBPlayer,128,283,411,25,38,UCBPlayer
16006,UCBPlayer,111,186,297,10,71,UCBPlayer
16007,UCBPlayer,124,299,423,25,34,UCBPlayer
16008,UCBPlayer,115,170,285,10,75,UCBPlayer
16009,UCBPlayer,120,315,435,25,30,UCBPlayer
16010,UCBPlayer,119,154,273,10,79,UCBPlayer
16011,UCBPlayer,112,332,444,25,27,UCBPlayer
16012,UCBPlayer,127,137,264,10,82,UCBPlayer
16013,UCBPlayer,104,349,453,25,24,UCBPlayer
16014,UCBPlayer,126,126,252,7,85,Tie
16015,UCBPlayer,111,351,462,28,22,UCBPlayer
16016,UCBPlayer,116,126,242,3,87,UCBPlayer
16017,UCBPlayer,122,347,469,32,21,UCBPlayer
16018,UCBPlayer,107,132,239,0,87,UCBPlayer
16019,UCBPlayer,132,337,469,35,22,UCBPlayer
16020,UCBPlayer,103,148,251,0,83,UCBPlayer
16021,UCBPlayer,136,321,457,35,26,UCBPlayer
16022,UCBPlayer,99,164,263,0,79,UCBPlayer
16023,UCBPlayer,140,305,445,35,30,UCBPlayer
16024,UCBPlayer,95,180,275,0,75,UCBPlayer
16025,UCBPlayer,144,289,433,35,34,UCBPlayer
16026,UCBPlayer,91,196,287,0,71,UCBPlayer
16027,UCBPlayer,148,273,421,35,38,UCBPlayer
16028,UCBPlayer,87,212,299,0,67,UCBPlayer
16029,UCBPlayer,152,257,409,35,42,UCBPlayer
16030,UCBPlayer,84,224,308,0,64,UCBPlayer
16031,UCBPlayer,146,251,397,32,45,UCBPlayer
16032,UCBPlayer,89,234,323,3,60,UCBPlayer
16033,UCBPlayer,138,243,381,28,49,UCBPlayer
16034,UCBPlayer,97,242,339,7,56,UCBPlayer
16035,UCBPlayer,130,235,365,24,53,UCBPlayer
16036,UCBPlayer,105,250,355,11,52,UCBPlayer
16037,UCBPlayer,122,227,349,20,57,UCBPlayer
16038,UCBPlayer,109,259,368,15,49,UCBPlayer
16039,UCBPlayer,118,218,336,16,60,UCBPlayer
16040,UCBPlayer,117,267,384,19,45,UCBPlayer
16041,UCBPlayer,110,210,320,12,64,UCBPlayer
16042,UCBPlayer,126,271,397,23,42,UCBPlayer
16043,UCBPlayer,105,210,315,10,65,UCBPlayer
16044,UCBPlayer,130,275,405,25,40,UCBPlayer
16045,UCBPlayer,105,210,315,10,65,UCBPlayer
16046,UCBPlayer,130,275,405,25,40,UCBPlayer
16047,UCBPlayer,106,206,312,10,66,UCBPlayer
16048,UCBPlayer,130,275,405,25,40,UCBPlayer
16049,UCBPlayer,105,210,315,10,65,UCBPlayer
16050,UCBPlayer,131,271,402,25,41,UCBPlayer
16051,UCBPlayer,105,210,315,10,65,UCBPlayer
16052,UCBPlayer,130,275,405,25,40,UCBPlayer
16053,UCBPlayer,105,210,315,10,65,UCBPlayer
16054,UCBPlayer,130,275,405,25,40,UCBPlayer
16055,UCBPlayer,103,203,306,10,68,UCBPlayer
16056,UCBPlayer,128,283,411,25,38,UCBPlayer
16057,UCBPlayer,111,186,297,10,71,UCBPlayer
16058,UCBPlayer,124,299,423,25,34,UCBPlayer
16059,UCBPlayer,115,170,285,10,75,UCBPlayer
16060,UCBPlayer,120,315,435,25,30,UCBPlayer
16061,UCBPlayer,119,154,273,10,79,UCBPlayer
16062,UCBPlayer,112,332,444,25,27,UCBPlayer
16063,UCBPlayer,127,137,264,10,82,UCBPlayer
16064,UCBPlayer,104,349,453,25,24,UCBPlayer
16065,UCBPlayer,126,126,252,7,85,Tie
16066,UCBPlayer,111,351,462,28,22,UCBPlayer
16067,UCBPlayer,116,126,242,3,87,UCBPlayer
16068,UCBPlayer,122,347,469,32,21,UCBPlayer
16069,UCBPlayer,107,132,239,0,87,UCBPlayer
16070,UCBPlayer,132,337,469,35,22,UCBPlayer
16071,UCBPlayer,103,148,251,0,83,UCBPlayer
16072,UCBPlayer,136,321,457,35,26,UCBPlayer
16073,UCBPlayer,99,164,263,0,79,UCBPlayer
16074,UCBPlayer,140,305,445,35,30,UCBPlayer
16075,UCBPlayer,95,180,275,0,75,UCBPlayer
16076,UCBPlayer,144,289,433,35,34,UCBPlayer
16077,UCBPlayer,91,196,287,0,71,UCBPlayer
16078,UCBPlayer,148,273,421,35,38,UCBPlayer
16079,UCBPlayer,87,212,299,0,67,UCBPlayer
16080,UCBPlayer,152,257,409,35,42,UCBPlayer
16081,UCBPlayer,84,224,308,0,64,UCBPlayer
16082,UCBPlayer,146,251,397,32,45,UCBPlayer
16083,UCBPlayer,89,234,323,3,60,UCBPlayer
16084,UCBPlayer,138,243,381,28,49,UCBPlayer
16085,UCBPlayer,97,242,339,7,56,UCBPlayer
16086,UCBPlayer,130,235,365,24,53,UCBPlayer
16087,UCBPlayer,105,250,355,11,52,UCBPlayer
16088,UCBPlayer,122,227,349,20,57,UCBPlayer
16089,UCBPlayer,109,259,368,15,49,UCBPlayer
16090,UCBPlayer,118,218,336,16,60,UCBPlayer
16091,UCBPlayer,117,267,384,19,45,UCBPlayer
16092,UCBPlayer,110,210,320,12,64,UCBPlayer
16093,UCBPlayer,126,271,397,23,42,UCBPlayer
16094,UCBPlayer,105,210,315,10,65,UCBPlayer
16095,UCBPlayer,130,275,405,25,40,UCBPlayer
16096,UCBPlayer,105,210,315,10,65,UCBPlayer
16097,UCBPlayer,130,275,405,25,40,UCBPlayer
16098,UCBPlayer,106,206,312,10,66,UCBPlayer
16099,UCBPlayer,130,275,405,25,40,UCBPlayer
16100,UCBPlayer,105,210,315,10,65,UCBPlayer
16101,UCBPlayer,131,271,402,25,41,UCBPlayer
16102,UCBPlayer,105,210,315,10,65,UCBPlayer
16103,UCBPlayer,130,275,405,25,40,UCBPlayer
16104,UCBPlayer,105,210,315,10,65,UCBPlayer
16105,UCBPlayer,130,275,405,25,40,UCBPlayer
16106,UCBPlayer,103,203,306,10,68,UCBPlayer
16107,UCBPlayer,128,283,411,25,38,UCBPlayer
16108,UCBPlayer,111,186,297,10,71,UCBPlayer
16109,UCBPlayer,124,299,423,25,34,UCBPlayer
16110,UCBPlayer,115,170,285,10,75,UCBPlayer
16111,UCBPlayer,120,315,435,25,30,UCBPlayer
16112,UCBPlayer,119,154,273,10,79,UCBPlayer
16113,UCBPlayer,112,332,444,25,27,UCBPlayer
16114,UCBPlayer,127,137,264,10,82,UCBPlayer
16115,UCBPlayer,104,349,453,25,24,UCBPlayer
16116,UCBPlayer,126,126,252,7,85,Tie
16117,UCBPlayer,111,351,462,28,22,UCBPlayer
16118,UCBPlayer,116,126,242,3,87,UCBPlayer
16119,UCBPlayer,122,347,469,32,21,UCBPlayer
16120,UCBPlayer,107,132,239,0,87,UCBPlayer
16121,UCBPlayer,132,337,469,35,22,UCBPlayer
16122,UCBPlayer,103,148,251,0,83,UCBPlayer
16123,UCBPlayer,136,321,457,35,26,UCBPlayer
16124,UCBPlayer,99,164,263,0,79,UCBPlayer
16125,UCBPlayer,140,305,445,35,30,UCBPlayer
16126,UCBPlayer,95,180,275,0,75,UCBPlayer
16127,UCBPlayer,144,289,433,35,34,UCBPlayer
16128,UCBPlayer,91,196,287,0,71,UCBPlayer
16129,UCBPlayer,148,273,421,35,38,UCBPlayer
16130,UCBPlayer,87,212,299,0,67,UCBPlayer
16131,UCBPlayer,152,257,409,35,42,UCBPlayer
16132,UCBPlayer,84,224,308,0,64,UCBPlayer
16133,UCBPlayer,146,251,397,32,45,UCBPlayer
16134,UCBPlayer,89,234,323,3,60,UCBPlayer
16135,UCBPlayer,138,243,381,28,49,UCBPlayer
16136,UCBPlayer,97,242,339,7,56,UCBPlayer
16137,UCBPlayer,130,235,365,24,53,UCBPlayer
16138,UCBPlayer,105,250,355,11,52,UCBPlayer
16139,UCBPlayer,122,227,349,20,57,UCBPlayer
16140,UCBPlayer,109,259,368,15,49,UCBPlayer
16141,UCBPlayer,118,218,336,16,60,UCBPlayer
16142,UCBPlayer,117,267,384,19,45,UCBPlayer
16143,UCBPlayer,110,210,320,12,64,UCBPlayer
16144,UCBPlayer,126,271,397,23,42,UCBPlayer
16145,UCBPlayer,105,210,315,10,65,UCBPlayer
16146,UCBPlayer,130,275,405,25,40,UCBPlayer
16147,UCBPlayer,105,210,315,10,65,UCBPlayer
16148,UCBPlayer,130,275,405,25,40,UCBPlayer
16149,UCBPlayer,106,206,312,10,66,UCBPlayer
16150,UCBPlayer,130,275,405,25,40,UCBPlayer
16151,UCBPlayer,105,210,315,10,65,UCBPlayer
16152,UCBPlayer,131,271,402,25,41,UCBPlayer
16153,UCBPlayer,105,210,315,10,65,UCBPlayer
16154,UCBPlayer,130,275,405,25,40,UCBPlayer
16155,UCBPlayer,105,210,315,10,65,UCBPlayer
16156,UCBPlayer,130,275,405,25,40,UCBPlayer
16157,UCBPlayer,103,203,306,10,68,UCBPlayer
16158,UCBPlayer,128,283,411,25,38,UCBPlayer
16159,UCBPlayer,111,186,297,10,71,UCBPlayer
16160,UCBPlayer,124,299,423,25,34,UCBPlayer
16161,UCBPlayer,115,170,285,10,75,UCBPlayer
16162,UCBPlayer,120,315,435,25,30,UCBPlayer
16163,UCBPlayer,119,154,273,10,79,UCBPlayer
16164,UCBPlayer,112,332,444,25,27,UCBPlayer
16165,UCBPlayer,127,137,264,10,82,UCBPlayer
16166,UCBPlayer,104,349,453,25,24,UCBPlayer
16167,UCBPlayer,126,126,252,7,85,Tie
16168,UCBPlayer,111,351,462,28,22,UCBPlayer
16169,UCBPlayer,116,126,242,3,87,UCBPlayer
16170,UCBPlayer,122,347,469,32,21,UCBPlayer
16171,UCBPlayer,107,132,239,0,87,UCBPlayer
16172,UCBPlayer,132,337,469,35,22,UCBPlayer
16173,UCBPlayer,103,148,251,0,83,UCBPlayer
16174,UCBPlayer,136,321,457,35,26,UCBPlayer
16175,UCBPlayer,99,164,263,0,79,UCBPlayer
16176,UCBPlayer,140,305,445,35,30,UCBPlayer
16177,UCBPlayer,95,180,275,0,75,UCBPlayer
16178,UCBPlayer,144,289,433,35,34,UCBPlayer
16179,UCBPlayer,91,196,287,0,71,UCBPlayer
16180,UCBPlayer,148,273,421,35,38,UCBPlayer
16181,UCBPlayer,87,212,299,0,67,UCBPlayer
16182,UCBPlayer,152,257,409,35,42,UCBPlayer
16183,UCBPlayer,84,224,308,0,64,UCBPlayer
16184,UCBPlayer,146,251,397,32,45,UCBPlayer
16185,UCBPlayer,89,234,323,3,60,UCBPlayer
16186,UCBPlayer,138,243,381,28,49,UCBPlayer
16187,UCBPlayer,97,242,339,7,56,UCBPlayer
16188,UCBPlayer,130,235,365,24,53,UCBPlayer
16189,UCBPlayer,105,250,355,11,52,UCBPlayer
16190,UCBPlayer,122,227,349,20,57,UCBPlayer
16191,UCBPlayer,109,259,368,15,49,UCBPlayer
16192,UCBPlayer,118,218,336,16,60,UCBPlayer
16193,UCBPlayer,117,267,384,19,45,UCBPlayer
16194,UCBPlayer,110,210,320,12,64,UCBPlayer
16195,UCBPlayer,126,271,397,23,42,UCBPlayer
16196,UCBPlayer,105,210,315,10,65,UCBPlayer
16197,UCBPlayer,130,275,405,25,40,UCBPlayer
16198,UCBPlayer,105,210,315,10,65,UCBPlayer
16199,UCBPlayer,130,275,405,25,40,UCBPlayer
16200,UCBPlayer,106,206,312,10,66,UCBPlayer
16201,UCBPlayer,130,275,405,25,40,UCBPlayer
16202,UCBPlayer,105,210,315,10,65,UCBPlayer
16203,UCBPlayer,131,271,402,25,41,UCBPlayer
16204,UCBPlayer,105,210,315,10,65,UCBPlayer
16205,UCBPlayer,130,275,405,25,40,UCBPlayer
16206,UCBPlayer,105,210,315,10,65,UCBPlayer
16207,UCBPlayer,130,275,405,25,40,UCBPlayer
16208,UCBPlayer,103,203,306,10,68,UCBPlayer
16209,UCBPlayer,128,283,411,25,38,UCBPlayer
16210,UCBPlayer,111,186,297,10,71,UCBPlayer
16211,UCBPlayer,124,299,423,25,34,UCBPlayer
16212,UCBPlayer,115,170,285,10,75,UCBPlayer
16213,UCBPlayer,120,315,435,25,30,UCBPlayer
16214,UCBPlayer,119,154,273,10,79,UCBPlayer
16215,UCBPlayer,112,332,444,25,27,UCBPlayer
16216,UCBPlayer,127,137,264,10,82,UCBPlayer
16217,UCBPlayer,104,349,453,25,24,UCBPlayer
16218,UCBPlayer,126,126,252,7,85,Tie
16219,UCBPlayer,111,351,462,28,22,UCBPlayer
16220,UCBPlayer,116,126,242,3,87,UCBPlayer
16221,UCBPlayer,122,347,469,32,21,UCBPlayer
16222,UCBPlayer,107,132,239,0,87,UCBPlayer
16223,UCBPlayer,132,337,469,35,22,UCBPlayer
16224,UCBPlayer,103,148,251,0,83,UCBPlayer
16225,UCBPlayer,136,321,457,35,26,UCBPlayer
16226,UCBPlayer,99,164,263,0,79,UCBPlayer
16227,UCBPlayer,140,305,445,35,30,UCBPlayer
16228,UCBPlayer,95,180,275,0,75,UCBPlayer
16229,UCBPlayer,144,289,433,35,34,UCBPlayer
16230,UCBPlayer,91,196,287,0,71,UCBPlayer
16231,UCBPlayer,148,273,421,35,38,UCBPlayer
16232,UCBPlayer,87,212,299,0,67,UCBPlayer
16233,UCBPlayer,152,257,409,35,42,UCBPlayer
16234,UCBPlayer,84,224,308,0,64,UCBPlayer
16235,UCBPlayer,146,251,397,32,45,UCBPlayer
16236,UCBPlayer,89,234,323,3,60,UCBPlayer
16237,UCBPlayer,138,243,381,28,49,UCBPlayer
16238,UCBPlayer,97,242,339,7,56,UCBPlayer
16239,UCBPlayer,130,235,365,24,53,UCBPlayer
16240,UCBPlayer,105,250,355,11,52,UCBPlayer
16241,UCBPlayer,122,227,349,20,57,UCBPlayer
16242,UCBPlayer,109,259,368,15,49,UCBPlayer
16243,UCBPlayer,118,218,336,16,60,UCBPlayer
16244,UCBPlayer,117,267,384,19,45,UCBPlayer
16245,UCBPlayer,110,210,320,12,64,UCBPlayer
16246,UCBPlayer,126,271,397,23,42,UCBPlayer
16247,UCBPlayer,105,210,315,10,65,UCBPlayer
16248,UCBPlayer,130,275,405,25,40,UCBPlayer
16249,UCBPlayer,105,210,315,10,65,UCBPlayer
16250,UCBPlayer,130,275,405,25,40,UCBPlayer
16251,UCBPlayer,106,206,312,10,66,UCBPlayer
16252,UCBPlayer,130,275,405,25,40,UCBPlayer
16253,UCBPlayer,105,210,315,10,65,UCBPlayer
16254,UCBPlayer,131,271,402,25,41,UCBPlayer
16255,UCBPlayer,105,210,315,10,65,UCBPlayer
16256,UCBPlayer,130,275,405,25,40,UCBPlayer
16257,UCBPlayer,105,210,315,10,65,UCBPlayer
16258,UCBPlayer,130,275,405,25,40,UCBPlayer
16259,UCBPlayer,103,203,306,10,68,UCBPlayer
16260,UCBPlayer,128,283,411,25,38,UCBPlayer
16261,UCBPlayer,111,186,297,10,71,UCBPlayer
16262,UCBPlayer,124,299,423,25,34,UCBPlayer
16263,UCBPlayer,115,170,285,10,75,UCBPlayer
16264,UCBPlayer,120,315,435,25,30,UCBPlayer
16265,UCBPlayer,119,154,273,10,79,UCBPlayer
16266,UCBPlayer,112,332,444,25,27,UCBPlayer
16267,UCBPlayer,127,137,264,10,82,UCBPlayer
16268,UCBPlayer,104,349,453,25,24,UCBPlayer
16269,UCBPlayer,126,126,252,7,85,Tie
16270,UCBPlayer,111,351,462,28,22,UCBPlayer
16271,UCBPlayer,116,126,242,3,87,UCBPlayer
16272,UCBPlayer,122,347,469,32,21,UCBPlayer
16273,UCBPlayer,107,132,239,0,87,UCBPlayer
16274,UCBPlayer,132,337,469,35,22,UCBPlayer
16275,UCBPlayer,103,148,251,0,83,UCBPlayer
16276,UCBPlayer,136,321,457,35,26,UCBPlayer
16277,UCBPlayer,99,164,263,0,79,UCBPlayer
16278,UCBPlayer,140,305,445,35,30,UCBPlayer
16279,UCBPlayer,95,180,275,0,75,UCBPlayer
16280,UCBPlayer,144,289,433,35,34,UCBPlayer
16281,UCBPlayer,91,196,287,0,71,UCBPlayer
16282,UCBPlayer,148,273,421,35,38,UCBPlayer
16283,UCBPlayer,87,212,299,0,67,UCBPlayer
16284,UCBPlayer,152,257,409,35,42,UCBPlayer
16285,UCBPlayer,84,224,308,0,64,UCBPlayer
16286,UCBPlayer,146,251,397,32,45,UCBPlayer
16287,UCBPlayer,89,234,323,3,60,UCBPlayer
16288,UCBPlayer,138,243,381,28,49,UCBPlayer
16289,UCBPlayer,97,242,339,7,56,UCBPlayer
16290,UCBPlayer,130,235,365,24,53,UCBPlayer
16291,UCBPlayer,105,250,355,11,52,UCBPlayer
16292,UCBPlayer,122,227,349,20,57,UCBPlayer
16293,UCBPlayer,109,259,368,15,49,UCBPlayer
16294,UCBPlayer,118,218,336,16,60,UCBPlayer
16295,UCBPlayer,117,267,384,19,45,UCBPlayer
16296,UCBPlayer,110,210,320,12,64,UCBPlayer
16297,UCBPlayer,126,271,397,23,42,UCBPlayer
16298,UCBPlayer,105,210,315,10,65,UCBPlayer
16299,UCBPlayer,130,275,405,25,40,UCBPlayer
16300,UCBPlayer,105,210,315,10,65,UCBPlayer
16301,UCBPlayer,130,275,405,25,40,UCBPlayer
16302,UCBPlayer,106,206,312,10,66,UCBPlayer
16303,UCBPlayer,130,275,405,25,40,UCBPlayer
16304,UCBPlayer,105,210,315,10,65,UCBPlayer
16305,UCBPlayer,131,271,402,25,41,UCBPlayer
16306,UCBPlayer,105,210,315,10,65,UCBPlayer
16307,UCBPlayer,130,275,405,25,40,UCBPlayer
16308,UCBPlayer,105,210,315,10,65,UCBPlayer
16309,UCBPlayer,130,275,405,25,40,UCBPlayer
16310,UCBPlayer,103,203,306,10,68,UCBPlayer
16311,UCBPlayer,128,283,411,25,38,UCBPlayer
16312,UCBPlayer,111,186,297,10,71,UCBPlayer
16313,UCBPlayer,124,299,423,25,34,UCBPlayer
16314,UCBPlayer,115,170,285,10,75,UCBPlayer
16315,UCBPlayer,120,315,435,25,30,UCBPlayer
16316,UCBPlayer,119,154,273,10,79,UCBPlayer
16317,UCBPlayer,112,332,444,25,27,UCBPlayer
16318,UCBPlayer,127,137,264,10,82,UCBPlayer
16319,UCBPlayer,104,349,453,25,24,UCBPlayer
16320,UCBPlayer,126,126,252,7,85,Tie
16321,UCBPlayer,111,351,462,28,22,UCBPlayer
16322,UCBPlayer,116,126,242,3,87,UCBPlayer
16323,UCBPlayer,122,347,469,32,21,UCBPlayer
16324,UCBPlayer,107,132,239,0,87,UCBPlayer
16325,UCBPlayer,132,337,469,35,22,UCBPlayer
16326,UCBPlayer,103,148,251,0,83,UCBPlayer
16327,UCBPlayer,136,321,457,35,26,UCBPlayer
16328,UCBPlayer,99,164,263,0,79,UCBPlayer
16329,UCBPlayer,140,305,445,35,30,UCBPlayer
16330,UCBPlayer,95,180,275,0,75,UCBPlayer
16331,UCBPlayer,144,289,433,35,34,UCBPlayer
16332,UCBPlayer,91,196,287,0,71,UCBPlayer
16333,UCBPlayer,148,273,421,35,38,UCBPlayer
16334,UCBPlayer,87,212,299,0,67,UCBPlayer
16335,UCBPlayer,152,257,409,35,42,UCBPlayer
16336,UCBPlayer,84,224,308,0,64,UCBPlayer
16337,UCBPlayer,146,251,397,32,45,UCBPlayer
16338,UCBPlayer,89,234,323,3,60,UCBPlayer
16339,UCBPlayer,138,243,381,28,49,UCBPlayer
16340,UCBPlayer,97,242,339,7,56,UCBPlayer
16341,UCBPlayer,130,235,365,24,53,UCBPlayer
16342,UCBPlayer,105,250,355,11,52,UCBPlayer
16343,UCBPlayer,122,227,349,20,57,UCBPlayer
16344,UCBPlayer,109,259,368,15,49,UCBPlayer
16345,UCBPlayer,118,218,336,16,60,UCBPlayer
16346,UCBPlayer,117,267,384,19,45,UCBPlayer
16347,UCBPlayer,110,210,320,12,64,UCBPlayer
16348,UCBPlayer,126,271,397,23,42,UCBPlayer
16349,UCBPlayer,105,210,315,10,65,UCBPlayer
16350,UCBPlayer,130,275,405,25,40,UCBPlayer
16351,UCBPlayer,105,210,315,10,65,UCBPlayer
16352,UCBPlayer,130,275,405,25,40,UCBPlayer
16353,UCBPlayer,106,206,312,10,66,UCBPlayer
16354,UCBPlayer,130,275,405,25,40,UCBPlayer
16355,UCBPlayer,105,210,315,10,65,UCBPlayer
16356,UCBPlayer,131,271,402,25,41,UCBPlayer
16357,UCBPlayer,105,210,315,10,65,UCBPlayer
16358,UCBPlayer,130,275,405,25,40,UCBPlayer
16359,UCBPlayer,105,210,315,10,65,UCBPlayer
16360,UCBPlayer,130,275,405,25,40,UCBPlayer
16361,UCBPlayer,103,203,306,10,68,UCBPlayer
16362,UCBPlayer,128,283,411,25,38,UCBPlayer
16363,UCBPlayer,111,186,297,10,71,UCBPlayer
16364,UCBPlayer,124,299,423,25,34,UCBPlayer
16365,UCBPlayer,115,170,285,10,75,UCBPlayer
16366,UCBPlayer,120,315,435,25,30,UCBPlayer
16367,UCBPlayer,119,154,273,10,79,UCBPlayer
16368,UCBPlayer,112,332,444,25,27,UCBPlayer
16369,UCBPlayer,127,137,264,10,82,UCBPlayer
16370,UCBPlayer,104,349,453,25,24,UCBPlayer
16371,UCBPlayer,126,126,252,7,85,Tie
16372,UCBPlayer,111,351,462,28,22,UCBPlayer
16373,UCBPlayer,116,126,242,3,87,UCBPlayer
16374,UCBPlayer,122,347,469,32,21,UCBPlayer
16375,UCBPlayer,107,132,239,0,87,UCBPlayer
16376,UCBPlayer,132,337,469,35,22,UCBPlayer
16377,UCBPlayer,103,148,251,0,83,UCBPlayer
16378,UCBPlayer,136,321,457,35,26,UCBPlayer
16379,UCBPlayer,99,164,263,0,79,UCBPlayer
16380,UCBPlayer,140,305,445,35,30,UCBPlayer
16381,UCBPlayer,95,180,275,0,75,UCBPlayer
16382,UCBPlayer,144,289,433,35,34,UCBPlayer
16383,UCBPlayer,91,196,287,0,71,UCBPlayer
16384,UCBPlayer,148,273,421,35,38,UCBPlayer
16385,UCBPlayer,87,212,299,0,67,UCBPlayer
16386,UCBPlayer,152,257,409,35,42,UCBPlayer
16387,UCBPlayer,84,224,308,0,64,UCBPlayer
16388,UCBPlayer,146,251,397,32,45,UCBPlayer
16389,UCBPlayer,89,234,323,3,60,UCBPlayer
16390,UCBPlayer,138,243,381,28,49,UCBPlayer
16391,UCBPlayer,97,242,339,7,56,UCBPlayer
16392,UCBPlayer,130,235,365,24,53,UCBPlayer
16393,UCBPlayer,105,250,355,11,52,UCBPlayer
16394,UCBPlayer,122,227,349,20,57,UCBPlayer
16395,UCBPlayer,109,259,368,15,49,UCBPlayer
16396,UCBPlayer,118,218,336,16,60,UCBPlayer
16397,UCBPlayer,117,267,384,19,45,UCBPlayer
16398,UCBPlayer,110,210,320,12,64,UCBPlayer
16399,UCBPlayer,126,271,397,23,42,UCBPlayer
16400,UCBPlayer,105,210,315,10,65,UCBPlayer
16401,UCBPlayer,130,275,405,25,40,UCBPlayer
16402,UCBPlayer,105,210,315,10,65,UCBPlayer
16403,UCBPlayer,130,275,405,25,40,UCBPlayer
16404,UCBPlayer,106,206,312,10,66,UCBPlayer
16405,UCBPlayer,130,275,405,25,40,UCBPlayer
16406,UCBPlayer,105,210,315,10,65,UCBPlayer
16407,UCBPlayer,131,271,402,25,41,UCBPlayer
16408,UCBPlayer,105,210,315,10,65,UCBPlayer
16409,UCBPlayer,130,275,405,25,40,UCBPlayer
16410,UCBPlayer,105,210,315,10,65,UCBPlayer
16411,UCBPlayer,130,275,405,25,40,UCBPlayer
16412,UCBPlayer,103,203,306,10,68,UCBPlayer
16413,UCBPlayer,128,283,411,25,38,UCBPlayer
16414,UCBPlayer,111,186,297,10,71,UCBPlayer
16415,UCBPlayer,124,299,423,25,34,UCBPlayer
16416,UCBPlayer,115,170,285,10,75,UCBPlayer
16417,UCBPlayer,120,315,435,25,30,UCBPlayer
16418,UCBPlayer,119,154,273,10,79,UCBPlayer
16419,UCBPlayer,112,332,444,25,27,UCBPlayer
16420,UCBPlayer,127,137,264,10,82,UCBPlayer
16421,UCBPlayer,104,349,453,25,24,UCBPlayer
16422,UCBPlayer,126,126,252,7,85,Tie
16423,UCBPlayer,111,351,462,28,22,UCBPlayer
16424,UCBPlayer,116,126,242,3,87,UCBPlayer
16425,UCBPlayer,122,347,469,32,21,UCBPlayer
16426,UCBPlayer,107,132,239,0,87,UCBPlayer
16427,UCBPlayer,132,337,469,35,22,UCBPlayer
16428,UCBPlayer,103,148,251,0,83,UCBPlayer
16429,UCBPlayer,136,321,457,35,26,UCBPlayer
16430,UCBPlayer,99,164,263,0,79,UCBPlayer
16431,UCBPlayer,140,305,445,35,30,UCBPlayer
16432,UCBPlayer,95,180,275,0,75,UCBPlayer
16433,UCBPlayer,144,289,433,35,34,UCBPlayer
16434,UCBPlayer,91,196,287,0,71,UCBPlayer
16435,UCBPlayer,148,273,421,35,38,UCBPlayer
16436,UCBPlayer,87,212,299,0,67,UCBPlayer
16437,UCBPlayer,152,257,409,35,42,UCBPlayer
16438,UCBPlayer,84,224,308,0,64,UCBPlayer
16439,UCBPlayer,146,251,397,32,45,UCBPlayer
16440,UCBPlayer,89,234,323,3,60,UCBPlayer
16441,UCBPlayer,138,243,381,28,49,UCBPlayer
16442,UCBPlayer,97,242,339,7,56,UCBPlayer
16443,UCBPlayer,130,235,365,24,53,UCBPlayer
16444,UCBPlayer,105,250,355,11,52,UCBPlayer
16445,UCBPlayer,122,227,349,20,57,UCBPlayer
16446,UCBPlayer,109,259,368,15,49,UCBPlayer
16447,UCBPlayer,118,218,336,16,60,UCBPlayer
16448,UCBPlayer,117,267,384,19,45,UCBPlayer
16449,UCBPlayer,110,210,320,12,64,UCBPlayer
16450,UCBPlayer,126,271,397,23,42,UCBPlayer
16451,UCBPlayer,105,210,315,10,65,UCBPlayer
16452,UCBPlayer,130,275,405,25,40,UCBPlayer
16453,UCBPlayer,105,210,315,10,65,UCBPlayer
16454,UCBPlayer,130,275,405,25,40,UCBPlayer
16455,UCBPlayer,106,206,312,10,66,UCBPlayer
16456,UCBPlayer,130,275,405,25,40,UCBPlayer
16457,UCBPlayer,105,210,315,10,65,UCBPlayer
16458,UCBPlayer,131,271,402,25,41,UCBPlayer
16459,UCBPlayer,105,210,315,10,65,UCBPlayer
16460,UCBPlayer,130,275,405,25,40,UCBPlayer
16461,UCBPlayer,105,210,315,10,65,UCBPlayer
16462,UCBPlayer,130,275,405,25,40,UCBPlayer
16463,UCBPlayer,103,203,306,10,68,UCBPlayer
16464,UCBPlayer,128,283,411,25,38,UCBPlayer
16465,UCBPlayer,111,186,297,10,71,UCBPlayer
16466,UCBPlayer,124,299,423,25,34,UCBPlayer
16467,UCBPlayer,115,170,285,10,75,UCBPlayer
16468,UCBPlayer,120,315,435,25,30,UCBPlayer
16469,UCBPlayer,119,154,273,10,79,UCBPlayer
16470,UCBPlayer,112,332,444,25,27,UCBPlayer
16471,UCBPlayer,127,137,264,10,82,UCBPlayer
16472,UCBPlayer,104,349,453,25,24,UCBPlayer
16473,UCBPlayer,126,126,252,7,85,Tie
16474,UCBPlayer,111,351,462,28,22,UCBPlayer
16475,UCBPlayer,116,126,242,3,87,UCBPlayer
16476,UCBPlayer,122,347,469,32,21,UCBPlayer
16477,UCBPlayer,107,132,239,0,87,UCBPlayer
16478,UCBPlayer,132,337,469,35,22,UCBPlayer
16479,UCBPlayer,103,148,251,0,83,UCBPlayer
16480,UCBPlayer,136,321,457,35,26,UCBPlayer
16481,UCBPlayer,99,164,263,0,79,UCBPlayer
16482,UCBPlayer,140,305,445,35,30,UCBPlayer
16483,UCBPlayer,95,180,275,0,75,UCBPlayer
16484,UCBPlayer,144,289,433,35,34,UCBPlayer
16485,UCBPlayer,91,196,287,0,71,UCBPlayer
16486,UCBPlayer,148,273,421,35,38,UCBPlayer
16487,UCBPlayer,87,212,299,0,67,UCBPlayer
16488,UCBPlayer,152,257,409,35,42,UCBPlayer
16489,UCBPlayer,84,224,308,0,64,UCBPlayer
16490,UCBPlayer,146,251,397,32,45,UCBPlayer
16491,UCBPlayer,89,234,323,3,60,UCBPlayer
16492,UCBPlayer,138,243,381,28,49,UCBPlayer
16493,UCBPlayer,97,242,339,7,56,UCBPlayer
16494,UCBPlayer,130,235,365,24,53,UCBPlayer
16495,UCBPlayer,105,250,355,11,52,UCBPlayer
16496,UCBPlayer,122,227,349,20,57,UCBPlayer
16497,UCBPlayer,109,259,368,15,49,UCBPlayer
16498,UCBPlayer,118,218,336,16,60,UCBPlayer
16499,UCBPlayer,117,267,384,19,45,UCBPlayer
16500,UCBPlayer,110,210,320,12,64,UCBPlayer
16501,UCBPlayer,126,271,397,23,42,UCBPlayer
16502,UCBPlayer,105,210,315,10,65,UCBPlayer
16503,UCBPlayer,130,275,405,25,40,UCBPlayer
16504,UCBPlayer,105,210,315,10,65,UCBPlayer
16505,UCBPlayer,130,275,405,25,40,UCBPlayer
16506,UCBPlayer,106,206,312,10,66,UCBPlayer
16507,UCBPlayer,130,275,405,25,40,UCBPlayer
16508,UCBPlayer,105,210,315,10,65,UCBPlayer
16509,UCBPlayer,131,271,402,25,41,UCBPlayer
16510,UCBPlayer,105,210,315,10,65,UCBPlayer
16511,UCBPlayer,130,275,405,25,40,UCBPlayer
16512,UCBPlayer,105,210,315,10,65,UCBPlayer
16513,UCBPlayer,130,275,405,25,40,UCBPlayer
16514,UCBPlayer,103,203,306,10,68,UCBPlayer
16515,UCBPlayer,128,283,411,25,38,UCBPlayer
16516,UCBPlayer,111,186,297,10,71,UCBPlayer
16517,UCBPlayer,124,299,423,25,34,UCBPlayer
16518,UCBPlayer,115,170,285,10,75,UCBPlayer
16519,UCBPlayer,120,315,435,25,30,UCBPlayer
16520,UCBPlayer,119,154,273,10,79,UCBPlayer
16521,UCBPlayer,112,332,444,25,27,UCBPlayer
16522,UCBPlayer,127,137,264,10,82,UCBPlayer
16523,UCBPlayer,104,349,453,25,24,UCBPlayer
16524,UCBPlayer,126,126,252,7,85,Tie
16525,UCBPlayer,111,351,462,28,22,UCBPlayer
16526,UCBPlayer,116,126,242,3,87,UCBPlayer
16527,UCBPlayer,122,347,469,32,21,UCBPlayer
16528,UCBPlayer,107,132,239,0,87,UCBPlayer
16529,UCBPlayer,132,337,469,35,22,UCBPlayer
16530,UCBPlayer,103,148,251,0,83,UCBPlayer
16531,UCBPlayer,136,321,457,35,26,UCBPlayer
16532,UCBPlayer,99,164,263,0,79,UCBPlayer
16533,UCBPlayer,140,305,445,35,30,UCBPlayer
16534,UCBPlayer,95,180,275,0,75,UCBPlayer
16535,UCBPlayer,144,289,433,35,34,UCBPlayer
16536,UCBPlayer,91,196,287,0,71,UCBPlayer
16537,UCBPlayer,148,273,421,35,38,UCBPlayer
16538,UCBPlayer,87,212,299,0,67,UCBPlayer
16539,UCBPlayer,152,257,409,35,42,UCBPlayer
16540,UCBPlayer,84,224,308,0,64,UCBPlayer
16541,UCBPlayer,146,251,397,32,45,UCBPlayer
16542,UCBPlayer,89,234,323,3,60,UCBPlayer
16543,UCBPlayer,138,243,381,28,49,UCBPlayer
16544,UCBPlayer,97,242,339,7,56,UCBPlayer
16545,UCBPlayer,130,235,365,24,53,UCBPlayer
16546,UCBPlayer,105,250,355,11,52,UCBPlayer
16547,UCBPlayer,122,227,349,20,57,UCBPlayer
16548,UCBPlayer,109,259,368,15,49,UCBPlayer
16549,UCBPlayer,118,218,336,16,60,UCBPlayer
16550,UCBPlayer,117,267,384,19,45,UCBPlayer
16551,UCBPlayer,110,210,320,12,64,UCBPlayer
16552,UCBPlayer,126,271,397,23,42,UCBPlayer
16553,UCBPlayer,105,210,315,10,65,UCBPlayer
16554,UCBPlayer,130,275,405,25,40,UCBPlayer
16555,UCBPlayer,105,210,315,10,65,UCBPlayer
16556,UCBPlayer,130,275,405,25,40,UCBPlayer
16557,UCBPlayer,106,206,312,10,66,UCBPlayer
16558,UCBPlayer,130,275,405,25,40,UCBPlayer
16559,UCBPlayer,105,210,315,10,65,UCBPlayer
16560,UCBPlayer,131,271,402,25,41,UCBPlayer
16561,UCBPlayer,105,210,315,10,65,UCBPlayer
16562,UCBPlayer,130,275,405,25,40,UCBPlayer
16563,UCBPlayer,105,210,315,10,65,UCBPlayer
16564,UCBPlayer,130,275,405,25,40,UCBPlayer
16565,UCBPlayer,103,203,306,10,68,UCBPlayer
16566,UCBPlayer,128,283,411,25,38,UCBPlayer
16567,UCBPlayer,111,186,297,10,71,UCBPlayer
16568,UCBPlayer,124,299,423,25,34,UCBPlayer
16569,UCBPlayer,115,170,285,10,75,UCBPlayer
16570,UCBPlayer,120,315,435,25,30,UCBPlayer
16571,UCBPlayer,119,154,273,10,79,UCBPlayer
16572,UCBPlayer,112,332,444,25,27,UCBPlayer
16573,UCBPlayer,127,137,264,10,82,UCBPlayer
16574,UCBPlayer,104,349,453,25,24,UCBPlayer
16575,UCBPlayer,126,126,252,7,85,Tie
16576,UCBPlayer,111,351,462,28,22,UCBPlayer
16577,UCBPlayer,116,126,242,3,87,UCBPlayer
16578,UCBPlayer,122,347,469,32,21,UCBPlayer
16579,UCBPlayer,107,132,239,0,87,UCBPlayer
16580,UCBPlayer,132,337,469,35,22,UCBPlayer
16581,UCBPlayer,103,148,251,0,83,UCBPlayer
16582,UCBPlayer,136,321,457,35,26,UCBPlayer
16583,UCBPlayer,99,164,263,0,79,UCBPlayer
16584,UCBPlayer,140,305,445,35,30,UCBPlayer
16585,UCBPlayer,95,180,275,0,75,UCBPlayer
16586,UCBPlayer,144,289,433,35,34,UCBPlayer
16587,UCBPlayer,91,196,287,0,71,UCBPlayer
16588,UCBPlayer,148,273,421,35,38,UCBPlayer
16589,UCBPlayer,87,212,299,0,67,UCBPlayer
16590,UCBPlayer,152,257,409,35,42,UCBPlayer
16591,UCBPlayer,84,224,308,0,64,UCBPlayer
16592,UCBPlayer,146,251,397,32,45,UCBPlayer
16593,UCBPlayer,89,234,323,3,60,UCBPlayer
16594,UCBPlayer,138,243,381,28,49,UCBPlayer
16595,UCBPlayer,97,242,339,7,56,UCBPlayer
16596,UCBPlayer,130,235,365,24,53,UCBPlayer
16597,UCBPlayer,105,250,355,11,52,UCBPlayer
16598,UCBPlayer,122,227,349,20,57,UCBPlayer
16599,UCBPlayer,109,259,368,15,49,UCBPlayer
16600,UCBPlayer,118,218,336,16,60,UCBPlayer
16601,UCBPlayer,117,267,384,19,45,UCBPlayer
16602,UCBPlayer,110,210,320,12,64,UCBPlayer
16603,UCBPlayer,126,271,397,23,42,UCBPlayer
16604,UCBPlayer,105,210,315,10,65,UCBPlayer
16605,UCBPlayer,130,275,405,25,40,UCBPlayer
16606,UCBPlayer,105,210,315,10,65,UCBPlayer
16607,UCBPlayer,130,275,405,25,40,UCBPlayer
16608,UCBPlayer,106,206,312,10,66,UCBPlayer
16609,UCBPlayer,130,275,405,25,40,UCBPlayer
16610,UCBPlayer,105,210,315,10,65,UCBPlayer
16611,UCBPlayer,131,271,402,25,41,UCBPlayer
16612,UCBPlayer,105,210,315,10,65,UCBPlayer
16613,UCBPlayer,130,275,405,25,40,UCBPlayer
16614,UCBPlayer,105,210,315,10,65,UCBPlayer
16615,UCBPlayer,130,275,405,25,40,UCBPlayer
16616,UCBPlayer,103,203,306,10,68,UCBPlayer
16617,UCBPlayer,128,283,411,25,38,UCBPlayer
16618,UCBPlayer,111,186,297,10,71,UCBPlayer
16619,UCBPlayer,124,299,423,25,34,UCBPlayer
16620,UCBPlayer,115,170,285,10,75,UCBPlayer
16621,UCBPlayer,120,315,435,25,30,UCBPlayer
16622,UCBPlayer,119,154,273,10,79,UCBPlayer
16623,UCBPlayer,112,332,444,25,27,UCBPlayer
16624,UCBPlayer,127,137,264,10,82,UCBPlayer
16625,UCBPlayer,104,349,453,25,24,UCBPlayer
16626,UCBPlayer,126,126,252,7,85,Tie
16627,UCBPlayer,111,351,462,28,22,UCBPlayer
16628,UCBPlayer,116,126,242,3,87,UCBPlayer
16629,UCBPlayer,122,347,469,32,21,UCBPlayer
16630,UCBPlayer,107,132,239,0,87,UCBPlayer
16631,UCBPlayer,132,337,469,35,22,UCBPlayer
16632,UCBPlayer,103,148,251,0,83,UCBPlayer
16633,UCBPlayer,136,321,457,35,26,UCBPlayer
16634,UCBPlayer,99,164,263,0,79,UCBPlayer
16635,UCBPlayer,140,305,445,35,30,UCBPlayer
16636,UCBPlayer,95,180,275,0,75,UCBPlayer
16637,UCBPlayer,144,289,433,35,34,UCBPlayer
16638,UCBPlayer,91,196,287,0,71,UCBPlayer
16639,UCBPlayer,148,273,421,35,38,UCBPlayer
16640,UCBPlayer,87,212,299,0,67,UCBPlayer
16641,UCBPlayer,152,257,409,35,42,UCBPlayer
16642,UCBPlayer,84,224,308,0,64,UCBPlayer
16643,UCBPlayer,146,251,397,32,45,UCBPlayer
16644,UCBPlayer,89,234,323,3,60,UCBPlayer
16645,UCBPlayer,138,243,381,28,49,UCBPlayer
16646,UCBPlayer,97,242,339,7,56,UCBPlayer
16647,UCBPlayer,130,235,365,24,53,UCBPlayer
16648,UCBPlayer,105,250,355,11,52,UCBPlayer
16649,UCBPlayer,122,227,349,20,57,UCBPlayer
16650,UCBPlayer,109,259,368,15,49,UCBPlayer
16651,UCBPlayer,118,218,336,16,60,UCBPlayer
16652,UCBPlayer,117,267,384,19,45,UCBPlayer
16653,UCBPlayer,110,210,320,12,64,UCBPlayer
16654,UCBPlayer,126,271,397,23,42,UCBPlayer
16655,UCBPlayer,105,210,315,10,65,UCBPlayer
16656,UCBPlayer,130,275,405,25,40,UCBPlayer
16657,UCBPlayer,105,210,315,10,65,UCBPlayer
16658,UCBPlayer,130,275,405,25,40,UCBPlayer
16659,UCBPlayer,106,206,312,10,66,UCBPlayer
16660,UCBPlayer,130,275,405,25,40,UCBPlayer
16661,UCBPlayer,105,210,315,10,65,UCBPlayer
16662,UCBPlayer,131,271,402,25,41,UCBPlayer
16663,UCBPlayer,105,210,315,10,65,UCBPlayer
16664,UCBPlayer,130,275,405,25,40,UCBPlayer
16665,UCBPlayer,105,210,315,10,65,UCBPlayer
16666,UCBPlayer,130,275,405,25,40,UCBPlayer
16667,UCBPlayer,103,203,306,10,68,UCBPlayer
16668,UCBPlayer,128,283,411,25,38,UCBPlayer
16669,UCBPlayer,111,186,297,10,71,UCBPlayer
16670,UCBPlayer,124,299,423,25,34,UCBPlayer
16671,UCBPlayer,115,170,285,10,75,UCBPlayer
16672,UCBPlayer,120,315,435,25,30,UCBPlayer
16673,UCBPlayer,119,154,273,10,79,UCBPlayer
16674,UCBPlayer,112,332,444,25,27,UCBPlayer
16675,UCBPlayer,127,137,264,10,82,UCBPlayer
16676,UCBPlayer,104,349,453,25,24,UCBPlayer
16677,UCBPlayer,126,126,252,7,85,Tie
16678,UCBPlayer,111,351,462,28,22,UCBPlayer
16679,UCBPlayer,116,126,242,3,87,UCBPlayer
16680,UCBPlayer,122,347,469,32,21,UCBPlayer
16681,UCBPlayer,107,132,239,0,87,UCBPlayer
16682,UCBPlayer,132,337,469,35,22,UCBPlayer
16683,UCBPlayer,103,148,251,0,83,UCBPlayer
16684,UCBPlayer,136,321,457,35,26,UCBPlayer
16685,UCBPlayer,99,164,263,0,79,UCBPlayer
16686,UCBPlayer,140,305,445,35,30,UCBPlayer
16687,UCBPlayer,95,180,275,0,75,UCBPlayer
16688,UCBPlayer,144,289,433,35,34,UCBPlayer
16689,UCBPlayer,91,196,287,0,71,UCBPlayer
16690,UCBPlayer,148,273,421,35,38,UCBPlayer
16691,UCBPlayer,87,212,299,0,67,UCBPlayer
16692,UCBPlayer,152,257,409,35,42,UCBPlayer
16693,UCBPlayer,84,224,308,0,64,UCBPlayer
16694,UCBPlayer,146,251,397,32,45,UCBPlayer
16695,UCBPlayer,89,234,323,3,60,UCBPlayer
16696,UCBPlayer,138,243,381,28,49,UCBPlayer
16697,UCBPlayer,97,242,339,7,56,UCBPlayer
16698,UCBPlayer,130,235,365,24,53,UCBPlayer
16699,UCBPlayer,105,250,355,11,52,UCBPlayer
16700,UCBPlayer,122,227,349,20,57,UCBPlayer
16701,UCBPlayer,109,259,368,15,49,UCBPlayer
16702,UCBPlayer,118,218,336,16,60,UCBPlayer
16703,UCBPlayer,117,267,384,19,45,UCBPlayer
16704,UCBPlayer,110,210,320,12,64,UCBPlayer
16705,UCBPlayer,126,271,397,23,42,UCBPlayer
16706,UCBPlayer,105,210,315,10,65,UCBPlayer
16707,UCBPlayer,130,275,405,25,40,UCBPlayer
16708,UCBPlayer,105,210,315,10,65,UCBPlayer
16709,UCBPlayer,130,275,405,25,40,UCBPlayer
16710,UCBPlayer,106,206,312,10,66,UCBPlayer
16711,UCBPlayer,130,275,405,25,40,UCBPlayer
16712,UCBPlayer,105,210,315,10,65,UCBPlayer
16713,UCBPlayer,131,271,402,25,41,UCBPlayer
16714,UCBPlayer,105,210,315,10,65,UCBPlayer
16715,UCBPlayer,130,275,405,25,40,UCBPlayer
16716,UCBPlayer,105,210,315,10,65,UCBPlayer
16717,UCBPlayer,130,275,405,25,40,UCBPlayer
16718,UCBPlayer,103,203,306,10,68,UCBPlayer
16719,UCBPlayer,128,283,411,25,38,UCBPlayer
16720,UCBPlayer,111,186,297,10,71,UCBPlayer
16721,UCBPlayer,124,299,423,25,34,UCBPlayer
16722,UCBPlayer,115,170,285,10,75,UCBPlayer
16723,UCBPlayer,120,315,435,25,30,UCBPlayer
16724,UCBPlayer,119,154,273,10,79,UCBPlayer
16725,UCBPlayer,112,332,444,25,27,UCBPlayer
16726,UCBPlayer,127,137,264,10,82,UCBPlayer
16727,UCBPlayer,104,349,453,25,24,UCBPlayer
16728,UCBPlayer,126,126,252,7,85,Tie
16729,UCBPlayer,111,351,462,28,22,UCBPlayer
16730,UCBPlayer,116,126,242,3,87,UCBPlayer
16731,UCBPlayer,122,347,469,32,21,UCBPlayer
16732,UCBPlayer,107,132,239,0,87,UCBPlayer
16733,UCBPlayer,132,337,469,35,22,UCBPlayer
16734,UCBPlayer,103,148,251,0,83,UCBPlayer
16735,UCBPlayer,136,321,457,35,26,UCBPlayer
16736,UCBPlayer,99,164,263,0,79,UCBPlayer
16737,UCBPlayer,140,305,445,35,30,UCBPlayer
16738,UCBPlayer,95,180,275,0,75,UCBPlayer
16739,UCBPlayer,144,289,433,35,34,UCBPlayer
16740,UCBPlayer,91,196,287,0,71,UCBPlayer
16741,UCBPlayer,148,273,421,35,38,UCBPlayer
16742,UCBPlayer,87,212,299,0,67,UCBPlayer
16743,UCBPlayer,152,257,409,35,42,UCBPlayer
16744,UCBPlayer,84,224,308,0,64,UCBPlayer
16745,UCBPlayer,146,251,397,32,45,UCBPlayer
16746,UCBPlayer,89,234,323,3,60,UCBPlayer
16747,UCBPlayer,138,243,381,28,49,UCBPlayer
16748,UCBPlayer,97,242,339,7,56,UCBPlayer
16749,UCBPlayer,130,235,365,24,53,UCBPlayer
16750,UCBPlayer,105,250,355,11,52,UCBPlayer
16751,UCBPlayer,122,227,349,20,57,UCBPlayer
16752,UCBPlayer,109,259,368,15,49,UCBPlayer
16753,UCBPlayer,118,218,336,16,60,UCBPlayer
16754,UCBPlayer,117,267,384,19,45,UCBPlayer
16755,UCBPlayer,110,210,320,12,64,UCBPlayer
16756,UCBPlayer,126,271,397,23,42,UCBPlayer
16757,UCBPlayer,105,210,315,10,65,UCBPlayer
16758,UCBPlayer,130,275,405,25,40,UCBPlayer
16759,UCBPlayer,105,210,315,10,65,UCBPlayer
16760,UCBPlayer,130,275,405,25,40,UCBPlayer
16761,UCBPlayer,106,206,312,10,66,UCBPlayer
16762,UCBPlayer,130,275,405,25,40,UCBPlayer
16763,UCBPlayer,105,210,315,10,65,UCBPlayer
16764,UCBPlayer,131,271,402,25,41,UCBPlayer
16765,UCBPlayer,105,210,315,10,65,UCBPlayer
16766,UCBPlayer,130,275,405,25,40,UCBPlayer
16767,UCBPlayer,105,210,315,10,65,UCBPlayer
16768,UCBPlayer,130,275,405,25,40,UCBPlayer
16769,UCBPlayer,103,203,306,10,68,UCBPlayer
16770,UCBPlayer,128,283,411,25,38,UCBPlayer
16771,UCBPlayer,111,186,297,10,71,UCBPlayer
16772,UCBPlayer,124,299,423,25,34,UCBPlayer
16773,UCBPlayer,115,170,285,10,75,UCBPlayer
16774,UCBPlayer,120,315,435,25,30,UCBPlayer
16775,UCBPlayer,119,154,273,10,79,UCBPlayer
16776,UCBPlayer,112,332,444,25,27,UCBPlayer
16777,UCBPlayer,127,137,264,10,82,UCBPlayer
16778,UCBPlayer,104,349,453,25,24,UCBPlayer
16779,UCBPlayer,126,126,252,7,85,Tie
16780,UCBPlayer,111,351,462,28,22,UCBPlayer
16781,UCBPlayer,116,126,242,3,87,UCBPlayer
16782,UCBPlayer,122,347,469,32,21,UCBPlayer
16783,UCBPlayer,107,132,239,0,87,UCBPlayer
16784,UCBPlayer,132,337,469,35,22,UCBPlayer
16785,UCBPlayer,103,148,251,0,83,UCBPlayer
16786,UCBPlayer,136,321,457,35,26,UCBPlayer
16787,UCBPlayer,99,164,263,0,79,UCBPlayer
16788,UCBPlayer,140,305,445,35,30,UCBPlayer
16789,UCBPlayer,95,180,275,0,75,UCBPlayer
16790,UCBPlayer,144,289,433,35,34,UCBPlayer
16791,UCBPlayer,91,196,287,0,71,UCBPlayer
16792,UCBPlayer,148,273,421,35,38,UCBPlayer
16793,UCBPlayer,87,212,299,0,67,UCBPlayer
16794,UCBPlayer,152,257,409,35,42,UCBPlayer
16795,UCBPlayer,84,224,308,0,64,UCBPlayer
16796,UCBPlayer,146,251,397,32,45,UCBPlayer
16797,UCBPlayer,89,234,323,3,60,UCBPlayer
16798,UCBPlayer,138,243,381,28,49,UCBPlayer
16799,UCBPlayer,97,242,339,7,56,UCBPlayer
16800,UCBPlayer,130,235,365,24,53,UCBPlayer
16801,UCBPlayer,105,250,355,11,52,UCBPlayer
16802,UCBPlayer,122,227,349,20,57,UCBPlayer
16803,UCBPlayer,109,259,368,15,49,UCBPlayer
16804,UCBPlayer,118,218,336,16,60,UCBPlayer
16805,UCBPlayer,117,267,384,19,45,UCBPlayer
16806,UCBPlayer,110,210,320,12,64,UCBPlayer
16807,UCBPlayer,126,271,397,23,42,UCBPlayer
16808,UCBPlayer,105,210,315,10,65,UCBPlayer
16809,UCBPlayer,130,275,405,25,40,UCBPlayer
16810,UCBPlayer,105,210,315,10,65,UCBPlayer
16811,UCBPlayer,130,275,405,25,40,UCBPlayer
16812,UCBPlayer,106,206,312,10,66,UCBPlayer
16813,UCBPlayer,130,275,405,25,40,UCBPlayer
16814,UCBPlayer,105,210,315,10,65,UCBPlayer
16815,UCBPlayer,131,271,402,25,41,UCBPlayer
16816,UCBPlayer,105,210,315,10,65,UCBPlayer
16817,UCBPlayer,130,275,405,25,40,UCBPlayer
16818,UCBPlayer,105,210,315,10,65,UCBPlayer
16819,UCBPlayer,130,275,405,25,40,UCBPlayer
16820,UCBPlayer,103,203,306,10,68,UCBPlayer
16821,UCBPlayer,128,283,411,25,38,UCBPlayer
16822,UCBPlayer,111,186,297,10,71,UCBPlayer
16823,UCBPlayer,124,299,423,25,34,UCBPlayer
16824,UCBPlayer,115,170,285,10,75,UCBPlayer
16825,UCBPlayer,120,315,435,25,30,UCBPlayer
16826,UCBPlayer,119,154,273,10,79,UCBPlayer
16827,UCBPlayer,112,332,444,25,27,UCBPlayer
16828,UCBPlayer,127,137,264,10,82,UCBPlayer
16829,UCBPlayer,104,349,453,25,24,UCBPlayer
16830,UCBPlayer,126,126,252,7,85,Tie
16831,UCBPlayer,111,351,462,28,22,UCBPlayer
16832,UCBPlayer,116,126,242,3,87,UCBPlayer
16833,UCBPlayer,122,347,469,32,21,UCBPlayer
16834,UCBPlayer,107,132,239,0,87,UCBPlayer
16835,UCBPlayer,132,337,469,35,22,UCBPlayer
16836,UCBPlayer,103,148,251,0,83,UCBPlayer
16837,UCBPlayer,136,321,457,35,26,UCBPlayer
16838,UCBPlayer,99,164,263,0,79,UCBPlayer
16839,UCBPlayer,140,305,445,35,30,UCBPlayer
16840,UCBPlayer,95,180,275,0,75,UCBPlayer
16841,UCBPlayer,144,289,433,35,34,UCBPlayer
16842,UCBPlayer,91,196,287,0,71,UCBPlayer
16843,UCBPlayer,148,273,421,35,38,UCBPlayer
16844,UCBPlayer,87,212,299,0,67,UCBPlayer
16845,UCBPlayer,152,257,409,35,42,UCBPlayer
16846,UCBPlayer,84,224,308,0,64,UCBPlayer
16847,UCBPlayer,146,251,397,32,45,UCBPlayer
16848,UCBPlayer,89,234,323,3,60,UCBPlayer
16849,UCBPlayer,138,243,381,28,49,UCBPlayer
16850,UCBPlayer,97,242,339,7,56,UCBPlayer
16851,UCBPlayer,130,235,365,24,53,UCBPlayer
16852,UCBPlayer,105,250,355,11,52,UCBPlayer
16853,UCBPlayer,122,227,349,20,57,UCBPlayer
16854,UCBPlayer,109,259,368,15,49,UCBPlayer
16855,UCBPlayer,118,218,336,16,60,UCBPlayer
16856,UCBPlayer,117,267,384,19,45,UCBPlayer
16857,UCBPlayer,110,210,320,12,64,UCBPlayer
16858,UCBPlayer,126,271,397,23,42,UCBPlayer
16859,UCBPlayer,105,210,315,10,65,UCBPlayer
16860,UCBPlayer,130,275,405,25,40,UCBPlayer
16861,UCBPlayer,105,210,315,10,65,UCBPlayer
16862,UCBPlayer,130,275,405,25,40,UCBPlayer
16863,UCBPlayer,106,206,312,10,66,UCBPlayer
16864,UCBPlayer,130,275,405,25,40,UCBPlayer
16865,UCBPlayer,105,210,315,10,65,UCBPlayer
16866,UCBPlayer,131,271,402,25,41,UCBPlayer
16867,UCBPlayer,105,210,315,10,65,UCBPlayer
16868,UCBPlayer,130,275,405,25,40,UCBPlayer
16869,UCBPlayer,105,210,315,10,65,UCBPlayer
16870,UCBPlayer,130,275,405,25,40,UCBPlayer
16871,UCBPlayer,103,203,306,10,68,UCBPlayer
16872,UCBPlayer,128,283,411,25,38,UCBPlayer
16873,UCBPlayer,111,186,297,10,71,UCBPlayer
16874,UCBPlayer,124,299,423,25,34,UCBPlayer
16875,UCBPlayer,115,170,285,10,75,UCBPlayer
16876,UCBPlayer,120,315,435,25,30,UCBPlayer
16877,UCBPlayer,119,154,273,10,79,UCBPlayer
16878,UCBPlayer,112,332,444,25,27,UCBPlayer
16879,UCBPlayer,127,137,264,10,82,UCBPlayer
16880,UCBPlayer,104,349,453,25,24,UCBPlayer
16881,UCBPlayer,126,126,252,7,85,Tie
16882,UCBPlayer,111,351,462,28,22,UCBPlayer
16883,UCBPlayer,116,126,242,3,87,UCBPlayer
16884,UCBPlayer,122,347,469,32,21,UCBPlayer
16885,UCBPlayer,107,132,239,0,87,UCBPlayer
16886,UCBPlayer,132,337,469,35,22,UCBPlayer
16887,UCBPlayer,103,148,251,0,83,UCBPlayer
16888,UCBPlayer,136,321,457,35,26,UCBPlayer
16889,UCBPlayer,99,164,263,0,79,UCBPlayer
16890,UCBPlayer,140,305,445,35,30,UCBPlayer
16891,UCBPlayer,95,180,275,0,75,UCBPlayer
16892,UCBPlayer,144,289,433,35,34,UCBPlayer
16893,UCBPlayer,91,196,287,0,71,UCBPlayer
16894,UCBPlayer,148,273,421,35,38,UCBPlayer
16895,UCBPlayer,87,212,299,0,67,UCBPlayer
16896,UCBPlayer,152,257,409,35,42,UCBPlayer
16897,UCBPlayer,84,224,308,0,64,UCBPlayer
16898,UCBPlayer,146,251,397,32,45,UCBPlayer
16899,UCBPlayer,89,234,323,3,60,UCBPlayer
16900,UCBPlayer,138,243,381,28,49,UCBPlayer
16901,UCBPlayer,97,242,339,7,56,UCBPlayer
16902,UCBPlayer,130,235,365,24,53,UCBPlayer
16903,UCBPlayer,105,250,355,11,52,UCBPlayer
16904,UCBPlayer,122,227,349,20,57,UCBPlayer
16905,UCBPlayer,109,259,368,15,49,UCBPlayer
16906,UCBPlayer,118,218,336,16,60,UCBPlayer
16907,UCBPlayer,117,267,384,19,45,UCBPlayer
16908,UCBPlayer,110,210,320,12,64,UCBPlayer
16909,UCBPlayer,126,271,397,23,42,UCBPlayer
16910,UCBPlayer,105,210,315,10,65,UCBPlayer
16911,UCBPlayer,130,275,405,25,40,UCBPlayer
16912,UCBPlayer,105,210,315,10,65,UCBPlayer
16913,UCBPlayer,130,275,405,25,40,UCBPlayer
16914,UCBPlayer,106,206,312,10,66,UCBPlayer
16915,UCBPlayer,130,275,405,25,40,UCBPlayer
16916,UCBPlayer,105,210,315,10,65,UCBPlayer
16917,UCBPlayer,131,271,402,25,41,UCBPlayer
16918,UCBPlayer,105,210,315,10,65,UCBPlayer
16919,UCBPlayer,130,275,405,25,40,UCBPlayer
16920,UCBPlayer,105,210,315,10,65,UCBPlayer
16921,UCBPlayer,130,275,405,25,40,UCBPlayer
16922,UCBPlayer,103,203,306,10,68,UCBPlayer
16923,UCBPlayer,128,283,411,25,38,UCBPlayer
16924,UCBPlayer,111,186,297,10,71,UCBPlayer
16925,UCBPlayer,124,299,423,25,34,UCBPlayer
16926,UCBPlayer,115,170,285,10,75,UCBPlayer
16927,UCBPlayer,120,315,435,25,30,UCBPlayer
16928,UCBPlayer,119,154,273,10,79,UCBPlayer
16929,UCBPlayer,112,332,444,25,27,UCBPlayer
16930,UCBPlayer,127,137,264,10,82,UCBPlayer
16931,UCBPlayer,104,349,453,25,24,UCBPlayer
16932,UCBPlayer,126,126,252,7,85,Tie
16933,UCBPlayer,111,351,462,28,22,UCBPlayer
16934,UCBPlayer,116,126,242,3,87,UCBPlayer
16935,UCBPlayer,122,347,469,32,21,UCBPlayer
16936,UCBPlayer,107,132,239,0,87,UCBPlayer
16937,UCBPlayer,132,337,469,35,22,UCBPlayer
16938,UCBPlayer,103,148,251,0,83,UCBPlayer
16939,UCBPlayer,136,321,457,35,26,UCBPlayer
16940,UCBPlayer,99,164,263,0,79,UCBPlayer
16941,UCBPlayer,140,305,445,35,30,UCBPlayer
16942,UCBPlayer,95,180,275,0,75,UCBPlayer
16943,UCBPlayer,144,289,433,35,34,UCBPlayer
16944,UCBPlayer,91,196,287,0,71,UCBPlayer
16945,UCBPlayer,148,273,421,35,38,UCBPlayer
16946,UCBPlayer,87,212,299,0,67,UCBPlayer
16947,UCBPlayer,152,257,409,35,42,UCBPlayer
16948,UCBPlayer,84,224,308,0,64,UCBPlayer
16949,UCBPlayer,146,251,397,32,45,UCBPlayer
16950,UCBPlayer,89,234,323,3,60,UCBPlayer
16951,UCBPlayer,138,243,381,28,49,UCBPlayer
16952,UCBPlayer,97,242,339,7,56,UCBPlayer
16953,UCBPlayer,130,235,365,24,53,UCBPlayer
16954,UCBPlayer,105,250,355,11,52,UCBPlayer
16955,UCBPlayer,122,227,349,20,57,UCBPlayer
16956,UCBPlayer,109,259,368,15,49,UCBPlayer
16957,UCBPlayer,118,218,336,16,60,UCBPlayer
16958,UCBPlayer,117,267,384,19,45,UCBPlayer
16959,UCBPlayer,110,210,320,12,64,UCBPlayer
16960,UCBPlayer,126,271,397,23,42,UCBPlayer
16961,UCBPlayer,105,210,315,10,65,UCBPlayer
16962,UCBPlayer,130,275,405,25,40,UCBPlayer
16963,UCBPlayer,105,210,315,10,65,UCBPlayer
16964,UCBPlayer,130,275,405,25,40,UCBPlayer
16965,UCBPlayer,106,206,312,10,66,UCBPlayer
16966,UCBPlayer,130,275,405,25,40,UCBPlayer
16967,UCBPlayer,105,210,315,10,65,UCBPlayer
16968,UCBPlayer,131,271,402,25,41,UCBPlayer
16969,UCBPlayer,105,210,315,10,65,UCBPlayer
16970,UCBPlayer,130,275,405,25,40,UCBPlayer
16971,UCBPlayer,105,210,315,10,65,UCBPlayer
16972,UCBPlayer,130,275,405,25,40,UCBPlayer
16973,UCBPlayer,103,203,306,10,68,UCBPlayer
16974,UCBPlayer,128,283,411,25,38,UCBPlayer
16975,UCBPlayer,111,186,297,10,71,UCBPlayer
16976,UCBPlayer,124,299,423,25,34,UCBPlayer
16977,UCBPlayer,115,170,285,10,75,UCBPlayer
16978,UCBPlayer,120,315,435,25,30,UCBPlayer
16979,UCBPlayer,119,154,273,10,79,UCBPlayer
16980,UCBPlayer,112,332,444,25,27,UCBPlayer
16981,UCBPlayer,127,137,264,10,82,UCBPlayer
16982,UCBPlayer,104,349,453,25,24,UCBPlayer
16983,UCBPlayer,126,126,252,7,85,Tie
16984,UCBPlayer,111,351,462,28,22,UCBPlayer
16985,UCBPlayer,116,126,242,3,87,UCBPlayer
16986,UCBPlayer,122,347,469,32,21,UCBPlayer
16987,UCBPlayer,107,132,239,0,87,UCBPlayer
16988,UCBPlayer,132,337,469,35,22,UCBPlayer
16989,UCBPlayer,103,148,251,0,83,UCBPlayer
16990,UCBPlayer,136,321,457,35,26,UCBPlayer
16991,UCBPlayer,99,164,263,0,79,UCBPlayer
16992,UCBPlayer,140,305,445,35,30,UCBPlayer
16993,UCBPlayer,95,180,275,0,75,UCBPlayer
16994,UCBPlayer,144,289,433,35,34,UCBPlayer
16995,UCBPlayer,91,196,287,0,71,UCBPlayer
16996,UCBPlayer,148,273,421,35,38,UCBPlayer
16997,UCBPlayer,87,212,299,0,67,UCBPlayer
16998,UCBPlayer,152,257,409,35,42,UCBPlayer
16999,UCBPlayer,84,224,308,0,64,UCBPlayer
17000,UCBPlayer,146,251,397,32,45,UCBPlayer
17001,UCBPlayer,89,234,323,3,60,UCBPlayer
17002,UCBPlayer,138,243,381,28,49,UCBPlayer
17003,UCBPlayer,97,242,339,7,56,UCBPlayer
17004,UCBPlayer,130,235,365,24,53,UCBPlayer
17005,UCBPlayer,105,250,355,11,52,UCBPlayer
17006,UCBPlayer,122,227,349,20,57,UCBPlayer
17007,UCBPlayer,109,259,368,15,49,UCBPlayer
17008,UCBPlayer,118,218,336,16,60,UCBPlayer
17009,UCBPlayer,117,267,384,19,45,UCBPlayer
17010,UCBPlayer,110,210,320,12,64,UCBPlayer
17011,UCBPlayer,126,271,397,23,42,UCBPlayer
17012,UCBPlayer,105,210,315,10,65,UCBPlayer
17013,UCBPlayer,130,275,405,25,40,UCBPlayer
17014,UCBPlayer,105,210,315,10,65,UCBPlayer
17015,UCBPlayer,130,275,405,25,40,UCBPlayer
17016,UCBPlayer,106,206,312,10,66,UCBPlayer
17017,UCBPlayer,130,275,405,25,40,UCBPlayer
17018,UCBPlayer,105,210,315,10,65,UCBPlayer
17019,UCBPlayer,131,271,402,25,41,UCBPlayer
17020,UCBPlayer,105,210,315,10,65,UCBPlayer
17021,UCBPlayer,130,275,405,25,40,UCBPlayer
17022,UCBPlayer,105,210,315,10,65,UCBPlayer
17023,UCBPlayer,130,275,405,25,40,UCBPlayer
17024,UCBPlayer,103,203,306,10,68,UCBPlayer
17025,UCBPlayer,128,283,411,25,38,UCBPlayer
17026,UCBPlayer,111,186,297,10,71,UCBPlayer
17027,UCBPlayer,124,299,423,25,34,UCBPlayer
17028,UCBPlayer,115,170,285,10,75,UCBPlayer
17029,UCBPlayer,120,315,435,25,30,UCBPlayer
17030,UCBPlayer,119,154,273,10,79,UCBPlayer
17031,UCBPlayer,112,332,444,25,27,UCBPlayer
17032,UCBPlayer,127,137,264,10,82,UCBPlayer
17033,UCBPlayer,104,349,453,25,24,UCBPlayer
17034,UCBPlayer,126,126,252,7,85,Tie
17035,UCBPlayer,111,351,462,28,22,UCBPlayer
17036,UCBPlayer,116,126,242,3,87,UCBPlayer
17037,UCBPlayer,122,347,469,32,21,UCBPlayer
17038,UCBPlayer,107,132,239,0,87,UCBPlayer
17039,UCBPlayer,132,337,469,35,22,UCBPlayer
17040,UCBPlayer,103,148,251,0,83,UCBPlayer
17041,UCBPlayer,136,321,457,35,26,UCBPlayer
17042,UCBPlayer,99,164,263,0,79,UCBPlayer
17043,UCBPlayer,140,305,445,35,30,UCBPlayer
17044,UCBPlayer,95,180,275,0,75,UCBPlayer
17045,UCBPlayer,144,289,433,35,34,UCBPlayer
17046,UCBPlayer,91,196,287,0,71,UCBPlayer
17047,UCBPlayer,148,273,421,35,38,UCBPlayer
17048,UCBPlayer,87,212,299,0,67,UCBPlayer
17049,UCBPlayer,152,257,409,35,42,UCBPlayer
17050,UCBPlayer,84,224,308,0,64,UCBPlayer
17051,UCBPlayer,146,251,397,32,45,UCBPlayer
17052,UCBPlayer,89,234,323,3,60,UCBPlayer
17053,UCBPlayer,138,243,381,28,49,UCBPlayer
17054,UCBPlayer,97,242,339,7,56,UCBPlayer
17055,UCBPlayer,130,235,365,24,53,UCBPlayer
17056,UCBPlayer,105,250,355,11,52,UCBPlayer
17057,UCBPlayer,122,227,349,20,57,UCBPlayer
17058,UCBPlayer,109,259,368,15,49,UCBPlayer
17059,UCBPlayer,118,218,336,16,60,UCBPlayer
17060,UCBPlayer,117,267,384,19,45,UCBPlayer
17061,UCBPlayer,110,210,320,12,64,UCBPlayer
17062,UCBPlayer,126,271,397,23,42,UCBPlayer
17063,UCBPlayer,105,210,315,10,65,UCBPlayer
17064,UCBPlayer,130,275,405,25,40,UCBPlayer
17065,UCBPlayer,105,210,315,10,65,UCBPlayer
17066,UCBPlayer,130,275,405,25,40,UCBPlayer
17067,UCBPlayer,106,206,312,10,66,UCBPlayer
17068,UCBPlayer,130,275,405,25,40,UCBPlayer
17069,UCBPlayer,105,210,315,10,65,UCBPlayer
17070,UCBPlayer,131,271,402,25,41,UCBPlayer
17071,UCBPlayer,105,210,315,10,65,UCBPlayer
17072,UCBPlayer,130,275,405,25,40,UCBPlayer
17073,UCBPlayer,105,210,315,10,65,UCBPlayer
17074,UCBPlayer,130,275,405,25,40,UCBPlayer
17075,UCBPlayer,103,203,306,10,68,UCBPlayer
17076,UCBPlayer,128,283,411,25,38,UCBPlayer
17077,UCBPlayer,111,186,297,10,71,UCBPlayer
17078,UCBPlayer,124,299,423,25,34,UCBPlayer
17079,UCBPlayer,115,170,285,10,75,UCBPlayer
17080,UCBPlayer,120,315,435,25,30,UCBPlayer
17081,UCBPlayer,119,154,273,10,79,UCBPlayer
17082,UCBPlayer,112,332,444,25,27,UCBPlayer
17083,UCBPlayer,127,137,264,10,82,UCBPlayer
17084,UCBPlayer,104,349,453,25,24,UCBPlayer
17085,UCBPlayer,126,126,252,7,85,Tie
17086,UCBPlayer,111,351,462,28,22,UCBPlayer
17087,UCBPlayer,116,126,242,3,87,UCBPlayer
17088,UCBPlayer,122,347,469,32,21,UCBPlayer
17089,UCBPlayer,107,132,239,0,87,UCBPlayer
17090,UCBPlayer,132,337,469,35,22,UCBPlayer
17091,UCBPlayer,103,148,251,0,83,UCBPlayer
17092,UCBPlayer,136,321,457,35,26,UCBPlayer
17093,UCBPlayer,99,164,263,0,79,UCBPlayer
17094,UCBPlayer,140,305,445,35,30,UCBPlayer
17095,UCBPlayer,95,180,275,0,75,UCBPlayer
17096,UCBPlayer,144,289,433,35,34,UCBPlayer
17097,UCBPlayer,91,196,287,0,71,UCBPlayer
17098,UCBPlayer,148,273,421,35,38,UCBPlayer
17099,UCBPlayer,87,212,299,0,67,UCBPlayer
17100,UCBPlayer,152,257,409,35,42,UCBPlayer
17101,UCBPlayer,84,224,308,0,64,UCBPlayer
17102,UCBPlayer,146,251,397,32,45,UCBPlayer
17103,UCBPlayer,89,234,323,3,60,UCBPlayer
17104,UCBPlayer,138,243,381,28,49,UCBPlayer
17105,UCBPlayer,97,242,339,7,56,UCBPlayer
17106,UCBPlayer,130,235,365,24,53,UCBPlayer
17107,UCBPlayer,105,250,355,11,52,UCBPlayer
17108,UCBPlayer,122,227,349,20,57,UCBPlayer
17109,UCBPlayer,109,259,368,15,49,UCBPlayer
17110,UCBPlayer,118,218,336,16,60,UCBPlayer
17111,UCBPlayer,117,267,384,19,45,UCBPlayer
17112,UCBPlayer,110,210,320,12,64,UCBPlayer
17113,UCBPlayer,126,271,397,23,42,UCBPlayer
17114,UCBPlayer,105,210,315,10,65,UCBPlayer
17115,UCBPlayer,130,275,405,25,40,UCBPlayer
17116,UCBPlayer,105,210,315,10,65,UCBPlayer
17117,UCBPlayer,130,275,405,25,40,UCBPlayer
17118,UCBPlayer,106,206,312,10,66,UCBPlayer
17119,UCBPlayer,130,275,405,25,40,UCBPlayer
17120,UCBPlayer,105,210,315,10,65,UCBPlayer
17121,UCBPlayer,131,271,402,25,41,UCBPlayer
17122,UCBPlayer,105,210,315,10,65,UCBPlayer
17123,UCBPlayer,130,275,405,25,40,UCBPlayer
17124,UCBPlayer,105,210,315,10,65,UCBPlayer
17125,UCBPlayer,130,275,405,25,40,UCBPlayer
17126,UCBPlayer,103,203,306,10,68,UCBPlayer
17127,UCBPlayer,128,283,411,25,38,UCBPlayer
17128,UCBPlayer,111,186,297,10,71,UCBPlayer
17129,UCBPlayer,124,299,423,25,34,UCBPlayer
17130,UCBPlayer,115,170,285,10,75,UCBPlayer
17131,UCBPlayer,120,315,435,25,30,UCBPlayer
17132,UCBPlayer,119,154,273,10,79,UCBPlayer
17133,UCBPlayer,112,332,444,25,27,UCBPlayer
17134,UCBPlayer,127,137,264,10,82,UCBPlayer
17135,UCBPlayer,104,349,453,25,24,UCBPlayer
17136,UCBPlayer,126,126,252,7,85,Tie
17137,UCBPlayer,111,351,462,28,22,UCBPlayer
17138,UCBPlayer,116,126,242,3,87,UCBPlayer
17139,UCBPlayer,122,347,469,32,21,UCBPlayer
17140,UCBPlayer,107,132,239,0,87,UCBPlayer
17141,UCBPlayer,132,337,469,35,22,UCBPlayer
17142,UCBPlayer,103,148,251,0,83,UCBPlayer
17143,UCBPlayer,136,321,457,35,26,UCBPlayer
17144,UCBPlayer,99,164,263,0,79,UCBPlayer
17145,UCBPlayer,140,305,445,35,30,UCBPlayer
17146,UCBPlayer,95,180,275,0,75,UCBPlayer
17147,UCBPlayer,144,289,433,35,34,UCBPlayer
17148,UCBPlayer,91,196,287,0,71,UCBPlayer
17149,UCBPlayer,148,273,421,35,38,UCBPlayer
17150,UCBPlayer,87,212,299,0,67,UCBPlayer
17151,UCBPlayer,152,257,409,35,42,UCBPlayer
17152,UCBPlayer,84,224,308,0,64,UCBPlayer
17153,UCBPlayer,146,251,397,32,45,UCBPlayer
17154,UCBPlayer,89,234,323,3,60,UCBPlayer
17155,UCBPlayer,138,243,381,28,49,UCBPlayer
17156,UCBPlayer,97,242,339,7,56,UCBPlayer
17157,UCBPlayer,130,235,365,24,53,UCBPlayer
17158,UCBPlayer,105,250,355,11,52,UCBPlayer
17159,UCBPlayer,122,227,349,20,57,UCBPlayer
17160,UCBPlayer,109,259,368,15,49,UCBPlayer
17161,UCBPlayer,118,218,336,16,60,UCBPlayer
17162,UCBPlayer,117,267,384,19,45,UCBPlayer
17163,UCBPlayer,110,210,320,12,64,UCBPlayer
17164,UCBPlayer,126,271,397,23,42,UCBPlayer
17165,UCBPlayer,105,210,315,10,65,UCBPlayer
17166,UCBPlayer,130,275,405,25,40,UCBPlayer
17167,UCBPlayer,105,210,315,10,65,UCBPlayer
17168,UCBPlayer,130,275,405,25,40,UCBPlayer
17169,UCBPlayer,106,206,312,10,66,UCBPlayer
17170,UCBPlayer,130,275,405,25,40,UCBPlayer
17171,UCBPlayer,105,210,315,10,65,UCBPlayer
17172,UCBPlayer,131,271,402,25,41,UCBPlayer
17173,UCBPlayer,105,210,315,10,65,UCBPlayer
17174,UCBPlayer,130,275,405,25,40,UCBPlayer
17175,UCBPlayer,105,210,315,10,65,UCBPlayer
17176,UCBPlayer,130,275,405,25,40,UCBPlayer
17177,UCBPlayer,103,203,306,10,68,UCBPlayer
17178,UCBPlayer,128,283,411,25,38,UCBPlayer
17179,UCBPlayer,111,186,297,10,71,UCBPlayer
17180,UCBPlayer,124,299,423,25,34,UCBPlayer
17181,UCBPlayer,115,170,285,10,75,UCBPlayer
17182,UCBPlayer,120,315,435,25,30,UCBPlayer
17183,UCBPlayer,119,154,273,10,79,UCBPlayer
17184,UCBPlayer,112,332,444,25,27,UCBPlayer
17185,UCBPlayer,127,137,264,10,82,UCBPlayer
17186,UCBPlayer,104,349,453,25,24,UCBPlayer
17187,UCBPlayer,126,126,252,7,85,Tie
17188,UCBPlayer,111,351,462,28,22,UCBPlayer
17189,UCBPlayer,116,126,242,3,87,UCBPlayer
17190,UCBPlayer,122,347,469,32,21,UCBPlayer
17191,UCBPlayer,107,132,239,0,87,UCBPlayer
17192,UCBPlayer,132,337,469,35,22,UCBPlayer
17193,UCBPlayer,103,148,251,0,83,UCBPlayer
17194,UCBPlayer,136,321,457,35,26,UCBPlayer
17195,UCBPlayer,99,164,263,0,79,UCBPlayer
17196,UCBPlayer,140,305,445,35,30,UCBPlayer
17197,UCBPlayer,95,180,275,0,75,UCBPlayer
17198,UCBPlayer,144,289,433,35,34,UCBPlayer
17199,UCBPlayer,91,196,287,0,71,UCBPlayer
17200,UCBPlayer,148,273,421,35,38,UCBPlayer
17201,UCBPlayer,87,212,299,0,67,UCBPlayer
17202,UCBPlayer,152,257,409,35,42,UCBPlayer
17203,UCBPlayer,84,224,308,0,64,UCBPlayer
17204,UCBPlayer,146,251,397,32,45,UCBPlayer
17205,UCBPlayer,89,234,323,3,60,UCBPlayer
17206,UCBPlayer,138,243,381,28,49,UCBPlayer
17207,UCBPlayer,97,242,339,7,56,UCBPlayer
17208,UCBPlayer,130,235,365,24,53,UCBPlayer
17209,UCBPlayer,105,250,355,11,52,UCBPlayer
17210,UCBPlayer,122,227,349,20,57,UCBPlayer
17211,UCBPlayer,109,259,368,15,49,UCBPlayer
17212,UCBPlayer,118,218,336,16,60,UCBPlayer
17213,UCBPlayer,117,267,384,19,45,UCBPlayer
17214,UCBPlayer,110,210,320,12,64,UCBPlayer
17215,UCBPlayer,126,271,397,23,42,UCBPlayer
17216,UCBPlayer,105,210,315,10,65,UCBPlayer
17217,UCBPlayer,130,275,405,25,40,UCBPlayer
17218,UCBPlayer,105,210,315,10,65,UCBPlayer
17219,UCBPlayer,130,275,405,25,40,UCBPlayer
17220,UCBPlayer,106,206,312,10,66,UCBPlayer
17221,UCBPlayer,130,275,405,25,40,UCBPlayer
17222,UCBPlayer,105,210,315,10,65,UCBPlayer
17223,UCBPlayer,131,271,402,25,41,UCBPlayer
17224,UCBPlayer,105,210,315,10,65,UCBPlayer
17225,UCBPlayer,130,275,405,25,40,UCBPlayer
17226,UCBPlayer,105,210,315,10,65,UCBPlayer
17227,UCBPlayer,130,275,405,25,40,UCBPlayer
17228,UCBPlayer,103,203,306,10,68,UCBPlayer
17229,UCBPlayer,128,283,411,25,38,UCBPlayer
17230,UCBPlayer,111,186,297,10,71,UCBPlayer
17231,UCBPlayer,124,299,423,25,34,UCBPlayer
17232,UCBPlayer,115,170,285,10,75,UCBPlayer
17233,UCBPlayer,120,315,435,25,30,UCBPlayer
17234,UCBPlayer,119,154,273,10,79,UCBPlayer
17235,UCBPlayer,112,332,444,25,27,UCBPlayer
17236,UCBPlayer,127,137,264,10,82,UCBPlayer
17237,UCBPlayer,104,349,453,25,24,UCBPlayer
17238,UCBPlayer,126,126,252,7,85,Tie
17239,UCBPlayer,111,351,462,28,22,UCBPlayer
17240,UCBPlayer,116,126,242,3,87,UCBPlayer
17241,UCBPlayer,122,347,469,32,21,UCBPlayer
17242,UCBPlayer,107,132,239,0,87,UCBPlayer
17243,UCBPlayer,132,337,469,35,22,UCBPlayer
17244,UCBPlayer,103,148,251,0,83,UCBPlayer
17245,UCBPlayer,136,321,457,35,26,UCBPlayer
17246,UCBPlayer,99,164,263,0,79,UCBPlayer
17247,UCBPlayer,140,305,445,35,30,UCBPlayer
17248,UCBPlayer,95,180,275,0,75,UCBPlayer
17249,UCBPlayer,144,289,433,35,34,UCBPlayer
17250,UCBPlayer,91,196,287,0,71,UCBPlayer
17251,UCBPlayer,148,273,421,35,38,UCBPlayer
17252,UCBPlayer,87,212,299,0,67,UCBPlayer
17253,UCBPlayer,152,257,409,35,42,UCBPlayer
17254,UCBPlayer,84,224,308,0,64,UCBPlayer
17255,UCBPlayer,146,251,397,32,45,UCBPlayer
17256,UCBPlayer,89,234,323,3,60,UCBPlayer
17257,UCBPlayer,138,243,381,28,49,UCBPlayer
17258,UCBPlayer,97,242,339,7,56,UCBPlayer
17259,UCBPlayer,130,235,365,24,53,UCBPlayer
17260,UCBPlayer,105,250,355,11,52,UCBPlayer
17261,UCBPlayer,122,227,349,20,57,UCBPlayer
17262,UCBPlayer,109,259,368,15,49,UCBPlayer
17263,UCBPlayer,118,218,336,16,60,UCBPlayer
17264,UCBPlayer,117,267,384,19,45,UCBPlayer
17265,UCBPlayer,110,210,320,12,64,UCBPlayer
17266,UCBPlayer,126,271,397,23,42,UCBPlayer
17267,UCBPlayer,105,210,315,10,65,UCBPlayer
17268,UCBPlayer,130,275,405,25,40,UCBPlayer
17269,UCBPlayer,105,210,315,10,65,UCBPlayer
17270,UCBPlayer,130,275,405,25,40,UCBPlayer
17271,UCBPlayer,106,206,312,10,66,UCBPlayer
17272,UCBPlayer,130,275,405,25,40,UCBPlayer
17273,UCBPlayer,105,210,315,10,65,UCBPlayer
17274,UCBPlayer,131,271,402,25,41,UCBPlayer
17275,UCBPlayer,105,210,315,10,65,UCBPlayer
17276,UCBPlayer,130,275,405,25,40,UCBPlayer
17277,UCBPlayer,105,210,315,10,65,UCBPlayer
17278,UCBPlayer,130,275,405,25,40,UCBPlayer
17279,UCBPlayer,103,203,306,10,68,UCBPlayer
17280,UCBPlayer,128,283,411,25,38,UCBPlayer
17281,UCBPlayer,111,186,297,10,71,UCBPlayer
17282,UCBPlayer,124,299,423,25,34,UCBPlayer
17283,UCBPlayer,115,170,285,10,75,UCBPlayer
17284,UCBPlayer,120,315,435,25,30,UCBPlayer
17285,UCBPlayer,119,154,273,10,79,UCBPlayer
17286,UCBPlayer,112,332,444,25,27,UCBPlayer
17287,UCBPlayer,127,137,264,10,82,UCBPlayer
17288,UCBPlayer,104,349,453,25,24,UCBPlayer
17289,UCBPlayer,126,126,252,7,85,Tie
17290,UCBPlayer,111,351,462,28,22,UCBPlayer
17291,UCBPlayer,116,126,242,3,87,UCBPlayer
17292,UCBPlayer,122,347,469,32,21,UCBPlayer
17293,UCBPlayer,107,132,239,0,87,UCBPlayer
17294,UCBPlayer,132,337,469,35,22,UCBPlayer
17295,UCBPlayer,103,148,251,0,83,UCBPlayer
17296,UCBPlayer,136,321,457,35,26,UCBPlayer
17297,UCBPlayer,99,164,263,0,79,UCBPlayer
17298,UCBPlayer,140,305,445,35,30,UCBPlayer
17299,UCBPlayer,95,180,275,0,75,UCBPlayer
17300,UCBPlayer,144,289,433,35,34,UCBPlayer
17301,UCBPlayer,91,196,287,0,71,UCBPlayer
17302,UCBPlayer,148,273,421,35,38,UCBPlayer
17303,UCBPlayer,87,212,299,0,67,UCBPlayer
17304,UCBPlayer,152,257,409,35,42,UCBPlayer
17305,UCBPlayer,84,224,308,0,64,UCBPlayer
17306,UCBPlayer,146,251,397,32,45,UCBPlayer
17307,UCBPlayer,89,234,323,3,60,UCBPlayer
17308,UCBPlayer,138,243,381,28,49,UCBPlayer
17309,UCBPlayer,97,242,339,7,56,UCBPlayer
17310,UCBPlayer,130,235,365,24,53,UCBPlayer
17311,UCBPlayer,105,250,355,11,52,UCBPlayer
17312,UCBPlayer,122,227,349,20,57,UCBPlayer
17313,UCBPlayer,109,259,368,15,49,UCBPlayer
17314,UCBPlayer,118,218,336,16,60,UCBPlayer
17315,UCBPlayer,117,267,384,19,45,UCBPlayer
17316,UCBPlayer,110,210,320,12,64,UCBPlayer
17317,UCBPlayer,126,271,397,23,42,UCBPlayer
17318,UCBPlayer,105,210,315,10,65,UCBPlayer
17319,UCBPlayer,130,275,405,25,40,UCBPlayer
17320,UCBPlayer,105,210,315,10,65,UCBPlayer
17321,UCBPlayer,130,275,405,25,40,UCBPlayer
17322,UCBPlayer,106,206,312,10,66,UCBPlayer
17323,UCBPlayer,130,275,405,25,40,UCBPlayer
17324,UCBPlayer,105,210,315,10,65,UCBPlayer
17325,UCBPlayer,131,271,402,25,41,UCBPlayer
17326,UCBPlayer,105,210,315,10,65,UCBPlayer
17327,UCBPlayer,130,275,405,25,40,UCBPlayer
17328,UCBPlayer,105,210,315,10,65,UCBPlayer
17329,UCBPlayer,130,275,405,25,40,UCBPlayer
17330,UCBPlayer,103,203,306,10,68,UCBPlayer
17331,UCBPlayer,128,283,411,25,38,UCBPlayer
17332,UCBPlayer,111,186,297,10,71,UCBPlayer
17333,UCBPlayer,124,299,423,25,34,UCBPlayer
17334,UCBPlayer,115,170,285,10,75,UCBPlayer
17335,UCBPlayer,120,315,435,25,30,UCBPlayer
17336,UCBPlayer,119,154,273,10,79,UCBPlayer
17337,UCBPlayer,112,332,444,25,27,UCBPlayer
17338,UCBPlayer,127,137,264,10,82,UCBPlayer
17339,UCBPlayer,104,349,453,25,24,UCBPlayer
17340,UCBPlayer,126,126,252,7,85,Tie
17341,UCBPlayer,111,351,462,28,22,UCBPlayer
17342,UCBPlayer,116,126,242,3,87,UCBPlayer
17343,UCBPlayer,122,347,469,32,21,UCBPlayer
17344,UCBPlayer,107,132,239,0,87,UCBPlayer
17345,UCBPlayer,132,337,469,35,22,UCBPlayer
17346,UCBPlayer,103,148,251,0,83,UCBPlayer
17347,UCBPlayer,136,321,457,35,26,UCBPlayer
17348,UCBPlayer,99,164,263,0,79,UCBPlayer
17349,UCBPlayer,140,305,445,35,30,UCBPlayer
17350,UCBPlayer,95,180,275,0,75,UCBPlayer
17351,UCBPlayer,144,289,433,35,34,UCBPlayer
17352,UCBPlayer,91,196,287,0,71,UCBPlayer
17353,UCBPlayer,148,273,421,35,38,UCBPlayer
17354,UCBPlayer,87,212,299,0,67,UCBPlayer
17355,UCBPlayer,152,257,409,35,42,UCBPlayer
17356,UCBPlayer,84,224,308,0,64,UCBPlayer
17357,UCBPlayer,146,251,397,32,45,UCBPlayer
17358,UCBPlayer,89,234,323,3,60,UCBPlayer
17359,UCBPlayer,138,243,381,28,49,UCBPlayer
17360,UCBPlayer,97,242,339,7,56,UCBPlayer
17361,UCBPlayer,130,235,365,24,53,UCBPlayer
17362,UCBPlayer,105,250,355,11,52,UCBPlayer
17363,UCBPlayer,122,227,349,20,57,UCBPlayer
17364,UCBPlayer,109,259,368,15,49,UCBPlayer
17365,UCBPlayer,118,218,336,16,60,UCBPlayer
17366,UCBPlayer,117,267,384,19,45,UCBPlayer
17367,UCBPlayer,110,210,320,12,64,UCBPlayer
17368,UCBPlayer,126,271,397,23,42,UCBPlayer
17369,UCBPlayer,105,210,315,10,65,UCBPlayer
17370,UCBPlayer,130,275,405,25,40,UCBPlayer
17371,UCBPlayer,105,210,315,10,65,UCBPlayer
17372,UCBPlayer,130,275,405,25,40,UCBPlayer
17373,UCBPlayer,106,206,312,10,66,UCBPlayer
17374,UCBPlayer,130,275,405,25,40,UCBPlayer
17375,UCBPlayer,105,210,315,10,65,UCBPlayer
17376,UCBPlayer,131,271,402,25,41,UCBPlayer
17377,UCBPlayer,105,210,315,10,65,UCBPlayer
17378,UCBPlayer,130,275,405,25,40,UCBPlayer
17379,UCBPlayer,105,210,315,10,65,UCBPlayer
17380,UCBPlayer,130,275,405,25,40,UCBPlayer
17381,UCBPlayer,103,203,306,10,68,UCBPlayer
17382,UCBPlayer,128,283,411,25,38,UCBPlayer
17383,UCBPlayer,111,186,297,10,71,UCBPlayer
17384,UCBPlayer,124,299,423,25,34,UCBPlayer
17385,UCBPlayer,115,170,285,10,75,UCBPlayer
17386,UCBPlayer,120,315,435,25,30,UCBPlayer
17387,UCBPlayer,119,154,273,10,79,UCBPlayer
17388,UCBPlayer,112,332,444,25,27,UCBPlayer
17389,UCBPlayer,127,137,264,10,82,UCBPlayer
17390,UCBPlayer,104,349,453,25,24,UCBPlayer
17391,UCBPlayer,126,126,252,7,85,Tie
17392,UCBPlayer,111,351,462,28,22,UCBPlayer
17393,UCBPlayer,116,126,242,3,87,UCBPlayer
17394,UCBPlayer,122,347,469,32,21,UCBPlayer
17395,UCBPlayer,107,132,239,0,87,UCBPlayer
17396,UCBPlayer,132,337,469,35,22,UCBPlayer
17397,UCBPlayer,103,148,251,0,83,UCBPlayer
17398,UCBPlayer,136,321,457,35,26,UCBPlayer
17399,UCBPlayer,99,164,263,0,79,UCBPlayer
17400,UCBPlayer,140,305,445,35,30,UCBPlayer
17401,UCBPlayer,95,180,275,0,75,UCBPlayer
17402,UCBPlayer,144,289,433,35,34,UCBPlayer
17403,UCBPlayer,91,196,287,0,71,UCBPlayer
17404,UCBPlayer,148,273,421,35,38,UCBPlayer
17405,UCBPlayer,87,212,299,0,67,UCBPlayer
17406,UCBPlayer,152,257,409,35,42,UCBPlayer
17407,UCBPlayer,84,224,308,0,64,UCBPlayer
17408,UCBPlayer,146,251,397,32,45,UCBPlayer
17409,UCBPlayer,89,234,323,3,60,UCBPlayer
17410,UCBPlayer,138,243,381,28,49,UCBPlayer
17411,UCBPlayer,97,242,339,7,56,UCBPlayer
17412,UCBPlayer,130,235,365,24,53,UCBPlayer
17413,UCBPlayer,105,250,355,11,52,UCBPlayer
17414,UCBPlayer,122,227,349,20,57,UCBPlayer
17415,UCBPlayer,109,259,368,15,49,UCBPlayer
17416,UCBPlayer,118,218,336,16,60,UCBPlayer
17417,UCBPlayer,117,267,384,19,45,UCBPlayer
17418,UCBPlayer,110,210,320,12,64,UCBPlayer
17419,UCBPlayer,126,271,397,23,42,UCBPlayer
17420,UCBPlayer,105,210,315,10,65,UCBPlayer
17421,UCBPlayer,130,275,405,25,40,UCBPlayer
17422,UCBPlayer,105,210,315,10,65,UCBPlayer
17423,UCBPlayer,130,275,405,25,40,UCBPlayer
17424,UCBPlayer,106,206,312,10,66,UCBPlayer
17425,UCBPlayer,130,275,405,25,40,UCBPlayer
17426,UCBPlayer,105,210,315,10,65,UCBPlayer
17427,UCBPlayer,131,271,402,25,41,UCBPlayer
17428,UCBPlayer,105,210,315,10,65,UCBPlayer
17429,UCBPlayer,130,275,405,25,40,UCBPlayer
17430,UCBPlayer,105,210,315,10,65,UCBPlayer
17431,UCBPlayer,130,275,405,25,40,UCBPlayer
17432,UCBPlayer,103,203,306,10,68,UCBPlayer
17433,UCBPlayer,128,283,411,25,38,UCBPlayer
17434,UCBPlayer,111,186,297,10,71,UCBPlayer
17435,UCBPlayer,124,299,423,25,34,UCBPlayer
17436,UCBPlayer,115,170,285,10,75,UCBPlayer
17437,UCBPlayer,120,315,435,25,30,UCBPlayer
17438,UCBPlayer,119,154,273,10,79,UCBPlayer
17439,UCBPlayer,112,332,444,25,27,UCBPlayer
17440,UCBPlayer,127,137,264,10,82,UCBPlayer
17441,UCBPlayer,104,349,453,25,24,UCBPlayer
17442,UCBPlayer,126,126,252,7,85,Tie
17443,UCBPlayer,111,351,462,28,22,UCBPlayer
17444,UCBPlayer,116,126,242,3,87,UCBPlayer
17445,UCBPlayer,122,347,469,32,21,UCBPlayer
17446,UCBPlayer,107,132,239,0,87,UCBPlayer
17447,UCBPlayer,132,337,469,35,22,UCBPlayer
17448,UCBPlayer,103,148,251,0,83,UCBPlayer
17449,UCBPlayer,136,321,457,35,26,UCBPlayer
17450,UCBPlayer,99,164,263,0,79,UCBPlayer
17451,UCBPlayer,140,305,445,35,30,UCBPlayer
17452,UCBPlayer,95,180,275,0,75,UCBPlayer
17453,UCBPlayer,144,289,433,35,34,UCBPlayer
17454,UCBPlayer,91,196,287,0,71,UCBPlayer
17455,UCBPlayer,148,273,421,35,38,UCBPlayer
17456,UCBPlayer,87,212,299,0,67,UCBPlayer
17457,UCBPlayer,152,257,409,35,42,UCBPlayer
17458,UCBPlayer,84,224,308,0,64,UCBPlayer
17459,UCBPlayer,146,251,397,32,45,UCBPlayer
17460,UCBPlayer,89,234,323,3,60,UCBPlayer
17461,UCBPlayer,138,243,381,28,49,UCBPlayer
17462,UCBPlayer,97,242,339,7,56,UCBPlayer
17463,UCBPlayer,130,235,365,24,53,UCBPlayer
17464,UCBPlayer,105,250,355,11,52,UCBPlayer
17465,UCBPlayer,122,227,349,20,57,UCBPlayer
17466,UCBPlayer,109,259,368,15,49,UCBPlayer
17467,UCBPlayer,118,218,336,16,60,UCBPlayer
17468,UCBPlayer,117,267,384,19,45,UCBPlayer
17469,UCBPlayer,110,210,320,12,64,UCBPlayer
17470,UCBPlayer,126,271,397,23,42,UCBPlayer
17471,UCBPlayer,105,210,315,10,65,UCBPlayer
17472,UCBPlayer,130,275,405,25,40,UCBPlayer
17473,UCBPlayer,105,210,315,10,65,UCBPlayer
17474,UCBPlayer,130,275,405,25,40,UCBPlayer
17475,UCBPlayer,106,206,312,10,66,UCBPlayer
17476,UCBPlayer,130,275,405,25,40,UCBPlayer
17477,UCBPlayer,105,210,315,10,65,UCBPlayer
17478,UCBPlayer,131,271,402,25,41,UCBPlayer
17479,UCBPlayer,105,210,315,10,65,UCBPlayer
17480,UCBPlayer,130,275,405,25,40,UCBPlayer
17481,UCBPlayer,105,210,315,10,65,UCBPlayer
17482,UCBPlayer,130,275,405,25,40,UCBPlayer
17483,UCBPlayer,103,203,306,10,68,UCBPlayer
17484,UCBPlayer,128,283,411,25,38,UCBPlayer
17485,UCBPlayer,111,186,297,10,71,UCBPlayer
17486,UCBPlayer,124,299,423,25,34,UCBPlayer
17487,UCBPlayer,115,170,285,10,75,UCBPlayer
17488,UCBPlayer,120,315,435,25,30,UCBPlayer
17489,UCBPlayer,119,154,273,10,79,UCBPlayer
17490,UCBPlayer,112,332,444,25,27,UCBPlayer
17491,UCBPlayer,127,137,264,10,82,UCBPlayer
17492,UCBPlayer,104,349,453,25,24,UCBPlayer
17493,UCBPlayer,126,126,252,7,85,Tie
17494,UCBPlayer,111,351,462,28,22,UCBPlayer
17495,UCBPlayer,116,126,242,3,87,UCBPlayer
17496,UCBPlayer,122,347,469,32,21,UCBPlayer
17497,UCBPlayer,107,132,239,0,87,UCBPlayer
17498,UCBPlayer,132,337,469,35,22,UCBPlayer
17499,UCBPlayer,103,148,251,0,83,UCBPlayer
17500,UCBPlayer,136,321,457,35,26,UCBPlayer
17501,UCBPlayer,99,164,263,0,79,UCBPlayer
17502,UCBPlayer,140,305,445,35,30,UCBPlayer
17503,UCBPlayer,95,180,275,0,75,UCBPlayer
17504,UCBPlayer,144,289,433,35,34,UCBPlayer
17505,UCBPlayer,91,196,287,0,71,UCBPlayer
17506,UCBPlayer,148,273,421,35,38,UCBPlayer
17507,UCBPlayer,87,212,299,0,67,UCBPlayer
17508,UCBPlayer,152,257,409,35,42,UCBPlayer
17509,UCBPlayer,84,224,308,0,64,UCBPlayer
17510,UCBPlayer,146,251,397,32,45,UCBPlayer
17511,UCBPlayer,89,234,323,3,60,UCBPlayer
17512,UCBPlayer,138,243,381,28,49,UCBPlayer
17513,UCBPlayer,97,242,339,7,56,UCBPlayer
17514,UCBPlayer,130,235,365,24,53,UCBPlayer
17515,UCBPlayer,105,250,355,11,52,UCBPlayer
17516,UCBPlayer,122,227,349,20,57,UCBPlayer
17517,UCBPlayer,109,259,368,15,49,UCBPlayer
17518,UCBPlayer,118,218,336,16,60,UCBPlayer
17519,UCBPlayer,117,267,384,19,45,UCBPlayer
17520,UCBPlayer,110,210,320,12,64,UCBPlayer
17521,UCBPlayer,126,271,397,23,42,UCBPlayer
17522,UCBPlayer,105,210,315,10,65,UCBPlayer
17523,UCBPlayer,130,275,405,25,40,UCBPlayer
17524,UCBPlayer,105,210,315,10,65,UCBPlayer
17525,UCBPlayer,130,275,405,25,40,UCBPlayer
17526,UCBPlayer,106,206,312,10,66,UCBPlayer
17527,UCBPlayer,130,275,405,25,40,UCBPlayer
17528,UCBPlayer,105,210,315,10,65,UCBPlayer
17529,UCBPlayer,131,271,402,25,41,UCBPlayer
17530,UCBPlayer,105,210,315,10,65,UCBPlayer
17531,UCBPlayer,130,275,405,25,40,UCBPlayer
17532,UCBPlayer,105,210,315,10,65,UCBPlayer
17533,UCBPlayer,130,275,405,25,40,UCBPlayer
17534,UCBPlayer,103,203,306,10,68,UCBPlayer
17535,UCBPlayer,128,283,411,25,38,UCBPlayer
17536,UCBPlayer,111,186,297,10,71,UCBPlayer
17537,UCBPlayer,124,299,423,25,34,UCBPlayer
17538,UCBPlayer,115,170,285,10,75,UCBPlayer
17539,UCBPlayer,120,315,435,25,30,UCBPlayer
17540,UCBPlayer,119,154,273,10,79,UCBPlayer
17541,UCBPlayer,112,332,444,25,27,UCBPlayer
17542,UCBPlayer,127,137,264,10,82,UCBPlayer
17543,UCBPlayer,104,349,453,25,24,UCBPlayer
17544,UCBPlayer,126,126,252,7,85,Tie
17545,UCBPlayer,111,351,462,28,22,UCBPlayer
17546,UCBPlayer,116,126,242,3,87,UCBPlayer
17547,UCBPlayer,122,347,469,32,21,UCBPlayer
17548,UCBPlayer,107,132,239,0,87,UCBPlayer
17549,UCBPlayer,132,337,469,35,22,UCBPlayer
17550,UCBPlayer,103,148,251,0,83,UCBPlayer
17551,UCBPlayer,136,321,457,35,26,UCBPlayer
17552,UCBPlayer,99,164,263,0,79,UCBPlayer
17553,UCBPlayer,140,305,445,35,30,UCBPlayer
17554,UCBPlayer,95,180,275,0,75,UCBPlayer
17555,UCBPlayer,144,289,433,35,34,UCBPlayer
17556,UCBPlayer,91,196,287,0,71,UCBPlayer
17557,UCBPlayer,148,273,421,35,38,UCBPlayer
17558,UCBPlayer,87,212,299,0,67,UCBPlayer
17559,UCBPlayer,152,257,409,35,42,UCBPlayer
17560,UCBPlayer,84,224,308,0,64,UCBPlayer
17561,UCBPlayer,146,251,397,32,45,UCBPlayer
17562,UCBPlayer,89,234,323,3,60,UCBPlayer
17563,UCBPlayer,138,243,381,28,49,UCBPlayer
17564,UCBPlayer,97,242,339,7,56,UCBPlayer
17565,UCBPlayer,130,235,365,24,53,UCBPlayer
17566,UCBPlayer,105,250,355,11,52,UCBPlayer
17567,UCBPlayer,122,227,349,20,57,UCBPlayer
17568,UCBPlayer,109,259,368,15,49,UCBPlayer
17569,UCBPlayer,118,218,336,16,60,UCBPlayer
17570,UCBPlayer,117,267,384,19,45,UCBPlayer
17571,UCBPlayer,110,210,320,12,64,UCBPlayer
17572,UCBPlayer,126,271,397,23,42,UCBPlayer
17573,UCBPlayer,105,210,315,10,65,UCBPlayer
17574,UCBPlayer,130,275,405,25,40,UCBPlayer
17575,UCBPlayer,105,210,315,10,65,UCBPlayer
17576,UCBPlayer,130,275,405,25,40,UCBPlayer
17577,UCBPlayer,106,206,312,10,66,UCBPlayer
17578,UCBPlayer,130,275,405,25,40,UCBPlayer
17579,UCBPlayer,105,210,315,10,65,UCBPlayer
17580,UCBPlayer,131,271,402,25,41,UCBPlayer
17581,UCBPlayer,105,210,315,10,65,UCBPlayer
17582,UCBPlayer,130,275,405,25,40,UCBPlayer
17583,UCBPlayer,105,210,315,10,65,UCBPlayer
17584,UCBPlayer,130,275,405,25,40,UCBPlayer
17585,UCBPlayer,103,203,306,10,68,UCBPlayer
17586,UCBPlayer,128,283,411,25,38,UCBPlayer
17587,UCBPlayer,111,186,297,10,71,UCBPlayer
17588,UCBPlayer,124,299,423,25,34,UCBPlayer
17589,UCBPlayer,115,170,285,10,75,UCBPlayer
17590,UCBPlayer,120,315,435,25,30,UCBPlayer
17591,UCBPlayer,119,154,273,10,79,UCBPlayer
17592,UCBPlayer,112,332,444,25,27,UCBPlayer
17593,UCBPlayer,127,137,264,10,82,UCBPlayer
17594,UCBPlayer,104,349,453,25,24,UCBPlayer
17595,UCBPlayer,126,126,252,7,85,Tie
17596,UCBPlayer,111,351,462,28,22,UCBPlayer
17597,UCBPlayer,116,126,242,3,87,UCBPlayer
17598,UCBPlayer,122,347,469,32,21,UCBPlayer
17599,UCBPlayer,107,132,239,0,87,UCBPlayer
17600,UCBPlayer,132,337,469,35,22,UCBPlayer
17601,UCBPlayer,103,148,251,0,83,UCBPlayer
17602,UCBPlayer,136,321,457,35,26,UCBPlayer
17603,UCBPlayer,99,164,263,0,79,UCBPlayer
17604,UCBPlayer,140,305,445,35,30,UCBPlayer
17605,UCBPlayer,95,180,275,0,75,UCBPlayer
17606,UCBPlayer,144,289,433,35,34,UCBPlayer
17607,UCBPlayer,91,196,287,0,71,UCBPlayer
17608,UCBPlayer,148,273,421,35,38,UCBPlayer
17609,UCBPlayer,87,212,299,0,67,UCBPlayer
17610,UCBPlayer,152,257,409,35,42,UCBPlayer
17611,UCBPlayer,84,224,308,0,64,UCBPlayer
17612,UCBPlayer,146,251,397,32,45,UCBPlayer
17613,UCBPlayer,89,234,323,3,60,UCBPlayer
17614,UCBPlayer,138,243,381,28,49,UCBPlayer
17615,UCBPlayer,97,242,339,7,56,UCBPlayer
17616,UCBPlayer,130,235,365,24,53,UCBPlayer
17617,UCBPlayer,105,250,355,11,52,UCBPlayer
17618,UCBPlayer,122,227,349,20,57,UCBPlayer
17619,UCBPlayer,109,259,368,15,49,UCBPlayer
17620,UCBPlayer,118,218,336,16,60,UCBPlayer
17621,UCBPlayer,117,267,384,19,45,UCBPlayer
17622,UCBPlayer,110,210,320,12,64,UCBPlayer
17623,UCBPlayer,126,271,397,23,42,UCBPlayer
17624,UCBPlayer,105,210,315,10,65,UCBPlayer
17625,UCBPlayer,130,275,405,25,40,UCBPlayer
17626,UCBPlayer,105,210,315,10,65,UCBPlayer
17627,UCBPlayer,130,275,405,25,40,UCBPlayer
17628,UCBPlayer,106,206,312,10,66,UCBPlayer
17629,UCBPlayer,130,275,405,25,40,UCBPlayer
17630,UCBPlayer,105,210,315,10,65,UCBPlayer
17631,UCBPlayer,131,271,402,25,41,UCBPlayer
17632,UCBPlayer,105,210,315,10,65,UCBPlayer
17633,UCBPlayer,130,275,405,25,40,UCBPlayer
17634,UCBPlayer,105,210,315,10,65,UCBPlayer
17635,UCBPlayer,130,275,405,25,40,UCBPlayer
17636,UCBPlayer,103,203,306,10,68,UCBPlayer
17637,UCBPlayer,128,283,411,25,38,UCBPlayer
17638,UCBPlayer,111,186,297,10,71,UCBPlayer
17639,UCBPlayer,124,299,423,25,34,UCBPlayer
17640,UCBPlayer,115,170,285,10,75,UCBPlayer
17641,UCBPlayer,120,315,435,25,30,UCBPlayer
17642,UCBPlayer,119,154,273,10,79,UCBPlayer
17643,UCBPlayer,112,332,444,25,27,UCBPlayer
17644,UCBPlayer,127,137,264,10,82,UCBPlayer
17645,UCBPlayer,104,349,453,25,24,UCBPlayer
17646,UCBPlayer,126,126,252,7,85,Tie
17647,UCBPlayer,111,351,462,28,22,UCBPlayer
17648,UCBPlayer,116,126,242,3,87,UCBPlayer
17649,UCBPlayer,122,347,469,32,21,UCBPlayer
17650,UCBPlayer,107,132,239,0,87,UCBPlayer
17651,UCBPlayer,132,337,469,35,22,UCBPlayer
17652,UCBPlayer,103,148,251,0,83,UCBPlayer
17653,UCBPlayer,136,321,457,35,26,UCBPlayer
17654,UCBPlayer,99,164,263,0,79,UCBPlayer
17655,UCBPlayer,140,305,445,35,30,UCBPlayer
17656,UCBPlayer,95,180,275,0,75,UCBPlayer
17657,UCBPlayer,144,289,433,35,34,UCBPlayer
17658,UCBPlayer,91,196,287,0,71,UCBPlayer
17659,UCBPlayer,148,273,421,35,38,UCBPlayer
17660,UCBPlayer,87,212,299,0,67,UCBPlayer
17661,UCBPlayer,152,257,409,35,42,UCBPlayer
17662,UCBPlayer,84,224,308,0,64,UCBPlayer
17663,UCBPlayer,146,251,397,32,45,UCBPlayer
17664,UCBPlayer,89,234,323,3,60,UCBPlayer
17665,UCBPlayer,138,243,381,28,49,UCBPlayer
17666,UCBPlayer,97,242,339,7,56,UCBPlayer
17667,UCBPlayer,130,235,365,24,53,UCBPlayer
17668,UCBPlayer,105,250,355,11,52,UCBPlayer
17669,UCBPlayer,122,227,349,20,57,UCBPlayer
17670,UCBPlayer,109,259,368,15,49,UCBPlayer
17671,UCBPlayer,118,218,336,16,60,UCBPlayer
17672,UCBPlayer,117,267,384,19,45,UCBPlayer
17673,UCBPlayer,110,210,320,12,64,UCBPlayer
17674,UCBPlayer,126,271,397,23,42,UCBPlayer
17675,UCBPlayer,105,210,315,10,65,UCBPlayer
17676,UCBPlayer,130,275,405,25,40,UCBPlayer
17677,UCBPlayer,105,210,315,10,65,UCBPlayer
17678,UCBPlayer,130,275,405,25,40,UCBPlayer
17679,UCBPlayer,106,206,312,10,66,UCBPlayer
17680,UCBPlayer,130,275,405,25,40,UCBPlayer
17681,UCBPlayer,105,210,315,10,65,UCBPlayer
17682,UCBPlayer,131,271,402,25,41,UCBPlayer
17683,UCBPlayer,105,210,315,10,65,UCBPlayer
17684,UCBPlayer,130,275,405,25,40,UCBPlayer
17685,UCBPlayer,105,210,315,10,65,UCBPlayer
17686,UCBPlayer,130,275,405,25,40,UCBPlayer
17687,UCBPlayer,103,203,306,10,68,UCBPlayer
17688,UCBPlayer,128,283,411,25,38,UCBPlayer
17689,UCBPlayer,111,186,297,10,71,UCBPlayer
17690,UCBPlayer,124,299,423,25,34,UCBPlayer
17691,UCBPlayer,115,170,285,10,75,UCBPlayer
17692,UCBPlayer,120,315,435,25,30,UCBPlayer
17693,UCBPlayer,119,154,273,10,79,UCBPlayer
17694,UCBPlayer,112,332,444,25,27,UCBPlayer
17695,UCBPlayer,127,137,264,10,82,UCBPlayer
17696,UCBPlayer,104,349,453,25,24,UCBPlayer
17697,UCBPlayer,126,126,252,7,85,Tie
17698,UCBPlayer,111,351,462,28,22,UCBPlayer
17699,UCBPlayer,116,126,242,3,87,UCBPlayer
17700,UCBPlayer,122,347,469,32,21,UCBPlayer
17701,UCBPlayer,107,132,239,0,87,UCBPlayer
17702,UCBPlayer,132,337,469,35,22,UCBPlayer
17703,UCBPlayer,103,148,251,0,83,UCBPlayer
17704,UCBPlayer,136,321,457,35,26,UCBPlayer
17705,UCBPlayer,99,164,263,0,79,UCBPlayer
17706,UCBPlayer,140,305,445,35,30,UCBPlayer
17707,UCBPlayer,95,180,275,0,75,UCBPlayer
17708,UCBPlayer,144,289,433,35,34,UCBPlayer
17709,UCBPlayer,91,196,287,0,71,UCBPlayer
17710,UCBPlayer,148,273,421,35,38,UCBPlayer
17711,UCBPlayer,87,212,299,0,67,UCBPlayer
17712,UCBPlayer,152,257,409,35,42,UCBPlayer
17713,UCBPlayer,84,224,308,0,64,UCBPlayer
17714,UCBPlayer,146,251,397,32,45,UCBPlayer
17715,UCBPlayer,89,234,323,3,60,UCBPlayer
17716,UCBPlayer,138,243,381,28,49,UCBPlayer
17717,UCBPlayer,97,242,339,7,56,UCBPlayer
17718,UCBPlayer,130,235,365,24,53,UCBPlayer
17719,UCBPlayer,105,250,355,11,52,UCBPlayer
17720,UCBPlayer,122,227,349,20,57,UCBPlayer
17721,UCBPlayer,109,259,368,15,49,UCBPlayer
17722,UCBPlayer,118,218,336,16,60,UCBPlayer
17723,UCBPlayer,117,267,384,19,45,UCBPlayer
17724,UCBPlayer,110,210,320,12,64,UCBPlayer
17725,UCBPlayer,126,271,397,23,42,UCBPlayer
17726,UCBPlayer,105,210,315,10,65,UCBPlayer
17727,UCBPlayer,130,275,405,25,40,UCBPlayer
17728,UCBPlayer,105,210,315,10,65,UCBPlayer
17729,UCBPlayer,130,275,405,25,40,UCBPlayer
17730,UCBPlayer,106,206,312,10,66,UCBPlayer
17731,UCBPlayer,130,275,405,25,40,UCBPlayer
17732,UCBPlayer,105,210,315,10,65,UCBPlayer
17733,UCBPlayer,131,271,402,25,41,UCBPlayer
17734,UCBPlayer,105,210,315,10,65,UCBPlayer
17735,UCBPlayer,130,275,405,25,40,UCBPlayer
17736,UCBPlayer,105,210,315,10,65,UCBPlayer
17737,UCBPlayer,130,275,405,25,40,UCBPlayer
17738,UCBPlayer,103,203,306,10,68,UCBPlayer
17739,UCBPlayer,128,283,411,25,38,UCBPlayer
17740,UCBPlayer,111,186,297,10,71,UCBPlayer
17741,UCBPlayer,124,299,423,25,34,UCBPlayer
17742,UCBPlayer,115,170,285,10,75,UCBPlayer
17743,UCBPlayer,120,315,435,25,30,UCBPlayer
17744,UCBPlayer,119,154,273,10,79,UCBPlayer
17745,UCBPlayer,112,332,444,25,27,UCBPlayer
17746,UCBPlayer,127,137,264,10,82,UCBPlayer
17747,UCBPlayer,104,349,453,25,24,UCBPlayer
17748,UCBPlayer,126,126,252,7,85,Tie
17749,UCBPlayer,111,351,462,28,22,UCBPlayer
17750,UCBPlayer,116,126,242,3,87,UCBPlayer
17751,UCBPlayer,122,347,469,32,21,UCBPlayer
17752,UCBPlayer,107,132,239,0,87,UCBPlayer
17753,UCBPlayer,132,337,469,35,22,UCBPlayer
17754,UCBPlayer,103,148,251,0,83,UCBPlayer
17755,UCBPlayer,136,321,457,35,26,UCBPlayer
17756,UCBPlayer,99,164,263,0,79,UCBPlayer
17757,UCBPlayer,140,305,445,35,30,UCBPlayer
17758,UCBPlayer,95,180,275,0,75,UCBPlayer
17759,UCBPlayer,144,289,433,35,34,UCBPlayer
17760,UCBPlayer,91,196,287,0,71,UCBPlayer
17761,UCBPlayer,148,273,421,35,38,UCBPlayer
17762,UCBPlayer,87,212,299,0,67,UCBPlayer
17763,UCBPlayer,152,257,409,35,42,UCBPlayer
17764,UCBPlayer,84,224,308,0,64,UCBPlayer
17765,UCBPlayer,146,251,397,32,45,UCBPlayer
17766,UCBPlayer,89,234,323,3,60,UCBPlayer
17767,UCBPlayer,138,243,381,28,49,UCBPlayer
17768,UCBPlayer,97,242,339,7,56,UCBPlayer
17769,UCBPlayer,130,235,365,24,53,UCBPlayer
17770,UCBPlayer,105,250,355,11,52,UCBPlayer
17771,UCBPlayer,122,227,349,20,57,UCBPlayer
17772,UCBPlayer,109,259,368,15,49,UCBPlayer
17773,UCBPlayer,118,218,336,16,60,UCBPlayer
17774,UCBPlayer,117,267,384,19,45,UCBPlayer
17775,UCBPlayer,110,210,320,12,64,UCBPlayer
17776,UCBPlayer,126,271,397,23,42,UCBPlayer
17777,UCBPlayer,105,210,315,10,65,UCBPlayer
17778,UCBPlayer,130,275,405,25,40,UCBPlayer
17779,UCBPlayer,105,210,315,10,65,UCBPlayer
17780,UCBPlayer,130,275,405,25,40,UCBPlayer
17781,UCBPlayer,106,206,312,10,66,UCBPlayer
17782,UCBPlayer,130,275,405,25,40,UCBPlayer
17783,UCBPlayer,105,210,315,10,65,UCBPlayer
17784,UCBPlayer,131,271,402,25,41,UCBPlayer
17785,UCBPlayer,105,210,315,10,65,UCBPlayer
17786,UCBPlayer,130,275,405,25,40,UCBPlayer
17787,UCBPlayer,105,210,315,10,65,UCBPlayer
17788,UCBPlayer,130,275,405,25,40,UCBPlayer
17789,UCBPlayer,103,203,306,10,68,UCBPlayer
17790,UCBPlayer,128,283,411,25,38,UCBPlayer
17791,UCBPlayer,111,186,297,10,71,UCBPlayer
17792,UCBPlayer,124,299,423,25,34,UCBPlayer
17793,UCBPlayer,115,170,285,10,75,UCBPlayer
17794,UCBPlayer,120,315,435,25,30,UCBPlayer
17795,UCBPlayer,119,154,273,10,79,UCBPlayer
17796,UCBPlayer,112,332,444,25,27,UCBPlayer
17797,UCBPlayer,127,137,264,10,82,UCBPlayer
17798,UCBPlayer,104,349,453,25,24,UCBPlayer
17799,UCBPlayer,126,126,252,7,85,Tie
17800,UCBPlayer,111,351,462,28,22,UCBPlayer
17801,UCBPlayer,116,126,242,3,87,UCBPlayer
17802,UCBPlayer,122,347,469,32,21,UCBPlayer
17803,UCBPlayer,107,132,239,0,87,UCBPlayer
17804,UCBPlayer,132,337,469,35,22,UCBPlayer
17805,UCBPlayer,103,148,251,0,83,UCBPlayer
17806,UCBPlayer,136,321,457,35,26,UCBPlayer
17807,UCBPlayer,99,164,263,0,79,UCBPlayer
17808,UCBPlayer,140,305,445,35,30,UCBPlayer
17809,UCBPlayer,95,180,275,0,75,UCBPlayer
17810,UCBPlayer,144,289,433,35,34,UCBPlayer
17811,UCBPlayer,91,196,287,0,71,UCBPlayer
17812,UCBPlayer,148,273,421,35,38,UCBPlayer
17813,UCBPlayer,87,212,299,0,67,UCBPlayer
17814,UCBPlayer,152,257,409,35,42,UCBPlayer
17815,UCBPlayer,84,224,308,0,64,UCBPlayer
17816,UCBPlayer,146,251,397,32,45,UCBPlayer
17817,UCBPlayer,89,234,323,3,60,UCBPlayer
17818,UCBPlayer,138,243,381,28,49,UCBPlayer
17819,UCBPlayer,97,242,339,7,56,UCBPlayer
17820,UCBPlayer,130,235,365,24,53,UCBPlayer
17821,UCBPlayer,105,250,355,11,52,UCBPlayer
17822,UCBPlayer,122,227,349,20,57,UCBPlayer
17823,UCBPlayer,109,259,368,15,49,UCBPlayer
17824,UCBPlayer,118,218,336,16,60,UCBPlayer
17825,UCBPlayer,117,267,384,19,45,UCBPlayer
17826,UCBPlayer,110,210,320,12,64,UCBPlayer
17827,UCBPlayer,126,271,397,23,42,UCBPlayer
17828,UCBPlayer,105,210,315,10,65,UCBPlayer
17829,UCBPlayer,130,275,405,25,40,UCBPlayer
17830,UCBPlayer,105,210,315,10,65,UCBPlayer
17831,UCBPlayer,130,275,405,25,40,UCBPlayer
17832,UCBPlayer,106,206,312,10,66,UCBPlayer
17833,UCBPlayer,130,275,405,25,40,UCBPlayer
17834,UCBPlayer,105,210,315,10,65,UCBPlayer
17835,UCBPlayer,131,271,402,25,41,UCBPlayer
17836,UCBPlayer,105,210,315,10,65,UCBPlayer
17837,UCBPlayer,130,275,405,25,40,UCBPlayer
17838,UCBPlayer,105,210,315,10,65,UCBPlayer
17839,UCBPlayer,130,275,405,25,40,UCBPlayer
17840,UCBPlayer,103,203,306,10,68,UCBPlayer
17841,UCBPlayer,128,283,411,25,38,UCBPlayer
17842,UCBPlayer,111,186,297,10,71,UCBPlayer
17843,UCBPlayer,124,299,423,25,34,UCBPlayer
17844,UCBPlayer,115,170,285,10,75,UCBPlayer
17845,UCBPlayer,120,315,435,25,30,UCBPlayer
17846,UCBPlayer,119,154,273,10,79,UCBPlayer
17847,UCBPlayer,112,332,444,25,27,UCBPlayer
17848,UCBPlayer,127,137,264,10,82,UCBPlayer
17849,UCBPlayer,104,349,453,25,24,UCBPlayer
17850,UCBPlayer,126,126,252,7,85,Tie
17851,UCBPlayer,111,351,462,28,22,UCBPlayer
17852,UCBPlayer,116,126,242,3,87,UCBPlayer
17853,UCBPlayer,122,347,469,32,21,UCBPlayer
17854,UCBPlayer,107,132,239,0,87,UCBPlayer
17855,UCBPlayer,132,337,469,35,22,UCBPlayer
17856,UCBPlayer,103,148,251,0,83,UCBPlayer
17857,UCBPlayer,136,321,457,35,26,UCBPlayer
17858,UCBPlayer,99,164,263,0,79,UCBPlayer
17859,UCBPlayer,140,305,445,35,30,UCBPlayer
17860,UCBPlayer,95,180,275,0,75,UCBPlayer
17861,UCBPlayer,144,289,433,35,34,UCBPlayer
17862,UCBPlayer,91,196,287,0,71,UCBPlayer
17863,UCBPlayer,148,273,421,35,38,UCBPlayer
17864,UCBPlayer,87,212,299,0,67,UCBPlayer
17865,UCBPlayer,152,257,409,35,42,UCBPlayer
17866,UCBPlayer,84,224,308,0,64,UCBPlayer
17867,UCBPlayer,146,251,397,32,45,UCBPlayer
17868,UCBPlayer,89,234,323,3,60,UCBPlayer
17869,UCBPlayer,138,243,381,28,49,UCBPlayer
17870,UCBPlayer,97,242,339,7,56,UCBPlayer
17871,UCBPlayer,130,235,365,24,53,UCBPlayer
17872,UCBPlayer,105,250,355,11,52,UCBPlayer
17873,UCBPlayer,122,227,349,20,57,UCBPlayer
17874,UCBPlayer,109,259,368,15,49,UCBPlayer
17875,UCBPlayer,118,218,336,16,60,UCBPlayer
17876,UCBPlayer,117,267,384,19,45,UCBPlayer
17877,UCBPlayer,110,210,320,12,64,UCBPlayer
17878,UCBPlayer,126,271,397,23,42,UCBPlayer
17879,UCBPlayer,105,210,315,10,65,UCBPlayer
17880,UCBPlayer,130,275,405,25,40,UCBPlayer
17881,UCBPlayer,105,210,315,10,65,UCBPlayer
17882,UCBPlayer,130,275,405,25,40,UCBPlayer
17883,UCBPlayer,106,206,312,10,66,UCBPlayer
17884,UCBPlayer,130,275,405,25,40,UCBPlayer
17885,UCBPlayer,105,210,315,10,65,UCBPlayer
17886,UCBPlayer,131,271,402,25,41,UCBPlayer
17887,UCBPlayer,105,210,315,10,65,UCBPlayer
17888,UCBPlayer,130,275,405,25,40,UCBPlayer
17889,UCBPlayer,105,210,315,10,65,UCBPlayer
17890,UCBPlayer,130,275,405,25,40,UCBPlayer
17891,UCBPlayer,103,203,306,10,68,UCBPlayer
17892,UCBPlayer,128,283,411,25,38,UCBPlayer
17893,UCBPlayer,111,186,297,10,71,UCBPlayer
17894,UCBPlayer,124,299,423,25,34,UCBPlayer
17895,UCBPlayer,115,170,285,10,75,UCBPlayer
17896,UCBPlayer,120,315,435,25,30,UCBPlayer
17897,UCBPlayer,119,154,273,10,79,UCBPlayer
17898,UCBPlayer,112,332,444,25,27,UCBPlayer
17899,UCBPlayer,127,137,264,10,82,UCBPlayer
17900,UCBPlayer,104,349,453,25,24,UCBPlayer
17901,UCBPlayer,126,126,252,7,85,Tie
17902,UCBPlayer,111,351,462,28,22,UCBPlayer
17903,UCBPlayer,116,126,242,3,87,UCBPlayer
17904,UCBPlayer,122,347,469,32,21,UCBPlayer
17905,UCBPlayer,107,132,239,0,87,UCBPlayer
17906,UCBPlayer,132,337,469,35,22,UCBPlayer
17907,UCBPlayer,103,148,251,0,83,UCBPlayer
17908,UCBPlayer,136,321,457,35,26,UCBPlayer
17909,UCBPlayer,99,164,263,0,79,UCBPlayer
17910,UCBPlayer,140,305,445,35,30,UCBPlayer
17911,UCBPlayer,95,180,275,0,75,UCBPlayer
17912,UCBPlayer,144,289,433,35,34,UCBPlayer
17913,UCBPlayer,91,196,287,0,71,UCBPlayer
17914,UCBPlayer,148,273,421,35,38,UCBPlayer
17915,UCBPlayer,87,212,299,0,67,UCBPlayer
17916,UCBPlayer,152,257,409,35,42,UCBPlayer
17917,UCBPlayer,84,224,308,0,64,UCBPlayer
17918,UCBPlayer,146,251,397,32,45,UCBPlayer
17919,UCBPlayer,89,234,323,3,60,UCBPlayer
17920,UCBPlayer,138,243,381,28,49,UCBPlayer
17921,UCBPlayer,97,242,339,7,56,UCBPlayer
17922,UCBPlayer,130,235,365,24,53,UCBPlayer
17923,UCBPlayer,105,250,355,11,52,UCBPlayer
17924,UCBPlayer,122,227,349,20,57,UCBPlayer
17925,UCBPlayer,109,259,368,15,49,UCBPlayer
17926,UCBPlayer,118,218,336,16,60,UCBPlayer
17927,UCBPlayer,117,267,384,19,45,UCBPlayer
17928,UCBPlayer,110,210,320,12,64,UCBPlayer
17929,UCBPlayer,126,271,397,23,42,UCBPlayer
17930,UCBPlayer,105,210,315,10,65,UCBPlayer
17931,UCBPlayer,130,275,405,25,40,UCBPlayer
17932,UCBPlayer,105,210,315,10,65,UCBPlayer
17933,UCBPlayer,130,275,405,25,40,UCBPlayer
17934,UCBPlayer,106,206,312,10,66,UCBPlayer
17935,UCBPlayer,130,275,405,25,40,UCBPlayer
17936,UCBPlayer,105,210,315,10,65,UCBPlayer
17937,UCBPlayer,131,271,402,25,41,UCBPlayer
17938,UCBPlayer,105,210,315,10,65,UCBPlayer
17939,UCBPlayer,130,275,405,25,40,UCBPlayer
17940,UCBPlayer,105,210,315,10,65,UCBPlayer
17941,UCBPlayer,130,275,405,25,40,UCBPlayer
17942,UCBPlayer,103,203,306,10,68,UCBPlayer
17943,UCBPlayer,128,283,411,25,38,UCBPlayer
17944,UCBPlayer,111,186,297,10,71,UCBPlayer
17945,UCBPlayer,124,299,423,25,34,UCBPlayer
17946,UCBPlayer,115,170,285,10,75,UCBPlayer
17947,UCBPlayer,120,315,435,25,30,UCBPlayer
17948,UCBPlayer,119,154,273,10,79,UCBPlayer
17949,UCBPlayer,112,332,444,25,27,UCBPlayer
17950,UCBPlayer,127,137,264,10,82,UCBPlayer
17951,UCBPlayer,104,349,453,25,24,UCBPlayer
17952,UCBPlayer,126,126,252,7,85,Tie
17953,UCBPlayer,111,351,462,28,22,UCBPlayer
17954,UCBPlayer,116,126,242,3,87,UCBPlayer
17955,UCBPlayer,122,347,469,32,21,UCBPlayer
17956,UCBPlayer,107,132,239,0,87,UCBPlayer
17957,UCBPlayer,132,337,469,35,22,UCBPlayer
17958,UCBPlayer,103,148,251,0,83,UCBPlayer
17959,UCBPlayer,136,321,457,35,26,UCBPlayer
17960,UCBPlayer,99,164,263,0,79,UCBPlayer
17961,UCBPlayer,140,305,445,35,30,UCBPlayer
17962,UCBPlayer,95,180,275,0,75,UCBPlayer
17963,UCBPlayer,144,289,433,35,34,UCBPlayer
17964,UCBPlayer,91,196,287,0,71,UCBPlayer
17965,UCBPlayer,148,273,421,35,38,UCBPlayer
17966,UCBPlayer,87,212,299,0,67,UCBPlayer
17967,UCBPlayer,152,257,409,35,42,UCBPlayer
17968,UCBPlayer,84,224,308,0,64,UCBPlayer
17969,UCBPlayer,146,251,397,32,45,UCBPlayer
17970,UCBPlayer,89,234,323,3,60,UCBPlayer
17971,UCBPlayer,138,243,381,28,49,UCBPlayer
17972,UCBPlayer,97,242,339,7,56,UCBPlayer
17973,UCBPlayer,130,235,365,24,53,UCBPlayer
17974,UCBPlayer,105,250,355,11,52,UCBPlayer
17975,UCBPlayer,122,227,349,20,57,UCBPlayer
17976,UCBPlayer,109,259,368,15,49,UCBPlayer
17977,UCBPlayer,118,218,336,16,60,UCBPlayer
17978,UCBPlayer,117,267,384,19,45,UCBPlayer
17979,UCBPlayer,110,210,320,12,64,UCBPlayer
17980,UCBPlayer,126,271,397,23,42,UCBPlayer
17981,UCBPlayer,105,210,315,10,65,UCBPlayer
17982,UCBPlayer,130,275,405,25,40,UCBPlayer
17983,UCBPlayer,105,210,315,10,65,UCBPlayer
17984,UCBPlayer,130,275,405,25,40,UCBPlayer
17985,UCBPlayer,106,206,312,10,66,UCBPlayer
17986,UCBPlayer,130,275,405,25,40,UCBPlayer
17987,UCBPlayer,105,210,315,10,65,UCBPlayer
17988,UCBPlayer,131,271,402,25,41,UCBPlayer
17989,UCBPlayer,105,210,315,10,65,UCBPlayer
17990,UCBPlayer,130,275,405,25,40,UCBPlayer
17991,UCBPlayer,105,210,315,10,65,UCBPlayer
17992,UCBPlayer,130,275,405,25,40,UCBPlayer
17993,UCBPlayer,103,203,306,10,68,UCBPlayer
17994,UCBPlayer,128,283,411,25,38,UCBPlayer
17995,UCBPlayer,111,186,297,10,71,UCBPlayer
17996,UCBPlayer,124,299,423,25,34,UCBPlayer
17997,UCBPlayer,115,170,285,10,75,UCBPlayer
17998,UCBPlayer,120,315,435,25,30,UCBPlayer
17999,UCBPlayer,119,154,273,10,79,UCBPlayer
18000,UCBPlayer,112,332,444,25,27,UCBPlayer
18001,UCBPlayer,127,137,264,10,82,UCBPlayer
18002,UCBPlayer,104,349,453,25,24,UCBPlayer
18003,UCBPlayer,126,126,252,7,85,Tie
18004,UCBPlayer,111,351,462,28,22,UCBPlayer
18005,UCBPlayer,116,126,242,3,87,UCBPlayer
18006,UCBPlayer,122,347,469,32,21,UCBPlayer
18007,UCBPlayer,107,132,239,0,87,UCBPlayer
18008,UCBPlayer,132,337,469,35,22,UCBPlayer
18009,UCBPlayer,103,148,251,0,83,UCBPlayer
18010,UCBPlayer,136,321,457,35,26,UCBPlayer
18011,UCBPlayer,99,164,263,0,79,UCBPlayer
18012,UCBPlayer,140,305,445,35,30,UCBPlayer
18013,UCBPlayer,95,180,275,0,75,UCBPlayer
18014,UCBPlayer,144,289,433,35,34,UCBPlayer
18015,UCBPlayer,91,196,287,0,71,UCBPlayer
18016,UCBPlayer,148,273,421,35,38,UCBPlayer
18017,UCBPlayer,87,212,299,0,67,UCBPlayer
18018,UCBPlayer,152,257,409,35,42,UCBPlayer
18019,UCBPlayer,84,224,308,0,64,UCBPlayer
18020,UCBPlayer,146,251,397,32,45,UCBPlayer
18021,UCBPlayer,89,234,323,3,60,UCBPlayer
18022,UCBPlayer,138,243,381,28,49,UCBPlayer
18023,UCBPlayer,97,242,339,7,56,UCBPlayer
18024,UCBPlayer,130,235,365,24,53,UCBPlayer
18025,UCBPlayer,105,250,355,11,52,UCBPlayer
18026,UCBPlayer,122,227,349,20,57,UCBPlayer
18027,UCBPlayer,109,259,368,15,49,UCBPlayer
18028,UCBPlayer,118,218,336,16,60,UCBPlayer
18029,UCBPlayer,117,267,384,19,45,UCBPlayer
18030,UCBPlayer,110,210,320,12,64,UCBPlayer
18031,UCBPlayer,126,271,397,23,42,UCBPlayer
18032,UCBPlayer,105,210,315,10,65,UCBPlayer
18033,UCBPlayer,130,275,405,25,40,UCBPlayer
18034,UCBPlayer,105,210,315,10,65,UCBPlayer
18035,UCBPlayer,130,275,405,25,40,UCBPlayer
18036,UCBPlayer,106,206,312,10,66,UCBPlayer
18037,UCBPlayer,130,275,405,25,40,UCBPlayer
18038,UCBPlayer,105,210,315,10,65,UCBPlayer
18039,UCBPlayer,131,271,402,25,41,UCBPlayer
18040,UCBPlayer,105,210,315,10,65,UCBPlayer
18041,UCBPlayer,130,275,405,25,40,UCBPlayer
18042,UCBPlayer,105,210,315,10,65,UCBPlayer
18043,UCBPlayer,130,275,405,25,40,UCBPlayer
18044,UCBPlayer,103,203,306,10,68,UCBPlayer
18045,UCBPlayer,128,283,411,25,38,UCBPlayer
18046,UCBPlayer,111,186,297,10,71,UCBPlayer
18047,UCBPlayer,124,299,423,25,34,UCBPlayer
18048,UCBPlayer,115,170,285,10,75,UCBPlayer
18049,UCBPlayer,120,315,435,25,30,UCBPlayer
18050,UCBPlayer,119,154,273,10,79,UCBPlayer
18051,UCBPlayer,112,332,444,25,27,UCBPlayer
18052,UCBPlayer,127,137,264,10,82,UCBPlayer
18053,UCBPlayer,104,349,453,25,24,UCBPlayer
18054,UCBPlayer,126,126,252,7,85,Tie
18055,UCBPlayer,111,351,462,28,22,UCBPlayer
18056,UCBPlayer,116,126,242,3,87,UCBPlayer
18057,UCBPlayer,122,347,469,32,21,UCBPlayer
18058,UCBPlayer,107,132,239,0,87,UCBPlayer
18059,UCBPlayer,132,337,469,35,22,UCBPlayer
18060,UCBPlayer,103,148,251,0,83,UCBPlayer
18061,UCBPlayer,136,321,457,35,26,UCBPlayer
18062,UCBPlayer,99,164,263,0,79,UCBPlayer
18063,UCBPlayer,140,305,445,35,30,UCBPlayer
18064,UCBPlayer,95,180,275,0,75,UCBPlayer
18065,UCBPlayer,144,289,433,35,34,UCBPlayer
18066,UCBPlayer,91,196,287,0,71,UCBPlayer
18067,UCBPlayer,148,273,421,35,38,UCBPlayer
18068,UCBPlayer,87,212,299,0,67,UCBPlayer
18069,UCBPlayer,152,257,409,35,42,UCBPlayer
18070,UCBPlayer,84,224,308,0,64,UCBPlayer
18071,UCBPlayer,146,251,397,32,45,UCBPlayer
18072,UCBPlayer,89,234,323,3,60,UCBPlayer
18073,UCBPlayer,138,243,381,28,49,UCBPlayer
18074,UCBPlayer,97,242,339,7,56,UCBPlayer
18075,UCBPlayer,130,235,365,24,53,UCBPlayer
18076,UCBPlayer,105,250,355,11,52,UCBPlayer
18077,UCBPlayer,122,227,349,20,57,UCBPlayer
18078,UCBPlayer,109,259,368,15,49,UCBPlayer
18079,UCBPlayer,118,218,336,16,60,UCBPlayer
18080,UCBPlayer,117,267,384,19,45,UCBPlayer
18081,UCBPlayer,110,210,320,12,64,UCBPlayer
18082,UCBPlayer,126,271,397,23,42,UCBPlayer
18083,UCBPlayer,105,210,315,10,65,UCBPlayer
18084,UCBPlayer,130,275,405,25,40,UCBPlayer
18085,UCBPlayer,105,210,315,10,65,UCBPlayer
18086,UCBPlayer,130,275,405,25,40,UCBPlayer
18087,UCBPlayer,106,206,312,10,66,UCBPlayer
18088,UCBPlayer,130,275,405,25,40,UCBPlayer
18089,UCBPlayer,105,210,315,10,65,UCBPlayer
18090,UCBPlayer,131,271,402,25,41,UCBPlayer
18091,UCBPlayer,105,210,315,10,65,UCBPlayer
18092,UCBPlayer,130,275,405,25,40,UCBPlayer
18093,UCBPlayer,105,210,315,10,65,UCBPlayer
18094,UCBPlayer,130,275,405,25,40,UCBPlayer
18095,UCBPlayer,103,203,306,10,68,UCBPlayer
18096,UCBPlayer,128,283,411,25,38,UCBPlayer
18097,UCBPlayer,111,186,297,10,71,UCBPlayer
18098,UCBPlayer,124,299,423,25,34,UCBPlayer
18099,UCBPlayer,115,170,285,10,75,UCBPlayer
18100,UCBPlayer,120,315,435,25,30,UCBPlayer
18101,UCBPlayer,119,154,273,10,79,UCBPlayer
18102,UCBPlayer,112,332,444,25,27,UCBPlayer
18103,UCBPlayer,127,137,264,10,82,UCBPlayer
18104,UCBPlayer,104,349,453,25,24,UCBPlayer
18105,UCBPlayer,126,126,252,7,85,Tie
18106,UCBPlayer,111,351,462,28,22,UCBPlayer
18107,UCBPlayer,116,126,242,3,87,UCBPlayer
18108,UCBPlayer,122,347,469,32,21,UCBPlayer
18109,UCBPlayer,107,132,239,0,87,UCBPlayer
18110,UCBPlayer,132,337,469,35,22,UCBPlayer
18111,UCBPlayer,103,148,251,0,83,UCBPlayer
18112,UCBPlayer,136,321,457,35,26,UCBPlayer
18113,UCBPlayer,99,164,263,0,79,UCBPlayer
18114,UCBPlayer,140,305,445,35,30,UCBPlayer
18115,UCBPlayer,95,180,275,0,75,UCBPlayer
18116,UCBPlayer,144,289,433,35,34,UCBPlayer
18117,UCBPlayer,91,196,287,0,71,UCBPlayer
18118,UCBPlayer,148,273,421,35,38,UCBPlayer
18119,UCBPlayer,87,212,299,0,67,UCBPlayer
18120,UCBPlayer,152,257,409,35,42,UCBPlayer
18121,UCBPlayer,84,224,308,0,64,UCBPlayer
18122,UCBPlayer,146,251,397,32,45,UCBPlayer
18123,UCBPlayer,89,234,323,3,60,UCBPlayer
18124,UCBPlayer,138,243,381,28,49,UCBPlayer
18125,UCBPlayer,97,242,339,7,56,UCBPlayer
18126,UCBPlayer,130,235,365,24,53,UCBPlayer
18127,UCBPlayer,105,250,355,11,52,UCBPlayer
18128,UCBPlayer,122,227,349,20,57,UCBPlayer
18129,UCBPlayer,109,259,368,15,49,UCBPlayer
18130,UCBPlayer,118,218,336,16,60,UCBPlayer
18131,UCBPlayer,117,267,384,19,45,UCBPlayer
18132,UCBPlayer,110,210,320,12,64,UCBPlayer
18133,UCBPlayer,126,271,397,23,42,UCBPlayer
18134,UCBPlayer,105,210,315,10,65,UCBPlayer
18135,UCBPlayer,130,275,405,25,40,UCBPlayer
18136,UCBPlayer,105,210,315,10,65,UCBPlayer
18137,UCBPlayer,130,275,405,25,40,UCBPlayer
18138,UCBPlayer,106,206,312,10,66,UCBPlayer
18139,UCBPlayer,130,275,405,25,40,UCBPlayer
18140,UCBPlayer,105,210,315,10,65,UCBPlayer
18141,UCBPlayer,131,271,402,25,41,UCBPlayer
18142,UCBPlayer,105,210,315,10,65,UCBPlayer
18143,UCBPlayer,130,275,405,25,40,UCBPlayer
18144,UCBPlayer,105,210,315,10,65,UCBPlayer
18145,UCBPlayer,130,275,405,25,40,UCBPlayer
18146,UCBPlayer,103,203,306,10,68,UCBPlayer
18147,UCBPlayer,128,283,411,25,38,UCBPlayer
18148,UCBPlayer,111,186,297,10,71,UCBPlayer
18149,UCBPlayer,124,299,423,25,34,UCBPlayer
18150,UCBPlayer,115,170,285,10,75,UCBPlayer
18151,UCBPlayer,120,315,435,25,30,UCBPlayer
18152,UCBPlayer,119,154,273,10,79,UCBPlayer
18153,UCBPlayer,112,332,444,25,27,UCBPlayer
18154,UCBPlayer,127,137,264,10,82,UCBPlayer
18155,UCBPlayer,104,349,453,25,24,UCBPlayer
18156,UCBPlayer,126,126,252,7,85,Tie
18157,UCBPlayer,111,351,462,28,22,UCBPlayer
18158,UCBPlayer,116,126,242,3,87,UCBPlayer
18159,UCBPlayer,122,347,469,32,21,UCBPlayer
18160,UCBPlayer,107,132,239,0,87,UCBPlayer
18161,UCBPlayer,132,337,469,35,22,UCBPlayer
18162,UCBPlayer,103,148,251,0,83,UCBPlayer
18163,UCBPlayer,136,321,457,35,26,UCBPlayer
18164,UCBPlayer,99,164,263,0,79,UCBPlayer
18165,UCBPlayer,140,305,445,35,30,UCBPlayer
18166,UCBPlayer,95,180,275,0,75,UCBPlayer
18167,UCBPlayer,144,289,433,35,34,UCBPlayer
18168,UCBPlayer,91,196,287,0,71,UCBPlayer
18169,UCBPlayer,148,273,421,35,38,UCBPlayer
18170,UCBPlayer,87,212,299,0,67,UCBPlayer
18171,UCBPlayer,152,257,409,35,42,UCBPlayer
18172,UCBPlayer,84,224,308,0,64,UCBPlayer
18173,UCBPlayer,146,251,397,32,45,UCBPlayer
18174,UCBPlayer,89,234,323,3,60,UCBPlayer
18175,UCBPlayer,138,243,381,28,49,UCBPlayer
18176,UCBPlayer,97,242,339,7,56,UCBPlayer
18177,UCBPlayer,130,235,365,24,53,UCBPlayer
18178,UCBPlayer,105,250,355,11,52,UCBPlayer
18179,UCBPlayer,122,227,349,20,57,UCBPlayer
18180,UCBPlayer,109,259,368,15,49,UCBPlayer
18181,UCBPlayer,118,218,336,16,60,UCBPlayer
18182,UCBPlayer,117,267,384,19,45,UCBPlayer
18183,UCBPlayer,110,210,320,12,64,UCBPlayer
18184,UCBPlayer,126,271,397,23,42,UCBPlayer
18185,UCBPlayer,105,210,315,10,65,UCBPlayer
18186,UCBPlayer,130,275,405,25,40,UCBPlayer
18187,UCBPlayer,105,210,315,10,65,UCBPlayer
18188,UCBPlayer,130,275,405,25,40,UCBPlayer
18189,UCBPlayer,106,206,312,10,66,UCBPlayer
18190,UCBPlayer,130,275,405,25,40,UCBPlayer
18191,UCBPlayer,105,210,315,10,65,UCBPlayer
18192,UCBPlayer,131,271,402,25,41,UCBPlayer
18193,UCBPlayer,105,210,315,10,65,UCBPlayer
18194,UCBPlayer,130,275,405,25,40,UCBPlayer
18195,UCBPlayer,105,210,315,10,65,UCBPlayer
18196,UCBPlayer,130,275,405,25,40,UCBPlayer
18197,UCBPlayer,103,203,306,10,68,UCBPlayer
18198,UCBPlayer,128,283,411,25,38,UCBPlayer
18199,UCBPlayer,111,186,297,10,71,UCBPlayer
18200,UCBPlayer,124,299,423,25,34,UCBPlayer
18201,UCBPlayer,115,170,285,10,75,UCBPlayer
18202,UCBPlayer,120,315,435,25,30,UCBPlayer
18203,UCBPlayer,119,154,273,10,79,UCBPlayer
18204,UCBPlayer,112,332,444,25,27,UCBPlayer
18205,UCBPlayer,127,137,264,10,82,UCBPlayer
18206,UCBPlayer,104,349,453,25,24,UCBPlayer
18207,UCBPlayer,126,126,252,7,85,Tie
18208,UCBPlayer,111,351,462,28,22,UCBPlayer
18209,UCBPlayer,116,126,242,3,87,UCBPlayer
18210,UCBPlayer,122,347,469,32,21,UCBPlayer
18211,UCBPlayer,107,132,239,0,87,UCBPlayer
18212,UCBPlayer,132,337,469,35,22,UCBPlayer
18213,UCBPlayer,103,148,251,0,83,UCBPlayer
18214,UCBPlayer,136,321,457,35,26,UCBPlayer
18215,UCBPlayer,99,164,263,0,79,UCBPlayer
18216,UCBPlayer,140,305,445,35,30,UCBPlayer
18217,UCBPlayer,95,180,275,0,75,UCBPlayer
18218,UCBPlayer,144,289,433,35,34,UCBPlayer
18219,UCBPlayer,91,196,287,0,71,UCBPlayer
18220,UCBPlayer,148,273,421,35,38,UCBPlayer
18221,UCBPlayer,87,212,299,0,67,UCBPlayer
18222,UCBPlayer,152,257,409,35,42,UCBPlayer
18223,UCBPlayer,84,224,308,0,64,UCBPlayer
18224,UCBPlayer,146,251,397,32,45,UCBPlayer
18225,UCBPlayer,89,234,323,3,60,UCBPlayer
18226,UCBPlayer,138,243,381,28,49,UCBPlayer
18227,UCBPlayer,97,242,339,7,56,UCBPlayer
18228,UCBPlayer,130,235,365,24,53,UCBPlayer
18229,UCBPlayer,105,250,355,11,52,UCBPlayer
18230,UCBPlayer,122,227,349,20,57,UCBPlayer
18231,UCBPlayer,109,259,368,15,49,UCBPlayer
18232,UCBPlayer,118,218,336,16,60,UCBPlayer
18233,UCBPlayer,117,267,384,19,45,UCBPlayer
18234,UCBPlayer,110,210,320,12,64,UCBPlayer
18235,UCBPlayer,126,271,397,23,42,UCBPlayer
18236,UCBPlayer,105,210,315,10,65,UCBPlayer
18237,UCBPlayer,130,275,405,25,40,UCBPlayer
18238,UCBPlayer,105,210,315,10,65,UCBPlayer
18239,UCBPlayer,130,275,405,25,40,UCBPlayer
18240,UCBPlayer,106,206,312,10,66,UCBPlayer
18241,UCBPlayer,130,275,405,25,40,UCBPlayer
18242,UCBPlayer,105,210,315,10,65,UCBPlayer
18243,UCBPlayer,131,271,402,25,41,UCBPlayer
18244,UCBPlayer,105,210,315,10,65,UCBPlayer
18245,UCBPlayer,130,275,405,25,40,UCBPlayer
18246,UCBPlayer,105,210,315,10,65,UCBPlayer
18247,UCBPlayer,130,275,405,25,40,UCBPlayer
18248,UCBPlayer,103,203,306,10,68,UCBPlayer
18249,UCBPlayer,128,283,411,25,38,UCBPlayer
18250,UCBPlayer,111,186,297,10,71,UCBPlayer
18251,UCBPlayer,124,299,423,25,34,UCBPlayer
18252,UCBPlayer,115,170,285,10,75,UCBPlayer
18253,UCBPlayer,120,315,435,25,30,UCBPlayer
18254,UCBPlayer,119,154,273,10,79,UCBPlayer
18255,UCBPlayer,112,332,444,25,27,UCBPlayer
18256,UCBPlayer,127,137,264,10,82,UCBPlayer
18257,UCBPlayer,104,349,453,25,24,UCBPlayer
18258,UCBPlayer,126,126,252,7,85,Tie
18259,UCBPlayer,111,351,462,28,22,UCBPlayer
18260,UCBPlayer,116,126,242,3,87,UCBPlayer
18261,UCBPlayer,122,347,469,32,21,UCBPlayer
18262,UCBPlayer,107,132,239,0,87,UCBPlayer
18263,UCBPlayer,132,337,469,35,22,UCBPlayer
18264,UCBPlayer,103,148,251,0,83,UCBPlayer
18265,UCBPlayer,136,321,457,35,26,UCBPlayer
18266,UCBPlayer,99,164,263,0,79,UCBPlayer
18267,UCBPlayer,140,305,445,35,30,UCBPlayer
18268,UCBPlayer,95,180,275,0,75,UCBPlayer
18269,UCBPlayer,144,289,433,35,34,UCBPlayer
18270,UCBPlayer,91,196,287,0,71,UCBPlayer
18271,UCBPlayer,148,273,421,35,38,UCBPlayer
18272,UCBPlayer,87,212,299,0,67,UCBPlayer
18273,UCBPlayer,152,257,409,35,42,UCBPlayer
18274,UCBPlayer,84,224,308,0,64,UCBPlayer
18275,UCBPlayer,146,251,397,32,45,UCBPlayer
18276,UCBPlayer,89,234,323,3,60,UCBPlayer
18277,UCBPlayer,138,243,381,28,49,UCBPlayer
18278,UCBPlayer,97,242,339,7,56,UCBPlayer
18279,UCBPlayer,130,235,365,24,53,UCBPlayer
18280,UCBPlayer,105,250,355,11,52,UCBPlayer
18281,UCBPlayer,122,227,349,20,57,UCBPlayer
18282,UCBPlayer,109,259,368,15,49,UCBPlayer
18283,UCBPlayer,118,218,336,16,60,UCBPlayer
18284,UCBPlayer,117,267,384,19,45,UCBPlayer
18285,UCBPlayer,110,210,320,12,64,UCBPlayer
18286,UCBPlayer,126,271,397,23,42,UCBPlayer
18287,UCBPlayer,105,210,315,10,65,UCBPlayer
18288,UCBPlayer,130,275,405,25,40,UCBPlayer
18289,UCBPlayer,105,210,315,10,65,UCBPlayer
18290,UCBPlayer,130,275,405,25,40,UCBPlayer
18291,UCBPlayer,106,206,312,10,66,UCBPlayer
18292,UCBPlayer,130,275,405,25,40,UCBPlayer
18293,UCBPlayer,105,210,315,10,65,UCBPlayer
18294,UCBPlayer,131,271,402,25,41,UCBPlayer
18295,UCBPlayer,105,210,315,10,65,UCBPlayer
18296,UCBPlayer,130,275,405,25,40,UCBPlayer
18297,UCBPlayer,105,210,315,10,65,UCBPlayer
18298,UCBPlayer,130,275,405,25,40,UCBPlayer
18299,UCBPlayer,103,203,306,10,68,UCBPlayer
18300,UCBPlayer,128,283,411,25,38,UCBPlayer
18301,UCBPlayer,111,186,297,10,71,UCBPlayer
18302,UCBPlayer,124,299,423,25,34,UCBPlayer
18303,UCBPlayer,115,170,285,10,75,UCBPlayer
18304,UCBPlayer,120,315,435,25,30,UCBPlayer
18305,UCBPlayer,119,154,273,10,79,UCBPlayer
18306,UCBPlayer,112,332,444,25,27,UCBPlayer
18307,UCBPlayer,127,137,264,10,82,UCBPlayer
18308,UCBPlayer,104,349,453,25,24,UCBPlayer
18309,UCBPlayer,126,126,252,7,85,Tie
18310,UCBPlayer,111,351,462,28,22,UCBPlayer
18311,UCBPlayer,116,126,242,3,87,UCBPlayer
18312,UCBPlayer,122,347,469,32,21,UCBPlayer
18313,UCBPlayer,107,132,239,0,87,UCBPlayer
18314,UCBPlayer,132,337,469,35,22,UCBPlayer
18315,UCBPlayer,103,148,251,0,83,UCBPlayer
18316,UCBPlayer,136,321,457,35,26,UCBPlayer
18317,UCBPlayer,99,164,263,0,79,UCBPlayer
18318,UCBPlayer,140,305,445,35,30,UCBPlayer
18319,UCBPlayer,95,180,275,0,75,UCBPlayer
18320,UCBPlayer,144,289,433,35,34,UCBPlayer
18321,UCBPlayer,91,196,287,0,71,UCBPlayer
18322,UCBPlayer,148,273,421,35,38,UCBPlayer
18323,UCBPlayer,87,212,299,0,67,UCBPlayer
18324,UCBPlayer,152,257,409,35,42,UCBPlayer
18325,UCBPlayer,84,224,308,0,64,UCBPlayer
18326,UCBPlayer,146,251,397,32,45,UCBPlayer
18327,UCBPlayer,89,234,323,3,60,UCBPlayer
18328,UCBPlayer,138,243,381,28,49,UCBPlayer
18329,UCBPlayer,97,242,339,7,56,UCBPlayer
18330,UCBPlayer,130,235,365,24,53,UCBPlayer
18331,UCBPlayer,105,250,355,11,52,UCBPlayer
18332,UCBPlayer,122,227,349,20,57,UCBPlayer
18333,UCBPlayer,109,259,368,15,49,UCBPlayer
18334,UCBPlayer,118,218,336,16,60,UCBPlayer
18335,UCBPlayer,117,267,384,19,45,UCBPlayer
18336,UCBPlayer,110,210,320,12,64,UCBPlayer
18337,UCBPlayer,126,271,397,23,42,UCBPlayer
18338,UCBPlayer,105,210,315,10,65,UCBPlayer
18339,UCBPlayer,130,275,405,25,40,UCBPlayer
18340,UCBPlayer,105,210,315,10,65,UCBPlayer
18341,UCBPlayer,130,275,405,25,40,UCBPlayer
18342,UCBPlayer,106,206,312,10,66,UCBPlayer
18343,UCBPlayer,130,275,405,25,40,UCBPlayer
18344,UCBPlayer,105,210,315,10,65,UCBPlayer
18345,UCBPlayer,131,271,402,25,41,UCBPlayer
18346,UCBPlayer,105,210,315,10,65,UCBPlayer
18347,UCBPlayer,130,275,405,25,40,UCBPlayer
18348,UCBPlayer,105,210,315,10,65,UCBPlayer
18349,UCBPlayer,130,275,405,25,40,UCBPlayer
18350,UCBPlayer,103,203,306,10,68,UCBPlayer
18351,UCBPlayer,128,283,411,25,38,UCBPlayer
18352,UCBPlayer,111,186,297,10,71,UCBPlayer
18353,UCBPlayer,124,299,423,25,34,UCBPlayer
18354,UCBPlayer,115,170,285,10,75,UCBPlayer
18355,UCBPlayer,120,315,435,25,30,UCBPlayer
18356,UCBPlayer,119,154,273,10,79,UCBPlayer
18357,UCBPlayer,112,332,444,25,27,UCBPlayer
18358,UCBPlayer,127,137,264,10,82,UCBPlayer
18359,UCBPlayer,104,349,453,25,24,UCBPlayer
18360,UCBPlayer,126,126,252,7,85,Tie
18361,UCBPlayer,111,351,462,28,22,UCBPlayer
18362,UCBPlayer,116,126,242,3,87,UCBPlayer
18363,UCBPlayer,122,347,469,32,21,UCBPlayer
18364,UCBPlayer,107,132,239,0,87,UCBPlayer
18365,UCBPlayer,132,337,469,35,22,UCBPlayer
18366,UCBPlayer,103,148,251,0,83,UCBPlayer
18367,UCBPlayer,136,321,457,35,26,UCBPlayer
18368,UCBPlayer,99,164,263,0,79,UCBPlayer
18369,UCBPlayer,140,305,445,35,30,UCBPlayer
18370,UCBPlayer,95,180,275,0,75,UCBPlayer
18371,UCBPlayer,144,289,433,35,34,UCBPlayer
18372,UCBPlayer,91,196,287,0,71,UCBPlayer
18373,UCBPlayer,148,273,421,35,38,UCBPlayer
18374,UCBPlayer,87,212,299,0,67,UCBPlayer
18375,UCBPlayer,152,257,409,35,42,UCBPlayer
18376,UCBPlayer,84,224,308,0,64,UCBPlayer
18377,UCBPlayer,146,251,397,32,45,UCBPlayer
18378,UCBPlayer,89,234,323,3,60,UCBPlayer
18379,UCBPlayer,138,243,381,28,49,UCBPlayer
18380,UCBPlayer,97,242,339,7,56,UCBPlayer
18381,UCBPlayer,130,235,365,24,53,UCBPlayer
18382,UCBPlayer,105,250,355,11,52,UCBPlayer
18383,UCBPlayer,122,227,349,20,57,UCBPlayer
18384,UCBPlayer,109,259,368,15,49,UCBPlayer
18385,UCBPlayer,118,218,336,16,60,UCBPlayer
18386,UCBPlayer,117,267,384,19,45,UCBPlayer
18387,UCBPlayer,110,210,320,12,64,UCBPlayer
18388,UCBPlayer,126,271,397,23,42,UCBPlayer
18389,UCBPlayer,105,210,315,10,65,UCBPlayer
18390,UCBPlayer,130,275,405,25,40,UCBPlayer
18391,UCBPlayer,105,210,315,10,65,UCBPlayer
18392,UCBPlayer,130,275,405,25,40,UCBPlayer
18393,UCBPlayer,106,206,312,10,66,UCBPlayer
18394,UCBPlayer,130,275,405,25,40,UCBPlayer
18395,UCBPlayer,105,210,315,10,65,UCBPlayer
18396,UCBPlayer,131,271,402,25,41,UCBPlayer
18397,UCBPlayer,105,210,315,10,65,UCBPlayer
18398,UCBPlayer,130,275,405,25,40,UCBPlayer
18399,UCBPlayer,105,210,315,10,65,UCBPlayer
18400,UCBPlayer,130,275,405,25,40,UCBPlayer
18401,UCBPlayer,103,203,306,10,68,UCBPlayer
18402,UCBPlayer,128,283,411,25,38,UCBPlayer
18403,UCBPlayer,111,186,297,10,71,UCBPlayer
18404,UCBPlayer,124,299,423,25,34,UCBPlayer
18405,UCBPlayer,115,170,285,10,75,UCBPlayer
18406,UCBPlayer,120,315,435,25,30,UCBPlayer
18407,UCBPlayer,119,154,273,10,79,UCBPlayer
18408,UCBPlayer,112,332,444,25,27,UCBPlayer
18409,UCBPlayer,127,137,264,10,82,UCBPlayer
18410,UCBPlayer,104,349,453,25,24,UCBPlayer
18411,UCBPlayer,126,126,252,7,85,Tie
18412,UCBPlayer,111,351,462,28,22,UCBPlayer
18413,UCBPlayer,116,126,242,3,87,UCBPlayer
18414,UCBPlayer,122,347,469,32,21,UCBPlayer
18415,UCBPlayer,107,132,239,0,87,UCBPlayer
18416,UCBPlayer,132,337,469,35,22,UCBPlayer
18417,UCBPlayer,103,148,251,0,83,UCBPlayer
18418,UCBPlayer,136,321,457,35,26,UCBPlayer
18419,UCBPlayer,99,164,263,0,79,UCBPlayer
18420,UCBPlayer,140,305,445,35,30,UCBPlayer
18421,UCBPlayer,95,180,275,0,75,UCBPlayer
18422,UCBPlayer,144,289,433,35,34,UCBPlayer
18423,UCBPlayer,91,196,287,0,71,UCBPlayer
18424,UCBPlayer,148,273,421,35,38,UCBPlayer
18425,UCBPlayer,87,212,299,0,67,UCBPlayer
18426,UCBPlayer,152,257,409,35,42,UCBPlayer
18427,UCBPlayer,84,224,308,0,64,UCBPlayer
18428,UCBPlayer,146,251,397,32,45,UCBPlayer
18429,UCBPlayer,89,234,323,3,60,UCBPlayer
18430,UCBPlayer,138,243,381,28,49,UCBPlayer
18431,UCBPlayer,97,242,339,7,56,UCBPlayer
18432,UCBPlayer,130,235,365,24,53,UCBPlayer
18433,UCBPlayer,105,250,355,11,52,UCBPlayer
18434,UCBPlayer,122,227,349,20,57,UCBPlayer
18435,UCBPlayer,109,259,368,15,49,UCBPlayer
18436,UCBPlayer,118,218,336,16,60,UCBPlayer
18437,UCBPlayer,117,267,384,19,45,UCBPlayer
18438,UCBPlayer,110,210,320,12,64,UCBPlayer
18439,UCBPlayer,126,271,397,23,42,UCBPlayer
18440,UCBPlayer,105,210,315,10,65,UCBPlayer
18441,UCBPlayer,130,275,405,25,40,UCBPlayer
18442,UCBPlayer,105,210,315,10,65,UCBPlayer
18443,UCBPlayer,130,275,405,25,40,UCBPlayer
18444,UCBPlayer,106,206,312,10,66,UCBPlayer
18445,UCBPlayer,130,275,405,25,40,UCBPlayer
18446,UCBPlayer,105,210,315,10,65,UCBPlayer
18447,UCBPlayer,131,271,402,25,41,UCBPlayer
18448,UCBPlayer,105,210,315,10,65,UCBPlayer
18449,UCBPlayer,130,275,405,25,40,UCBPlayer
18450,UCBPlayer,105,210,315,10,65,UCBPlayer
18451,UCBPlayer,130,275,405,25,40,UCBPlayer
18452,UCBPlayer,103,203,306,10,68,UCBPlayer
18453,UCBPlayer,128,283,411,25,38,UCBPlayer
18454,UCBPlayer,111,186,297,10,71,UCBPlayer
18455,UCBPlayer,124,299,423,25,34,UCBPlayer
18456,UCBPlayer,115,170,285,10,75,UCBPlayer
18457,UCBPlayer,120,315,435,25,30,UCBPlayer
18458,UCBPlayer,119,154,273,10,79,UCBPlayer
18459,UCBPlayer,112,332,444,25,27,UCBPlayer
18460,UCBPlayer,127,137,264,10,82,UCBPlayer
18461,UCBPlayer,104,349,453,25,24,UCBPlayer
18462,UCBPlayer,126,126,252,7,85,Tie
18463,UCBPlayer,111,351,462,28,22,UCBPlayer
18464,UCBPlayer,116,126,242,3,87,UCBPlayer
18465,UCBPlayer,122,347,469,32,21,UCBPlayer
18466,UCBPlayer,107,132,239,0,87,UCBPlayer
18467,UCBPlayer,132,337,469,35,22,UCBPlayer
18468,UCBPlayer,103,148,251,0,83,UCBPlayer
18469,UCBPlayer,136,321,457,35,26,UCBPlayer
18470,UCBPlayer,99,164,263,0,79,UCBPlayer
18471,UCBPlayer,140,305,445,35,30,UCBPlayer
18472,UCBPlayer,95,180,275,0,75,UCBPlayer
18473,UCBPlayer,144,289,433,35,34,UCBPlayer
18474,UCBPlayer,91,196,287,0,71,UCBPlayer
18475,UCBPlayer,148,273,421,35,38,UCBPlayer
18476,UCBPlayer,87,212,299,0,67,UCBPlayer
18477,UCBPlayer,152,257,409,35,42,UCBPlayer
18478,UCBPlayer,84,224,308,0,64,UCBPlayer
18479,UCBPlayer,146,251,397,32,45,UCBPlayer
18480,UCBPlayer,89,234,323,3,60,UCBPlayer
18481,UCBPlayer,138,243,381,28,49,UCBPlayer
18482,UCBPlayer,97,242,339,7,56,UCBPlayer
18483,UCBPlayer,130,235,365,24,53,UCBPlayer
18484,UCBPlayer,105,250,355,11,52,UCBPlayer
18485,UCBPlayer,122,227,349,20,57,UCBPlayer
18486,UCBPlayer,109,259,368,15,49,UCBPlayer
18487,UCBPlayer,118,218,336,16,60,UCBPlayer
18488,UCBPlayer,117,267,384,19,45,UCBPlayer
18489,UCBPlayer,110,210,320,12,64,UCBPlayer
18490,UCBPlayer,126,271,397,23,42,UCBPlayer
18491,UCBPlayer,105,210,315,10,65,UCBPlayer
18492,UCBPlayer,130,275,405,25,40,UCBPlayer
18493,UCBPlayer,105,210,315,10,65,UCBPlayer
18494,UCBPlayer,130,275,405,25,40,UCBPlayer
18495,UCBPlayer,106,206,312,10,66,UCBPlayer
18496,UCBPlayer,130,275,405,25,40,UCBPlayer
18497,UCBPlayer,105,210,315,10,65,UCBPlayer
18498,UCBPlayer,131,271,402,25,41,UCBPlayer
18499,UCBPlayer,105,210,315,10,65,UCBPlayer
18500,UCBPlayer,130,275,405,25,40,UCBPlayer
18501,UCBPlayer,105,210,315,10,65,UCBPlayer
18502,UCBPlayer,130,275,405,25,40,UCBPlayer
18503,UCBPlayer,103,203,306,10,68,UCBPlayer
18504,UCBPlayer,128,283,411,25,38,UCBPlayer
18505,UCBPlayer,111,186,297,10,71,UCBPlayer
18506,UCBPlayer,124,299,423,25,34,UCBPlayer
18507,UCBPlayer,115,170,285,10,75,UCBPlayer
18508,UCBPlayer,120,315,435,25,30,UCBPlayer
18509,UCBPlayer,119,154,273,10,79,UCBPlayer
18510,UCBPlayer,112,332,444,25,27,UCBPlayer
18511,UCBPlayer,127,137,264,10,82,UCBPlayer
18512,UCBPlayer,104,349,453,25,24,UCBPlayer
18513,UCBPlayer,126,126,252,7,85,Tie
18514,UCBPlayer,111,351,462,28,22,UCBPlayer
18515,UCBPlayer,116,126,242,3,87,UCBPlayer
18516,UCBPlayer,122,347,469,32,21,UCBPlayer
18517,UCBPlayer,107,132,239,0,87,UCBPlayer
18518,UCBPlayer,132,337,469,35,22,UCBPlayer
18519,UCBPlayer,103,148,251,0,83,UCBPlayer
18520,UCBPlayer,136,321,457,35,26,UCBPlayer
18521,UCBPlayer,99,164,263,0,79,UCBPlayer
18522,UCBPlayer,140,305,445,35,30,UCBPlayer
18523,UCBPlayer,95,180,275,0,75,UCBPlayer
18524,UCBPlayer,144,289,433,35,34,UCBPlayer
18525,UCBPlayer,91,196,287,0,71,UCBPlayer
18526,UCBPlayer,148,273,421,35,38,UCBPlayer
18527,UCBPlayer,87,212,299,0,67,UCBPlayer
18528,UCBPlayer,152,257,409,35,42,UCBPlayer
18529,UCBPlayer,84,224,308,0,64,UCBPlayer
18530,UCBPlayer,146,251,397,32,45,UCBPlayer
18531,UCBPlayer,89,234,323,3,60,UCBPlayer
18532,UCBPlayer,138,243,381,28,49,UCBPlayer
18533,UCBPlayer,97,242,339,7,56,UCBPlayer
18534,UCBPlayer,130,235,365,24,53,UCBPlayer
18535,UCBPlayer,105,250,355,11,52,UCBPlayer
18536,UCBPlayer,122,227,349,20,57,UCBPlayer
18537,UCBPlayer,109,259,368,15,49,UCBPlayer
18538,UCBPlayer,118,218,336,16,60,UCBPlayer
18539,UCBPlayer,117,267,384,19,45,UCBPlayer
18540,UCBPlayer,110,210,320,12,64,UCBPlayer
18541,UCBPlayer,126,271,397,23,42,UCBPlayer
18542,UCBPlayer,105,210,315,10,65,UCBPlayer
18543,UCBPlayer,130,275,405,25,40,UCBPlayer
18544,UCBPlayer,105,210,315,10,65,UCBPlayer
18545,UCBPlayer,130,275,405,25,40,UCBPlayer
18546,UCBPlayer,106,206,312,10,66,UCBPlayer
18547,UCBPlayer,130,275,405,25,40,UCBPlayer
18548,UCBPlayer,105,210,315,10,65,UCBPlayer
18549,UCBPlayer,131,271,402,25,41,UCBPlayer
18550,UCBPlayer,105,210,315,10,65,UCBPlayer
18551,UCBPlayer,130,275,405,25,40,UCBPlayer
18552,UCBPlayer,105,210,315,10,65,UCBPlayer
18553,UCBPlayer,130,275,405,25,40,UCBPlayer
18554,UCBPlayer,103,203,306,10,68,UCBPlayer
18555,UCBPlayer,128,283,411,25,38,UCBPlayer
18556,UCBPlayer,111,186,297,10,71,UCBPlayer
18557,UCBPlayer,124,299,423,25,34,UCBPlayer
18558,UCBPlayer,115,170,285,10,75,UCBPlayer
18559,UCBPlayer,120,315,435,25,30,UCBPlayer
18560,UCBPlayer,119,154,273,10,79,UCBPlayer
18561,UCBPlayer,112,332,444,25,27,UCBPlayer
18562,UCBPlayer,127,137,264,10,82,UCBPlayer
18563,UCBPlayer,104,349,453,25,24,UCBPlayer
18564,UCBPlayer,126,126,252,7,85,Tie
18565,UCBPlayer,111,351,462,28,22,UCBPlayer
18566,UCBPlayer,116,126,242,3,87,UCBPlayer
18567,UCBPlayer,122,347,469,32,21,UCBPlayer
18568,UCBPlayer,107,132,239,0,87,UCBPlayer
18569,UCBPlayer,132,337,469,35,22,UCBPlayer
18570,UCBPlayer,103,148,251,0,83,UCBPlayer
18571,UCBPlayer,136,321,457,35,26,UCBPlayer
18572,UCBPlayer,99,164,263,0,79,UCBPlayer
18573,UCBPlayer,140,305,445,35,30,UCBPlayer
18574,UCBPlayer,95,180,275,0,75,UCBPlayer
18575,UCBPlayer,144,289,433,35,34,UCBPlayer
18576,UCBPlayer,91,196,287,0,71,UCBPlayer
18577,UCBPlayer,148,273,421,35,38,UCBPlayer
18578,UCBPlayer,87,212,299,0,67,UCBPlayer
18579,UCBPlayer,152,257,409,35,42,UCBPlayer
18580,UCBPlayer,84,224,308,0,64,UCBPlayer
18581,UCBPlayer,146,251,397,32,45,UCBPlayer
18582,UCBPlayer,89,234,323,3,60,UCBPlayer
18583,UCBPlayer,138,243,381,28,49,UCBPlayer
18584,UCBPlayer,97,242,339,7,56,UCBPlayer
18585,UCBPlayer,130,235,365,24,53,UCBPlayer
18586,UCBPlayer,105,250,355,11,52,UCBPlayer
18587,UCBPlayer,122,227,349,20,57,UCBPlayer
18588,UCBPlayer,109,259,368,15,49,UCBPlayer
18589,UCBPlayer,118,218,336,16,60,UCBPlayer
18590,UCBPlayer,117,267,384,19,45,UCBPlayer
18591,UCBPlayer,110,210,320,12,64,UCBPlayer
18592,UCBPlayer,126,271,397,23,42,UCBPlayer
18593,UCBPlayer,105,210,315,10,65,UCBPlayer
18594,UCBPlayer,130,275,405,25,40,UCBPlayer
18595,UCBPlayer,105,210,315,10,65,UCBPlayer
18596,UCBPlayer,130,275,405,25,40,UCBPlayer
18597,UCBPlayer,106,206,312,10,66,UCBPlayer
18598,UCBPlayer,130,275,405,25,40,UCBPlayer
18599,UCBPlayer,105,210,315,10,65,UCBPlayer
18600,UCBPlayer,131,271,402,25,41,UCBPlayer
18601,UCBPlayer,105,210,315,10,65,UCBPlayer
18602,UCBPlayer,130,275,405,25,40,UCBPlayer
18603,UCBPlayer,105,210,315,10,65,UCBPlayer
18604,UCBPlayer,130,275,405,25,40,UCBPlayer
18605,UCBPlayer,103,203,306,10,68,UCBPlayer
18606,UCBPlayer,128,283,411,25,38,UCBPlayer
18607,UCBPlayer,111,186,297,10,71,UCBPlayer
18608,UCBPlayer,124,299,423,25,34,UCBPlayer
18609,UCBPlayer,115,170,285,10,75,UCBPlayer
18610,UCBPlayer,120,315,435,25,30,UCBPlayer
18611,UCBPlayer,119,154,273,10,79,UCBPlayer
18612,UCBPlayer,112,332,444,25,27,UCBPlayer
18613,UCBPlayer,127,137,264,10,82,UCBPlayer
18614,UCBPlayer,104,349,453,25,24,UCBPlayer
18615,UCBPlayer,126,126,252,7,85,Tie
18616,UCBPlayer,111,351,462,28,22,UCBPlayer
18617,UCBPlayer,116,126,242,3,87,UCBPlayer
18618,UCBPlayer,122,347,469,32,21,UCBPlayer
18619,UCBPlayer,107,132,239,0,87,UCBPlayer
18620,UCBPlayer,132,337,469,35,22,UCBPlayer
18621,UCBPlayer,103,148,251,0,83,UCBPlayer
18622,UCBPlayer,136,321,457,35,26,UCBPlayer
18623,UCBPlayer,99,164,263,0,79,UCBPlayer
18624,UCBPlayer,140,305,445,35,30,UCBPlayer
18625,UCBPlayer,95,180,275,0,75,UCBPlayer
18626,UCBPlayer,144,289,433,35,34,UCBPlayer
18627,UCBPlayer,91,196,287,0,71,UCBPlayer
18628,UCBPlayer,148,273,421,35,38,UCBPlayer
18629,UCBPlayer,87,212,299,0,67,UCBPlayer
18630,UCBPlayer,152,257,409,35,42,UCBPlayer
18631,UCBPlayer,84,224,308,0,64,UCBPlayer
18632,UCBPlayer,146,251,397,32,45,UCBPlayer
18633,UCBPlayer,89,234,323,3,60,UCBPlayer
18634,UCBPlayer,138,243,381,28,49,UCBPlayer
18635,UCBPlayer,97,242,339,7,56,UCBPlayer
18636,UCBPlayer,130,235,365,24,53,UCBPlayer
18637,UCBPlayer,105,250,355,11,52,UCBPlayer
18638,UCBPlayer,122,227,349,20,57,UCBPlayer
18639,UCBPlayer,109,259,368,15,49,UCBPlayer
18640,UCBPlayer,118,218,336,16,60,UCBPlayer
18641,UCBPlayer,117,267,384,19,45,UCBPlayer
18642,UCBPlayer,110,210,320,12,64,UCBPlayer
18643,UCBPlayer,126,271,397,23,42,UCBPlayer
18644,UCBPlayer,105,210,315,10,65,UCBPlayer
18645,UCBPlayer,130,275,405,25,40,UCBPlayer
18646,UCBPlayer,105,210,315,10,65,UCBPlayer
18647,UCBPlayer,130,275,405,25,40,UCBPlayer
18648,UCBPlayer,106,206,312,10,66,UCBPlayer
18649,UCBPlayer,130,275,405,25,40,UCBPlayer
18650,UCBPlayer,105,210,315,10,65,UCBPlayer
18651,UCBPlayer,131,271,402,25,41,UCBPlayer
18652,UCBPlayer,105,210,315,10,65,UCBPlayer
18653,UCBPlayer,130,275,405,25,40,UCBPlayer
18654,UCBPlayer,105,210,315,10,65,UCBPlayer
18655,UCBPlayer,130,275,405,25,40,UCBPlayer
18656,UCBPlayer,103,203,306,10,68,UCBPlayer
18657,UCBPlayer,128,283,411,25,38,UCBPlayer
18658,UCBPlayer,111,186,297,10,71,UCBPlayer
18659,UCBPlayer,124,299,423,25,34,UCBPlayer
18660,UCBPlayer,115,170,285,10,75,UCBPlayer
18661,UCBPlayer,120,315,435,25,30,UCBPlayer
18662,UCBPlayer,119,154,273,10,79,UCBPlayer
18663,UCBPlayer,112,332,444,25,27,UCBPlayer
18664,UCBPlayer,127,137,264,10,82,UCBPlayer
18665,UCBPlayer,104,349,453,25,24,UCBPlayer
18666,UCBPlayer,126,126,252,7,85,Tie
18667,UCBPlayer,111,351,462,28,22,UCBPlayer
18668,UCBPlayer,116,126,242,3,87,UCBPlayer
18669,UCBPlayer,122,347,469,32,21,UCBPlayer
18670,UCBPlayer,107,132,239,0,87,UCBPlayer
18671,UCBPlayer,132,337,469,35,22,UCBPlayer
18672,UCBPlayer,103,148,251,0,83,UCBPlayer
18673,UCBPlayer,136,321,457,35,26,UCBPlayer
18674,UCBPlayer,99,164,263,0,79,UCBPlayer
18675,UCBPlayer,140,305,445,35,30,UCBPlayer
18676,UCBPlayer,95,180,275,0,75,UCBPlayer
18677,UCBPlayer,144,289,433,35,34,UCBPlayer
18678,UCBPlayer,91,196,287,0,71,UCBPlayer
18679,UCBPlayer,148,273,421,35,38,UCBPlayer
18680,UCBPlayer,87,212,299,0,67,UCBPlayer
18681,UCBPlayer,152,257,409,35,42,UCBPlayer
18682,UCBPlayer,84,224,308,0,64,UCBPlayer
18683,UCBPlayer,146,251,397,32,45,UCBPlayer
18684,UCBPlayer,89,234,323,3,60,UCBPlayer
18685,UCBPlayer,138,243,381,28,49,UCBPlayer
18686,UCBPlayer,97,242,339,7,56,UCBPlayer
18687,UCBPlayer,130,235,365,24,53,UCBPlayer
18688,UCBPlayer,105,250,355,11,52,UCBPlayer
18689,UCBPlayer,122,227,349,20,57,UCBPlayer
18690,UCBPlayer,109,259,368,15,49,UCBPlayer
18691,UCBPlayer,118,218,336,16,60,UCBPlayer
18692,UCBPlayer,117,267,384,19,45,UCBPlayer
18693,UCBPlayer,110,210,320,12,64,UCBPlayer
18694,UCBPlayer,126,271,397,23,42,UCBPlayer
18695,UCBPlayer,105,210,315,10,65,UCBPlayer
18696,UCBPlayer,130,275,405,25,40,UCBPlayer
18697,UCBPlayer,105,210,315,10,65,UCBPlayer
18698,UCBPlayer,130,275,405,25,40,UCBPlayer
18699,UCBPlayer,106,206,312,10,66,UCBPlayer
18700,UCBPlayer,130,275,405,25,40,UCBPlayer
18701,UCBPlayer,105,210,315,10,65,UCBPlayer
18702,UCBPlayer,131,271,402,25,41,UCBPlayer
18703,UCBPlayer,105,210,315,10,65,UCBPlayer
18704,UCBPlayer,130,275,405,25,40,UCBPlayer
18705,UCBPlayer,105,210,315,10,65,UCBPlayer
18706,UCBPlayer,130,275,405,25,40,UCBPlayer
18707,UCBPlayer,103,203,306,10,68,UCBPlayer
18708,UCBPlayer,128,283,411,25,38,UCBPlayer
18709,UCBPlayer,111,186,297,10,71,UCBPlayer
18710,UCBPlayer,124,299,423,25,34,UCBPlayer
18711,UCBPlayer,115,170,285,10,75,UCBPlayer
18712,UCBPlayer,120,315,435,25,30,UCBPlayer
18713,UCBPlayer,119,154,273,10,79,UCBPlayer
18714,UCBPlayer,112,332,444,25,27,UCBPlayer
18715,UCBPlayer,127,137,264,10,82,UCBPlayer
18716,UCBPlayer,104,349,453,25,24,UCBPlayer
18717,UCBPlayer,126,126,252,7,85,Tie
18718,UCBPlayer,111,351,462,28,22,UCBPlayer
18719,UCBPlayer,116,126,242,3,87,UCBPlayer
18720,UCBPlayer,122,347,469,32,21,UCBPlayer
18721,UCBPlayer,107,132,239,0,87,UCBPlayer
18722,UCBPlayer,132,337,469,35,22,UCBPlayer
18723,UCBPlayer,103,148,251,0,83,UCBPlayer
18724,UCBPlayer,136,321,457,35,26,UCBPlayer
18725,UCBPlayer,99,164,263,0,79,UCBPlayer
18726,UCBPlayer,140,305,445,35,30,UCBPlayer
18727,UCBPlayer,95,180,275,0,75,UCBPlayer
18728,UCBPlayer,144,289,433,35,34,UCBPlayer
18729,UCBPlayer,91,196,287,0,71,UCBPlayer
18730,UCBPlayer,148,273,421,35,38,UCBPlayer
18731,UCBPlayer,87,212,299,0,67,UCBPlayer
18732,UCBPlayer,152,257,409,35,42,UCBPlayer
18733,UCBPlayer,84,224,308,0,64,UCBPlayer
18734,UCBPlayer,146,251,397,32,45,UCBPlayer
18735,UCBPlayer,89,234,323,3,60,UCBPlayer
18736,UCBPlayer,138,243,381,28,49,UCBPlayer
18737,UCBPlayer,97,242,339,7,56,UCBPlayer
18738,UCBPlayer,130,235,365,24,53,UCBPlayer
18739,UCBPlayer,105,250,355,11,52,UCBPlayer
18740,UCBPlayer,122,227,349,20,57,UCBPlayer
18741,UCBPlayer,109,259,368,15,49,UCBPlayer
18742,UCBPlayer,118,218,336,16,60,UCBPlayer
18743,UCBPlayer,117,267,384,19,45,UCBPlayer
18744,UCBPlayer,110,210,320,12,64,UCBPlayer
18745,UCBPlayer,126,271,397,23,42,UCBPlayer
18746,UCBPlayer,105,210,315,10,65,UCBPlayer
18747,UCBPlayer,130,275,405,25,40,UCBPlayer
18748,UCBPlayer,105,210,315,10,65,UCBPlayer
18749,UCBPlayer,130,275,405,25,40,UCBPlayer
18750,UCBPlayer,106,206,312,10,66,UCBPlayer
18751,UCBPlayer,130,275,405,25,40,UCBPlayer
18752,UCBPlayer,105,210,315,10,65,UCBPlayer
18753,UCBPlayer,131,271,402,25,41,UCBPlayer
18754,UCBPlayer,105,210,315,10,65,UCBPlayer
18755,UCBPlayer,130,275,405,25,40,UCBPlayer
18756,UCBPlayer,105,210,315,10,65,UCBPlayer
18757,UCBPlayer,130,275,405,25,40,UCBPlayer
18758,UCBPlayer,103,203,306,10,68,UCBPlayer
18759,UCBPlayer,128,283,411,25,38,UCBPlayer
18760,UCBPlayer,111,186,297,10,71,UCBPlayer
18761,UCBPlayer,124,299,423,25,34,UCBPlayer
18762,UCBPlayer,115,170,285,10,75,UCBPlayer
18763,UCBPlayer,120,315,435,25,30,UCBPlayer
18764,UCBPlayer,119,154,273,10,79,UCBPlayer
18765,UCBPlayer,112,332,444,25,27,UCBPlayer
18766,UCBPlayer,127,137,264,10,82,UCBPlayer
18767,UCBPlayer,104,349,453,25,24,UCBPlayer
18768,UCBPlayer,126,126,252,7,85,Tie
18769,UCBPlayer,111,351,462,28,22,UCBPlayer
18770,UCBPlayer,116,126,242,3,87,UCBPlayer
18771,UCBPlayer,122,347,469,32,21,UCBPlayer
18772,UCBPlayer,107,132,239,0,87,UCBPlayer
18773,UCBPlayer,132,337,469,35,22,UCBPlayer
18774,UCBPlayer,103,148,251,0,83,UCBPlayer
18775,UCBPlayer,136,321,457,35,26,UCBPlayer
18776,UCBPlayer,99,164,263,0,79,UCBPlayer
18777,UCBPlayer,140,305,445,35,30,UCBPlayer
18778,UCBPlayer,95,180,275,0,75,UCBPlayer
18779,UCBPlayer,144,289,433,35,34,UCBPlayer
18780,UCBPlayer,91,196,287,0,71,UCBPlayer
18781,UCBPlayer,148,273,421,35,38,UCBPlayer
18782,UCBPlayer,87,212,299,0,67,UCBPlayer
18783,UCBPlayer,152,257,409,35,42,UCBPlayer
18784,UCBPlayer,84,224,308,0,64,UCBPlayer
18785,UCBPlayer,146,251,397,32,45,UCBPlayer
18786,UCBPlayer,89,234,323,3,60,UCBPlayer
18787,UCBPlayer,138,243,381,28,49,UCBPlayer
18788,UCBPlayer,97,242,339,7,56,UCBPlayer
18789,UCBPlayer,130,235,365,24,53,UCBPlayer
18790,UCBPlayer,105,250,355,11,52,UCBPlayer
18791,UCBPlayer,122,227,349,20,57,UCBPlayer
18792,UCBPlayer,109,259,368,15,49,UCBPlayer
18793,UCBPlayer,118,218,336,16,60,UCBPlayer
18794,UCBPlayer,117,267,384,19,45,UCBPlayer
18795,UCBPlayer,110,210,320,12,64,UCBPlayer
18796,UCBPlayer,126,271,397,23,42,UCBPlayer
18797,UCBPlayer,105,210,315,10,65,UCBPlayer
18798,UCBPlayer,130,275,405,25,40,UCBPlayer
18799,UCBPlayer,105,210,315,10,65,UCBPlayer
18800,UCBPlayer,130,275,405,25,40,UCBPlayer
18801,UCBPlayer,106,206,312,10,66,UCBPlayer
18802,UCBPlayer,130,275,405,25,40,UCBPlayer
18803,UCBPlayer,105,210,315,10,65,UCBPlayer
18804,UCBPlayer,131,271,402,25,41,UCBPlayer
18805,UCBPlayer,105,210,315,10,65,UCBPlayer
18806,UCBPlayer,130,275,405,25,40,UCBPlayer
18807,UCBPlayer,105,210,315,10,65,UCBPlayer
18808,UCBPlayer,130,275,405,25,40,UCBPlayer
18809,UCBPlayer,103,203,306,10,68,UCBPlayer
18810,UCBPlayer,128,283,411,25,38,UCBPlayer
18811,UCBPlayer,111,186,297,10,71,UCBPlayer
18812,UCBPlayer,124,299,423,25,34,UCBPlayer
18813,UCBPlayer,115,170,285,10,75,UCBPlayer
18814,UCBPlayer,120,315,435,25,30,UCBPlayer
18815,UCBPlayer,119,154,273,10,79,UCBPlayer
18816,UCBPlayer,112,332,444,25,27,UCBPlayer
18817,UCBPlayer,127,137,264,10,82,UCBPlayer
18818,UCBPlayer,104,349,453,25,24,UCBPlayer
18819,UCBPlayer,126,126,252,7,85,Tie
18820,UCBPlayer,111,351,462,28,22,UCBPlayer
18821,UCBPlayer,116,126,242,3,87,UCBPlayer
18822,UCBPlayer,122,347,469,32,21,UCBPlayer
18823,UCBPlayer,107,132,239,0,87,UCBPlayer
18824,UCBPlayer,132,337,469,35,22,UCBPlayer
18825,UCBPlayer,103,148,251,0,83,UCBPlayer
18826,UCBPlayer,136,321,457,35,26,UCBPlayer
18827,UCBPlayer,99,164,263,0,79,UCBPlayer
18828,UCBPlayer,140,305,445,35,30,UCBPlayer
18829,UCBPlayer,95,180,275,0,75,UCBPlayer
18830,UCBPlayer,144,289,433,35,34,UCBPlayer
18831,UCBPlayer,91,196,287,0,71,UCBPlayer
18832,UCBPlayer,148,273,421,35,38,UCBPlayer
18833,UCBPlayer,87,212,299,0,67,UCBPlayer
18834,UCBPlayer,152,257,409,35,42,UCBPlayer
18835,UCBPlayer,84,224,308,0,64,UCBPlayer
18836,UCBPlayer,146,251,397,32,45,UCBPlayer
18837,UCBPlayer,89,234,323,3,60,UCBPlayer
18838,UCBPlayer,138,243,381,28,49,UCBPlayer
18839,UCBPlayer,97,242,339,7,56,UCBPlayer
18840,UCBPlayer,130,235,365,24,53,UCBPlayer
18841,UCBPlayer,105,250,355,11,52,UCBPlayer
18842,UCBPlayer,122,227,349,20,57,UCBPlayer
18843,UCBPlayer,109,259,368,15,49,UCBPlayer
18844,UCBPlayer,118,218,336,16,60,UCBPlayer
18845,UCBPlayer,117,267,384,19,45,UCBPlayer
18846,UCBPlayer,110,210,320,12,64,UCBPlayer
18847,UCBPlayer,126,271,397,23,42,UCBPlayer
18848,UCBPlayer,105,210,315,10,65,UCBPlayer
18849,UCBPlayer,130,275,405,25,40,UCBPlayer
18850,UCBPlayer,105,210,315,10,65,UCBPlayer
18851,UCBPlayer,130,275,405,25,40,UCBPlayer
18852,UCBPlayer,106,206,312,10,66,UCBPlayer
18853,UCBPlayer,130,275,405,25,40,UCBPlayer
18854,UCBPlayer,105,210,315,10,65,UCBPlayer
18855,UCBPlayer,131,271,402,25,41,UCBPlayer
18856,UCBPlayer,105,210,315,10,65,UCBPlayer
18857,UCBPlayer,130,275,405,25,40,UCBPlayer
18858,UCBPlayer,105,210,315,10,65,UCBPlayer
18859,UCBPlayer,130,275,405,25,40,UCBPlayer
18860,UCBPlayer,103,203,306,10,68,UCBPlayer
18861,UCBPlayer,128,283,411,25,38,UCBPlayer
18862,UCBPlayer,111,186,297,10,71,UCBPlayer
18863,UCBPlayer,124,299,423,25,34,UCBPlayer
18864,UCBPlayer,115,170,285,10,75,UCBPlayer
18865,UCBPlayer,120,315,435,25,30,UCBPlayer
18866,UCBPlayer,119,154,273,10,79,UCBPlayer
18867,UCBPlayer,112,332,444,25,27,UCBPlayer
18868,UCBPlayer,127,137,264,10,82,UCBPlayer
18869,UCBPlayer,104,349,453,25,24,UCBPlayer
18870,UCBPlayer,126,126,252,7,85,Tie
18871,UCBPlayer,111,351,462,28,22,UCBPlayer
18872,UCBPlayer,116,126,242,3,87,UCBPlayer
18873,UCBPlayer,122,347,469,32,21,UCBPlayer
18874,UCBPlayer,107,132,239,0,87,UCBPlayer
18875,UCBPlayer,132,337,469,35,22,UCBPlayer
18876,UCBPlayer,103,148,251,0,83,UCBPlayer
18877,UCBPlayer,136,321,457,35,26,UCBPlayer
18878,UCBPlayer,99,164,263,0,79,UCBPlayer
18879,UCBPlayer,140,305,445,35,30,UCBPlayer
18880,UCBPlayer,95,180,275,0,75,UCBPlayer
18881,UCBPlayer,144,289,433,35,34,UCBPlayer
18882,UCBPlayer,91,196,287,0,71,UCBPlayer
18883,UCBPlayer,148,273,421,35,38,UCBPlayer
18884,UCBPlayer,87,212,299,0,67,UCBPlayer
18885,UCBPlayer,152,257,409,35,42,UCBPlayer
18886,UCBPlayer,84,224,308,0,64,UCBPlayer
18887,UCBPlayer,146,251,397,32,45,UCBPlayer
18888,UCBPlayer,89,234,323,3,60,UCBPlayer
18889,UCBPlayer,138,243,381,28,49,UCBPlayer
18890,UCBPlayer,97,242,339,7,56,UCBPlayer
18891,UCBPlayer,130,235,365,24,53,UCBPlayer
18892,UCBPlayer,105,250,355,11,52,UCBPlayer
18893,UCBPlayer,122,227,349,20,57,UCBPlayer
18894,UCBPlayer,109,259,368,15,49,UCBPlayer
18895,UCBPlayer,118,218,336,16,60,UCBPlayer
18896,UCBPlayer,117,267,384,19,45,UCBPlayer
18897,UCBPlayer,110,210,320,12,64,UCBPlayer
18898,UCBPlayer,126,271,397,23,42,UCBPlayer
18899,UCBPlayer,105,210,315,10,65,UCBPlayer
18900,UCBPlayer,130,275,405,25,40,UCBPlayer
18901,UCBPlayer,105,210,315,10,65,UCBPlayer
18902,UCBPlayer,130,275,405,25,40,UCBPlayer
18903,UCBPlayer,106,206,312,10,66,UCBPlayer
18904,UCBPlayer,130,275,405,25,40,UCBPlayer
18905,UCBPlayer,105,210,315,10,65,UCBPlayer
18906,UCBPlayer,131,271,402,25,41,UCBPlayer
18907,UCBPlayer,105,210,315,10,65,UCBPlayer
18908,UCBPlayer,130,275,405,25,40,UCBPlayer
18909,UCBPlayer,105,210,315,10,65,UCBPlayer
18910,UCBPlayer,130,275,405,25,40,UCBPlayer
18911,UCBPlayer,103,203,306,10,68,UCBPlayer
18912,UCBPlayer,128,283,411,25,38,UCBPlayer
18913,UCBPlayer,111,186,297,10,71,UCBPlayer
18914,UCBPlayer,124,299,423,25,34,UCBPlayer
18915,UCBPlayer,115,170,285,10,75,UCBPlayer
18916,UCBPlayer,120,315,435,25,30,UCBPlayer
18917,UCBPlayer,119,154,273,10,79,UCBPlayer
18918,UCBPlayer,112,332,444,25,27,UCBPlayer
18919,UCBPlayer,127,137,264,10,82,UCBPlayer
18920,UCBPlayer,104,349,453,25,24,UCBPlayer
18921,UCBPlayer,126,126,252,7,85,Tie
18922,UCBPlayer,111,351,462,28,22,UCBPlayer
18923,UCBPlayer,116,126,242,3,87,UCBPlayer
18924,UCBPlayer,122,347,469,32,21,UCBPlayer
18925,UCBPlayer,107,132,239,0,87,UCBPlayer
18926,UCBPlayer,132,337,469,35,22,UCBPlayer
18927,UCBPlayer,103,148,251,0,83,UCBPlayer
18928,UCBPlayer,136,321,457,35,26,UCBPlayer
18929,UCBPlayer,99,164,263,0,79,UCBPlayer
18930,UCBPlayer,140,305,445,35,30,UCBPlayer
18931,UCBPlayer,95,180,275,0,75,UCBPlayer
18932,UCBPlayer,144,289,433,35,34,UCBPlayer
18933,UCBPlayer,91,196,287,0,71,UCBPlayer
18934,UCBPlayer,148,273,421,35,38,UCBPlayer
18935,UCBPlayer,87,212,299,0,67,UCBPlayer
18936,UCBPlayer,152,257,409,35,42,UCBPlayer
18937,UCBPlayer,84,224,308,0,64,UCBPlayer
18938,UCBPlayer,146,251,397,32,45,UCBPlayer
18939,UCBPlayer,89,234,323,3,60,UCBPlayer
18940,UCBPlayer,138,243,381,28,49,UCBPlayer
18941,UCBPlayer,97,242,339,7,56,UCBPlayer
18942,UCBPlayer,130,235,365,24,53,UCBPlayer
18943,UCBPlayer,105,250,355,11,52,UCBPlayer
18944,UCBPlayer,122,227,349,20,57,UCBPlayer
18945,UCBPlayer,109,259,368,15,49,UCBPlayer
18946,UCBPlayer,118,218,336,16,60,UCBPlayer
18947,UCBPlayer,117,267,384,19,45,UCBPlayer
18948,UCBPlayer,110,210,320,12,64,UCBPlayer
18949,UCBPlayer,126,271,397,23,42,UCBPlayer
18950,UCBPlayer,105,210,315,10,65,UCBPlayer
18951,UCBPlayer,130,275,405,25,40,UCBPlayer
18952,UCBPlayer,105,210,315,10,65,UCBPlayer
18953,UCBPlayer,130,275,405,25,40,UCBPlayer
18954,UCBPlayer,106,206,312,10,66,UCBPlayer
18955,UCBPlayer,130,275,405,25,40,UCBPlayer
18956,UCBPlayer,105,210,315,10,65,UCBPlayer
18957,UCBPlayer,131,271,402,25,41,UCBPlayer
18958,UCBPlayer,105,210,315,10,65,UCBPlayer
18959,UCBPlayer,130,275,405,25,40,UCBPlayer
18960,UCBPlayer,105,210,315,10,65,UCBPlayer
18961,UCBPlayer,130,275,405,25,40,UCBPlayer
18962,UCBPlayer,103,203,306,10,68,UCBPlayer
18963,UCBPlayer,128,283,411,25,38,UCBPlayer
18964,UCBPlayer,111,186,297,10,71,UCBPlayer
18965,UCBPlayer,124,299,423,25,34,UCBPlayer
18966,UCBPlayer,115,170,285,10,75,UCBPlayer
18967,UCBPlayer,120,315,435,25,30,UCBPlayer
18968,UCBPlayer,119,154,273,10,79,UCBPlayer
18969,UCBPlayer,112,332,444,25,27,UCBPlayer
18970,UCBPlayer,127,137,264,10,82,UCBPlayer
18971,UCBPlayer,104,349,453,25,24,UCBPlayer
18972,UCBPlayer,126,126,252,7,85,Tie
18973,UCBPlayer,111,351,462,28,22,UCBPlayer
18974,UCBPlayer,116,126,242,3,87,UCBPlayer
18975,UCBPlayer,122,347,469,32,21,UCBPlayer
18976,UCBPlayer,107,132,239,0,87,UCBPlayer
18977,UCBPlayer,132,337,469,35,22,UCBPlayer
18978,UCBPlayer,103,148,251,0,83,UCBPlayer
18979,UCBPlayer,136,321,457,35,26,UCBPlayer
18980,UCBPlayer,99,164,263,0,79,UCBPlayer
18981,UCBPlayer,140,305,445,35,30,UCBPlayer
18982,UCBPlayer,95,180,275,0,75,UCBPlayer
18983,UCBPlayer,144,289,433,35,34,UCBPlayer
18984,UCBPlayer,91,196,287,0,71,UCBPlayer
18985,UCBPlayer,148,273,421,35,38,UCBPlayer
18986,UCBPlayer,87,212,299,0,67,UCBPlayer
18987,UCBPlayer,152,257,409,35,42,UCBPlayer
18988,UCBPlayer,84,224,308,0,64,UCBPlayer
18989,UCBPlayer,146,251,397,32,45,UCBPlayer
18990,UCBPlayer,89,234,323,3,60,UCBPlayer
18991,UCBPlayer,138,243,381,28,49,UCBPlayer
18992,UCBPlayer,97,242,339,7,56,UCBPlayer
18993,UCBPlayer,130,235,365,24,53,UCBPlayer
18994,UCBPlayer,105,250,355,11,52,UCBPlayer
18995,UCBPlayer,122,227,349,20,57,UCBPlayer
18996,UCBPlayer,109,259,368,15,49,UCBPlayer
18997,UCBPlayer,118,218,336,16,60,UCBPlayer
18998,UCBPlayer,117,267,384,19,45,UCBPlayer
18999,UCBPlayer,110,210,320,12,64,UCBPlayer
19000,UCBPlayer,126,271,397,23,42,UCBPlayer
19001,UCBPlayer,105,210,315,10,65,UCBPlayer
19002,UCBPlayer,130,275,405,25,40,UCBPlayer
19003,UCBPlayer,105,210,315,10,65,UCBPlayer
19004,UCBPlayer,130,275,405,25,40,UCBPlayer
19005,UCBPlayer,106,206,312,10,66,UCBPlayer
19006,UCBPlayer,130,275,405,25,40,UCBPlayer
19007,UCBPlayer,105,210,315,10,65,UCBPlayer
19008,UCBPlayer,131,271,402,25,41,UCBPlayer
19009,UCBPlayer,105,210,315,10,65,UCBPlayer
19010,UCBPlayer,130,275,405,25,40,UCBPlayer
19011,UCBPlayer,105,210,315,10,65,UCBPlayer
19012,UCBPlayer,130,275,405,25,40,UCBPlayer
19013,UCBPlayer,103,203,306,10,68,UCBPlayer
19014,UCBPlayer,128,283,411,25,38,UCBPlayer
19015,UCBPlayer,111,186,297,10,71,UCBPlayer
19016,UCBPlayer,124,299,423,25,34,UCBPlayer
19017,UCBPlayer,115,170,285,10,75,UCBPlayer
19018,UCBPlayer,120,315,435,25,30,UCBPlayer
19019,UCBPlayer,119,154,273,10,79,UCBPlayer
19020,UCBPlayer,112,332,444,25,27,UCBPlayer
19021,UCBPlayer,127,137,264,10,82,UCBPlayer
19022,UCBPlayer,104,349,453,25,24,UCBPlayer
19023,UCBPlayer,126,126,252,7,85,Tie
19024,UCBPlayer,111,351,462,28,22,UCBPlayer
19025,UCBPlayer,116,126,242,3,87,UCBPlayer
19026,UCBPlayer,122,347,469,32,21,UCBPlayer
19027,UCBPlayer,107,132,239,0,87,UCBPlayer
19028,UCBPlayer,132,337,469,35,22,UCBPlayer
19029,UCBPlayer,103,148,251,0,83,UCBPlayer
19030,UCBPlayer,136,321,457,35,26,UCBPlayer
19031,UCBPlayer,99,164,263,0,79,UCBPlayer
19032,UCBPlayer,140,305,445,35,30,UCBPlayer
19033,UCBPlayer,95,180,275,0,75,UCBPlayer
19034,UCBPlayer,144,289,433,35,34,UCBPlayer
19035,UCBPlayer,91,196,287,0,71,UCBPlayer
19036,UCBPlayer,148,273,421,35,38,UCBPlayer
19037,UCBPlayer,87,212,299,0,67,UCBPlayer
19038,UCBPlayer,152,257,409,35,42,UCBPlayer
19039,UCBPlayer,84,224,308,0,64,UCBPlayer
19040,UCBPlayer,146,251,397,32,45,UCBPlayer
19041,UCBPlayer,89,234,323,3,60,UCBPlayer
19042,UCBPlayer,138,243,381,28,49,UCBPlayer
19043,UCBPlayer,97,242,339,7,56,UCBPlayer
19044,UCBPlayer,130,235,365,24,53,UCBPlayer
19045,UCBPlayer,105,250,355,11,52,UCBPlayer
19046,UCBPlayer,122,227,349,20,57,UCBPlayer
19047,UCBPlayer,109,259,368,15,49,UCBPlayer
19048,UCBPlayer,118,218,336,16,60,UCBPlayer
19049,UCBPlayer,117,267,384,19,45,UCBPlayer
19050,UCBPlayer,110,210,320,12,64,UCBPlayer
19051,UCBPlayer,126,271,397,23,42,UCBPlayer
19052,UCBPlayer,105,210,315,10,65,UCBPlayer
19053,UCBPlayer,130,275,405,25,40,UCBPlayer
19054,UCBPlayer,105,210,315,10,65,UCBPlayer
19055,UCBPlayer,130,275,405,25,40,UCBPlayer
19056,UCBPlayer,106,206,312,10,66,UCBPlayer
19057,UCBPlayer,130,275,405,25,40,UCBPlayer
19058,UCBPlayer,105,210,315,10,65,UCBPlayer
19059,UCBPlayer,131,271,402,25,41,UCBPlayer
19060,UCBPlayer,105,210,315,10,65,UCBPlayer
19061,UCBPlayer,130,275,405,25,40,UCBPlayer
19062,UCBPlayer,105,210,315,10,65,UCBPlayer
19063,UCBPlayer,130,275,405,25,40,UCBPlayer
19064,UCBPlayer,103,203,306,10,68,UCBPlayer
19065,UCBPlayer,128,283,411,25,38,UCBPlayer
19066,UCBPlayer,111,186,297,10,71,UCBPlayer
19067,UCBPlayer,124,299,423,25,34,UCBPlayer
19068,UCBPlayer,115,170,285,10,75,UCBPlayer
19069,UCBPlayer,120,315,435,25,30,UCBPlayer
19070,UCBPlayer,119,154,273,10,79,UCBPlayer
19071,UCBPlayer,112,332,444,25,27,UCBPlayer
19072,UCBPlayer,127,137,264,10,82,UCBPlayer
19073,UCBPlayer,104,349,453,25,24,UCBPlayer
19074,UCBPlayer,126,126,252,7,85,Tie
19075,UCBPlayer,111,351,462,28,22,UCBPlayer
19076,UCBPlayer,116,126,242,3,87,UCBPlayer
19077,UCBPlayer,122,347,469,32,21,UCBPlayer
19078,UCBPlayer,107,132,239,0,87,UCBPlayer
19079,UCBPlayer,132,337,469,35,22,UCBPlayer
19080,UCBPlayer,103,148,251,0,83,UCBPlayer
19081,UCBPlayer,136,321,457,35,26,UCBPlayer
19082,UCBPlayer,99,164,263,0,79,UCBPlayer
19083,UCBPlayer,140,305,445,35,30,UCBPlayer
19084,UCBPlayer,95,180,275,0,75,UCBPlayer
19085,UCBPlayer,144,289,433,35,34,UCBPlayer
19086,UCBPlayer,91,196,287,0,71,UCBPlayer
19087,UCBPlayer,148,273,421,35,38,UCBPlayer
19088,UCBPlayer,87,212,299,0,67,UCBPlayer
19089,UCBPlayer,152,257,409,35,42,UCBPlayer
19090,UCBPlayer,84,224,308,0,64,UCBPlayer
19091,UCBPlayer,146,251,397,32,45,UCBPlayer
19092,UCBPlayer,89,234,323,3,60,UCBPlayer
19093,UCBPlayer,138,243,381,28,49,UCBPlayer
19094,UCBPlayer,97,242,339,7,56,UCBPlayer
19095,UCBPlayer,130,235,365,24,53,UCBPlayer
19096,UCBPlayer,105,250,355,11,52,UCBPlayer
19097,UCBPlayer,122,227,349,20,57,UCBPlayer
19098,UCBPlayer,109,259,368,15,49,UCBPlayer
19099,UCBPlayer,118,218,336,16,60,UCBPlayer
19100,UCBPlayer,117,267,384,19,45,UCBPlayer
19101,UCBPlayer,110,210,320,12,64,UCBPlayer
19102,UCBPlayer,126,271,397,23,42,UCBPlayer
19103,UCBPlayer,105,210,315,10,65,UCBPlayer
19104,UCBPlayer,130,275,405,25,40,UCBPlayer
19105,UCBPlayer,105,210,315,10,65,UCBPlayer
19106,UCBPlayer,130,275,405,25,40,UCBPlayer
19107,UCBPlayer,106,206,312,10,66,UCBPlayer
19108,UCBPlayer,130,275,405,25,40,UCBPlayer
19109,UCBPlayer,105,210,315,10,65,UCBPlayer
19110,UCBPlayer,131,271,402,25,41,UCBPlayer
19111,UCBPlayer,105,210,315,10,65,UCBPlayer
19112,UCBPlayer,130,275,405,25,40,UCBPlayer
19113,UCBPlayer,105,210,315,10,65,UCBPlayer
19114,UCBPlayer,130,275,405,25,40,UCBPlayer
19115,UCBPlayer,103,203,306,10,68,UCBPlayer
19116,UCBPlayer,128,283,411,25,38,UCBPlayer
19117,UCBPlayer,111,186,297,10,71,UCBPlayer
19118,UCBPlayer,124,299,423,25,34,UCBPlayer
19119,UCBPlayer,115,170,285,10,75,UCBPlayer
19120,UCBPlayer,120,315,435,25,30,UCBPlayer
19121,UCBPlayer,119,154,273,10,79,UCBPlayer
19122,UCBPlayer,112,332,444,25,27,UCBPlayer
19123,UCBPlayer,127,137,264,10,82,UCBPlayer
19124,UCBPlayer,104,349,453,25,24,UCBPlayer
19125,UCBPlayer,126,126,252,7,85,Tie
19126,UCBPlayer,111,351,462,28,22,UCBPlayer
19127,UCBPlayer,116,126,242,3,87,UCBPlayer
19128,UCBPlayer,122,347,469,32,21,UCBPlayer
19129,UCBPlayer,107,132,239,0,87,UCBPlayer
19130,UCBPlayer,132,337,469,35,22,UCBPlayer
19131,UCBPlayer,103,148,251,0,83,UCBPlayer
19132,UCBPlayer,136,321,457,35,26,UCBPlayer
19133,UCBPlayer,99,164,263,0,79,UCBPlayer
19134,UCBPlayer,140,305,445,35,30,UCBPlayer
19135,UCBPlayer,95,180,275,0,75,UCBPlayer
19136,UCBPlayer,144,289,433,35,34,UCBPlayer
19137,UCBPlayer,91,196,287,0,71,UCBPlayer
19138,UCBPlayer,148,273,421,35,38,UCBPlayer
19139,UCBPlayer,87,212,299,0,67,UCBPlayer
19140,UCBPlayer,152,257,409,35,42,UCBPlayer
19141,UCBPlayer,84,224,308,0,64,UCBPlayer
19142,UCBPlayer,146,251,397,32,45,UCBPlayer
19143,UCBPlayer,89,234,323,3,60,UCBPlayer
19144,UCBPlayer,138,243,381,28,49,UCBPlayer
19145,UCBPlayer,97,242,339,7,56,UCBPlayer
19146,UCBPlayer,130,235,365,24,53,UCBPlayer
19147,UCBPlayer,105,250,355,11,52,UCBPlayer
19148,UCBPlayer,122,227,349,20,57,UCBPlayer
19149,UCBPlayer,109,259,368,15,49,UCBPlayer
19150,UCBPlayer,118,218,336,16,60,UCBPlayer
19151,UCBPlayer,117,267,384,19,45,UCBPlayer
19152,UCBPlayer,110,210,320,12,64,UCBPlayer
19153,UCBPlayer,126,271,397,23,42,UCBPlayer
19154,UCBPlayer,105,210,315,10,65,UCBPlayer
19155,UCBPlayer,130,275,405,25,40,UCBPlayer
19156,UCBPlayer,105,210,315,10,65,UCBPlayer
19157,UCBPlayer,130,275,405,25,40,UCBPlayer
19158,UCBPlayer,106,206,312,10,66,UCBPlayer
19159,UCBPlayer,130,275,405,25,40,UCBPlayer
19160,UCBPlayer,105,210,315,10,65,UCBPlayer
19161,UCBPlayer,131,271,402,25,41,UCBPlayer
19162,UCBPlayer,105,210,315,10,65,UCBPlayer
19163,UCBPlayer,130,275,405,25,40,UCBPlayer
19164,UCBPlayer,105,210,315,10,65,UCBPlayer
19165,UCBPlayer,130,275,405,25,40,UCBPlayer
19166,UCBPlayer,103,203,306,10,68,UCBPlayer
19167,UCBPlayer,128,283,411,25,38,UCBPlayer
19168,UCBPlayer,111,186,297,10,71,UCBPlayer
19169,UCBPlayer,124,299,423,25,34,UCBPlayer
19170,UCBPlayer,115,170,285,10,75,UCBPlayer
19171,UCBPlayer,120,315,435,25,30,UCBPlayer
19172,UCBPlayer,119,154,273,10,79,UCBPlayer
19173,UCBPlayer,112,332,444,25,27,UCBPlayer
19174,UCBPlayer,127,137,264,10,82,UCBPlayer
19175,UCBPlayer,104,349,453,25,24,UCBPlayer
19176,UCBPlayer,126,126,252,7,85,Tie
19177,UCBPlayer,111,351,462,28,22,UCBPlayer
19178,UCBPlayer,116,126,242,3,87,UCBPlayer
19179,UCBPlayer,122,347,469,32,21,UCBPlayer
19180,UCBPlayer,107,132,239,0,87,UCBPlayer
19181,UCBPlayer,132,337,469,35,22,UCBPlayer
19182,UCBPlayer,103,148,251,0,83,UCBPlayer
19183,UCBPlayer,136,321,457,35,26,UCBPlayer
19184,UCBPlayer,99,164,263,0,79,UCBPlayer
19185,UCBPlayer,140,305,445,35,30,UCBPlayer
19186,UCBPlayer,95,180,275,0,75,UCBPlayer
19187,UCBPlayer,144,289,433,35,34,UCBPlayer
19188,UCBPlayer,91,196,287,0,71,UCBPlayer
19189,UCBPlayer,148,273,421,35,38,UCBPlayer
19190,UCBPlayer,87,212,299,0,67,UCBPlayer
19191,UCBPlayer,152,257,409,35,42,UCBPlayer
19192,UCBPlayer,84,224,308,0,64,UCBPlayer
19193,UCBPlayer,146,251,397,32,45,UCBPlayer
19194,UCBPlayer,89,234,323,3,60,UCBPlayer
19195,UCBPlayer,138,243,381,28,49,UCBPlayer
19196,UCBPlayer,97,242,339,7,56,UCBPlayer
19197,UCBPlayer,130,235,365,24,53,UCBPlayer
19198,UCBPlayer,105,250,355,11,52,UCBPlayer
19199,UCBPlayer,122,227,349,20,57,UCBPlayer
19200,UCBPlayer,109,259,368,15,49,UCBPlayer
19201,UCBPlayer,118,218,336,16,60,UCBPlayer
19202,UCBPlayer,117,267,384,19,45,UCBPlayer
19203,UCBPlayer,110,210,320,12,64,UCBPlayer
19204,UCBPlayer,126,271,397,23,42,UCBPlayer
19205,UCBPlayer,105,210,315,10,65,UCBPlayer
19206,UCBPlayer,130,275,405,25,40,UCBPlayer
19207,UCBPlayer,105,210,315,10,65,UCBPlayer
19208,UCBPlayer,130,275,405,25,40,UCBPlayer
19209,UCBPlayer,106,206,312,10,66,UCBPlayer
19210,UCBPlayer,130,275,405,25,40,UCBPlayer
19211,UCBPlayer,105,210,315,10,65,UCBPlayer
19212,UCBPlayer,131,271,402,25,41,UCBPlayer
19213,UCBPlayer,105,210,315,10,65,UCBPlayer
19214,UCBPlayer,130,275,405,25,40,UCBPlayer
19215,UCBPlayer,105,210,315,10,65,UCBPlayer
19216,UCBPlayer,130,275,405,25,40,UCBPlayer
19217,UCBPlayer,103,203,306,10,68,UCBPlayer
19218,UCBPlayer,128,283,411,25,38,UCBPlayer
19219,UCBPlayer,111,186,297,10,71,UCBPlayer
19220,UCBPlayer,124,299,423,25,34,UCBPlayer
19221,UCBPlayer,115,170,285,10,75,UCBPlayer
19222,UCBPlayer,120,315,435,25,30,UCBPlayer
19223,UCBPlayer,119,154,273,10,79,UCBPlayer
19224,UCBPlayer,112,332,444,25,27,UCBPlayer
19225,UCBPlayer,127,137,264,10,82,UCBPlayer
19226,UCBPlayer,104,349,453,25,24,UCBPlayer
19227,UCBPlayer,126,126,252,7,85,Tie
19228,UCBPlayer,111,351,462,28,22,UCBPlayer
19229,UCBPlayer,116,126,242,3,87,UCBPlayer
19230,UCBPlayer,122,347,469,32,21,UCBPlayer
19231,UCBPlayer,107,132,239,0,87,UCBPlayer
19232,UCBPlayer,132,337,469,35,22,UCBPlayer
19233,UCBPlayer,103,148,251,0,83,UCBPlayer
19234,UCBPlayer,136,321,457,35,26,UCBPlayer
19235,UCBPlayer,99,164,263,0,79,UCBPlayer
19236,UCBPlayer,140,305,445,35,30,UCBPlayer
19237,UCBPlayer,95,180,275,0,75,UCBPlayer
19238,UCBPlayer,144,289,433,35,34,UCBPlayer
19239,UCBPlayer,91,196,287,0,71,UCBPlayer
19240,UCBPlayer,148,273,421,35,38,UCBPlayer
19241,UCBPlayer,87,212,299,0,67,UCBPlayer
19242,UCBPlayer,152,257,409,35,42,UCBPlayer
19243,UCBPlayer,84,224,308,0,64,UCBPlayer
19244,UCBPlayer,146,251,397,32,45,UCBPlayer
19245,UCBPlayer,89,234,323,3,60,UCBPlayer
19246,UCBPlayer,138,243,381,28,49,UCBPlayer
19247,UCBPlayer,97,242,339,7,56,UCBPlayer
19248,UCBPlayer,130,235,365,24,53,UCBPlayer
19249,UCBPlayer,105,250,355,11,52,UCBPlayer
19250,UCBPlayer,122,227,349,20,57,UCBPlayer
19251,UCBPlayer,109,259,368,15,49,UCBPlayer
19252,UCBPlayer,118,218,336,16,60,UCBPlayer
19253,UCBPlayer,117,267,384,19,45,UCBPlayer
19254,UCBPlayer,110,210,320,12,64,UCBPlayer
19255,UCBPlayer,126,271,397,23,42,UCBPlayer
19256,UCBPlayer,105,210,315,10,65,UCBPlayer
19257,UCBPlayer,130,275,405,25,40,UCBPlayer
19258,UCBPlayer,105,210,315,10,65,UCBPlayer
19259,UCBPlayer,130,275,405,25,40,UCBPlayer
19260,UCBPlayer,106,206,312,10,66,UCBPlayer
19261,UCBPlayer,130,275,405,25,40,UCBPlayer
19262,UCBPlayer,105,210,315,10,65,UCBPlayer
19263,UCBPlayer,131,271,402,25,41,UCBPlayer
19264,UCBPlayer,105,210,315,10,65,UCBPlayer
19265,UCBPlayer,130,275,405,25,40,UCBPlayer
19266,UCBPlayer,105,210,315,10,65,UCBPlayer
19267,UCBPlayer,130,275,405,25,40,UCBPlayer
19268,UCBPlayer,103,203,306,10,68,UCBPlayer
19269,UCBPlayer,128,283,411,25,38,UCBPlayer
19270,UCBPlayer,111,186,297,10,71,UCBPlayer
19271,UCBPlayer,124,299,423,25,34,UCBPlayer
19272,UCBPlayer,115,170,285,10,75,UCBPlayer
19273,UCBPlayer,120,315,435,25,30,UCBPlayer
19274,UCBPlayer,119,154,273,10,79,UCBPlayer
19275,UCBPlayer,112,332,444,25,27,UCBPlayer
19276,UCBPlayer,127,137,264,10,82,UCBPlayer
19277,UCBPlayer,104,349,453,25,24,UCBPlayer
19278,UCBPlayer,126,126,252,7,85,Tie
19279,UCBPlayer,111,351,462,28,22,UCBPlayer
19280,UCBPlayer,116,126,242,3,87,UCBPlayer
19281,UCBPlayer,122,347,469,32,21,UCBPlayer
19282,UCBPlayer,107,132,239,0,87,UCBPlayer
19283,UCBPlayer,132,337,469,35,22,UCBPlayer
19284,UCBPlayer,103,148,251,0,83,UCBPlayer
19285,UCBPlayer,136,321,457,35,26,UCBPlayer
19286,UCBPlayer,99,164,263,0,79,UCBPlayer
19287,UCBPlayer,140,305,445,35,30,UCBPlayer
19288,UCBPlayer,95,180,275,0,75,UCBPlayer
19289,UCBPlayer,144,289,433,35,34,UCBPlayer
19290,UCBPlayer,91,196,287,0,71,UCBPlayer
19291,UCBPlayer,148,273,421,35,38,UCBPlayer
19292,UCBPlayer,87,212,299,0,67,UCBPlayer
19293,UCBPlayer,152,257,409,35,42,UCBPlayer
19294,UCBPlayer,84,224,308,0,64,UCBPlayer
19295,UCBPlayer,146,251,397,32,45,UCBPlayer
19296,UCBPlayer,89,234,323,3,60,UCBPlayer
19297,UCBPlayer,138,243,381,28,49,UCBPlayer
19298,UCBPlayer,97,242,339,7,56,UCBPlayer
19299,UCBPlayer,130,235,365,24,53,UCBPlayer
19300,UCBPlayer,105,250,355,11,52,UCBPlayer
19301,UCBPlayer,122,227,349,20,57,UCBPlayer
19302,UCBPlayer,109,259,368,15,49,UCBPlayer
19303,UCBPlayer,118,218,336,16,60,UCBPlayer
19304,UCBPlayer,117,267,384,19,45,UCBPlayer
19305,UCBPlayer,110,210,320,12,64,UCBPlayer
19306,UCBPlayer,126,271,397,23,42,UCBPlayer
19307,UCBPlayer,105,210,315,10,65,UCBPlayer
19308,UCBPlayer,130,275,405,25,40,UCBPlayer
19309,UCBPlayer,105,210,315,10,65,UCBPlayer
19310,UCBPlayer,130,275,405,25,40,UCBPlayer
19311,UCBPlayer,106,206,312,10,66,UCBPlayer
19312,UCBPlayer,130,275,405,25,40,UCBPlayer
19313,UCBPlayer,105,210,315,10,65,UCBPlayer
19314,UCBPlayer,131,271,402,25,41,UCBPlayer
19315,UCBPlayer,105,210,315,10,65,UCBPlayer
19316,UCBPlayer,130,275,405,25,40,UCBPlayer
19317,UCBPlayer,105,210,315,10,65,UCBPlayer
19318,UCBPlayer,130,275,405,25,40,UCBPlayer
19319,UCBPlayer,103,203,306,10,68,UCBPlayer
19320,UCBPlayer,128,283,411,25,38,UCBPlayer
19321,UCBPlayer,111,186,297,10,71,UCBPlayer
19322,UCBPlayer,124,299,423,25,34,UCBPlayer
19323,UCBPlayer,115,170,285,10,75,UCBPlayer
19324,UCBPlayer,120,315,435,25,30,UCBPlayer
19325,UCBPlayer,119,154,273,10,79,UCBPlayer
19326,UCBPlayer,112,332,444,25,27,UCBPlayer
19327,UCBPlayer,127,137,264,10,82,UCBPlayer
19328,UCBPlayer,104,349,453,25,24,UCBPlayer
19329,UCBPlayer,126,126,252,7,85,Tie
19330,UCBPlayer,111,351,462,28,22,UCBPlayer
19331,UCBPlayer,116,126,242,3,87,UCBPlayer
19332,UCBPlayer,122,347,469,32,21,UCBPlayer
19333,UCBPlayer,107,132,239,0,87,UCBPlayer
19334,UCBPlayer,132,337,469,35,22,UCBPlayer
19335,UCBPlayer,103,148,251,0,83,UCBPlayer
19336,UCBPlayer,136,321,457,35,26,UCBPlayer
19337,UCBPlayer,99,164,263,0,79,UCBPlayer
19338,UCBPlayer,140,305,445,35,30,UCBPlayer
19339,UCBPlayer,95,180,275,0,75,UCBPlayer
19340,UCBPlayer,144,289,433,35,34,UCBPlayer
19341,UCBPlayer,91,196,287,0,71,UCBPlayer
19342,UCBPlayer,148,273,421,35,38,UCBPlayer
19343,UCBPlayer,87,212,299,0,67,UCBPlayer
19344,UCBPlayer,152,257,409,35,42,UCBPlayer
19345,UCBPlayer,84,224,308,0,64,UCBPlayer
19346,UCBPlayer,146,251,397,32,45,UCBPlayer
19347,UCBPlayer,89,234,323,3,60,UCBPlayer
19348,UCBPlayer,138,243,381,28,49,UCBPlayer
19349,UCBPlayer,97,242,339,7,56,UCBPlayer
19350,UCBPlayer,130,235,365,24,53,UCBPlayer
19351,UCBPlayer,105,250,355,11,52,UCBPlayer
19352,UCBPlayer,122,227,349,20,57,UCBPlayer
19353,UCBPlayer,109,259,368,15,49,UCBPlayer
19354,UCBPlayer,118,218,336,16,60,UCBPlayer
19355,UCBPlayer,117,267,384,19,45,UCBPlayer
19356,UCBPlayer,110,210,320,12,64,UCBPlayer
19357,UCBPlayer,126,271,397,23,42,UCBPlayer
19358,UCBPlayer,105,210,315,10,65,UCBPlayer
19359,UCBPlayer,130,275,405,25,40,UCBPlayer
19360,UCBPlayer,105,210,315,10,65,UCBPlayer
19361,UCBPlayer,130,275,405,25,40,UCBPlayer
19362,UCBPlayer,106,206,312,10,66,UCBPlayer
19363,UCBPlayer,130,275,405,25,40,UCBPlayer
19364,UCBPlayer,105,210,315,10,65,UCBPlayer
19365,UCBPlayer,131,271,402,25,41,UCBPlayer
19366,UCBPlayer,105,210,315,10,65,UCBPlayer
19367,UCBPlayer,130,275,405,25,40,UCBPlayer
19368,UCBPlayer,105,210,315,10,65,UCBPlayer
19369,UCBPlayer,130,275,405,25,40,UCBPlayer
19370,UCBPlayer,103,203,306,10,68,UCBPlayer
19371,UCBPlayer,128,283,411,25,38,UCBPlayer
19372,UCBPlayer,111,186,297,10,71,UCBPlayer
19373,UCBPlayer,124,299,423,25,34,UCBPlayer
19374,UCBPlayer,115,170,285,10,75,UCBPlayer
19375,UCBPlayer,120,315,435,25,30,UCBPlayer
19376,UCBPlayer,119,154,273,10,79,UCBPlayer
19377,UCBPlayer,112,332,444,25,27,UCBPlayer
19378,UCBPlayer,127,137,264,10,82,UCBPlayer
19379,UCBPlayer,104,349,453,25,24,UCBPlayer
19380,UCBPlayer,126,126,252,7,85,Tie
19381,UCBPlayer,111,351,462,28,22,UCBPlayer
19382,UCBPlayer,116,126,242,3,87,UCBPlayer
19383,UCBPlayer,122,347,469,32,21,UCBPlayer
19384,UCBPlayer,107,132,239,0,87,UCBPlayer
19385,UCBPlayer,132,337,469,35,22,UCBPlayer
19386,UCBPlayer,103,148,251,0,83,UCBPlayer
19387,UCBPlayer,136,321,457,35,26,UCBPlayer
19388,UCBPlayer,99,164,263,0,79,UCBPlayer
19389,UCBPlayer,140,305,445,35,30,UCBPlayer
19390,UCBPlayer,95,180,275,0,75,UCBPlayer
19391,UCBPlayer,144,289,433,35,34,UCBPlayer
19392,UCBPlayer,91,196,287,0,71,UCBPlayer
19393,UCBPlayer,148,273,421,35,38,UCBPlayer
19394,UCBPlayer,87,212,299,0,67,UCBPlayer
19395,UCBPlayer,152,257,409,35,42,UCBPlayer
19396,UCBPlayer,84,224,308,0,64,UCBPlayer
19397,UCBPlayer,146,251,397,32,45,UCBPlayer
19398,UCBPlayer,89,234,323,3,60,UCBPlayer
19399,UCBPlayer,138,243,381,28,49,UCBPlayer
19400,UCBPlayer,97,242,339,7,56,UCBPlayer
19401,UCBPlayer,130,235,365,24,53,UCBPlayer
19402,UCBPlayer,105,250,355,11,52,UCBPlayer
19403,UCBPlayer,122,227,349,20,57,UCBPlayer
19404,UCBPlayer,109,259,368,15,49,UCBPlayer
19405,UCBPlayer,118,218,336,16,60,UCBPlayer
19406,UCBPlayer,117,267,384,19,45,UCBPlayer
19407,UCBPlayer,110,210,320,12,64,UCBPlayer
19408,UCBPlayer,126,271,397,23,42,UCBPlayer
19409,UCBPlayer,105,210,315,10,65,UCBPlayer
19410,UCBPlayer,130,275,405,25,40,UCBPlayer
19411,UCBPlayer,105,210,315,10,65,UCBPlayer
19412,UCBPlayer,130,275,405,25,40,UCBPlayer
19413,UCBPlayer,106,206,312,10,66,UCBPlayer
19414,UCBPlayer,130,275,405,25,40,UCBPlayer
19415,UCBPlayer,105,210,315,10,65,UCBPlayer
19416,UCBPlayer,131,271,402,25,41,UCBPlayer
19417,UCBPlayer,105,210,315,10,65,UCBPlayer
19418,UCBPlayer,130,275,405,25,40,UCBPlayer
19419,UCBPlayer,105,210,315,10,65,UCBPlayer
19420,UCBPlayer,130,275,405,25,40,UCBPlayer
19421,UCBPlayer,103,203,306,10,68,UCBPlayer
19422,UCBPlayer,128,283,411,25,38,UCBPlayer
19423,UCBPlayer,111,186,297,10,71,UCBPlayer
19424,UCBPlayer,124,299,423,25,34,UCBPlayer
19425,UCBPlayer,115,170,285,10,75,UCBPlayer
19426,UCBPlayer,120,315,435,25,30,UCBPlayer
19427,UCBPlayer,119,154,273,10,79,UCBPlayer
19428,UCBPlayer,112,332,444,25,27,UCBPlayer
19429,UCBPlayer,127,137,264,10,82,UCBPlayer
19430,UCBPlayer,104,349,453,25,24,UCBPlayer
19431,UCBPlayer,126,126,252,7,85,Tie
19432,UCBPlayer,111,351,462,28,22,UCBPlayer
19433,UCBPlayer,116,126,242,3,87,UCBPlayer
19434,UCBPlayer,122,347,469,32,21,UCBPlayer
19435,UCBPlayer,107,132,239,0,87,UCBPlayer
19436,UCBPlayer,132,337,469,35,22,UCBPlayer
19437,UCBPlayer,103,148,251,0,83,UCBPlayer
19438,UCBPlayer,136,321,457,35,26,UCBPlayer
19439,UCBPlayer,99,164,263,0,79,UCBPlayer
19440,UCBPlayer,140,305,445,35,30,UCBPlayer
19441,UCBPlayer,95,180,275,0,75,UCBPlayer
19442,UCBPlayer,144,289,433,35,34,UCBPlayer
19443,UCBPlayer,91,196,287,0,71,UCBPlayer
19444,UCBPlayer,148,273,421,35,38,UCBPlayer
19445,UCBPlayer,87,212,299,0,67,UCBPlayer
19446,UCBPlayer,152,257,409,35,42,UCBPlayer
19447,UCBPlayer,84,224,308,0,64,UCBPlayer
19448,UCBPlayer,146,251,397,32,45,UCBPlayer
19449,UCBPlayer,89,234,323,3,60,UCBPlayer
19450,UCBPlayer,138,243,381,28,49,UCBPlayer
19451,UCBPlayer,97,242,339,7,56,UCBPlayer
19452,UCBPlayer,130,235,365,24,53,UCBPlayer
19453,UCBPlayer,105,250,355,11,52,UCBPlayer
19454,UCBPlayer,122,227,349,20,57,UCBPlayer
19455,UCBPlayer,109,259,368,15,49,UCBPlayer
19456,UCBPlayer,118,218,336,16,60,UCBPlayer
19457,UCBPlayer,117,267,384,19,45,UCBPlayer
19458,UCBPlayer,110,210,320,12,64,UCBPlayer
19459,UCBPlayer,126,271,397,23,42,UCBPlayer
19460,UCBPlayer,105,210,315,10,65,UCBPlayer
19461,UCBPlayer,130,275,405,25,40,UCBPlayer
19462,UCBPlayer,105,210,315,10,65,UCBPlayer
19463,UCBPlayer,130,275,405,25,40,UCBPlayer
19464,UCBPlayer,106,206,312,10,66,UCBPlayer
19465,UCBPlayer,130,275,405,25,40,UCBPlayer
19466,UCBPlayer,105,210,315,10,65,UCBPlayer
19467,UCBPlayer,131,271,402,25,41,UCBPlayer
19468,UCBPlayer,105,210,315,10,65,UCBPlayer
19469,UCBPlayer,130,275,405,25,40,UCBPlayer
19470,UCBPlayer,105,210,315,10,65,UCBPlayer
19471,UCBPlayer,130,275,405,25,40,UCBPlayer
19472,UCBPlayer,103,203,306,10,68,UCBPlayer
19473,UCBPlayer,128,283,411,25,38,UCBPlayer
19474,UCBPlayer,111,186,297,10,71,UCBPlayer
19475,UCBPlayer,124,299,423,25,34,UCBPlayer
19476,UCBPlayer,115,170,285,10,75,UCBPlayer
19477,UCBPlayer,120,315,435,25,30,UCBPlayer
19478,UCBPlayer,119,154,273,10,79,UCBPlayer
19479,UCBPlayer,112,332,444,25,27,UCBPlayer
19480,UCBPlayer,127,137,264,10,82,UCBPlayer
19481,UCBPlayer,104,349,453,25,24,UCBPlayer
19482,UCBPlayer,126,126,252,7,85,Tie
19483,UCBPlayer,111,351,462,28,22,UCBPlayer
19484,UCBPlayer,116,126,242,3,87,UCBPlayer
19485,UCBPlayer,122,347,469,32,21,UCBPlayer
19486,UCBPlayer,107,132,239,0,87,UCBPlayer
19487,UCBPlayer,132,337,469,35,22,UCBPlayer
19488,UCBPlayer,103,148,251,0,83,UCBPlayer
19489,UCBPlayer,136,321,457,35,26,UCBPlayer
19490,UCBPlayer,99,164,263,0,79,UCBPlayer
19491,UCBPlayer,140,305,445,35,30,UCBPlayer
19492,UCBPlayer,95,180,275,0,75,UCBPlayer
19493,UCBPlayer,144,289,433,35,34,UCBPlayer
19494,UCBPlayer,91,196,287,0,71,UCBPlayer
19495,UCBPlayer,148,273,421,35,38,UCBPlayer
19496,UCBPlayer,87,212,299,0,67,UCBPlayer
19497,UCBPlayer,152,257,409,35,42,UCBPlayer
19498,UCBPlayer,84,224,308,0,64,UCBPlayer
19499,UCBPlayer,146,251,397,32,45,UCBPlayer
19500,UCBPlayer,89,234,323,3,60,UCBPlayer
19501,UCBPlayer,138,243,381,28,49,UCBPlayer
19502,UCBPlayer,97,242,339,7,56,UCBPlayer
19503,UCBPlayer,130,235,365,24,53,UCBPlayer
19504,UCBPlayer,105,250,355,11,52,UCBPlayer
19505,UCBPlayer,122,227,349,20,57,UCBPlayer
19506,UCBPlayer,109,259,368,15,49,UCBPlayer
19507,UCBPlayer,118,218,336,16,60,UCBPlayer
19508,UCBPlayer,117,267,384,19,45,UCBPlayer
19509,UCBPlayer,110,210,320,12,64,UCBPlayer
19510,UCBPlayer,126,271,397,23,42,UCBPlayer
19511,UCBPlayer,105,210,315,10,65,UCBPlayer
19512,UCBPlayer,130,275,405,25,40,UCBPlayer
19513,UCBPlayer,105,210,315,10,65,UCBPlayer
19514,UCBPlayer,130,275,405,25,40,UCBPlayer
19515,UCBPlayer,106,206,312,10,66,UCBPlayer
19516,UCBPlayer,130,275,405,25,40,UCBPlayer
19517,UCBPlayer,105,210,315,10,65,UCBPlayer
19518,UCBPlayer,131,271,402,25,41,UCBPlayer
19519,UCBPlayer,105,210,315,10,65,UCBPlayer
19520,UCBPlayer,130,275,405,25,40,UCBPlayer
19521,UCBPlayer,105,210,315,10,65,UCBPlayer
19522,UCBPlayer,130,275,405,25,40,UCBPlayer
19523,UCBPlayer,103,203,306,10,68,UCBPlayer
19524,UCBPlayer,128,283,411,25,38,UCBPlayer
19525,UCBPlayer,111,186,297,10,71,UCBPlayer
19526,UCBPlayer,124,299,423,25,34,UCBPlayer
19527,UCBPlayer,115,170,285,10,75,UCBPlayer
19528,UCBPlayer,120,315,435,25,30,UCBPlayer
19529,UCBPlayer,119,154,273,10,79,UCBPlayer
19530,UCBPlayer,112,332,444,25,27,UCBPlayer
19531,UCBPlayer,127,137,264,10,82,UCBPlayer
19532,UCBPlayer,104,349,453,25,24,UCBPlayer
19533,UCBPlayer,126,126,252,7,85,Tie
19534,UCBPlayer,111,351,462,28,22,UCBPlayer
19535,UCBPlayer,116,126,242,3,87,UCBPlayer
19536,UCBPlayer,122,347,469,32,21,UCBPlayer
19537,UCBPlayer,107,132,239,0,87,UCBPlayer
19538,UCBPlayer,132,337,469,35,22,UCBPlayer
19539,UCBPlayer,103,148,251,0,83,UCBPlayer
19540,UCBPlayer,136,321,457,35,26,UCBPlayer
19541,UCBPlayer,99,164,263,0,79,UCBPlayer
19542,UCBPlayer,140,305,445,35,30,UCBPlayer
19543,UCBPlayer,95,180,275,0,75,UCBPlayer
19544,UCBPlayer,144,289,433,35,34,UCBPlayer
19545,UCBPlayer,91,196,287,0,71,UCBPlayer
19546,UCBPlayer,148,273,421,35,38,UCBPlayer
19547,UCBPlayer,87,212,299,0,67,UCBPlayer
19548,UCBPlayer,152,257,409,35,42,UCBPlayer
19549,UCBPlayer,84,224,308,0,64,UCBPlayer
19550,UCBPlayer,146,251,397,32,45,UCBPlayer
19551,UCBPlayer,89,234,323,3,60,UCBPlayer
19552,UCBPlayer,138,243,381,28,49,UCBPlayer
19553,UCBPlayer,97,242,339,7,56,UCBPlayer
19554,UCBPlayer,130,235,365,24,53,UCBPlayer
19555,UCBPlayer,105,250,355,11,52,UCBPlayer
19556,UCBPlayer,122,227,349,20,57,UCBPlayer
19557,UCBPlayer,109,259,368,15,49,UCBPlayer
19558,UCBPlayer,118,218,336,16,60,UCBPlayer
19559,UCBPlayer,117,267,384,19,45,UCBPlayer
19560,UCBPlayer,110,210,320,12,64,UCBPlayer
19561,UCBPlayer,126,271,397,23,42,UCBPlayer
19562,UCBPlayer,105,210,315,10,65,UCBPlayer
19563,UCBPlayer,130,275,405,25,40,UCBPlayer
19564,UCBPlayer,105,210,315,10,65,UCBPlayer
19565,UCBPlayer,130,275,405,25,40,UCBPlayer
19566,UCBPlayer,106,206,312,10,66,UCBPlayer
19567,UCBPlayer,130,275,405,25,40,UCBPlayer
19568,UCBPlayer,105,210,315,10,65,UCBPlayer
19569,UCBPlayer,131,271,402,25,41,UCBPlayer
19570,UCBPlayer,105,210,315,10,65,UCBPlayer
19571,UCBPlayer,130,275,405,25,40,UCBPlayer
19572,UCBPlayer,105,210,315,10,65,UCBPlayer
19573,UCBPlayer,130,275,405,25,40,UCBPlayer
19574,UCBPlayer,103,203,306,10,68,UCBPlayer
19575,UCBPlayer,128,283,411,25,38,UCBPlayer
19576,UCBPlayer,111,186,297,10,71,UCBPlayer
19577,UCBPlayer,124,299,423,25,34,UCBPlayer
19578,UCBPlayer,115,170,285,10,75,UCBPlayer
19579,UCBPlayer,120,315,435,25,30,UCBPlayer
19580,UCBPlayer,119,154,273,10,79,UCBPlayer
19581,UCBPlayer,112,332,444,25,27,UCBPlayer
19582,UCBPlayer,127,137,264,10,82,UCBPlayer
19583,UCBPlayer,104,349,453,25,24,UCBPlayer
19584,UCBPlayer,126,126,252,7,85,Tie
19585,UCBPlayer,111,351,462,28,22,UCBPlayer
19586,UCBPlayer,116,126,242,3,87,UCBPlayer
19587,UCBPlayer,122,347,469,32,21,UCBPlayer
19588,UCBPlayer,107,132,239,0,87,UCBPlayer
19589,UCBPlayer,132,337,469,35,22,UCBPlayer
19590,UCBPlayer,103,148,251,0,83,UCBPlayer
19591,UCBPlayer,136,321,457,35,26,UCBPlayer
19592,UCBPlayer,99,164,263,0,79,UCBPlayer
19593,UCBPlayer,140,305,445,35,30,UCBPlayer
19594,UCBPlayer,95,180,275,0,75,UCBPlayer
19595,UCBPlayer,144,289,433,35,34,UCBPlayer
19596,UCBPlayer,91,196,287,0,71,UCBPlayer
19597,UCBPlayer,148,273,421,35,38,UCBPlayer
19598,UCBPlayer,87,212,299,0,67,UCBPlayer
19599,UCBPlayer,152,257,409,35,42,UCBPlayer
19600,UCBPlayer,84,224,308,0,64,UCBPlayer
19601,UCBPlayer,146,251,397,32,45,UCBPlayer
19602,UCBPlayer,89,234,323,3,60,UCBPlayer
19603,UCBPlayer,138,243,381,28,49,UCBPlayer
19604,UCBPlayer,97,242,339,7,56,UCBPlayer
19605,UCBPlayer,130,235,365,24,53,UCBPlayer
19606,UCBPlayer,105,250,355,11,52,UCBPlayer
19607,UCBPlayer,122,227,349,20,57,UCBPlayer
19608,UCBPlayer,109,259,368,15,49,UCBPlayer
19609,UCBPlayer,118,218,336,16,60,UCBPlayer
19610,UCBPlayer,117,267,384,19,45,UCBPlayer
19611,UCBPlayer,110,210,320,12,64,UCBPlayer
19612,UCBPlayer,126,271,397,23,42,UCBPlayer
19613,UCBPlayer,105,210,315,10,65,UCBPlayer
19614,UCBPlayer,130,275,405,25,40,UCBPlayer
19615,UCBPlayer,105,210,315,10,65,UCBPlayer
19616,UCBPlayer,130,275,405,25,40,UCBPlayer
19617,UCBPlayer,106,206,312,10,66,UCBPlayer
19618,UCBPlayer,130,275,405,25,40,UCBPlayer
19619,UCBPlayer,105,210,315,10,65,UCBPlayer
19620,UCBPlayer,131,271,402,25,41,UCBPlayer
19621,UCBPlayer,105,210,315,10,65,UCBPlayer
19622,UCBPlayer,130,275,405,25,40,UCBPlayer
19623,UCBPlayer,105,210,315,10,65,UCBPlayer
19624,UCBPlayer,130,275,405,25,40,UCBPlayer
19625,UCBPlayer,103,203,306,10,68,UCBPlayer
19626,UCBPlayer,128,283,411,25,38,UCBPlayer
19627,UCBPlayer,111,186,297,10,71,UCBPlayer
19628,UCBPlayer,124,299,423,25,34,UCBPlayer
19629,UCBPlayer,115,170,285,10,75,UCBPlayer
19630,UCBPlayer,120,315,435,25,30,UCBPlayer
19631,UCBPlayer,119,154,273,10,79,UCBPlayer
19632,UCBPlayer,112,332,444,25,27,UCBPlayer
19633,UCBPlayer,127,137,264,10,82,UCBPlayer
19634,UCBPlayer,104,349,453,25,24,UCBPlayer
19635,UCBPlayer,126,126,252,7,85,Tie
19636,UCBPlayer,111,351,462,28,22,UCBPlayer
19637,UCBPlayer,116,126,242,3,87,UCBPlayer
19638,UCBPlayer,122,347,469,32,21,UCBPlayer
19639,UCBPlayer,107,132,239,0,87,UCBPlayer
19640,UCBPlayer,132,337,469,35,22,UCBPlayer
19641,UCBPlayer,103,148,251,0,83,UCBPlayer
19642,UCBPlayer,136,321,457,35,26,UCBPlayer
19643,UCBPlayer,99,164,263,0,79,UCBPlayer
19644,UCBPlayer,140,305,445,35,30,UCBPlayer
19645,UCBPlayer,95,180,275,0,75,UCBPlayer
19646,UCBPlayer,144,289,433,35,34,UCBPlayer
19647,UCBPlayer,91,196,287,0,71,UCBPlayer
19648,UCBPlayer,148,273,421,35,38,UCBPlayer
19649,UCBPlayer,87,212,299,0,67,UCBPlayer
19650,UCBPlayer,152,257,409,35,42,UCBPlayer
19651,UCBPlayer,84,224,308,0,64,UCBPlayer
19652,UCBPlayer,146,251,397,32,45,UCBPlayer
19653,UCBPlayer,89,234,323,3,60,UCBPlayer
19654,UCBPlayer,138,243,381,28,49,UCBPlayer
19655,UCBPlayer,97,242,339,7,56,UCBPlayer
19656,UCBPlayer,130,235,365,24,53,UCBPlayer
19657,UCBPlayer,105,250,355,11,52,UCBPlayer
19658,UCBPlayer,122,227,349,20,57,UCBPlayer
19659,UCBPlayer,109,259,368,15,49,UCBPlayer
19660,UCBPlayer,118,218,336,16,60,UCBPlayer
19661,UCBPlayer,117,267,384,19,45,UCBPlayer
19662,UCBPlayer,110,210,320,12,64,UCBPlayer
19663,UCBPlayer,126,271,397,23,42,UCBPlayer
19664,UCBPlayer,105,210,315,10,65,UCBPlayer
19665,UCBPlayer,130,275,405,25,40,UCBPlayer
19666,UCBPlayer,105,210,315,10,65,UCBPlayer
19667,UCBPlayer,130,275,405,25,40,UCBPlayer
19668,UCBPlayer,106,206,312,10,66,UCBPlayer
19669,UCBPlayer,130,275,405,25,40,UCBPlayer
19670,UCBPlayer,105,210,315,10,65,UCBPlayer
19671,UCBPlayer,131,271,402,25,41,UCBPlayer
19672,UCBPlayer,105,210,315,10,65,UCBPlayer
19673,UCBPlayer,130,275,405,25,40,UCBPlayer
19674,UCBPlayer,105,210,315,10,65,UCBPlayer
19675,UCBPlayer,130,275,405,25,40,UCBPlayer
19676,UCBPlayer,103,203,306,10,68,UCBPlayer
19677,UCBPlayer,128,283,411,25,38,UCBPlayer
19678,UCBPlayer,111,186,297,10,71,UCBPlayer
19679,UCBPlayer,124,299,423,25,34,UCBPlayer
19680,UCBPlayer,115,170,285,10,75,UCBPlayer
19681,UCBPlayer,120,315,435,25,30,UCBPlayer
19682,UCBPlayer,119,154,273,10,79,UCBPlayer
19683,UCBPlayer,112,332,444,25,27,UCBPlayer
19684,UCBPlayer,127,137,264,10,82,UCBPlayer
19685,UCBPlayer,104,349,453,25,24,UCBPlayer
19686,UCBPlayer,126,126,252,7,85,Tie
19687,UCBPlayer,111,351,462,28,22,UCBPlayer
19688,UCBPlayer,116,126,242,3,87,UCBPlayer
19689,UCBPlayer,122,347,469,32,21,UCBPlayer
19690,UCBPlayer,107,132,239,0,87,UCBPlayer
19691,UCBPlayer,132,337,469,35,22,UCBPlayer
19692,UCBPlayer,103,148,251,0,83,UCBPlayer
19693,UCBPlayer,136,321,457,35,26,UCBPlayer
19694,UCBPlayer,99,164,263,0,79,UCBPlayer
19695,UCBPlayer,140,305,445,35,30,UCBPlayer
19696,UCBPlayer,95,180,275,0,75,UCBPlayer
19697,UCBPlayer,144,289,433,35,34,UCBPlayer
19698,UCBPlayer,91,196,287,0,71,UCBPlayer
19699,UCBPlayer,148,273,421,35,38,UCBPlayer
19700,UCBPlayer,87,212,299,0,67,UCBPlayer
19701,UCBPlayer,152,257,409,35,42,UCBPlayer
19702,UCBPlayer,84,224,308,0,64,UCBPlayer
19703,UCBPlayer,146,251,397,32,45,UCBPlayer
19704,UCBPlayer,89,234,323,3,60,UCBPlayer
19705,UCBPlayer,138,243,381,28,49,UCBPlayer
19706,UCBPlayer,97,242,339,7,56,UCBPlayer
19707,UCBPlayer,130,235,365,24,53,UCBPlayer
19708,UCBPlayer,105,250,355,11,52,UCBPlayer
19709,UCBPlayer,122,227,349,20,57,UCBPlayer
19710,UCBPlayer,109,259,368,15,49,UCBPlayer
19711,UCBPlayer,118,218,336,16,60,UCBPlayer
19712,UCBPlayer,117,267,384,19,45,UCBPlayer
19713,UCBPlayer,110,210,320,12,64,UCBPlayer
19714,UCBPlayer,126,271,397,23,42,UCBPlayer
19715,UCBPlayer,105,210,315,10,65,UCBPlayer
19716,UCBPlayer,130,275,405,25,40,UCBPlayer
19717,UCBPlayer,105,210,315,10,65,UCBPlayer
19718,UCBPlayer,130,275,405,25,40,UCBPlayer
19719,UCBPlayer,106,206,312,10,66,UCBPlayer
19720,UCBPlayer,130,275,405,25,40,UCBPlayer
19721,UCBPlayer,105,210,315,10,65,UCBPlayer
19722,UCBPlayer,131,271,402,25,41,UCBPlayer
19723,UCBPlayer,105,210,315,10,65,UCBPlayer
19724,UCBPlayer,130,275,405,25,40,UCBPlayer
19725,UCBPlayer,105,210,315,10,65,UCBPlayer
19726,UCBPlayer,130,275,405,25,40,UCBPlayer
19727,UCBPlayer,103,203,306,10,68,UCBPlayer
19728,UCBPlayer,128,283,411,25,38,UCBPlayer
19729,UCBPlayer,111,186,297,10,71,UCBPlayer
19730,UCBPlayer,124,299,423,25,34,UCBPlayer
19731,UCBPlayer,115,170,285,10,75,UCBPlayer
19732,UCBPlayer,120,315,435,25,30,UCBPlayer
19733,UCBPlayer,119,154,273,10,79,UCBPlayer
19734,UCBPlayer,112,332,444,25,27,UCBPlayer
19735,UCBPlayer,127,137,264,10,82,UCBPlayer
19736,UCBPlayer,104,349,453,25,24,UCBPlayer
19737,UCBPlayer,126,126,252,7,85,Tie
19738,UCBPlayer,111,351,462,28,22,UCBPlayer
19739,UCBPlayer,116,126,242,3,87,UCBPlayer
19740,UCBPlayer,122,347,469,32,21,UCBPlayer
19741,UCBPlayer,107,132,239,0,87,UCBPlayer
19742,UCBPlayer,132,337,469,35,22,UCBPlayer
19743,UCBPlayer,103,148,251,0,83,UCBPlayer
19744,UCBPlayer,136,321,457,35,26,UCBPlayer
19745,UCBPlayer,99,164,263,0,79,UCBPlayer
19746,UCBPlayer,140,305,445,35,30,UCBPlayer
19747,UCBPlayer,95,180,275,0,75,UCBPlayer
19748,UCBPlayer,144,289,433,35,34,UCBPlayer
19749,UCBPlayer,91,196,287,0,71,UCBPlayer
19750,UCBPlayer,148,273,421,35,38,UCBPlayer
19751,UCBPlayer,87,212,299,0,67,UCBPlayer
19752,UCBPlayer,152,257,409,35,42,UCBPlayer
19753,UCBPlayer,84,224,308,0,64,UCBPlayer
19754,UCBPlayer,146,251,397,32,45,UCBPlayer
19755,UCBPlayer,89,234,323,3,60,UCBPlayer
19756,UCBPlayer,138,243,381,28,49,UCBPlayer
19757,UCBPlayer,97,242,339,7,56,UCBPlayer
19758,UCBPlayer,130,235,365,24,53,UCBPlayer
19759,UCBPlayer,105,250,355,11,52,UCBPlayer
19760,UCBPlayer,122,227,349,20,57,UCBPlayer
19761,UCBPlayer,109,259,368,15,49,UCBPlayer
19762,UCBPlayer,118,218,336,16,60,UCBPlayer
19763,UCBPlayer,117,267,384,19,45,UCBPlayer
19764,UCBPlayer,110,210,320,12,64,UCBPlayer
19765,UCBPlayer,126,271,397,23,42,UCBPlayer
19766,UCBPlayer,105,210,315,10,65,UCBPlayer
19767,UCBPlayer,130,275,405,25,40,UCBPlayer
19768,UCBPlayer,105,210,315,10,65,UCBPlayer
19769,UCBPlayer,130,275,405,25,40,UCBPlayer
19770,UCBPlayer,106,206,312,10,66,UCBPlayer
19771,UCBPlayer,130,275,405,25,40,UCBPlayer
19772,UCBPlayer,105,210,315,10,65,UCBPlayer
19773,UCBPlayer,131,271,402,25,41,UCBPlayer
19774,UCBPlayer,105,210,315,10,65,UCBPlayer
19775,UCBPlayer,130,275,405,25,40,UCBPlayer
19776,UCBPlayer,105,210,315,10,65,UCBPlayer
19777,UCBPlayer,130,275,405,25,40,UCBPlayer
19778,UCBPlayer,103,203,306,10,68,UCBPlayer
19779,UCBPlayer,128,283,411,25,38,UCBPlayer
19780,UCBPlayer,111,186,297,10,71,UCBPlayer
19781,UCBPlayer,124,299,423,25,34,UCBPlayer
19782,UCBPlayer,115,170,285,10,75,UCBPlayer
19783,UCBPlayer,120,315,435,25,30,UCBPlayer
19784,UCBPlayer,119,154,273,10,79,UCBPlayer
19785,UCBPlayer,112,332,444,25,27,UCBPlayer
19786,UCBPlayer,127,137,264,10,82,UCBPlayer
19787,UCBPlayer,104,349,453,25,24,UCBPlayer
19788,UCBPlayer,126,126,252,7,85,Tie
19789,UCBPlayer,111,351,462,28,22,UCBPlayer
19790,UCBPlayer,116,126,242,3,87,UCBPlayer
19791,UCBPlayer,122,347,469,32,21,UCBPlayer
19792,UCBPlayer,107,132,239,0,87,UCBPlayer
19793,UCBPlayer,132,337,469,35,22,UCBPlayer
19794,UCBPlayer,103,148,251,0,83,UCBPlayer
19795,UCBPlayer,136,321,457,35,26,UCBPlayer
19796,UCBPlayer,99,164,263,0,79,UCBPlayer
19797,UCBPlayer,140,305,445,35,30,UCBPlayer
19798,UCBPlayer,95,180,275,0,75,UCBPlayer
19799,UCBPlayer,144,289,433,35,34,UCBPlayer
19800,UCBPlayer,91,196,287,0,71,UCBPlayer
19801,UCBPlayer,148,273,421,35,38,UCBPlayer
19802,UCBPlayer,87,212,299,0,67,UCBPlayer
19803,UCBPlayer,152,257,409,35,42,UCBPlayer
19804,UCBPlayer,84,224,308,0,64,UCBPlayer
19805,UCBPlayer,146,251,397,32,45,UCBPlayer
19806,UCBPlayer,89,234,323,3,60,UCBPlayer
19807,UCBPlayer,138,243,381,28,49,UCBPlayer
19808,UCBPlayer,97,242,339,7,56,UCBPlayer
19809,UCBPlayer,130,235,365,24,53,UCBPlayer
19810,UCBPlayer,105,250,355,11,52,UCBPlayer
19811,UCBPlayer,122,227,349,20,57,UCBPlayer
19812,UCBPlayer,109,259,368,15,49,UCBPlayer
19813,UCBPlayer,118,218,336,16,60,UCBPlayer
19814,UCBPlayer,117,267,384,19,45,UCBPlayer
19815,UCBPlayer,110,210,320,12,64,UCBPlayer
19816,UCBPlayer,126,271,397,23,42,UCBPlayer
19817,UCBPlayer,105,210,315,10,65,UCBPlayer
19818,UCBPlayer,130,275,405,25,40,UCBPlayer
19819,UCBPlayer,105,210,315,10,65,UCBPlayer
19820,UCBPlayer,130,275,405,25,40,UCBPlayer
19821,UCBPlayer,106,206,312,10,66,UCBPlayer
19822,UCBPlayer,130,275,405,25,40,UCBPlayer
19823,UCBPlayer,105,210,315,10,65,UCBPlayer
19824,UCBPlayer,131,271,402,25,41,UCBPlayer
19825,UCBPlayer,105,210,315,10,65,UCBPlayer
19826,UCBPlayer,130,275,405,25,40,UCBPlayer
19827,UCBPlayer,105,210,315,10,65,UCBPlayer
19828,UCBPlayer,130,275,405,25,40,UCBPlayer
19829,UCBPlayer,103,203,306,10,68,UCBPlayer
19830,UCBPlayer,128,283,411,25,38,UCBPlayer
19831,UCBPlayer,111,186,297,10,71,UCBPlayer
19832,UCBPlayer,124,299,423,25,34,UCBPlayer
19833,UCBPlayer,115,170,285,10,75,UCBPlayer
19834,UCBPlayer,120,315,435,25,30,UCBPlayer
19835,UCBPlayer,119,154,273,10,79,UCBPlayer
19836,UCBPlayer,112,332,444,25,27,UCBPlayer
19837,UCBPlayer,127,137,264,10,82,UCBPlayer
19838,UCBPlayer,104,349,453,25,24,UCBPlayer
19839,UCBPlayer,126,126,252,7,85,Tie
19840,UCBPlayer,111,351,462,28,22,UCBPlayer
19841,UCBPlayer,116,126,242,3,87,UCBPlayer
19842,UCBPlayer,122,347,469,32,21,UCBPlayer
19843,UCBPlayer,107,132,239,0,87,UCBPlayer
19844,UCBPlayer,132,337,469,35,22,UCBPlayer
19845,UCBPlayer,103,148,251,0,83,UCBPlayer
19846,UCBPlayer,136,321,457,35,26,UCBPlayer
19847,UCBPlayer,99,164,263,0,79,UCBPlayer
19848,UCBPlayer,140,305,445,35,30,UCBPlayer
19849,UCBPlayer,95,180,275,0,75,UCBPlayer
19850,UCBPlayer,144,289,433,35,34,UCBPlayer
19851,UCBPlayer,91,196,287,0,71,UCBPlayer
19852,UCBPlayer,148,273,421,35,38,UCBPlayer
19853,UCBPlayer,87,212,299,0,67,UCBPlayer
19854,UCBPlayer,152,257,409,35,42,UCBPlayer
19855,UCBPlayer,84,224,308,0,64,UCBPlayer
19856,UCBPlayer,146,251,397,32,45,UCBPlayer
19857,UCBPlayer,89,234,323,3,60,UCBPlayer
19858,UCBPlayer,138,243,381,28,49,UCBPlayer
19859,UCBPlayer,97,242,339,7,56,UCBPlayer
19860,UCBPlayer,130,235,365,24,53,UCBPlayer
19861,UCBPlayer,105,250,355,11,52,UCBPlayer
19862,UCBPlayer,122,227,349,20,57,UCBPlayer
19863,UCBPlayer,109,259,368,15,49,UCBPlayer
19864,UCBPlayer,118,218,336,16,60,UCBPlayer
19865,UCBPlayer,117,267,384,19,45,UCBPlayer
19866,UCBPlayer,110,210,320,12,64,UCBPlayer
19867,UCBPlayer,126,271,397,23,42,UCBPlayer
19868,UCBPlayer,105,210,315,10,65,UCBPlayer
19869,UCBPlayer,130,275,405,25,40,UCBPlayer
19870,UCBPlayer,105,210,315,10,65,UCBPlayer
19871,UCBPlayer,130,275,405,25,40,UCBPlayer
19872,UCBPlayer,106,206,312,10,66,UCBPlayer
19873,UCBPlayer,130,275,405,25,40,UCBPlayer
19874,UCBPlayer,105,210,315,10,65,UCBPlayer
19875,UCBPlayer,131,271,402,25,41,UCBPlayer
19876,UCBPlayer,105,210,315,10,65,UCBPlayer
19877,UCBPlayer,130,275,405,25,40,UCBPlayer
19878,UCBPlayer,105,210,315,10,65,UCBPlayer
19879,UCBPlayer,130,275,405,25,40,UCBPlayer
19880,UCBPlayer,103,203,306,10,68,UCBPlayer
19881,UCBPlayer,128,283,411,25,38,UCBPlayer
19882,UCBPlayer,111,186,297,10,71,UCBPlayer
19883,UCBPlayer,124,299,423,25,34,UCBPlayer
19884,UCBPlayer,115,170,285,10,75,UCBPlayer
19885,UCBPlayer,120,315,435,25,30,UCBPlayer
19886,UCBPlayer,119,154,273,10,79,UCBPlayer
19887,UCBPlayer,112,332,444,25,27,UCBPlayer
19888,UCBPlayer,127,137,264,10,82,UCBPlayer
19889,UCBPlayer,104,349,453,25,24,UCBPlayer
19890,UCBPlayer,126,126,252,7,85,Tie
19891,UCBPlayer,111,351,462,28,22,UCBPlayer
19892,UCBPlayer,116,126,242,3,87,UCBPlayer
19893,UCBPlayer,122,347,469,32,21,UCBPlayer
19894,UCBPlayer,107,132,239,0,87,UCBPlayer
19895,UCBPlayer,132,337,469,35,22,UCBPlayer
19896,UCBPlayer,103,148,251,0,83,UCBPlayer
19897,UCBPlayer,136,321,457,35,26,UCBPlayer
19898,UCBPlayer,99,164,263,0,79,UCBPlayer
19899,UCBPlayer,140,305,445,35,30,UCBPlayer
19900,UCBPlayer,95,180,275,0,75,UCBPlayer
19901,UCBPlayer,144,289,433,35,34,UCBPlayer
19902,UCBPlayer,91,196,287,0,71,UCBPlayer
19903,UCBPlayer,148,273,421,35,38,UCBPlayer
19904,UCBPlayer,87,212,299,0,67,UCBPlayer
19905,UCBPlayer,152,257,409,35,42,UCBPlayer
19906,UCBPlayer,84,224,308,0,64,UCBPlayer
19907,UCBPlayer,146,251,397,32,45,UCBPlayer
19908,UCBPlayer,89,234,323,3,60,UCBPlayer
19909,UCBPlayer,138,243,381,28,49,UCBPlayer
19910,UCBPlayer,97,242,339,7,56,UCBPlayer
19911,UCBPlayer,130,235,365,24,53,UCBPlayer
19912,UCBPlayer,105,250,355,11,52,UCBPlayer
19913,UCBPlayer,122,227,349,20,57,UCBPlayer
19914,UCBPlayer,109,259,368,15,49,UCBPlayer
19915,UCBPlayer,118,218,336,16,60,UCBPlayer
19916,UCBPlayer,117,267,384,19,45,UCBPlayer
19917,UCBPlayer,110,210,320,12,64,UCBPlayer
19918,UCBPlayer,126,271,397,23,42,UCBPlayer
19919,UCBPlayer,105,210,315,10,65,UCBPlayer
19920,UCBPlayer,130,275,405,25,40,UCBPlayer
19921,UCBPlayer,105,210,315,10,65,UCBPlayer
19922,UCBPlayer,130,275,405,25,40,UCBPlayer
19923,UCBPlayer,106,206,312,10,66,UCBPlayer
19924,UCBPlayer,130,275,405,25,40,UCBPlayer
19925,UCBPlayer,105,210,315,10,65,UCBPlayer
19926,UCBPlayer,131,271,402,25,41,UCBPlayer
19927,UCBPlayer,105,210,315,10,65,UCBPlayer
19928,UCBPlayer,130,275,405,25,40,UCBPlayer
19929,UCBPlayer,105,210,315,10,65,UCBPlayer
19930,UCBPlayer,130,275,405,25,40,UCBPlayer
19931,UCBPlayer,103,203,306,10,68,UCBPlayer
19932,UCBPlayer,128,283,411,25,38,UCBPlayer
19933,UCBPlayer,111,186,297,10,71,UCBPlayer
19934,UCBPlayer,124,299,423,25,34,UCBPlayer
19935,UCBPlayer,115,170,285,10,75,UCBPlayer
19936,UCBPlayer,120,315,435,25,30,UCBPlayer
19937,UCBPlayer,119,154,273,10,79,UCBPlayer
19938,UCBPlayer,112,332,444,25,27,UCBPlayer
19939,UCBPlayer,127,137,264,10,82,UCBPlayer
19940,UCBPlayer,104,349,453,25,24,UCBPlayer
19941,UCBPlayer,126,126,252,7,85,Tie
19942,UCBPlayer,111,351,462,28,22,UCBPlayer
19943,UCBPlayer,116,126,242,3,87,UCBPlayer
19944,UCBPlayer,122,347,469,32,21,UCBPlayer
19945,UCBPlayer,107,132,239,0,87,UCBPlayer
19946,UCBPlayer,132,337,469,35,22,UCBPlayer
19947,UCBPlayer,103,148,251,0,83,UCBPlayer
19948,UCBPlayer,136,321,457,35,26,UCBPlayer
19949,UCBPlayer,99,164,263,0,79,UCBPlayer
19950,UCBPlayer,140,305,445,35,30,UCBPlayer
19951,UCBPlayer,95,180,275,0,75,UCBPlayer
19952,UCBPlayer,144,289,433,35,34,UCBPlayer
19953,UCBPlayer,91,196,287,0,71,UCBPlayer
19954,UCBPlayer,148,273,421,35,38,UCBPlayer
19955,UCBPlayer,87,212,299,0,67,UCBPlayer
19956,UCBPlayer,152,257,409,35,42,UCBPlayer
19957,UCBPlayer,84,224,308,0,64,UCBPlayer
19958,UCBPlayer,146,251,397,32,45,UCBPlayer
19959,UCBPlayer,89,234,323,3,60,UCBPlayer
19960,UCBPlayer,138,243,381,28,49,UCBPlayer
19961,UCBPlayer,97,242,339,7,56,UCBPlayer
19962,UCBPlayer,130,235,365,24,53,UCBPlayer
19963,UCBPlayer,105,250,355,11,52,UCBPlayer
19964,UCBPlayer,122,227,349,20,57,UCBPlayer
19965,UCBPlayer,109,259,368,15,49,UCBPlayer
19966,UCBPlayer,118,218,336,16,60,UCBPlayer
19967,UCBPlayer,117,267,384,19,45,UCBPlayer
19968,UCBPlayer,110,210,320,12,64,UCBPlayer
19969,UCBPlayer,126,271,397,23,42,UCBPlayer
19970,UCBPlayer,105,210,315,10,65,UCBPlayer
19971,UCBPlayer,130,275,405,25,40,UCBPlayer
19972,UCBPlayer,105,210,315,10,65,UCBPlayer
19973,UCBPlayer,130,275,405,25,40,UCBPlayer
19974,UCBPlayer,106,206,312,10,66,UCBPlayer
19975,UCBPlayer,130,275,405,25,40,UCBPlayer
19976,UCBPlayer,105,210,315,10,65,UCBPlayer
19977,UCBPlayer,131,271,402,25,41,UCBPlayer
19978,UCBPlayer,105,210,315,10,65,UCBPlayer
19979,UCBPlayer,130,275,405,25,40,UCBPlayer
19980,UCBPlayer,105,210,315,10,65,UCBPlayer
19981,UCBPlayer,130,275,405,25,40,UCBPlayer
19982,UCBPlayer,103,203,306,10,68,UCBPlayer
19983,UCBPlayer,128,283,411,25,38,UCBPlayer
19984,UCBPlayer,111,186,297,10,71,UCBPlayer
19985,UCBPlayer,124,299,423,25,34,UCBPlayer
19986,UCBPlayer,115,170,285,10,75,UCBPlayer
19987,UCBPlayer,120,315,435,25,30,UCBPlayer
19988,UCBPlayer,119,154,273,10,79,UCBPlayer
19989,UCBPlayer,112,332,444,25,27,UCBPlayer
19990,UCBPlayer,127,137,264,10,82,UCBPlayer
19991,UCBPlayer,104,349,453,25,24,UCBPlayer
19992,UCBPlayer,126,126,252,7,85,Tie
19993,UCBPlayer,111,351,462,28,22,UCBPlayer
19994,UCBPlayer,116,126,242,3,87,UCBPlayer
19995,UCBPlayer,122,347,469,32,21,UCBPlayer
19996,UCBPlayer,107,132,239,0,87,UCBPlayer
19997,UCBPlayer,132,337,469,35,22,UCBPlayer
19998,UCBPlayer,103,148,251,0,83,UCBPlayer
19999,UCBPlayer,136,321,457,35,26,UCBPlayer
20000,UCBPlayer,99,164,263,0,79,UCBPlayer
20001,UCBPlayer,140,305,445,35,30,UCBPlayer
20002,UCBPlayer,95,180,275,0,75,UCBPlayer
20003,UCBPlayer,144,289,433,35,34,UCBPlayer
20004,UCBPlayer,91,196,287,0,71,UCBPlayer
20005,UCBPlayer,148,273,421,35,38,UCBPlayer
20006,UCBPlayer,87,212,299,0,67,UCBPlayer
20007,UCBPlayer,152,257,409,35,42,UCBPlayer
20008,UCBPlayer,84,224,308,0,64,UCBPlayer
20009,UCBPlayer,146,251,397,32,45,UCBPlayer
20010,UCBPlayer,89,234,323,3,60,UCBPlayer
20011,UCBPlayer,138,243,381,28,49,UCBPlayer
20012,UCBPlayer,97,242,339,7,56,UCBPlayer
20013,UCBPlayer,130,235,365,24,53,UCBPlayer
20014,UCBPlayer,105,250,355,11,52,UCBPlayer
20015,UCBPlayer,122,227,349,20,57,UCBPlayer
20016,UCBPlayer,109,259,368,15,49,UCBPlayer
20017,UCBPlayer,118,218,336,16,60,UCBPlayer
20018,UCBPlayer,117,267,384,19,45,UCBPlayer
20019,UCBPlayer,110,210,320,12,64,UCBPlayer
20020,UCBPlayer,126,271,397,23,42,UCBPlayer
20021,UCBPlayer,105,210,315,10,65,UCBPlayer
20022,UCBPlayer,130,275,405,25,40,UCBPlayer
20023,UCBPlayer,105,210,315,10,65,UCBPlayer
20024,UCBPlayer,130,275,405,25,40,UCBPlayer
20025,UCBPlayer,106,206,312,10,66,UCBPlayer
20026,UCBPlayer,130,275,405,25,40,UCBPlayer
20027,UCBPlayer,105,210,315,10,65,UCBPlayer
20028,UCBPlayer,131,271,402,25,41,UCBPlayer
20029,UCBPlayer,105,210,315,10,65,UCBPlayer
20030,UCBPlayer,130,275,405,25,40,UCBPlayer
20031,UCBPlayer,105,210,315,10,65,UCBPlayer
20032,UCBPlayer,130,275,405,25,40,UCBPlayer
20033,UCBPlayer,103,203,306,10,68,UCBPlayer
20034,UCBPlayer,128,283,411,25,38,UCBPlayer
20035,UCBPlayer,111,186,297,10,71,UCBPlayer
20036,UCBPlayer,124,299,423,25,34,UCBPlayer
20037,UCBPlayer,115,170,285,10,75,UCBPlayer
20038,UCBPlayer,120,315,435,25,30,UCBPlayer
20039,UCBPlayer,119,154,273,10,79,UCBPlayer
20040,UCBPlayer,112,332,444,25,27,UCBPlayer
20041,UCBPlayer,127,137,264,10,82,UCBPlayer
20042,UCBPlayer,104,349,453,25,24,UCBPlayer
20043,UCBPlayer,126,126,252,7,85,Tie
20044,UCBPlayer,111,351,462,28,22,UCBPlayer
20045,UCBPlayer,116,126,242,3,87,UCBPlayer
20046,UCBPlayer,122,347,469,32,21,UCBPlayer
20047,UCBPlayer,107,132,239,0,87,UCBPlayer
20048,UCBPlayer,132,337,469,35,22,UCBPlayer
20049,UCBPlayer,103,148,251,0,83,UCBPlayer
20050,UCBPlayer,136,321,457,35,26,UCBPlayer
20051,UCBPlayer,99,164,263,0,79,UCBPlayer
20052,UCBPlayer,140,305,445,35,30,UCBPlayer
20053,UCBPlayer,95,180,275,0,75,UCBPlayer
20054,UCBPlayer,144,289,433,35,34,UCBPlayer
20055,UCBPlayer,91,196,287,0,71,UCBPlayer
20056,UCBPlayer,148,273,421,35,38,UCBPlayer
20057,UCBPlayer,87,212,299,0,67,UCBPlayer
20058,UCBPlayer,152,257,409,35,42,UCBPlayer
20059,UCBPlayer,84,224,308,0,64,UCBPlayer
20060,UCBPlayer,146,251,397,32,45,UCBPlayer
20061,UCBPlayer,89,234,323,3,60,UCBPlayer
20062,UCBPlayer,138,243,381,28,49,UCBPlayer
20063,UCBPlayer,97,242,339,7,56,UCBPlayer
20064,UCBPlayer,130,235,365,24,53,UCBPlayer
20065,UCBPlayer,105,250,355,11,52,UCBPlayer
20066,UCBPlayer,122,227,349,20,57,UCBPlayer
20067,UCBPlayer,109,259,368,15,49,UCBPlayer
20068,UCBPlayer,118,218,336,16,60,UCBPlayer
20069,UCBPlayer,117,267,384,19,45,UCBPlayer
20070,UCBPlayer,110,210,320,12,64,UCBPlayer
20071,UCBPlayer,126,271,397,23,42,UCBPlayer
20072,UCBPlayer,105,210,315,10,65,UCBPlayer
20073,UCBPlayer,130,275,405,25,40,UCBPlayer
20074,UCBPlayer,105,210,315,10,65,UCBPlayer
20075,UCBPlayer,130,275,405,25,40,UCBPlayer
20076,UCBPlayer,106,206,312,10,66,UCBPlayer
20077,UCBPlayer,130,275,405,25,40,UCBPlayer
20078,UCBPlayer,105,210,315,10,65,UCBPlayer
20079,UCBPlayer,131,271,402,25,41,UCBPlayer
20080,UCBPlayer,105,210,315,10,65,UCBPlayer
20081,UCBPlayer,130,275,405,25,40,UCBPlayer
20082,UCBPlayer,105,210,315,10,65,UCBPlayer
20083,UCBPlayer,130,275,405,25,40,UCBPlayer
20084,UCBPlayer,103,203,306,10,68,UCBPlayer
20085,UCBPlayer,128,283,411,25,38,UCBPlayer
20086,UCBPlayer,111,186,297,10,71,UCBPlayer
20087,UCBPlayer,124,299,423,25,34,UCBPlayer
20088,UCBPlayer,115,170,285,10,75,UCBPlayer
20089,UCBPlayer,120,315,435,25,30,UCBPlayer
20090,UCBPlayer,119,154,273,10,79,UCBPlayer
20091,UCBPlayer,112,332,444,25,27,UCBPlayer
20092,UCBPlayer,127,137,264,10,82,UCBPlayer
20093,UCBPlayer,104,349,453,25,24,UCBPlayer
20094,UCBPlayer,126,126,252,7,85,Tie
20095,UCBPlayer,111,351,462,28,22,UCBPlayer
20096,UCBPlayer,116,126,242,3,87,UCBPlayer
20097,UCBPlayer,122,347,469,32,21,UCBPlayer
20098,UCBPlayer,107,132,239,0,87,UCBPlayer
20099,UCBPlayer,132,337,469,35,22,UCBPlayer
20100,UCBPlayer,103,148,251,0,83,UCBPlayer
20101,UCBPlayer,136,321,457,35,26,UCBPlayer
20102,UCBPlayer,99,164,263,0,79,UCBPlayer
20103,UCBPlayer,140,305,445,35,30,UCBPlayer
20104,UCBPlayer,95,180,275,0,75,UCBPlayer
20105,UCBPlayer,144,289,433,35,34,UCBPlayer
20106,UCBPlayer,91,196,287,0,71,UCBPlayer
20107,UCBPlayer,148,273,421,35,38,UCBPlayer
20108,UCBPlayer,87,212,299,0,67,UCBPlayer
20109,UCBPlayer,152,257,409,35,42,UCBPlayer
20110,UCBPlayer,84,224,308,0,64,UCBPlayer
20111,UCBPlayer,146,251,397,32,45,UCBPlayer
20112,UCBPlayer,89,234,323,3,60,UCBPlayer
20113,UCBPlayer,138,243,381,28,49,UCBPlayer
20114,UCBPlayer,97,242,339,7,56,UCBPlayer
20115,UCBPlayer,130,235,365,24,53,UCBPlayer
20116,UCBPlayer,105,250,355,11,52,UCBPlayer
20117,UCBPlayer,122,227,349,20,57,UCBPlayer
20118,UCBPlayer,109,259,368,15,49,UCBPlayer
20119,UCBPlayer,118,218,336,16,60,UCBPlayer
20120,UCBPlayer,117,267,384,19,45,UCBPlayer
20121,UCBPlayer,110,210,320,12,64,UCBPlayer
20122,UCBPlayer,126,271,397,23,42,UCBPlayer
20123,UCBPlayer,105,210,315,10,65,UCBPlayer
20124,UCBPlayer,130,275,405,25,40,UCBPlayer
20125,UCBPlayer,105,210,315,10,65,UCBPlayer
20126,UCBPlayer,130,275,405,25,40,UCBPlayer
20127,UCBPlayer,106,206,312,10,66,UCBPlayer
20128,UCBPlayer,130,275,405,25,40,UCBPlayer
20129,UCBPlayer,105,210,315,10,65,UCBPlayer
20130,UCBPlayer,131,271,402,25,41,UCBPlayer
20131,UCBPlayer,105,210,315,10,65,UCBPlayer
20132,UCBPlayer,130,275,405,25,40,UCBPlayer
20133,UCBPlayer,105,210,315,10,65,UCBPlayer
20134,UCBPlayer,130,275,405,25,40,UCBPlayer
20135,UCBPlayer,103,203,306,10,68,UCBPlayer
20136,UCBPlayer,128,283,411,25,38,UCBPlayer
20137,UCBPlayer,111,186,297,10,71,UCBPlayer
20138,UCBPlayer,124,299,423,25,34,UCBPlayer
20139,UCBPlayer,115,170,285,10,75,UCBPlayer
20140,UCBPlayer,120,315,435,25,30,UCBPlayer
20141,UCBPlayer,119,154,273,10,79,UCBPlayer
20142,UCBPlayer,112,332,444,25,27,UCBPlayer
20143,UCBPlayer,127,137,264,10,82,UCBPlayer
20144,UCBPlayer,104,349,453,25,24,UCBPlayer
20145,UCBPlayer,126,126,252,7,85,Tie
20146,UCBPlayer,111,351,462,28,22,UCBPlayer
20147,UCBPlayer,116,126,242,3,87,UCBPlayer
20148,UCBPlayer,122,347,469,32,21,UCBPlayer
20149,UCBPlayer,107,132,239,0,87,UCBPlayer
20150,UCBPlayer,132,337,469,35,22,UCBPlayer
20151,UCBPlayer,103,148,251,0,83,UCBPlayer
20152,UCBPlayer,136,321,457,35,26,UCBPlayer
20153,UCBPlayer,99,164,263,0,79,UCBPlayer
20154,UCBPlayer,140,305,445,35,30,UCBPlayer
20155,UCBPlayer,95,180,275,0,75,UCBPlayer
20156,UCBPlayer,144,289,433,35,34,UCBPlayer
20157,UCBPlayer,91,196,287,0,71,UCBPlayer
20158,UCBPlayer,148,273,421,35,38,UCBPlayer
20159,UCBPlayer,87,212,299,0,67,UCBPlayer
20160,UCBPlayer,152,257,409,35,42,UCBPlayer
20161,UCBPlayer,84,224,308,0,64,UCBPlayer
20162,UCBPlayer,146,251,397,32,45,UCBPlayer
20163,UCBPlayer,89,234,323,3,60,UCBPlayer
20164,UCBPlayer,138,243,381,28,49,UCBPlayer
20165,UCBPlayer,97,242,339,7,56,UCBPlayer
20166,UCBPlayer,130,235,365,24,53,UCBPlayer
20167,UCBPlayer,105,250,355,11,52,UCBPlayer
20168,UCBPlayer,122,227,349,20,57,UCBPlayer
20169,UCBPlayer,109,259,368,15,49,UCBPlayer
20170,UCBPlayer,118,218,336,16,60,UCBPlayer
20171,UCBPlayer,117,267,384,19,45,UCBPlayer
20172,UCBPlayer,110,210,320,12,64,UCBPlayer
20173,UCBPlayer,126,271,397,23,42,UCBPlayer
20174,UCBPlayer,105,210,315,10,65,UCBPlayer
20175,UCBPlayer,130,275,405,25,40,UCBPlayer
20176,UCBPlayer,105,210,315,10,65,UCBPlayer
20177,UCBPlayer,130,275,405,25,40,UCBPlayer
20178,UCBPlayer,106,206,312,10,66,UCBPlayer
20179,UCBPlayer,130,275,405,25,40,UCBPlayer
20180,UCBPlayer,105,210,315,10,65,UCBPlayer
20181,UCBPlayer,131,271,402,25,41,UCBPlayer
20182,UCBPlayer,105,210,315,10,65,UCBPlayer
20183,UCBPlayer,130,275,405,25,40,UCBPlayer
20184,UCBPlayer,105,210,315,10,65,UCBPlayer
20185,UCBPlayer,130,275,405,25,40,UCBPlayer
20186,UCBPlayer,103,203,306,10,68,UCBPlayer
20187,UCBPlayer,128,283,411,25,38,UCBPlayer
20188,UCBPlayer,111,186,297,10,71,UCBPlayer
20189,UCBPlayer,124,299,423,25,34,UCBPlayer
20190,UCBPlayer,115,170,285,10,75,UCBPlayer
20191,UCBPlayer,120,315,435,25,30,UCBPlayer
20192,UCBPlayer,119,154,273,10,79,UCBPlayer
20193,UCBPlayer,112,332,444,25,27,UCBPlayer
20194,UCBPlayer,127,137,264,10,82,UCBPlayer
20195,UCBPlayer,104,349,453,25,24,UCBPlayer
20196,UCBPlayer,126,126,252,7,85,Tie
20197,UCBPlayer,111,351,462,28,22,UCBPlayer
20198,UCBPlayer,116,126,242,3,87,UCBPlayer
20199,UCBPlayer,122,347,469,32,21,UCBPlayer
20200,UCBPlayer,107,132,239,0,87,UCBPlayer
20201,UCBPlayer,132,337,469,35,22,UCBPlayer
20202,UCBPlayer,103,148,251,0,83,UCBPlayer
20203,UCBPlayer,136,321,457,35,26,UCBPlayer
20204,UCBPlayer,99,164,263,0,79,UCBPlayer
20205,UCBPlayer,140,305,445,35,30,UCBPlayer
20206,UCBPlayer,95,180,275,0,75,UCBPlayer
20207,UCBPlayer,144,289,433,35,34,UCBPlayer
20208,UCBPlayer,91,196,287,0,71,UCBPlayer
20209,UCBPlayer,148,273,421,35,38,UCBPlayer
20210,UCBPlayer,87,212,299,0,67,UCBPlayer
20211,UCBPlayer,152,257,409,35,42,UCBPlayer
20212,UCBPlayer,84,224,308,0,64,UCBPlayer
20213,UCBPlayer,146,251,397,32,45,UCBPlayer
20214,UCBPlayer,89,234,323,3,60,UCBPlayer
20215,UCBPlayer,138,243,381,28,49,UCBPlayer
20216,UCBPlayer,97,242,339,7,56,UCBPlayer
20217,UCBPlayer,130,235,365,24,53,UCBPlayer
20218,UCBPlayer,105,250,355,11,52,UCBPlayer
20219,UCBPlayer,122,227,349,20,57,UCBPlayer
20220,UCBPlayer,109,259,368,15,49,UCBPlayer
20221,UCBPlayer,118,218,336,16,60,UCBPlayer
20222,UCBPlayer,117,267,384,19,45,UCBPlayer
20223,UCBPlayer,110,210,320,12,64,UCBPlayer
20224,UCBPlayer,126,271,397,23,42,UCBPlayer
20225,UCBPlayer,105,210,315,10,65,UCBPlayer
20226,UCBPlayer,130,275,405,25,40,UCBPlayer
20227,UCBPlayer,105,210,315,10,65,UCBPlayer
20228,UCBPlayer,130,275,405,25,40,UCBPlayer
20229,UCBPlayer,106,206,312,10,66,UCBPlayer
20230,UCBPlayer,130,275,405,25,40,UCBPlayer
20231,UCBPlayer,105,210,315,10,65,UCBPlayer
20232,UCBPlayer,131,271,402,25,41,UCBPlayer
20233,UCBPlayer,105,210,315,10,65,UCBPlayer
20234,UCBPlayer,130,275,405,25,40,UCBPlayer
20235,UCBPlayer,105,210,315,10,65,UCBPlayer
20236,UCBPlayer,130,275,405,25,40,UCBPlayer
20237,UCBPlayer,103,203,306,10,68,UCBPlayer
20238,UCBPlayer,128,283,411,25,38,UCBPlayer
20239,UCBPlayer,111,186,297,10,71,UCBPlayer
20240,UCBPlayer,124,299,423,25,34,UCBPlayer
20241,UCBPlayer,115,170,285,10,75,UCBPlayer
20242,UCBPlayer,120,315,435,25,30,UCBPlayer
20243,UCBPlayer,119,154,273,10,79,UCBPlayer
20244,UCBPlayer,112,332,444,25,27,UCBPlayer
20245,UCBPlayer,127,137,264,10,82,UCBPlayer
20246,UCBPlayer,104,349,453,25,24,UCBPlayer
20247,UCBPlayer,126,126,252,7,85,Tie
20248,UCBPlayer,111,351,462,28,22,UCBPlayer
20249,UCBPlayer,116,126,242,3,87,UCBPlayer
20250,UCBPlayer,122,347,469,32,21,UCBPlayer
20251,UCBPlayer,107,132,239,0,87,UCBPlayer
20252,UCBPlayer,132,337,469,35,22,UCBPlayer
20253,UCBPlayer,103,148,251,0,83,UCBPlayer
20254,UCBPlayer,136,321,457,35,26,UCBPlayer
20255,UCBPlayer,99,164,263,0,79,UCBPlayer
20256,UCBPlayer,140,305,445,35,30,UCBPlayer
20257,UCBPlayer,95,180,275,0,75,UCBPlayer
20258,UCBPlayer,144,289,433,35,34,UCBPlayer
20259,UCBPlayer,91,196,287,0,71,UCBPlayer
20260,UCBPlayer,148,273,421,35,38,UCBPlayer
20261,UCBPlayer,87,212,299,0,67,UCBPlayer
20262,UCBPlayer,152,257,409,35,42,UCBPlayer
20263,UCBPlayer,84,224,308,0,64,UCBPlayer
20264,UCBPlayer,146,251,397,32,45,UCBPlayer
20265,UCBPlayer,89,234,323,3,60,UCBPlayer
20266,UCBPlayer,138,243,381,28,49,UCBPlayer
20267,UCBPlayer,97,242,339,7,56,UCBPlayer
20268,UCBPlayer,130,235,365,24,53,UCBPlayer
20269,UCBPlayer,105,250,355,11,52,UCBPlayer
20270,UCBPlayer,122,227,349,20,57,UCBPlayer
20271,UCBPlayer,109,259,368,15,49,UCBPlayer
20272,UCBPlayer,118,218,336,16,60,UCBPlayer
20273,UCBPlayer,117,267,384,19,45,UCBPlayer
20274,UCBPlayer,110,210,320,12,64,UCBPlayer
20275,UCBPlayer,126,271,397,23,42,UCBPlayer
20276,UCBPlayer,105,210,315,10,65,UCBPlayer
20277,UCBPlayer,130,275,405,25,40,UCBPlayer
20278,UCBPlayer,105,210,315,10,65,UCBPlayer
20279,UCBPlayer,130,275,405,25,40,UCBPlayer
20280,UCBPlayer,106,206,312,10,66,UCBPlayer
20281,UCBPlayer,130,275,405,25,40,UCBPlayer
20282,UCBPlayer,105,210,315,10,65,UCBPlayer
20283,UCBPlayer,131,271,402,25,41,UCBPlayer
20284,UCBPlayer,105,210,315,10,65,UCBPlayer
20285,UCBPlayer,130,275,405,25,40,UCBPlayer
20286,UCBPlayer,105,210,315,10,65,UCBPlayer
20287,UCBPlayer,130,275,405,25,40,UCBPlayer
20288,UCBPlayer,103,203,306,10,68,UCBPlayer
20289,UCBPlayer,128,283,411,25,38,UCBPlayer
20290,UCBPlayer,111,186,297,10,71,UCBPlayer
20291,UCBPlayer,124,299,423,25,34,UCBPlayer
20292,UCBPlayer,115,170,285,10,75,UCBPlayer
20293,UCBPlayer,120,315,435,25,30,UCBPlayer
20294,UCBPlayer,119,154,273,10,79,UCBPlayer
20295,UCBPlayer,112,332,444,25,27,UCBPlayer
20296,UCBPlayer,127,137,264,10,82,UCBPlayer
20297,UCBPlayer,104,349,453,25,24,UCBPlayer
20298,UCBPlayer,126,126,252,7,85,Tie
20299,UCBPlayer,111,351,462,28,22,UCBPlayer
20300,UCBPlayer,116,126,242,3,87,UCBPlayer
20301,UCBPlayer,122,347,469,32,21,UCBPlayer
20302,UCBPlayer,107,132,239,0,87,UCBPlayer
20303,UCBPlayer,132,337,469,35,22,UCBPlayer
20304,UCBPlayer,103,148,251,0,83,UCBPlayer
20305,UCBPlayer,136,321,457,35,26,UCBPlayer
20306,UCBPlayer,99,164,263,0,79,UCBPlayer
20307,UCBPlayer,140,305,445,35,30,UCBPlayer
20308,UCBPlayer,95,180,275,0,75,UCBPlayer
20309,UCBPlayer,144,289,433,35,34,UCBPlayer
20310,UCBPlayer,91,196,287,0,71,UCBPlayer
20311,UCBPlayer,148,273,421,35,38,UCBPlayer
20312,UCBPlayer,87,212,299,0,67,UCBPlayer
20313,UCBPlayer,152,257,409,35,42,UCBPlayer
20314,UCBPlayer,84,224,308,0,64,UCBPlayer
20315,UCBPlayer,146,251,397,32,45,UCBPlayer
20316,UCBPlayer,89,234,323,3,60,UCBPlayer
20317,UCBPlayer,138,243,381,28,49,UCBPlayer
20318,UCBPlayer,97,242,339,7,56,UCBPlayer
20319,UCBPlayer,130,235,365,24,53,UCBPlayer
20320,UCBPlayer,105,250,355,11,52,UCBPlayer
20321,UCBPlayer,122,227,349,20,57,UCBPlayer
20322,UCBPlayer,109,259,368,15,49,UCBPlayer
20323,UCBPlayer,118,218,336,16,60,UCBPlayer
20324,UCBPlayer,117,267,384,19,45,UCBPlayer
20325,UCBPlayer,110,210,320,12,64,UCBPlayer
20326,UCBPlayer,126,271,397,23,42,UCBPlayer
20327,UCBPlayer,105,210,315,10,65,UCBPlayer
20328,UCBPlayer,130,275,405,25,40,UCBPlayer
20329,UCBPlayer,105,210,315,10,65,UCBPlayer
20330,UCBPlayer,130,275,405,25,40,UCBPlayer
20331,UCBPlayer,106,206,312,10,66,UCBPlayer
20332,UCBPlayer,130,275,405,25,40,UCBPlayer
20333,UCBPlayer,105,210,315,10,65,UCBPlayer
20334,UCBPlayer,131,271,402,25,41,UCBPlayer
20335,UCBPlayer,105,210,315,10,65,UCBPlayer
20336,UCBPlayer,130,275,405,25,40,UCBPlayer
20337,UCBPlayer,105,210,315,10,65,UCBPlayer
20338,UCBPlayer,130,275,405,25,40,UCBPlayer
20339,UCBPlayer,103,203,306,10,68,UCBPlayer
20340,UCBPlayer,128,283,411,25,38,UCBPlayer
20341,UCBPlayer,111,186,297,10,71,UCBPlayer
20342,UCBPlayer,124,299,423,25,34,UCBPlayer
20343,UCBPlayer,115,170,285,10,75,UCBPlayer
20344,UCBPlayer,120,315,435,25,30,UCBPlayer
20345,UCBPlayer,119,154,273,10,79,UCBPlayer
20346,UCBPlayer,112,332,444,25,27,UCBPlayer
20347,UCBPlayer,127,137,264,10,82,UCBPlayer
20348,UCBPlayer,104,349,453,25,24,UCBPlayer
20349,UCBPlayer,126,126,252,7,85,Tie
20350,UCBPlayer,111,351,462,28,22,UCBPlayer
20351,UCBPlayer,116,126,242,3,87,UCBPlayer
20352,UCBPlayer,122,347,469,32,21,UCBPlayer
20353,UCBPlayer,107,132,239,0,87,UCBPlayer
20354,UCBPlayer,132,337,469,35,22,UCBPlayer
20355,UCBPlayer,103,148,251,0,83,UCBPlayer
20356,UCBPlayer,136,321,457,35,26,UCBPlayer
20357,UCBPlayer,99,164,263,0,79,UCBPlayer
20358,UCBPlayer,140,305,445,35,30,UCBPlayer
20359,UCBPlayer,95,180,275,0,75,UCBPlayer
20360,UCBPlayer,144,289,433,35,34,UCBPlayer
20361,UCBPlayer,91,196,287,0,71,UCBPlayer
20362,UCBPlayer,148,273,421,35,38,UCBPlayer
20363,UCBPlayer,87,212,299,0,67,UCBPlayer
20364,UCBPlayer,152,257,409,35,42,UCBPlayer
20365,UCBPlayer,84,224,308,0,64,UCBPlayer
20366,UCBPlayer,146,251,397,32,45,UCBPlayer
20367,UCBPlayer,89,234,323,3,60,UCBPlayer
20368,UCBPlayer,138,243,381,28,49,UCBPlayer
20369,UCBPlayer,97,242,339,7,56,UCBPlayer
20370,UCBPlayer,130,235,365,24,53,UCBPlayer
20371,UCBPlayer,105,250,355,11,52,UCBPlayer
20372,UCBPlayer,122,227,349,20,57,UCBPlayer
20373,UCBPlayer,109,259,368,15,49,UCBPlayer
20374,UCBPlayer,118,218,336,16,60,UCBPlayer
20375,UCBPlayer,117,267,384,19,45,UCBPlayer
20376,UCBPlayer,110,210,320,12,64,UCBPlayer
20377,UCBPlayer,126,271,397,23,42,UCBPlayer
20378,UCBPlayer,105,210,315,10,65,UCBPlayer
20379,UCBPlayer,130,275,405,25,40,UCBPlayer
20380,UCBPlayer,105,210,315,10,65,UCBPlayer
20381,UCBPlayer,130,275,405,25,40,UCBPlayer
20382,UCBPlayer,106,206,312,10,66,UCBPlayer
20383,UCBPlayer,130,275,405,25,40,UCBPlayer
20384,UCBPlayer,105,210,315,10,65,UCBPlayer
20385,UCBPlayer,131,271,402,25,41,UCBPlayer
20386,UCBPlayer,105,210,315,10,65,UCBPlayer
20387,UCBPlayer,130,275,405,25,40,UCBPlayer
20388,UCBPlayer,105,210,315,10,65,UCBPlayer
20389,UCBPlayer,130,275,405,25,40,UCBPlayer
20390,UCBPlayer,103,203,306,10,68,UCBPlayer
20391,UCBPlayer,128,283,411,25,38,UCBPlayer
20392,UCBPlayer,111,186,297,10,71,UCBPlayer
20393,UCBPlayer,124,299,423,25,34,UCBPlayer
20394,UCBPlayer,115,170,285,10,75,UCBPlayer
20395,UCBPlayer,120,315,435,25,30,UCBPlayer
20396,UCBPlayer,119,154,273,10,79,UCBPlayer
20397,UCBPlayer,112,332,444,25,27,UCBPlayer
20398,UCBPlayer,127,137,264,10,82,UCBPlayer
20399,UCBPlayer,104,349,453,25,24,UCBPlayer
20400,UCBPlayer,126,126,252,7,85,Tie
20401,UCBPlayer,111,351,462,28,22,UCBPlayer
20402,UCBPlayer,116,126,242,3,87,UCBPlayer
20403,UCBPlayer,122,347,469,32,21,UCBPlayer
20404,UCBPlayer,107,132,239,0,87,UCBPlayer
20405,UCBPlayer,132,337,469,35,22,UCBPlayer
20406,UCBPlayer,103,148,251,0,83,UCBPlayer
20407,UCBPlayer,136,321,457,35,26,UCBPlayer
20408,UCBPlayer,99,164,263,0,79,UCBPlayer
20409,UCBPlayer,140,305,445,35,30,UCBPlayer
20410,UCBPlayer,95,180,275,0,75,UCBPlayer
20411,UCBPlayer,144,289,433,35,34,UCBPlayer
20412,UCBPlayer,91,196,287,0,71,UCBPlayer
20413,UCBPlayer,148,273,421,35,38,UCBPlayer
20414,UCBPlayer,87,212,299,0,67,UCBPlayer
20415,UCBPlayer,152,257,409,35,42,UCBPlayer
20416,UCBPlayer,84,224,308,0,64,UCBPlayer
20417,UCBPlayer,146,251,397,32,45,UCBPlayer
20418,UCBPlayer,89,234,323,3,60,UCBPlayer
20419,UCBPlayer,138,243,381,28,49,UCBPlayer
20420,UCBPlayer,97,242,339,7,56,UCBPlayer
20421,UCBPlayer,130,235,365,24,53,UCBPlayer
20422,UCBPlayer,105,250,355,11,52,UCBPlayer
20423,UCBPlayer,122,227,349,20,57,UCBPlayer
20424,UCBPlayer,109,259,368,15,49,UCBPlayer
20425,UCBPlayer,118,218,336,16,60,UCBPlayer
20426,UCBPlayer,117,267,384,19,45,UCBPlayer
20427,UCBPlayer,110,210,320,12,64,UCBPlayer
20428,UCBPlayer,126,271,397,23,42,UCBPlayer
20429,UCBPlayer,105,210,315,10,65,UCBPlayer
20430,UCBPlayer,130,275,405,25,40,UCBPlayer
20431,UCBPlayer,105,210,315,10,65,UCBPlayer
20432,UCBPlayer,130,275,405,25,40,UCBPlayer
20433,UCBPlayer,106,206,312,10,66,UCBPlayer
20434,UCBPlayer,130,275,405,25,40,UCBPlayer
20435,UCBPlayer,105,210,315,10,65,UCBPlayer
20436,UCBPlayer,131,271,402,25,41,UCBPlayer
20437,UCBPlayer,105,210,315,10,65,UCBPlayer
20438,UCBPlayer,130,275,405,25,40,UCBPlayer
20439,UCBPlayer,105,210,315,10,65,UCBPlayer
20440,UCBPlayer,130,275,405,25,40,UCBPlayer
20441,UCBPlayer,103,203,306,10,68,UCBPlayer
20442,UCBPlayer,128,283,411,25,38,UCBPlayer
20443,UCBPlayer,111,186,297,10,71,UCBPlayer
20444,UCBPlayer,124,299,423,25,34,UCBPlayer
20445,UCBPlayer,115,170,285,10,75,UCBPlayer
20446,UCBPlayer,120,315,435,25,30,UCBPlayer
20447,UCBPlayer,119,154,273,10,79,UCBPlayer
20448,UCBPlayer,112,332,444,25,27,UCBPlayer
20449,UCBPlayer,127,137,264,10,82,UCBPlayer
20450,UCBPlayer,104,349,453,25,24,UCBPlayer
20451,UCBPlayer,126,126,252,7,85,Tie
20452,UCBPlayer,111,351,462,28,22,UCBPlayer
20453,UCBPlayer,116,126,242,3,87,UCBPlayer
20454,UCBPlayer,122,347,469,32,21,UCBPlayer
20455,UCBPlayer,107,132,239,0,87,UCBPlayer
20456,UCBPlayer,132,337,469,35,22,UCBPlayer
20457,UCBPlayer,103,148,251,0,83,UCBPlayer
20458,UCBPlayer,136,321,457,35,26,UCBPlayer
20459,UCBPlayer,99,164,263,0,79,UCBPlayer
20460,UCBPlayer,140,305,445,35,30,UCBPlayer
20461,UCBPlayer,95,180,275,0,75,UCBPlayer
20462,UCBPlayer,144,289,433,35,34,UCBPlayer
20463,UCBPlayer,91,196,287,0,71,UCBPlayer
20464,UCBPlayer,148,273,421,35,38,UCBPlayer
20465,UCBPlayer,87,212,299,0,67,UCBPlayer
20466,UCBPlayer,152,257,409,35,42,UCBPlayer
20467,UCBPlayer,84,224,308,0,64,UCBPlayer
20468,UCBPlayer,146,251,397,32,45,UCBPlayer
20469,UCBPlayer,89,234,323,3,60,UCBPlayer
20470,UCBPlayer,138,243,381,28,49,UCBPlayer
20471,UCBPlayer,97,242,339,7,56,UCBPlayer
20472,UCBPlayer,130,235,365,24,53,UCBPlayer
20473,UCBPlayer,105,250,355,11,52,UCBPlayer
20474,UCBPlayer,122,227,349,20,57,UCBPlayer
20475,UCBPlayer,109,259,368,15,49,UCBPlayer
20476,UCBPlayer,118,218,336,16,60,UCBPlayer
20477,UCBPlayer,117,267,384,19,45,UCBPlayer
20478,UCBPlayer,110,210,320,12,64,UCBPlayer
20479,UCBPlayer,126,271,397,23,42,UCBPlayer
20480,UCBPlayer,105,210,315,10,65,UCBPlayer
20481,UCBPlayer,130,275,405,25,40,UCBPlayer
20482,UCBPlayer,105,210,315,10,65,UCBPlayer
20483,UCBPlayer,130,275,405,25,40,UCBPlayer
20484,UCBPlayer,106,206,312,10,66,UCBPlayer
20485,UCBPlayer,130,275,405,25,40,UCBPlayer
20486,UCBPlayer,105,210,315,10,65,UCBPlayer
20487,UCBPlayer,131,271,402,25,41,UCBPlayer
20488,UCBPlayer,105,210,315,10,65,UCBPlayer
20489,UCBPlayer,130,275,405,25,40,UCBPlayer
20490,UCBPlayer,105,210,315,10,65,UCBPlayer
20491,UCBPlayer,130,275,405,25,40,UCBPlayer
20492,UCBPlayer,103,203,306,10,68,UCBPlayer
20493,UCBPlayer,128,283,411,25,38,UCBPlayer
20494,UCBPlayer,111,186,297,10,71,UCBPlayer
20495,UCBPlayer,124,299,423,25,34,UCBPlayer
20496,UCBPlayer,115,170,285,10,75,UCBPlayer
20497,UCBPlayer,120,315,435,25,30,UCBPlayer
20498,UCBPlayer,119,154,273,10,79,UCBPlayer
20499,UCBPlayer,112,332,444,25,27,UCBPlayer
20500,UCBPlayer,127,137,264,10,82,UCBPlayer
20501,UCBPlayer,104,349,453,25,24,UCBPlayer
20502,UCBPlayer,126,126,252,7,85,Tie
20503,UCBPlayer,111,351,462,28,22,UCBPlayer
20504,UCBPlayer,116,126,242,3,87,UCBPlayer
20505,UCBPlayer,122,347,469,32,21,UCBPlayer
20506,UCBPlayer,107,132,239,0,87,UCBPlayer
20507,UCBPlayer,132,337,469,35,22,UCBPlayer
20508,UCBPlayer,103,148,251,0,83,UCBPlayer
20509,UCBPlayer,136,321,457,35,26,UCBPlayer
20510,UCBPlayer,99,164,263,0,79,UCBPlayer
20511,UCBPlayer,140,305,445,35,30,UCBPlayer
20512,UCBPlayer,95,180,275,0,75,UCBPlayer
20513,UCBPlayer,144,289,433,35,34,UCBPlayer
20514,UCBPlayer,91,196,287,0,71,UCBPlayer
20515,UCBPlayer,148,273,421,35,38,UCBPlayer
20516,UCBPlayer,87,212,299,0,67,UCBPlayer
20517,UCBPlayer,152,257,409,35,42,UCBPlayer
20518,UCBPlayer,84,224,308,0,64,UCBPlayer
20519,UCBPlayer,146,251,397,32,45,UCBPlayer
20520,UCBPlayer,89,234,323,3,60,UCBPlayer
20521,UCBPlayer,138,243,381,28,49,UCBPlayer
20522,UCBPlayer,97,242,339,7,56,UCBPlayer
20523,UCBPlayer,130,235,365,24,53,UCBPlayer
20524,UCBPlayer,105,250,355,11,52,UCBPlayer
20525,UCBPlayer,122,227,349,20,57,UCBPlayer
20526,UCBPlayer,109,259,368,15,49,UCBPlayer
20527,UCBPlayer,118,218,336,16,60,UCBPlayer
20528,UCBPlayer,117,267,384,19,45,UCBPlayer
20529,UCBPlayer,110,210,320,12,64,UCBPlayer
20530,UCBPlayer,126,271,397,23,42,UCBPlayer
20531,UCBPlayer,105,210,315,10,65,UCBPlayer
20532,UCBPlayer,130,275,405,25,40,UCBPlayer
20533,UCBPlayer,105,210,315,10,65,UCBPlayer
20534,UCBPlayer,130,275,405,25,40,UCBPlayer
20535,UCBPlayer,106,206,312,10,66,UCBPlayer
20536,UCBPlayer,130,275,405,25,40,UCBPlayer
20537,UCBPlayer,105,210,315,10,65,UCBPlayer
20538,UCBPlayer,131,271,402,25,41,UCBPlayer
20539,UCBPlayer,105,210,315,10,65,UCBPlayer
20540,UCBPlayer,130,275,405,25,40,UCBPlayer
20541,UCBPlayer,105,210,315,10,65,UCBPlayer
20542,UCBPlayer,130,275,405,25,40,UCBPlayer
20543,UCBPlayer,103,203,306,10,68,UCBPlayer
20544,UCBPlayer,128,283,411,25,38,UCBPlayer
20545,UCBPlayer,111,186,297,10,71,UCBPlayer
20546,UCBPlayer,124,299,423,25,34,UCBPlayer
20547,UCBPlayer,115,170,285,10,75,UCBPlayer
20548,UCBPlayer,120,315,435,25,30,UCBPlayer
20549,UCBPlayer,119,154,273,10,79,UCBPlayer
20550,UCBPlayer,112,332,444,25,27,UCBPlayer
20551,UCBPlayer,127,137,264,10,82,UCBPlayer
20552,UCBPlayer,104,349,453,25,24,UCBPlayer
20553,UCBPlayer,126,126,252,7,85,Tie
20554,UCBPlayer,111,351,462,28,22,UCBPlayer
20555,UCBPlayer,116,126,242,3,87,UCBPlayer
20556,UCBPlayer,122,347,469,32,21,UCBPlayer
20557,UCBPlayer,107,132,239,0,87,UCBPlayer
20558,UCBPlayer,132,337,469,35,22,UCBPlayer
20559,UCBPlayer,103,148,251,0,83,UCBPlayer
20560,UCBPlayer,136,321,457,35,26,UCBPlayer
20561,UCBPlayer,99,164,263,0,79,UCBPlayer
20562,UCBPlayer,140,305,445,35,30,UCBPlayer
20563,UCBPlayer,95,180,275,0,75,UCBPlayer
20564,UCBPlayer,144,289,433,35,34,UCBPlayer
20565,UCBPlayer,91,196,287,0,71,UCBPlayer
20566,UCBPlayer,148,273,421,35,38,UCBPlayer
20567,UCBPlayer,87,212,299,0,67,UCBPlayer
20568,UCBPlayer,152,257,409,35,42,UCBPlayer
20569,UCBPlayer,84,224,308,0,64,UCBPlayer
20570,UCBPlayer,146,251,397,32,45,UCBPlayer
20571,UCBPlayer,89,234,323,3,60,UCBPlayer
20572,UCBPlayer,138,243,381,28,49,UCBPlayer
20573,UCBPlayer,97,242,339,7,56,UCBPlayer
20574,UCBPlayer,130,235,365,24,53,UCBPlayer
20575,UCBPlayer,105,250,355,11,52,UCBPlayer
20576,UCBPlayer,122,227,349,20,57,UCBPlayer
20577,UCBPlayer,109,259,368,15,49,UCBPlayer
20578,UCBPlayer,118,218,336,16,60,UCBPlayer
20579,UCBPlayer,117,267,384,19,45,UCBPlayer
20580,UCBPlayer,110,210,320,12,64,UCBPlayer
20581,UCBPlayer,126,271,397,23,42,UCBPlayer
20582,UCBPlayer,105,210,315,10,65,UCBPlayer
20583,UCBPlayer,130,275,405,25,40,UCBPlayer
20584,UCBPlayer,105,210,315,10,65,UCBPlayer
20585,UCBPlayer,130,275,405,25,40,UCBPlayer
20586,UCBPlayer,106,206,312,10,66,UCBPlayer
20587,UCBPlayer,130,275,405,25,40,UCBPlayer
20588,UCBPlayer,105,210,315,10,65,UCBPlayer
20589,UCBPlayer,131,271,402,25,41,UCBPlayer
20590,UCBPlayer,105,210,315,10,65,UCBPlayer
20591,UCBPlayer,130,275,405,25,40,UCBPlayer
20592,UCBPlayer,105,210,315,10,65,UCBPlayer
20593,UCBPlayer,130,275,405,25,40,UCBPlayer
20594,UCBPlayer,103,203,306,10,68,UCBPlayer
20595,UCBPlayer,128,283,411,25,38,UCBPlayer
20596,UCBPlayer,111,186,297,10,71,UCBPlayer
20597,UCBPlayer,124,299,423,25,34,UCBPlayer
20598,UCBPlayer,115,170,285,10,75,UCBPlayer
20599,UCBPlayer,120,315,435,25,30,UCBPlayer
20600,UCBPlayer,119,154,273,10,79,UCBPlayer
20601,UCBPlayer,112,332,444,25,27,UCBPlayer
20602,UCBPlayer,127,137,264,10,82,UCBPlayer
20603,UCBPlayer,104,349,453,25,24,UCBPlayer
20604,UCBPlayer,126,126,252,7,85,Tie
20605,UCBPlayer,111,351,462,28,22,UCBPlayer
20606,UCBPlayer,116,126,242,3,87,UCBPlayer
20607,UCBPlayer,122,347,469,32,21,UCBPlayer
20608,UCBPlayer,107,132,239,0,87,UCBPlayer
20609,UCBPlayer,132,337,469,35,22,UCBPlayer
20610,UCBPlayer,103,148,251,0,83,UCBPlayer
20611,UCBPlayer,136,321,457,35,26,UCBPlayer
20612,UCBPlayer,99,164,263,0,79,UCBPlayer
20613,UCBPlayer,140,305,445,35,30,UCBPlayer
20614,UCBPlayer,95,180,275,0,75,UCBPlayer
20615,UCBPlayer,144,289,433,35,34,UCBPlayer
20616,UCBPlayer,91,196,287,0,71,UCBPlayer
20617,UCBPlayer,148,273,421,35,38,UCBPlayer
20618,UCBPlayer,87,212,299,0,67,UCBPlayer
20619,UCBPlayer,152,257,409,35,42,UCBPlayer
20620,UCBPlayer,84,224,308,0,64,UCBPlayer
20621,UCBPlayer,146,251,397,32,45,UCBPlayer
20622,UCBPlayer,89,234,323,3,60,UCBPlayer
20623,UCBPlayer,138,243,381,28,49,UCBPlayer
20624,UCBPlayer,97,242,339,7,56,UCBPlayer
20625,UCBPlayer,130,235,365,24,53,UCBPlayer
20626,UCBPlayer,105,250,355,11,52,UCBPlayer
20627,UCBPlayer,122,227,349,20,57,UCBPlayer
20628,UCBPlayer,109,259,368,15,49,UCBPlayer
20629,UCBPlayer,118,218,336,16,60,UCBPlayer
20630,UCBPlayer,117,267,384,19,45,UCBPlayer
20631,UCBPlayer,110,210,320,12,64,UCBPlayer
20632,UCBPlayer,126,271,397,23,42,UCBPlayer
20633,UCBPlayer,105,210,315,10,65,UCBPlayer
20634,UCBPlayer,130,275,405,25,40,UCBPlayer
20635,UCBPlayer,105,210,315,10,65,UCBPlayer
20636,UCBPlayer,130,275,405,25,40,UCBPlayer
20637,UCBPlayer,106,206,312,10,66,UCBPlayer
20638,UCBPlayer,130,275,405,25,40,UCBPlayer
20639,UCBPlayer,105,210,315,10,65,UCBPlayer
20640,UCBPlayer,131,271,402,25,41,UCBPlayer
20641,UCBPlayer,105,210,315,10,65,UCBPlayer
20642,UCBPlayer,130,275,405,25,40,UCBPlayer
20643,UCBPlayer,105,210,315,10,65,UCBPlayer
20644,UCBPlayer,130,275,405,25,40,UCBPlayer
20645,UCBPlayer,103,203,306,10,68,UCBPlayer
20646,UCBPlayer,128,283,411,25,38,UCBPlayer
20647,UCBPlayer,111,186,297,10,71,UCBPlayer
20648,UCBPlayer,124,299,423,25,34,UCBPlayer
20649,UCBPlayer,115,170,285,10,75,UCBPlayer
20650,UCBPlayer,120,315,435,25,30,UCBPlayer
20651,UCBPlayer,119,154,273,10,79,UCBPlayer
20652,UCBPlayer,112,332,444,25,27,UCBPlayer
20653,UCBPlayer,127,137,264,10,82,UCBPlayer
20654,UCBPlayer,104,349,453,25,24,UCBPlayer
20655,UCBPlayer,126,126,252,7,85,Tie
20656,UCBPlayer,111,351,462,28,22,UCBPlayer
20657,UCBPlayer,116,126,242,3,87,UCBPlayer
20658,UCBPlayer,122,347,469,32,21,UCBPlayer
20659,UCBPlayer,107,132,239,0,87,UCBPlayer
20660,UCBPlayer,132,337,469,35,22,UCBPlayer
20661,UCBPlayer,103,148,251,0,83,UCBPlayer
20662,UCBPlayer,136,321,457,35,26,UCBPlayer
20663,UCBPlayer,99,164,263,0,79,UCBPlayer
20664,UCBPlayer,140,305,445,35,30,UCBPlayer
20665,UCBPlayer,95,180,275,0,75,UCBPlayer
20666,UCBPlayer,144,289,433,35,34,UCBPlayer
20667,UCBPlayer,91,196,287,0,71,UCBPlayer
20668,UCBPlayer,148,273,421,35,38,UCBPlayer
20669,UCBPlayer,87,212,299,0,67,UCBPlayer
20670,UCBPlayer,152,257,409,35,42,UCBPlayer
20671,UCBPlayer,84,224,308,0,64,UCBPlayer
20672,UCBPlayer,146,251,397,32,45,UCBPlayer
20673,UCBPlayer,89,234,323,3,60,UCBPlayer
20674,UCBPlayer,138,243,381,28,49,UCBPlayer
20675,UCBPlayer,97,242,339,7,56,UCBPlayer
20676,UCBPlayer,130,235,365,24,53,UCBPlayer
20677,UCBPlayer,105,250,355,11,52,UCBPlayer
20678,UCBPlayer,122,227,349,20,57,UCBPlayer
20679,UCBPlayer,109,259,368,15,49,UCBPlayer
20680,UCBPlayer,118,218,336,16,60,UCBPlayer
20681,UCBPlayer,117,267,384,19,45,UCBPlayer
20682,UCBPlayer,110,210,320,12,64,UCBPlayer
20683,UCBPlayer,126,271,397,23,42,UCBPlayer
20684,UCBPlayer,105,210,315,10,65,UCBPlayer
20685,UCBPlayer,130,275,405,25,40,UCBPlayer
20686,UCBPlayer,105,210,315,10,65,UCBPlayer
20687,UCBPlayer,130,275,405,25,40,UCBPlayer
20688,UCBPlayer,106,206,312,10,66,UCBPlayer
20689,UCBPlayer,130,275,405,25,40,UCBPlayer
20690,UCBPlayer,105,210,315,10,65,UCBPlayer
20691,UCBPlayer,131,271,402,25,41,UCBPlayer
20692,UCBPlayer,105,210,315,10,65,UCBPlayer
20693,UCBPlayer,130,275,405,25,40,UCBPlayer
20694,UCBPlayer,105,210,315,10,65,UCBPlayer
20695,UCBPlayer,130,275,405,25,40,UCBPlayer
20696,UCBPlayer,103,203,306,10,68,UCBPlayer
20697,UCBPlayer,128,283,411,25,38,UCBPlayer
20698,UCBPlayer,111,186,297,10,71,UCBPlayer
20699,UCBPlayer,124,299,423,25,34,UCBPlayer
20700,UCBPlayer,115,170,285,10,75,UCBPlayer
20701,UCBPlayer,120,315,435,25,30,UCBPlayer
20702,UCBPlayer,119,154,273,10,79,UCBPlayer
20703,UCBPlayer,112,332,444,25,27,UCBPlayer
20704,UCBPlayer,127,137,264,10,82,UCBPlayer
20705,UCBPlayer,104,349,453,25,24,UCBPlayer
20706,UCBPlayer,126,126,252,7,85,Tie
20707,UCBPlayer,111,351,462,28,22,UCBPlayer
20708,UCBPlayer,116,126,242,3,87,UCBPlayer
20709,UCBPlayer,122,347,469,32,21,UCBPlayer
20710,UCBPlayer,107,132,239,0,87,UCBPlayer
20711,UCBPlayer,132,337,469,35,22,UCBPlayer
20712,UCBPlayer,103,148,251,0,83,UCBPlayer
20713,UCBPlayer,136,321,457,35,26,UCBPlayer
20714,UCBPlayer,99,164,263,0,79,UCBPlayer
20715,UCBPlayer,140,305,445,35,30,UCBPlayer
20716,UCBPlayer,95,180,275,0,75,UCBPlayer
20717,UCBPlayer,144,289,433,35,34,UCBPlayer
20718,UCBPlayer,91,196,287,0,71,UCBPlayer
20719,UCBPlayer,148,273,421,35,38,UCBPlayer
20720,UCBPlayer,87,212,299,0,67,UCBPlayer
20721,UCBPlayer,152,257,409,35,42,UCBPlayer
20722,UCBPlayer,84,224,308,0,64,UCBPlayer
20723,UCBPlayer,146,251,397,32,45,UCBPlayer
20724,UCBPlayer,89,234,323,3,60,UCBPlayer
20725,UCBPlayer,138,243,381,28,49,UCBPlayer
20726,UCBPlayer,97,242,339,7,56,UCBPlayer
20727,UCBPlayer,130,235,365,24,53,UCBPlayer
20728,UCBPlayer,105,250,355,11,52,UCBPlayer
20729,UCBPlayer,122,227,349,20,57,UCBPlayer
20730,UCBPlayer,109,259,368,15,49,UCBPlayer
20731,UCBPlayer,118,218,336,16,60,UCBPlayer
20732,UCBPlayer,117,267,384,19,45,UCBPlayer
20733,UCBPlayer,110,210,320,12,64,UCBPlayer
20734,UCBPlayer,126,271,397,23,42,UCBPlayer
20735,UCBPlayer,105,210,315,10,65,UCBPlayer
20736,UCBPlayer,130,275,405,25,40,UCBPlayer
20737,UCBPlayer,105,210,315,10,65,UCBPlayer
20738,UCBPlayer,130,275,405,25,40,UCBPlayer
20739,UCBPlayer,106,206,312,10,66,UCBPlayer
20740,UCBPlayer,130,275,405,25,40,UCBPlayer
20741,UCBPlayer,105,210,315,10,65,UCBPlayer
20742,UCBPlayer,131,271,402,25,41,UCBPlayer
20743,UCBPlayer,105,210,315,10,65,UCBPlayer
20744,UCBPlayer,130,275,405,25,40,UCBPlayer
20745,UCBPlayer,105,210,315,10,65,UCBPlayer
20746,UCBPlayer,130,275,405,25,40,UCBPlayer
20747,UCBPlayer,103,203,306,10,68,UCBPlayer
20748,UCBPlayer,128,283,411,25,38,UCBPlayer
20749,UCBPlayer,111,186,297,10,71,UCBPlayer
20750,UCBPlayer,124,299,423,25,34,UCBPlayer
20751,UCBPlayer,115,170,285,10,75,UCBPlayer
20752,UCBPlayer,120,315,435,25,30,UCBPlayer
20753,UCBPlayer,119,154,273,10,79,UCBPlayer
20754,UCBPlayer,112,332,444,25,27,UCBPlayer
20755,UCBPlayer,127,137,264,10,82,UCBPlayer
20756,UCBPlayer,104,349,453,25,24,UCBPlayer
20757,UCBPlayer,126,126,252,7,85,Tie
20758,UCBPlayer,111,351,462,28,22,UCBPlayer
20759,UCBPlayer,116,126,242,3,87,UCBPlayer
20760,UCBPlayer,122,347,469,32,21,UCBPlayer
20761,UCBPlayer,107,132,239,0,87,UCBPlayer
20762,UCBPlayer,132,337,469,35,22,UCBPlayer
20763,UCBPlayer,103,148,251,0,83,UCBPlayer
20764,UCBPlayer,136,321,457,35,26,UCBPlayer
20765,UCBPlayer,99,164,263,0,79,UCBPlayer
20766,UCBPlayer,140,305,445,35,30,UCBPlayer
20767,UCBPlayer,95,180,275,0,75,UCBPlayer
20768,UCBPlayer,144,289,433,35,34,UCBPlayer
20769,UCBPlayer,91,196,287,0,71,UCBPlayer
20770,UCBPlayer,148,273,421,35,38,UCBPlayer
20771,UCBPlayer,87,212,299,0,67,UCBPlayer
20772,UCBPlayer,152,257,409,35,42,UCBPlayer
20773,UCBPlayer,84,224,308,0,64,UCBPlayer
20774,UCBPlayer,146,251,397,32,45,UCBPlayer
20775,UCBPlayer,89,234,323,3,60,UCBPlayer
20776,UCBPlayer,138,243,381,28,49,UCBPlayer
20777,UCBPlayer,97,242,339,7,56,UCBPlayer
20778,UCBPlayer,130,235,365,24,53,UCBPlayer
20779,UCBPlayer,105,250,355,11,52,UCBPlayer
20780,UCBPlayer,122,227,349,20,57,UCBPlayer
20781,UCBPlayer,109,259,368,15,49,UCBPlayer
20782,UCBPlayer,118,218,336,16,60,UCBPlayer
20783,UCBPlayer,117,267,384,19,45,UCBPlayer
20784,UCBPlayer,110,210,320,12,64,UCBPlayer
20785,UCBPlayer,126,271,397,23,42,UCBPlayer
20786,UCBPlayer,105,210,315,10,65,UCBPlayer
20787,UCBPlayer,130,275,405,25,40,UCBPlayer
20788,UCBPlayer,105,210,315,10,65,UCBPlayer
20789,UCBPlayer,130,275,405,25,40,UCBPlayer
20790,UCBPlayer,106,206,312,10,66,UCBPlayer
20791,UCBPlayer,130,275,405,25,40,UCBPlayer
20792,UCBPlayer,105,210,315,10,65,UCBPlayer
20793,UCBPlayer,131,271,402,25,41,UCBPlayer
20794,UCBPlayer,105,210,315,10,65,UCBPlayer
20795,UCBPlayer,130,275,405,25,40,UCBPlayer
20796,UCBPlayer,105,210,315,10,65,UCBPlayer
20797,UCBPlayer,130,275,405,25,40,UCBPlayer
20798,UCBPlayer,103,203,306,10,68,UCBPlayer
20799,UCBPlayer,128,283,411,25,38,UCBPlayer
20800,UCBPlayer,111,186,297,10,71,UCBPlayer
20801,UCBPlayer,124,299,423,25,34,UCBPlayer
20802,UCBPlayer,115,170,285,10,75,UCBPlayer
20803,UCBPlayer,120,315,435,25,30,UCBPlayer
20804,UCBPlayer,119,154,273,10,79,UCBPlayer
20805,UCBPlayer,112,332,444,25,27,UCBPlayer
20806,UCBPlayer,127,137,264,10,82,UCBPlayer
20807,UCBPlayer,104,349,453,25,24,UCBPlayer
20808,UCBPlayer,126,126,252,7,85,Tie
20809,UCBPlayer,111,351,462,28,22,UCBPlayer
20810,UCBPlayer,116,126,242,3,87,UCBPlayer
20811,UCBPlayer,122,347,469,32,21,UCBPlayer
20812,UCBPlayer,107,132,239,0,87,UCBPlayer
20813,UCBPlayer,132,337,469,35,22,UCBPlayer
20814,UCBPlayer,103,148,251,0,83,UCBPlayer
20815,UCBPlayer,136,321,457,35,26,UCBPlayer
20816,UCBPlayer,99,164,263,0,79,UCBPlayer
20817,UCBPlayer,140,305,445,35,30,UCBPlayer
20818,UCBPlayer,95,180,275,0,75,UCBPlayer
20819,UCBPlayer,144,289,433,35,34,UCBPlayer
20820,UCBPlayer,91,196,287,0,71,UCBPlayer
20821,UCBPlayer,148,273,421,35,38,UCBPlayer
20822,UCBPlayer,87,212,299,0,67,UCBPlayer
20823,UCBPlayer,152,257,409,35,42,UCBPlayer
20824,UCBPlayer,84,224,308,0,64,UCBPlayer
20825,UCBPlayer,146,251,397,32,45,UCBPlayer
20826,UCBPlayer,89,234,323,3,60,UCBPlayer
20827,UCBPlayer,138,243,381,28,49,UCBPlayer
20828,UCBPlayer,97,242,339,7,56,UCBPlayer
20829,UCBPlayer,130,235,365,24,53,UCBPlayer
20830,UCBPlayer,105,250,355,11,52,UCBPlayer
20831,UCBPlayer,122,227,349,20,57,UCBPlayer
20832,UCBPlayer,109,259,368,15,49,UCBPlayer
20833,UCBPlayer,118,218,336,16,60,UCBPlayer
20834,UCBPlayer,117,267,384,19,45,UCBPlayer
20835,UCBPlayer,110,210,320,12,64,UCBPlayer
20836,UCBPlayer,126,271,397,23,42,UCBPlayer
20837,UCBPlayer,105,210,315,10,65,UCBPlayer
20838,UCBPlayer,130,275,405,25,40,UCBPlayer
20839,UCBPlayer,105,210,315,10,65,UCBPlayer
20840,UCBPlayer,130,275,405,25,40,UCBPlayer
20841,UCBPlayer,106,206,312,10,66,UCBPlayer
20842,UCBPlayer,130,275,405,25,40,UCBPlayer
20843,UCBPlayer,105,210,315,10,65,UCBPlayer
20844,UCBPlayer,131,271,402,25,41,UCBPlayer
20845,UCBPlayer,105,210,315,10,65,UCBPlayer
20846,UCBPlayer,130,275,405,25,40,UCBPlayer
20847,UCBPlayer,105,210,315,10,65,UCBPlayer
20848,UCBPlayer,130,275,405,25,40,UCBPlayer
20849,UCBPlayer,103,203,306,10,68,UCBPlayer
20850,UCBPlayer,128,283,411,25,38,UCBPlayer
20851,UCBPlayer,111,186,297,10,71,UCBPlayer
20852,UCBPlayer,124,299,423,25,34,UCBPlayer
20853,UCBPlayer,115,170,285,10,75,UCBPlayer
20854,UCBPlayer,120,315,435,25,30,UCBPlayer
20855,UCBPlayer,119,154,273,10,79,UCBPlayer
20856,UCBPlayer,112,332,444,25,27,UCBPlayer
20857,UCBPlayer,127,137,264,10,82,UCBPlayer
20858,UCBPlayer,104,349,453,25,24,UCBPlayer
20859,UCBPlayer,126,126,252,7,85,Tie
20860,UCBPlayer,111,351,462,28,22,UCBPlayer
20861,UCBPlayer,116,126,242,3,87,UCBPlayer
20862,UCBPlayer,122,347,469,32,21,UCBPlayer
20863,UCBPlayer,107,132,239,0,87,UCBPlayer
20864,UCBPlayer,132,337,469,35,22,UCBPlayer
20865,UCBPlayer,103,148,251,0,83,UCBPlayer
20866,UCBPlayer,136,321,457,35,26,UCBPlayer
20867,UCBPlayer,99,164,263,0,79,UCBPlayer
20868,UCBPlayer,140,305,445,35,30,UCBPlayer
20869,UCBPlayer,95,180,275,0,75,UCBPlayer
20870,UCBPlayer,144,289,433,35,34,UCBPlayer
20871,UCBPlayer,91,196,287,0,71,UCBPlayer
20872,UCBPlayer,148,273,421,35,38,UCBPlayer
20873,UCBPlayer,87,212,299,0,67,UCBPlayer
20874,UCBPlayer,152,257,409,35,42,UCBPlayer
20875,UCBPlayer,84,224,308,0,64,UCBPlayer
20876,UCBPlayer,146,251,397,32,45,UCBPlayer
20877,UCBPlayer,89,234,323,3,60,UCBPlayer
20878,UCBPlayer,138,243,381,28,49,UCBPlayer
20879,UCBPlayer,97,242,339,7,56,UCBPlayer
20880,UCBPlayer,130,235,365,24,53,UCBPlayer
20881,UCBPlayer,105,250,355,11,52,UCBPlayer
20882,UCBPlayer,122,227,349,20,57,UCBPlayer
20883,UCBPlayer,109,259,368,15,49,UCBPlayer
20884,UCBPlayer,118,218,336,16,60,UCBPlayer
20885,UCBPlayer,117,267,384,19,45,UCBPlayer
20886,UCBPlayer,110,210,320,12,64,UCBPlayer
20887,UCBPlayer,126,271,397,23,42,UCBPlayer
20888,UCBPlayer,105,210,315,10,65,UCBPlayer
20889,UCBPlayer,130,275,405,25,40,UCBPlayer
20890,UCBPlayer,105,210,315,10,65,UCBPlayer
20891,UCBPlayer,130,275,405,25,40,UCBPlayer
20892,UCBPlayer,106,206,312,10,66,UCBPlayer
20893,UCBPlayer,130,275,405,25,40,UCBPlayer
20894,UCBPlayer,105,210,315,10,65,UCBPlayer
20895,UCBPlayer,131,271,402,25,41,UCBPlayer
20896,UCBPlayer,105,210,315,10,65,UCBPlayer
20897,UCBPlayer,130,275,405,25,40,UCBPlayer
20898,UCBPlayer,105,210,315,10,65,UCBPlayer
20899,UCBPlayer,130,275,405,25,40,UCBPlayer
20900,UCBPlayer,103,203,306,10,68,UCBPlayer
20901,UCBPlayer,128,283,411,25,38,UCBPlayer
20902,UCBPlayer,111,186,297,10,71,UCBPlayer
20903,UCBPlayer,124,299,423,25,34,UCBPlayer
20904,UCBPlayer,115,170,285,10,75,UCBPlayer
20905,UCBPlayer,120,315,435,25,30,UCBPlayer
20906,UCBPlayer,119,154,273,10,79,UCBPlayer
20907,UCBPlayer,112,332,444,25,27,UCBPlayer
20908,UCBPlayer,127,137,264,10,82,UCBPlayer
20909,UCBPlayer,104,349,453,25,24,UCBPlayer
20910,UCBPlayer,126,126,252,7,85,Tie
20911,UCBPlayer,111,351,462,28,22,UCBPlayer
20912,UCBPlayer,116,126,242,3,87,UCBPlayer
20913,UCBPlayer,122,347,469,32,21,UCBPlayer
20914,UCBPlayer,107,132,239,0,87,UCBPlayer
20915,UCBPlayer,132,337,469,35,22,UCBPlayer
20916,UCBPlayer,103,148,251,0,83,UCBPlayer
20917,UCBPlayer,136,321,457,35,26,UCBPlayer
20918,UCBPlayer,99,164,263,0,79,UCBPlayer
20919,UCBPlayer,140,305,445,35,30,UCBPlayer
20920,UCBPlayer,95,180,275,0,75,UCBPlayer
20921,UCBPlayer,144,289,433,35,34,UCBPlayer
20922,UCBPlayer,91,196,287,0,71,UCBPlayer
20923,UCBPlayer,148,273,421,35,38,UCBPlayer
20924,UCBPlayer,87,212,299,0,67,UCBPlayer
20925,UCBPlayer,152,257,409,35,42,UCBPlayer
20926,UCBPlayer,84,224,308,0,64,UCBPlayer
20927,UCBPlayer,146,251,397,32,45,UCBPlayer
20928,UCBPlayer,89,234,323,3,60,UCBPlayer
20929,UCBPlayer,138,243,381,28,49,UCBPlayer
20930,UCBPlayer,97,242,339,7,56,UCBPlayer
20931,UCBPlayer,130,235,365,24,53,UCBPlayer
20932,UCBPlayer,105,250,355,11,52,UCBPlayer
20933,UCBPlayer,122,227,349,20,57,UCBPlayer
20934,UCBPlayer,109,259,368,15,49,UCBPlayer
20935,UCBPlayer,118,218,336,16,60,UCBPlayer
20936,UCBPlayer,117,267,384,19,45,UCBPlayer
20937,UCBPlayer,110,210,320,12,64,UCBPlayer
20938,UCBPlayer,126,271,397,23,42,UCBPlayer
20939,UCBPlayer,105,210,315,10,65,UCBPlayer
20940,UCBPlayer,130,275,405,25,40,UCBPlayer
20941,UCBPlayer,105,210,315,10,65,UCBPlayer
20942,UCBPlayer,130,275,405,25,40,UCBPlayer
20943,UCBPlayer,106,206,312,10,66,UCBPlayer
20944,UCBPlayer,130,275,405,25,40,UCBPlayer
20945,UCBPlayer,105,210,315,10,65,UCBPlayer
20946,UCBPlayer,131,271,402,25,41,UCBPlayer
20947,UCBPlayer,105,210,315,10,65,UCBPlayer
20948,UCBPlayer,130,275,405,25,40,UCBPlayer
20949,UCBPlayer,105,210,315,10,65,UCBPlayer
20950,UCBPlayer,130,275,405,25,40,UCBPlayer
20951,UCBPlayer,103,203,306,10,68,UCBPlayer
20952,UCBPlayer,128,283,411,25,38,UCBPlayer
20953,UCBPlayer,111,186,297,10,71,UCBPlayer
20954,UCBPlayer,124,299,423,25,34,UCBPlayer
20955,UCBPlayer,115,170,285,10,75,UCBPlayer
20956,UCBPlayer,120,315,435,25,30,UCBPlayer
20957,UCBPlayer,119,154,273,10,79,UCBPlayer
20958,UCBPlayer,112,332,444,25,27,UCBPlayer
20959,UCBPlayer,127,137,264,10,82,UCBPlayer
20960,UCBPlayer,104,349,453,25,24,UCBPlayer
20961,UCBPlayer,126,126,252,7,85,Tie
20962,UCBPlayer,111,351,462,28,22,UCBPlayer
20963,UCBPlayer,116,126,242,3,87,UCBPlayer
20964,UCBPlayer,122,347,469,32,21,UCBPlayer
20965,UCBPlayer,107,132,239,0,87,UCBPlayer
20966,UCBPlayer,132,337,469,35,22,UCBPlayer
20967,UCBPlayer,103,148,251,0,83,UCBPlayer
20968,UCBPlayer,136,321,457,35,26,UCBPlayer
20969,UCBPlayer,99,164,263,0,79,UCBPlayer
20970,UCBPlayer,140,305,445,35,30,UCBPlayer
20971,UCBPlayer,95,180,275,0,75,UCBPlayer
20972,UCBPlayer,144,289,433,35,34,UCBPlayer
20973,UCBPlayer,91,196,287,0,71,UCBPlayer
20974,UCBPlayer,148,273,421,35,38,UCBPlayer
20975,UCBPlayer,87,212,299,0,67,UCBPlayer
20976,UCBPlayer,152,257,409,35,42,UCBPlayer
20977,UCBPlayer,84,224,308,0,64,UCBPlayer
20978,UCBPlayer,146,251,397,32,45,UCBPlayer
20979,UCBPlayer,89,234,323,3,60,UCBPlayer
20980,UCBPlayer,138,243,381,28,49,UCBPlayer
20981,UCBPlayer,97,242,339,7,56,UCBPlayer
20982,UCBPlayer,130,235,365,24,53,UCBPlayer
20983,UCBPlayer,105,250,355,11,52,UCBPlayer
20984,UCBPlayer,122,227,349,20,57,UCBPlayer
20985,UCBPlayer,109,259,368,15,49,UCBPlayer
20986,UCBPlayer,118,218,336,16,60,UCBPlayer
20987,UCBPlayer,117,267,384,19,45,UCBPlayer
20988,UCBPlayer,110,210,320,12,64,UCBPlayer
20989,UCBPlayer,126,271,397,23,42,UCBPlayer
20990,UCBPlayer,105,210,315,10,65,UCBPlayer
20991,UCBPlayer,130,275,405,25,40,UCBPlayer
20992,UCBPlayer,105,210,315,10,65,UCBPlayer
20993,UCBPlayer,130,275,405,25,40,UCBPlayer
20994,UCBPlayer,106,206,312,10,66,UCBPlayer
20995,UCBPlayer,130,275,405,25,40,UCBPlayer
20996,UCBPlayer,105,210,315,10,65,UCBPlayer
20997,UCBPlayer,131,271,402,25,41,UCBPlayer
20998,UCBPlayer,105,210,315,10,65,UCBPlayer
20999,UCBPlayer,130,275,405,25,40,UCBPlayer
21000,UCBPlayer,105,210,315,10,65,UCBPlayer
21001,UCBPlayer,130,275,405,25,40,UCBPlayer
21002,UCBPlayer,103,203,306,10,68,UCBPlayer
21003,UCBPlayer,128,283,411,25,38,UCBPlayer
21004,UCBPlayer,111,186,297,10,71,UCBPlayer
21005,UCBPlayer,124,299,423,25,34,UCBPlayer
21006,UCBPlayer,115,170,285,10,75,UCBPlayer
21007,UCBPlayer,120,315,435,25,30,UCBPlayer
21008,UCBPlayer,119,154,273,10,79,UCBPlayer
21009,UCBPlayer,112,332,444,25,27,UCBPlayer
21010,UCBPlayer,127,137,264,10,82,UCBPlayer
21011,UCBPlayer,104,349,453,25,24,UCBPlayer
21012,UCBPlayer,126,126,252,7,85,Tie
21013,UCBPlayer,111,351,462,28,22,UCBPlayer
21014,UCBPlayer,116,126,242,3,87,UCBPlayer
21015,UCBPlayer,122,347,469,32,21,UCBPlayer
21016,UCBPlayer,107,132,239,0,87,UCBPlayer
21017,UCBPlayer,132,337,469,35,22,UCBPlayer
21018,UCBPlayer,103,148,251,0,83,UCBPlayer
21019,UCBPlayer,136,321,457,35,26,UCBPlayer
21020,UCBPlayer,99,164,263,0,79,UCBPlayer
21021,UCBPlayer,140,305,445,35,30,UCBPlayer
21022,UCBPlayer,95,180,275,0,75,UCBPlayer
21023,UCBPlayer,144,289,433,35,34,UCBPlayer
21024,UCBPlayer,91,196,287,0,71,UCBPlayer
21025,UCBPlayer,148,273,421,35,38,UCBPlayer
21026,UCBPlayer,87,212,299,0,67,UCBPlayer
21027,UCBPlayer,152,257,409,35,42,UCBPlayer
21028,UCBPlayer,84,224,308,0,64,UCBPlayer
21029,UCBPlayer,146,251,397,32,45,UCBPlayer
21030,UCBPlayer,89,234,323,3,60,UCBPlayer
21031,UCBPlayer,138,243,381,28,49,UCBPlayer
21032,UCBPlayer,97,242,339,7,56,UCBPlayer
21033,UCBPlayer,130,235,365,24,53,UCBPlayer
21034,UCBPlayer,105,250,355,11,52,UCBPlayer
21035,UCBPlayer,122,227,349,20,57,UCBPlayer
21036,UCBPlayer,109,259,368,15,49,UCBPlayer
21037,UCBPlayer,118,218,336,16,60,UCBPlayer
21038,UCBPlayer,117,267,384,19,45,UCBPlayer
21039,UCBPlayer,110,210,320,12,64,UCBPlayer
21040,UCBPlayer,126,271,397,23,42,UCBPlayer
21041,UCBPlayer,105,210,315,10,65,UCBPlayer
21042,UCBPlayer,130,275,405,25,40,UCBPlayer
21043,UCBPlayer,105,210,315,10,65,UCBPlayer
21044,UCBPlayer,130,275,405,25,40,UCBPlayer
21045,UCBPlayer,106,206,312,10,66,UCBPlayer
21046,UCBPlayer,130,275,405,25,40,UCBPlayer
21047,UCBPlayer,105,210,315,10,65,UCBPlayer
21048,UCBPlayer,131,271,402,25,41,UCBPlayer
21049,UCBPlayer,105,210,315,10,65,UCBPlayer
21050,UCBPlayer,130,275,405,25,40,UCBPlayer
21051,UCBPlayer,105,210,315,10,65,UCBPlayer
21052,UCBPlayer,130,275,405,25,40,UCBPlayer
21053,UCBPlayer,103,203,306,10,68,UCBPlayer
21054,UCBPlayer,128,283,411,25,38,UCBPlayer
21055,UCBPlayer,111,186,297,10,71,UCBPlayer
21056,UCBPlayer,124,299,423,25,34,UCBPlayer
21057,UCBPlayer,115,170,285,10,75,UCBPlayer
21058,UCBPlayer,120,315,435,25,30,UCBPlayer
21059,UCBPlayer,119,154,273,10,79,UCBPlayer
21060,UCBPlayer,112,332,444,25,27,UCBPlayer
21061,UCBPlayer,127,137,264,10,82,UCBPlayer
21062,UCBPlayer,104,349,453,25,24,UCBPlayer
21063,UCBPlayer,126,126,252,7,85,Tie
21064,UCBPlayer,111,351,462,28,22,UCBPlayer
21065,UCBPlayer,116,126,242,3,87,UCBPlayer
21066,UCBPlayer,122,347,469,32,21,UCBPlayer
21067,UCBPlayer,107,132,239,0,87,UCBPlayer
21068,UCBPlayer,132,337,469,35,22,UCBPlayer
21069,UCBPlayer,103,148,251,0,83,UCBPlayer
21070,UCBPlayer,136,321,457,35,26,UCBPlayer
21071,UCBPlayer,99,164,263,0,79,UCBPlayer
21072,UCBPlayer,140,305,445,35,30,UCBPlayer
21073,UCBPlayer,95,180,275,0,75,UCBPlayer
21074,UCBPlayer,144,289,433,35,34,UCBPlayer
21075,UCBPlayer,91,196,287,0,71,UCBPlayer
21076,UCBPlayer,148,273,421,35,38,UCBPlayer
21077,UCBPlayer,87,212,299,0,67,UCBPlayer
21078,UCBPlayer,152,257,409,35,42,UCBPlayer
21079,UCBPlayer,84,224,308,0,64,UCBPlayer
21080,UCBPlayer,146,251,397,32,45,UCBPlayer
21081,UCBPlayer,89,234,323,3,60,UCBPlayer
21082,UCBPlayer,138,243,381,28,49,UCBPlayer
21083,UCBPlayer,97,242,339,7,56,UCBPlayer
21084,UCBPlayer,130,235,365,24,53,UCBPlayer
21085,UCBPlayer,105,250,355,11,52,UCBPlayer
21086,UCBPlayer,122,227,349,20,57,UCBPlayer
21087,UCBPlayer,109,259,368,15,49,UCBPlayer
21088,UCBPlayer,118,218,336,16,60,UCBPlayer
21089,UCBPlayer,117,267,384,19,45,UCBPlayer
21090,UCBPlayer,110,210,320,12,64,UCBPlayer
21091,UCBPlayer,126,271,397,23,42,UCBPlayer
21092,UCBPlayer,105,210,315,10,65,UCBPlayer
21093,UCBPlayer,130,275,405,25,40,UCBPlayer
21094,UCBPlayer,105,210,315,10,65,UCBPlayer
21095,UCBPlayer,130,275,405,25,40,UCBPlayer
21096,UCBPlayer,106,206,312,10,66,UCBPlayer
21097,UCBPlayer,130,275,405,25,40,UCBPlayer
21098,UCBPlayer,105,210,315,10,65,UCBPlayer
21099,UCBPlayer,131,271,402,25,41,UCBPlayer
21100,UCBPlayer,105,210,315,10,65,UCBPlayer
21101,UCBPlayer,130,275,405,25,40,UCBPlayer
21102,UCBPlayer,105,210,315,10,65,UCBPlayer
21103,UCBPlayer,130,275,405,25,40,UCBPlayer
21104,UCBPlayer,103,203,306,10,68,UCBPlayer
21105,UCBPlayer,128,283,411,25,38,UCBPlayer
21106,UCBPlayer,111,186,297,10,71,UCBPlayer
21107,UCBPlayer,124,299,423,25,34,UCBPlayer
21108,UCBPlayer,115,170,285,10,75,UCBPlayer
21109,UCBPlayer,120,315,435,25,30,UCBPlayer
21110,UCBPlayer,119,154,273,10,79,UCBPlayer
21111,UCBPlayer,112,332,444,25,27,UCBPlayer
21112,UCBPlayer,127,137,264,10,82,UCBPlayer
21113,UCBPlayer,104,349,453,25,24,UCBPlayer
21114,UCBPlayer,126,126,252,7,85,Tie
21115,UCBPlayer,111,351,462,28,22,UCBPlayer
21116,UCBPlayer,116,126,242,3,87,UCBPlayer
21117,UCBPlayer,122,347,469,32,21,UCBPlayer
21118,UCBPlayer,107,132,239,0,87,UCBPlayer
21119,UCBPlayer,132,337,469,35,22,UCBPlayer
21120,UCBPlayer,103,148,251,0,83,UCBPlayer
21121,UCBPlayer,136,321,457,35,26,UCBPlayer
21122,UCBPlayer,99,164,263,0,79,UCBPlayer
21123,UCBPlayer,140,305,445,35,30,UCBPlayer
21124,UCBPlayer,95,180,275,0,75,UCBPlayer
21125,UCBPlayer,144,289,433,35,34,UCBPlayer
21126,UCBPlayer,91,196,287,0,71,UCBPlayer
21127,UCBPlayer,148,273,421,35,38,UCBPlayer
21128,UCBPlayer,87,212,299,0,67,UCBPlayer
21129,UCBPlayer,152,257,409,35,42,UCBPlayer
21130,UCBPlayer,84,224,308,0,64,UCBPlayer
21131,UCBPlayer,146,251,397,32,45,UCBPlayer
21132,UCBPlayer,89,234,323,3,60,UCBPlayer
21133,UCBPlayer,138,243,381,28,49,UCBPlayer
21134,UCBPlayer,97,242,339,7,56,UCBPlayer
21135,UCBPlayer,130,235,365,24,53,UCBPlayer
21136,UCBPlayer,105,250,355,11,52,UCBPlayer
21137,UCBPlayer,122,227,349,20,57,UCBPlayer
21138,UCBPlayer,109,259,368,15,49,UCBPlayer
21139,UCBPlayer,118,218,336,16,60,UCBPlayer
21140,UCBPlayer,117,267,384,19,45,UCBPlayer
21141,UCBPlayer,110,210,320,12,64,UCBPlayer
21142,UCBPlayer,126,271,397,23,42,UCBPlayer
21143,UCBPlayer,105,210,315,10,65,UCBPlayer
21144,UCBPlayer,130,275,405,25,40,UCBPlayer
21145,UCBPlayer,105,210,315,10,65,UCBPlayer
21146,UCBPlayer,130,275,405,25,40,UCBPlayer
21147,UCBPlayer,106,206,312,10,66,UCBPlayer
21148,UCBPlayer,130,275,405,25,40,UCBPlayer
21149,UCBPlayer,105,210,315,10,65,UCBPlayer
21150,UCBPlayer,131,271,402,25,41,UCBPlayer
21151,UCBPlayer,105,210,315,10,65,UCBPlayer
21152,UCBPlayer,130,275,405,25,40,UCBPlayer
21153,UCBPlayer,105,210,315,10,65,UCBPlayer
21154,UCBPlayer,130,275,405,25,40,UCBPlayer
21155,UCBPlayer,103,203,306,10,68,UCBPlayer
21156,UCBPlayer,128,283,411,25,38,UCBPlayer
21157,UCBPlayer,111,186,297,10,71,UCBPlayer
21158,UCBPlayer,124,299,423,25,34,UCBPlayer
21159,UCBPlayer,115,170,285,10,75,UCBPlayer
21160,UCBPlayer,120,315,435,25,30,UCBPlayer
21161,UCBPlayer,119,154,273,10,79,UCBPlayer
21162,UCBPlayer,112,332,444,25,27,UCBPlayer
21163,UCBPlayer,127,137,264,10,82,UCBPlayer
21164,UCBPlayer,104,349,453,25,24,UCBPlayer
21165,UCBPlayer,126,126,252,7,85,Tie
21166,UCBPlayer,111,351,462,28,22,UCBPlayer
21167,UCBPlayer,116,126,242,3,87,UCBPlayer
21168,UCBPlayer,122,347,469,32,21,UCBPlayer
21169,UCBPlayer,107,132,239,0,87,UCBPlayer
21170,UCBPlayer,132,337,469,35,22,UCBPlayer
21171,UCBPlayer,103,148,251,0,83,UCBPlayer
21172,UCBPlayer,136,321,457,35,26,UCBPlayer
21173,UCBPlayer,99,164,263,0,79,UCBPlayer
21174,UCBPlayer,140,305,445,35,30,UCBPlayer
21175,UCBPlayer,95,180,275,0,75,UCBPlayer
21176,UCBPlayer,144,289,433,35,34,UCBPlayer
21177,UCBPlayer,91,196,287,0,71,UCBPlayer
21178,UCBPlayer,148,273,421,35,38,UCBPlayer
21179,UCBPlayer,87,212,299,0,67,UCBPlayer
21180,UCBPlayer,152,257,409,35,42,UCBPlayer
21181,UCBPlayer,84,224,308,0,64,UCBPlayer
21182,UCBPlayer,146,251,397,32,45,UCBPlayer
21183,UCBPlayer,89,234,323,3,60,UCBPlayer
21184,UCBPlayer,138,243,381,28,49,UCBPlayer
21185,UCBPlayer,97,242,339,7,56,UCBPlayer
21186,UCBPlayer,130,235,365,24,53,UCBPlayer
21187,UCBPlayer,105,250,355,11,52,UCBPlayer
21188,UCBPlayer,122,227,349,20,57,UCBPlayer
21189,UCBPlayer,109,259,368,15,49,UCBPlayer
21190,UCBPlayer,118,218,336,16,60,UCBPlayer
21191,UCBPlayer,117,267,384,19,45,UCBPlayer
21192,UCBPlayer,110,210,320,12,64,UCBPlayer
21193,UCBPlayer,126,271,397,23,42,UCBPlayer
21194,UCBPlayer,105,210,315,10,65,UCBPlayer
21195,UCBPlayer,130,275,405,25,40,UCBPlayer
21196,UCBPlayer,105,210,315,10,65,UCBPlayer
21197,UCBPlayer,130,275,405,25,40,UCBPlayer
21198,UCBPlayer,106,206,312,10,66,UCBPlayer
21199,UCBPlayer,130,275,405,25,40,UCBPlayer
21200,UCBPlayer,105,210,315,10,65,UCBPlayer
21201,UCBPlayer,131,271,402,25,41,UCBPlayer
21202,UCBPlayer,105,210,315,10,65,UCBPlayer
21203,UCBPlayer,130,275,405,25,40,UCBPlayer
21204,UCBPlayer,105,210,315,10,65,UCBPlayer
21205,UCBPlayer,130,275,405,25,40,UCBPlayer
21206,UCBPlayer,103,203,306,10,68,UCBPlayer
21207,UCBPlayer,128,283,411,25,38,UCBPlayer
21208,UCBPlayer,111,186,297,10,71,UCBPlayer
21209,UCBPlayer,124,299,423,25,34,UCBPlayer
21210,UCBPlayer,115,170,285,10,75,UCBPlayer
21211,UCBPlayer,120,315,435,25,30,UCBPlayer
21212,UCBPlayer,119,154,273,10,79,UCBPlayer
21213,UCBPlayer,112,332,444,25,27,UCBPlayer
21214,UCBPlayer,127,137,264,10,82,UCBPlayer
21215,UCBPlayer,104,349,453,25,24,UCBPlayer
21216,UCBPlayer,126,126,252,7,85,Tie
21217,UCBPlayer,111,351,462,28,22,UCBPlayer
21218,UCBPlayer,116,126,242,3,87,UCBPlayer
21219,UCBPlayer,122,347,469,32,21,UCBPlayer
21220,UCBPlayer,107,132,239,0,87,UCBPlayer
21221,UCBPlayer,132,337,469,35,22,UCBPlayer
21222,UCBPlayer,103,148,251,0,83,UCBPlayer
21223,UCBPlayer,136,321,457,35,26,UCBPlayer
21224,UCBPlayer,99,164,263,0,79,UCBPlayer
21225,UCBPlayer,140,305,445,35,30,UCBPlayer
21226,UCBPlayer,95,180,275,0,75,UCBPlayer
21227,UCBPlayer,144,289,433,35,34,UCBPlayer
21228,UCBPlayer,91,196,287,0,71,UCBPlayer
21229,UCBPlayer,148,273,421,35,38,UCBPlayer
21230,UCBPlayer,87,212,299,0,67,UCBPlayer
21231,UCBPlayer,152,257,409,35,42,UCBPlayer
21232,UCBPlayer,84,224,308,0,64,UCBPlayer
21233,UCBPlayer,146,251,397,32,45,UCBPlayer
21234,UCBPlayer,89,234,323,3,60,UCBPlayer
21235,UCBPlayer,138,243,381,28,49,UCBPlayer
21236,UCBPlayer,97,242,339,7,56,UCBPlayer
21237,UCBPlayer,130,235,365,24,53,UCBPlayer
21238,UCBPlayer,105,250,355,11,52,UCBPlayer
21239,UCBPlayer,122,227,349,20,57,UCBPlayer
21240,UCBPlayer,109,259,368,15,49,UCBPlayer
21241,UCBPlayer,118,218,336,16,60,UCBPlayer
21242,UCBPlayer,117,267,384,19,45,UCBPlayer
21243,UCBPlayer,110,210,320,12,64,UCBPlayer
21244,UCBPlayer,126,271,397,23,42,UCBPlayer
21245,UCBPlayer,105,210,315,10,65,UCBPlayer
21246,UCBPlayer,130,275,405,25,40,UCBPlayer
21247,UCBPlayer,105,210,315,10,65,UCBPlayer
21248,UCBPlayer,130,275,405,25,40,UCBPlayer
21249,UCBPlayer,106,206,312,10,66,UCBPlayer
21250,UCBPlayer,130,275,405,25,40,UCBPlayer
21251,UCBPlayer,105,210,315,10,65,UCBPlayer
21252,UCBPlayer,131,271,402,25,41,UCBPlayer
21253,UCBPlayer,105,210,315,10,65,UCBPlayer
21254,UCBPlayer,130,275,405,25,40,UCBPlayer
21255,UCBPlayer,105,210,315,10,65,UCBPlayer
21256,UCBPlayer,130,275,405,25,40,UCBPlayer
21257,UCBPlayer,103,203,306,10,68,UCBPlayer
21258,UCBPlayer,128,283,411,25,38,UCBPlayer
21259,UCBPlayer,111,186,297,10,71,UCBPlayer
21260,UCBPlayer,124,299,423,25,34,UCBPlayer
21261,UCBPlayer,115,170,285,10,75,UCBPlayer
21262,UCBPlayer,120,315,435,25,30,UCBPlayer
21263,UCBPlayer,119,154,273,10,79,UCBPlayer
21264,UCBPlayer,112,332,444,25,27,UCBPlayer
21265,UCBPlayer,127,137,264,10,82,UCBPlayer
21266,UCBPlayer,104,349,453,25,24,UCBPlayer
21267,UCBPlayer,126,126,252,7,85,Tie
21268,UCBPlayer,111,351,462,28,22,UCBPlayer
21269,UCBPlayer,116,126,242,3,87,UCBPlayer
21270,UCBPlayer,122,347,469,32,21,UCBPlayer
21271,UCBPlayer,107,132,239,0,87,UCBPlayer
21272,UCBPlayer,132,337,469,35,22,UCBPlayer
21273,UCBPlayer,103,148,251,0,83,UCBPlayer
21274,UCBPlayer,136,321,457,35,26,UCBPlayer
21275,UCBPlayer,99,164,263,0,79,UCBPlayer
21276,UCBPlayer,140,305,445,35,30,UCBPlayer
21277,UCBPlayer,95,180,275,0,75,UCBPlayer
21278,UCBPlayer,144,289,433,35,34,UCBPlayer
21279,UCBPlayer,91,196,287,0,71,UCBPlayer
21280,UCBPlayer,148,273,421,35,38,UCBPlayer
21281,UCBPlayer,87,212,299,0,67,UCBPlayer
21282,UCBPlayer,152,257,409,35,42,UCBPlayer
21283,UCBPlayer,84,224,308,0,64,UCBPlayer
21284,UCBPlayer,146,251,397,32,45,UCBPlayer
21285,UCBPlayer,89,234,323,3,60,UCBPlayer
21286,UCBPlayer,138,243,381,28,49,UCBPlayer
21287,UCBPlayer,97,242,339,7,56,UCBPlayer
21288,UCBPlayer,130,235,365,24,53,UCBPlayer
21289,UCBPlayer,105,250,355,11,52,UCBPlayer
21290,UCBPlayer,122,227,349,20,57,UCBPlayer
21291,UCBPlayer,109,259,368,15,49,UCBPlayer
21292,UCBPlayer,118,218,336,16,60,UCBPlayer
21293,UCBPlayer,117,267,384,19,45,UCBPlayer
21294,UCBPlayer,110,210,320,12,64,UCBPlayer
21295,UCBPlayer,126,271,397,23,42,UCBPlayer
21296,UCBPlayer,105,210,315,10,65,UCBPlayer
21297,UCBPlayer,130,275,405,25,40,UCBPlayer
21298,UCBPlayer,105,210,315,10,65,UCBPlayer
21299,UCBPlayer,130,275,405,25,40,UCBPlayer
21300,UCBPlayer,106,206,312,10,66,UCBPlayer
21301,UCBPlayer,130,275,405,25,40,UCBPlayer
21302,UCBPlayer,105,210,315,10,65,UCBPlayer
21303,UCBPlayer,131,271,402,25,41,UCBPlayer
21304,UCBPlayer,105,210,315,10,65,UCBPlayer
21305,UCBPlayer,130,275,405,25,40,UCBPlayer
21306,UCBPlayer,105,210,315,10,65,UCBPlayer
21307,UCBPlayer,130,275,405,25,40,UCBPlayer
21308,UCBPlayer,103,203,306,10,68,UCBPlayer
21309,UCBPlayer,128,283,411,25,38,UCBPlayer
21310,UCBPlayer,111,186,297,10,71,UCBPlayer
21311,UCBPlayer,124,299,423,25,34,UCBPlayer
21312,UCBPlayer,115,170,285,10,75,UCBPlayer
21313,UCBPlayer,120,315,435,25,30,UCBPlayer
21314,UCBPlayer,119,154,273,10,79,UCBPlayer
21315,UCBPlayer,112,332,444,25,27,UCBPlayer
21316,UCBPlayer,127,137,264,10,82,UCBPlayer
21317,UCBPlayer,104,349,453,25,24,UCBPlayer
21318,UCBPlayer,126,126,252,7,85,Tie
21319,UCBPlayer,111,351,462,28,22,UCBPlayer
21320,UCBPlayer,116,126,242,3,87,UCBPlayer
21321,UCBPlayer,122,347,469,32,21,UCBPlayer
21322,UCBPlayer,107,132,239,0,87,UCBPlayer
21323,UCBPlayer,132,337,469,35,22,UCBPlayer
21324,UCBPlayer,103,148,251,0,83,UCBPlayer
21325,UCBPlayer,136,321,457,35,26,UCBPlayer
21326,UCBPlayer,99,164,263,0,79,UCBPlayer
21327,UCBPlayer,140,305,445,35,30,UCBPlayer
21328,UCBPlayer,95,180,275,0,75,UCBPlayer
21329,UCBPlayer,144,289,433,35,34,UCBPlayer
21330,UCBPlayer,91,196,287,0,71,UCBPlayer
21331,UCBPlayer,148,273,421,35,38,UCBPlayer
21332,UCBPlayer,87,212,299,0,67,UCBPlayer
21333,UCBPlayer,152,257,409,35,42,UCBPlayer
21334,UCBPlayer,84,224,308,0,64,UCBPlayer
21335,UCBPlayer,146,251,397,32,45,UCBPlayer
21336,UCBPlayer,89,234,323,3,60,UCBPlayer
21337,UCBPlayer,138,243,381,28,49,UCBPlayer
21338,UCBPlayer,97,242,339,7,56,UCBPlayer
21339,UCBPlayer,130,235,365,24,53,UCBPlayer
21340,UCBPlayer,105,250,355,11,52,UCBPlayer
21341,UCBPlayer,122,227,349,20,57,UCBPlayer
21342,UCBPlayer,109,259,368,15,49,UCBPlayer
21343,UCBPlayer,118,218,336,16,60,UCBPlayer
21344,UCBPlayer,117,267,384,19,45,UCBPlayer
21345,UCBPlayer,110,210,320,12,64,UCBPlayer
21346,UCBPlayer,126,271,397,23,42,UCBPlayer
21347,UCBPlayer,105,210,315,10,65,UCBPlayer
21348,UCBPlayer,130,275,405,25,40,UCBPlayer
21349,UCBPlayer,105,210,315,10,65,UCBPlayer
21350,UCBPlayer,130,275,405,25,40,UCBPlayer
21351,UCBPlayer,106,206,312,10,66,UCBPlayer
21352,UCBPlayer,130,275,405,25,40,UCBPlayer
21353,UCBPlayer,105,210,315,10,65,UCBPlayer
21354,UCBPlayer,131,271,402,25,41,UCBPlayer
21355,UCBPlayer,105,210,315,10,65,UCBPlayer
21356,UCBPlayer,130,275,405,25,40,UCBPlayer
21357,UCBPlayer,105,210,315,10,65,UCBPlayer
21358,UCBPlayer,130,275,405,25,40,UCBPlayer
21359,UCBPlayer,103,203,306,10,68,UCBPlayer
21360,UCBPlayer,128,283,411,25,38,UCBPlayer
21361,UCBPlayer,111,186,297,10,71,UCBPlayer
21362,UCBPlayer,124,299,423,25,34,UCBPlayer
21363,UCBPlayer,115,170,285,10,75,UCBPlayer
21364,UCBPlayer,120,315,435,25,30,UCBPlayer
21365,UCBPlayer,119,154,273,10,79,UCBPlayer
21366,UCBPlayer,112,332,444,25,27,UCBPlayer
21367,UCBPlayer,127,137,264,10,82,UCBPlayer
21368,UCBPlayer,104,349,453,25,24,UCBPlayer
21369,UCBPlayer,126,126,252,7,85,Tie
21370,UCBPlayer,111,351,462,28,22,UCBPlayer
21371,UCBPlayer,116,126,242,3,87,UCBPlayer
21372,UCBPlayer,122,347,469,32,21,UCBPlayer
21373,UCBPlayer,107,132,239,0,87,UCBPlayer
21374,UCBPlayer,132,337,469,35,22,UCBPlayer
21375,UCBPlayer,103,148,251,0,83,UCBPlayer
21376,UCBPlayer,136,321,457,35,26,UCBPlayer
21377,UCBPlayer,99,164,263,0,79,UCBPlayer
21378,UCBPlayer,140,305,445,35,30,UCBPlayer
21379,UCBPlayer,95,180,275,0,75,UCBPlayer
21380,UCBPlayer,144,289,433,35,34,UCBPlayer
21381,UCBPlayer,91,196,287,0,71,UCBPlayer
21382,UCBPlayer,148,273,421,35,38,UCBPlayer
21383,UCBPlayer,87,212,299,0,67,UCBPlayer
21384,UCBPlayer,152,257,409,35,42,UCBPlayer
21385,UCBPlayer,84,224,308,0,64,UCBPlayer
21386,UCBPlayer,146,251,397,32,45,UCBPlayer
21387,UCBPlayer,89,234,323,3,60,UCBPlayer
21388,UCBPlayer,138,243,381,28,49,UCBPlayer
21389,UCBPlayer,97,242,339,7,56,UCBPlayer
21390,UCBPlayer,130,235,365,24,53,UCBPlayer
21391,UCBPlayer,105,250,355,11,52,UCBPlayer
21392,UCBPlayer,122,227,349,20,57,UCBPlayer
21393,UCBPlayer,109,259,368,15,49,UCBPlayer
21394,UCBPlayer,118,218,336,16,60,UCBPlayer
21395,UCBPlayer,117,267,384,19,45,UCBPlayer
21396,UCBPlayer,110,210,320,12,64,UCBPlayer
21397,UCBPlayer,126,271,397,23,42,UCBPlayer
21398,UCBPlayer,105,210,315,10,65,UCBPlayer
21399,UCBPlayer,130,275,405,25,40,UCBPlayer
21400,UCBPlayer,105,210,315,10,65,UCBPlayer
21401,UCBPlayer,130,275,405,25,40,UCBPlayer
21402,UCBPlayer,106,206,312,10,66,UCBPlayer
21403,UCBPlayer,130,275,405,25,40,UCBPlayer
21404,UCBPlayer,105,210,315,10,65,UCBPlayer
21405,UCBPlayer,131,271,402,25,41,UCBPlayer
21406,UCBPlayer,105,210,315,10,65,UCBPlayer
21407,UCBPlayer,130,275,405,25,40,UCBPlayer
21408,UCBPlayer,105,210,315,10,65,UCBPlayer
21409,UCBPlayer,130,275,405,25,40,UCBPlayer
21410,UCBPlayer,103,203,306,10,68,UCBPlayer
21411,UCBPlayer,128,283,411,25,38,UCBPlayer
21412,UCBPlayer,111,186,297,10,71,UCBPlayer
21413,UCBPlayer,124,299,423,25,34,UCBPlayer
21414,UCBPlayer,115,170,285,10,75,UCBPlayer
21415,UCBPlayer,120,315,435,25,30,UCBPlayer
21416,UCBPlayer,119,154,273,10,79,UCBPlayer
21417,UCBPlayer,112,332,444,25,27,UCBPlayer
21418,UCBPlayer,127,137,264,10,82,UCBPlayer
21419,UCBPlayer,104,349,453,25,24,UCBPlayer
21420,UCBPlayer,126,126,252,7,85,Tie
21421,UCBPlayer,111,351,462,28,22,UCBPlayer
21422,UCBPlayer,116,126,242,3,87,UCBPlayer
21423,UCBPlayer,122,347,469,32,21,UCBPlayer
21424,UCBPlayer,107,132,239,0,87,UCBPlayer
21425,UCBPlayer,132,337,469,35,22,UCBPlayer
21426,UCBPlayer,103,148,251,0,83,UCBPlayer
21427,UCBPlayer,136,321,457,35,26,UCBPlayer
21428,UCBPlayer,99,164,263,0,79,UCBPlayer
21429,UCBPlayer,140,305,445,35,30,UCBPlayer
21430,UCBPlayer,95,180,275,0,75,UCBPlayer
21431,UCBPlayer,144,289,433,35,34,UCBPlayer
21432,UCBPlayer,91,196,287,0,71,UCBPlayer
21433,UCBPlayer,148,273,421,35,38,UCBPlayer
21434,UCBPlayer,87,212,299,0,67,UCBPlayer
21435,UCBPlayer,152,257,409,35,42,UCBPlayer
21436,UCBPlayer,84,224,308,0,64,UCBPlayer
21437,UCBPlayer,146,251,397,32,45,UCBPlayer
21438,UCBPlayer,89,234,323,3,60,UCBPlayer
21439,UCBPlayer,138,243,381,28,49,UCBPlayer
21440,UCBPlayer,97,242,339,7,56,UCBPlayer
21441,UCBPlayer,130,235,365,24,53,UCBPlayer
21442,UCBPlayer,105,250,355,11,52,UCBPlayer
21443,UCBPlayer,122,227,349,20,57,UCBPlayer
21444,UCBPlayer,109,259,368,15,49,UCBPlayer
21445,UCBPlayer,118,218,336,16,60,UCBPlayer
21446,UCBPlayer,117,267,384,19,45,UCBPlayer
21447,UCBPlayer,110,210,320,12,64,UCBPlayer
21448,UCBPlayer,126,271,397,23,42,UCBPlayer
21449,UCBPlayer,105,210,315,10,65,UCBPlayer
21450,UCBPlayer,130,275,405,25,40,UCBPlayer
21451,UCBPlayer,105,210,315,10,65,UCBPlayer
21452,UCBPlayer,130,275,405,25,40,UCBPlayer
21453,UCBPlayer,106,206,312,10,66,UCBPlayer
21454,UCBPlayer,130,275,405,25,40,UCBPlayer
21455,UCBPlayer,105,210,315,10,65,UCBPlayer
21456,UCBPlayer,131,271,402,25,41,UCBPlayer
21457,UCBPlayer,105,210,315,10,65,UCBPlayer
21458,UCBPlayer,130,275,405,25,40,UCBPlayer
21459,UCBPlayer,105,210,315,10,65,UCBPlayer
21460,UCBPlayer,130,275,405,25,40,UCBPlayer
21461,UCBPlayer,103,203,306,10,68,UCBPlayer
21462,UCBPlayer,128,283,411,25,38,UCBPlayer
21463,UCBPlayer,111,186,297,10,71,UCBPlayer
21464,UCBPlayer,124,299,423,25,34,UCBPlayer
21465,UCBPlayer,115,170,285,10,75,UCBPlayer
21466,UCBPlayer,120,315,435,25,30,UCBPlayer
21467,UCBPlayer,119,154,273,10,79,UCBPlayer
21468,UCBPlayer,112,332,444,25,27,UCBPlayer
21469,UCBPlayer,127,137,264,10,82,UCBPlayer
21470,UCBPlayer,104,349,453,25,24,UCBPlayer
21471,UCBPlayer,126,126,252,7,85,Tie
21472,UCBPlayer,111,351,462,28,22,UCBPlayer
21473,UCBPlayer,116,126,242,3,87,UCBPlayer
21474,UCBPlayer,122,347,469,32,21,UCBPlayer
21475,UCBPlayer,107,132,239,0,87,UCBPlayer
21476,UCBPlayer,132,337,469,35,22,UCBPlayer
21477,UCBPlayer,103,148,251,0,83,UCBPlayer
21478,UCBPlayer,136,321,457,35,26,UCBPlayer
21479,UCBPlayer,99,164,263,0,79,UCBPlayer
21480,UCBPlayer,140,305,445,35,30,UCBPlayer
21481,UCBPlayer,95,180,275,0,75,UCBPlayer
21482,UCBPlayer,144,289,433,35,34,UCBPlayer
21483,UCBPlayer,91,196,287,0,71,UCBPlayer
21484,UCBPlayer,148,273,421,35,38,UCBPlayer
21485,UCBPlayer,87,212,299,0,67,UCBPlayer
21486,UCBPlayer,152,257,409,35,42,UCBPlayer
21487,UCBPlayer,84,224,308,0,64,UCBPlayer
21488,UCBPlayer,146,251,397,32,45,UCBPlayer
21489,UCBPlayer,89,234,323,3,60,UCBPlayer
21490,UCBPlayer,138,243,381,28,49,UCBPlayer
21491,UCBPlayer,97,242,339,7,56,UCBPlayer
21492,UCBPlayer,130,235,365,24,53,UCBPlayer
21493,UCBPlayer,105,250,355,11,52,UCBPlayer
21494,UCBPlayer,122,227,349,20,57,UCBPlayer
21495,UCBPlayer,109,259,368,15,49,UCBPlayer
21496,UCBPlayer,118,218,336,16,60,UCBPlayer
21497,UCBPlayer,117,267,384,19,45,UCBPlayer
21498,UCBPlayer,110,210,320,12,64,UCBPlayer
21499,UCBPlayer,126,271,397,23,42,UCBPlayer
21500,UCBPlayer,105,210,315,10,65,UCBPlayer
21501,UCBPlayer,130,275,405,25,40,UCBPlayer
21502,UCBPlayer,105,210,315,10,65,UCBPlayer
21503,UCBPlayer,130,275,405,25,40,UCBPlayer
21504,UCBPlayer,106,206,312,10,66,UCBPlayer
21505,UCBPlayer,130,275,405,25,40,UCBPlayer
21506,UCBPlayer,105,210,315,10,65,UCBPlayer
21507,UCBPlayer,131,271,402,25,41,UCBPlayer
21508,UCBPlayer,105,210,315,10,65,UCBPlayer
21509,UCBPlayer,130,275,405,25,40,UCBPlayer
21510,UCBPlayer,105,210,315,10,65,UCBPlayer
21511,UCBPlayer,130,275,405,25,40,UCBPlayer
21512,UCBPlayer,103,203,306,10,68,UCBPlayer
21513,UCBPlayer,128,283,411,25,38,UCBPlayer
21514,UCBPlayer,111,186,297,10,71,UCBPlayer
21515,UCBPlayer,124,299,423,25,34,UCBPlayer
21516,UCBPlayer,115,170,285,10,75,UCBPlayer
21517,UCBPlayer,120,315,435,25,30,UCBPlayer
21518,UCBPlayer,119,154,273,10,79,UCBPlayer
21519,UCBPlayer,112,332,444,25,27,UCBPlayer
21520,UCBPlayer,127,137,264,10,82,UCBPlayer
21521,UCBPlayer,104,349,453,25,24,UCBPlayer
21522,UCBPlayer,126,126,252,7,85,Tie
21523,UCBPlayer,111,351,462,28,22,UCBPlayer
21524,UCBPlayer,116,126,242,3,87,UCBPlayer
21525,UCBPlayer,122,347,469,32,21,UCBPlayer
21526,UCBPlayer,107,132,239,0,87,UCBPlayer
21527,UCBPlayer,132,337,469,35,22,UCBPlayer
21528,UCBPlayer,103,148,251,0,83,UCBPlayer
21529,UCBPlayer,136,321,457,35,26,UCBPlayer
21530,UCBPlayer,99,164,263,0,79,UCBPlayer
21531,UCBPlayer,140,305,445,35,30,UCBPlayer
21532,UCBPlayer,95,180,275,0,75,UCBPlayer
21533,UCBPlayer,144,289,433,35,34,UCBPlayer
21534,UCBPlayer,91,196,287,0,71,UCBPlayer
21535,UCBPlayer,148,273,421,35,38,UCBPlayer
21536,UCBPlayer,87,212,299,0,67,UCBPlayer
21537,UCBPlayer,152,257,409,35,42,UCBPlayer
21538,UCBPlayer,84,224,308,0,64,UCBPlayer
21539,UCBPlayer,146,251,397,32,45,UCBPlayer
21540,UCBPlayer,89,234,323,3,60,UCBPlayer
21541,UCBPlayer,138,243,381,28,49,UCBPlayer
21542,UCBPlayer,97,242,339,7,56,UCBPlayer
21543,UCBPlayer,130,235,365,24,53,UCBPlayer
21544,UCBPlayer,105,250,355,11,52,UCBPlayer
21545,UCBPlayer,122,227,349,20,57,UCBPlayer
21546,UCBPlayer,109,259,368,15,49,UCBPlayer
21547,UCBPlayer,118,218,336,16,60,UCBPlayer
21548,UCBPlayer,117,267,384,19,45,UCBPlayer
21549,UCBPlayer,110,210,320,12,64,UCBPlayer
21550,UCBPlayer,126,271,397,23,42,UCBPlayer
21551,UCBPlayer,105,210,315,10,65,UCBPlayer
21552,UCBPlayer,130,275,405,25,40,UCBPlayer
21553,UCBPlayer,105,210,315,10,65,UCBPlayer
21554,UCBPlayer,130,275,405,25,40,UCBPlayer
21555,UCBPlayer,106,206,312,10,66,UCBPlayer
21556,UCBPlayer,130,275,405,25,40,UCBPlayer
21557,UCBPlayer,105,210,315,10,65,UCBPlayer
21558,UCBPlayer,131,271,402,25,41,UCBPlayer
21559,UCBPlayer,105,210,315,10,65,UCBPlayer
21560,UCBPlayer,130,275,405,25,40,UCBPlayer
21561,UCBPlayer,105,210,315,10,65,UCBPlayer
21562,UCBPlayer,130,275,405,25,40,UCBPlayer
21563,UCBPlayer,103,203,306,10,68,UCBPlayer
21564,UCBPlayer,128,283,411,25,38,UCBPlayer
21565,UCBPlayer,111,186,297,10,71,UCBPlayer
21566,UCBPlayer,124,299,423,25,34,UCBPlayer
21567,UCBPlayer,115,170,285,10,75,UCBPlayer
21568,UCBPlayer,120,315,435,25,30,UCBPlayer
21569,UCBPlayer,119,154,273,10,79,UCBPlayer
21570,UCBPlayer,112,332,444,25,27,UCBPlayer
21571,UCBPlayer,127,137,264,10,82,UCBPlayer
21572,UCBPlayer,104,349,453,25,24,UCBPlayer
21573,UCBPlayer,126,126,252,7,85,Tie
21574,UCBPlayer,111,351,462,28,22,UCBPlayer
21575,UCBPlayer,116,126,242,3,87,UCBPlayer
21576,UCBPlayer,122,347,469,32,21,UCBPlayer
21577,UCBPlayer,107,132,239,0,87,UCBPlayer
21578,UCBPlayer,132,337,469,35,22,UCBPlayer
21579,UCBPlayer,103,148,251,0,83,UCBPlayer
21580,UCBPlayer,136,321,457,35,26,UCBPlayer
21581,UCBPlayer,99,164,263,0,79,UCBPlayer
21582,UCBPlayer,140,305,445,35,30,UCBPlayer
21583,UCBPlayer,95,180,275,0,75,UCBPlayer
21584,UCBPlayer,144,289,433,35,34,UCBPlayer
21585,UCBPlayer,91,196,287,0,71,UCBPlayer
21586,UCBPlayer,148,273,421,35,38,UCBPlayer
21587,UCBPlayer,87,212,299,0,67,UCBPlayer
21588,UCBPlayer,152,257,409,35,42,UCBPlayer
21589,UCBPlayer,84,224,308,0,64,UCBPlayer
21590,UCBPlayer,146,251,397,32,45,UCBPlayer
21591,UCBPlayer,89,234,323,3,60,UCBPlayer
21592,UCBPlayer,138,243,381,28,49,UCBPlayer
21593,UCBPlayer,97,242,339,7,56,UCBPlayer
21594,UCBPlayer,130,235,365,24,53,UCBPlayer
21595,UCBPlayer,105,250,355,11,52,UCBPlayer
21596,UCBPlayer,122,227,349,20,57,UCBPlayer
21597,UCBPlayer,109,259,368,15,49,UCBPlayer
21598,UCBPlayer,118,218,336,16,60,UCBPlayer
21599,UCBPlayer,117,267,384,19,45,UCBPlayer
21600,UCBPlayer,110,210,320,12,64,UCBPlayer
21601,UCBPlayer,126,271,397,23,42,UCBPlayer
21602,UCBPlayer,105,210,315,10,65,UCBPlayer
21603,UCBPlayer,130,275,405,25,40,UCBPlayer
21604,UCBPlayer,105,210,315,10,65,UCBPlayer
21605,UCBPlayer,130,275,405,25,40,UCBPlayer
21606,UCBPlayer,106,206,312,10,66,UCBPlayer
21607,UCBPlayer,130,275,405,25,40,UCBPlayer
21608,UCBPlayer,105,210,315,10,65,UCBPlayer
21609,UCBPlayer,131,271,402,25,41,UCBPlayer
21610,UCBPlayer,105,210,315,10,65,UCBPlayer
21611,UCBPlayer,130,275,405,25,40,UCBPlayer
21612,UCBPlayer,105,210,315,10,65,UCBPlayer
21613,UCBPlayer,130,275,405,25,40,UCBPlayer
21614,UCBPlayer,103,203,306,10,68,UCBPlayer
21615,UCBPlayer,128,283,411,25,38,UCBPlayer
21616,UCBPlayer,111,186,297,10,71,UCBPlayer
21617,UCBPlayer,124,299,423,25,34,UCBPlayer
21618,UCBPlayer,115,170,285,10,75,UCBPlayer
21619,UCBPlayer,120,315,435,25,30,UCBPlayer
21620,UCBPlayer,119,154,273,10,79,UCBPlayer
21621,UCBPlayer,112,332,444,25,27,UCBPlayer
21622,UCBPlayer,127,137,264,10,82,UCBPlayer
21623,UCBPlayer,104,349,453,25,24,UCBPlayer
21624,UCBPlayer,126,126,252,7,85,Tie
21625,UCBPlayer,111,351,462,28,22,UCBPlayer
21626,UCBPlayer,116,126,242,3,87,UCBPlayer
21627,UCBPlayer,122,347,469,32,21,UCBPlayer
21628,UCBPlayer,107,132,239,0,87,UCBPlayer
21629,UCBPlayer,132,337,469,35,22,UCBPlayer
21630,UCBPlayer,103,148,251,0,83,UCBPlayer
21631,UCBPlayer,136,321,457,35,26,UCBPlayer
21632,UCBPlayer,99,164,263,0,79,UCBPlayer
21633,UCBPlayer,140,305,445,35,30,UCBPlayer
21634,UCBPlayer,95,180,275,0,75,UCBPlayer
21635,UCBPlayer,144,289,433,35,34,UCBPlayer
21636,UCBPlayer,91,196,287,0,71,UCBPlayer
21637,UCBPlayer,148,273,421,35,38,UCBPlayer
21638,UCBPlayer,87,212,299,0,67,UCBPlayer
21639,UCBPlayer,152,257,409,35,42,UCBPlayer
21640,UCBPlayer,84,224,308,0,64,UCBPlayer
21641,UCBPlayer,146,251,397,32,45,UCBPlayer
21642,UCBPlayer,89,234,323,3,60,UCBPlayer
21643,UCBPlayer,138,243,381,28,49,UCBPlayer
21644,UCBPlayer,97,242,339,7,56,UCBPlayer
21645,UCBPlayer,130,235,365,24,53,UCBPlayer
21646,UCBPlayer,105,250,355,11,52,UCBPlayer
21647,UCBPlayer,122,227,349,20,57,UCBPlayer
21648,UCBPlayer,109,259,368,15,49,UCBPlayer
21649,UCBPlayer,118,218,336,16,60,UCBPlayer
21650,UCBPlayer,117,267,384,19,45,UCBPlayer
21651,UCBPlayer,110,210,320,12,64,UCBPlayer
21652,UCBPlayer,126,271,397,23,42,UCBPlayer
21653,UCBPlayer,105,210,315,10,65,UCBPlayer
21654,UCBPlayer,130,275,405,25,40,UCBPlayer
21655,UCBPlayer,105,210,315,10,65,UCBPlayer
21656,UCBPlayer,130,275,405,25,40,UCBPlayer
21657,UCBPlayer,106,206,312,10,66,UCBPlayer
21658,UCBPlayer,130,275,405,25,40,UCBPlayer
21659,UCBPlayer,105,210,315,10,65,UCBPlayer
21660,UCBPlayer,131,271,402,25,41,UCBPlayer
21661,UCBPlayer,105,210,315,10,65,UCBPlayer
21662,UCBPlayer,130,275,405,25,40,UCBPlayer
21663,UCBPlayer,105,210,315,10,65,UCBPlayer
21664,UCBPlayer,130,275,405,25,40,UCBPlayer
21665,UCBPlayer,103,203,306,10,68,UCBPlayer
21666,UCBPlayer,128,283,411,25,38,UCBPlayer
21667,UCBPlayer,111,186,297,10,71,UCBPlayer
21668,UCBPlayer,124,299,423,25,34,UCBPlayer
21669,UCBPlayer,115,170,285,10,75,UCBPlayer
21670,UCBPlayer,120,315,435,25,30,UCBPlayer
21671,UCBPlayer,119,154,273,10,79,UCBPlayer
21672,UCBPlayer,112,332,444,25,27,UCBPlayer
21673,UCBPlayer,127,137,264,10,82,UCBPlayer
21674,UCBPlayer,104,349,453,25,24,UCBPlayer
21675,UCBPlayer,126,126,252,7,85,Tie
21676,UCBPlayer,111,351,462,28,22,UCBPlayer
21677,UCBPlayer,116,126,242,3,87,UCBPlayer
21678,UCBPlayer,122,347,469,32,21,UCBPlayer
21679,UCBPlayer,107,132,239,0,87,UCBPlayer
21680,UCBPlayer,132,337,469,35,22,UCBPlayer
21681,UCBPlayer,103,148,251,0,83,UCBPlayer
21682,UCBPlayer,136,321,457,35,26,UCBPlayer
21683,UCBPlayer,99,164,263,0,79,UCBPlayer
21684,UCBPlayer,140,305,445,35,30,UCBPlayer
21685,UCBPlayer,95,180,275,0,75,UCBPlayer
21686,UCBPlayer,144,289,433,35,34,UCBPlayer
21687,UCBPlayer,91,196,287,0,71,UCBPlayer
21688,UCBPlayer,148,273,421,35,38,UCBPlayer
21689,UCBPlayer,87,212,299,0,67,UCBPlayer
21690,UCBPlayer,152,257,409,35,42,UCBPlayer
21691,UCBPlayer,84,224,308,0,64,UCBPlayer
21692,UCBPlayer,146,251,397,32,45,UCBPlayer
21693,UCBPlayer,89,234,323,3,60,UCBPlayer
21694,UCBPlayer,138,243,381,28,49,UCBPlayer
21695,UCBPlayer,97,242,339,7,56,UCBPlayer
21696,UCBPlayer,130,235,365,24,53,UCBPlayer
21697,UCBPlayer,105,250,355,11,52,UCBPlayer
21698,UCBPlayer,122,227,349,20,57,UCBPlayer
21699,UCBPlayer,109,259,368,15,49,UCBPlayer
21700,UCBPlayer,118,218,336,16,60,UCBPlayer
21701,UCBPlayer,117,267,384,19,45,UCBPlayer
21702,UCBPlayer,110,210,320,12,64,UCBPlayer
21703,UCBPlayer,126,271,397,23,42,UCBPlayer
21704,UCBPlayer,105,210,315,10,65,UCBPlayer
21705,UCBPlayer,130,275,405,25,40,UCBPlayer
21706,UCBPlayer,105,210,315,10,65,UCBPlayer
21707,UCBPlayer,130,275,405,25,40,UCBPlayer
21708,UCBPlayer,106,206,312,10,66,UCBPlayer
21709,UCBPlayer,130,275,405,25,40,UCBPlayer
21710,UCBPlayer,105,210,315,10,65,UCBPlayer
21711,UCBPlayer,131,271,402,25,41,UCBPlayer
21712,UCBPlayer,105,210,315,10,65,UCBPlayer
21713,UCBPlayer,130,275,405,25,40,UCBPlayer
21714,UCBPlayer,105,210,315,10,65,UCBPlayer
21715,UCBPlayer,130,275,405,25,40,UCBPlayer
21716,UCBPlayer,103,203,306,10,68,UCBPlayer
21717,UCBPlayer,128,283,411,25,38,UCBPlayer
21718,UCBPlayer,111,186,297,10,71,UCBPlayer
21719,UCBPlayer,124,299,423,25,34,UCBPlayer
21720,UCBPlayer,115,170,285,10,75,UCBPlayer
21721,UCBPlayer,120,315,435,25,30,UCBPlayer
21722,UCBPlayer,119,154,273,10,79,UCBPlayer
21723,UCBPlayer,112,332,444,25,27,UCBPlayer
21724,UCBPlayer,127,137,264,10,82,UCBPlayer
21725,UCBPlayer,104,349,453,25,24,UCBPlayer
21726,UCBPlayer,126,126,252,7,85,Tie
21727,UCBPlayer,111,351,462,28,22,UCBPlayer
21728,UCBPlayer,116,126,242,3,87,UCBPlayer
21729,UCBPlayer,122,347,469,32,21,UCBPlayer
21730,UCBPlayer,107,132,239,0,87,UCBPlayer
21731,UCBPlayer,132,337,469,35,22,UCBPlayer
21732,UCBPlayer,103,148,251,0,83,UCBPlayer
21733,UCBPlayer,136,321,457,35,26,UCBPlayer
21734,UCBPlayer,99,164,263,0,79,UCBPlayer
21735,UCBPlayer,140,305,445,35,30,UCBPlayer
21736,UCBPlayer,95,180,275,0,75,UCBPlayer
21737,UCBPlayer,144,289,433,35,34,UCBPlayer
21738,UCBPlayer,91,196,287,0,71,UCBPlayer
21739,UCBPlayer,148,273,421,35,38,UCBPlayer
21740,UCBPlayer,87,212,299,0,67,UCBPlayer
21741,UCBPlayer,152,257,409,35,42,UCBPlayer
21742,UCBPlayer,84,224,308,0,64,UCBPlayer
21743,UCBPlayer,146,251,397,32,45,UCBPlayer
21744,UCBPlayer,89,234,323,3,60,UCBPlayer
21745,UCBPlayer,138,243,381,28,49,UCBPlayer
21746,UCBPlayer,97,242,339,7,56,UCBPlayer
21747,UCBPlayer,130,235,365,24,53,UCBPlayer
21748,UCBPlayer,105,250,355,11,52,UCBPlayer
21749,UCBPlayer,122,227,349,20,57,UCBPlayer
21750,UCBPlayer,109,259,368,15,49,UCBPlayer
21751,UCBPlayer,118,218,336,16,60,UCBPlayer
21752,UCBPlayer,117,267,384,19,45,UCBPlayer
21753,UCBPlayer,110,210,320,12,64,UCBPlayer
21754,UCBPlayer,126,271,397,23,42,UCBPlayer
21755,UCBPlayer,105,210,315,10,65,UCBPlayer
21756,UCBPlayer,130,275,405,25,40,UCBPlayer
21757,UCBPlayer,105,210,315,10,65,UCBPlayer
21758,UCBPlayer,130,275,405,25,40,UCBPlayer
21759,UCBPlayer,106,206,312,10,66,UCBPlayer
21760,UCBPlayer,130,275,405,25,40,UCBPlayer
21761,UCBPlayer,105,210,315,10,65,UCBPlayer
21762,UCBPlayer,131,271,402,25,41,UCBPlayer
21763,UCBPlayer,105,210,315,10,65,UCBPlayer
21764,UCBPlayer,130,275,405,25,40,UCBPlayer
21765,UCBPlayer,105,210,315,10,65,UCBPlayer
21766,UCBPlayer,130,275,405,25,40,UCBPlayer
21767,UCBPlayer,103,203,306,10,68,UCBPlayer
21768,UCBPlayer,128,283,411,25,38,UCBPlayer
21769,UCBPlayer,111,186,297,10,71,UCBPlayer
21770,UCBPlayer,124,299,423,25,34,UCBPlayer
21771,UCBPlayer,115,170,285,10,75,UCBPlayer
21772,UCBPlayer,120,315,435,25,30,UCBPlayer
21773,UCBPlayer,119,154,273,10,79,UCBPlayer
21774,UCBPlayer,112,332,444,25,27,UCBPlayer
21775,UCBPlayer,127,137,264,10,82,UCBPlayer
21776,UCBPlayer,104,349,453,25,24,UCBPlayer
21777,UCBPlayer,126,126,252,7,85,Tie
21778,UCBPlayer,111,351,462,28,22,UCBPlayer
21779,UCBPlayer,116,126,242,3,87,UCBPlayer
21780,UCBPlayer,122,347,469,32,21,UCBPlayer
21781,UCBPlayer,107,132,239,0,87,UCBPlayer
21782,UCBPlayer,132,337,469,35,22,UCBPlayer
21783,UCBPlayer,103,148,251,0,83,UCBPlayer
21784,UCBPlayer,136,321,457,35,26,UCBPlayer
21785,UCBPlayer,99,164,263,0,79,UCBPlayer
21786,UCBPlayer,140,305,445,35,30,UCBPlayer
21787,UCBPlayer,95,180,275,0,75,UCBPlayer
21788,UCBPlayer,144,289,433,35,34,UCBPlayer
21789,UCBPlayer,91,196,287,0,71,UCBPlayer
21790,UCBPlayer,148,273,421,35,38,UCBPlayer
21791,UCBPlayer,87,212,299,0,67,UCBPlayer
21792,UCBPlayer,152,257,409,35,42,UCBPlayer
21793,UCBPlayer,84,224,308,0,64,UCBPlayer
21794,UCBPlayer,146,251,397,32,45,UCBPlayer
21795,UCBPlayer,89,234,323,3,60,UCBPlayer
21796,UCBPlayer,138,243,381,28,49,UCBPlayer
21797,UCBPlayer,97,242,339,7,56,UCBPlayer
21798,UCBPlayer,130,235,365,24,53,UCBPlayer
21799,UCBPlayer,105,250,355,11,52,UCBPlayer
21800,UCBPlayer,122,227,349,20,57,UCBPlayer
21801,UCBPlayer,109,259,368,15,49,UCBPlayer
21802,UCBPlayer,118,218,336,16,60,UCBPlayer
21803,UCBPlayer,117,267,384,19,45,UCBPlayer
21804,UCBPlayer,110,210,320,12,64,UCBPlayer
21805,UCBPlayer,126,271,397,23,42,UCBPlayer
21806,UCBPlayer,105,210,315,10,65,UCBPlayer
21807,UCBPlayer,130,275,405,25,40,UCBPlayer
21808,UCBPlayer,105,210,315,10,65,UCBPlayer
21809,UCBPlayer,130,275,405,25,40,UCBPlayer
21810,UCBPlayer,106,206,312,10,66,UCBPlayer
21811,UCBPlayer,130,275,405,25,40,UCBPlayer
21812,UCBPlayer,105,210,315,10,65,UCBPlayer
21813,UCBPlayer,131,271,402,25,41,UCBPlayer
21814,UCBPlayer,105,210,315,10,65,UCBPlayer
21815,UCBPlayer,130,275,405,25,40,UCBPlayer
21816,UCBPlayer,105,210,315,10,65,UCBPlayer
21817,UCBPlayer,130,275,405,25,40,UCBPlayer
21818,UCBPlayer,103,203,306,10,68,UCBPlayer
21819,UCBPlayer,128,283,411,25,38,UCBPlayer
21820,UCBPlayer,111,186,297,10,71,UCBPlayer
21821,UCBPlayer,124,299,423,25,34,UCBPlayer
21822,UCBPlayer,115,170,285,10,75,UCBPlayer
21823,UCBPlayer,120,315,435,25,30,UCBPlayer
21824,UCBPlayer,119,154,273,10,79,UCBPlayer
21825,UCBPlayer,112,332,444,25,27,UCBPlayer
21826,UCBPlayer,127,137,264,10,82,UCBPlayer
21827,UCBPlayer,104,349,453,25,24,UCBPlayer
21828,UCBPlayer,126,126,252,7,85,Tie
21829,UCBPlayer,111,351,462,28,22,UCBPlayer
21830,UCBPlayer,116,126,242,3,87,UCBPlayer
21831,UCBPlayer,122,347,469,32,21,UCBPlayer
21832,UCBPlayer,107,132,239,0,87,UCBPlayer
21833,UCBPlayer,132,337,469,35,22,UCBPlayer
21834,UCBPlayer,103,148,251,0,83,UCBPlayer
21835,UCBPlayer,136,321,457,35,26,UCBPlayer
21836,UCBPlayer,99,164,263,0,79,UCBPlayer
21837,UCBPlayer,140,305,445,35,30,UCBPlayer
21838,UCBPlayer,95,180,275,0,75,UCBPlayer
21839,UCBPlayer,144,289,433,35,34,UCBPlayer
21840,UCBPlayer,91,196,287,0,71,UCBPlayer
21841,UCBPlayer,148,273,421,35,38,UCBPlayer
21842,UCBPlayer,87,212,299,0,67,UCBPlayer
21843,UCBPlayer,152,257,409,35,42,UCBPlayer
21844,UCBPlayer,84,224,308,0,64,UCBPlayer
21845,UCBPlayer,146,251,397,32,45,UCBPlayer
21846,UCBPlayer,89,234,323,3,60,UCBPlayer
21847,UCBPlayer,138,243,381,28,49,UCBPlayer
21848,UCBPlayer,97,242,339,7,56,UCBPlayer
21849,UCBPlayer,130,235,365,24,53,UCBPlayer
21850,UCBPlayer,105,250,355,11,52,UCBPlayer
21851,UCBPlayer,122,227,349,20,57,UCBPlayer
21852,UCBPlayer,109,259,368,15,49,UCBPlayer
21853,UCBPlayer,118,218,336,16,60,UCBPlayer
21854,UCBPlayer,117,267,384,19,45,UCBPlayer
21855,UCBPlayer,110,210,320,12,64,UCBPlayer
21856,UCBPlayer,126,271,397,23,42,UCBPlayer
21857,UCBPlayer,105,210,315,10,65,UCBPlayer
21858,UCBPlayer,130,275,405,25,40,UCBPlayer
21859,UCBPlayer,105,210,315,10,65,UCBPlayer
21860,UCBPlayer,130,275,405,25,40,UCBPlayer
21861,UCBPlayer,106,206,312,10,66,UCBPlayer
21862,UCBPlayer,130,275,405,25,40,UCBPlayer
21863,UCBPlayer,105,210,315,10,65,UCBPlayer
21864,UCBPlayer,131,271,402,25,41,UCBPlayer
21865,UCBPlayer,105,210,315,10,65,UCBPlayer
21866,UCBPlayer,130,275,405,25,40,UCBPlayer
21867,UCBPlayer,105,210,315,10,65,UCBPlayer
21868,UCBPlayer,130,275,405,25,40,UCBPlayer
21869,UCBPlayer,103,203,306,10,68,UCBPlayer
21870,UCBPlayer,128,283,411,25,38,UCBPlayer
21871,UCBPlayer,111,186,297,10,71,UCBPlayer
21872,UCBPlayer,124,299,423,25,34,UCBPlayer
21873,UCBPlayer,115,170,285,10,75,UCBPlayer
21874,UCBPlayer,120,315,435,25,30,UCBPlayer
21875,UCBPlayer,119,154,273,10,79,UCBPlayer
21876,UCBPlayer,112,332,444,25,27,UCBPlayer
21877,UCBPlayer,127,137,264,10,82,UCBPlayer
21878,UCBPlayer,104,349,453,25,24,UCBPlayer
21879,UCBPlayer,126,126,252,7,85,Tie
21880,UCBPlayer,111,351,462,28,22,UCBPlayer
21881,UCBPlayer,116,126,242,3,87,UCBPlayer
21882,UCBPlayer,122,347,469,32,21,UCBPlayer
21883,UCBPlayer,107,132,239,0,87,UCBPlayer
21884,UCBPlayer,132,337,469,35,22,UCBPlayer
21885,UCBPlayer,103,148,251,0,83,UCBPlayer
21886,UCBPlayer,136,321,457,35,26,UCBPlayer
21887,UCBPlayer,99,164,263,0,79,UCBPlayer
21888,UCBPlayer,140,305,445,35,30,UCBPlayer
21889,UCBPlayer,95,180,275,0,75,UCBPlayer
21890,UCBPlayer,144,289,433,35,34,UCBPlayer
21891,UCBPlayer,91,196,287,0,71,UCBPlayer
21892,UCBPlayer,148,273,421,35,38,UCBPlayer
21893,UCBPlayer,87,212,299,0,67,UCBPlayer
21894,UCBPlayer,152,257,409,35,42,UCBPlayer
21895,UCBPlayer,84,224,308,0,64,UCBPlayer
21896,UCBPlayer,146,251,397,32,45,UCBPlayer
21897,UCBPlayer,89,234,323,3,60,UCBPlayer
21898,UCBPlayer,138,243,381,28,49,UCBPlayer
21899,UCBPlayer,97,242,339,7,56,UCBPlayer
21900,UCBPlayer,130,235,365,24,53,UCBPlayer
21901,UCBPlayer,105,250,355,11,52,UCBPlayer
21902,UCBPlayer,122,227,349,20,57,UCBPlayer
21903,UCBPlayer,109,259,368,15,49,UCBPlayer
21904,UCBPlayer,118,218,336,16,60,UCBPlayer
21905,UCBPlayer,117,267,384,19,45,UCBPlayer
21906,UCBPlayer,110,210,320,12,64,UCBPlayer
21907,UCBPlayer,126,271,397,23,42,UCBPlayer
21908,UCBPlayer,105,210,315,10,65,UCBPlayer
21909,UCBPlayer,130,275,405,25,40,UCBPlayer
21910,UCBPlayer,105,210,315,10,65,UCBPlayer
21911,UCBPlayer,130,275,405,25,40,UCBPlayer
21912,UCBPlayer,106,206,312,10,66,UCBPlayer
21913,UCBPlayer,130,275,405,25,40,UCBPlayer
21914,UCBPlayer,105,210,315,10,65,UCBPlayer
21915,UCBPlayer,131,271,402,25,41,UCBPlayer
21916,UCBPlayer,105,210,315,10,65,UCBPlayer
21917,UCBPlayer,130,275,405,25,40,UCBPlayer
21918,UCBPlayer,105,210,315,10,65,UCBPlayer
21919,UCBPlayer,130,275,405,25,40,UCBPlayer
21920,UCBPlayer,103,203,306,10,68,UCBPlayer
21921,UCBPlayer,128,283,411,25,38,UCBPlayer
21922,UCBPlayer,111,186,297,10,71,UCBPlayer
21923,UCBPlayer,124,299,423,25,34,UCBPlayer
21924,UCBPlayer,115,170,285,10,75,UCBPlayer
21925,UCBPlayer,120,315,435,25,30,UCBPlayer
21926,UCBPlayer,119,154,273,10,79,UCBPlayer
21927,UCBPlayer,112,332,444,25,27,UCBPlayer
21928,UCBPlayer,127,137,264,10,82,UCBPlayer
21929,UCBPlayer,104,349,453,25,24,UCBPlayer
21930,UCBPlayer,126,126,252,7,85,Tie
21931,UCBPlayer,111,351,462,28,22,UCBPlayer
21932,UCBPlayer,116,126,242,3,87,UCBPlayer
21933,UCBPlayer,122,347,469,32,21,UCBPlayer
21934,UCBPlayer,107,132,239,0,87,UCBPlayer
21935,UCBPlayer,132,337,469,35,22,UCBPlayer
21936,UCBPlayer,103,148,251,0,83,UCBPlayer
21937,UCBPlayer,136,321,457,35,26,UCBPlayer
21938,UCBPlayer,99,164,263,0,79,UCBPlayer
21939,UCBPlayer,140,305,445,35,30,UCBPlayer
21940,UCBPlayer,95,180,275,0,75,UCBPlayer
21941,UCBPlayer,144,289,433,35,34,UCBPlayer
21942,UCBPlayer,91,196,287,0,71,UCBPlayer
21943,UCBPlayer,148,273,421,35,38,UCBPlayer
21944,UCBPlayer,87,212,299,0,67,UCBPlayer
21945,UCBPlayer,152,257,409,35,42,UCBPlayer
21946,UCBPlayer,84,224,308,0,64,UCBPlayer
21947,UCBPlayer,146,251,397,32,45,UCBPlayer
21948,UCBPlayer,89,234,323,3,60,UCBPlayer
21949,UCBPlayer,138,243,381,28,49,UCBPlayer
21950,UCBPlayer,97,242,339,7,56,UCBPlayer
21951,UCBPlayer,130,235,365,24,53,UCBPlayer
21952,UCBPlayer,105,250,355,11,52,UCBPlayer
21953,UCBPlayer,122,227,349,20,57,UCBPlayer
21954,UCBPlayer,109,259,368,15,49,UCBPlayer
21955,UCBPlayer,118,218,336,16,60,UCBPlayer
21956,UCBPlayer,117,267,384,19,45,UCBPlayer
21957,UCBPlayer,110,210,320,12,64,UCBPlayer
21958,UCBPlayer,126,271,397,23,42,UCBPlayer
21959,UCBPlayer,105,210,315,10,65,UCBPlayer
21960,UCBPlayer,130,275,405,25,40,UCBPlayer
21961,UCBPlayer,105,210,315,10,65,UCBPlayer
21962,UCBPlayer,130,275,405,25,40,UCBPlayer
21963,UCBPlayer,106,206,312,10,66,UCBPlayer
21964,UCBPlayer,130,275,405,25,40,UCBPlayer
21965,UCBPlayer,105,210,315,10,65,UCBPlayer
21966,UCBPlayer,131,271,402,25,41,UCBPlayer
21967,UCBPlayer,105,210,315,10,65,UCBPlayer
21968,UCBPlayer,130,275,405,25,40,UCBPlayer
21969,UCBPlayer,105,210,315,10,65,UCBPlayer
21970,UCBPlayer,130,275,405,25,40,UCBPlayer
21971,UCBPlayer,103,203,306,10,68,UCBPlayer
21972,UCBPlayer,128,283,411,25,38,UCBPlayer
21973,UCBPlayer,111,186,297,10,71,UCBPlayer
21974,UCBPlayer,124,299,423,25,34,UCBPlayer
21975,UCBPlayer,115,170,285,10,75,UCBPlayer
21976,UCBPlayer,120,315,435,25,30,UCBPlayer
21977,UCBPlayer,119,154,273,10,79,UCBPlayer
21978,UCBPlayer,112,332,444,25,27,UCBPlayer
21979,UCBPlayer,127,137,264,10,82,UCBPlayer
21980,UCBPlayer,104,349,453,25,24,UCBPlayer
21981,UCBPlayer,126,126,252,7,85,Tie
21982,UCBPlayer,111,351,462,28,22,UCBPlayer
21983,UCBPlayer,116,126,242,3,87,UCBPlayer
21984,UCBPlayer,122,347,469,32,21,UCBPlayer
21985,UCBPlayer,107,132,239,0,87,UCBPlayer
21986,UCBPlayer,132,337,469,35,22,UCBPlayer
21987,UCBPlayer,103,148,251,0,83,UCBPlayer
21988,UCBPlayer,136,321,457,35,26,UCBPlayer
21989,UCBPlayer,99,164,263,0,79,UCBPlayer
21990,UCBPlayer,140,305,445,35,30,UCBPlayer
21991,UCBPlayer,95,180,275,0,75,UCBPlayer
21992,UCBPlayer,144,289,433,35,34,UCBPlayer
21993,UCBPlayer,91,196,287,0,71,UCBPlayer
21994,UCBPlayer,148,273,421,35,38,UCBPlayer
21995,UCBPlayer,87,212,299,0,67,UCBPlayer
21996,UCBPlayer,152,257,409,35,42,UCBPlayer
21997,UCBPlayer,84,224,308,0,64,UCBPlayer
21998,UCBPlayer,146,251,397,32,45,UCBPlayer
21999,UCBPlayer,89,234,323,3,60,UCBPlayer
22000,UCBPlayer,138,243,381,28,49,UCBPlayer
22001,UCBPlayer,97,242,339,7,56,UCBPlayer
22002,UCBPlayer,130,235,365,24,53,UCBPlayer
22003,UCBPlayer,105,250,355,11,52,UCBPlayer
22004,UCBPlayer,122,227,349,20,57,UCBPlayer
22005,UCBPlayer,109,259,368,15,49,UCBPlayer
22006,UCBPlayer,118,218,336,16,60,UCBPlayer
22007,UCBPlayer,117,267,384,19,45,UCBPlayer
22008,UCBPlayer,110,210,320,12,64,UCBPlayer
22009,UCBPlayer,126,271,397,23,42,UCBPlayer
22010,UCBPlayer,105,210,315,10,65,UCBPlayer
22011,UCBPlayer,130,275,405,25,40,UCBPlayer
22012,UCBPlayer,105,210,315,10,65,UCBPlayer
22013,UCBPlayer,130,275,405,25,40,UCBPlayer
22014,UCBPlayer,106,206,312,10,66,UCBPlayer
22015,UCBPlayer,130,275,405,25,40,UCBPlayer
22016,UCBPlayer,105,210,315,10,65,UCBPlayer
22017,UCBPlayer,131,271,402,25,41,UCBPlayer
22018,UCBPlayer,105,210,315,10,65,UCBPlayer
22019,UCBPlayer,130,275,405,25,40,UCBPlayer
22020,UCBPlayer,105,210,315,10,65,UCBPlayer
22021,UCBPlayer,130,275,405,25,40,UCBPlayer
22022,UCBPlayer,103,203,306,10,68,UCBPlayer
22023,UCBPlayer,128,283,411,25,38,UCBPlayer
22024,UCBPlayer,111,186,297,10,71,UCBPlayer
22025,UCBPlayer,124,299,423,25,34,UCBPlayer
22026,UCBPlayer,115,170,285,10,75,UCBPlayer
22027,UCBPlayer,120,315,435,25,30,UCBPlayer
22028,UCBPlayer,119,154,273,10,79,UCBPlayer
22029,UCBPlayer,112,332,444,25,27,UCBPlayer
22030,UCBPlayer,127,137,264,10,82,UCBPlayer
22031,UCBPlayer,104,349,453,25,24,UCBPlayer
22032,UCBPlayer,126,126,252,7,85,Tie
22033,UCBPlayer,111,351,462,28,22,UCBPlayer
22034,UCBPlayer,116,126,242,3,87,UCBPlayer
22035,UCBPlayer,122,347,469,32,21,UCBPlayer
22036,UCBPlayer,107,132,239,0,87,UCBPlayer
22037,UCBPlayer,132,337,469,35,22,UCBPlayer
22038,UCBPlayer,103,148,251,0,83,UCBPlayer
22039,UCBPlayer,136,321,457,35,26,UCBPlayer
22040,UCBPlayer,99,164,263,0,79,UCBPlayer
22041,UCBPlayer,140,305,445,35,30,UCBPlayer
22042,UCBPlayer,95,180,275,0,75,UCBPlayer
22043,UCBPlayer,144,289,433,35,34,UCBPlayer
22044,UCBPlayer,91,196,287,0,71,UCBPlayer
22045,UCBPlayer,148,273,421,35,38,UCBPlayer
22046,UCBPlayer,87,212,299,0,67,UCBPlayer
22047,UCBPlayer,152,257,409,35,42,UCBPlayer
22048,UCBPlayer,84,224,308,0,64,UCBPlayer
22049,UCBPlayer,146,251,397,32,45,UCBPlayer
22050,UCBPlayer,89,234,323,3,60,UCBPlayer
22051,UCBPlayer,138,243,381,28,49,UCBPlayer
22052,UCBPlayer,97,242,339,7,56,UCBPlayer
22053,UCBPlayer,130,235,365,24,53,UCBPlayer
22054,UCBPlayer,105,250,355,11,52,UCBPlayer
22055,UCBPlayer,122,227,349,20,57,UCBPlayer
22056,UCBPlayer,109,259,368,15,49,UCBPlayer
22057,UCBPlayer,118,218,336,16,60,UCBPlayer
22058,UCBPlayer,117,267,384,19,45,UCBPlayer
22059,UCBPlayer,110,210,320,12,64,UCBPlayer
22060,UCBPlayer,126,271,397,23,42,UCBPlayer
22061,UCBPlayer,105,210,315,10,65,UCBPlayer
22062,UCBPlayer,130,275,405,25,40,UCBPlayer
22063,UCBPlayer,105,210,315,10,65,UCBPlayer
22064,UCBPlayer,130,275,405,25,40,UCBPlayer
22065,UCBPlayer,106,206,312,10,66,UCBPlayer
22066,UCBPlayer,130,275,405,25,40,UCBPlayer
22067,UCBPlayer,105,210,315,10,65,UCBPlayer
22068,UCBPlayer,131,271,402,25,41,UCBPlayer
22069,UCBPlayer,105,210,315,10,65,UCBPlayer
22070,UCBPlayer,130,275,405,25,40,UCBPlayer
22071,UCBPlayer,105,210,315,10,65,UCBPlayer
22072,UCBPlayer,130,275,405,25,40,UCBPlayer
22073,UCBPlayer,103,203,306,10,68,UCBPlayer
22074,UCBPlayer,128,283,411,25,38,UCBPlayer
22075,UCBPlayer,111,186,297,10,71,UCBPlayer
22076,UCBPlayer,124,299,423,25,34,UCBPlayer
22077,UCBPlayer,115,170,285,10,75,UCBPlayer
22078,UCBPlayer,120,315,435,25,30,UCBPlayer
22079,UCBPlayer,119,154,273,10,79,UCBPlayer
22080,UCBPlayer,112,332,444,25,27,UCBPlayer
22081,UCBPlayer,127,137,264,10,82,UCBPlayer
22082,UCBPlayer,104,349,453,25,24,UCBPlayer
22083,UCBPlayer,126,126,252,7,85,Tie
22084,UCBPlayer,111,351,462,28,22,UCBPlayer
22085,UCBPlayer,116,126,242,3,87,UCBPlayer
22086,UCBPlayer,122,347,469,32,21,UCBPlayer
22087,UCBPlayer,107,132,239,0,87,UCBPlayer
22088,UCBPlayer,132,337,469,35,22,UCBPlayer
22089,UCBPlayer,103,148,251,0,83,UCBPlayer
22090,UCBPlayer,136,321,457,35,26,UCBPlayer
22091,UCBPlayer,99,164,263,0,79,UCBPlayer
22092,UCBPlayer,140,305,445,35,30,UCBPlayer
22093,UCBPlayer,95,180,275,0,75,UCBPlayer
22094,UCBPlayer,144,289,433,35,34,UCBPlayer
22095,UCBPlayer,91,196,287,0,71,UCBPlayer
22096,UCBPlayer,148,273,421,35,38,UCBPlayer
22097,UCBPlayer,87,212,299,0,67,UCBPlayer
22098,UCBPlayer,152,257,409,35,42,UCBPlayer
22099,UCBPlayer,84,224,308,0,64,UCBPlayer
22100,UCBPlayer,146,251,397,32,45,UCBPlayer
22101,UCBPlayer,89,234,323,3,60,UCBPlayer
22102,UCBPlayer,138,243,381,28,49,UCBPlayer
22103,UCBPlayer,97,242,339,7,56,UCBPlayer
22104,UCBPlayer,130,235,365,24,53,UCBPlayer
22105,UCBPlayer,105,250,355,11,52,UCBPlayer
22106,UCBPlayer,122,227,349,20,57,UCBPlayer
22107,UCBPlayer,109,259,368,15,49,UCBPlayer
22108,UCBPlayer,118,218,336,16,60,UCBPlayer
22109,UCBPlayer,117,267,384,19,45,UCBPlayer
22110,UCBPlayer,110,210,320,12,64,UCBPlayer
22111,UCBPlayer,126,271,397,23,42,UCBPlayer
22112,UCBPlayer,105,210,315,10,65,UCBPlayer
22113,UCBPlayer,130,275,405,25,40,UCBPlayer
22114,UCBPlayer,105,210,315,10,65,UCBPlayer
22115,UCBPlayer,130,275,405,25,40,UCBPlayer
22116,UCBPlayer,106,206,312,10,66,UCBPlayer
22117,UCBPlayer,130,275,405,25,40,UCBPlayer
22118,UCBPlayer,105,210,315,10,65,UCBPlayer
22119,UCBPlayer,131,271,402,25,41,UCBPlayer
22120,UCBPlayer,105,210,315,10,65,UCBPlayer
22121,UCBPlayer,130,275,405,25,40,UCBPlayer
22122,UCBPlayer,105,210,315,10,65,UCBPlayer
22123,UCBPlayer,130,275,405,25,40,UCBPlayer
22124,UCBPlayer,103,203,306,10,68,UCBPlayer
22125,UCBPlayer,128,283,411,25,38,UCBPlayer
22126,UCBPlayer,111,186,297,10,71,UCBPlayer
22127,UCBPlayer,124,299,423,25,34,UCBPlayer
22128,UCBPlayer,115,170,285,10,75,UCBPlayer
22129,UCBPlayer,120,315,435,25,30,UCBPlayer
22130,UCBPlayer,119,154,273,10,79,UCBPlayer
22131,UCBPlayer,112,332,444,25,27,UCBPlayer
22132,UCBPlayer,127,137,264,10,82,UCBPlayer
22133,UCBPlayer,104,349,453,25,24,UCBPlayer
22134,UCBPlayer,126,126,252,7,85,Tie
22135,UCBPlayer,111,351,462,28,22,UCBPlayer
22136,UCBPlayer,116,126,242,3,87,UCBPlayer
22137,UCBPlayer,122,347,469,32,21,UCBPlayer
22138,UCBPlayer,107,132,239,0,87,UCBPlayer
22139,UCBPlayer,132,337,469,35,22,UCBPlayer
22140,UCBPlayer,103,148,251,0,83,UCBPlayer
22141,UCBPlayer,136,321,457,35,26,UCBPlayer
22142,UCBPlayer,99,164,263,0,79,UCBPlayer
22143,UCBPlayer,140,305,445,35,30,UCBPlayer
22144,UCBPlayer,95,180,275,0,75,UCBPlayer
22145,UCBPlayer,144,289,433,35,34,UCBPlayer
22146,UCBPlayer,91,196,287,0,71,UCBPlayer
22147,UCBPlayer,148,273,421,35,38,UCBPlayer
22148,UCBPlayer,87,212,299,0,67,UCBPlayer
22149,UCBPlayer,152,257,409,35,42,UCBPlayer
22150,UCBPlayer,84,224,308,0,64,UCBPlayer
22151,UCBPlayer,146,251,397,32,45,UCBPlayer
22152,UCBPlayer,89,234,323,3,60,UCBPlayer
22153,UCBPlayer,138,243,381,28,49,UCBPlayer
22154,UCBPlayer,97,242,339,7,56,UCBPlayer
22155,UCBPlayer,130,235,365,24,53,UCBPlayer
22156,UCBPlayer,105,250,355,11,52,UCBPlayer
22157,UCBPlayer,122,227,349,20,57,UCBPlayer
22158,UCBPlayer,109,259,368,15,49,UCBPlayer
22159,UCBPlayer,118,218,336,16,60,UCBPlayer
22160,UCBPlayer,117,267,384,19,45,UCBPlayer
22161,UCBPlayer,110,210,320,12,64,UCBPlayer
22162,UCBPlayer,126,271,397,23,42,UCBPlayer
22163,UCBPlayer,105,210,315,10,65,UCBPlayer
22164,UCBPlayer,130,275,405,25,40,UCBPlayer
22165,UCBPlayer,105,210,315,10,65,UCBPlayer
22166,UCBPlayer,130,275,405,25,40,UCBPlayer
22167,UCBPlayer,106,206,312,10,66,UCBPlayer
22168,UCBPlayer,130,275,405,25,40,UCBPlayer
22169,UCBPlayer,105,210,315,10,65,UCBPlayer
22170,UCBPlayer,131,271,402,25,41,UCBPlayer
22171,UCBPlayer,105,210,315,10,65,UCBPlayer
22172,UCBPlayer,130,275,405,25,40,UCBPlayer
22173,UCBPlayer,105,210,315,10,65,UCBPlayer
22174,UCBPlayer,130,275,405,25,40,UCBPlayer
22175,UCBPlayer,103,203,306,10,68,UCBPlayer
22176,UCBPlayer,128,283,411,25,38,UCBPlayer
22177,UCBPlayer,111,186,297,10,71,UCBPlayer
22178,UCBPlayer,124,299,423,25,34,UCBPlayer
22179,UCBPlayer,115,170,285,10,75,UCBPlayer
22180,UCBPlayer,120,315,435,25,30,UCBPlayer
22181,UCBPlayer,119,154,273,10,79,UCBPlayer
22182,UCBPlayer,112,332,444,25,27,UCBPlayer
22183,UCBPlayer,127,137,264,10,82,UCBPlayer
22184,UCBPlayer,104,349,453,25,24,UCBPlayer
22185,UCBPlayer,126,126,252,7,85,Tie
22186,UCBPlayer,111,351,462,28,22,UCBPlayer
22187,UCBPlayer,116,126,242,3,87,UCBPlayer
22188,UCBPlayer,122,347,469,32,21,UCBPlayer
22189,UCBPlayer,107,132,239,0,87,UCBPlayer
22190,UCBPlayer,132,337,469,35,22,UCBPlayer
22191,UCBPlayer,103,148,251,0,83,UCBPlayer
22192,UCBPlayer,136,321,457,35,26,UCBPlayer
22193,UCBPlayer,99,164,263,0,79,UCBPlayer
22194,UCBPlayer,140,305,445,35,30,UCBPlayer
22195,UCBPlayer,95,180,275,0,75,UCBPlayer
22196,UCBPlayer,144,289,433,35,34,UCBPlayer
22197,UCBPlayer,91,196,287,0,71,UCBPlayer
22198,UCBPlayer,148,273,421,35,38,UCBPlayer
22199,UCBPlayer,87,212,299,0,67,UCBPlayer
22200,UCBPlayer,152,257,409,35,42,UCBPlayer
22201,UCBPlayer,84,224,308,0,64,UCBPlayer
22202,UCBPlayer,146,251,397,32,45,UCBPlayer
22203,UCBPlayer,89,234,323,3,60,UCBPlayer
22204,UCBPlayer,138,243,381,28,49,UCBPlayer
22205,UCBPlayer,97,242,339,7,56,UCBPlayer
22206,UCBPlayer,130,235,365,24,53,UCBPlayer
22207,UCBPlayer,105,250,355,11,52,UCBPlayer
22208,UCBPlayer,122,227,349,20,57,UCBPlayer
22209,UCBPlayer,109,259,368,15,49,UCBPlayer
22210,UCBPlayer,118,218,336,16,60,UCBPlayer
22211,UCBPlayer,117,267,384,19,45,UCBPlayer
22212,UCBPlayer,110,210,320,12,64,UCBPlayer
22213,UCBPlayer,126,271,397,23,42,UCBPlayer
22214,UCBPlayer,105,210,315,10,65,UCBPlayer
22215,UCBPlayer,130,275,405,25,40,UCBPlayer
22216,UCBPlayer,105,210,315,10,65,UCBPlayer
22217,UCBPlayer,130,275,405,25,40,UCBPlayer
22218,UCBPlayer,106,206,312,10,66,UCBPlayer
22219,UCBPlayer,130,275,405,25,40,UCBPlayer
22220,UCBPlayer,105,210,315,10,65,UCBPlayer
22221,UCBPlayer,131,271,402,25,41,UCBPlayer
22222,UCBPlayer,105,210,315,10,65,UCBPlayer
22223,UCBPlayer,130,275,405,25,40,UCBPlayer
22224,UCBPlayer,105,210,315,10,65,UCBPlayer
22225,UCBPlayer,130,275,405,25,40,UCBPlayer
22226,UCBPlayer,103,203,306,10,68,UCBPlayer
22227,UCBPlayer,128,283,411,25,38,UCBPlayer
22228,UCBPlayer,111,186,297,10,71,UCBPlayer
22229,UCBPlayer,124,299,423,25,34,UCBPlayer
22230,UCBPlayer,115,170,285,10,75,UCBPlayer
22231,UCBPlayer,120,315,435,25,30,UCBPlayer
22232,UCBPlayer,119,154,273,10,79,UCBPlayer
22233,UCBPlayer,112,332,444,25,27,UCBPlayer
22234,UCBPlayer,127,137,264,10,82,UCBPlayer
22235,UCBPlayer,104,349,453,25,24,UCBPlayer
22236,UCBPlayer,126,126,252,7,85,Tie
22237,UCBPlayer,111,351,462,28,22,UCBPlayer
22238,UCBPlayer,116,126,242,3,87,UCBPlayer
22239,UCBPlayer,122,347,469,32,21,UCBPlayer
22240,UCBPlayer,107,132,239,0,87,UCBPlayer
22241,UCBPlayer,132,337,469,35,22,UCBPlayer
22242,UCBPlayer,103,148,251,0,83,UCBPlayer
22243,UCBPlayer,136,321,457,35,26,UCBPlayer
22244,UCBPlayer,99,164,263,0,79,UCBPlayer
22245,UCBPlayer,140,305,445,35,30,UCBPlayer
22246,UCBPlayer,95,180,275,0,75,UCBPlayer
22247,UCBPlayer,144,289,433,35,34,UCBPlayer
22248,UCBPlayer,91,196,287,0,71,UCBPlayer
22249,UCBPlayer,148,273,421,35,38,UCBPlayer
22250,UCBPlayer,87,212,299,0,67,UCBPlayer
22251,UCBPlayer,152,257,409,35,42,UCBPlayer
22252,UCBPlayer,84,224,308,0,64,UCBPlayer
22253,UCBPlayer,146,251,397,32,45,UCBPlayer
22254,UCBPlayer,89,234,323,3,60,UCBPlayer
22255,UCBPlayer,138,243,381,28,49,UCBPlayer
22256,UCBPlayer,97,242,339,7,56,UCBPlayer
22257,UCBPlayer,130,235,365,24,53,UCBPlayer
22258,UCBPlayer,105,250,355,11,52,UCBPlayer
22259,UCBPlayer,122,227,349,20,57,UCBPlayer
22260,UCBPlayer,109,259,368,15,49,UCBPlayer
22261,UCBPlayer,118,218,336,16,60,UCBPlayer
22262,UCBPlayer,117,267,384,19,45,UCBPlayer
22263,UCBPlayer,110,210,320,12,64,UCBPlayer
22264,UCBPlayer,126,271,397,23,42,UCBPlayer
22265,UCBPlayer,105,210,315,10,65,UCBPlayer
22266,UCBPlayer,130,275,405,25,40,UCBPlayer
22267,UCBPlayer,105,210,315,10,65,UCBPlayer
22268,UCBPlayer,130,275,405,25,40,UCBPlayer
22269,UCBPlayer,106,206,312,10,66,UCBPlayer
22270,UCBPlayer,130,275,405,25,40,UCBPlayer
22271,UCBPlayer,105,210,315,10,65,UCBPlayer
22272,UCBPlayer,131,271,402,25,41,UCBPlayer
22273,UCBPlayer,105,210,315,10,65,UCBPlayer
22274,UCBPlayer,130,275,405,25,40,UCBPlayer
22275,UCBPlayer,105,210,315,10,65,UCBPlayer
22276,UCBPlayer,130,275,405,25,40,UCBPlayer
22277,UCBPlayer,103,203,306,10,68,UCBPlayer
22278,UCBPlayer,128,283,411,25,38,UCBPlayer
22279,UCBPlayer,111,186,297,10,71,UCBPlayer
22280,UCBPlayer,124,299,423,25,34,UCBPlayer
22281,UCBPlayer,115,170,285,10,75,UCBPlayer
22282,UCBPlayer,120,315,435,25,30,UCBPlayer
22283,UCBPlayer,119,154,273,10,79,UCBPlayer
22284,UCBPlayer,112,332,444,25,27,UCBPlayer
22285,UCBPlayer,127,137,264,10,82,UCBPlayer
22286,UCBPlayer,104,349,453,25,24,UCBPlayer
22287,UCBPlayer,126,126,252,7,85,Tie
22288,UCBPlayer,111,351,462,28,22,UCBPlayer
22289,UCBPlayer,116,126,242,3,87,UCBPlayer
22290,UCBPlayer,122,347,469,32,21,UCBPlayer
22291,UCBPlayer,107,132,239,0,87,UCBPlayer
22292,UCBPlayer,132,337,469,35,22,UCBPlayer
22293,UCBPlayer,103,148,251,0,83,UCBPlayer
22294,UCBPlayer,136,321,457,35,26,UCBPlayer
22295,UCBPlayer,99,164,263,0,79,UCBPlayer
22296,UCBPlayer,140,305,445,35,30,UCBPlayer
22297,UCBPlayer,95,180,275,0,75,UCBPlayer
22298,UCBPlayer,144,289,433,35,34,UCBPlayer
22299,UCBPlayer,91,196,287,0,71,UCBPlayer
22300,UCBPlayer,148,273,421,35,38,UCBPlayer
22301,UCBPlayer,87,212,299,0,67,UCBPlayer
22302,UCBPlayer,152,257,409,35,42,UCBPlayer
22303,UCBPlayer,84,224,308,0,64,UCBPlayer
22304,UCBPlayer,146,251,397,32,45,UCBPlayer
22305,UCBPlayer,89,234,323,3,60,UCBPlayer
22306,UCBPlayer,138,243,381,28,49,UCBPlayer
22307,UCBPlayer,97,242,339,7,56,UCBPlayer
22308,UCBPlayer,130,235,365,24,53,UCBPlayer
22309,UCBPlayer,105,250,355,11,52,UCBPlayer
22310,UCBPlayer,122,227,349,20,57,UCBPlayer
22311,UCBPlayer,109,259,368,15,49,UCBPlayer
22312,UCBPlayer,118,218,336,16,60,UCBPlayer
22313,UCBPlayer,117,267,384,19,45,UCBPlayer
22314,UCBPlayer,110,210,320,12,64,UCBPlayer
22315,UCBPlayer,126,271,397,23,42,UCBPlayer
22316,UCBPlayer,105,210,315,10,65,UCBPlayer
22317,UCBPlayer,130,275,405,25,40,UCBPlayer
22318,UCBPlayer,105,210,315,10,65,UCBPlayer
22319,UCBPlayer,130,275,405,25,40,UCBPlayer
22320,UCBPlayer,106,206,312,10,66,UCBPlayer
22321,UCBPlayer,130,275,405,25,40,UCBPlayer
22322,UCBPlayer,105,210,315,10,65,UCBPlayer
22323,UCBPlayer,131,271,402,25,41,UCBPlayer
22324,UCBPlayer,105,210,315,10,65,UCBPlayer
22325,UCBPlayer,130,275,405,25,40,UCBPlayer
22326,UCBPlayer,105,210,315,10,65,UCBPlayer
22327,UCBPlayer,130,275,405,25,40,UCBPlayer
22328,UCBPlayer,103,203,306,10,68,UCBPlayer
22329,UCBPlayer,128,283,411,25,38,UCBPlayer
22330,UCBPlayer,111,186,297,10,71,UCBPlayer
22331,UCBPlayer,124,299,423,25,34,UCBPlayer
22332,UCBPlayer,115,170,285,10,75,UCBPlayer
22333,UCBPlayer,120,315,435,25,30,UCBPlayer
22334,UCBPlayer,119,154,273,10,79,UCBPlayer
22335,UCBPlayer,112,332,444,25,27,UCBPlayer
22336,UCBPlayer,127,137,264,10,82,UCBPlayer
22337,UCBPlayer,104,349,453,25,24,UCBPlayer
22338,UCBPlayer,126,126,252,7,85,Tie
22339,UCBPlayer,111,351,462,28,22,UCBPlayer
22340,UCBPlayer,116,126,242,3,87,UCBPlayer
22341,UCBPlayer,122,347,469,32,21,UCBPlayer
22342,UCBPlayer,107,132,239,0,87,UCBPlayer
22343,UCBPlayer,132,337,469,35,22,UCBPlayer
22344,UCBPlayer,103,148,251,0,83,UCBPlayer
22345,UCBPlayer,136,321,457,35,26,UCBPlayer
22346,UCBPlayer,99,164,263,0,79,UCBPlayer
22347,UCBPlayer,140,305,445,35,30,UCBPlayer
22348,UCBPlayer,95,180,275,0,75,UCBPlayer
22349,UCBPlayer,144,289,433,35,34,UCBPlayer
22350,UCBPlayer,91,196,287,0,71,UCBPlayer
22351,UCBPlayer,148,273,421,35,38,UCBPlayer
22352,UCBPlayer,87,212,299,0,67,UCBPlayer
22353,UCBPlayer,152,257,409,35,42,UCBPlayer
22354,UCBPlayer,84,224,308,0,64,UCBPlayer
22355,UCBPlayer,146,251,397,32,45,UCBPlayer
22356,UCBPlayer,89,234,323,3,60,UCBPlayer
22357,UCBPlayer,138,243,381,28,49,UCBPlayer
22358,UCBPlayer,97,242,339,7,56,UCBPlayer
22359,UCBPlayer,130,235,365,24,53,UCBPlayer
22360,UCBPlayer,105,250,355,11,52,UCBPlayer
22361,UCBPlayer,122,227,349,20,57,UCBPlayer
22362,UCBPlayer,109,259,368,15,49,UCBPlayer
22363,UCBPlayer,118,218,336,16,60,UCBPlayer
22364,UCBPlayer,117,267,384,19,45,UCBPlayer
22365,UCBPlayer,110,210,320,12,64,UCBPlayer
22366,UCBPlayer,126,271,397,23,42,UCBPlayer
22367,UCBPlayer,105,210,315,10,65,UCBPlayer
22368,UCBPlayer,130,275,405,25,40,UCBPlayer
22369,UCBPlayer,105,210,315,10,65,UCBPlayer
22370,UCBPlayer,130,275,405,25,40,UCBPlayer
22371,UCBPlayer,106,206,312,10,66,UCBPlayer
22372,UCBPlayer,130,275,405,25,40,UCBPlayer
22373,UCBPlayer,105,210,315,10,65,UCBPlayer
22374,UCBPlayer,131,271,402,25,41,UCBPlayer
22375,UCBPlayer,105,210,315,10,65,UCBPlayer
22376,UCBPlayer,130,275,405,25,40,UCBPlayer
22377,UCBPlayer,105,210,315,10,65,UCBPlayer
22378,UCBPlayer,130,275,405,25,40,UCBPlayer
22379,UCBPlayer,103,203,306,10,68,UCBPlayer
22380,UCBPlayer,128,283,411,25,38,UCBPlayer
22381,UCBPlayer,111,186,297,10,71,UCBPlayer
22382,UCBPlayer,124,299,423,25,34,UCBPlayer
22383,UCBPlayer,115,170,285,10,75,UCBPlayer
22384,UCBPlayer,120,315,435,25,30,UCBPlayer
22385,UCBPlayer,119,154,273,10,79,UCBPlayer
22386,UCBPlayer,112,332,444,25,27,UCBPlayer
22387,UCBPlayer,127,137,264,10,82,UCBPlayer
22388,UCBPlayer,104,349,453,25,24,UCBPlayer
22389,UCBPlayer,126,126,252,7,85,Tie
22390,UCBPlayer,111,351,462,28,22,UCBPlayer
22391,UCBPlayer,116,126,242,3,87,UCBPlayer
22392,UCBPlayer,122,347,469,32,21,UCBPlayer
22393,UCBPlayer,107,132,239,0,87,UCBPlayer
22394,UCBPlayer,132,337,469,35,22,UCBPlayer
22395,UCBPlayer,103,148,251,0,83,UCBPlayer
22396,UCBPlayer,136,321,457,35,26,UCBPlayer
22397,UCBPlayer,99,164,263,0,79,UCBPlayer
22398,UCBPlayer,140,305,445,35,30,UCBPlayer
22399,UCBPlayer,95,180,275,0,75,UCBPlayer
22400,UCBPlayer,144,289,433,35,34,UCBPlayer
22401,UCBPlayer,91,196,287,0,71,UCBPlayer
22402,UCBPlayer,148,273,421,35,38,UCBPlayer
22403,UCBPlayer,87,212,299,0,67,UCBPlayer
22404,UCBPlayer,152,257,409,35,42,UCBPlayer
22405,UCBPlayer,84,224,308,0,64,UCBPlayer
22406,UCBPlayer,146,251,397,32,45,UCBPlayer
22407,UCBPlayer,89,234,323,3,60,UCBPlayer
22408,UCBPlayer,138,243,381,28,49,UCBPlayer
22409,UCBPlayer,97,242,339,7,56,UCBPlayer
22410,UCBPlayer,130,235,365,24,53,UCBPlayer
22411,UCBPlayer,105,250,355,11,52,UCBPlayer
22412,UCBPlayer,122,227,349,20,57,UCBPlayer
22413,UCBPlayer,109,259,368,15,49,UCBPlayer
22414,UCBPlayer,118,218,336,16,60,UCBPlayer
22415,UCBPlayer,117,267,384,19,45,UCBPlayer
22416,UCBPlayer,110,210,320,12,64,UCBPlayer
22417,UCBPlayer,126,271,397,23,42,UCBPlayer
22418,UCBPlayer,105,210,315,10,65,UCBPlayer
22419,UCBPlayer,130,275,405,25,40,UCBPlayer
22420,UCBPlayer,105,210,315,10,65,UCBPlayer
22421,UCBPlayer,130,275,405,25,40,UCBPlayer
22422,UCBPlayer,106,206,312,10,66,UCBPlayer
22423,UCBPlayer,130,275,405,25,40,UCBPlayer
22424,UCBPlayer,105,210,315,10,65,UCBPlayer
22425,UCBPlayer,131,271,402,25,41,UCBPlayer
22426,UCBPlayer,105,210,315,10,65,UCBPlayer
22427,UCBPlayer,130,275,405,25,40,UCBPlayer
22428,UCBPlayer,105,210,315,10,65,UCBPlayer
22429,UCBPlayer,130,275,405,25,40,UCBPlayer
22430,UCBPlayer,103,203,306,10,68,UCBPlayer
22431,UCBPlayer,128,283,411,25,38,UCBPlayer
22432,UCBPlayer,111,186,297,10,71,UCBPlayer
22433,UCBPlayer,124,299,423,25,34,UCBPlayer
22434,UCBPlayer,115,170,285,10,75,UCBPlayer
22435,UCBPlayer,120,315,435,25,30,UCBPlayer
22436,UCBPlayer,119,154,273,10,79,UCBPlayer
22437,UCBPlayer,112,332,444,25,27,UCBPlayer
22438,UCBPlayer,127,137,264,10,82,UCBPlayer
22439,UCBPlayer,104,349,453,25,24,UCBPlayer
22440,UCBPlayer,126,126,252,7,85,Tie
22441,UCBPlayer,111,351,462,28,22,UCBPlayer
22442,UCBPlayer,116,126,242,3,87,UCBPlayer
22443,UCBPlayer,122,347,469,32,21,UCBPlayer
22444,UCBPlayer,107,132,239,0,87,UCBPlayer
22445,UCBPlayer,132,337,469,35,22,UCBPlayer
22446,UCBPlayer,103,148,251,0,83,UCBPlayer
22447,UCBPlayer,136,321,457,35,26,UCBPlayer
22448,UCBPlayer,99,164,263,0,79,UCBPlayer
22449,UCBPlayer,140,305,445,35,30,UCBPlayer
22450,UCBPlayer,95,180,275,0,75,UCBPlayer
22451,UCBPlayer,144,289,433,35,34,UCBPlayer
22452,UCBPlayer,91,196,287,0,71,UCBPlayer
22453,UCBPlayer,148,273,421,35,38,UCBPlayer
22454,UCBPlayer,87,212,299,0,67,UCBPlayer
22455,UCBPlayer,152,257,409,35,42,UCBPlayer
22456,UCBPlayer,84,224,308,0,64,UCBPlayer
22457,UCBPlayer,146,251,397,32,45,UCBPlayer
22458,UCBPlayer,89,234,323,3,60,UCBPlayer
22459,UCBPlayer,138,243,381,28,49,UCBPlayer
22460,UCBPlayer,97,242,339,7,56,UCBPlayer
22461,UCBPlayer,130,235,365,24,53,UCBPlayer
22462,UCBPlayer,105,250,355,11,52,UCBPlayer
22463,UCBPlayer,122,227,349,20,57,UCBPlayer
22464,UCBPlayer,109,259,368,15,49,UCBPlayer
22465,UCBPlayer,118,218,336,16,60,UCBPlayer
22466,UCBPlayer,117,267,384,19,45,UCBPlayer
22467,UCBPlayer,110,210,320,12,64,UCBPlayer
22468,UCBPlayer,126,271,397,23,42,UCBPlayer
22469,UCBPlayer,105,210,315,10,65,UCBPlayer
22470,UCBPlayer,130,275,405,25,40,UCBPlayer
22471,UCBPlayer,105,210,315,10,65,UCBPlayer
22472,UCBPlayer,130,275,405,25,40,UCBPlayer
22473,UCBPlayer,106,206,312,10,66,UCBPlayer
22474,UCBPlayer,130,275,405,25,40,UCBPlayer
22475,UCBPlayer,105,210,315,10,65,UCBPlayer
22476,UCBPlayer,131,271,402,25,41,UCBPlayer
22477,UCBPlayer,105,210,315,10,65,UCBPlayer
22478,UCBPlayer,130,275,405,25,40,UCBPlayer
22479,UCBPlayer,105,210,315,10,65,UCBPlayer
22480,UCBPlayer,130,275,405,25,40,UCBPlayer
22481,UCBPlayer,103,203,306,10,68,UCBPlayer
22482,UCBPlayer,128,283,411,25,38,UCBPlayer
22483,UCBPlayer,111,186,297,10,71,UCBPlayer
22484,UCBPlayer,124,299,423,25,34,UCBPlayer
22485,UCBPlayer,115,170,285,10,75,UCBPlayer
22486,UCBPlayer,120,315,435,25,30,UCBPlayer
22487,UCBPlayer,119,154,273,10,79,UCBPlayer
22488,UCBPlayer,112,332,444,25,27,UCBPlayer
22489,UCBPlayer,127,137,264,10,82,UCBPlayer
22490,UCBPlayer,104,349,453,25,24,UCBPlayer
22491,UCBPlayer,126,126,252,7,85,Tie
22492,UCBPlayer,111,351,462,28,22,UCBPlayer
22493,UCBPlayer,116,126,242,3,87,UCBPlayer
22494,UCBPlayer,122,347,469,32,21,UCBPlayer
22495,UCBPlayer,107,132,239,0,87,UCBPlayer
22496,UCBPlayer,132,337,469,35,22,UCBPlayer
22497,UCBPlayer,103,148,251,0,83,UCBPlayer
22498,UCBPlayer,136,321,457,35,26,UCBPlayer
22499,UCBPlayer,99,164,263,0,79,UCBPlayer
22500,UCBPlayer,140,305,445,35,30,UCBPlayer
22501,UCBPlayer,95,180,275,0,75,UCBPlayer
22502,UCBPlayer,144,289,433,35,34,UCBPlayer
22503,UCBPlayer,91,196,287,0,71,UCBPlayer
22504,UCBPlayer,148,273,421,35,38,UCBPlayer
22505,UCBPlayer,87,212,299,0,67,UCBPlayer
22506,UCBPlayer,152,257,409,35,42,UCBPlayer
22507,UCBPlayer,84,224,308,0,64,UCBPlayer
22508,UCBPlayer,146,251,397,32,45,UCBPlayer
22509,UCBPlayer,89,234,323,3,60,UCBPlayer
22510,UCBPlayer,138,243,381,28,49,UCBPlayer
22511,UCBPlayer,97,242,339,7,56,UCBPlayer
22512,UCBPlayer,130,235,365,24,53,UCBPlayer
22513,UCBPlayer,105,250,355,11,52,UCBPlayer
22514,UCBPlayer,122,227,349,20,57,UCBPlayer
22515,UCBPlayer,109,259,368,15,49,UCBPlayer
22516,UCBPlayer,118,218,336,16,60,UCBPlayer
22517,UCBPlayer,117,267,384,19,45,UCBPlayer
22518,UCBPlayer,110,210,320,12,64,UCBPlayer
22519,UCBPlayer,126,271,397,23,42,UCBPlayer
22520,UCBPlayer,105,210,315,10,65,UCBPlayer
22521,UCBPlayer,130,275,405,25,40,UCBPlayer
22522,UCBPlayer,105,210,315,10,65,UCBPlayer
22523,UCBPlayer,130,275,405,25,40,UCBPlayer
22524,UCBPlayer,106,206,312,10,66,UCBPlayer
22525,UCBPlayer,130,275,405,25,40,UCBPlayer
22526,UCBPlayer,105,210,315,10,65,UCBPlayer
22527,UCBPlayer,131,271,402,25,41,UCBPlayer
22528,UCBPlayer,105,210,315,10,65,UCBPlayer
22529,UCBPlayer,130,275,405,25,40,UCBPlayer
22530,UCBPlayer,105,210,315,10,65,UCBPlayer
22531,UCBPlayer,130,275,405,25,40,UCBPlayer
22532,UCBPlayer,103,203,306,10,68,UCBPlayer
22533,UCBPlayer,128,283,411,25,38,UCBPlayer
22534,UCBPlayer,111,186,297,10,71,UCBPlayer
22535,UCBPlayer,124,299,423,25,34,UCBPlayer
22536,UCBPlayer,115,170,285,10,75,UCBPlayer
22537,UCBPlayer,120,315,435,25,30,UCBPlayer
22538,UCBPlayer,119,154,273,10,79,UCBPlayer
22539,UCBPlayer,112,332,444,25,27,UCBPlayer
22540,UCBPlayer,127,137,264,10,82,UCBPlayer
22541,UCBPlayer,104,349,453,25,24,UCBPlayer
22542,UCBPlayer,126,126,252,7,85,Tie
22543,UCBPlayer,111,351,462,28,22,UCBPlayer
22544,UCBPlayer,116,126,242,3,87,UCBPlayer
22545,UCBPlayer,122,347,469,32,21,UCBPlayer
22546,UCBPlayer,107,132,239,0,87,UCBPlayer
22547,UCBPlayer,132,337,469,35,22,UCBPlayer
22548,UCBPlayer,103,148,251,0,83,UCBPlayer
22549,UCBPlayer,136,321,457,35,26,UCBPlayer
22550,UCBPlayer,99,164,263,0,79,UCBPlayer
22551,UCBPlayer,140,305,445,35,30,UCBPlayer
22552,UCBPlayer,95,180,275,0,75,UCBPlayer
22553,UCBPlayer,144,289,433,35,34,UCBPlayer
22554,UCBPlayer,91,196,287,0,71,UCBPlayer
22555,UCBPlayer,148,273,421,35,38,UCBPlayer
22556,UCBPlayer,87,212,299,0,67,UCBPlayer
22557,UCBPlayer,152,257,409,35,42,UCBPlayer
22558,UCBPlayer,84,224,308,0,64,UCBPlayer
22559,UCBPlayer,146,251,397,32,45,UCBPlayer
22560,UCBPlayer,89,234,323,3,60,UCBPlayer
22561,UCBPlayer,138,243,381,28,49,UCBPlayer
22562,UCBPlayer,97,242,339,7,56,UCBPlayer
22563,UCBPlayer,130,235,365,24,53,UCBPlayer
22564,UCBPlayer,105,250,355,11,52,UCBPlayer
22565,UCBPlayer,122,227,349,20,57,UCBPlayer
22566,UCBPlayer,109,259,368,15,49,UCBPlayer
22567,UCBPlayer,118,218,336,16,60,UCBPlayer
22568,UCBPlayer,117,267,384,19,45,UCBPlayer
22569,UCBPlayer,110,210,320,12,64,UCBPlayer
22570,UCBPlayer,126,271,397,23,42,UCBPlayer
22571,UCBPlayer,105,210,315,10,65,UCBPlayer
22572,UCBPlayer,130,275,405,25,40,UCBPlayer
22573,UCBPlayer,105,210,315,10,65,UCBPlayer
22574,UCBPlayer,130,275,405,25,40,UCBPlayer
22575,UCBPlayer,106,206,312,10,66,UCBPlayer
22576,UCBPlayer,130,275,405,25,40,UCBPlayer
22577,UCBPlayer,105,210,315,10,65,UCBPlayer
22578,UCBPlayer,131,271,402,25,41,UCBPlayer
22579,UCBPlayer,105,210,315,10,65,UCBPlayer
22580,UCBPlayer,130,275,405,25,40,UCBPlayer
22581,UCBPlayer,105,210,315,10,65,UCBPlayer
22582,UCBPlayer,130,275,405,25,40,UCBPlayer
22583,UCBPlayer,103,203,306,10,68,UCBPlayer
22584,UCBPlayer,128,283,411,25,38,UCBPlayer
22585,UCBPlayer,111,186,297,10,71,UCBPlayer
22586,UCBPlayer,124,299,423,25,34,UCBPlayer
22587,UCBPlayer,115,170,285,10,75,UCBPlayer
22588,UCBPlayer,120,315,435,25,30,UCBPlayer
22589,UCBPlayer,119,154,273,10,79,UCBPlayer
22590,UCBPlayer,112,332,444,25,27,UCBPlayer
22591,UCBPlayer,127,137,264,10,82,UCBPlayer
22592,UCBPlayer,104,349,453,25,24,UCBPlayer
22593,UCBPlayer,126,126,252,7,85,Tie
22594,UCBPlayer,111,351,462,28,22,UCBPlayer
22595,UCBPlayer,116,126,242,3,87,UCBPlayer
22596,UCBPlayer,122,347,469,32,21,UCBPlayer
22597,UCBPlayer,107,132,239,0,87,UCBPlayer
22598,UCBPlayer,132,337,469,35,22,UCBPlayer
22599,UCBPlayer,103,148,251,0,83,UCBPlayer
22600,UCBPlayer,136,321,457,35,26,UCBPlayer
22601,UCBPlayer,99,164,263,0,79,UCBPlayer
22602,UCBPlayer,140,305,445,35,30,UCBPlayer
22603,UCBPlayer,95,180,275,0,75,UCBPlayer
22604,UCBPlayer,144,289,433,35,34,UCBPlayer
22605,UCBPlayer,91,196,287,0,71,UCBPlayer
22606,UCBPlayer,148,273,421,35,38,UCBPlayer
22607,UCBPlayer,87,212,299,0,67,UCBPlayer
22608,UCBPlayer,152,257,409,35,42,UCBPlayer
22609,UCBPlayer,84,224,308,0,64,UCBPlayer
22610,UCBPlayer,146,251,397,32,45,UCBPlayer
22611,UCBPlayer,89,234,323,3,60,UCBPlayer
22612,UCBPlayer,138,243,381,28,49,UCBPlayer
22613,UCBPlayer,97,242,339,7,56,UCBPlayer
22614,UCBPlayer,130,235,365,24,53,UCBPlayer
22615,UCBPlayer,105,250,355,11,52,UCBPlayer
22616,UCBPlayer,122,227,349,20,57,UCBPlayer
22617,UCBPlayer,109,259,368,15,49,UCBPlayer
22618,UCBPlayer,118,218,336,16,60,UCBPlayer
22619,UCBPlayer,117,267,384,19,45,UCBPlayer
22620,UCBPlayer,110,210,320,12,64,UCBPlayer
22621,UCBPlayer,126,271,397,23,42,UCBPlayer
22622,UCBPlayer,105,210,315,10,65,UCBPlayer
22623,UCBPlayer,130,275,405,25,40,UCBPlayer
22624,UCBPlayer,105,210,315,10,65,UCBPlayer
22625,UCBPlayer,130,275,405,25,40,UCBPlayer
22626,UCBPlayer,106,206,312,10,66,UCBPlayer
22627,UCBPlayer,130,275,405,25,40,UCBPlayer
22628,UCBPlayer,105,210,315,10,65,UCBPlayer
22629,UCBPlayer,131,271,402,25,41,UCBPlayer
22630,UCBPlayer,105,210,315,10,65,UCBPlayer
22631,UCBPlayer,130,275,405,25,40,UCBPlayer
22632,UCBPlayer,105,210,315,10,65,UCBPlayer
22633,UCBPlayer,130,275,405,25,40,UCBPlayer
22634,UCBPlayer,103,203,306,10,68,UCBPlayer
22635,UCBPlayer,128,283,411,25,38,UCBPlayer
22636,UCBPlayer,111,186,297,10,71,UCBPlayer
22637,UCBPlayer,124,299,423,25,34,UCBPlayer
22638,UCBPlayer,115,170,285,10,75,UCBPlayer
22639,UCBPlayer,120,315,435,25,30,UCBPlayer
22640,UCBPlayer,119,154,273,10,79,UCBPlayer
22641,UCBPlayer,112,332,444,25,27,UCBPlayer
22642,UCBPlayer,127,137,264,10,82,UCBPlayer
22643,UCBPlayer,104,349,453,25,24,UCBPlayer
22644,UCBPlayer,126,126,252,7,85,Tie
22645,UCBPlayer,111,351,462,28,22,UCBPlayer
22646,UCBPlayer,116,126,242,3,87,UCBPlayer
22647,UCBPlayer,122,347,469,32,21,UCBPlayer
22648,UCBPlayer,107,132,239,0,87,UCBPlayer
22649,UCBPlayer,132,337,469,35,22,UCBPlayer
22650,UCBPlayer,103,148,251,0,83,UCBPlayer
22651,UCBPlayer,136,321,457,35,26,UCBPlayer
22652,UCBPlayer,99,164,263,0,79,UCBPlayer
22653,UCBPlayer,140,305,445,35,30,UCBPlayer
22654,UCBPlayer,95,180,275,0,75,UCBPlayer
22655,UCBPlayer,144,289,433,35,34,UCBPlayer
22656,UCBPlayer,91,196,287,0,71,UCBPlayer
22657,UCBPlayer,148,273,421,35,38,UCBPlayer
22658,UCBPlayer,87,212,299,0,67,UCBPlayer
22659,UCBPlayer,152,257,409,35,42,UCBPlayer
22660,UCBPlayer,84,224,308,0,64,UCBPlayer
22661,UCBPlayer,146,251,397,32,45,UCBPlayer
22662,UCBPlayer,89,234,323,3,60,UCBPlayer
22663,UCBPlayer,138,243,381,28,49,UCBPlayer
22664,UCBPlayer,97,242,339,7,56,UCBPlayer
22665,UCBPlayer,130,235,365,24,53,UCBPlayer
22666,UCBPlayer,105,250,355,11,52,UCBPlayer
22667,UCBPlayer,122,227,349,20,57,UCBPlayer
22668,UCBPlayer,109,259,368,15,49,UCBPlayer
22669,UCBPlayer,118,218,336,16,60,UCBPlayer
22670,UCBPlayer,117,267,384,19,45,UCBPlayer
22671,UCBPlayer,110,210,320,12,64,UCBPlayer
22672,UCBPlayer,126,271,397,23,42,UCBPlayer
22673,UCBPlayer,105,210,315,10,65,UCBPlayer
22674,UCBPlayer,130,275,405,25,40,UCBPlayer
22675,UCBPlayer,105,210,315,10,65,UCBPlayer
22676,UCBPlayer,130,275,405,25,40,UCBPlayer
22677,UCBPlayer,106,206,312,10,66,UCBPlayer
22678,UCBPlayer,130,275,405,25,40,UCBPlayer
22679,UCBPlayer,105,210,315,10,65,UCBPlayer
22680,UCBPlayer,131,271,402,25,41,UCBPlayer
22681,UCBPlayer,105,210,315,10,65,UCBPlayer
22682,UCBPlayer,130,275,405,25,40,UCBPlayer
22683,UCBPlayer,105,210,315,10,65,UCBPlayer
22684,UCBPlayer,130,275,405,25,40,UCBPlayer
22685,UCBPlayer,103,203,306,10,68,UCBPlayer
22686,UCBPlayer,128,283,411,25,38,UCBPlayer
22687,UCBPlayer,111,186,297,10,71,UCBPlayer
22688,UCBPlayer,124,299,423,25,34,UCBPlayer
22689,UCBPlayer,115,170,285,10,75,UCBPlayer
22690,UCBPlayer,120,315,435,25,30,UCBPlayer
22691,UCBPlayer,119,154,273,10,79,UCBPlayer
22692,UCBPlayer,112,332,444,25,27,UCBPlayer
22693,UCBPlayer,127,137,264,10,82,UCBPlayer
22694,UCBPlayer,104,349,453,25,24,UCBPlayer
22695,UCBPlayer,126,126,252,7,85,Tie
22696,UCBPlayer,111,351,462,28,22,UCBPlayer
22697,UCBPlayer,116,126,242,3,87,UCBPlayer
22698,UCBPlayer,122,347,469,32,21,UCBPlayer
22699,UCBPlayer,107,132,239,0,87,UCBPlayer
22700,UCBPlayer,132,337,469,35,22,UCBPlayer
22701,UCBPlayer,103,148,251,0,83,UCBPlayer
22702,UCBPlayer,136,321,457,35,26,UCBPlayer
22703,UCBPlayer,99,164,263,0,79,UCBPlayer
22704,UCBPlayer,140,305,445,35,30,UCBPlayer
22705,UCBPlayer,95,180,275,0,75,UCBPlayer
22706,UCBPlayer,144,289,433,35,34,UCBPlayer
22707,UCBPlayer,91,196,287,0,71,UCBPlayer
22708,UCBPlayer,148,273,421,35,38,UCBPlayer
22709,UCBPlayer,87,212,299,0,67,UCBPlayer
22710,UCBPlayer,152,257,409,35,42,UCBPlayer
22711,UCBPlayer,84,224,308,0,64,UCBPlayer
22712,UCBPlayer,146,251,397,32,45,UCBPlayer
22713,UCBPlayer,89,234,323,3,60,UCBPlayer
22714,UCBPlayer,138,243,381,28,49,UCBPlayer
22715,UCBPlayer,97,242,339,7,56,UCBPlayer
22716,UCBPlayer,130,235,365,24,53,UCBPlayer
22717,UCBPlayer,105,250,355,11,52,UCBPlayer
22718,UCBPlayer,122,227,349,20,57,UCBPlayer
22719,UCBPlayer,109,259,368,15,49,UCBPlayer
22720,UCBPlayer,118,218,336,16,60,UCBPlayer
22721,UCBPlayer,117,267,384,19,45,UCBPlayer
22722,UCBPlayer,110,210,320,12,64,UCBPlayer
22723,UCBPlayer,126,271,397,23,42,UCBPlayer
22724,UCBPlayer,105,210,315,10,65,UCBPlayer
22725,UCBPlayer,130,275,405,25,40,UCBPlayer
22726,UCBPlayer,105,210,315,10,65,UCBPlayer
22727,UCBPlayer,130,275,405,25,40,UCBPlayer
22728,UCBPlayer,106,206,312,10,66,UCBPlayer
22729,UCBPlayer,130,275,405,25,40,UCBPlayer
22730,UCBPlayer,105,210,315,10,65,UCBPlayer
22731,UCBPlayer,131,271,402,25,41,UCBPlayer
22732,UCBPlayer,105,210,315,10,65,UCBPlayer
22733,UCBPlayer,130,275,405,25,40,UCBPlayer
22734,UCBPlayer,105,210,315,10,65,UCBPlayer
22735,UCBPlayer,130,275,405,25,40,UCBPlayer
22736,UCBPlayer,103,203,306,10,68,UCBPlayer
22737,UCBPlayer,128,283,411,25,38,UCBPlayer
22738,UCBPlayer,111,186,297,10,71,UCBPlayer
22739,UCBPlayer,124,299,423,25,34,UCBPlayer
22740,UCBPlayer,115,170,285,10,75,UCBPlayer
22741,UCBPlayer,120,315,435,25,30,UCBPlayer
22742,UCBPlayer,119,154,273,10,79,UCBPlayer
22743,UCBPlayer,112,332,444,25,27,UCBPlayer
22744,UCBPlayer,127,137,264,10,82,UCBPlayer
22745,UCBPlayer,104,349,453,25,24,UCBPlayer
22746,UCBPlayer,126,126,252,7,85,Tie
22747,UCBPlayer,111,351,462,28,22,UCBPlayer
22748,UCBPlayer,116,126,242,3,87,UCBPlayer
22749,UCBPlayer,122,347,469,32,21,UCBPlayer
22750,UCBPlayer,107,132,239,0,87,UCBPlayer
22751,UCBPlayer,132,337,469,35,22,UCBPlayer
22752,UCBPlayer,103,148,251,0,83,UCBPlayer
22753,UCBPlayer,136,321,457,35,26,UCBPlayer
22754,UCBPlayer,99,164,263,0,79,UCBPlayer
22755,UCBPlayer,140,305,445,35,30,UCBPlayer
22756,UCBPlayer,95,180,275,0,75,UCBPlayer
22757,UCBPlayer,144,289,433,35,34,UCBPlayer
22758,UCBPlayer,91,196,287,0,71,UCBPlayer
22759,UCBPlayer,148,273,421,35,38,UCBPlayer
22760,UCBPlayer,87,212,299,0,67,UCBPlayer
22761,UCBPlayer,152,257,409,35,42,UCBPlayer
22762,UCBPlayer,84,224,308,0,64,UCBPlayer
22763,UCBPlayer,146,251,397,32,45,UCBPlayer
22764,UCBPlayer,89,234,323,3,60,UCBPlayer
22765,UCBPlayer,138,243,381,28,49,UCBPlayer
22766,UCBPlayer,97,242,339,7,56,UCBPlayer
22767,UCBPlayer,130,235,365,24,53,UCBPlayer
22768,UCBPlayer,105,250,355,11,52,UCBPlayer
22769,UCBPlayer,122,227,349,20,57,UCBPlayer
22770,UCBPlayer,109,259,368,15,49,UCBPlayer
22771,UCBPlayer,118,218,336,16,60,UCBPlayer
22772,UCBPlayer,117,267,384,19,45,UCBPlayer
22773,UCBPlayer,110,210,320,12,64,UCBPlayer
22774,UCBPlayer,126,271,397,23,42,UCBPlayer
22775,UCBPlayer,105,210,315,10,65,UCBPlayer
22776,UCBPlayer,130,275,405,25,40,UCBPlayer
22777,UCBPlayer,105,210,315,10,65,UCBPlayer
22778,UCBPlayer,130,275,405,25,40,UCBPlayer
22779,UCBPlayer,106,206,312,10,66,UCBPlayer
22780,UCBPlayer,130,275,405,25,40,UCBPlayer
22781,UCBPlayer,105,210,315,10,65,UCBPlayer
22782,UCBPlayer,131,271,402,25,41,UCBPlayer
22783,UCBPlayer,105,210,315,10,65,UCBPlayer
22784,UCBPlayer,130,275,405,25,40,UCBPlayer
22785,UCBPlayer,105,210,315,10,65,UCBPlayer
22786,UCBPlayer,130,275,405,25,40,UCBPlayer
22787,UCBPlayer,103,203,306,10,68,UCBPlayer
22788,UCBPlayer,128,283,411,25,38,UCBPlayer
22789,UCBPlayer,111,186,297,10,71,UCBPlayer
22790,UCBPlayer,124,299,423,25,34,UCBPlayer
22791,UCBPlayer,115,170,285,10,75,UCBPlayer
22792,UCBPlayer,120,315,435,25,30,UCBPlayer
22793,UCBPlayer,119,154,273,10,79,UCBPlayer
22794,UCBPlayer,112,332,444,25,27,UCBPlayer
22795,UCBPlayer,127,137,264,10,82,UCBPlayer
22796,UCBPlayer,104,349,453,25,24,UCBPlayer
22797,UCBPlayer,126,126,252,7,85,Tie
22798,UCBPlayer,111,351,462,28,22,UCBPlayer
22799,UCBPlayer,116,126,242,3,87,UCBPlayer
22800,UCBPlayer,122,347,469,32,21,UCBPlayer
22801,UCBPlayer,107,132,239,0,87,UCBPlayer
22802,UCBPlayer,132,337,469,35,22,UCBPlayer
22803,UCBPlayer,103,148,251,0,83,UCBPlayer
22804,UCBPlayer,136,321,457,35,26,UCBPlayer
22805,UCBPlayer,99,164,263,0,79,UCBPlayer
22806,UCBPlayer,140,305,445,35,30,UCBPlayer
22807,UCBPlayer,95,180,275,0,75,UCBPlayer
22808,UCBPlayer,144,289,433,35,34,UCBPlayer
22809,UCBPlayer,91,196,287,0,71,UCBPlayer
22810,UCBPlayer,148,273,421,35,38,UCBPlayer
22811,UCBPlayer,87,212,299,0,67,UCBPlayer
22812,UCBPlayer,152,257,409,35,42,UCBPlayer
22813,UCBPlayer,84,224,308,0,64,UCBPlayer
22814,UCBPlayer,146,251,397,32,45,UCBPlayer
22815,UCBPlayer,89,234,323,3,60,UCBPlayer
22816,UCBPlayer,138,243,381,28,49,UCBPlayer
22817,UCBPlayer,97,242,339,7,56,UCBPlayer
22818,UCBPlayer,130,235,365,24,53,UCBPlayer
22819,UCBPlayer,105,250,355,11,52,UCBPlayer
22820,UCBPlayer,122,227,349,20,57,UCBPlayer
22821,UCBPlayer,109,259,368,15,49,UCBPlayer
22822,UCBPlayer,118,218,336,16,60,UCBPlayer
22823,UCBPlayer,117,267,384,19,45,UCBPlayer
22824,UCBPlayer,110,210,320,12,64,UCBPlayer
22825,UCBPlayer,126,271,397,23,42,UCBPlayer
22826,UCBPlayer,105,210,315,10,65,UCBPlayer
22827,UCBPlayer,130,275,405,25,40,UCBPlayer
22828,UCBPlayer,105,210,315,10,65,UCBPlayer
22829,UCBPlayer,130,275,405,25,40,UCBPlayer
22830,UCBPlayer,106,206,312,10,66,UCBPlayer
22831,UCBPlayer,130,275,405,25,40,UCBPlayer
22832,UCBPlayer,105,210,315,10,65,UCBPlayer
22833,UCBPlayer,131,271,402,25,41,UCBPlayer
22834,UCBPlayer,105,210,315,10,65,UCBPlayer
22835,UCBPlayer,130,275,405,25,40,UCBPlayer
22836,UCBPlayer,105,210,315,10,65,UCBPlayer
22837,UCBPlayer,130,275,405,25,40,UCBPlayer
22838,UCBPlayer,103,203,306,10,68,UCBPlayer
22839,UCBPlayer,128,283,411,25,38,UCBPlayer
22840,UCBPlayer,111,186,297,10,71,UCBPlayer
22841,UCBPlayer,124,299,423,25,34,UCBPlayer
22842,UCBPlayer,115,170,285,10,75,UCBPlayer
22843,UCBPlayer,120,315,435,25,30,UCBPlayer
22844,UCBPlayer,119,154,273,10,79,UCBPlayer
22845,UCBPlayer,112,332,444,25,27,UCBPlayer
22846,UCBPlayer,127,137,264,10,82,UCBPlayer
22847,UCBPlayer,104,349,453,25,24,UCBPlayer
22848,UCBPlayer,126,126,252,7,85,Tie
22849,UCBPlayer,111,351,462,28,22,UCBPlayer
22850,UCBPlayer,116,126,242,3,87,UCBPlayer
22851,UCBPlayer,122,347,469,32,21,UCBPlayer
22852,UCBPlayer,107,132,239,0,87,UCBPlayer
22853,UCBPlayer,132,337,469,35,22,UCBPlayer
22854,UCBPlayer,103,148,251,0,83,UCBPlayer
22855,UCBPlayer,136,321,457,35,26,UCBPlayer
22856,UCBPlayer,99,164,263,0,79,UCBPlayer
22857,UCBPlayer,140,305,445,35,30,UCBPlayer
22858,UCBPlayer,95,180,275,0,75,UCBPlayer
22859,UCBPlayer,144,289,433,35,34,UCBPlayer
22860,UCBPlayer,91,196,287,0,71,UCBPlayer
22861,UCBPlayer,148,273,421,35,38,UCBPlayer
22862,UCBPlayer,87,212,299,0,67,UCBPlayer
22863,UCBPlayer,152,257,409,35,42,UCBPlayer
22864,UCBPlayer,84,224,308,0,64,UCBPlayer
22865,UCBPlayer,146,251,397,32,45,UCBPlayer
22866,UCBPlayer,89,234,323,3,60,UCBPlayer
22867,UCBPlayer,138,243,381,28,49,UCBPlayer
22868,UCBPlayer,97,242,339,7,56,UCBPlayer
22869,UCBPlayer,130,235,365,24,53,UCBPlayer
22870,UCBPlayer,105,250,355,11,52,UCBPlayer
22871,UCBPlayer,122,227,349,20,57,UCBPlayer
22872,UCBPlayer,109,259,368,15,49,UCBPlayer
22873,UCBPlayer,118,218,336,16,60,UCBPlayer
22874,UCBPlayer,117,267,384,19,45,UCBPlayer
22875,UCBPlayer,110,210,320,12,64,UCBPlayer
22876,UCBPlayer,126,271,397,23,42,UCBPlayer
22877,UCBPlayer,105,210,315,10,65,UCBPlayer
22878,UCBPlayer,130,275,405,25,40,UCBPlayer
22879,UCBPlayer,105,210,315,10,65,UCBPlayer
22880,UCBPlayer,130,275,405,25,40,UCBPlayer
22881,UCBPlayer,106,206,312,10,66,UCBPlayer
22882,UCBPlayer,130,275,405,25,40,UCBPlayer
22883,UCBPlayer,105,210,315,10,65,UCBPlayer
22884,UCBPlayer,131,271,402,25,41,UCBPlayer
22885,UCBPlayer,105,210,315,10,65,UCBPlayer
22886,UCBPlayer,130,275,405,25,40,UCBPlayer
22887,UCBPlayer,105,210,315,10,65,UCBPlayer
22888,UCBPlayer,130,275,405,25,40,UCBPlayer
22889,UCBPlayer,103,203,306,10,68,UCBPlayer
22890,UCBPlayer,128,283,411,25,38,UCBPlayer
22891,UCBPlayer,111,186,297,10,71,UCBPlayer
22892,UCBPlayer,124,299,423,25,34,UCBPlayer
22893,UCBPlayer,115,170,285,10,75,UCBPlayer
22894,UCBPlayer,120,315,435,25,30,UCBPlayer
22895,UCBPlayer,119,154,273,10,79,UCBPlayer
22896,UCBPlayer,112,332,444,25,27,UCBPlayer
22897,UCBPlayer,127,137,264,10,82,UCBPlayer
22898,UCBPlayer,104,349,453,25,24,UCBPlayer
22899,UCBPlayer,126,126,252,7,85,Tie
22900,UCBPlayer,111,351,462,28,22,UCBPlayer
22901,UCBPlayer,116,126,242,3,87,UCBPlayer
22902,UCBPlayer,122,347,469,32,21,UCBPlayer
22903,UCBPlayer,107,132,239,0,87,UCBPlayer
22904,UCBPlayer,132,337,469,35,22,UCBPlayer
22905,UCBPlayer,103,148,251,0,83,UCBPlayer
22906,UCBPlayer,136,321,457,35,26,UCBPlayer
22907,UCBPlayer,99,164,263,0,79,UCBPlayer
22908,UCBPlayer,140,305,445,35,30,UCBPlayer
22909,UCBPlayer,95,180,275,0,75,UCBPlayer
22910,UCBPlayer,144,289,433,35,34,UCBPlayer
22911,UCBPlayer,91,196,287,0,71,UCBPlayer
22912,UCBPlayer,148,273,421,35,38,UCBPlayer
22913,UCBPlayer,87,212,299,0,67,UCBPlayer
22914,UCBPlayer,152,257,409,35,42,UCBPlayer
22915,UCBPlayer,84,224,308,0,64,UCBPlayer
22916,UCBPlayer,146,251,397,32,45,UCBPlayer
22917,UCBPlayer,89,234,323,3,60,UCBPlayer
22918,UCBPlayer,138,243,381,28,49,UCBPlayer
22919,UCBPlayer,97,242,339,7,56,UCBPlayer
22920,UCBPlayer,130,235,365,24,53,UCBPlayer
22921,UCBPlayer,105,250,355,11,52,UCBPlayer
22922,UCBPlayer,122,227,349,20,57,UCBPlayer
22923,UCBPlayer,109,259,368,15,49,UCBPlayer
22924,UCBPlayer,118,218,336,16,60,UCBPlayer
22925,UCBPlayer,117,267,384,19,45,UCBPlayer
22926,UCBPlayer,110,210,320,12,64,UCBPlayer
22927,UCBPlayer,126,271,397,23,42,UCBPlayer
22928,UCBPlayer,105,210,315,10,65,UCBPlayer
22929,UCBPlayer,130,275,405,25,40,UCBPlayer
22930,UCBPlayer,105,210,315,10,65,UCBPlayer
22931,UCBPlayer,130,275,405,25,40,UCBPlayer
22932,UCBPlayer,106,206,312,10,66,UCBPlayer
22933,UCBPlayer,130,275,405,25,40,UCBPlayer
22934,UCBPlayer,105,210,315,10,65,UCBPlayer
22935,UCBPlayer,131,271,402,25,41,UCBPlayer
22936,UCBPlayer,105,210,315,10,65,UCBPlayer
22937,UCBPlayer,130,275,405,25,40,UCBPlayer
22938,UCBPlayer,105,210,315,10,65,UCBPlayer
22939,UCBPlayer,130,275,405,25,40,UCBPlayer
22940,UCBPlayer,103,203,306,10,68,UCBPlayer
22941,UCBPlayer,128,283,411,25,38,UCBPlayer
22942,UCBPlayer,111,186,297,10,71,UCBPlayer
22943,UCBPlayer,124,299,423,25,34,UCBPlayer
22944,UCBPlayer,115,170,285,10,75,UCBPlayer
22945,UCBPlayer,120,315,435,25,30,UCBPlayer
22946,UCBPlayer,119,154,273,10,79,UCBPlayer
22947,UCBPlayer,112,332,444,25,27,UCBPlayer
22948,UCBPlayer,127,137,264,10,82,UCBPlayer
22949,UCBPlayer,104,349,453,25,24,UCBPlayer
22950,UCBPlayer,126,126,252,7,85,Tie
22951,UCBPlayer,111,351,462,28,22,UCBPlayer
22952,UCBPlayer,116,126,242,3,87,UCBPlayer
22953,UCBPlayer,122,347,469,32,21,UCBPlayer
22954,UCBPlayer,107,132,239,0,87,UCBPlayer
22955,UCBPlayer,132,337,469,35,22,UCBPlayer
22956,UCBPlayer,103,148,251,0,83,UCBPlayer
22957,UCBPlayer,136,321,457,35,26,UCBPlayer
22958,UCBPlayer,99,164,263,0,79,UCBPlayer
22959,UCBPlayer,140,305,445,35,30,UCBPlayer
22960,UCBPlayer,95,180,275,0,75,UCBPlayer
22961,UCBPlayer,144,289,433,35,34,UCBPlayer
22962,UCBPlayer,91,196,287,0,71,UCBPlayer
22963,UCBPlayer,148,273,421,35,38,UCBPlayer
22964,UCBPlayer,87,212,299,0,67,UCBPlayer
22965,UCBPlayer,152,257,409,35,42,UCBPlayer
22966,UCBPlayer,84,224,308,0,64,UCBPlayer
22967,UCBPlayer,146,251,397,32,45,UCBPlayer
22968,UCBPlayer,89,234,323,3,60,UCBPlayer
22969,UCBPlayer,138,243,381,28,49,UCBPlayer
22970,UCBPlayer,97,242,339,7,56,UCBPlayer
22971,UCBPlayer,130,235,365,24,53,UCBPlayer
22972,UCBPlayer,105,250,355,11,52,UCBPlayer
22973,UCBPlayer,122,227,349,20,57,UCBPlayer
22974,UCBPlayer,109,259,368,15,49,UCBPlayer
22975,UCBPlayer,118,218,336,16,60,UCBPlayer
22976,UCBPlayer,117,267,384,19,45,UCBPlayer
22977,UCBPlayer,110,210,320,12,64,UCBPlayer
22978,UCBPlayer,126,271,397,23,42,UCBPlayer
22979,UCBPlayer,105,210,315,10,65,UCBPlayer
22980,UCBPlayer,130,275,405,25,40,UCBPlayer
22981,UCBPlayer,105,210,315,10,65,UCBPlayer
22982,UCBPlayer,130,275,405,25,40,UCBPlayer
22983,UCBPlayer,106,206,312,10,66,UCBPlayer
22984,UCBPlayer,130,275,405,25,40,UCBPlayer
22985,UCBPlayer,105,210,315,10,65,UCBPlayer
22986,UCBPlayer,131,271,402,25,41,UCBPlayer
22987,UCBPlayer,105,210,315,10,65,UCBPlayer
22988,UCBPlayer,130,275,405,25,40,UCBPlayer
22989,UCBPlayer,105,210,315,10,65,UCBPlayer
22990,UCBPlayer,130,275,405,25,40,UCBPlayer
22991,UCBPlayer,103,203,306,10,68,UCBPlayer
22992,UCBPlayer,128,283,411,25,38,UCBPlayer
22993,UCBPlayer,111,186,297,10,71,UCBPlayer
22994,UCBPlayer,124,299,423,25,34,UCBPlayer
22995,UCBPlayer,115,170,285,10,75,UCBPlayer
22996,UCBPlayer,120,315,435,25,30,UCBPlayer
22997,UCBPlayer,119,154,273,10,79,UCBPlayer
22998,UCBPlayer,112,332,444,25,27,UCBPlayer
22999,UCBPlayer,127,137,264,10,82,UCBPlayer
23000,UCBPlayer,104,349,453,25,24,UCBPlayer
23001,UCBPlayer,126,126,252,7,85,Tie
23002,UCBPlayer,111,351,462,28,22,UCBPlayer
23003,UCBPlayer,116,126,242,3,87,UCBPlayer
23004,UCBPlayer,122,347,469,32,21,UCBPlayer
23005,UCBPlayer,107,132,239,0,87,UCBPlayer
23006,UCBPlayer,132,337,469,35,22,UCBPlayer
23007,UCBPlayer,103,148,251,0,83,UCBPlayer
23008,UCBPlayer,136,321,457,35,26,UCBPlayer
23009,UCBPlayer,99,164,263,0,79,UCBPlayer
23010,UCBPlayer,140,305,445,35,30,UCBPlayer
23011,UCBPlayer,95,180,275,0,75,UCBPlayer
23012,UCBPlayer,144,289,433,35,34,UCBPlayer
23013,UCBPlayer,91,196,287,0,71,UCBPlayer
23014,UCBPlayer,148,273,421,35,38,UCBPlayer
23015,UCBPlayer,87,212,299,0,67,UCBPlayer
23016,UCBPlayer,152,257,409,35,42,UCBPlayer
23017,UCBPlayer,84,224,308,0,64,UCBPlayer
23018,UCBPlayer,146,251,397,32,45,UCBPlayer
23019,UCBPlayer,89,234,323,3,60,UCBPlayer
23020,UCBPlayer,138,243,381,28,49,UCBPlayer
23021,UCBPlayer,97,242,339,7,56,UCBPlayer
23022,UCBPlayer,130,235,365,24,53,UCBPlayer
23023,UCBPlayer,105,250,355,11,52,UCBPlayer
23024,UCBPlayer,122,227,349,20,57,UCBPlayer
23025,UCBPlayer,109,259,368,15,49,UCBPlayer
23026,UCBPlayer,118,218,336,16,60,UCBPlayer
23027,UCBPlayer,117,267,384,19,45,UCBPlayer
23028,UCBPlayer,110,210,320,12,64,UCBPlayer
23029,UCBPlayer,126,271,397,23,42,UCBPlayer
23030,UCBPlayer,105,210,315,10,65,UCBPlayer
23031,UCBPlayer,130,275,405,25,40,UCBPlayer
23032,UCBPlayer,105,210,315,10,65,UCBPlayer
23033,UCBPlayer,130,275,405,25,40,UCBPlayer
23034,UCBPlayer,106,206,312,10,66,UCBPlayer
23035,UCBPlayer,130,275,405,25,40,UCBPlayer
23036,UCBPlayer,105,210,315,10,65,UCBPlayer
23037,UCBPlayer,131,271,402,25,41,UCBPlayer
23038,UCBPlayer,105,210,315,10,65,UCBPlayer
23039,UCBPlayer,130,275,405,25,40,UCBPlayer
23040,UCBPlayer,105,210,315,10,65,UCBPlayer
23041,UCBPlayer,130,275,405,25,40,UCBPlayer
23042,UCBPlayer,103,203,306,10,68,UCBPlayer
23043,UCBPlayer,128,283,411,25,38,UCBPlayer
23044,UCBPlayer,111,186,297,10,71,UCBPlayer
23045,UCBPlayer,124,299,423,25,34,UCBPlayer
23046,UCBPlayer,115,170,285,10,75,UCBPlayer
23047,UCBPlayer,120,315,435,25,30,UCBPlayer
23048,UCBPlayer,119,154,273,10,79,UCBPlayer
23049,UCBPlayer,112,332,444,25,27,UCBPlayer
23050,UCBPlayer,127,137,264,10,82,UCBPlayer
23051,UCBPlayer,104,349,453,25,24,UCBPlayer
23052,UCBPlayer,126,126,252,7,85,Tie
23053,UCBPlayer,111,351,462,28,22,UCBPlayer
23054,UCBPlayer,116,126,242,3,87,UCBPlayer
23055,UCBPlayer,122,347,469,32,21,UCBPlayer
23056,UCBPlayer,107,132,239,0,87,UCBPlayer
23057,UCBPlayer,132,337,469,35,22,UCBPlayer
23058,UCBPlayer,103,148,251,0,83,UCBPlayer
23059,UCBPlayer,136,321,457,35,26,UCBPlayer
23060,UCBPlayer,99,164,263,0,79,UCBPlayer
23061,UCBPlayer,140,305,445,35,30,UCBPlayer
23062,UCBPlayer,95,180,275,0,75,UCBPlayer
23063,UCBPlayer,144,289,433,35,34,UCBPlayer
23064,UCBPlayer,91,196,287,0,71,UCBPlayer
23065,UCBPlayer,148,273,421,35,38,UCBPlayer
23066,UCBPlayer,87,212,299,0,67,UCBPlayer
23067,UCBPlayer,152,257,409,35,42,UCBPlayer
23068,UCBPlayer,84,224,308,0,64,UCBPlayer
23069,UCBPlayer,146,251,397,32,45,UCBPlayer
23070,UCBPlayer,89,234,323,3,60,UCBPlayer
23071,UCBPlayer,138,243,381,28,49,UCBPlayer
23072,UCBPlayer,97,242,339,7,56,UCBPlayer
23073,UCBPlayer,130,235,365,24,53,UCBPlayer
23074,UCBPlayer,105,250,355,11,52,UCBPlayer
23075,UCBPlayer,122,227,349,20,57,UCBPlayer
23076,UCBPlayer,109,259,368,15,49,UCBPlayer
23077,UCBPlayer,118,218,336,16,60,UCBPlayer
23078,UCBPlayer,117,267,384,19,45,UCBPlayer
23079,UCBPlayer,110,210,320,12,64,UCBPlayer
23080,UCBPlayer,126,271,397,23,42,UCBPlayer
23081,UCBPlayer,105,210,315,10,65,UCBPlayer
23082,UCBPlayer,130,275,405,25,40,UCBPlayer
23083,UCBPlayer,105,210,315,10,65,UCBPlayer
23084,UCBPlayer,130,275,405,25,40,UCBPlayer
23085,UCBPlayer,106,206,312,10,66,UCBPlayer
23086,UCBPlayer,130,275,405,25,40,UCBPlayer
23087,UCBPlayer,105,210,315,10,65,UCBPlayer
23088,UCBPlayer,131,271,402,25,41,UCBPlayer
23089,UCBPlayer,105,210,315,10,65,UCBPlayer
23090,UCBPlayer,130,275,405,25,40,UCBPlayer
23091,UCBPlayer,105,210,315,10,65,UCBPlayer
23092,UCBPlayer,130,275,405,25,40,UCBPlayer
23093,UCBPlayer,103,203,306,10,68,UCBPlayer
23094,UCBPlayer,128,283,411,25,38,UCBPlayer
23095,UCBPlayer,111,186,297,10,71,UCBPlayer
23096,UCBPlayer,124,299,423,25,34,UCBPlayer
23097,UCBPlayer,115,170,285,10,75,UCBPlayer
23098,UCBPlayer,120,315,435,25,30,UCBPlayer
23099,UCBPlayer,119,154,273,10,79,UCBPlayer
23100,UCBPlayer,112,332,444,25,27,UCBPlayer
23101,UCBPlayer,127,137,264,10,82,UCBPlayer
23102,UCBPlayer,104,349,453,25,24,UCBPlayer
23103,UCBPlayer,126,126,252,7,85,Tie
23104,UCBPlayer,111,351,462,28,22,UCBPlayer
23105,UCBPlayer,116,126,242,3,87,UCBPlayer
23106,UCBPlayer,122,347,469,32,21,UCBPlayer
23107,UCBPlayer,107,132,239,0,87,UCBPlayer
23108,UCBPlayer,132,337,469,35,22,UCBPlayer
23109,UCBPlayer,103,148,251,0,83,UCBPlayer
23110,UCBPlayer,136,321,457,35,26,UCBPlayer
23111,UCBPlayer,99,164,263,0,79,UCBPlayer
23112,UCBPlayer,140,305,445,35,30,UCBPlayer
23113,UCBPlayer,95,180,275,0,75,UCBPlayer
23114,UCBPlayer,144,289,433,35,34,UCBPlayer
23115,UCBPlayer,91,196,287,0,71,UCBPlayer
23116,UCBPlayer,148,273,421,35,38,UCBPlayer
23117,UCBPlayer,87,212,299,0,67,UCBPlayer
23118,UCBPlayer,152,257,409,35,42,UCBPlayer
23119,UCBPlayer,84,224,308,0,64,UCBPlayer
23120,UCBPlayer,146,251,397,32,45,UCBPlayer
23121,UCBPlayer,89,234,323,3,60,UCBPlayer
23122,UCBPlayer,138,243,381,28,49,UCBPlayer
23123,UCBPlayer,97,242,339,7,56,UCBPlayer
23124,UCBPlayer,130,235,365,24,53,UCBPlayer
23125,UCBPlayer,105,250,355,11,52,UCBPlayer
23126,UCBPlayer,122,227,349,20,57,UCBPlayer
23127,UCBPlayer,109,259,368,15,49,UCBPlayer
23128,UCBPlayer,118,218,336,16,60,UCBPlayer
23129,UCBPlayer,117,267,384,19,45,UCBPlayer
23130,UCBPlayer,110,210,320,12,64,UCBPlayer
23131,UCBPlayer,126,271,397,23,42,UCBPlayer
23132,UCBPlayer,105,210,315,10,65,UCBPlayer
23133,UCBPlayer,130,275,405,25,40,UCBPlayer
23134,UCBPlayer,105,210,315,10,65,UCBPlayer
23135,UCBPlayer,130,275,405,25,40,UCBPlayer
23136,UCBPlayer,106,206,312,10,66,UCBPlayer
23137,UCBPlayer,130,275,405,25,40,UCBPlayer
23138,UCBPlayer,105,210,315,10,65,UCBPlayer
23139,UCBPlayer,131,271,402,25,41,UCBPlayer
23140,UCBPlayer,105,210,315,10,65,UCBPlayer
23141,UCBPlayer,130,275,405,25,40,UCBPlayer
23142,UCBPlayer,105,210,315,10,65,UCBPlayer
23143,UCBPlayer,130,275,405,25,40,UCBPlayer
23144,UCBPlayer,103,203,306,10,68,UCBPlayer
23145,UCBPlayer,128,283,411,25,38,UCBPlayer
23146,UCBPlayer,111,186,297,10,71,UCBPlayer
23147,UCBPlayer,124,299,423,25,34,UCBPlayer
23148,UCBPlayer,115,170,285,10,75,UCBPlayer
23149,UCBPlayer,120,315,435,25,30,UCBPlayer
23150,UCBPlayer,119,154,273,10,79,UCBPlayer
23151,UCBPlayer,112,332,444,25,27,UCBPlayer
23152,UCBPlayer,127,137,264,10,82,UCBPlayer
23153,UCBPlayer,104,349,453,25,24,UCBPlayer
23154,UCBPlayer,126,126,252,7,85,Tie
23155,UCBPlayer,111,351,462,28,22,UCBPlayer
23156,UCBPlayer,116,126,242,3,87,UCBPlayer
23157,UCBPlayer,122,347,469,32,21,UCBPlayer
23158,UCBPlayer,107,132,239,0,87,UCBPlayer
23159,UCBPlayer,132,337,469,35,22,UCBPlayer
23160,UCBPlayer,103,148,251,0,83,UCBPlayer
23161,UCBPlayer,136,321,457,35,26,UCBPlayer
23162,UCBPlayer,99,164,263,0,79,UCBPlayer
23163,UCBPlayer,140,305,445,35,30,UCBPlayer
23164,UCBPlayer,95,180,275,0,75,UCBPlayer
23165,UCBPlayer,144,289,433,35,34,UCBPlayer
23166,UCBPlayer,91,196,287,0,71,UCBPlayer
23167,UCBPlayer,148,273,421,35,38,UCBPlayer
23168,UCBPlayer,87,212,299,0,67,UCBPlayer
23169,UCBPlayer,152,257,409,35,42,UCBPlayer
23170,UCBPlayer,84,224,308,0,64,UCBPlayer
23171,UCBPlayer,146,251,397,32,45,UCBPlayer
23172,UCBPlayer,89,234,323,3,60,UCBPlayer
23173,UCBPlayer,138,243,381,28,49,UCBPlayer
23174,UCBPlayer,97,242,339,7,56,UCBPlayer
23175,UCBPlayer,130,235,365,24,53,UCBPlayer
23176,UCBPlayer,105,250,355,11,52,UCBPlayer
23177,UCBPlayer,122,227,349,20,57,UCBPlayer
23178,UCBPlayer,109,259,368,15,49,UCBPlayer
23179,UCBPlayer,118,218,336,16,60,UCBPlayer
23180,UCBPlayer,117,267,384,19,45,UCBPlayer
23181,UCBPlayer,110,210,320,12,64,UCBPlayer
23182,UCBPlayer,126,271,397,23,42,UCBPlayer
23183,UCBPlayer,105,210,315,10,65,UCBPlayer
23184,UCBPlayer,130,275,405,25,40,UCBPlayer
23185,UCBPlayer,105,210,315,10,65,UCBPlayer
23186,UCBPlayer,130,275,405,25,40,UCBPlayer
23187,UCBPlayer,106,206,312,10,66,UCBPlayer
23188,UCBPlayer,130,275,405,25,40,UCBPlayer
23189,UCBPlayer,105,210,315,10,65,UCBPlayer
23190,UCBPlayer,131,271,402,25,41,UCBPlayer
23191,UCBPlayer,105,210,315,10,65,UCBPlayer
23192,UCBPlayer,130,275,405,25,40,UCBPlayer
23193,UCBPlayer,105,210,315,10,65,UCBPlayer
23194,UCBPlayer,130,275,405,25,40,UCBPlayer
23195,UCBPlayer,103,203,306,10,68,UCBPlayer
23196,UCBPlayer,128,283,411,25,38,UCBPlayer
23197,UCBPlayer,111,186,297,10,71,UCBPlayer
23198,UCBPlayer,124,299,423,25,34,UCBPlayer
23199,UCBPlayer,115,170,285,10,75,UCBPlayer
23200,UCBPlayer,120,315,435,25,30,UCBPlayer
23201,UCBPlayer,119,154,273,10,79,UCBPlayer
23202,UCBPlayer,112,332,444,25,27,UCBPlayer
23203,UCBPlayer,127,137,264,10,82,UCBPlayer
23204,UCBPlayer,104,349,453,25,24,UCBPlayer
23205,UCBPlayer,126,126,252,7,85,Tie
23206,UCBPlayer,111,351,462,28,22,UCBPlayer
23207,UCBPlayer,116,126,242,3,87,UCBPlayer
23208,UCBPlayer,122,347,469,32,21,UCBPlayer
23209,UCBPlayer,107,132,239,0,87,UCBPlayer
23210,UCBPlayer,132,337,469,35,22,UCBPlayer
23211,UCBPlayer,103,148,251,0,83,UCBPlayer
23212,UCBPlayer,136,321,457,35,26,UCBPlayer
23213,UCBPlayer,99,164,263,0,79,UCBPlayer
23214,UCBPlayer,140,305,445,35,30,UCBPlayer
23215,UCBPlayer,95,180,275,0,75,UCBPlayer
23216,UCBPlayer,144,289,433,35,34,UCBPlayer
23217,UCBPlayer,91,196,287,0,71,UCBPlayer
23218,UCBPlayer,148,273,421,35,38,UCBPlayer
23219,UCBPlayer,87,212,299,0,67,UCBPlayer
23220,UCBPlayer,152,257,409,35,42,UCBPlayer
23221,UCBPlayer,84,224,308,0,64,UCBPlayer
23222,UCBPlayer,146,251,397,32,45,UCBPlayer
23223,UCBPlayer,89,234,323,3,60,UCBPlayer
23224,UCBPlayer,138,243,381,28,49,UCBPlayer
23225,UCBPlayer,97,242,339,7,56,UCBPlayer
23226,UCBPlayer,130,235,365,24,53,UCBPlayer
23227,UCBPlayer,105,250,355,11,52,UCBPlayer
23228,UCBPlayer,122,227,349,20,57,UCBPlayer
23229,UCBPlayer,109,259,368,15,49,UCBPlayer
23230,UCBPlayer,118,218,336,16,60,UCBPlayer
23231,UCBPlayer,117,267,384,19,45,UCBPlayer
23232,UCBPlayer,110,210,320,12,64,UCBPlayer
23233,UCBPlayer,126,271,397,23,42,UCBPlayer
23234,UCBPlayer,105,210,315,10,65,UCBPlayer
23235,UCBPlayer,130,275,405,25,40,UCBPlayer
23236,UCBPlayer,105,210,315,10,65,UCBPlayer
23237,UCBPlayer,130,275,405,25,40,UCBPlayer
23238,UCBPlayer,106,206,312,10,66,UCBPlayer
23239,UCBPlayer,130,275,405,25,40,UCBPlayer
23240,UCBPlayer,105,210,315,10,65,UCBPlayer
23241,UCBPlayer,131,271,402,25,41,UCBPlayer
23242,UCBPlayer,105,210,315,10,65,UCBPlayer
23243,UCBPlayer,130,275,405,25,40,UCBPlayer
23244,UCBPlayer,105,210,315,10,65,UCBPlayer
23245,UCBPlayer,130,275,405,25,40,UCBPlayer
23246,UCBPlayer,103,203,306,10,68,UCBPlayer
23247,UCBPlayer,128,283,411,25,38,UCBPlayer
23248,UCBPlayer,111,186,297,10,71,UCBPlayer
23249,UCBPlayer,124,299,423,25,34,UCBPlayer
23250,UCBPlayer,115,170,285,10,75,UCBPlayer
23251,UCBPlayer,120,315,435,25,30,UCBPlayer
23252,UCBPlayer,119,154,273,10,79,UCBPlayer
23253,UCBPlayer,112,332,444,25,27,UCBPlayer
23254,UCBPlayer,127,137,264,10,82,UCBPlayer
23255,UCBPlayer,104,349,453,25,24,UCBPlayer
23256,UCBPlayer,126,126,252,7,85,Tie
23257,UCBPlayer,111,351,462,28,22,UCBPlayer
23258,UCBPlayer,116,126,242,3,87,UCBPlayer
23259,UCBPlayer,122,347,469,32,21,UCBPlayer
23260,UCBPlayer,107,132,239,0,87,UCBPlayer
23261,UCBPlayer,132,337,469,35,22,UCBPlayer
23262,UCBPlayer,103,148,251,0,83,UCBPlayer
23263,UCBPlayer,136,321,457,35,26,UCBPlayer
23264,UCBPlayer,99,164,263,0,79,UCBPlayer
23265,UCBPlayer,140,305,445,35,30,UCBPlayer
23266,UCBPlayer,95,180,275,0,75,UCBPlayer
23267,UCBPlayer,144,289,433,35,34,UCBPlayer
23268,UCBPlayer,91,196,287,0,71,UCBPlayer
23269,UCBPlayer,148,273,421,35,38,UCBPlayer
23270,UCBPlayer,87,212,299,0,67,UCBPlayer
23271,UCBPlayer,152,257,409,35,42,UCBPlayer
23272,UCBPlayer,84,224,308,0,64,UCBPlayer
23273,UCBPlayer,146,251,397,32,45,UCBPlayer
23274,UCBPlayer,89,234,323,3,60,UCBPlayer
23275,UCBPlayer,138,243,381,28,49,UCBPlayer
23276,UCBPlayer,97,242,339,7,56,UCBPlayer
23277,UCBPlayer,130,235,365,24,53,UCBPlayer
23278,UCBPlayer,105,250,355,11,52,UCBPlayer
23279,UCBPlayer,122,227,349,20,57,UCBPlayer
23280,UCBPlayer,109,259,368,15,49,UCBPlayer
23281,UCBPlayer,118,218,336,16,60,UCBPlayer
23282,UCBPlayer,117,267,384,19,45,UCBPlayer
23283,UCBPlayer,110,210,320,12,64,UCBPlayer
23284,UCBPlayer,126,271,397,23,42,UCBPlayer
23285,UCBPlayer,105,210,315,10,65,UCBPlayer
23286,UCBPlayer,130,275,405,25,40,UCBPlayer
23287,UCBPlayer,105,210,315,10,65,UCBPlayer
23288,UCBPlayer,130,275,405,25,40,UCBPlayer
23289,UCBPlayer,106,206,312,10,66,UCBPlayer
23290,UCBPlayer,130,275,405,25,40,UCBPlayer
23291,UCBPlayer,105,210,315,10,65,UCBPlayer
23292,UCBPlayer,131,271,402,25,41,UCBPlayer
23293,UCBPlayer,105,210,315,10,65,UCBPlayer
23294,UCBPlayer,130,275,405,25,40,UCBPlayer
23295,UCBPlayer,105,210,315,10,65,UCBPlayer
23296,UCBPlayer,130,275,405,25,40,UCBPlayer
23297,UCBPlayer,103,203,306,10,68,UCBPlayer
23298,UCBPlayer,128,283,411,25,38,UCBPlayer
23299,UCBPlayer,111,186,297,10,71,UCBPlayer
23300,UCBPlayer,124,299,423,25,34,UCBPlayer
23301,UCBPlayer,115,170,285,10,75,UCBPlayer
23302,UCBPlayer,120,315,435,25,30,UCBPlayer
23303,UCBPlayer,119,154,273,10,79,UCBPlayer
23304,UCBPlayer,112,332,444,25,27,UCBPlayer
23305,UCBPlayer,127,137,264,10,82,UCBPlayer
23306,UCBPlayer,104,349,453,25,24,UCBPlayer
23307,UCBPlayer,126,126,252,7,85,Tie
23308,UCBPlayer,111,351,462,28,22,UCBPlayer
23309,UCBPlayer,116,126,242,3,87,UCBPlayer
23310,UCBPlayer,122,347,469,32,21,UCBPlayer
23311,UCBPlayer,107,132,239,0,87,UCBPlayer
23312,UCBPlayer,132,337,469,35,22,UCBPlayer
23313,UCBPlayer,103,148,251,0,83,UCBPlayer
23314,UCBPlayer,136,321,457,35,26,UCBPlayer
23315,UCBPlayer,99,164,263,0,79,UCBPlayer
23316,UCBPlayer,140,305,445,35,30,UCBPlayer
23317,UCBPlayer,95,180,275,0,75,UCBPlayer
23318,UCBPlayer,144,289,433,35,34,UCBPlayer
23319,UCBPlayer,91,196,287,0,71,UCBPlayer
23320,UCBPlayer,148,273,421,35,38,UCBPlayer
23321,UCBPlayer,87,212,299,0,67,UCBPlayer
23322,UCBPlayer,152,257,409,35,42,UCBPlayer
23323,UCBPlayer,84,224,308,0,64,UCBPlayer
23324,UCBPlayer,146,251,397,32,45,UCBPlayer
23325,UCBPlayer,89,234,323,3,60,UCBPlayer
23326,UCBPlayer,138,243,381,28,49,UCBPlayer
23327,UCBPlayer,97,242,339,7,56,UCBPlayer
23328,UCBPlayer,130,235,365,24,53,UCBPlayer
23329,UCBPlayer,105,250,355,11,52,UCBPlayer
23330,UCBPlayer,122,227,349,20,57,UCBPlayer
23331,UCBPlayer,109,259,368,15,49,UCBPlayer
23332,UCBPlayer,118,218,336,16,60,UCBPlayer
23333,UCBPlayer,117,267,384,19,45,UCBPlayer
23334,UCBPlayer,110,210,320,12,64,UCBPlayer
23335,UCBPlayer,126,271,397,23,42,UCBPlayer
23336,UCBPlayer,105,210,315,10,65,UCBPlayer
23337,UCBPlayer,130,275,405,25,40,UCBPlayer
23338,UCBPlayer,105,210,315,10,65,UCBPlayer
23339,UCBPlayer,130,275,405,25,40,UCBPlayer
23340,UCBPlayer,106,206,312,10,66,UCBPlayer
23341,UCBPlayer,130,275,405,25,40,UCBPlayer
23342,UCBPlayer,105,210,315,10,65,UCBPlayer
23343,UCBPlayer,131,271,402,25,41,UCBPlayer
23344,UCBPlayer,105,210,315,10,65,UCBPlayer
23345,UCBPlayer,130,275,405,25,40,UCBPlayer
23346,UCBPlayer,105,210,315,10,65,UCBPlayer
23347,UCBPlayer,130,275,405,25,40,UCBPlayer
23348,UCBPlayer,103,203,306,10,68,UCBPlayer
23349,UCBPlayer,128,283,411,25,38,UCBPlayer
23350,UCBPlayer,111,186,297,10,71,UCBPlayer
23351,UCBPlayer,124,299,423,25,34,UCBPlayer
23352,UCBPlayer,115,170,285,10,75,UCBPlayer
23353,UCBPlayer,120,315,435,25,30,UCBPlayer
23354,UCBPlayer,119,154,273,10,79,UCBPlayer
23355,UCBPlayer,112,332,444,25,27,UCBPlayer
23356,UCBPlayer,127,137,264,10,82,UCBPlayer
23357,UCBPlayer,104,349,453,25,24,UCBPlayer
23358,UCBPlayer,126,126,252,7,85,Tie
23359,UCBPlayer,111,351,462,28,22,UCBPlayer
23360,UCBPlayer,116,126,242,3,87,UCBPlayer
23361,UCBPlayer,122,347,469,32,21,UCBPlayer
23362,UCBPlayer,107,132,239,0,87,UCBPlayer
23363,UCBPlayer,132,337,469,35,22,UCBPlayer
23364,UCBPlayer,103,148,251,0,83,UCBPlayer
23365,UCBPlayer,136,321,457,35,26,UCBPlayer
23366,UCBPlayer,99,164,263,0,79,UCBPlayer
23367,UCBPlayer,140,305,445,35,30,UCBPlayer
23368,UCBPlayer,95,180,275,0,75,UCBPlayer
23369,UCBPlayer,144,289,433,35,34,UCBPlayer
23370,UCBPlayer,91,196,287,0,71,UCBPlayer
23371,UCBPlayer,148,273,421,35,38,UCBPlayer
23372,UCBPlayer,87,212,299,0,67,UCBPlayer
23373,UCBPlayer,152,257,409,35,42,UCBPlayer
23374,UCBPlayer,84,224,308,0,64,UCBPlayer
23375,UCBPlayer,146,251,397,32,45,UCBPlayer
23376,UCBPlayer,89,234,323,3,60,UCBPlayer
23377,UCBPlayer,138,243,381,28,49,UCBPlayer
23378,UCBPlayer,97,242,339,7,56,UCBPlayer
23379,UCBPlayer,130,235,365,24,53,UCBPlayer
23380,UCBPlayer,105,250,355,11,52,UCBPlayer
23381,UCBPlayer,122,227,349,20,57,UCBPlayer
23382,UCBPlayer,109,259,368,15,49,UCBPlayer
23383,UCBPlayer,118,218,336,16,60,UCBPlayer
23384,UCBPlayer,117,267,384,19,45,UCBPlayer
23385,UCBPlayer,110,210,320,12,64,UCBPlayer
23386,UCBPlayer,126,271,397,23,42,UCBPlayer
23387,UCBPlayer,105,210,315,10,65,UCBPlayer
23388,UCBPlayer,130,275,405,25,40,UCBPlayer
23389,UCBPlayer,105,210,315,10,65,UCBPlayer
23390,UCBPlayer,130,275,405,25,40,UCBPlayer
23391,UCBPlayer,106,206,312,10,66,UCBPlayer
23392,UCBPlayer,130,275,405,25,40,UCBPlayer
23393,UCBPlayer,105,210,315,10,65,UCBPlayer
23394,UCBPlayer,131,271,402,25,41,UCBPlayer
23395,UCBPlayer,105,210,315,10,65,UCBPlayer
23396,UCBPlayer,130,275,405,25,40,UCBPlayer
23397,UCBPlayer,105,210,315,10,65,UCBPlayer
23398,UCBPlayer,130,275,405,25,40,UCBPlayer
23399,UCBPlayer,103,203,306,10,68,UCBPlayer
23400,UCBPlayer,128,283,411,25,38,UCBPlayer
23401,UCBPlayer,111,186,297,10,71,UCBPlayer
23402,UCBPlayer,124,299,423,25,34,UCBPlayer
23403,UCBPlayer,115,170,285,10,75,UCBPlayer
23404,UCBPlayer,120,315,435,25,30,UCBPlayer
23405,UCBPlayer,119,154,273,10,79,UCBPlayer
23406,UCBPlayer,112,332,444,25,27,UCBPlayer
23407,UCBPlayer,127,137,264,10,82,UCBPlayer
23408,UCBPlayer,104,349,453,25,24,UCBPlayer
23409,UCBPlayer,126,126,252,7,85,Tie
23410,UCBPlayer,111,351,462,28,22,UCBPlayer
23411,UCBPlayer,116,126,242,3,87,UCBPlayer
23412,UCBPlayer,122,347,469,32,21,UCBPlayer
23413,UCBPlayer,107,132,239,0,87,UCBPlayer
23414,UCBPlayer,132,337,469,35,22,UCBPlayer
23415,UCBPlayer,103,148,251,0,83,UCBPlayer
23416,UCBPlayer,136,321,457,35,26,UCBPlayer
23417,UCBPlayer,99,164,263,0,79,UCBPlayer
23418,UCBPlayer,140,305,445,35,30,UCBPlayer
23419,UCBPlayer,95,180,275,0,75,UCBPlayer
23420,UCBPlayer,144,289,433,35,34,UCBPlayer
23421,UCBPlayer,91,196,287,0,71,UCBPlayer
23422,UCBPlayer,148,273,421,35,38,UCBPlayer
23423,UCBPlayer,87,212,299,0,67,UCBPlayer
23424,UCBPlayer,152,257,409,35,42,UCBPlayer
23425,UCBPlayer,84,224,308,0,64,UCBPlayer
23426,UCBPlayer,146,251,397,32,45,UCBPlayer
23427,UCBPlayer,89,234,323,3,60,UCBPlayer
23428,UCBPlayer,138,243,381,28,49,UCBPlayer
23429,UCBPlayer,97,242,339,7,56,UCBPlayer
23430,UCBPlayer,130,235,365,24,53,UCBPlayer
23431,UCBPlayer,105,250,355,11,52,UCBPlayer
23432,UCBPlayer,122,227,349,20,57,UCBPlayer
23433,UCBPlayer,109,259,368,15,49,UCBPlayer
23434,UCBPlayer,118,218,336,16,60,UCBPlayer
23435,UCBPlayer,117,267,384,19,45,UCBPlayer
23436,UCBPlayer,110,210,320,12,64,UCBPlayer
23437,UCBPlayer,126,271,397,23,42,UCBPlayer
23438,UCBPlayer,105,210,315,10,65,UCBPlayer
23439,UCBPlayer,130,275,405,25,40,UCBPlayer
23440,UCBPlayer,105,210,315,10,65,UCBPlayer
23441,UCBPlayer,130,275,405,25,40,UCBPlayer
23442,UCBPlayer,106,206,312,10,66,UCBPlayer
23443,UCBPlayer,130,275,405,25,40,UCBPlayer
23444,UCBPlayer,105,210,315,10,65,UCBPlayer
23445,UCBPlayer,131,271,402,25,41,UCBPlayer
23446,UCBPlayer,105,210,315,10,65,UCBPlayer
23447,UCBPlayer,130,275,405,25,40,UCBPlayer
23448,UCBPlayer,105,210,315,10,65,UCBPlayer
23449,UCBPlayer,130,275,405,25,40,UCBPlayer
23450,UCBPlayer,103,203,306,10,68,UCBPlayer
23451,UCBPlayer,128,283,411,25,38,UCBPlayer
23452,UCBPlayer,111,186,297,10,71,UCBPlayer
23453,UCBPlayer,124,299,423,25,34,UCBPlayer
23454,UCBPlayer,115,170,285,10,75,UCBPlayer
23455,UCBPlayer,120,315,435,25,30,UCBPlayer
23456,UCBPlayer,119,154,273,10,79,UCBPlayer
23457,UCBPlayer,112,332,444,25,27,UCBPlayer
23458,UCBPlayer,127,137,264,10,82,UCBPlayer
23459,UCBPlayer,104,349,453,25,24,UCBPlayer
23460,UCBPlayer,126,126,252,7,85,Tie
23461,UCBPlayer,111,351,462,28,22,UCBPlayer
23462,UCBPlayer,116,126,242,3,87,UCBPlayer
23463,UCBPlayer,122,347,469,32,21,UCBPlayer
23464,UCBPlayer,107,132,239,0,87,UCBPlayer
23465,UCBPlayer,132,337,469,35,22,UCBPlayer
23466,UCBPlayer,103,148,251,0,83,UCBPlayer
23467,UCBPlayer,136,321,457,35,26,UCBPlayer
23468,UCBPlayer,99,164,263,0,79,UCBPlayer
23469,UCBPlayer,140,305,445,35,30,UCBPlayer
23470,UCBPlayer,95,180,275,0,75,UCBPlayer
23471,UCBPlayer,144,289,433,35,34,UCBPlayer
23472,UCBPlayer,91,196,287,0,71,UCBPlayer
23473,UCBPlayer,148,273,421,35,38,UCBPlayer
23474,UCBPlayer,87,212,299,0,67,UCBPlayer
23475,UCBPlayer,152,257,409,35,42,UCBPlayer
23476,UCBPlayer,84,224,308,0,64,UCBPlayer
23477,UCBPlayer,146,251,397,32,45,UCBPlayer
23478,UCBPlayer,89,234,323,3,60,UCBPlayer
23479,UCBPlayer,138,243,381,28,49,UCBPlayer
23480,UCBPlayer,97,242,339,7,56,UCBPlayer
23481,UCBPlayer,130,235,365,24,53,UCBPlayer
23482,UCBPlayer,105,250,355,11,52,UCBPlayer
23483,UCBPlayer,122,227,349,20,57,UCBPlayer
23484,UCBPlayer,109,259,368,15,49,UCBPlayer
23485,UCBPlayer,118,218,336,16,60,UCBPlayer
23486,UCBPlayer,117,267,384,19,45,UCBPlayer
23487,UCBPlayer,110,210,320,12,64,UCBPlayer
23488,UCBPlayer,126,271,397,23,42,UCBPlayer
23489,UCBPlayer,105,210,315,10,65,UCBPlayer
23490,UCBPlayer,130,275,405,25,40,UCBPlayer
23491,UCBPlayer,105,210,315,10,65,UCBPlayer
23492,UCBPlayer,130,275,405,25,40,UCBPlayer
23493,UCBPlayer,106,206,312,10,66,UCBPlayer
23494,UCBPlayer,130,275,405,25,40,UCBPlayer
23495,UCBPlayer,105,210,315,10,65,UCBPlayer
23496,UCBPlayer,131,271,402,25,41,UCBPlayer
23497,UCBPlayer,105,210,315,10,65,UCBPlayer
23498,UCBPlayer,130,275,405,25,40,UCBPlayer
23499,UCBPlayer,105,210,315,10,65,UCBPlayer
23500,UCBPlayer,130,275,405,25,40,UCBPlayer
23501,UCBPlayer,103,203,306,10,68,UCBPlayer
23502,UCBPlayer,128,283,411,25,38,UCBPlayer
23503,UCBPlayer,111,186,297,10,71,UCBPlayer
23504,UCBPlayer,124,299,423,25,34,UCBPlayer
23505,UCBPlayer,115,170,285,10,75,UCBPlayer
23506,UCBPlayer,120,315,435,25,30,UCBPlayer
23507,UCBPlayer,119,154,273,10,79,UCBPlayer
23508,UCBPlayer,112,332,444,25,27,UCBPlayer
23509,UCBPlayer,127,137,264,10,82,UCBPlayer
23510,UCBPlayer,104,349,453,25,24,UCBPlayer
23511,UCBPlayer,126,126,252,7,85,Tie
23512,UCBPlayer,111,351,462,28,22,UCBPlayer
23513,UCBPlayer,116,126,242,3,87,UCBPlayer
23514,UCBPlayer,122,347,469,32,21,UCBPlayer
23515,UCBPlayer,107,132,239,0,87,UCBPlayer
23516,UCBPlayer,132,337,469,35,22,UCBPlayer
23517,UCBPlayer,103,148,251,0,83,UCBPlayer
23518,UCBPlayer,136,321,457,35,26,UCBPlayer
23519,UCBPlayer,99,164,263,0,79,UCBPlayer
23520,UCBPlayer,140,305,445,35,30,UCBPlayer
23521,UCBPlayer,95,180,275,0,75,UCBPlayer
23522,UCBPlayer,144,289,433,35,34,UCBPlayer
23523,UCBPlayer,91,196,287,0,71,UCBPlayer
23524,UCBPlayer,148,273,421,35,38,UCBPlayer
23525,UCBPlayer,87,212,299,0,67,UCBPlayer
23526,UCBPlayer,152,257,409,35,42,UCBPlayer
23527,UCBPlayer,84,224,308,0,64,UCBPlayer
23528,UCBPlayer,146,251,397,32,45,UCBPlayer
23529,UCBPlayer,89,234,323,3,60,UCBPlayer
23530,UCBPlayer,138,243,381,28,49,UCBPlayer
23531,UCBPlayer,97,242,339,7,56,UCBPlayer
23532,UCBPlayer,130,235,365,24,53,UCBPlayer
23533,UCBPlayer,105,250,355,11,52,UCBPlayer
23534,UCBPlayer,122,227,349,20,57,UCBPlayer
23535,UCBPlayer,109,259,368,15,49,UCBPlayer
23536,UCBPlayer,118,218,336,16,60,UCBPlayer
23537,UCBPlayer,117,267,384,19,45,UCBPlayer
23538,UCBPlayer,110,210,320,12,64,UCBPlayer
23539,UCBPlayer,126,271,397,23,42,UCBPlayer
23540,UCBPlayer,105,210,315,10,65,UCBPlayer
23541,UCBPlayer,130,275,405,25,40,UCBPlayer
23542,UCBPlayer,105,210,315,10,65,UCBPlayer
23543,UCBPlayer,130,275,405,25,40,UCBPlayer
23544,UCBPlayer,106,206,312,10,66,UCBPlayer
23545,UCBPlayer,130,275,405,25,40,UCBPlayer
23546,UCBPlayer,105,210,315,10,65,UCBPlayer
23547,UCBPlayer,131,271,402,25,41,UCBPlayer
23548,UCBPlayer,105,210,315,10,65,UCBPlayer
23549,UCBPlayer,130,275,405,25,40,UCBPlayer
23550,UCBPlayer,105,210,315,10,65,UCBPlayer
23551,UCBPlayer,130,275,405,25,40,UCBPlayer
23552,UCBPlayer,103,203,306,10,68,UCBPlayer
23553,UCBPlayer,128,283,411,25,38,UCBPlayer
23554,UCBPlayer,111,186,297,10,71,UCBPlayer
23555,UCBPlayer,124,299,423,25,34,UCBPlayer
23556,UCBPlayer,115,170,285,10,75,UCBPlayer
23557,UCBPlayer,120,315,435,25,30,UCBPlayer
23558,UCBPlayer,119,154,273,10,79,UCBPlayer
23559,UCBPlayer,112,332,444,25,27,UCBPlayer
23560,UCBPlayer,127,137,264,10,82,UCBPlayer
23561,UCBPlayer,104,349,453,25,24,UCBPlayer
23562,UCBPlayer,126,126,252,7,85,Tie
23563,UCBPlayer,111,351,462,28,22,UCBPlayer
23564,UCBPlayer,116,126,242,3,87,UCBPlayer
23565,UCBPlayer,122,347,469,32,21,UCBPlayer
23566,UCBPlayer,107,132,239,0,87,UCBPlayer
23567,UCBPlayer,132,337,469,35,22,UCBPlayer
23568,UCBPlayer,103,148,251,0,83,UCBPlayer
23569,UCBPlayer,136,321,457,35,26,UCBPlayer
23570,UCBPlayer,99,164,263,0,79,UCBPlayer
23571,UCBPlayer,140,305,445,35,30,UCBPlayer
23572,UCBPlayer,95,180,275,0,75,UCBPlayer
23573,UCBPlayer,144,289,433,35,34,UCBPlayer
23574,UCBPlayer,91,196,287,0,71,UCBPlayer
23575,UCBPlayer,148,273,421,35,38,UCBPlayer
23576,UCBPlayer,87,212,299,0,67,UCBPlayer
23577,UCBPlayer,152,257,409,35,42,UCBPlayer
23578,UCBPlayer,84,224,308,0,64,UCBPlayer
23579,UCBPlayer,146,251,397,32,45,UCBPlayer
23580,UCBPlayer,89,234,323,3,60,UCBPlayer
23581,UCBPlayer,138,243,381,28,49,UCBPlayer
23582,UCBPlayer,97,242,339,7,56,UCBPlayer
23583,UCBPlayer,130,235,365,24,53,UCBPlayer
23584,UCBPlayer,105,250,355,11,52,UCBPlayer
23585,UCBPlayer,122,227,349,20,57,UCBPlayer
23586,UCBPlayer,109,259,368,15,49,UCBPlayer
23587,UCBPlayer,118,218,336,16,60,UCBPlayer
23588,UCBPlayer,117,267,384,19,45,UCBPlayer
23589,UCBPlayer,110,210,320,12,64,UCBPlayer
23590,UCBPlayer,126,271,397,23,42,UCBPlayer
23591,UCBPlayer,105,210,315,10,65,UCBPlayer
23592,UCBPlayer,130,275,405,25,40,UCBPlayer
23593,UCBPlayer,105,210,315,10,65,UCBPlayer
23594,UCBPlayer,130,275,405,25,40,UCBPlayer
23595,UCBPlayer,106,206,312,10,66,UCBPlayer
23596,UCBPlayer,130,275,405,25,40,UCBPlayer
23597,UCBPlayer,105,210,315,10,65,UCBPlayer
23598,UCBPlayer,131,271,402,25,41,UCBPlayer
23599,UCBPlayer,105,210,315,10,65,UCBPlayer
23600,UCBPlayer,130,275,405,25,40,UCBPlayer
23601,UCBPlayer,105,210,315,10,65,UCBPlayer
23602,UCBPlayer,130,275,405,25,40,UCBPlayer
23603,UCBPlayer,103,203,306,10,68,UCBPlayer
23604,UCBPlayer,128,283,411,25,38,UCBPlayer
23605,UCBPlayer,111,186,297,10,71,UCBPlayer
23606,UCBPlayer,124,299,423,25,34,UCBPlayer
23607,UCBPlayer,115,170,285,10,75,UCBPlayer
23608,UCBPlayer,120,315,435,25,30,UCBPlayer
23609,UCBPlayer,119,154,273,10,79,UCBPlayer
23610,UCBPlayer,112,332,444,25,27,UCBPlayer
23611,UCBPlayer,127,137,264,10,82,UCBPlayer
23612,UCBPlayer,104,349,453,25,24,UCBPlayer
23613,UCBPlayer,126,126,252,7,85,Tie
23614,UCBPlayer,111,351,462,28,22,UCBPlayer
23615,UCBPlayer,116,126,242,3,87,UCBPlayer
23616,UCBPlayer,122,347,469,32,21,UCBPlayer
23617,UCBPlayer,107,132,239,0,87,UCBPlayer
23618,UCBPlayer,132,337,469,35,22,UCBPlayer
23619,UCBPlayer,103,148,251,0,83,UCBPlayer
23620,UCBPlayer,136,321,457,35,26,UCBPlayer
23621,UCBPlayer,99,164,263,0,79,UCBPlayer
23622,UCBPlayer,140,305,445,35,30,UCBPlayer
23623,UCBPlayer,95,180,275,0,75,UCBPlayer
23624,UCBPlayer,144,289,433,35,34,UCBPlayer
23625,UCBPlayer,91,196,287,0,71,UCBPlayer
23626,UCBPlayer,148,273,421,35,38,UCBPlayer
23627,UCBPlayer,87,212,299,0,67,UCBPlayer
23628,UCBPlayer,152,257,409,35,42,UCBPlayer
23629,UCBPlayer,84,224,308,0,64,UCBPlayer
23630,UCBPlayer,146,251,397,32,45,UCBPlayer
23631,UCBPlayer,89,234,323,3,60,UCBPlayer
23632,UCBPlayer,138,243,381,28,49,UCBPlayer
23633,UCBPlayer,97,242,339,7,56,UCBPlayer
23634,UCBPlayer,130,235,365,24,53,UCBPlayer
23635,UCBPlayer,105,250,355,11,52,UCBPlayer
23636,UCBPlayer,122,227,349,20,57,UCBPlayer
23637,UCBPlayer,109,259,368,15,49,UCBPlayer
23638,UCBPlayer,118,218,336,16,60,UCBPlayer
23639,UCBPlayer,117,267,384,19,45,UCBPlayer
23640,UCBPlayer,110,210,320,12,64,UCBPlayer
23641,UCBPlayer,126,271,397,23,42,UCBPlayer
23642,UCBPlayer,105,210,315,10,65,UCBPlayer
23643,UCBPlayer,130,275,405,25,40,UCBPlayer
23644,UCBPlayer,105,210,315,10,65,UCBPlayer
23645,UCBPlayer,130,275,405,25,40,UCBPlayer
23646,UCBPlayer,106,206,312,10,66,UCBPlayer
23647,UCBPlayer,130,275,405,25,40,UCBPlayer
23648,UCBPlayer,105,210,315,10,65,UCBPlayer
23649,UCBPlayer,131,271,402,25,41,UCBPlayer
23650,UCBPlayer,105,210,315,10,65,UCBPlayer
23651,UCBPlayer,130,275,405,25,40,UCBPlayer
23652,UCBPlayer,105,210,315,10,65,UCBPlayer
23653,UCBPlayer,130,275,405,25,40,UCBPlayer
23654,UCBPlayer,103,203,306,10,68,UCBPlayer
23655,UCBPlayer,128,283,411,25,38,UCBPlayer
23656,UCBPlayer,111,186,297,10,71,UCBPlayer
23657,UCBPlayer,124,299,423,25,34,UCBPlayer
23658,UCBPlayer,115,170,285,10,75,UCBPlayer
23659,UCBPlayer,120,315,435,25,30,UCBPlayer
23660,UCBPlayer,119,154,273,10,79,UCBPlayer
23661,UCBPlayer,112,332,444,25,27,UCBPlayer
23662,UCBPlayer,127,137,264,10,82,UCBPlayer
23663,UCBPlayer,104,349,453,25,24,UCBPlayer
23664,UCBPlayer,126,126,252,7,85,Tie
23665,UCBPlayer,111,351,462,28,22,UCBPlayer
23666,UCBPlayer,116,126,242,3,87,UCBPlayer
23667,UCBPlayer,122,347,469,32,21,UCBPlayer
23668,UCBPlayer,107,132,239,0,87,UCBPlayer
23669,UCBPlayer,132,337,469,35,22,UCBPlayer
23670,UCBPlayer,103,148,251,0,83,UCBPlayer
23671,UCBPlayer,136,321,457,35,26,UCBPlayer
23672,UCBPlayer,99,164,263,0,79,UCBPlayer
23673,UCBPlayer,140,305,445,35,30,UCBPlayer
23674,UCBPlayer,95,180,275,0,75,UCBPlayer
23675,UCBPlayer,144,289,433,35,34,UCBPlayer
23676,UCBPlayer,91,196,287,0,71,UCBPlayer
23677,UCBPlayer,148,273,421,35,38,UCBPlayer
23678,UCBPlayer,87,212,299,0,67,UCBPlayer
23679,UCBPlayer,152,257,409,35,42,UCBPlayer
23680,UCBPlayer,84,224,308,0,64,UCBPlayer
23681,UCBPlayer,146,251,397,32,45,UCBPlayer
23682,UCBPlayer,89,234,323,3,60,UCBPlayer
23683,UCBPlayer,138,243,381,28,49,UCBPlayer
23684,UCBPlayer,97,242,339,7,56,UCBPlayer
23685,UCBPlayer,130,235,365,24,53,UCBPlayer
23686,UCBPlayer,105,250,355,11,52,UCBPlayer
23687,UCBPlayer,122,227,349,20,57,UCBPlayer
23688,UCBPlayer,109,259,368,15,49,UCBPlayer
23689,UCBPlayer,118,218,336,16,60,UCBPlayer
23690,UCBPlayer,117,267,384,19,45,UCBPlayer
23691,UCBPlayer,110,210,320,12,64,UCBPlayer
23692,UCBPlayer,126,271,397,23,42,UCBPlayer
23693,UCBPlayer,105,210,315,10,65,UCBPlayer
23694,UCBPlayer,130,275,405,25,40,UCBPlayer
23695,UCBPlayer,105,210,315,10,65,UCBPlayer
23696,UCBPlayer,130,275,405,25,40,UCBPlayer
23697,UCBPlayer,106,206,312,10,66,UCBPlayer
23698,UCBPlayer,130,275,405,25,40,UCBPlayer
23699,UCBPlayer,105,210,315,10,65,UCBPlayer
23700,UCBPlayer,131,271,402,25,41,UCBPlayer
23701,UCBPlayer,105,210,315,10,65,UCBPlayer
23702,UCBPlayer,130,275,405,25,40,UCBPlayer
23703,UCBPlayer,105,210,315,10,65,UCBPlayer
23704,UCBPlayer,130,275,405,25,40,UCBPlayer
23705,UCBPlayer,103,203,306,10,68,UCBPlayer
23706,UCBPlayer,128,283,411,25,38,UCBPlayer
23707,UCBPlayer,111,186,297,10,71,UCBPlayer
23708,UCBPlayer,124,299,423,25,34,UCBPlayer
23709,UCBPlayer,115,170,285,10,75,UCBPlayer
23710,UCBPlayer,120,315,435,25,30,UCBPlayer
23711,UCBPlayer,119,154,273,10,79,UCBPlayer
23712,UCBPlayer,112,332,444,25,27,UCBPlayer
23713,UCBPlayer,127,137,264,10,82,UCBPlayer
23714,UCBPlayer,104,349,453,25,24,UCBPlayer
23715,UCBPlayer,126,126,252,7,85,Tie
23716,UCBPlayer,111,351,462,28,22,UCBPlayer
23717,UCBPlayer,116,126,242,3,87,UCBPlayer
23718,UCBPlayer,122,347,469,32,21,UCBPlayer
23719,UCBPlayer,107,132,239,0,87,UCBPlayer
23720,UCBPlayer,132,337,469,35,22,UCBPlayer
23721,UCBPlayer,103,148,251,0,83,UCBPlayer
23722,UCBPlayer,136,321,457,35,26,UCBPlayer
23723,UCBPlayer,99,164,263,0,79,UCBPlayer
23724,UCBPlayer,140,305,445,35,30,UCBPlayer
23725,UCBPlayer,95,180,275,0,75,UCBPlayer
23726,UCBPlayer,144,289,433,35,34,UCBPlayer
23727,UCBPlayer,91,196,287,0,71,UCBPlayer
23728,UCBPlayer,148,273,421,35,38,UCBPlayer
23729,UCBPlayer,87,212,299,0,67,UCBPlayer
23730,UCBPlayer,152,257,409,35,42,UCBPlayer
23731,UCBPlayer,84,224,308,0,64,UCBPlayer
23732,UCBPlayer,146,251,397,32,45,UCBPlayer
23733,UCBPlayer,89,234,323,3,60,UCBPlayer
23734,UCBPlayer,138,243,381,28,49,UCBPlayer
23735,UCBPlayer,97,242,339,7,56,UCBPlayer
23736,UCBPlayer,130,235,365,24,53,UCBPlayer
23737,UCBPlayer,105,250,355,11,52,UCBPlayer
23738,UCBPlayer,122,227,349,20,57,UCBPlayer
23739,UCBPlayer,109,259,368,15,49,UCBPlayer
23740,UCBPlayer,118,218,336,16,60,UCBPlayer
23741,UCBPlayer,117,267,384,19,45,UCBPlayer
23742,UCBPlayer,110,210,320,12,64,UCBPlayer
23743,UCBPlayer,126,271,397,23,42,UCBPlayer
23744,UCBPlayer,105,210,315,10,65,UCBPlayer
23745,UCBPlayer,130,275,405,25,40,UCBPlayer
23746,UCBPlayer,105,210,315,10,65,UCBPlayer
23747,UCBPlayer,130,275,405,25,40,UCBPlayer
23748,UCBPlayer,106,206,312,10,66,UCBPlayer
23749,UCBPlayer,130,275,405,25,40,UCBPlayer
23750,UCBPlayer,105,210,315,10,65,UCBPlayer
23751,UCBPlayer,131,271,402,25,41,UCBPlayer
23752,UCBPlayer,105,210,315,10,65,UCBPlayer
23753,UCBPlayer,130,275,405,25,40,UCBPlayer
23754,UCBPlayer,105,210,315,10,65,UCBPlayer
23755,UCBPlayer,130,275,405,25,40,UCBPlayer
23756,UCBPlayer,103,203,306,10,68,UCBPlayer
23757,UCBPlayer,128,283,411,25,38,UCBPlayer
23758,UCBPlayer,111,186,297,10,71,UCBPlayer
23759,UCBPlayer,124,299,423,25,34,UCBPlayer
23760,UCBPlayer,115,170,285,10,75,UCBPlayer
23761,UCBPlayer,120,315,435,25,30,UCBPlayer
23762,UCBPlayer,119,154,273,10,79,UCBPlayer
23763,UCBPlayer,112,332,444,25,27,UCBPlayer
23764,UCBPlayer,127,137,264,10,82,UCBPlayer
23765,UCBPlayer,104,349,453,25,24,UCBPlayer
23766,UCBPlayer,126,126,252,7,85,Tie
23767,UCBPlayer,111,351,462,28,22,UCBPlayer
23768,UCBPlayer,116,126,242,3,87,UCBPlayer
23769,UCBPlayer,122,347,469,32,21,UCBPlayer
23770,UCBPlayer,107,132,239,0,87,UCBPlayer
23771,UCBPlayer,132,337,469,35,22,UCBPlayer
23772,UCBPlayer,103,148,251,0,83,UCBPlayer
23773,UCBPlayer,136,321,457,35,26,UCBPlayer
23774,UCBPlayer,99,164,263,0,79,UCBPlayer
23775,UCBPlayer,140,305,445,35,30,UCBPlayer
23776,UCBPlayer,95,180,275,0,75,UCBPlayer
23777,UCBPlayer,144,289,433,35,34,UCBPlayer
23778,UCBPlayer,91,196,287,0,71,UCBPlayer
23779,UCBPlayer,148,273,421,35,38,UCBPlayer
23780,UCBPlayer,87,212,299,0,67,UCBPlayer
23781,UCBPlayer,152,257,409,35,42,UCBPlayer
23782,UCBPlayer,84,224,308,0,64,UCBPlayer
23783,UCBPlayer,146,251,397,32,45,UCBPlayer
23784,UCBPlayer,89,234,323,3,60,UCBPlayer
23785,UCBPlayer,138,243,381,28,49,UCBPlayer
23786,UCBPlayer,97,242,339,7,56,UCBPlayer
23787,UCBPlayer,130,235,365,24,53,UCBPlayer
23788,UCBPlayer,105,250,355,11,52,UCBPlayer
23789,UCBPlayer,122,227,349,20,57,UCBPlayer
23790,UCBPlayer,109,259,368,15,49,UCBPlayer
23791,UCBPlayer,118,218,336,16,60,UCBPlayer
23792,UCBPlayer,117,267,384,19,45,UCBPlayer
23793,UCBPlayer,110,210,320,12,64,UCBPlayer
23794,UCBPlayer,126,271,397,23,42,UCBPlayer
23795,UCBPlayer,105,210,315,10,65,UCBPlayer
23796,UCBPlayer,130,275,405,25,40,UCBPlayer
23797,UCBPlayer,105,210,315,10,65,UCBPlayer
23798,UCBPlayer,130,275,405,25,40,UCBPlayer
23799,UCBPlayer,106,206,312,10,66,UCBPlayer
23800,UCBPlayer,130,275,405,25,40,UCBPlayer
23801,UCBPlayer,105,210,315,10,65,UCBPlayer
23802,UCBPlayer,131,271,402,25,41,UCBPlayer
23803,UCBPlayer,105,210,315,10,65,UCBPlayer
23804,UCBPlayer,130,275,405,25,40,UCBPlayer
23805,UCBPlayer,105,210,315,10,65,UCBPlayer
23806,UCBPlayer,130,275,405,25,40,UCBPlayer
23807,UCBPlayer,103,203,306,10,68,UCBPlayer
23808,UCBPlayer,128,283,411,25,38,UCBPlayer
23809,UCBPlayer,111,186,297,10,71,UCBPlayer
23810,UCBPlayer,124,299,423,25,34,UCBPlayer
23811,UCBPlayer,115,170,285,10,75,UCBPlayer
23812,UCBPlayer,120,315,435,25,30,UCBPlayer
23813,UCBPlayer,119,154,273,10,79,UCBPlayer
23814,UCBPlayer,112,332,444,25,27,UCBPlayer
23815,UCBPlayer,127,137,264,10,82,UCBPlayer
23816,UCBPlayer,104,349,453,25,24,UCBPlayer
23817,UCBPlayer,126,126,252,7,85,Tie
23818,UCBPlayer,111,351,462,28,22,UCBPlayer
23819,UCBPlayer,116,126,242,3,87,UCBPlayer
23820,UCBPlayer,122,347,469,32,21,UCBPlayer
23821,UCBPlayer,107,132,239,0,87,UCBPlayer
23822,UCBPlayer,132,337,469,35,22,UCBPlayer
23823,UCBPlayer,103,148,251,0,83,UCBPlayer
23824,UCBPlayer,136,321,457,35,26,UCBPlayer
23825,UCBPlayer,99,164,263,0,79,UCBPlayer
23826,UCBPlayer,140,305,445,35,30,UCBPlayer
23827,UCBPlayer,95,180,275,0,75,UCBPlayer
23828,UCBPlayer,144,289,433,35,34,UCBPlayer
23829,UCBPlayer,91,196,287,0,71,UCBPlayer
23830,UCBPlayer,148,273,421,35,38,UCBPlayer
23831,UCBPlayer,87,212,299,0,67,UCBPlayer
23832,UCBPlayer,152,257,409,35,42,UCBPlayer
23833,UCBPlayer,84,224,308,0,64,UCBPlayer
23834,UCBPlayer,146,251,397,32,45,UCBPlayer
23835,UCBPlayer,89,234,323,3,60,UCBPlayer
23836,UCBPlayer,138,243,381,28,49,UCBPlayer
23837,UCBPlayer,97,242,339,7,56,UCBPlayer
23838,UCBPlayer,130,235,365,24,53,UCBPlayer
23839,UCBPlayer,105,250,355,11,52,UCBPlayer
23840,UCBPlayer,122,227,349,20,57,UCBPlayer
23841,UCBPlayer,109,259,368,15,49,UCBPlayer
23842,UCBPlayer,118,218,336,16,60,UCBPlayer
23843,UCBPlayer,117,267,384,19,45,UCBPlayer
23844,UCBPlayer,110,210,320,12,64,UCBPlayer
23845,UCBPlayer,126,271,397,23,42,UCBPlayer
23846,UCBPlayer,105,210,315,10,65,UCBPlayer
23847,UCBPlayer,130,275,405,25,40,UCBPlayer
23848,UCBPlayer,105,210,315,10,65,UCBPlayer
23849,UCBPlayer,130,275,405,25,40,UCBPlayer
23850,UCBPlayer,106,206,312,10,66,UCBPlayer
23851,UCBPlayer,130,275,405,25,40,UCBPlayer
23852,UCBPlayer,105,210,315,10,65,UCBPlayer
23853,UCBPlayer,131,271,402,25,41,UCBPlayer
23854,UCBPlayer,105,210,315,10,65,UCBPlayer
23855,UCBPlayer,130,275,405,25,40,UCBPlayer
23856,UCBPlayer,105,210,315,10,65,UCBPlayer
23857,UCBPlayer,130,275,405,25,40,UCBPlayer
23858,UCBPlayer,103,203,306,10,68,UCBPlayer
23859,UCBPlayer,128,283,411,25,38,UCBPlayer
23860,UCBPlayer,111,186,297,10,71,UCBPlayer
23861,UCBPlayer,124,299,423,25,34,UCBPlayer
23862,UCBPlayer,115,170,285,10,75,UCBPlayer
23863,UCBPlayer,120,315,435,25,30,UCBPlayer
23864,UCBPlayer,119,154,273,10,79,UCBPlayer
23865,UCBPlayer,112,332,444,25,27,UCBPlayer
23866,UCBPlayer,127,137,264,10,82,UCBPlayer
23867,UCBPlayer,104,349,453,25,24,UCBPlayer
23868,UCBPlayer,126,126,252,7,85,Tie
23869,UCBPlayer,111,351,462,28,22,UCBPlayer
23870,UCBPlayer,116,126,242,3,87,UCBPlayer
23871,UCBPlayer,122,347,469,32,21,UCBPlayer
23872,UCBPlayer,107,132,239,0,87,UCBPlayer
23873,UCBPlayer,132,337,469,35,22,UCBPlayer
23874,UCBPlayer,103,148,251,0,83,UCBPlayer
23875,UCBPlayer,136,321,457,35,26,UCBPlayer
23876,UCBPlayer,99,164,263,0,79,UCBPlayer
23877,UCBPlayer,140,305,445,35,30,UCBPlayer
23878,UCBPlayer,95,180,275,0,75,UCBPlayer
23879,UCBPlayer,144,289,433,35,34,UCBPlayer
23880,UCBPlayer,91,196,287,0,71,UCBPlayer
23881,UCBPlayer,148,273,421,35,38,UCBPlayer
23882,UCBPlayer,87,212,299,0,67,UCBPlayer
23883,UCBPlayer,152,257,409,35,42,UCBPlayer
23884,UCBPlayer,84,224,308,0,64,UCBPlayer
23885,UCBPlayer,146,251,397,32,45,UCBPlayer
23886,UCBPlayer,89,234,323,3,60,UCBPlayer
23887,UCBPlayer,138,243,381,28,49,UCBPlayer
23888,UCBPlayer,97,242,339,7,56,UCBPlayer
23889,UCBPlayer,130,235,365,24,53,UCBPlayer
23890,UCBPlayer,105,250,355,11,52,UCBPlayer
23891,UCBPlayer,122,227,349,20,57,UCBPlayer
23892,UCBPlayer,109,259,368,15,49,UCBPlayer
23893,UCBPlayer,118,218,336,16,60,UCBPlayer
23894,UCBPlayer,117,267,384,19,45,UCBPlayer
23895,UCBPlayer,110,210,320,12,64,UCBPlayer
23896,UCBPlayer,126,271,397,23,42,UCBPlayer
23897,UCBPlayer,105,210,315,10,65,UCBPlayer
23898,UCBPlayer,130,275,405,25,40,UCBPlayer
23899,UCBPlayer,105,210,315,10,65,UCBPlayer
23900,UCBPlayer,130,275,405,25,40,UCBPlayer
23901,UCBPlayer,106,206,312,10,66,UCBPlayer
23902,UCBPlayer,130,275,405,25,40,UCBPlayer
23903,UCBPlayer,105,210,315,10,65,UCBPlayer
23904,UCBPlayer,131,271,402,25,41,UCBPlayer
23905,UCBPlayer,105,210,315,10,65,UCBPlayer
23906,UCBPlayer,130,275,405,25,40,UCBPlayer
23907,UCBPlayer,105,210,315,10,65,UCBPlayer
23908,UCBPlayer,130,275,405,25,40,UCBPlayer
23909,UCBPlayer,103,203,306,10,68,UCBPlayer
23910,UCBPlayer,128,283,411,25,38,UCBPlayer
23911,UCBPlayer,111,186,297,10,71,UCBPlayer
23912,UCBPlayer,124,299,423,25,34,UCBPlayer
23913,UCBPlayer,115,170,285,10,75,UCBPlayer
23914,UCBPlayer,120,315,435,25,30,UCBPlayer
23915,UCBPlayer,119,154,273,10,79,UCBPlayer
23916,UCBPlayer,112,332,444,25,27,UCBPlayer
23917,UCBPlayer,127,137,264,10,82,UCBPlayer
23918,UCBPlayer,104,349,453,25,24,UCBPlayer
23919,UCBPlayer,126,126,252,7,85,Tie
23920,UCBPlayer,111,351,462,28,22,UCBPlayer
23921,UCBPlayer,116,126,242,3,87,UCBPlayer
23922,UCBPlayer,122,347,469,32,21,UCBPlayer
23923,UCBPlayer,107,132,239,0,87,UCBPlayer
23924,UCBPlayer,132,337,469,35,22,UCBPlayer
23925,UCBPlayer,103,148,251,0,83,UCBPlayer
23926,UCBPlayer,136,321,457,35,26,UCBPlayer
23927,UCBPlayer,99,164,263,0,79,UCBPlayer
23928,UCBPlayer,140,305,445,35,30,UCBPlayer
23929,UCBPlayer,95,180,275,0,75,UCBPlayer
23930,UCBPlayer,144,289,433,35,34,UCBPlayer
23931,UCBPlayer,91,196,287,0,71,UCBPlayer
23932,UCBPlayer,148,273,421,35,38,UCBPlayer
23933,UCBPlayer,87,212,299,0,67,UCBPlayer
23934,UCBPlayer,152,257,409,35,42,UCBPlayer
23935,UCBPlayer,84,224,308,0,64,UCBPlayer
23936,UCBPlayer,146,251,397,32,45,UCBPlayer
23937,UCBPlayer,89,234,323,3,60,UCBPlayer
23938,UCBPlayer,138,243,381,28,49,UCBPlayer
23939,UCBPlayer,97,242,339,7,56,UCBPlayer
23940,UCBPlayer,130,235,365,24,53,UCBPlayer
23941,UCBPlayer,105,250,355,11,52,UCBPlayer
23942,UCBPlayer,122,227,349,20,57,UCBPlayer
23943,UCBPlayer,109,259,368,15,49,UCBPlayer
23944,UCBPlayer,118,218,336,16,60,UCBPlayer
23945,UCBPlayer,117,267,384,19,45,UCBPlayer
23946,UCBPlayer,110,210,320,12,64,UCBPlayer
23947,UCBPlayer,126,271,397,23,42,UCBPlayer
23948,UCBPlayer,105,210,315,10,65,UCBPlayer
23949,UCBPlayer,130,275,405,25,40,UCBPlayer
23950,UCBPlayer,105,210,315,10,65,UCBPlayer
23951,UCBPlayer,130,275,405,25,40,UCBPlayer
23952,UCBPlayer,106,206,312,10,66,UCBPlayer
23953,UCBPlayer,130,275,405,25,40,UCBPlayer
23954,UCBPlayer,105,210,315,10,65,UCBPlayer
23955,UCBPlayer,131,271,402,25,41,UCBPlayer
23956,UCBPlayer,105,210,315,10,65,UCBPlayer
23957,UCBPlayer,130,275,405,25,40,UCBPlayer
23958,UCBPlayer,105,210,315,10,65,UCBPlayer
23959,UCBPlayer,130,275,405,25,40,UCBPlayer
23960,UCBPlayer,103,203,306,10,68,UCBPlayer
23961,UCBPlayer,128,283,411,25,38,UCBPlayer
23962,UCBPlayer,111,186,297,10,71,UCBPlayer
23963,UCBPlayer,124,299,423,25,34,UCBPlayer
23964,UCBPlayer,115,170,285,10,75,UCBPlayer
23965,UCBPlayer,120,315,435,25,30,UCBPlayer
23966,UCBPlayer,119,154,273,10,79,UCBPlayer
23967,UCBPlayer,112,332,444,25,27,UCBPlayer
23968,UCBPlayer,127,137,264,10,82,UCBPlayer
23969,UCBPlayer,104,349,453,25,24,UCBPlayer
23970,UCBPlayer,126,126,252,7,85,Tie
23971,UCBPlayer,111,351,462,28,22,UCBPlayer
23972,UCBPlayer,116,126,242,3,87,UCBPlayer
23973,UCBPlayer,122,347,469,32,21,UCBPlayer
23974,UCBPlayer,107,132,239,0,87,UCBPlayer
23975,UCBPlayer,132,337,469,35,22,UCBPlayer
23976,UCBPlayer,103,148,251,0,83,UCBPlayer
23977,UCBPlayer,136,321,457,35,26,UCBPlayer
23978,UCBPlayer,99,164,263,0,79,UCBPlayer
23979,UCBPlayer,140,305,445,35,30,UCBPlayer
23980,UCBPlayer,95,180,275,0,75,UCBPlayer
23981,UCBPlayer,144,289,433,35,34,UCBPlayer
23982,UCBPlayer,91,196,287,0,71,UCBPlayer
23983,UCBPlayer,148,273,421,35,38,UCBPlayer
23984,UCBPlayer,87,212,299,0,67,UCBPlayer
23985,UCBPlayer,152,257,409,35,42,UCBPlayer
23986,UCBPlayer,84,224,308,0,64,UCBPlayer
23987,UCBPlayer,146,251,397,32,45,UCBPlayer
23988,UCBPlayer,89,234,323,3,60,UCBPlayer
23989,UCBPlayer,138,243,381,28,49,UCBPlayer
23990,UCBPlayer,97,242,339,7,56,UCBPlayer
23991,UCBPlayer,130,235,365,24,53,UCBPlayer
23992,UCBPlayer,105,250,355,11,52,UCBPlayer
23993,UCBPlayer,122,227,349,20,57,UCBPlayer
23994,UCBPlayer,109,259,368,15,49,UCBPlayer
23995,UCBPlayer,118,218,336,16,60,UCBPlayer
23996,UCBPlayer,117,267,384,19,45,UCBPlayer
23997,UCBPlayer,110,210,320,12,64,UCBPlayer
23998,UCBPlayer,126,271,397,23,42,UCBPlayer
23999,UCBPlayer,105,210,315,10,65,UCBPlayer
24000,UCBPlayer,130,275,405,25,40,UCBPlayer
24001,UCBPlayer,105,210,315,10,65,UCBPlayer
24002,UCBPlayer,130,275,405,25,40,UCBPlayer
24003,UCBPlayer,106,206,312,10,66,UCBPlayer
24004,UCBPlayer,130,275,405,25,40,UCBPlayer
24005,UCBPlayer,105,210,315,10,65,UCBPlayer
24006,UCBPlayer,131,271,402,25,41,UCBPlayer
24007,UCBPlayer,105,210,315,10,65,UCBPlayer
24008,UCBPlayer,130,275,405,25,40,UCBPlayer
24009,UCBPlayer,105,210,315,10,65,UCBPlayer
24010,UCBPlayer,130,275,405,25,40,UCBPlayer
24011,UCBPlayer,103,203,306,10,68,UCBPlayer
24012,UCBPlayer,128,283,411,25,38,UCBPlayer
24013,UCBPlayer,111,186,297,10,71,UCBPlayer
24014,UCBPlayer,124,299,423,25,34,UCBPlayer
24015,UCBPlayer,115,170,285,10,75,UCBPlayer
24016,UCBPlayer,120,315,435,25,30,UCBPlayer
24017,UCBPlayer,119,154,273,10,79,UCBPlayer
24018,UCBPlayer,112,332,444,25,27,UCBPlayer
24019,UCBPlayer,127,137,264,10,82,UCBPlayer
24020,UCBPlayer,104,349,453,25,24,UCBPlayer
24021,UCBPlayer,126,126,252,7,85,Tie
24022,UCBPlayer,111,351,462,28,22,UCBPlayer
24023,UCBPlayer,116,126,242,3,87,UCBPlayer
24024,UCBPlayer,122,347,469,32,21,UCBPlayer
24025,UCBPlayer,107,132,239,0,87,UCBPlayer
24026,UCBPlayer,132,337,469,35,22,UCBPlayer
24027,UCBPlayer,103,148,251,0,83,UCBPlayer
24028,UCBPlayer,136,321,457,35,26,UCBPlayer
24029,UCBPlayer,99,164,263,0,79,UCBPlayer
24030,UCBPlayer,140,305,445,35,30,UCBPlayer
24031,UCBPlayer,95,180,275,0,75,UCBPlayer
24032,UCBPlayer,144,289,433,35,34,UCBPlayer
24033,UCBPlayer,91,196,287,0,71,UCBPlayer
24034,UCBPlayer,148,273,421,35,38,UCBPlayer
24035,UCBPlayer,87,212,299,0,67,UCBPlayer
24036,UCBPlayer,152,257,409,35,42,UCBPlayer
24037,UCBPlayer,84,224,308,0,64,UCBPlayer
24038,UCBPlayer,146,251,397,32,45,UCBPlayer
24039,UCBPlayer,89,234,323,3,60,UCBPlayer
24040,UCBPlayer,138,243,381,28,49,UCBPlayer
24041,UCBPlayer,97,242,339,7,56,UCBPlayer
24042,UCBPlayer,130,235,365,24,53,UCBPlayer
24043,UCBPlayer,105,250,355,11,52,UCBPlayer
24044,UCBPlayer,122,227,349,20,57,UCBPlayer
24045,UCBPlayer,109,259,368,15,49,UCBPlayer
24046,UCBPlayer,118,218,336,16,60,UCBPlayer
24047,UCBPlayer,117,267,384,19,45,UCBPlayer
24048,UCBPlayer,110,210,320,12,64,UCBPlayer
24049,UCBPlayer,126,271,397,23,42,UCBPlayer
24050,UCBPlayer,105,210,315,10,65,UCBPlayer
24051,UCBPlayer,130,275,405,25,40,UCBPlayer
24052,UCBPlayer,105,210,315,10,65,UCBPlayer
24053,UCBPlayer,130,275,405,25,40,UCBPlayer
24054,UCBPlayer,106,206,312,10,66,UCBPlayer
24055,UCBPlayer,130,275,405,25,40,UCBPlayer
24056,UCBPlayer,105,210,315,10,65,UCBPlayer
24057,UCBPlayer,131,271,402,25,41,UCBPlayer
24058,UCBPlayer,105,210,315,10,65,UCBPlayer
24059,UCBPlayer,130,275,405,25,40,UCBPlayer
24060,UCBPlayer,105,210,315,10,65,UCBPlayer
24061,UCBPlayer,130,275,405,25,40,UCBPlayer
24062,UCBPlayer,103,203,306,10,68,UCBPlayer
24063,UCBPlayer,128,283,411,25,38,UCBPlayer
24064,UCBPlayer,111,186,297,10,71,UCBPlayer
24065,UCBPlayer,124,299,423,25,34,UCBPlayer
24066,UCBPlayer,115,170,285,10,75,UCBPlayer
24067,UCBPlayer,120,315,435,25,30,UCBPlayer
24068,UCBPlayer,119,154,273,10,79,UCBPlayer
24069,UCBPlayer,112,332,444,25,27,UCBPlayer
24070,UCBPlayer,127,137,264,10,82,UCBPlayer
24071,UCBPlayer,104,349,453,25,24,UCBPlayer
24072,UCBPlayer,126,126,252,7,85,Tie
24073,UCBPlayer,111,351,462,28,22,UCBPlayer
24074,UCBPlayer,116,126,242,3,87,UCBPlayer
24075,UCBPlayer,122,347,469,32,21,UCBPlayer
24076,UCBPlayer,107,132,239,0,87,UCBPlayer
24077,UCBPlayer,132,337,469,35,22,UCBPlayer
24078,UCBPlayer,103,148,251,0,83,UCBPlayer
24079,UCBPlayer,136,321,457,35,26,UCBPlayer
24080,UCBPlayer,99,164,263,0,79,UCBPlayer
24081,UCBPlayer,140,305,445,35,30,UCBPlayer
24082,UCBPlayer,95,180,275,0,75,UCBPlayer
24083,UCBPlayer,144,289,433,35,34,UCBPlayer
24084,UCBPlayer,91,196,287,0,71,UCBPlayer
24085,UCBPlayer,148,273,421,35,38,UCBPlayer
24086,UCBPlayer,87,212,299,0,67,UCBPlayer
24087,UCBPlayer,152,257,409,35,42,UCBPlayer
24088,UCBPlayer,84,224,308,0,64,UCBPlayer
24089,UCBPlayer,146,251,397,32,45,UCBPlayer
24090,UCBPlayer,89,234,323,3,60,UCBPlayer
24091,UCBPlayer,138,243,381,28,49,UCBPlayer
24092,UCBPlayer,97,242,339,7,56,UCBPlayer
24093,UCBPlayer,130,235,365,24,53,UCBPlayer
24094,UCBPlayer,105,250,355,11,52,UCBPlayer
24095,UCBPlayer,122,227,349,20,57,UCBPlayer
24096,UCBPlayer,109,259,368,15,49,UCBPlayer
24097,UCBPlayer,118,218,336,16,60,UCBPlayer
24098,UCBPlayer,117,267,384,19,45,UCBPlayer
24099,UCBPlayer,110,210,320,12,64,UCBPlayer
24100,UCBPlayer,126,271,397,23,42,UCBPlayer
24101,UCBPlayer,105,210,315,10,65,UCBPlayer
24102,UCBPlayer,130,275,405,25,40,UCBPlayer
24103,UCBPlayer,105,210,315,10,65,UCBPlayer
24104,UCBPlayer,130,275,405,25,40,UCBPlayer
24105,UCBPlayer,106,206,312,10,66,UCBPlayer
24106,UCBPlayer,130,275,405,25,40,UCBPlayer
24107,UCBPlayer,105,210,315,10,65,UCBPlayer
24108,UCBPlayer,131,271,402,25,41,UCBPlayer
24109,UCBPlayer,105,210,315,10,65,UCBPlayer
24110,UCBPlayer,130,275,405,25,40,UCBPlayer
24111,UCBPlayer,105,210,315,10,65,UCBPlayer
24112,UCBPlayer,130,275,405,25,40,UCBPlayer
24113,UCBPlayer,103,203,306,10,68,UCBPlayer
24114,UCBPlayer,128,283,411,25,38,UCBPlayer
24115,UCBPlayer,111,186,297,10,71,UCBPlayer
24116,UCBPlayer,124,299,423,25,34,UCBPlayer
24117,UCBPlayer,115,170,285,10,75,UCBPlayer
24118,UCBPlayer,120,315,435,25,30,UCBPlayer
24119,UCBPlayer,119,154,273,10,79,UCBPlayer
24120,UCBPlayer,112,332,444,25,27,UCBPlayer
24121,UCBPlayer,127,137,264,10,82,UCBPlayer
24122,UCBPlayer,104,349,453,25,24,UCBPlayer
24123,UCBPlayer,126,126,252,7,85,Tie
24124,UCBPlayer,111,351,462,28,22,UCBPlayer
24125,UCBPlayer,116,126,242,3,87,UCBPlayer
24126,UCBPlayer,122,347,469,32,21,UCBPlayer
24127,UCBPlayer,107,132,239,0,87,UCBPlayer
24128,UCBPlayer,132,337,469,35,22,UCBPlayer
24129,UCBPlayer,103,148,251,0,83,UCBPlayer
24130,UCBPlayer,136,321,457,35,26,UCBPlayer
24131,UCBPlayer,99,164,263,0,79,UCBPlayer
24132,UCBPlayer,140,305,445,35,30,UCBPlayer
24133,UCBPlayer,95,180,275,0,75,UCBPlayer
24134,UCBPlayer,144,289,433,35,34,UCBPlayer
24135,UCBPlayer,91,196,287,0,71,UCBPlayer
24136,UCBPlayer,148,273,421,35,38,UCBPlayer
24137,UCBPlayer,87,212,299,0,67,UCBPlayer
24138,UCBPlayer,152,257,409,35,42,UCBPlayer
24139,UCBPlayer,84,224,308,0,64,UCBPlayer
24140,UCBPlayer,146,251,397,32,45,UCBPlayer
24141,UCBPlayer,89,234,323,3,60,UCBPlayer
24142,UCBPlayer,138,243,381,28,49,UCBPlayer
24143,UCBPlayer,97,242,339,7,56,UCBPlayer
24144,UCBPlayer,130,235,365,24,53,UCBPlayer
24145,UCBPlayer,105,250,355,11,52,UCBPlayer
24146,UCBPlayer,122,227,349,20,57,UCBPlayer
24147,UCBPlayer,109,259,368,15,49,UCBPlayer
24148,UCBPlayer,118,218,336,16,60,UCBPlayer
24149,UCBPlayer,117,267,384,19,45,UCBPlayer
24150,UCBPlayer,110,210,320,12,64,UCBPlayer
24151,UCBPlayer,126,271,397,23,42,UCBPlayer
24152,UCBPlayer,105,210,315,10,65,UCBPlayer
24153,UCBPlayer,130,275,405,25,40,UCBPlayer
24154,UCBPlayer,105,210,315,10,65,UCBPlayer
24155,UCBPlayer,130,275,405,25,40,UCBPlayer
24156,UCBPlayer,106,206,312,10,66,UCBPlayer
24157,UCBPlayer,130,275,405,25,40,UCBPlayer
24158,UCBPlayer,105,210,315,10,65,UCBPlayer
24159,UCBPlayer,131,271,402,25,41,UCBPlayer
24160,UCBPlayer,105,210,315,10,65,UCBPlayer
24161,UCBPlayer,130,275,405,25,40,UCBPlayer
24162,UCBPlayer,105,210,315,10,65,UCBPlayer
24163,UCBPlayer,130,275,405,25,40,UCBPlayer
24164,UCBPlayer,103,203,306,10,68,UCBPlayer
24165,UCBPlayer,128,283,411,25,38,UCBPlayer
24166,UCBPlayer,111,186,297,10,71,UCBPlayer
24167,UCBPlayer,124,299,423,25,34,UCBPlayer
24168,UCBPlayer,115,170,285,10,75,UCBPlayer
24169,UCBPlayer,120,315,435,25,30,UCBPlayer
24170,UCBPlayer,119,154,273,10,79,UCBPlayer
24171,UCBPlayer,112,332,444,25,27,UCBPlayer
24172,UCBPlayer,127,137,264,10,82,UCBPlayer
24173,UCBPlayer,104,349,453,25,24,UCBPlayer
24174,UCBPlayer,126,126,252,7,85,Tie
24175,UCBPlayer,111,351,462,28,22,UCBPlayer
24176,UCBPlayer,116,126,242,3,87,UCBPlayer
24177,UCBPlayer,122,347,469,32,21,UCBPlayer
24178,UCBPlayer,107,132,239,0,87,UCBPlayer
24179,UCBPlayer,132,337,469,35,22,UCBPlayer
24180,UCBPlayer,103,148,251,0,83,UCBPlayer
24181,UCBPlayer,136,321,457,35,26,UCBPlayer
24182,UCBPlayer,99,164,263,0,79,UCBPlayer
24183,UCBPlayer,140,305,445,35,30,UCBPlayer
24184,UCBPlayer,95,180,275,0,75,UCBPlayer
24185,UCBPlayer,144,289,433,35,34,UCBPlayer
24186,UCBPlayer,91,196,287,0,71,UCBPlayer
24187,UCBPlayer,148,273,421,35,38,UCBPlayer
24188,UCBPlayer,87,212,299,0,67,UCBPlayer
24189,UCBPlayer,152,257,409,35,42,UCBPlayer
24190,UCBPlayer,84,224,308,0,64,UCBPlayer
24191,UCBPlayer,146,251,397,32,45,UCBPlayer
24192,UCBPlayer,89,234,323,3,60,UCBPlayer
24193,UCBPlayer,138,243,381,28,49,UCBPlayer
24194,UCBPlayer,97,242,339,7,56,UCBPlayer
24195,UCBPlayer,130,235,365,24,53,UCBPlayer
24196,UCBPlayer,105,250,355,11,52,UCBPlayer
24197,UCBPlayer,122,227,349,20,57,UCBPlayer
24198,UCBPlayer,109,259,368,15,49,UCBPlayer
24199,UCBPlayer,118,218,336,16,60,UCBPlayer
24200,UCBPlayer,117,267,384,19,45,UCBPlayer
24201,UCBPlayer,110,210,320,12,64,UCBPlayer
24202,UCBPlayer,126,271,397,23,42,UCBPlayer
24203,UCBPlayer,105,210,315,10,65,UCBPlayer
24204,UCBPlayer,130,275,405,25,40,UCBPlayer
24205,UCBPlayer,105,210,315,10,65,UCBPlayer
24206,UCBPlayer,130,275,405,25,40,UCBPlayer
24207,UCBPlayer,106,206,312,10,66,UCBPlayer
24208,UCBPlayer,130,275,405,25,40,UCBPlayer
24209,UCBPlayer,105,210,315,10,65,UCBPlayer
24210,UCBPlayer,131,271,402,25,41,UCBPlayer
24211,UCBPlayer,105,210,315,10,65,UCBPlayer
24212,UCBPlayer,130,275,405,25,40,UCBPlayer
24213,UCBPlayer,105,210,315,10,65,UCBPlayer
24214,UCBPlayer,130,275,405,25,40,UCBPlayer
24215,UCBPlayer,103,203,306,10,68,UCBPlayer
24216,UCBPlayer,128,283,411,25,38,UCBPlayer
24217,UCBPlayer,111,186,297,10,71,UCBPlayer
24218,UCBPlayer,124,299,423,25,34,UCBPlayer
24219,UCBPlayer,115,170,285,10,75,UCBPlayer
24220,UCBPlayer,120,315,435,25,30,UCBPlayer
24221,UCBPlayer,119,154,273,10,79,UCBPlayer
24222,UCBPlayer,112,332,444,25,27,UCBPlayer
24223,UCBPlayer,127,137,264,10,82,UCBPlayer
24224,UCBPlayer,104,349,453,25,24,UCBPlayer
24225,UCBPlayer,126,126,252,7,85,Tie
24226,UCBPlayer,111,351,462,28,22,UCBPlayer
24227,UCBPlayer,116,126,242,3,87,UCBPlayer
24228,UCBPlayer,122,347,469,32,21,UCBPlayer
24229,UCBPlayer,107,132,239,0,87,UCBPlayer
24230,UCBPlayer,132,337,469,35,22,UCBPlayer
24231,UCBPlayer,103,148,251,0,83,UCBPlayer
24232,UCBPlayer,136,321,457,35,26,UCBPlayer
24233,UCBPlayer,99,164,263,0,79,UCBPlayer
24234,UCBPlayer,140,305,445,35,30,UCBPlayer
24235,UCBPlayer,95,180,275,0,75,UCBPlayer
24236,UCBPlayer,144,289,433,35,34,UCBPlayer
24237,UCBPlayer,91,196,287,0,71,UCBPlayer
24238,UCBPlayer,148,273,421,35,38,UCBPlayer
24239,UCBPlayer,87,212,299,0,67,UCBPlayer
24240,UCBPlayer,152,257,409,35,42,UCBPlayer
24241,UCBPlayer,84,224,308,0,64,UCBPlayer
24242,UCBPlayer,146,251,397,32,45,UCBPlayer
24243,UCBPlayer,89,234,323,3,60,UCBPlayer
24244,UCBPlayer,138,243,381,28,49,UCBPlayer
24245,UCBPlayer,97,242,339,7,56,UCBPlayer
24246,UCBPlayer,130,235,365,24,53,UCBPlayer
24247,UCBPlayer,105,250,355,11,52,UCBPlayer
24248,UCBPlayer,122,227,349,20,57,UCBPlayer
24249,UCBPlayer,109,259,368,15,49,UCBPlayer
24250,UCBPlayer,118,218,336,16,60,UCBPlayer
24251,UCBPlayer,117,267,384,19,45,UCBPlayer
24252,UCBPlayer,110,210,320,12,64,UCBPlayer
24253,UCBPlayer,126,271,397,23,42,UCBPlayer
24254,UCBPlayer,105,210,315,10,65,UCBPlayer
24255,UCBPlayer,130,275,405,25,40,UCBPlayer
24256,UCBPlayer,105,210,315,10,65,UCBPlayer
24257,UCBPlayer,130,275,405,25,40,UCBPlayer
24258,UCBPlayer,106,206,312,10,66,UCBPlayer
24259,UCBPlayer,130,275,405,25,40,UCBPlayer
24260,UCBPlayer,105,210,315,10,65,UCBPlayer
24261,UCBPlayer,131,271,402,25,41,UCBPlayer
24262,UCBPlayer,105,210,315,10,65,UCBPlayer
24263,UCBPlayer,130,275,405,25,40,UCBPlayer
24264,UCBPlayer,105,210,315,10,65,UCBPlayer
24265,UCBPlayer,130,275,405,25,40,UCBPlayer
24266,UCBPlayer,103,203,306,10,68,UCBPlayer
24267,UCBPlayer,128,283,411,25,38,UCBPlayer
24268,UCBPlayer,111,186,297,10,71,UCBPlayer
24269,UCBPlayer,124,299,423,25,34,UCBPlayer
24270,UCBPlayer,115,170,285,10,75,UCBPlayer
24271,UCBPlayer,120,315,435,25,30,UCBPlayer
24272,UCBPlayer,119,154,273,10,79,UCBPlayer
24273,UCBPlayer,112,332,444,25,27,UCBPlayer
24274,UCBPlayer,127,137,264,10,82,UCBPlayer
24275,UCBPlayer,104,349,453,25,24,UCBPlayer
24276,UCBPlayer,126,126,252,7,85,Tie
24277,UCBPlayer,111,351,462,28,22,UCBPlayer
24278,UCBPlayer,116,126,242,3,87,UCBPlayer
24279,UCBPlayer,122,347,469,32,21,UCBPlayer
24280,UCBPlayer,107,132,239,0,87,UCBPlayer
24281,UCBPlayer,132,337,469,35,22,UCBPlayer
24282,UCBPlayer,103,148,251,0,83,UCBPlayer
24283,UCBPlayer,136,321,457,35,26,UCBPlayer
24284,UCBPlayer,99,164,263,0,79,UCBPlayer
24285,UCBPlayer,140,305,445,35,30,UCBPlayer
24286,UCBPlayer,95,180,275,0,75,UCBPlayer
24287,UCBPlayer,144,289,433,35,34,UCBPlayer
24288,UCBPlayer,91,196,287,0,71,UCBPlayer
24289,UCBPlayer,148,273,421,35,38,UCBPlayer
24290,UCBPlayer,87,212,299,0,67,UCBPlayer
24291,UCBPlayer,152,257,409,35,42,UCBPlayer
24292,UCBPlayer,84,224,308,0,64,UCBPlayer
24293,UCBPlayer,146,251,397,32,45,UCBPlayer
24294,UCBPlayer,89,234,323,3,60,UCBPlayer
24295,UCBPlayer,138,243,381,28,49,UCBPlayer
24296,UCBPlayer,97,242,339,7,56,UCBPlayer
24297,UCBPlayer,130,235,365,24,53,UCBPlayer
24298,UCBPlayer,105,250,355,11,52,UCBPlayer
24299,UCBPlayer,122,227,349,20,57,UCBPlayer
24300,UCBPlayer,109,259,368,15,49,UCBPlayer
24301,UCBPlayer,118,218,336,16,60,UCBPlayer
24302,UCBPlayer,117,267,384,19,45,UCBPlayer
24303,UCBPlayer,110,210,320,12,64,UCBPlayer
24304,UCBPlayer,126,271,397,23,42,UCBPlayer
24305,UCBPlayer,105,210,315,10,65,UCBPlayer
24306,UCBPlayer,130,275,405,25,40,UCBPlayer
24307,UCBPlayer,105,210,315,10,65,UCBPlayer
24308,UCBPlayer,130,275,405,25,40,UCBPlayer
24309,UCBPlayer,106,206,312,10,66,UCBPlayer
24310,UCBPlayer,130,275,405,25,40,UCBPlayer
24311,UCBPlayer,105,210,315,10,65,UCBPlayer
24312,UCBPlayer,131,271,402,25,41,UCBPlayer
24313,UCBPlayer,105,210,315,10,65,UCBPlayer
24314,UCBPlayer,130,275,405,25,40,UCBPlayer
24315,UCBPlayer,105,210,315,10,65,UCBPlayer
24316,UCBPlayer,130,275,405,25,40,UCBPlayer
24317,UCBPlayer,103,203,306,10,68,UCBPlayer
24318,UCBPlayer,128,283,411,25,38,UCBPlayer
24319,UCBPlayer,111,186,297,10,71,UCBPlayer
24320,UCBPlayer,124,299,423,25,34,UCBPlayer
24321,UCBPlayer,115,170,285,10,75,UCBPlayer
24322,UCBPlayer,120,315,435,25,30,UCBPlayer
24323,UCBPlayer,119,154,273,10,79,UCBPlayer
24324,UCBPlayer,112,332,444,25,27,UCBPlayer
24325,UCBPlayer,127,137,264,10,82,UCBPlayer
24326,UCBPlayer,104,349,453,25,24,UCBPlayer
24327,UCBPlayer,126,126,252,7,85,Tie
24328,UCBPlayer,111,351,462,28,22,UCBPlayer
24329,UCBPlayer,116,126,242,3,87,UCBPlayer
24330,UCBPlayer,122,347,469,32,21,UCBPlayer
24331,UCBPlayer,107,132,239,0,87,UCBPlayer
24332,UCBPlayer,132,337,469,35,22,UCBPlayer
24333,UCBPlayer,103,148,251,0,83,UCBPlayer
24334,UCBPlayer,136,321,457,35,26,UCBPlayer
24335,UCBPlayer,99,164,263,0,79,UCBPlayer
24336,UCBPlayer,140,305,445,35,30,UCBPlayer
24337,UCBPlayer,95,180,275,0,75,UCBPlayer
24338,UCBPlayer,144,289,433,35,34,UCBPlayer
24339,UCBPlayer,91,196,287,0,71,UCBPlayer
24340,UCBPlayer,148,273,421,35,38,UCBPlayer
24341,UCBPlayer,87,212,299,0,67,UCBPlayer
24342,UCBPlayer,152,257,409,35,42,UCBPlayer
24343,UCBPlayer,84,224,308,0,64,UCBPlayer
24344,UCBPlayer,146,251,397,32,45,UCBPlayer
24345,UCBPlayer,89,234,323,3,60,UCBPlayer
24346,UCBPlayer,138,243,381,28,49,UCBPlayer
24347,UCBPlayer,97,242,339,7,56,UCBPlayer
24348,UCBPlayer,130,235,365,24,53,UCBPlayer
24349,UCBPlayer,105,250,355,11,52,UCBPlayer
24350,UCBPlayer,122,227,349,20,57,UCBPlayer
24351,UCBPlayer,109,259,368,15,49,UCBPlayer
24352,UCBPlayer,118,218,336,16,60,UCBPlayer
24353,UCBPlayer,117,267,384,19,45,UCBPlayer
24354,UCBPlayer,110,210,320,12,64,UCBPlayer
24355,UCBPlayer,126,271,397,23,42,UCBPlayer
24356,UCBPlayer,105,210,315,10,65,UCBPlayer
24357,UCBPlayer,130,275,405,25,40,UCBPlayer
24358,UCBPlayer,105,210,315,10,65,UCBPlayer
24359,UCBPlayer,130,275,405,25,40,UCBPlayer
24360,UCBPlayer,106,206,312,10,66,UCBPlayer
24361,UCBPlayer,130,275,405,25,40,UCBPlayer
24362,UCBPlayer,105,210,315,10,65,UCBPlayer
24363,UCBPlayer,131,271,402,25,41,UCBPlayer
24364,UCBPlayer,105,210,315,10,65,UCBPlayer
24365,UCBPlayer,130,275,405,25,40,UCBPlayer
24366,UCBPlayer,105,210,315,10,65,UCBPlayer
24367,UCBPlayer,130,275,405,25,40,UCBPlayer
24368,UCBPlayer,103,203,306,10,68,UCBPlayer
24369,UCBPlayer,128,283,411,25,38,UCBPlayer
24370,UCBPlayer,111,186,297,10,71,UCBPlayer
24371,UCBPlayer,124,299,423,25,34,UCBPlayer
24372,UCBPlayer,115,170,285,10,75,UCBPlayer
24373,UCBPlayer,120,315,435,25,30,UCBPlayer
24374,UCBPlayer,119,154,273,10,79,UCBPlayer
24375,UCBPlayer,112,332,444,25,27,UCBPlayer
24376,UCBPlayer,127,137,264,10,82,UCBPlayer
24377,UCBPlayer,104,349,453,25,24,UCBPlayer
24378,UCBPlayer,126,126,252,7,85,Tie
24379,UCBPlayer,111,351,462,28,22,UCBPlayer
24380,UCBPlayer,116,126,242,3,87,UCBPlayer
24381,UCBPlayer,122,347,469,32,21,UCBPlayer
24382,UCBPlayer,107,132,239,0,87,UCBPlayer
24383,UCBPlayer,132,337,469,35,22,UCBPlayer
24384,UCBPlayer,103,148,251,0,83,UCBPlayer
24385,UCBPlayer,136,321,457,35,26,UCBPlayer
24386,UCBPlayer,99,164,263,0,79,UCBPlayer
24387,UCBPlayer,140,305,445,35,30,UCBPlayer
24388,UCBPlayer,95,180,275,0,75,UCBPlayer
24389,UCBPlayer,144,289,433,35,34,UCBPlayer
24390,UCBPlayer,91,196,287,0,71,UCBPlayer
24391,UCBPlayer,148,273,421,35,38,UCBPlayer
24392,UCBPlayer,87,212,299,0,67,UCBPlayer
24393,UCBPlayer,152,257,409,35,42,UCBPlayer
24394,UCBPlayer,84,224,308,0,64,UCBPlayer
24395,UCBPlayer,146,251,397,32,45,UCBPlayer
24396,UCBPlayer,89,234,323,3,60,UCBPlayer
24397,UCBPlayer,138,243,381,28,49,UCBPlayer
24398,UCBPlayer,97,242,339,7,56,UCBPlayer
24399,UCBPlayer,130,235,365,24,53,UCBPlayer
24400,UCBPlayer,105,250,355,11,52,UCBPlayer
24401,UCBPlayer,122,227,349,20,57,UCBPlayer
24402,UCBPlayer,109,259,368,15,49,UCBPlayer
24403,UCBPlayer,118,218,336,16,60,UCBPlayer
24404,UCBPlayer,117,267,384,19,45,UCBPlayer
24405,UCBPlayer,110,210,320,12,64,UCBPlayer
24406,UCBPlayer,126,271,397,23,42,UCBPlayer
24407,UCBPlayer,105,210,315,10,65,UCBPlayer
24408,UCBPlayer,130,275,405,25,40,UCBPlayer
24409,UCBPlayer,105,210,315,10,65,UCBPlayer
24410,UCBPlayer,130,275,405,25,40,UCBPlayer
24411,UCBPlayer,106,206,312,10,66,UCBPlayer
24412,UCBPlayer,130,275,405,25,40,UCBPlayer
24413,UCBPlayer,105,210,315,10,65,UCBPlayer
24414,UCBPlayer,131,271,402,25,41,UCBPlayer
24415,UCBPlayer,105,210,315,10,65,UCBPlayer
24416,UCBPlayer,130,275,405,25,40,UCBPlayer
24417,UCBPlayer,105,210,315,10,65,UCBPlayer
24418,UCBPlayer,130,275,405,25,40,UCBPlayer
24419,UCBPlayer,103,203,306,10,68,UCBPlayer
24420,UCBPlayer,128,283,411,25,38,UCBPlayer
24421,UCBPlayer,111,186,297,10,71,UCBPlayer
24422,UCBPlayer,124,299,423,25,34,UCBPlayer
24423,UCBPlayer,115,170,285,10,75,UCBPlayer
24424,UCBPlayer,120,315,435,25,30,UCBPlayer
24425,UCBPlayer,119,154,273,10,79,UCBPlayer
24426,UCBPlayer,112,332,444,25,27,UCBPlayer
24427,UCBPlayer,127,137,264,10,82,UCBPlayer
24428,UCBPlayer,104,349,453,25,24,UCBPlayer
24429,UCBPlayer,126,126,252,7,85,Tie
24430,UCBPlayer,111,351,462,28,22,UCBPlayer
24431,UCBPlayer,116,126,242,3,87,UCBPlayer
24432,UCBPlayer,122,347,469,32,21,UCBPlayer
24433,UCBPlayer,107,132,239,0,87,UCBPlayer
24434,UCBPlayer,132,337,469,35,22,UCBPlayer
24435,UCBPlayer,103,148,251,0,83,UCBPlayer
24436,UCBPlayer,136,321,457,35,26,UCBPlayer
24437,UCBPlayer,99,164,263,0,79,UCBPlayer
24438,UCBPlayer,140,305,445,35,30,UCBPlayer
24439,UCBPlayer,95,180,275,0,75,UCBPlayer
24440,UCBPlayer,144,289,433,35,34,UCBPlayer
24441,UCBPlayer,91,196,287,0,71,UCBPlayer
24442,UCBPlayer,148,273,421,35,38,UCBPlayer
24443,UCBPlayer,87,212,299,0,67,UCBPlayer
24444,UCBPlayer,152,257,409,35,42,UCBPlayer
24445,UCBPlayer,84,224,308,0,64,UCBPlayer
24446,UCBPlayer,146,251,397,32,45,UCBPlayer
24447,UCBPlayer,89,234,323,3,60,UCBPlayer
24448,UCBPlayer,138,243,381,28,49,UCBPlayer
24449,UCBPlayer,97,242,339,7,56,UCBPlayer
24450,UCBPlayer,130,235,365,24,53,UCBPlayer
24451,UCBPlayer,105,250,355,11,52,UCBPlayer
24452,UCBPlayer,122,227,349,20,57,UCBPlayer
24453,UCBPlayer,109,259,368,15,49,UCBPlayer
24454,UCBPlayer,118,218,336,16,60,UCBPlayer
24455,UCBPlayer,117,267,384,19,45,UCBPlayer
24456,UCBPlayer,110,210,320,12,64,UCBPlayer
24457,UCBPlayer,126,271,397,23,42,UCBPlayer
24458,UCBPlayer,105,210,315,10,65,UCBPlayer
24459,UCBPlayer,130,275,405,25,40,UCBPlayer
24460,UCBPlayer,105,210,315,10,65,UCBPlayer
24461,UCBPlayer,130,275,405,25,40,UCBPlayer
24462,UCBPlayer,106,206,312,10,66,UCBPlayer
24463,UCBPlayer,130,275,405,25,40,UCBPlayer
24464,UCBPlayer,105,210,315,10,65,UCBPlayer
24465,UCBPlayer,131,271,402,25,41,UCBPlayer
24466,UCBPlayer,105,210,315,10,65,UCBPlayer
24467,UCBPlayer,130,275,405,25,40,UCBPlayer
24468,UCBPlayer,105,210,315,10,65,UCBPlayer
24469,UCBPlayer,130,275,405,25,40,UCBPlayer
24470,UCBPlayer,103,203,306,10,68,UCBPlayer
24471,UCBPlayer,128,283,411,25,38,UCBPlayer
24472,UCBPlayer,111,186,297,10,71,UCBPlayer
24473,UCBPlayer,124,299,423,25,34,UCBPlayer
24474,UCBPlayer,115,170,285,10,75,UCBPlayer
24475,UCBPlayer,120,315,435,25,30,UCBPlayer
24476,UCBPlayer,119,154,273,10,79,UCBPlayer
24477,UCBPlayer,112,332,444,25,27,UCBPlayer
24478,UCBPlayer,127,137,264,10,82,UCBPlayer
24479,UCBPlayer,104,349,453,25,24,UCBPlayer
24480,UCBPlayer,126,126,252,7,85,Tie
24481,UCBPlayer,111,351,462,28,22,UCBPlayer
24482,UCBPlayer,116,126,242,3,87,UCBPlayer
24483,UCBPlayer,122,347,469,32,21,UCBPlayer
24484,UCBPlayer,107,132,239,0,87,UCBPlayer
24485,UCBPlayer,132,337,469,35,22,UCBPlayer
24486,UCBPlayer,103,148,251,0,83,UCBPlayer
24487,UCBPlayer,136,321,457,35,26,UCBPlayer
24488,UCBPlayer,99,164,263,0,79,UCBPlayer
24489,UCBPlayer,140,305,445,35,30,UCBPlayer
24490,UCBPlayer,95,180,275,0,75,UCBPlayer
24491,UCBPlayer,144,289,433,35,34,UCBPlayer
24492,UCBPlayer,91,196,287,0,71,UCBPlayer
24493,UCBPlayer,148,273,421,35,38,UCBPlayer
24494,UCBPlayer,87,212,299,0,67,UCBPlayer
24495,UCBPlayer,152,257,409,35,42,UCBPlayer
24496,UCBPlayer,84,224,308,0,64,UCBPlayer
24497,UCBPlayer,146,251,397,32,45,UCBPlayer
24498,UCBPlayer,89,234,323,3,60,UCBPlayer
24499,UCBPlayer,138,243,381,28,49,UCBPlayer
24500,UCBPlayer,97,242,339,7,56,UCBPlayer
24501,UCBPlayer,130,235,365,24,53,UCBPlayer
24502,UCBPlayer,105,250,355,11,52,UCBPlayer
24503,UCBPlayer,122,227,349,20,57,UCBPlayer
24504,UCBPlayer,109,259,368,15,49,UCBPlayer
24505,UCBPlayer,118,218,336,16,60,UCBPlayer
24506,UCBPlayer,117,267,384,19,45,UCBPlayer
24507,UCBPlayer,110,210,320,12,64,UCBPlayer
24508,UCBPlayer,126,271,397,23,42,UCBPlayer
24509,UCBPlayer,105,210,315,10,65,UCBPlayer
24510,UCBPlayer,130,275,405,25,40,UCBPlayer
24511,UCBPlayer,105,210,315,10,65,UCBPlayer
24512,UCBPlayer,130,275,405,25,40,UCBPlayer
24513,UCBPlayer,106,206,312,10,66,UCBPlayer
24514,UCBPlayer,130,275,405,25,40,UCBPlayer
24515,UCBPlayer,105,210,315,10,65,UCBPlayer
24516,UCBPlayer,131,271,402,25,41,UCBPlayer
24517,UCBPlayer,105,210,315,10,65,UCBPlayer
24518,UCBPlayer,130,275,405,25,40,UCBPlayer
24519,UCBPlayer,105,210,315,10,65,UCBPlayer
24520,UCBPlayer,130,275,405,25,40,UCBPlayer
24521,UCBPlayer,103,203,306,10,68,UCBPlayer
24522,UCBPlayer,128,283,411,25,38,UCBPlayer
24523,UCBPlayer,111,186,297,10,71,UCBPlayer
24524,UCBPlayer,124,299,423,25,34,UCBPlayer
24525,UCBPlayer,115,170,285,10,75,UCBPlayer
24526,UCBPlayer,120,315,435,25,30,UCBPlayer
24527,UCBPlayer,119,154,273,10,79,UCBPlayer
24528,UCBPlayer,112,332,444,25,27,UCBPlayer
24529,UCBPlayer,127,137,264,10,82,UCBPlayer
24530,UCBPlayer,104,349,453,25,24,UCBPlayer
24531,UCBPlayer,126,126,252,7,85,Tie
24532,UCBPlayer,111,351,462,28,22,UCBPlayer
24533,UCBPlayer,116,126,242,3,87,UCBPlayer
24534,UCBPlayer,122,347,469,32,21,UCBPlayer
24535,UCBPlayer,107,132,239,0,87,UCBPlayer
24536,UCBPlayer,132,337,469,35,22,UCBPlayer
24537,UCBPlayer,103,148,251,0,83,UCBPlayer
24538,UCBPlayer,136,321,457,35,26,UCBPlayer
24539,UCBPlayer,99,164,263,0,79,UCBPlayer
24540,UCBPlayer,140,305,445,35,30,UCBPlayer
24541,UCBPlayer,95,180,275,0,75,UCBPlayer
24542,UCBPlayer,144,289,433,35,34,UCBPlayer
24543,UCBPlayer,91,196,287,0,71,UCBPlayer
24544,UCBPlayer,148,273,421,35,38,UCBPlayer
24545,UCBPlayer,87,212,299,0,67,UCBPlayer
24546,UCBPlayer,152,257,409,35,42,UCBPlayer
24547,UCBPlayer,84,224,308,0,64,UCBPlayer
24548,UCBPlayer,146,251,397,32,45,UCBPlayer
24549,UCBPlayer,89,234,323,3,60,UCBPlayer
24550,UCBPlayer,138,243,381,28,49,UCBPlayer
24551,UCBPlayer,97,242,339,7,56,UCBPlayer
24552,UCBPlayer,130,235,365,24,53,UCBPlayer
24553,UCBPlayer,105,250,355,11,52,UCBPlayer
24554,UCBPlayer,122,227,349,20,57,UCBPlayer
24555,UCBPlayer,109,259,368,15,49,UCBPlayer
24556,UCBPlayer,118,218,336,16,60,UCBPlayer
24557,UCBPlayer,117,267,384,19,45,UCBPlayer
24558,UCBPlayer,110,210,320,12,64,UCBPlayer
24559,UCBPlayer,126,271,397,23,42,UCBPlayer
24560,UCBPlayer,105,210,315,10,65,UCBPlayer
24561,UCBPlayer,130,275,405,25,40,UCBPlayer
24562,UCBPlayer,105,210,315,10,65,UCBPlayer
24563,UCBPlayer,130,275,405,25,40,UCBPlayer
24564,UCBPlayer,106,206,312,10,66,UCBPlayer
24565,UCBPlayer,130,275,405,25,40,UCBPlayer
24566,UCBPlayer,105,210,315,10,65,UCBPlayer
24567,UCBPlayer,131,271,402,25,41,UCBPlayer
24568,UCBPlayer,105,210,315,10,65,UCBPlayer
24569,UCBPlayer,130,275,405,25,40,UCBPlayer
24570,UCBPlayer,105,210,315,10,65,UCBPlayer
24571,UCBPlayer,130,275,405,25,40,UCBPlayer
24572,UCBPlayer,103,203,306,10,68,UCBPlayer
24573,UCBPlayer,128,283,411,25,38,UCBPlayer
24574,UCBPlayer,111,186,297,10,71,UCBPlayer
24575,UCBPlayer,124,299,423,25,34,UCBPlayer
24576,UCBPlayer,115,170,285,10,75,UCBPlayer
24577,UCBPlayer,120,315,435,25,30,UCBPlayer
24578,UCBPlayer,119,154,273,10,79,UCBPlayer
24579,UCBPlayer,112,332,444,25,27,UCBPlayer
24580,UCBPlayer,127,137,264,10,82,UCBPlayer
24581,UCBPlayer,104,349,453,25,24,UCBPlayer
24582,UCBPlayer,126,126,252,7,85,Tie
24583,UCBPlayer,111,351,462,28,22,UCBPlayer
24584,UCBPlayer,116,126,242,3,87,UCBPlayer
24585,UCBPlayer,122,347,469,32,21,UCBPlayer
24586,UCBPlayer,107,132,239,0,87,UCBPlayer
24587,UCBPlayer,132,337,469,35,22,UCBPlayer
24588,UCBPlayer,103,148,251,0,83,UCBPlayer
24589,UCBPlayer,136,321,457,35,26,UCBPlayer
24590,UCBPlayer,99,164,263,0,79,UCBPlayer
24591,UCBPlayer,140,305,445,35,30,UCBPlayer
24592,UCBPlayer,95,180,275,0,75,UCBPlayer
24593,UCBPlayer,144,289,433,35,34,UCBPlayer
24594,UCBPlayer,91,196,287,0,71,UCBPlayer
24595,UCBPlayer,148,273,421,35,38,UCBPlayer
24596,UCBPlayer,87,212,299,0,67,UCBPlayer
24597,UCBPlayer,152,257,409,35,42,UCBPlayer
24598,UCBPlayer,84,224,308,0,64,UCBPlayer
24599,UCBPlayer,146,251,397,32,45,UCBPlayer
24600,UCBPlayer,89,234,323,3,60,UCBPlayer
24601,UCBPlayer,138,243,381,28,49,UCBPlayer
24602,UCBPlayer,97,242,339,7,56,UCBPlayer
24603,UCBPlayer,130,235,365,24,53,UCBPlayer
24604,UCBPlayer,105,250,355,11,52,UCBPlayer
24605,UCBPlayer,122,227,349,20,57,UCBPlayer
24606,UCBPlayer,109,259,368,15,49,UCBPlayer
24607,UCBPlayer,118,218,336,16,60,UCBPlayer
24608,UCBPlayer,117,267,384,19,45,UCBPlayer
24609,UCBPlayer,110,210,320,12,64,UCBPlayer
24610,UCBPlayer,126,271,397,23,42,UCBPlayer
24611,UCBPlayer,105,210,315,10,65,UCBPlayer
24612,UCBPlayer,130,275,405,25,40,UCBPlayer
24613,UCBPlayer,105,210,315,10,65,UCBPlayer
24614,UCBPlayer,130,275,405,25,40,UCBPlayer
24615,UCBPlayer,106,206,312,10,66,UCBPlayer
24616,UCBPlayer,130,275,405,25,40,UCBPlayer
24617,UCBPlayer,105,210,315,10,65,UCBPlayer
24618,UCBPlayer,131,271,402,25,41,UCBPlayer
24619,UCBPlayer,105,210,315,10,65,UCBPlayer
24620,UCBPlayer,130,275,405,25,40,UCBPlayer
24621,UCBPlayer,105,210,315,10,65,UCBPlayer
24622,UCBPlayer,130,275,405,25,40,UCBPlayer
24623,UCBPlayer,103,203,306,10,68,UCBPlayer
24624,UCBPlayer,128,283,411,25,38,UCBPlayer
24625,UCBPlayer,111,186,297,10,71,UCBPlayer
24626,UCBPlayer,124,299,423,25,34,UCBPlayer
24627,UCBPlayer,115,170,285,10,75,UCBPlayer
24628,UCBPlayer,120,315,435,25,30,UCBPlayer
24629,UCBPlayer,119,154,273,10,79,UCBPlayer
24630,UCBPlayer,112,332,444,25,27,UCBPlayer
24631,UCBPlayer,127,137,264,10,82,UCBPlayer
24632,UCBPlayer,104,349,453,25,24,UCBPlayer
24633,UCBPlayer,126,126,252,7,85,Tie
24634,UCBPlayer,111,351,462,28,22,UCBPlayer
24635,UCBPlayer,116,126,242,3,87,UCBPlayer
24636,UCBPlayer,122,347,469,32,21,UCBPlayer
24637,UCBPlayer,107,132,239,0,87,UCBPlayer
24638,UCBPlayer,132,337,469,35,22,UCBPlayer
24639,UCBPlayer,103,148,251,0,83,UCBPlayer
24640,UCBPlayer,136,321,457,35,26,UCBPlayer
24641,UCBPlayer,99,164,263,0,79,UCBPlayer
24642,UCBPlayer,140,305,445,35,30,UCBPlayer
24643,UCBPlayer,95,180,275,0,75,UCBPlayer
24644,UCBPlayer,144,289,433,35,34,UCBPlayer
24645,UCBPlayer,91,196,287,0,71,UCBPlayer
24646,UCBPlayer,148,273,421,35,38,UCBPlayer
24647,UCBPlayer,87,212,299,0,67,UCBPlayer
24648,UCBPlayer,152,257,409,35,42,UCBPlayer
24649,UCBPlayer,84,224,308,0,64,UCBPlayer
24650,UCBPlayer,146,251,397,32,45,UCBPlayer
24651,UCBPlayer,89,234,323,3,60,UCBPlayer
24652,UCBPlayer,138,243,381,28,49,UCBPlayer
24653,UCBPlayer,97,242,339,7,56,UCBPlayer
24654,UCBPlayer,130,235,365,24,53,UCBPlayer
24655,UCBPlayer,105,250,355,11,52,UCBPlayer
24656,UCBPlayer,122,227,349,20,57,UCBPlayer
24657,UCBPlayer,109,259,368,15,49,UCBPlayer
24658,UCBPlayer,118,218,336,16,60,UCBPlayer
24659,UCBPlayer,117,267,384,19,45,UCBPlayer
24660,UCBPlayer,110,210,320,12,64,UCBPlayer
24661,UCBPlayer,126,271,397,23,42,UCBPlayer
24662,UCBPlayer,105,210,315,10,65,UCBPlayer
24663,UCBPlayer,130,275,405,25,40,UCBPlayer
24664,UCBPlayer,105,210,315,10,65,UCBPlayer
24665,UCBPlayer,130,275,405,25,40,UCBPlayer
24666,UCBPlayer,106,206,312,10,66,UCBPlayer
24667,UCBPlayer,130,275,405,25,40,UCBPlayer
24668,UCBPlayer,105,210,315,10,65,UCBPlayer
24669,UCBPlayer,131,271,402,25,41,UCBPlayer
24670,UCBPlayer,105,210,315,10,65,UCBPlayer
24671,UCBPlayer,130,275,405,25,40,UCBPlayer
24672,UCBPlayer,105,210,315,10,65,UCBPlayer
24673,UCBPlayer,130,275,405,25,40,UCBPlayer
24674,UCBPlayer,103,203,306,10,68,UCBPlayer
24675,UCBPlayer,128,283,411,25,38,UCBPlayer
24676,UCBPlayer,111,186,297,10,71,UCBPlayer
24677,UCBPlayer,124,299,423,25,34,UCBPlayer
24678,UCBPlayer,115,170,285,10,75,UCBPlayer
24679,UCBPlayer,120,315,435,25,30,UCBPlayer
24680,UCBPlayer,119,154,273,10,79,UCBPlayer
24681,UCBPlayer,112,332,444,25,27,UCBPlayer
24682,UCBPlayer,127,137,264,10,82,UCBPlayer
24683,UCBPlayer,104,349,453,25,24,UCBPlayer
24684,UCBPlayer,126,126,252,7,85,Tie
24685,UCBPlayer,111,351,462,28,22,UCBPlayer
24686,UCBPlayer,116,126,242,3,87,UCBPlayer
24687,UCBPlayer,122,347,469,32,21,UCBPlayer
24688,UCBPlayer,107,132,239,0,87,UCBPlayer
24689,UCBPlayer,132,337,469,35,22,UCBPlayer
24690,UCBPlayer,103,148,251,0,83,UCBPlayer
24691,UCBPlayer,136,321,457,35,26,UCBPlayer
24692,UCBPlayer,99,164,263,0,79,UCBPlayer
24693,UCBPlayer,140,305,445,35,30,UCBPlayer
24694,UCBPlayer,95,180,275,0,75,UCBPlayer
24695,UCBPlayer,144,289,433,35,34,UCBPlayer
24696,UCBPlayer,91,196,287,0,71,UCBPlayer
24697,UCBPlayer,148,273,421,35,38,UCBPlayer
24698,UCBPlayer,87,212,299,0,67,UCBPlayer
24699,UCBPlayer,152,257,409,35,42,UCBPlayer
24700,UCBPlayer,84,224,308,0,64,UCBPlayer
24701,UCBPlayer,146,251,397,32,45,UCBPlayer
24702,UCBPlayer,89,234,323,3,60,UCBPlayer
24703,UCBPlayer,138,243,381,28,49,UCBPlayer
24704,UCBPlayer,97,242,339,7,56,UCBPlayer
24705,UCBPlayer,130,235,365,24,53,UCBPlayer
24706,UCBPlayer,105,250,355,11,52,UCBPlayer
24707,UCBPlayer,122,227,349,20,57,UCBPlayer
24708,UCBPlayer,109,259,368,15,49,UCBPlayer
24709,UCBPlayer,118,218,336,16,60,UCBPlayer
24710,UCBPlayer,117,267,384,19,45,UCBPlayer
24711,UCBPlayer,110,210,320,12,64,UCBPlayer
24712,UCBPlayer,126,271,397,23,42,UCBPlayer
24713,UCBPlayer,105,210,315,10,65,UCBPlayer
24714,UCBPlayer,130,275,405,25,40,UCBPlayer
24715,UCBPlayer,105,210,315,10,65,UCBPlayer
24716,UCBPlayer,130,275,405,25,40,UCBPlayer
24717,UCBPlayer,106,206,312,10,66,UCBPlayer
24718,UCBPlayer,130,275,405,25,40,UCBPlayer
24719,UCBPlayer,105,210,315,10,65,UCBPlayer
24720,UCBPlayer,131,271,402,25,41,UCBPlayer
24721,UCBPlayer,105,210,315,10,65,UCBPlayer
24722,UCBPlayer,130,275,405,25,40,UCBPlayer
24723,UCBPlayer,105,210,315,10,65,UCBPlayer
24724,UCBPlayer,130,275,405,25,40,UCBPlayer
24725,UCBPlayer,103,203,306,10,68,UCBPlayer
24726,UCBPlayer,128,283,411,25,38,UCBPlayer
24727,UCBPlayer,111,186,297,10,71,UCBPlayer
24728,UCBPlayer,124,299,423,25,34,UCBPlayer
24729,UCBPlayer,115,170,285,10,75,UCBPlayer
24730,UCBPlayer,120,315,435,25,30,UCBPlayer
24731,UCBPlayer,119,154,273,10,79,UCBPlayer
24732,UCBPlayer,112,332,444,25,27,UCBPlayer
24733,UCBPlayer,127,137,264,10,82,UCBPlayer
24734,UCBPlayer,104,349,453,25,24,UCBPlayer
24735,UCBPlayer,126,126,252,7,85,Tie
24736,UCBPlayer,111,351,462,28,22,UCBPlayer
24737,UCBPlayer,116,126,242,3,87,UCBPlayer
24738,UCBPlayer,122,347,469,32,21,UCBPlayer
24739,UCBPlayer,107,132,239,0,87,UCBPlayer
24740,UCBPlayer,132,337,469,35,22,UCBPlayer
24741,UCBPlayer,103,148,251,0,83,UCBPlayer
24742,UCBPlayer,136,321,457,35,26,UCBPlayer
24743,UCBPlayer,99,164,263,0,79,UCBPlayer
24744,UCBPlayer,140,305,445,35,30,UCBPlayer
24745,UCBPlayer,95,180,275,0,75,UCBPlayer
24746,UCBPlayer,144,289,433,35,34,UCBPlayer
24747,UCBPlayer,91,196,287,0,71,UCBPlayer
24748,UCBPlayer,148,273,421,35,38,UCBPlayer
24749,UCBPlayer,87,212,299,0,67,UCBPlayer
24750,UCBPlayer,152,257,409,35,42,UCBPlayer
24751,UCBPlayer,84,224,308,0,64,UCBPlayer
24752,UCBPlayer,146,251,397,32,45,UCBPlayer
24753,UCBPlayer,89,234,323,3,60,UCBPlayer
24754,UCBPlayer,138,243,381,28,49,UCBPlayer
24755,UCBPlayer,97,242,339,7,56,UCBPlayer
24756,UCBPlayer,130,235,365,24,53,UCBPlayer
24757,UCBPlayer,105,250,355,11,52,UCBPlayer
24758,UCBPlayer,122,227,349,20,57,UCBPlayer
24759,UCBPlayer,109,259,368,15,49,UCBPlayer
24760,UCBPlayer,118,218,336,16,60,UCBPlayer
24761,UCBPlayer,117,267,384,19,45,UCBPlayer
24762,UCBPlayer,110,210,320,12,64,UCBPlayer
24763,UCBPlayer,126,271,397,23,42,UCBPlayer
24764,UCBPlayer,105,210,315,10,65,UCBPlayer
24765,UCBPlayer,130,275,405,25,40,UCBPlayer
24766,UCBPlayer,105,210,315,10,65,UCBPlayer
24767,UCBPlayer,130,275,405,25,40,UCBPlayer
24768,UCBPlayer,106,206,312,10,66,UCBPlayer
24769,UCBPlayer,130,275,405,25,40,UCBPlayer
24770,UCBPlayer,105,210,315,10,65,UCBPlayer
24771,UCBPlayer,131,271,402,25,41,UCBPlayer
24772,UCBPlayer,105,210,315,10,65,UCBPlayer
24773,UCBPlayer,130,275,405,25,40,UCBPlayer
24774,UCBPlayer,105,210,315,10,65,UCBPlayer
24775,UCBPlayer,130,275,405,25,40,UCBPlayer
24776,UCBPlayer,103,203,306,10,68,UCBPlayer
24777,UCBPlayer,128,283,411,25,38,UCBPlayer
24778,UCBPlayer,111,186,297,10,71,UCBPlayer
24779,UCBPlayer,124,299,423,25,34,UCBPlayer
24780,UCBPlayer,115,170,285,10,75,UCBPlayer
24781,UCBPlayer,120,315,435,25,30,UCBPlayer
24782,UCBPlayer,119,154,273,10,79,UCBPlayer
24783,UCBPlayer,112,332,444,25,27,UCBPlayer
24784,UCBPlayer,127,137,264,10,82,UCBPlayer
24785,UCBPlayer,104,349,453,25,24,UCBPlayer
24786,UCBPlayer,126,126,252,7,85,Tie
24787,UCBPlayer,111,351,462,28,22,UCBPlayer
24788,UCBPlayer,116,126,242,3,87,UCBPlayer
24789,UCBPlayer,122,347,469,32,21,UCBPlayer
24790,UCBPlayer,107,132,239,0,87,UCBPlayer
24791,UCBPlayer,132,337,469,35,22,UCBPlayer
24792,UCBPlayer,103,148,251,0,83,UCBPlayer
24793,UCBPlayer,136,321,457,35,26,UCBPlayer
24794,UCBPlayer,99,164,263,0,79,UCBPlayer
24795,UCBPlayer,140,305,445,35,30,UCBPlayer
24796,UCBPlayer,95,180,275,0,75,UCBPlayer
24797,UCBPlayer,144,289,433,35,34,UCBPlayer
24798,UCBPlayer,91,196,287,0,71,UCBPlayer
24799,UCBPlayer,148,273,421,35,38,UCBPlayer
24800,UCBPlayer,87,212,299,0,67,UCBPlayer
24801,UCBPlayer,152,257,409,35,42,UCBPlayer
24802,UCBPlayer,84,224,308,0,64,UCBPlayer
24803,UCBPlayer,146,251,397,32,45,UCBPlayer
24804,UCBPlayer,89,234,323,3,60,UCBPlayer
24805,UCBPlayer,138,243,381,28,49,UCBPlayer
24806,UCBPlayer,97,242,339,7,56,UCBPlayer
24807,UCBPlayer,130,235,365,24,53,UCBPlayer
24808,UCBPlayer,105,250,355,11,52,UCBPlayer
24809,UCBPlayer,122,227,349,20,57,UCBPlayer
24810,UCBPlayer,109,259,368,15,49,UCBPlayer
24811,UCBPlayer,118,218,336,16,60,UCBPlayer
24812,UCBPlayer,117,267,384,19,45,UCBPlayer
24813,UCBPlayer,110,210,320,12,64,UCBPlayer
24814,UCBPlayer,126,271,397,23,42,UCBPlayer
24815,UCBPlayer,105,210,315,10,65,UCBPlayer
24816,UCBPlayer,130,275,405,25,40,UCBPlayer
24817,UCBPlayer,105,210,315,10,65,UCBPlayer
24818,UCBPlayer,130,275,405,25,40,UCBPlayer
24819,UCBPlayer,106,206,312,10,66,UCBPlayer
24820,UCBPlayer,130,275,405,25,40,UCBPlayer
24821,UCBPlayer,105,210,315,10,65,UCBPlayer
24822,UCBPlayer,131,271,402,25,41,UCBPlayer
24823,UCBPlayer,105,210,315,10,65,UCBPlayer
24824,UCBPlayer,130,275,405,25,40,UCBPlayer
24825,UCBPlayer,105,210,315,10,65,UCBPlayer
24826,UCBPlayer,130,275,405,25,40,UCBPlayer
24827,UCBPlayer,103,203,306,10,68,UCBPlayer
24828,UCBPlayer,128,283,411,25,38,UCBPlayer
24829,UCBPlayer,111,186,297,10,71,UCBPlayer
24830,UCBPlayer,124,299,423,25,34,UCBPlayer
24831,UCBPlayer,115,170,285,10,75,UCBPlayer
24832,UCBPlayer,120,315,435,25,30,UCBPlayer
24833,UCBPlayer,119,154,273,10,79,UCBPlayer
24834,UCBPlayer,112,332,444,25,27,UCBPlayer
24835,UCBPlayer,127,137,264,10,82,UCBPlayer
24836,UCBPlayer,104,349,453,25,24,UCBPlayer
24837,UCBPlayer,126,126,252,7,85,Tie
24838,UCBPlayer,111,351,462,28,22,UCBPlayer
24839,UCBPlayer,116,126,242,3,87,UCBPlayer
24840,UCBPlayer,122,347,469,32,21,UCBPlayer
24841,UCBPlayer,107,132,239,0,87,UCBPlayer
24842,UCBPlayer,132,337,469,35,22,UCBPlayer
24843,UCBPlayer,103,148,251,0,83,UCBPlayer
24844,UCBPlayer,136,321,457,35,26,UCBPlayer
24845,UCBPlayer,99,164,263,0,79,UCBPlayer
24846,UCBPlayer,140,305,445,35,30,UCBPlayer
24847,UCBPlayer,95,180,275,0,75,UCBPlayer
24848,UCBPlayer,144,289,433,35,34,UCBPlayer
24849,UCBPlayer,91,196,287,0,71,UCBPlayer
24850,UCBPlayer,148,273,421,35,38,UCBPlayer
24851,UCBPlayer,87,212,299,0,67,UCBPlayer
24852,UCBPlayer,152,257,409,35,42,UCBPlayer
24853,UCBPlayer,84,224,308,0,64,UCBPlayer
24854,UCBPlayer,146,251,397,32,45,UCBPlayer
24855,UCBPlayer,89,234,323,3,60,UCBPlayer
24856,UCBPlayer,138,243,381,28,49,UCBPlayer
24857,UCBPlayer,97,242,339,7,56,UCBPlayer
24858,UCBPlayer,130,235,365,24,53,UCBPlayer
24859,UCBPlayer,105,250,355,11,52,UCBPlayer
24860,UCBPlayer,122,227,349,20,57,UCBPlayer
24861,UCBPlayer,109,259,368,15,49,UCBPlayer
24862,UCBPlayer,118,218,336,16,60,UCBPlayer
24863,UCBPlayer,117,267,384,19,45,UCBPlayer
24864,UCBPlayer,110,210,320,12,64,UCBPlayer
24865,UCBPlayer,126,271,397,23,42,UCBPlayer
24866,UCBPlayer,105,210,315,10,65,UCBPlayer
24867,UCBPlayer,130,275,405,25,40,UCBPlayer
24868,UCBPlayer,105,210,315,10,65,UCBPlayer
24869,UCBPlayer,130,275,405,25,40,UCBPlayer
24870,UCBPlayer,106,206,312,10,66,UCBPlayer
24871,UCBPlayer,130,275,405,25,40,UCBPlayer
24872,UCBPlayer,105,210,315,10,65,UCBPlayer
24873,UCBPlayer,131,271,402,25,41,UCBPlayer
24874,UCBPlayer,105,210,315,10,65,UCBPlayer
24875,UCBPlayer,130,275,405,25,40,UCBPlayer
24876,UCBPlayer,105,210,315,10,65,UCBPlayer
24877,UCBPlayer,130,275,405,25,40,UCBPlayer
24878,UCBPlayer,103,203,306,10,68,UCBPlayer
24879,UCBPlayer,128,283,411,25,38,UCBPlayer
24880,UCBPlayer,111,186,297,10,71,UCBPlayer
24881,UCBPlayer,124,299,423,25,34,UCBPlayer
24882,UCBPlayer,115,170,285,10,75,UCBPlayer
24883,UCBPlayer,120,315,435,25,30,UCBPlayer
24884,UCBPlayer,119,154,273,10,79,UCBPlayer
24885,UCBPlayer,112,332,444,25,27,UCBPlayer
24886,UCBPlayer,127,137,264,10,82,UCBPlayer
24887,UCBPlayer,104,349,453,25,24,UCBPlayer
24888,UCBPlayer,126,126,252,7,85,Tie
24889,UCBPlayer,111,351,462,28,22,UCBPlayer
24890,UCBPlayer,116,126,242,3,87,UCBPlayer
24891,UCBPlayer,122,347,469,32,21,UCBPlayer
24892,UCBPlayer,107,132,239,0,87,UCBPlayer
24893,UCBPlayer,132,337,469,35,22,UCBPlayer
24894,UCBPlayer,103,148,251,0,83,UCBPlayer
24895,UCBPlayer,136,321,457,35,26,UCBPlayer
24896,UCBPlayer,99,164,263,0,79,UCBPlayer
24897,UCBPlayer,140,305,445,35,30,UCBPlayer
24898,UCBPlayer,95,180,275,0,75,UCBPlayer
24899,UCBPlayer,144,289,433,35,34,UCBPlayer
24900,UCBPlayer,91,196,287,0,71,UCBPlayer
24901,UCBPlayer,148,273,421,35,38,UCBPlayer
24902,UCBPlayer,87,212,299,0,67,UCBPlayer
24903,UCBPlayer,152,257,409,35,42,UCBPlayer
24904,UCBPlayer,84,224,308,0,64,UCBPlayer
24905,UCBPlayer,146,251,397,32,45,UCBPlayer
24906,UCBPlayer,89,234,323,3,60,UCBPlayer
24907,UCBPlayer,138,243,381,28,49,UCBPlayer
24908,UCBPlayer,97,242,339,7,56,UCBPlayer
24909,UCBPlayer,130,235,365,24,53,UCBPlayer
24910,UCBPlayer,105,250,355,11,52,UCBPlayer
24911,UCBPlayer,122,227,349,20,57,UCBPlayer
24912,UCBPlayer,109,259,368,15,49,UCBPlayer
24913,UCBPlayer,118,218,336,16,60,UCBPlayer
24914,UCBPlayer,117,267,384,19,45,UCBPlayer
24915,UCBPlayer,110,210,320,12,64,UCBPlayer
24916,UCBPlayer,126,271,397,23,42,UCBPlayer
24917,UCBPlayer,105,210,315,10,65,UCBPlayer
24918,UCBPlayer,130,275,405,25,40,UCBPlayer
24919,UCBPlayer,105,210,315,10,65,UCBPlayer
24920,UCBPlayer,130,275,405,25,40,UCBPlayer
24921,UCBPlayer,106,206,312,10,66,UCBPlayer
24922,UCBPlayer,130,275,405,25,40,UCBPlayer
24923,UCBPlayer,105,210,315,10,65,UCBPlayer
24924,UCBPlayer,131,271,402,25,41,UCBPlayer
24925,UCBPlayer,105,210,315,10,65,UCBPlayer
24926,UCBPlayer,130,275,405,25,40,UCBPlayer
24927,UCBPlayer,105,210,315,10,65,UCBPlayer
24928,UCBPlayer,130,275,405,25,40,UCBPlayer
24929,UCBPlayer,103,203,306,10,68,UCBPlayer
24930,UCBPlayer,128,283,411,25,38,UCBPlayer
24931,UCBPlayer,111,186,297,10,71,UCBPlayer
24932,UCBPlayer,124,299,423,25,34,UCBPlayer
24933,UCBPlayer,115,170,285,10,75,UCBPlayer
24934,UCBPlayer,120,315,435,25,30,UCBPlayer
24935,UCBPlayer,119,154,273,10,79,UCBPlayer
24936,UCBPlayer,112,332,444,25,27,UCBPlayer
24937,UCBPlayer,127,137,264,10,82,UCBPlayer
24938,UCBPlayer,104,349,453,25,24,UCBPlayer
24939,UCBPlayer,126,126,252,7,85,Tie
24940,UCBPlayer,111,351,462,28,22,UCBPlayer
24941,UCBPlayer,116,126,242,3,87,UCBPlayer
24942,UCBPlayer,122,347,469,32,21,UCBPlayer
24943,UCBPlayer,107,132,239,0,87,UCBPlayer
24944,UCBPlayer,132,337,469,35,22,UCBPlayer
24945,UCBPlayer,103,148,251,0,83,UCBPlayer
24946,UCBPlayer,136,321,457,35,26,UCBPlayer
24947,UCBPlayer,99,164,263,0,79,UCBPlayer
24948,UCBPlayer,140,305,445,35,30,UCBPlayer
24949,UCBPlayer,95,180,275,0,75,UCBPlayer
24950,UCBPlayer,144,289,433,35,34,UCBPlayer
24951,UCBPlayer,91,196,287,0,71,UCBPlayer
24952,UCBPlayer,148,273,421,35,38,UCBPlayer
24953,UCBPlayer,87,212,299,0,67,UCBPlayer
24954,UCBPlayer,152,257,409,35,42,UCBPlayer
24955,UCBPlayer,84,224,308,0,64,UCBPlayer
24956,UCBPlayer,146,251,397,32,45,UCBPlayer
24957,UCBPlayer,89,234,323,3,60,UCBPlayer
24958,UCBPlayer,138,243,381,28,49,UCBPlayer
24959,UCBPlayer,97,242,339,7,56,UCBPlayer
24960,UCBPlayer,130,235,365,24,53,UCBPlayer
24961,UCBPlayer,105,250,355,11,52,UCBPlayer
24962,UCBPlayer,122,227,349,20,57,UCBPlayer
24963,UCBPlayer,109,259,368,15,49,UCBPlayer
24964,UCBPlayer,118,218,336,16,60,UCBPlayer
24965,UCBPlayer,117,267,384,19,45,UCBPlayer
24966,UCBPlayer,110,210,320,12,64,UCBPlayer
24967,UCBPlayer,126,271,397,23,42,UCBPlayer
24968,UCBPlayer,105,210,315,10,65,UCBPlayer
24969,UCBPlayer,130,275,405,25,40,UCBPlayer
24970,UCBPlayer,105,210,315,10,65,UCBPlayer
24971,UCBPlayer,130,275,405,25,40,UCBPlayer
24972,UCBPlayer,106,206,312,10,66,UCBPlayer
24973,UCBPlayer,130,275,405,25,40,UCBPlayer
24974,UCBPlayer,105,210,315,10,65,UCBPlayer
24975,UCBPlayer,131,271,402,25,41,UCBPlayer
24976,UCBPlayer,105,210,315,10,65,UCBPlayer
24977,UCBPlayer,130,275,405,25,40,UCBPlayer
24978,UCBPlayer,105,210,315,10,65,UCBPlayer
24979,UCBPlayer,130,275,405,25,40,UCBPlayer
24980,UCBPlayer,103,203,306,10,68,UCBPlayer
24981,UCBPlayer,128,283,411,25,38,UCBPlayer
24982,UCBPlayer,111,186,297,10,71,UCBPlayer
24983,UCBPlayer,124,299,423,25,34,UCBPlayer
24984,UCBPlayer,115,170,285,10,75,UCBPlayer
24985,UCBPlayer,120,315,435,25,30,UCBPlayer
24986,UCBPlayer,119,154,273,10,79,UCBPlayer
24987,UCBPlayer,112,332,444,25,27,UCBPlayer
24988,UCBPlayer,127,137,264,10,82,UCBPlayer
24989,UCBPlayer,104,349,453,25,24,UCBPlayer
24990,UCBPlayer,126,126,252,7,85,Tie
24991,UCBPlayer,111,351,462,28,22,UCBPlayer
24992,UCBPlayer,116,126,242,3,87,UCBPlayer
24993,UCBPlayer,122,347,469,32,21,UCBPlayer
24994,UCBPlayer,107,132,239,0,87,UCBPlayer
24995,UCBPlayer,132,337,469,35,22,UCBPlayer
24996,UCBPlayer,103,148,251,0,83,UCBPlayer
24997,UCBPlayer,136,321,457,35,26,UCBPlayer
24998,UCBPlayer,99,164,263,0,79,UCBPlayer
24999,UCBPlayer,140,305,445,35,30,UCBPlayer
25000,UCBPlayer,95,180,275,0,75,UCBPlayer
25001,UCBPlayer,144,289,433,35,34,UCBPlayer
25002,UCBPlayer,91,196,287,0,71,UCBPlayer
25003,UCBPlayer,148,273,421,35,38,UCBPlayer
25004,UCBPlayer,87,212,299,0,67,UCBPlayer
25005,UCBPlayer,152,257,409,35,42,UCBPlayer
25006,UCBPlayer,84,224,308,0,64,UCBPlayer
25007,UCBPlayer,146,251,397,32,45,UCBPlayer
25008,UCBPlayer,89,234,323,3,60,UCBPlayer
25009,UCBPlayer,138,243,381,28,49,UCBPlayer
25010,UCBPlayer,97,242,339,7,56,UCBPlayer
25011,UCBPlayer,130,235,365,24,53,UCBPlayer
25012,UCBPlayer,105,250,355,11,52,UCBPlayer
25013,UCBPlayer,122,227,349,20,57,UCBPlayer
25014,UCBPlayer,109,259,368,15,49,UCBPlayer
25015,UCBPlayer,118,218,336,16,60,UCBPlayer
25016,UCBPlayer,117,267,384,19,45,UCBPlayer
25017,UCBPlayer,110,210,320,12,64,UCBPlayer
25018,UCBPlayer,126,271,397,23,42,UCBPlayer
25019,UCBPlayer,105,210,315,10,65,UCBPlayer
25020,UCBPlayer,130,275,405,25,40,UCBPlayer
25021,UCBPlayer,105,210,315,10,65,UCBPlayer
25022,UCBPlayer,130,275,405,25,40,UCBPlayer
25023,UCBPlayer,106,206,312,10,66,UCBPlayer
25024,UCBPlayer,130,275,405,25,40,UCBPlayer
25025,UCBPlayer,105,210,315,10,65,UCBPlayer
25026,UCBPlayer,131,271,402,25,41,UCBPlayer
25027,UCBPlayer,105,210,315,10,65,UCBPlayer
25028,UCBPlayer,130,275,405,25,40,UCBPlayer
25029,UCBPlayer,105,210,315,10,65,UCBPlayer
25030,UCBPlayer,130,275,405,25,40,UCBPlayer
25031,UCBPlayer,103,203,306,10,68,UCBPlayer
25032,UCBPlayer,128,283,411,25,38,UCBPlayer
25033,UCBPlayer,111,186,297,10,71,UCBPlayer
25034,UCBPlayer,124,299,423,25,34,UCBPlayer
25035,UCBPlayer,115,170,285,10,75,UCBPlayer
25036,UCBPlayer,120,315,435,25,30,UCBPlayer
25037,UCBPlayer,119,154,273,10,79,UCBPlayer
25038,UCBPlayer,112,332,444,25,27,UCBPlayer
25039,UCBPlayer,127,137,264,10,82,UCBPlayer
25040,UCBPlayer,104,349,453,25,24,UCBPlayer
25041,UCBPlayer,126,126,252,7,85,Tie
25042,UCBPlayer,111,351,462,28,22,UCBPlayer
25043,UCBPlayer,116,126,242,3,87,UCBPlayer
25044,UCBPlayer,122,347,469,32,21,UCBPlayer
25045,UCBPlayer,107,132,239,0,87,UCBPlayer
25046,UCBPlayer,132,337,469,35,22,UCBPlayer
25047,UCBPlayer,103,148,251,0,83,UCBPlayer
25048,UCBPlayer,136,321,457,35,26,UCBPlayer
25049,UCBPlayer,99,164,263,0,79,UCBPlayer
25050,UCBPlayer,140,305,445,35,30,UCBPlayer
25051,UCBPlayer,95,180,275,0,75,UCBPlayer
25052,UCBPlayer,144,289,433,35,34,UCBPlayer
25053,UCBPlayer,91,196,287,0,71,UCBPlayer
25054,UCBPlayer,148,273,421,35,38,UCBPlayer
25055,UCBPlayer,87,212,299,0,67,UCBPlayer
25056,UCBPlayer,152,257,409,35,42,UCBPlayer
25057,UCBPlayer,84,224,308,0,64,UCBPlayer
25058,UCBPlayer,146,251,397,32,45,UCBPlayer
25059,UCBPlayer,89,234,323,3,60,UCBPlayer
25060,UCBPlayer,138,243,381,28,49,UCBPlayer
25061,UCBPlayer,97,242,339,7,56,UCBPlayer
25062,UCBPlayer,130,235,365,24,53,UCBPlayer
25063,UCBPlayer,105,250,355,11,52,UCBPlayer
25064,UCBPlayer,122,227,349,20,57,UCBPlayer
25065,UCBPlayer,109,259,368,15,49,UCBPlayer
25066,UCBPlayer,118,218,336,16,60,UCBPlayer
25067,UCBPlayer,117,267,384,19,45,UCBPlayer
25068,UCBPlayer,110,210,320,12,64,UCBPlayer
25069,UCBPlayer,126,271,397,23,42,UCBPlayer
25070,UCBPlayer,105,210,315,10,65,UCBPlayer
25071,UCBPlayer,130,275,405,25,40,UCBPlayer
25072,UCBPlayer,105,210,315,10,65,UCBPlayer
25073,UCBPlayer,130,275,405,25,40,UCBPlayer
25074,UCBPlayer,106,206,312,10,66,UCBPlayer
25075,UCBPlayer,130,275,405,25,40,UCBPlayer
25076,UCBPlayer,105,210,315,10,65,UCBPlayer
25077,UCBPlayer,131,271,402,25,41,UCBPlayer
25078,UCBPlayer,105,210,315,10,65,UCBPlayer
25079,UCBPlayer,130,275,405,25,40,UCBPlayer
25080,UCBPlayer,105,210,315,10,65,UCBPlayer
25081,UCBPlayer,130,275,405,25,40,UCBPlayer
25082,UCBPlayer,103,203,306,10,68,UCBPlayer
25083,UCBPlayer,128,283,411,25,38,UCBPlayer
25084,UCBPlayer,111,186,297,10,71,UCBPlayer
25085,UCBPlayer,124,299,423,25,34,UCBPlayer
25086,UCBPlayer,115,170,285,10,75,UCBPlayer
25087,UCBPlayer,120,315,435,25,30,UCBPlayer
25088,UCBPlayer,119,154,273,10,79,UCBPlayer
25089,UCBPlayer,112,332,444,25,27,UCBPlayer
25090,UCBPlayer,127,137,264,10,82,UCBPlayer
25091,UCBPlayer,104,349,453,25,24,UCBPlayer
25092,UCBPlayer,126,126,252,7,85,Tie
25093,UCBPlayer,111,351,462,28,22,UCBPlayer
25094,UCBPlayer,116,126,242,3,87,UCBPlayer
25095,UCBPlayer,122,347,469,32,21,UCBPlayer
25096,UCBPlayer,107,132,239,0,87,UCBPlayer
25097,UCBPlayer,132,337,469,35,22,UCBPlayer
25098,UCBPlayer,103,148,251,0,83,UCBPlayer
25099,UCBPlayer,136,321,457,35,26,UCBPlayer
25100,UCBPlayer,99,164,263,0,79,UCBPlayer
25101,UCBPlayer,140,305,445,35,30,UCBPlayer
25102,UCBPlayer,95,180,275,0,75,UCBPlayer
25103,UCBPlayer,144,289,433,35,34,UCBPlayer
25104,UCBPlayer,91,196,287,0,71,UCBPlayer
25105,UCBPlayer,148,273,421,35,38,UCBPlayer
25106,UCBPlayer,87,212,299,0,67,UCBPlayer
25107,UCBPlayer,152,257,409,35,42,UCBPlayer
25108,UCBPlayer,84,224,308,0,64,UCBPlayer
25109,UCBPlayer,146,251,397,32,45,UCBPlayer
25110,UCBPlayer,89,234,323,3,60,UCBPlayer
25111,UCBPlayer,138,243,381,28,49,UCBPlayer
25112,UCBPlayer,97,242,339,7,56,UCBPlayer
25113,UCBPlayer,130,235,365,24,53,UCBPlayer
25114,UCBPlayer,105,250,355,11,52,UCBPlayer
25115,UCBPlayer,122,227,349,20,57,UCBPlayer
25116,UCBPlayer,109,259,368,15,49,UCBPlayer
25117,UCBPlayer,118,218,336,16,60,UCBPlayer
25118,UCBPlayer,117,267,384,19,45,UCBPlayer
25119,UCBPlayer,110,210,320,12,64,UCBPlayer
25120,UCBPlayer,126,271,397,23,42,UCBPlayer
25121,UCBPlayer,105,210,315,10,65,UCBPlayer
25122,UCBPlayer,130,275,405,25,40,UCBPlayer
25123,UCBPlayer,105,210,315,10,65,UCBPlayer
25124,UCBPlayer,130,275,405,25,40,UCBPlayer
25125,UCBPlayer,106,206,312,10,66,UCBPlayer
25126,UCBPlayer,130,275,405,25,40,UCBPlayer
25127,UCBPlayer,105,210,315,10,65,UCBPlayer
25128,UCBPlayer,131,271,402,25,41,UCBPlayer
25129,UCBPlayer,105,210,315,10,65,UCBPlayer
25130,UCBPlayer,130,275,405,25,40,UCBPlayer
25131,UCBPlayer,105,210,315,10,65,UCBPlayer
25132,UCBPlayer,130,275,405,25,40,UCBPlayer
25133,UCBPlayer,103,203,306,10,68,UCBPlayer
25134,UCBPlayer,128,283,411,25,38,UCBPlayer
25135,UCBPlayer,111,186,297,10,71,UCBPlayer
25136,UCBPlayer,124,299,423,25,34,UCBPlayer
25137,UCBPlayer,115,170,285,10,75,UCBPlayer
25138,UCBPlayer,120,315,435,25,30,UCBPlayer
25139,UCBPlayer,119,154,273,10,79,UCBPlayer
25140,UCBPlayer,112,332,444,25,27,UCBPlayer
25141,UCBPlayer,127,137,264,10,82,UCBPlayer
25142,UCBPlayer,104,349,453,25,24,UCBPlayer
25143,UCBPlayer,126,126,252,7,85,Tie
25144,UCBPlayer,111,351,462,28,22,UCBPlayer
25145,UCBPlayer,116,126,242,3,87,UCBPlayer
25146,UCBPlayer,122,347,469,32,21,UCBPlayer
25147,UCBPlayer,107,132,239,0,87,UCBPlayer
25148,UCBPlayer,132,337,469,35,22,UCBPlayer
25149,UCBPlayer,103,148,251,0,83,UCBPlayer
25150,UCBPlayer,136,321,457,35,26,UCBPlayer
25151,UCBPlayer,99,164,263,0,79,UCBPlayer
25152,UCBPlayer,140,305,445,35,30,UCBPlayer
25153,UCBPlayer,95,180,275,0,75,UCBPlayer
25154,UCBPlayer,144,289,433,35,34,UCBPlayer
25155,UCBPlayer,91,196,287,0,71,UCBPlayer
25156,UCBPlayer,148,273,421,35,38,UCBPlayer
25157,UCBPlayer,87,212,299,0,67,UCBPlayer
25158,UCBPlayer,152,257,409,35,42,UCBPlayer
25159,UCBPlayer,84,224,308,0,64,UCBPlayer
25160,UCBPlayer,146,251,397,32,45,UCBPlayer
25161,UCBPlayer,89,234,323,3,60,UCBPlayer
25162,UCBPlayer,138,243,381,28,49,UCBPlayer
25163,UCBPlayer,97,242,339,7,56,UCBPlayer
25164,UCBPlayer,130,235,365,24,53,UCBPlayer
25165,UCBPlayer,105,250,355,11,52,UCBPlayer
25166,UCBPlayer,122,227,349,20,57,UCBPlayer
25167,UCBPlayer,109,259,368,15,49,UCBPlayer
25168,UCBPlayer,118,218,336,16,60,UCBPlayer
25169,UCBPlayer,117,267,384,19,45,UCBPlayer
25170,UCBPlayer,110,210,320,12,64,UCBPlayer
25171,UCBPlayer,126,271,397,23,42,UCBPlayer
25172,UCBPlayer,105,210,315,10,65,UCBPlayer
25173,UCBPlayer,130,275,405,25,40,UCBPlayer
25174,UCBPlayer,105,210,315,10,65,UCBPlayer
25175,UCBPlayer,130,275,405,25,40,UCBPlayer
25176,UCBPlayer,106,206,312,10,66,UCBPlayer
25177,UCBPlayer,130,275,405,25,40,UCBPlayer
25178,UCBPlayer,105,210,315,10,65,UCBPlayer
25179,UCBPlayer,131,271,402,25,41,UCBPlayer
25180,UCBPlayer,105,210,315,10,65,UCBPlayer
25181,UCBPlayer,130,275,405,25,40,UCBPlayer
25182,UCBPlayer,105,210,315,10,65,UCBPlayer
25183,UCBPlayer,130,275,405,25,40,UCBPlayer
25184,UCBPlayer,103,203,306,10,68,UCBPlayer
25185,UCBPlayer,128,283,411,25,38,UCBPlayer
25186,UCBPlayer,111,186,297,10,71,UCBPlayer
25187,UCBPlayer,124,299,423,25,34,UCBPlayer
25188,UCBPlayer,115,170,285,10,75,UCBPlayer
25189,UCBPlayer,120,315,435,25,30,UCBPlayer
25190,UCBPlayer,119,154,273,10,79,UCBPlayer
25191,UCBPlayer,112,332,444,25,27,UCBPlayer
25192,UCBPlayer,127,137,264,10,82,UCBPlayer
25193,UCBPlayer,104,349,453,25,24,UCBPlayer
25194,UCBPlayer,126,126,252,7,85,Tie
25195,UCBPlayer,111,351,462,28,22,UCBPlayer
25196,UCBPlayer,116,126,242,3,87,UCBPlayer
25197,UCBPlayer,122,347,469,32,21,UCBPlayer
25198,UCBPlayer,107,132,239,0,87,UCBPlayer
25199,UCBPlayer,132,337,469,35,22,UCBPlayer
25200,UCBPlayer,103,148,251,0,83,UCBPlayer
25201,UCBPlayer,136,321,457,35,26,UCBPlayer
25202,UCBPlayer,99,164,263,0,79,UCBPlayer
25203,UCBPlayer,140,305,445,35,30,UCBPlayer
25204,UCBPlayer,95,180,275,0,75,UCBPlayer
25205,UCBPlayer,144,289,433,35,34,UCBPlayer
25206,UCBPlayer,91,196,287,0,71,UCBPlayer
25207,UCBPlayer,148,273,421,35,38,UCBPlayer
25208,UCBPlayer,87,212,299,0,67,UCBPlayer
25209,UCBPlayer,152,257,409,35,42,UCBPlayer
25210,UCBPlayer,84,224,308,0,64,UCBPlayer
25211,UCBPlayer,146,251,397,32,45,UCBPlayer
25212,UCBPlayer,89,234,323,3,60,UCBPlayer
25213,UCBPlayer,138,243,381,28,49,UCBPlayer
25214,UCBPlayer,97,242,339,7,56,UCBPlayer
25215,UCBPlayer,130,235,365,24,53,UCBPlayer
25216,UCBPlayer,105,250,355,11,52,UCBPlayer
25217,UCBPlayer,122,227,349,20,57,UCBPlayer
25218,UCBPlayer,109,259,368,15,49,UCBPlayer
25219,UCBPlayer,118,218,336,16,60,UCBPlayer
25220,UCBPlayer,117,267,384,19,45,UCBPlayer
25221,UCBPlayer,110,210,320,12,64,UCBPlayer
25222,UCBPlayer,126,271,397,23,42,UCBPlayer
25223,UCBPlayer,105,210,315,10,65,UCBPlayer
25224,UCBPlayer,130,275,405,25,40,UCBPlayer
25225,UCBPlayer,105,210,315,10,65,UCBPlayer
25226,UCBPlayer,130,275,405,25,40,UCBPlayer
25227,UCBPlayer,106,206,312,10,66,UCBPlayer
25228,UCBPlayer,130,275,405,25,40,UCBPlayer
25229,UCBPlayer,105,210,315,10,65,UCBPlayer
25230,UCBPlayer,131,271,402,25,41,UCBPlayer
25231,UCBPlayer,105,210,315,10,65,UCBPlayer
25232,UCBPlayer,130,275,405,25,40,UCBPlayer
25233,UCBPlayer,105,210,315,10,65,UCBPlayer
25234,UCBPlayer,130,275,405,25,40,UCBPlayer
25235,UCBPlayer,103,203,306,10,68,UCBPlayer
25236,UCBPlayer,128,283,411,25,38,UCBPlayer
25237,UCBPlayer,111,186,297,10,71,UCBPlayer
25238,UCBPlayer,124,299,423,25,34,UCBPlayer
25239,UCBPlayer,115,170,285,10,75,UCBPlayer
25240,UCBPlayer,120,315,435,25,30,UCBPlayer
25241,UCBPlayer,119,154,273,10,79,UCBPlayer
25242,UCBPlayer,112,332,444,25,27,UCBPlayer
25243,UCBPlayer,127,137,264,10,82,UCBPlayer
25244,UCBPlayer,104,349,453,25,24,UCBPlayer
25245,UCBPlayer,126,126,252,7,85,Tie
25246,UCBPlayer,111,351,462,28,22,UCBPlayer
25247,UCBPlayer,116,126,242,3,87,UCBPlayer
25248,UCBPlayer,122,347,469,32,21,UCBPlayer
25249,UCBPlayer,107,132,239,0,87,UCBPlayer
25250,UCBPlayer,132,337,469,35,22,UCBPlayer
25251,UCBPlayer,103,148,251,0,83,UCBPlayer
25252,UCBPlayer,136,321,457,35,26,UCBPlayer
25253,UCBPlayer,99,164,263,0,79,UCBPlayer
25254,UCBPlayer,140,305,445,35,30,UCBPlayer
25255,UCBPlayer,95,180,275,0,75,UCBPlayer
25256,UCBPlayer,144,289,433,35,34,UCBPlayer
25257,UCBPlayer,91,196,287,0,71,UCBPlayer
25258,UCBPlayer,148,273,421,35,38,UCBPlayer
25259,UCBPlayer,87,212,299,0,67,UCBPlayer
25260,UCBPlayer,152,257,409,35,42,UCBPlayer
25261,UCBPlayer,84,224,308,0,64,UCBPlayer
25262,UCBPlayer,146,251,397,32,45,UCBPlayer
25263,UCBPlayer,89,234,323,3,60,UCBPlayer
25264,UCBPlayer,138,243,381,28,49,UCBPlayer
25265,UCBPlayer,97,242,339,7,56,UCBPlayer
25266,UCBPlayer,130,235,365,24,53,UCBPlayer
25267,UCBPlayer,105,250,355,11,52,UCBPlayer
25268,UCBPlayer,122,227,349,20,57,UCBPlayer
25269,UCBPlayer,109,259,368,15,49,UCBPlayer
25270,UCBPlayer,118,218,336,16,60,UCBPlayer
25271,UCBPlayer,117,267,384,19,45,UCBPlayer
25272,UCBPlayer,110,210,320,12,64,UCBPlayer
25273,UCBPlayer,126,271,397,23,42,UCBPlayer
25274,UCBPlayer,105,210,315,10,65,UCBPlayer
25275,UCBPlayer,130,275,405,25,40,UCBPlayer
25276,UCBPlayer,105,210,315,10,65,UCBPlayer
25277,UCBPlayer,130,275,405,25,40,UCBPlayer
25278,UCBPlayer,106,206,312,10,66,UCBPlayer
25279,UCBPlayer,130,275,405,25,40,UCBPlayer
25280,UCBPlayer,105,210,315,10,65,UCBPlayer
25281,UCBPlayer,131,271,402,25,41,UCBPlayer
25282,UCBPlayer,105,210,315,10,65,UCBPlayer
25283,UCBPlayer,130,275,405,25,40,UCBPlayer
25284,UCBPlayer,105,210,315,10,65,UCBPlayer
25285,UCBPlayer,130,275,405,25,40,UCBPlayer
25286,UCBPlayer,103,203,306,10,68,UCBPlayer
25287,UCBPlayer,128,283,411,25,38,UCBPlayer
25288,UCBPlayer,111,186,297,10,71,UCBPlayer
25289,UCBPlayer,124,299,423,25,34,UCBPlayer
25290,UCBPlayer,115,170,285,10,75,UCBPlayer
25291,UCBPlayer,120,315,435,25,30,UCBPlayer
25292,UCBPlayer,119,154,273,10,79,UCBPlayer
25293,UCBPlayer,112,332,444,25,27,UCBPlayer
25294,UCBPlayer,127,137,264,10,82,UCBPlayer
25295,UCBPlayer,104,349,453,25,24,UCBPlayer
25296,UCBPlayer,126,126,252,7,85,Tie
25297,UCBPlayer,111,351,462,28,22,UCBPlayer
25298,UCBPlayer,116,126,242,3,87,UCBPlayer
25299,UCBPlayer,122,347,469,32,21,UCBPlayer
25300,UCBPlayer,107,132,239,0,87,UCBPlayer
25301,UCBPlayer,132,337,469,35,22,UCBPlayer
25302,UCBPlayer,103,148,251,0,83,UCBPlayer
25303,UCBPlayer,136,321,457,35,26,UCBPlayer
25304,UCBPlayer,99,164,263,0,79,UCBPlayer
25305,UCBPlayer,140,305,445,35,30,UCBPlayer
25306,UCBPlayer,95,180,275,0,75,UCBPlayer
25307,UCBPlayer,144,289,433,35,34,UCBPlayer
25308,UCBPlayer,91,196,287,0,71,UCBPlayer
25309,UCBPlayer,148,273,421,35,38,UCBPlayer
25310,UCBPlayer,87,212,299,0,67,UCBPlayer
25311,UCBPlayer,152,257,409,35,42,UCBPlayer
25312,UCBPlayer,84,224,308,0,64,UCBPlayer
25313,UCBPlayer,146,251,397,32,45,UCBPlayer
25314,UCBPlayer,89,234,323,3,60,UCBPlayer
25315,UCBPlayer,138,243,381,28,49,UCBPlayer
25316,UCBPlayer,97,242,339,7,56,UCBPlayer
25317,UCBPlayer,130,235,365,24,53,UCBPlayer
25318,UCBPlayer,105,250,355,11,52,UCBPlayer
25319,UCBPlayer,122,227,349,20,57,UCBPlayer
25320,UCBPlayer,109,259,368,15,49,UCBPlayer
25321,UCBPlayer,118,218,336,16,60,UCBPlayer
25322,UCBPlayer,117,267,384,19,45,UCBPlayer
25323,UCBPlayer,110,210,320,12,64,UCBPlayer
25324,UCBPlayer,126,271,397,23,42,UCBPlayer
25325,UCBPlayer,105,210,315,10,65,UCBPlayer
25326,UCBPlayer,130,275,405,25,40,UCBPlayer
25327,UCBPlayer,105,210,315,10,65,UCBPlayer
25328,UCBPlayer,130,275,405,25,40,UCBPlayer
25329,UCBPlayer,106,206,312,10,66,UCBPlayer
25330,UCBPlayer,130,275,405,25,40,UCBPlayer
25331,UCBPlayer,105,210,315,10,65,UCBPlayer
25332,UCBPlayer,131,271,402,25,41,UCBPlayer
25333,UCBPlayer,105,210,315,10,65,UCBPlayer
25334,UCBPlayer,130,275,405,25,40,UCBPlayer
25335,UCBPlayer,105,210,315,10,65,UCBPlayer
25336,UCBPlayer,130,275,405,25,40,UCBPlayer
25337,UCBPlayer,103,203,306,10,68,UCBPlayer
25338,UCBPlayer,128,283,411,25,38,UCBPlayer
25339,UCBPlayer,111,186,297,10,71,UCBPlayer
25340,UCBPlayer,124,299,423,25,34,UCBPlayer
25341,UCBPlayer,115,170,285,10,75,UCBPlayer
25342,UCBPlayer,120,315,435,25,30,UCBPlayer
25343,UCBPlayer,119,154,273,10,79,UCBPlayer
25344,UCBPlayer,112,332,444,25,27,UCBPlayer
25345,UCBPlayer,127,137,264,10,82,UCBPlayer
25346,UCBPlayer,104,349,453,25,24,UCBPlayer
25347,UCBPlayer,126,126,252,7,85,Tie
25348,UCBPlayer,111,351,462,28,22,UCBPlayer
25349,UCBPlayer,116,126,242,3,87,UCBPlayer
25350,UCBPlayer,122,347,469,32,21,UCBPlayer
25351,UCBPlayer,107,132,239,0,87,UCBPlayer
25352,UCBPlayer,132,337,469,35,22,UCBPlayer
25353,UCBPlayer,103,148,251,0,83,UCBPlayer
25354,UCBPlayer,136,321,457,35,26,UCBPlayer
25355,UCBPlayer,99,164,263,0,79,UCBPlayer
25356,UCBPlayer,140,305,445,35,30,UCBPlayer
25357,UCBPlayer,95,180,275,0,75,UCBPlayer
25358,UCBPlayer,144,289,433,35,34,UCBPlayer
25359,UCBPlayer,91,196,287,0,71,UCBPlayer
25360,UCBPlayer,148,273,421,35,38,UCBPlayer
25361,UCBPlayer,87,212,299,0,67,UCBPlayer
25362,UCBPlayer,152,257,409,35,42,UCBPlayer
25363,UCBPlayer,84,224,308,0,64,UCBPlayer
25364,UCBPlayer,146,251,397,32,45,UCBPlayer
25365,UCBPlayer,89,234,323,3,60,UCBPlayer
25366,UCBPlayer,138,243,381,28,49,UCBPlayer
25367,UCBPlayer,97,242,339,7,56,UCBPlayer
25368,UCBPlayer,130,235,365,24,53,UCBPlayer
25369,UCBPlayer,105,250,355,11,52,UCBPlayer
25370,UCBPlayer,122,227,349,20,57,UCBPlayer
25371,UCBPlayer,109,259,368,15,49,UCBPlayer
25372,UCBPlayer,118,218,336,16,60,UCBPlayer
25373,UCBPlayer,117,267,384,19,45,UCBPlayer
25374,UCBPlayer,110,210,320,12,64,UCBPlayer
25375,UCBPlayer,126,271,397,23,42,UCBPlayer
25376,UCBPlayer,105,210,315,10,65,UCBPlayer
25377,UCBPlayer,130,275,405,25,40,UCBPlayer
25378,UCBPlayer,105,210,315,10,65,UCBPlayer
25379,UCBPlayer,130,275,405,25,40,UCBPlayer
25380,UCBPlayer,106,206,312,10,66,UCBPlayer
25381,UCBPlayer,130,275,405,25,40,UCBPlayer
25382,UCBPlayer,105,210,315,10,65,UCBPlayer
25383,UCBPlayer,131,271,402,25,41,UCBPlayer
25384,UCBPlayer,105,210,315,10,65,UCBPlayer
25385,UCBPlayer,130,275,405,25,40,UCBPlayer
25386,UCBPlayer,105,210,315,10,65,UCBPlayer
25387,UCBPlayer,130,275,405,25,40,UCBPlayer
25388,UCBPlayer,103,203,306,10,68,UCBPlayer
25389,UCBPlayer,128,283,411,25,38,UCBPlayer
25390,UCBPlayer,111,186,297,10,71,UCBPlayer
25391,UCBPlayer,124,299,423,25,34,UCBPlayer
25392,UCBPlayer,115,170,285,10,75,UCBPlayer
25393,UCBPlayer,120,315,435,25,30,UCBPlayer
25394,UCBPlayer,119,154,273,10,79,UCBPlayer
25395,UCBPlayer,112,332,444,25,27,UCBPlayer
25396,UCBPlayer,127,137,264,10,82,UCBPlayer
25397,UCBPlayer,104,349,453,25,24,UCBPlayer
25398,UCBPlayer,126,126,252,7,85,Tie
25399,UCBPlayer,111,351,462,28,22,UCBPlayer
25400,UCBPlayer,116,126,242,3,87,UCBPlayer
25401,UCBPlayer,122,347,469,32,21,UCBPlayer
25402,UCBPlayer,107,132,239,0,87,UCBPlayer
25403,UCBPlayer,132,337,469,35,22,UCBPlayer
25404,UCBPlayer,103,148,251,0,83,UCBPlayer
25405,UCBPlayer,136,321,457,35,26,UCBPlayer
25406,UCBPlayer,99,164,263,0,79,UCBPlayer
25407,UCBPlayer,140,305,445,35,30,UCBPlayer
25408,UCBPlayer,95,180,275,0,75,UCBPlayer
25409,UCBPlayer,144,289,433,35,34,UCBPlayer
25410,UCBPlayer,91,196,287,0,71,UCBPlayer
25411,UCBPlayer,148,273,421,35,38,UCBPlayer
25412,UCBPlayer,87,212,299,0,67,UCBPlayer
25413,UCBPlayer,152,257,409,35,42,UCBPlayer
25414,UCBPlayer,84,224,308,0,64,UCBPlayer
25415,UCBPlayer,146,251,397,32,45,UCBPlayer
25416,UCBPlayer,89,234,323,3,60,UCBPlayer
25417,UCBPlayer,138,243,381,28,49,UCBPlayer
25418,UCBPlayer,97,242,339,7,56,UCBPlayer
25419,UCBPlayer,130,235,365,24,53,UCBPlayer
25420,UCBPlayer,105,250,355,11,52,UCBPlayer
25421,UCBPlayer,122,227,349,20,57,UCBPlayer
25422,UCBPlayer,109,259,368,15,49,UCBPlayer
25423,UCBPlayer,118,218,336,16,60,UCBPlayer
25424,UCBPlayer,117,267,384,19,45,UCBPlayer
25425,UCBPlayer,110,210,320,12,64,UCBPlayer
25426,UCBPlayer,126,271,397,23,42,UCBPlayer
25427,UCBPlayer,105,210,315,10,65,UCBPlayer
25428,UCBPlayer,130,275,405,25,40,UCBPlayer
25429,UCBPlayer,105,210,315,10,65,UCBPlayer
25430,UCBPlayer,130,275,405,25,40,UCBPlayer
25431,UCBPlayer,106,206,312,10,66,UCBPlayer
25432,UCBPlayer,130,275,405,25,40,UCBPlayer
25433,UCBPlayer,105,210,315,10,65,UCBPlayer
25434,UCBPlayer,131,271,402,25,41,UCBPlayer
25435,UCBPlayer,105,210,315,10,65,UCBPlayer
25436,UCBPlayer,130,275,405,25,40,UCBPlayer
25437,UCBPlayer,105,210,315,10,65,UCBPlayer
25438,UCBPlayer,130,275,405,25,40,UCBPlayer
25439,UCBPlayer,103,203,306,10,68,UCBPlayer
25440,UCBPlayer,128,283,411,25,38,UCBPlayer
25441,UCBPlayer,111,186,297,10,71,UCBPlayer
25442,UCBPlayer,124,299,423,25,34,UCBPlayer
25443,UCBPlayer,115,170,285,10,75,UCBPlayer
25444,UCBPlayer,120,315,435,25,30,UCBPlayer
25445,UCBPlayer,119,154,273,10,79,UCBPlayer
25446,UCBPlayer,112,332,444,25,27,UCBPlayer
25447,UCBPlayer,127,137,264,10,82,UCBPlayer
25448,UCBPlayer,104,349,453,25,24,UCBPlayer
25449,UCBPlayer,126,126,252,7,85,Tie
25450,UCBPlayer,111,351,462,28,22,UCBPlayer
25451,UCBPlayer,116,126,242,3,87,UCBPlayer
25452,UCBPlayer,122,347,469,32,21,UCBPlayer
25453,UCBPlayer,107,132,239,0,87,UCBPlayer
25454,UCBPlayer,132,337,469,35,22,UCBPlayer
25455,UCBPlayer,103,148,251,0,83,UCBPlayer
25456,UCBPlayer,136,321,457,35,26,UCBPlayer
25457,UCBPlayer,99,164,263,0,79,UCBPlayer
25458,UCBPlayer,140,305,445,35,30,UCBPlayer
25459,UCBPlayer,95,180,275,0,75,UCBPlayer
25460,UCBPlayer,144,289,433,35,34,UCBPlayer
25461,UCBPlayer,91,196,287,0,71,UCBPlayer
25462,UCBPlayer,148,273,421,35,38,UCBPlayer
25463,UCBPlayer,87,212,299,0,67,UCBPlayer
25464,UCBPlayer,152,257,409,35,42,UCBPlayer
25465,UCBPlayer,84,224,308,0,64,UCBPlayer
25466,UCBPlayer,146,251,397,32,45,UCBPlayer
25467,UCBPlayer,89,234,323,3,60,UCBPlayer
25468,UCBPlayer,138,243,381,28,49,UCBPlayer
25469,UCBPlayer,97,242,339,7,56,UCBPlayer
25470,UCBPlayer,130,235,365,24,53,UCBPlayer
25471,UCBPlayer,105,250,355,11,52,UCBPlayer
25472,UCBPlayer,122,227,349,20,57,UCBPlayer
25473,UCBPlayer,109,259,368,15,49,UCBPlayer
25474,UCBPlayer,118,218,336,16,60,UCBPlayer
25475,UCBPlayer,117,267,384,19,45,UCBPlayer
25476,UCBPlayer,110,210,320,12,64,UCBPlayer
25477,UCBPlayer,126,271,397,23,42,UCBPlayer
25478,UCBPlayer,105,210,315,10,65,UCBPlayer
25479,UCBPlayer,130,275,405,25,40,UCBPlayer
25480,UCBPlayer,105,210,315,10,65,UCBPlayer
25481,UCBPlayer,130,275,405,25,40,UCBPlayer
25482,UCBPlayer,106,206,312,10,66,UCBPlayer
25483,UCBPlayer,130,275,405,25,40,UCBPlayer
25484,UCBPlayer,105,210,315,10,65,UCBPlayer
25485,UCBPlayer,131,271,402,25,41,UCBPlayer
25486,UCBPlayer,105,210,315,10,65,UCBPlayer
25487,UCBPlayer,130,275,405,25,40,UCBPlayer
25488,UCBPlayer,105,210,315,10,65,UCBPlayer
25489,UCBPlayer,130,275,405,25,40,UCBPlayer
25490,UCBPlayer,103,203,306,10,68,UCBPlayer
25491,UCBPlayer,128,283,411,25,38,UCBPlayer
25492,UCBPlayer,111,186,297,10,71,UCBPlayer
25493,UCBPlayer,124,299,423,25,34,UCBPlayer
25494,UCBPlayer,115,170,285,10,75,UCBPlayer
25495,UCBPlayer,120,315,435,25,30,UCBPlayer
25496,UCBPlayer,119,154,273,10,79,UCBPlayer
25497,UCBPlayer,112,332,444,25,27,UCBPlayer
25498,UCBPlayer,127,137,264,10,82,UCBPlayer
25499,UCBPlayer,104,349,453,25,24,UCBPlayer
25500,UCBPlayer,126,126,252,7,85,Tie
25501,UCBPlayer,111,351,462,28,22,UCBPlayer
25502,UCBPlayer,116,126,242,3,87,UCBPlayer
25503,UCBPlayer,122,347,469,32,21,UCBPlayer
25504,UCBPlayer,107,132,239,0,87,UCBPlayer
25505,UCBPlayer,132,337,469,35,22,UCBPlayer
25506,UCBPlayer,103,148,251,0,83,UCBPlayer
25507,UCBPlayer,136,321,457,35,26,UCBPlayer
25508,UCBPlayer,99,164,263,0,79,UCBPlayer
25509,UCBPlayer,140,305,445,35,30,UCBPlayer
25510,UCBPlayer,95,180,275,0,75,UCBPlayer
25511,UCBPlayer,144,289,433,35,34,UCBPlayer
25512,UCBPlayer,91,196,287,0,71,UCBPlayer
25513,UCBPlayer,148,273,421,35,38,UCBPlayer
25514,UCBPlayer,87,212,299,0,67,UCBPlayer
25515,UCBPlayer,152,257,409,35,42,UCBPlayer
25516,UCBPlayer,84,224,308,0,64,UCBPlayer
25517,UCBPlayer,146,251,397,32,45,UCBPlayer
25518,UCBPlayer,89,234,323,3,60,UCBPlayer
25519,UCBPlayer,138,243,381,28,49,UCBPlayer
25520,UCBPlayer,97,242,339,7,56,UCBPlayer
25521,UCBPlayer,130,235,365,24,53,UCBPlayer
25522,UCBPlayer,105,250,355,11,52,UCBPlayer
25523,UCBPlayer,122,227,349,20,57,UCBPlayer
25524,UCBPlayer,109,259,368,15,49,UCBPlayer
25525,UCBPlayer,118,218,336,16,60,UCBPlayer
25526,UCBPlayer,117,267,384,19,45,UCBPlayer
25527,UCBPlayer,110,210,320,12,64,UCBPlayer
25528,UCBPlayer,126,271,397,23,42,UCBPlayer
25529,UCBPlayer,105,210,315,10,65,UCBPlayer
25530,UCBPlayer,130,275,405,25,40,UCBPlayer
25531,UCBPlayer,105,210,315,10,65,UCBPlayer
25532,UCBPlayer,130,275,405,25,40,UCBPlayer
25533,UCBPlayer,106,206,312,10,66,UCBPlayer
25534,UCBPlayer,130,275,405,25,40,UCBPlayer
25535,UCBPlayer,105,210,315,10,65,UCBPlayer
25536,UCBPlayer,131,271,402,25,41,UCBPlayer
25537,UCBPlayer,105,210,315,10,65,UCBPlayer
25538,UCBPlayer,130,275,405,25,40,UCBPlayer
25539,UCBPlayer,105,210,315,10,65,UCBPlayer
25540,UCBPlayer,130,275,405,25,40,UCBPlayer
25541,UCBPlayer,103,203,306,10,68,UCBPlayer
25542,UCBPlayer,128,283,411,25,38,UCBPlayer
25543,UCBPlayer,111,186,297,10,71,UCBPlayer
25544,UCBPlayer,124,299,423,25,34,UCBPlayer
25545,UCBPlayer,115,170,285,10,75,UCBPlayer
25546,UCBPlayer,120,315,435,25,30,UCBPlayer
25547,UCBPlayer,119,154,273,10,79,UCBPlayer
25548,UCBPlayer,112,332,444,25,27,UCBPlayer
25549,UCBPlayer,127,137,264,10,82,UCBPlayer
25550,UCBPlayer,104,349,453,25,24,UCBPlayer
25551,UCBPlayer,126,126,252,7,85,Tie
25552,UCBPlayer,111,351,462,28,22,UCBPlayer
25553,UCBPlayer,116,126,242,3,87,UCBPlayer
25554,UCBPlayer,122,347,469,32,21,UCBPlayer
25555,UCBPlayer,107,132,239,0,87,UCBPlayer
25556,UCBPlayer,132,337,469,35,22,UCBPlayer
25557,UCBPlayer,103,148,251,0,83,UCBPlayer
25558,UCBPlayer,136,321,457,35,26,UCBPlayer
25559,UCBPlayer,99,164,263,0,79,UCBPlayer
25560,UCBPlayer,140,305,445,35,30,UCBPlayer
25561,UCBPlayer,95,180,275,0,75,UCBPlayer
25562,UCBPlayer,144,289,433,35,34,UCBPlayer
25563,UCBPlayer,91,196,287,0,71,UCBPlayer
25564,UCBPlayer,148,273,421,35,38,UCBPlayer
25565,UCBPlayer,87,212,299,0,67,UCBPlayer
25566,UCBPlayer,152,257,409,35,42,UCBPlayer
25567,UCBPlayer,84,224,308,0,64,UCBPlayer
25568,UCBPlayer,146,251,397,32,45,UCBPlayer
25569,UCBPlayer,89,234,323,3,60,UCBPlayer
25570,UCBPlayer,138,243,381,28,49,UCBPlayer
25571,UCBPlayer,97,242,339,7,56,UCBPlayer
25572,UCBPlayer,130,235,365,24,53,UCBPlayer
25573,UCBPlayer,105,250,355,11,52,UCBPlayer
25574,UCBPlayer,122,227,349,20,57,UCBPlayer
25575,UCBPlayer,109,259,368,15,49,UCBPlayer
25576,UCBPlayer,118,218,336,16,60,UCBPlayer
25577,UCBPlayer,117,267,384,19,45,UCBPlayer
25578,UCBPlayer,110,210,320,12,64,UCBPlayer
25579,UCBPlayer,126,271,397,23,42,UCBPlayer
25580,UCBPlayer,105,210,315,10,65,UCBPlayer
25581,UCBPlayer,130,275,405,25,40,UCBPlayer
25582,UCBPlayer,105,210,315,10,65,UCBPlayer
25583,UCBPlayer,130,275,405,25,40,UCBPlayer
25584,UCBPlayer,106,206,312,10,66,UCBPlayer
25585,UCBPlayer,130,275,405,25,40,UCBPlayer
25586,UCBPlayer,105,210,315,10,65,UCBPlayer
25587,UCBPlayer,131,271,402,25,41,UCBPlayer
25588,UCBPlayer,105,210,315,10,65,UCBPlayer
25589,UCBPlayer,130,275,405,25,40,UCBPlayer
25590,UCBPlayer,105,210,315,10,65,UCBPlayer
25591,UCBPlayer,130,275,405,25,40,UCBPlayer
25592,UCBPlayer,103,203,306,10,68,UCBPlayer
25593,UCBPlayer,128,283,411,25,38,UCBPlayer
25594,UCBPlayer,111,186,297,10,71,UCBPlayer
25595,UCBPlayer,124,299,423,25,34,UCBPlayer
25596,UCBPlayer,115,170,285,10,75,UCBPlayer
25597,UCBPlayer,120,315,435,25,30,UCBPlayer
25598,UCBPlayer,119,154,273,10,79,UCBPlayer
25599,UCBPlayer,112,332,444,25,27,UCBPlayer
25600,UCBPlayer,127,137,264,10,82,UCBPlayer
25601,UCBPlayer,104,349,453,25,24,UCBPlayer
25602,UCBPlayer,126,126,252,7,85,Tie
25603,UCBPlayer,111,351,462,28,22,UCBPlayer
25604,UCBPlayer,116,126,242,3,87,UCBPlayer
25605,UCBPlayer,122,347,469,32,21,UCBPlayer
25606,UCBPlayer,107,132,239,0,87,UCBPlayer
25607,UCBPlayer,132,337,469,35,22,UCBPlayer
25608,UCBPlayer,103,148,251,0,83,UCBPlayer
25609,UCBPlayer,136,321,457,35,26,UCBPlayer
25610,UCBPlayer,99,164,263,0,79,UCBPlayer
25611,UCBPlayer,140,305,445,35,30,UCBPlayer
25612,UCBPlayer,95,180,275,0,75,UCBPlayer
25613,UCBPlayer,144,289,433,35,34,UCBPlayer
25614,UCBPlayer,91,196,287,0,71,UCBPlayer
25615,UCBPlayer,148,273,421,35,38,UCBPlayer
25616,UCBPlayer,87,212,299,0,67,UCBPlayer
25617,UCBPlayer,152,257,409,35,42,UCBPlayer
25618,UCBPlayer,84,224,308,0,64,UCBPlayer
25619,UCBPlayer,146,251,397,32,45,UCBPlayer
25620,UCBPlayer,89,234,323,3,60,UCBPlayer
25621,UCBPlayer,138,243,381,28,49,UCBPlayer
25622,UCBPlayer,97,242,339,7,56,UCBPlayer
25623,UCBPlayer,130,235,365,24,53,UCBPlayer
25624,UCBPlayer,105,250,355,11,52,UCBPlayer
25625,UCBPlayer,122,227,349,20,57,UCBPlayer
25626,UCBPlayer,109,259,368,15,49,UCBPlayer
25627,UCBPlayer,118,218,336,16,60,UCBPlayer
25628,UCBPlayer,117,267,384,19,45,UCBPlayer
25629,UCBPlayer,110,210,320,12,64,UCBPlayer
25630,UCBPlayer,126,271,397,23,42,UCBPlayer
25631,UCBPlayer,105,210,315,10,65,UCBPlayer
25632,UCBPlayer,130,275,405,25,40,UCBPlayer
25633,UCBPlayer,105,210,315,10,65,UCBPlayer
25634,UCBPlayer,130,275,405,25,40,UCBPlayer
25635,UCBPlayer,106,206,312,10,66,UCBPlayer
25636,UCBPlayer,130,275,405,25,40,UCBPlayer
25637,UCBPlayer,105,210,315,10,65,UCBPlayer
25638,UCBPlayer,131,271,402,25,41,UCBPlayer
25639,UCBPlayer,105,210,315,10,65,UCBPlayer
25640,UCBPlayer,130,275,405,25,40,UCBPlayer
25641,UCBPlayer,105,210,315,10,65,UCBPlayer
25642,UCBPlayer,130,275,405,25,40,UCBPlayer
25643,UCBPlayer,103,203,306,10,68,UCBPlayer
25644,UCBPlayer,128,283,411,25,38,UCBPlayer
25645,UCBPlayer,111,186,297,10,71,UCBPlayer
25646,UCBPlayer,124,299,423,25,34,UCBPlayer
25647,UCBPlayer,115,170,285,10,75,UCBPlayer
25648,UCBPlayer,120,315,435,25,30,UCBPlayer
25649,UCBPlayer,119,154,273,10,79,UCBPlayer
25650,UCBPlayer,112,332,444,25,27,UCBPlayer
25651,UCBPlayer,127,137,264,10,82,UCBPlayer
25652,UCBPlayer,104,349,453,25,24,UCBPlayer
25653,UCBPlayer,126,126,252,7,85,Tie
25654,UCBPlayer,111,351,462,28,22,UCBPlayer
25655,UCBPlayer,116,126,242,3,87,UCBPlayer
25656,UCBPlayer,122,347,469,32,21,UCBPlayer
25657,UCBPlayer,107,132,239,0,87,UCBPlayer
25658,UCBPlayer,132,337,469,35,22,UCBPlayer
25659,UCBPlayer,103,148,251,0,83,UCBPlayer
25660,UCBPlayer,136,321,457,35,26,UCBPlayer
25661,UCBPlayer,99,164,263,0,79,UCBPlayer
25662,UCBPlayer,140,305,445,35,30,UCBPlayer
25663,UCBPlayer,95,180,275,0,75,UCBPlayer
25664,UCBPlayer,144,289,433,35,34,UCBPlayer
25665,UCBPlayer,91,196,287,0,71,UCBPlayer
25666,UCBPlayer,148,273,421,35,38,UCBPlayer
25667,UCBPlayer,87,212,299,0,67,UCBPlayer
25668,UCBPlayer,152,257,409,35,42,UCBPlayer
25669,UCBPlayer,84,224,308,0,64,UCBPlayer
25670,UCBPlayer,146,251,397,32,45,UCBPlayer
25671,UCBPlayer,89,234,323,3,60,UCBPlayer
25672,UCBPlayer,138,243,381,28,49,UCBPlayer
25673,UCBPlayer,97,242,339,7,56,UCBPlayer
25674,UCBPlayer,130,235,365,24,53,UCBPlayer
25675,UCBPlayer,105,250,355,11,52,UCBPlayer
25676,UCBPlayer,122,227,349,20,57,UCBPlayer
25677,UCBPlayer,109,259,368,15,49,UCBPlayer
25678,UCBPlayer,118,218,336,16,60,UCBPlayer
25679,UCBPlayer,117,267,384,19,45,UCBPlayer
25680,UCBPlayer,110,210,320,12,64,UCBPlayer
25681,UCBPlayer,126,271,397,23,42,UCBPlayer
25682,UCBPlayer,105,210,315,10,65,UCBPlayer
25683,UCBPlayer,130,275,405,25,40,UCBPlayer
25684,UCBPlayer,105,210,315,10,65,UCBPlayer
25685,UCBPlayer,130,275,405,25,40,UCBPlayer
25686,UCBPlayer,106,206,312,10,66,UCBPlayer
25687,UCBPlayer,130,275,405,25,40,UCBPlayer
25688,UCBPlayer,105,210,315,10,65,UCBPlayer
25689,UCBPlayer,131,271,402,25,41,UCBPlayer
25690,UCBPlayer,105,210,315,10,65,UCBPlayer
25691,UCBPlayer,130,275,405,25,40,UCBPlayer
25692,UCBPlayer,105,210,315,10,65,UCBPlayer
25693,UCBPlayer,130,275,405,25,40,UCBPlayer
25694,UCBPlayer,103,203,306,10,68,UCBPlayer
25695,UCBPlayer,128,283,411,25,38,UCBPlayer
25696,UCBPlayer,111,186,297,10,71,UCBPlayer
25697,UCBPlayer,124,299,423,25,34,UCBPlayer
25698,UCBPlayer,115,170,285,10,75,UCBPlayer
25699,UCBPlayer,120,315,435,25,30,UCBPlayer
25700,UCBPlayer,119,154,273,10,79,UCBPlayer
25701,UCBPlayer,112,332,444,25,27,UCBPlayer
25702,UCBPlayer,127,137,264,10,82,UCBPlayer
25703,UCBPlayer,104,349,453,25,24,UCBPlayer
25704,UCBPlayer,126,126,252,7,85,Tie
25705,UCBPlayer,111,351,462,28,22,UCBPlayer
25706,UCBPlayer,116,126,242,3,87,UCBPlayer
25707,UCBPlayer,122,347,469,32,21,UCBPlayer
25708,UCBPlayer,107,132,239,0,87,UCBPlayer
25709,UCBPlayer,132,337,469,35,22,UCBPlayer
25710,UCBPlayer,103,148,251,0,83,UCBPlayer
25711,UCBPlayer,136,321,457,35,26,UCBPlayer
25712,UCBPlayer,99,164,263,0,79,UCBPlayer
25713,UCBPlayer,140,305,445,35,30,UCBPlayer
25714,UCBPlayer,95,180,275,0,75,UCBPlayer
25715,UCBPlayer,144,289,433,35,34,UCBPlayer
25716,UCBPlayer,91,196,287,0,71,UCBPlayer
25717,UCBPlayer,148,273,421,35,38,UCBPlayer
25718,UCBPlayer,87,212,299,0,67,UCBPlayer
25719,UCBPlayer,152,257,409,35,42,UCBPlayer
25720,UCBPlayer,84,224,308,0,64,UCBPlayer
25721,UCBPlayer,146,251,397,32,45,UCBPlayer
25722,UCBPlayer,89,234,323,3,60,UCBPlayer
25723,UCBPlayer,138,243,381,28,49,UCBPlayer
25724,UCBPlayer,97,242,339,7,56,UCBPlayer
25725,UCBPlayer,130,235,365,24,53,UCBPlayer
25726,UCBPlayer,105,250,355,11,52,UCBPlayer
25727,UCBPlayer,122,227,349,20,57,UCBPlayer
25728,UCBPlayer,109,259,368,15,49,UCBPlayer
25729,UCBPlayer,118,218,336,16,60,UCBPlayer
25730,UCBPlayer,117,267,384,19,45,UCBPlayer
25731,UCBPlayer,110,210,320,12,64,UCBPlayer
25732,UCBPlayer,126,271,397,23,42,UCBPlayer
25733,UCBPlayer,105,210,315,10,65,UCBPlayer
25734,UCBPlayer,130,275,405,25,40,UCBPlayer
25735,UCBPlayer,105,210,315,10,65,UCBPlayer
25736,UCBPlayer,130,275,405,25,40,UCBPlayer
25737,UCBPlayer,106,206,312,10,66,UCBPlayer
25738,UCBPlayer,130,275,405,25,40,UCBPlayer
25739,UCBPlayer,105,210,315,10,65,UCBPlayer
25740,UCBPlayer,131,271,402,25,41,UCBPlayer
25741,UCBPlayer,105,210,315,10,65,UCBPlayer
25742,UCBPlayer,130,275,405,25,40,UCBPlayer
25743,UCBPlayer,105,210,315,10,65,UCBPlayer
25744,UCBPlayer,130,275,405,25,40,UCBPlayer
25745,UCBPlayer,103,203,306,10,68,UCBPlayer
25746,UCBPlayer,128,283,411,25,38,UCBPlayer
25747,UCBPlayer,111,186,297,10,71,UCBPlayer
25748,UCBPlayer,124,299,423,25,34,UCBPlayer
25749,UCBPlayer,115,170,285,10,75,UCBPlayer
25750,UCBPlayer,120,315,435,25,30,UCBPlayer
25751,UCBPlayer,119,154,273,10,79,UCBPlayer
25752,UCBPlayer,112,332,444,25,27,UCBPlayer
25753,UCBPlayer,127,137,264,10,82,UCBPlayer
25754,UCBPlayer,104,349,453,25,24,UCBPlayer
25755,UCBPlayer,126,126,252,7,85,Tie
25756,UCBPlayer,111,351,462,28,22,UCBPlayer
25757,UCBPlayer,116,126,242,3,87,UCBPlayer
25758,UCBPlayer,122,347,469,32,21,UCBPlayer
25759,UCBPlayer,107,132,239,0,87,UCBPlayer
25760,UCBPlayer,132,337,469,35,22,UCBPlayer
25761,UCBPlayer,103,148,251,0,83,UCBPlayer
25762,UCBPlayer,136,321,457,35,26,UCBPlayer
25763,UCBPlayer,99,164,263,0,79,UCBPlayer
25764,UCBPlayer,140,305,445,35,30,UCBPlayer
25765,UCBPlayer,95,180,275,0,75,UCBPlayer
25766,UCBPlayer,144,289,433,35,34,UCBPlayer
25767,UCBPlayer,91,196,287,0,71,UCBPlayer
25768,UCBPlayer,148,273,421,35,38,UCBPlayer
25769,UCBPlayer,87,212,299,0,67,UCBPlayer
25770,UCBPlayer,152,257,409,35,42,UCBPlayer
25771,UCBPlayer,84,224,308,0,64,UCBPlayer
25772,UCBPlayer,146,251,397,32,45,UCBPlayer
25773,UCBPlayer,89,234,323,3,60,UCBPlayer
25774,UCBPlayer,138,243,381,28,49,UCBPlayer
25775,UCBPlayer,97,242,339,7,56,UCBPlayer
25776,UCBPlayer,130,235,365,24,53,UCBPlayer
25777,UCBPlayer,105,250,355,11,52,UCBPlayer
25778,UCBPlayer,122,227,349,20,57,UCBPlayer
25779,UCBPlayer,109,259,368,15,49,UCBPlayer
25780,UCBPlayer,118,218,336,16,60,UCBPlayer
25781,UCBPlayer,117,267,384,19,45,UCBPlayer
25782,UCBPlayer,110,210,320,12,64,UCBPlayer
25783,UCBPlayer,126,271,397,23,42,UCBPlayer
25784,UCBPlayer,105,210,315,10,65,UCBPlayer
25785,UCBPlayer,130,275,405,25,40,UCBPlayer
25786,UCBPlayer,105,210,315,10,65,UCBPlayer
25787,UCBPlayer,130,275,405,25,40,UCBPlayer
25788,UCBPlayer,106,206,312,10,66,UCBPlayer
25789,UCBPlayer,130,275,405,25,40,UCBPlayer
25790,UCBPlayer,105,210,315,10,65,UCBPlayer
25791,UCBPlayer,131,271,402,25,41,UCBPlayer
25792,UCBPlayer,105,210,315,10,65,UCBPlayer
25793,UCBPlayer,130,275,405,25,40,UCBPlayer
25794,UCBPlayer,105,210,315,10,65,UCBPlayer
25795,UCBPlayer,130,275,405,25,40,UCBPlayer
25796,UCBPlayer,103,203,306,10,68,UCBPlayer
25797,UCBPlayer,128,283,411,25,38,UCBPlayer
25798,UCBPlayer,111,186,297,10,71,UCBPlayer
25799,UCBPlayer,124,299,423,25,34,UCBPlayer
25800,UCBPlayer,115,170,285,10,75,UCBPlayer
25801,UCBPlayer,120,315,435,25,30,UCBPlayer
25802,UCBPlayer,119,154,273,10,79,UCBPlayer
25803,UCBPlayer,112,332,444,25,27,UCBPlayer
25804,UCBPlayer,127,137,264,10,82,UCBPlayer
25805,UCBPlayer,104,349,453,25,24,UCBPlayer
25806,UCBPlayer,126,126,252,7,85,Tie
25807,UCBPlayer,111,351,462,28,22,UCBPlayer
25808,UCBPlayer,116,126,242,3,87,UCBPlayer
25809,UCBPlayer,122,347,469,32,21,UCBPlayer
25810,UCBPlayer,107,132,239,0,87,UCBPlayer
25811,UCBPlayer,132,337,469,35,22,UCBPlayer
25812,UCBPlayer,103,148,251,0,83,UCBPlayer
25813,UCBPlayer,136,321,457,35,26,UCBPlayer
25814,UCBPlayer,99,164,263,0,79,UCBPlayer
25815,UCBPlayer,140,305,445,35,30,UCBPlayer
25816,UCBPlayer,95,180,275,0,75,UCBPlayer
25817,UCBPlayer,144,289,433,35,34,UCBPlayer
25818,UCBPlayer,91,196,287,0,71,UCBPlayer
25819,UCBPlayer,148,273,421,35,38,UCBPlayer
25820,UCBPlayer,87,212,299,0,67,UCBPlayer
25821,UCBPlayer,152,257,409,35,42,UCBPlayer
25822,UCBPlayer,84,224,308,0,64,UCBPlayer
25823,UCBPlayer,146,251,397,32,45,UCBPlayer
25824,UCBPlayer,89,234,323,3,60,UCBPlayer
25825,UCBPlayer,138,243,381,28,49,UCBPlayer
25826,UCBPlayer,97,242,339,7,56,UCBPlayer
25827,UCBPlayer,130,235,365,24,53,UCBPlayer
25828,UCBPlayer,105,250,355,11,52,UCBPlayer
25829,UCBPlayer,122,227,349,20,57,UCBPlayer
25830,UCBPlayer,109,259,368,15,49,UCBPlayer
25831,UCBPlayer,118,218,336,16,60,UCBPlayer
25832,UCBPlayer,117,267,384,19,45,UCBPlayer
25833,UCBPlayer,110,210,320,12,64,UCBPlayer
25834,UCBPlayer,126,271,397,23,42,UCBPlayer
25835,UCBPlayer,105,210,315,10,65,UCBPlayer
25836,UCBPlayer,130,275,405,25,40,UCBPlayer
25837,UCBPlayer,105,210,315,10,65,UCBPlayer
25838,UCBPlayer,130,275,405,25,40,UCBPlayer
25839,UCBPlayer,106,206,312,10,66,UCBPlayer
25840,UCBPlayer,130,275,405,25,40,UCBPlayer
25841,UCBPlayer,105,210,315,10,65,UCBPlayer
25842,UCBPlayer,131,271,402,25,41,UCBPlayer
25843,UCBPlayer,105,210,315,10,65,UCBPlayer
25844,UCBPlayer,130,275,405,25,40,UCBPlayer
25845,UCBPlayer,105,210,315,10,65,UCBPlayer
25846,UCBPlayer,130,275,405,25,40,UCBPlayer
25847,UCBPlayer,103,203,306,10,68,UCBPlayer
25848,UCBPlayer,128,283,411,25,38,UCBPlayer
25849,UCBPlayer,111,186,297,10,71,UCBPlayer
25850,UCBPlayer,124,299,423,25,34,UCBPlayer
25851,UCBPlayer,115,170,285,10,75,UCBPlayer
25852,UCBPlayer,120,315,435,25,30,UCBPlayer
25853,UCBPlayer,119,154,273,10,79,UCBPlayer
25854,UCBPlayer,112,332,444,25,27,UCBPlayer
25855,UCBPlayer,127,137,264,10,82,UCBPlayer
25856,UCBPlayer,104,349,453,25,24,UCBPlayer
25857,UCBPlayer,126,126,252,7,85,Tie
25858,UCBPlayer,111,351,462,28,22,UCBPlayer
25859,UCBPlayer,116,126,242,3,87,UCBPlayer
25860,UCBPlayer,122,347,469,32,21,UCBPlayer
25861,UCBPlayer,107,132,239,0,87,UCBPlayer
25862,UCBPlayer,132,337,469,35,22,UCBPlayer
25863,UCBPlayer,103,148,251,0,83,UCBPlayer
25864,UCBPlayer,136,321,457,35,26,UCBPlayer
25865,UCBPlayer,99,164,263,0,79,UCBPlayer
25866,UCBPlayer,140,305,445,35,30,UCBPlayer
25867,UCBPlayer,95,180,275,0,75,UCBPlayer
25868,UCBPlayer,144,289,433,35,34,UCBPlayer
25869,UCBPlayer,91,196,287,0,71,UCBPlayer
25870,UCBPlayer,148,273,421,35,38,UCBPlayer
25871,UCBPlayer,87,212,299,0,67,UCBPlayer
25872,UCBPlayer,152,257,409,35,42,UCBPlayer
25873,UCBPlayer,84,224,308,0,64,UCBPlayer
25874,UCBPlayer,146,251,397,32,45,UCBPlayer
25875,UCBPlayer,89,234,323,3,60,UCBPlayer
25876,UCBPlayer,138,243,381,28,49,UCBPlayer
25877,UCBPlayer,97,242,339,7,56,UCBPlayer
25878,UCBPlayer,130,235,365,24,53,UCBPlayer
25879,UCBPlayer,105,250,355,11,52,UCBPlayer
25880,UCBPlayer,122,227,349,20,57,UCBPlayer
25881,UCBPlayer,109,259,368,15,49,UCBPlayer
25882,UCBPlayer,118,218,336,16,60,UCBPlayer
25883,UCBPlayer,117,267,384,19,45,UCBPlayer
25884,UCBPlayer,110,210,320,12,64,UCBPlayer
25885,UCBPlayer,126,271,397,23,42,UCBPlayer
25886,UCBPlayer,105,210,315,10,65,UCBPlayer
25887,UCBPlayer,130,275,405,25,40,UCBPlayer
25888,UCBPlayer,105,210,315,10,65,UCBPlayer
25889,UCBPlayer,130,275,405,25,40,UCBPlayer
25890,UCBPlayer,106,206,312,10,66,UCBPlayer
25891,UCBPlayer,130,275,405,25,40,UCBPlayer
25892,UCBPlayer,105,210,315,10,65,UCBPlayer
25893,UCBPlayer,131,271,402,25,41,UCBPlayer
25894,UCBPlayer,105,210,315,10,65,UCBPlayer
25895,UCBPlayer,130,275,405,25,40,UCBPlayer
25896,UCBPlayer,105,210,315,10,65,UCBPlayer
25897,UCBPlayer,130,275,405,25,40,UCBPlayer
25898,UCBPlayer,103,203,306,10,68,UCBPlayer
25899,UCBPlayer,128,283,411,25,38,UCBPlayer
25900,UCBPlayer,111,186,297,10,71,UCBPlayer
25901,UCBPlayer,124,299,423,25,34,UCBPlayer
25902,UCBPlayer,115,170,285,10,75,UCBPlayer
25903,UCBPlayer,120,315,435,25,30,UCBPlayer
25904,UCBPlayer,119,154,273,10,79,UCBPlayer
25905,UCBPlayer,112,332,444,25,27,UCBPlayer
25906,UCBPlayer,127,137,264,10,82,UCBPlayer
25907,UCBPlayer,104,349,453,25,24,UCBPlayer
25908,UCBPlayer,126,126,252,7,85,Tie
25909,UCBPlayer,111,351,462,28,22,UCBPlayer
25910,UCBPlayer,116,126,242,3,87,UCBPlayer
25911,UCBPlayer,122,347,469,32,21,UCBPlayer
25912,UCBPlayer,107,132,239,0,87,UCBPlayer
25913,UCBPlayer,132,337,469,35,22,UCBPlayer
25914,UCBPlayer,103,148,251,0,83,UCBPlayer
25915,UCBPlayer,136,321,457,35,26,UCBPlayer
25916,UCBPlayer,99,164,263,0,79,UCBPlayer
25917,UCBPlayer,140,305,445,35,30,UCBPlayer
25918,UCBPlayer,95,180,275,0,75,UCBPlayer
25919,UCBPlayer,144,289,433,35,34,UCBPlayer
25920,UCBPlayer,91,196,287,0,71,UCBPlayer
25921,UCBPlayer,148,273,421,35,38,UCBPlayer
25922,UCBPlayer,87,212,299,0,67,UCBPlayer
25923,UCBPlayer,152,257,409,35,42,UCBPlayer
25924,UCBPlayer,84,224,308,0,64,UCBPlayer
25925,UCBPlayer,146,251,397,32,45,UCBPlayer
25926,UCBPlayer,89,234,323,3,60,UCBPlayer
25927,UCBPlayer,138,243,381,28,49,UCBPlayer
25928,UCBPlayer,97,242,339,7,56,UCBPlayer
25929,UCBPlayer,130,235,365,24,53,UCBPlayer
25930,UCBPlayer,105,250,355,11,52,UCBPlayer
25931,UCBPlayer,122,227,349,20,57,UCBPlayer
25932,UCBPlayer,109,259,368,15,49,UCBPlayer
25933,UCBPlayer,118,218,336,16,60,UCBPlayer
25934,UCBPlayer,117,267,384,19,45,UCBPlayer
25935,UCBPlayer,110,210,320,12,64,UCBPlayer
25936,UCBPlayer,126,271,397,23,42,UCBPlayer
25937,UCBPlayer,105,210,315,10,65,UCBPlayer
25938,UCBPlayer,130,275,405,25,40,UCBPlayer
25939,UCBPlayer,105,210,315,10,65,UCBPlayer
25940,UCBPlayer,130,275,405,25,40,UCBPlayer
25941,UCBPlayer,106,206,312,10,66,UCBPlayer
25942,UCBPlayer,130,275,405,25,40,UCBPlayer
25943,UCBPlayer,105,210,315,10,65,UCBPlayer
25944,UCBPlayer,131,271,402,25,41,UCBPlayer
25945,UCBPlayer,105,210,315,10,65,UCBPlayer
25946,UCBPlayer,130,275,405,25,40,UCBPlayer
25947,UCBPlayer,105,210,315,10,65,UCBPlayer
25948,UCBPlayer,130,275,405,25,40,UCBPlayer
25949,UCBPlayer,103,203,306,10,68,UCBPlayer
25950,UCBPlayer,128,283,411,25,38,UCBPlayer
25951,UCBPlayer,111,186,297,10,71,UCBPlayer
25952,UCBPlayer,124,299,423,25,34,UCBPlayer
25953,UCBPlayer,115,170,285,10,75,UCBPlayer
25954,UCBPlayer,120,315,435,25,30,UCBPlayer
25955,UCBPlayer,119,154,273,10,79,UCBPlayer
25956,UCBPlayer,112,332,444,25,27,UCBPlayer
25957,UCBPlayer,127,137,264,10,82,UCBPlayer
25958,UCBPlayer,104,349,453,25,24,UCBPlayer
25959,UCBPlayer,126,126,252,7,85,Tie
25960,UCBPlayer,111,351,462,28,22,UCBPlayer
25961,UCBPlayer,116,126,242,3,87,UCBPlayer
25962,UCBPlayer,122,347,469,32,21,UCBPlayer
25963,UCBPlayer,107,132,239,0,87,UCBPlayer
25964,UCBPlayer,132,337,469,35,22,UCBPlayer
25965,UCBPlayer,103,148,251,0,83,UCBPlayer
25966,UCBPlayer,136,321,457,35,26,UCBPlayer
25967,UCBPlayer,99,164,263,0,79,UCBPlayer
25968,UCBPlayer,140,305,445,35,30,UCBPlayer
25969,UCBPlayer,95,180,275,0,75,UCBPlayer
25970,UCBPlayer,144,289,433,35,34,UCBPlayer
25971,UCBPlayer,91,196,287,0,71,UCBPlayer
25972,UCBPlayer,148,273,421,35,38,UCBPlayer
25973,UCBPlayer,87,212,299,0,67,UCBPlayer
25974,UCBPlayer,152,257,409,35,42,UCBPlayer
25975,UCBPlayer,84,224,308,0,64,UCBPlayer
25976,UCBPlayer,146,251,397,32,45,UCBPlayer
25977,UCBPlayer,89,234,323,3,60,UCBPlayer
25978,UCBPlayer,138,243,381,28,49,UCBPlayer
25979,UCBPlayer,97,242,339,7,56,UCBPlayer
25980,UCBPlayer,130,235,365,24,53,UCBPlayer
25981,UCBPlayer,105,250,355,11,52,UCBPlayer
25982,UCBPlayer,122,227,349,20,57,UCBPlayer
25983,UCBPlayer,109,259,368,15,49,UCBPlayer
25984,UCBPlayer,118,218,336,16,60,UCBPlayer
25985,UCBPlayer,117,267,384,19,45,UCBPlayer
25986,UCBPlayer,110,210,320,12,64,UCBPlayer
25987,UCBPlayer,126,271,397,23,42,UCBPlayer
25988,UCBPlayer,105,210,315,10,65,UCBPlayer
25989,UCBPlayer,130,275,405,25,40,UCBPlayer
25990,UCBPlayer,105,210,315,10,65,UCBPlayer
25991,UCBPlayer,130,275,405,25,40,UCBPlayer
25992,UCBPlayer,106,206,312,10,66,UCBPlayer
25993,UCBPlayer,130,275,405,25,40,UCBPlayer
25994,UCBPlayer,105,210,315,10,65,UCBPlayer
25995,UCBPlayer,131,271,402,25,41,UCBPlayer
25996,UCBPlayer,105,210,315,10,65,UCBPlayer
25997,UCBPlayer,130,275,405,25,40,UCBPlayer
25998,UCBPlayer,105,210,315,10,65,UCBPlayer
25999,UCBPlayer,130,275,405,25,40,UCBPlayer
26000,UCBPlayer,103,203,306,10,68,UCBPlayer
26001,UCBPlayer,128,283,411,25,38,UCBPlayer
26002,UCBPlayer,111,186,297,10,71,UCBPlayer
26003,UCBPlayer,124,299,423,25,34,UCBPlayer
26004,UCBPlayer,115,170,285,10,75,UCBPlayer
26005,UCBPlayer,120,315,435,25,30,UCBPlayer
26006,UCBPlayer,119,154,273,10,79,UCBPlayer
26007,UCBPlayer,112,332,444,25,27,UCBPlayer
26008,UCBPlayer,127,137,264,10,82,UCBPlayer
26009,UCBPlayer,104,349,453,25,24,UCBPlayer
26010,UCBPlayer,126,126,252,7,85,Tie
26011,UCBPlayer,111,351,462,28,22,UCBPlayer
26012,UCBPlayer,116,126,242,3,87,UCBPlayer
26013,UCBPlayer,122,347,469,32,21,UCBPlayer
26014,UCBPlayer,107,132,239,0,87,UCBPlayer
26015,UCBPlayer,132,337,469,35,22,UCBPlayer
26016,UCBPlayer,103,148,251,0,83,UCBPlayer
26017,UCBPlayer,136,321,457,35,26,UCBPlayer
26018,UCBPlayer,99,164,263,0,79,UCBPlayer
26019,UCBPlayer,140,305,445,35,30,UCBPlayer
26020,UCBPlayer,95,180,275,0,75,UCBPlayer
26021,UCBPlayer,144,289,433,35,34,UCBPlayer
26022,UCBPlayer,91,196,287,0,71,UCBPlayer
26023,UCBPlayer,148,273,421,35,38,UCBPlayer
26024,UCBPlayer,87,212,299,0,67,UCBPlayer
26025,UCBPlayer,152,257,409,35,42,UCBPlayer
26026,UCBPlayer,84,224,308,0,64,UCBPlayer
26027,UCBPlayer,146,251,397,32,45,UCBPlayer
26028,UCBPlayer,89,234,323,3,60,UCBPlayer
26029,UCBPlayer,138,243,381,28,49,UCBPlayer
26030,UCBPlayer,97,242,339,7,56,UCBPlayer
26031,UCBPlayer,130,235,365,24,53,UCBPlayer
26032,UCBPlayer,105,250,355,11,52,UCBPlayer
26033,UCBPlayer,122,227,349,20,57,UCBPlayer
26034,UCBPlayer,109,259,368,15,49,UCBPlayer
26035,UCBPlayer,118,218,336,16,60,UCBPlayer
26036,UCBPlayer,117,267,384,19,45,UCBPlayer
26037,UCBPlayer,110,210,320,12,64,UCBPlayer
26038,UCBPlayer,126,271,397,23,42,UCBPlayer
26039,UCBPlayer,105,210,315,10,65,UCBPlayer
26040,UCBPlayer,130,275,405,25,40,UCBPlayer
26041,UCBPlayer,105,210,315,10,65,UCBPlayer
26042,UCBPlayer,130,275,405,25,40,UCBPlayer
26043,UCBPlayer,106,206,312,10,66,UCBPlayer
26044,UCBPlayer,130,275,405,25,40,UCBPlayer
26045,UCBPlayer,105,210,315,10,65,UCBPlayer
26046,UCBPlayer,131,271,402,25,41,UCBPlayer
26047,UCBPlayer,105,210,315,10,65,UCBPlayer
26048,UCBPlayer,130,275,405,25,40,UCBPlayer
26049,UCBPlayer,105,210,315,10,65,UCBPlayer
26050,UCBPlayer,130,275,405,25,40,UCBPlayer
26051,UCBPlayer,103,203,306,10,68,UCBPlayer
26052,UCBPlayer,128,283,411,25,38,UCBPlayer
26053,UCBPlayer,111,186,297,10,71,UCBPlayer
26054,UCBPlayer,124,299,423,25,34,UCBPlayer
26055,UCBPlayer,115,170,285,10,75,UCBPlayer
26056,UCBPlayer,120,315,435,25,30,UCBPlayer
26057,UCBPlayer,119,154,273,10,79,UCBPlayer
26058,UCBPlayer,112,332,444,25,27,UCBPlayer
26059,UCBPlayer,127,137,264,10,82,UCBPlayer
26060,UCBPlayer,104,349,453,25,24,UCBPlayer
26061,UCBPlayer,126,126,252,7,85,Tie
26062,UCBPlayer,111,351,462,28,22,UCBPlayer
26063,UCBPlayer,116,126,242,3,87,UCBPlayer
26064,UCBPlayer,122,347,469,32,21,UCBPlayer
26065,UCBPlayer,107,132,239,0,87,UCBPlayer
26066,UCBPlayer,132,337,469,35,22,UCBPlayer
26067,UCBPlayer,103,148,251,0,83,UCBPlayer
26068,UCBPlayer,136,321,457,35,26,UCBPlayer
26069,UCBPlayer,99,164,263,0,79,UCBPlayer
26070,UCBPlayer,140,305,445,35,30,UCBPlayer
26071,UCBPlayer,95,180,275,0,75,UCBPlayer
26072,UCBPlayer,144,289,433,35,34,UCBPlayer
26073,UCBPlayer,91,196,287,0,71,UCBPlayer
26074,UCBPlayer,148,273,421,35,38,UCBPlayer
26075,UCBPlayer,87,212,299,0,67,UCBPlayer
26076,UCBPlayer,152,257,409,35,42,UCBPlayer
26077,UCBPlayer,84,224,308,0,64,UCBPlayer
26078,UCBPlayer,146,251,397,32,45,UCBPlayer
26079,UCBPlayer,89,234,323,3,60,UCBPlayer
26080,UCBPlayer,138,243,381,28,49,UCBPlayer
26081,UCBPlayer,97,242,339,7,56,UCBPlayer
26082,UCBPlayer,130,235,365,24,53,UCBPlayer
26083,UCBPlayer,105,250,355,11,52,UCBPlayer
26084,UCBPlayer,122,227,349,20,57,UCBPlayer
26085,UCBPlayer,109,259,368,15,49,UCBPlayer
26086,UCBPlayer,118,218,336,16,60,UCBPlayer
26087,UCBPlayer,117,267,384,19,45,UCBPlayer
26088,UCBPlayer,110,210,320,12,64,UCBPlayer
26089,UCBPlayer,126,271,397,23,42,UCBPlayer
26090,UCBPlayer,105,210,315,10,65,UCBPlayer
26091,UCBPlayer,130,275,405,25,40,UCBPlayer
26092,UCBPlayer,105,210,315,10,65,UCBPlayer
26093,UCBPlayer,130,275,405,25,40,UCBPlayer
26094,UCBPlayer,106,206,312,10,66,UCBPlayer
26095,UCBPlayer,130,275,405,25,40,UCBPlayer
26096,UCBPlayer,105,210,315,10,65,UCBPlayer
26097,UCBPlayer,131,271,402,25,41,UCBPlayer
26098,UCBPlayer,105,210,315,10,65,UCBPlayer
26099,UCBPlayer,130,275,405,25,40,UCBPlayer
26100,UCBPlayer,105,210,315,10,65,UCBPlayer
26101,UCBPlayer,130,275,405,25,40,UCBPlayer
26102,UCBPlayer,103,203,306,10,68,UCBPlayer
26103,UCBPlayer,128,283,411,25,38,UCBPlayer
26104,UCBPlayer,111,186,297,10,71,UCBPlayer
26105,UCBPlayer,124,299,423,25,34,UCBPlayer
26106,UCBPlayer,115,170,285,10,75,UCBPlayer
26107,UCBPlayer,120,315,435,25,30,UCBPlayer
26108,UCBPlayer,119,154,273,10,79,UCBPlayer
26109,UCBPlayer,112,332,444,25,27,UCBPlayer
26110,UCBPlayer,127,137,264,10,82,UCBPlayer
26111,UCBPlayer,104,349,453,25,24,UCBPlayer
26112,UCBPlayer,126,126,252,7,85,Tie
26113,UCBPlayer,111,351,462,28,22,UCBPlayer
26114,UCBPlayer,116,126,242,3,87,UCBPlayer
26115,UCBPlayer,122,347,469,32,21,UCBPlayer
26116,UCBPlayer,107,132,239,0,87,UCBPlayer
26117,UCBPlayer,132,337,469,35,22,UCBPlayer
26118,UCBPlayer,103,148,251,0,83,UCBPlayer
26119,UCBPlayer,136,321,457,35,26,UCBPlayer
26120,UCBPlayer,99,164,263,0,79,UCBPlayer
26121,UCBPlayer,140,305,445,35,30,UCBPlayer
26122,UCBPlayer,95,180,275,0,75,UCBPlayer
26123,UCBPlayer,144,289,433,35,34,UCBPlayer
26124,UCBPlayer,91,196,287,0,71,UCBPlayer
26125,UCBPlayer,148,273,421,35,38,UCBPlayer
26126,UCBPlayer,87,212,299,0,67,UCBPlayer
26127,UCBPlayer,152,257,409,35,42,UCBPlayer
26128,UCBPlayer,84,224,308,0,64,UCBPlayer
26129,UCBPlayer,146,251,397,32,45,UCBPlayer
26130,UCBPlayer,89,234,323,3,60,UCBPlayer
26131,UCBPlayer,138,243,381,28,49,UCBPlayer
26132,UCBPlayer,97,242,339,7,56,UCBPlayer
26133,UCBPlayer,130,235,365,24,53,UCBPlayer
26134,UCBPlayer,105,250,355,11,52,UCBPlayer
26135,UCBPlayer,122,227,349,20,57,UCBPlayer
26136,UCBPlayer,109,259,368,15,49,UCBPlayer
26137,UCBPlayer,118,218,336,16,60,UCBPlayer
26138,UCBPlayer,117,267,384,19,45,UCBPlayer
26139,UCBPlayer,110,210,320,12,64,UCBPlayer
26140,UCBPlayer,126,271,397,23,42,UCBPlayer
26141,UCBPlayer,105,210,315,10,65,UCBPlayer
26142,UCBPlayer,130,275,405,25,40,UCBPlayer
26143,UCBPlayer,105,210,315,10,65,UCBPlayer
26144,UCBPlayer,130,275,405,25,40,UCBPlayer
26145,UCBPlayer,106,206,312,10,66,UCBPlayer
26146,UCBPlayer,130,275,405,25,40,UCBPlayer
26147,UCBPlayer,105,210,315,10,65,UCBPlayer
26148,UCBPlayer,131,271,402,25,41,UCBPlayer
26149,UCBPlayer,105,210,315,10,65,UCBPlayer
26150,UCBPlayer,130,275,405,25,40,UCBPlayer
26151,UCBPlayer,105,210,315,10,65,UCBPlayer
26152,UCBPlayer,130,275,405,25,40,UCBPlayer
26153,UCBPlayer,103,203,306,10,68,UCBPlayer
26154,UCBPlayer,128,283,411,25,38,UCBPlayer
26155,UCBPlayer,111,186,297,10,71,UCBPlayer
26156,UCBPlayer,124,299,423,25,34,UCBPlayer
26157,UCBPlayer,115,170,285,10,75,UCBPlayer
26158,UCBPlayer,120,315,435,25,30,UCBPlayer
26159,UCBPlayer,119,154,273,10,79,UCBPlayer
26160,UCBPlayer,112,332,444,25,27,UCBPlayer
26161,UCBPlayer,127,137,264,10,82,UCBPlayer
26162,UCBPlayer,104,349,453,25,24,UCBPlayer
26163,UCBPlayer,126,126,252,7,85,Tie
26164,UCBPlayer,111,351,462,28,22,UCBPlayer
26165,UCBPlayer,116,126,242,3,87,UCBPlayer
26166,UCBPlayer,122,347,469,32,21,UCBPlayer
26167,UCBPlayer,107,132,239,0,87,UCBPlayer
26168,UCBPlayer,132,337,469,35,22,UCBPlayer
26169,UCBPlayer,103,148,251,0,83,UCBPlayer
26170,UCBPlayer,136,321,457,35,26,UCBPlayer
26171,UCBPlayer,99,164,263,0,79,UCBPlayer
26172,UCBPlayer,140,305,445,35,30,UCBPlayer
26173,UCBPlayer,95,180,275,0,75,UCBPlayer
26174,UCBPlayer,144,289,433,35,34,UCBPlayer
26175,UCBPlayer,91,196,287,0,71,UCBPlayer
26176,UCBPlayer,148,273,421,35,38,UCBPlayer
26177,UCBPlayer,87,212,299,0,67,UCBPlayer
26178,UCBPlayer,152,257,409,35,42,UCBPlayer
26179,UCBPlayer,84,224,308,0,64,UCBPlayer
26180,UCBPlayer,146,251,397,32,45,UCBPlayer
26181,UCBPlayer,89,234,323,3,60,UCBPlayer
26182,UCBPlayer,138,243,381,28,49,UCBPlayer
26183,UCBPlayer,97,242,339,7,56,UCBPlayer
26184,UCBPlayer,130,235,365,24,53,UCBPlayer
26185,UCBPlayer,105,250,355,11,52,UCBPlayer
26186,UCBPlayer,122,227,349,20,57,UCBPlayer
26187,UCBPlayer,109,259,368,15,49,UCBPlayer
26188,UCBPlayer,118,218,336,16,60,UCBPlayer
26189,UCBPlayer,117,267,384,19,45,UCBPlayer
26190,UCBPlayer,110,210,320,12,64,UCBPlayer
26191,UCBPlayer,126,271,397,23,42,UCBPlayer
26192,UCBPlayer,105,210,315,10,65,UCBPlayer
26193,UCBPlayer,130,275,405,25,40,UCBPlayer
26194,UCBPlayer,105,210,315,10,65,UCBPlayer
26195,UCBPlayer,130,275,405,25,40,UCBPlayer
26196,UCBPlayer,106,206,312,10,66,UCBPlayer
26197,UCBPlayer,130,275,405,25,40,UCBPlayer
26198,UCBPlayer,105,210,315,10,65,UCBPlayer
26199,UCBPlayer,131,271,402,25,41,UCBPlayer
26200,UCBPlayer,105,210,315,10,65,UCBPlayer
26201,UCBPlayer,130,275,405,25,40,UCBPlayer
26202,UCBPlayer,105,210,315,10,65,UCBPlayer
26203,UCBPlayer,130,275,405,25,40,UCBPlayer
26204,UCBPlayer,103,203,306,10,68,UCBPlayer
26205,UCBPlayer,128,283,411,25,38,UCBPlayer
26206,UCBPlayer,111,186,297,10,71,UCBPlayer
26207,UCBPlayer,124,299,423,25,34,UCBPlayer
26208,UCBPlayer,115,170,285,10,75,UCBPlayer
26209,UCBPlayer,120,315,435,25,30,UCBPlayer
26210,UCBPlayer,119,154,273,10,79,UCBPlayer
26211,UCBPlayer,112,332,444,25,27,UCBPlayer
26212,UCBPlayer,127,137,264,10,82,UCBPlayer
26213,UCBPlayer,104,349,453,25,24,UCBPlayer
26214,UCBPlayer,126,126,252,7,85,Tie
26215,UCBPlayer,111,351,462,28,22,UCBPlayer
26216,UCBPlayer,116,126,242,3,87,UCBPlayer
26217,UCBPlayer,122,347,469,32,21,UCBPlayer
26218,UCBPlayer,107,132,239,0,87,UCBPlayer
26219,UCBPlayer,132,337,469,35,22,UCBPlayer
26220,UCBPlayer,103,148,251,0,83,UCBPlayer
26221,UCBPlayer,136,321,457,35,26,UCBPlayer
26222,UCBPlayer,99,164,263,0,79,UCBPlayer
26223,UCBPlayer,140,305,445,35,30,UCBPlayer
26224,UCBPlayer,95,180,275,0,75,UCBPlayer
26225,UCBPlayer,144,289,433,35,34,UCBPlayer
26226,UCBPlayer,91,196,287,0,71,UCBPlayer
26227,UCBPlayer,148,273,421,35,38,UCBPlayer
26228,UCBPlayer,87,212,299,0,67,UCBPlayer
26229,UCBPlayer,152,257,409,35,42,UCBPlayer
26230,UCBPlayer,84,224,308,0,64,UCBPlayer
26231,UCBPlayer,146,251,397,32,45,UCBPlayer
26232,UCBPlayer,89,234,323,3,60,UCBPlayer
26233,UCBPlayer,138,243,381,28,49,UCBPlayer
26234,UCBPlayer,97,242,339,7,56,UCBPlayer
26235,UCBPlayer,130,235,365,24,53,UCBPlayer
26236,UCBPlayer,105,250,355,11,52,UCBPlayer
26237,UCBPlayer,122,227,349,20,57,UCBPlayer
26238,UCBPlayer,109,259,368,15,49,UCBPlayer
26239,UCBPlayer,118,218,336,16,60,UCBPlayer
26240,UCBPlayer,117,267,384,19,45,UCBPlayer
26241,UCBPlayer,110,210,320,12,64,UCBPlayer
26242,UCBPlayer,126,271,397,23,42,UCBPlayer
26243,UCBPlayer,105,210,315,10,65,UCBPlayer
26244,UCBPlayer,130,275,405,25,40,UCBPlayer
26245,UCBPlayer,105,210,315,10,65,UCBPlayer
26246,UCBPlayer,130,275,405,25,40,UCBPlayer
26247,UCBPlayer,106,206,312,10,66,UCBPlayer
26248,UCBPlayer,130,275,405,25,40,UCBPlayer
26249,UCBPlayer,105,210,315,10,65,UCBPlayer
26250,UCBPlayer,131,271,402,25,41,UCBPlayer
26251,UCBPlayer,105,210,315,10,65,UCBPlayer
26252,UCBPlayer,130,275,405,25,40,UCBPlayer
26253,UCBPlayer,105,210,315,10,65,UCBPlayer
26254,UCBPlayer,130,275,405,25,40,UCBPlayer
26255,UCBPlayer,103,203,306,10,68,UCBPlayer
26256,UCBPlayer,128,283,411,25,38,UCBPlayer
26257,UCBPlayer,111,186,297,10,71,UCBPlayer
26258,UCBPlayer,124,299,423,25,34,UCBPlayer
26259,UCBPlayer,115,170,285,10,75,UCBPlayer
26260,UCBPlayer,120,315,435,25,30,UCBPlayer
26261,UCBPlayer,119,154,273,10,79,UCBPlayer
26262,UCBPlayer,112,332,444,25,27,UCBPlayer
26263,UCBPlayer,127,137,264,10,82,UCBPlayer
26264,UCBPlayer,104,349,453,25,24,UCBPlayer
26265,UCBPlayer,126,126,252,7,85,Tie
26266,UCBPlayer,111,351,462,28,22,UCBPlayer
26267,UCBPlayer,116,126,242,3,87,UCBPlayer
26268,UCBPlayer,122,347,469,32,21,UCBPlayer
26269,UCBPlayer,107,132,239,0,87,UCBPlayer
26270,UCBPlayer,132,337,469,35,22,UCBPlayer
26271,UCBPlayer,103,148,251,0,83,UCBPlayer
26272,UCBPlayer,136,321,457,35,26,UCBPlayer
26273,UCBPlayer,99,164,263,0,79,UCBPlayer
26274,UCBPlayer,140,305,445,35,30,UCBPlayer
26275,UCBPlayer,95,180,275,0,75,UCBPlayer
26276,UCBPlayer,144,289,433,35,34,UCBPlayer
26277,UCBPlayer,91,196,287,0,71,UCBPlayer
26278,UCBPlayer,148,273,421,35,38,UCBPlayer
26279,UCBPlayer,87,212,299,0,67,UCBPlayer
26280,UCBPlayer,152,257,409,35,42,UCBPlayer
26281,UCBPlayer,84,224,308,0,64,UCBPlayer
26282,UCBPlayer,146,251,397,32,45,UCBPlayer
26283,UCBPlayer,89,234,323,3,60,UCBPlayer
26284,UCBPlayer,138,243,381,28,49,UCBPlayer
26285,UCBPlayer,97,242,339,7,56,UCBPlayer
26286,UCBPlayer,130,235,365,24,53,UCBPlayer
26287,UCBPlayer,105,250,355,11,52,UCBPlayer
26288,UCBPlayer,122,227,349,20,57,UCBPlayer
26289,UCBPlayer,109,259,368,15,49,UCBPlayer
26290,UCBPlayer,118,218,336,16,60,UCBPlayer
26291,UCBPlayer,117,267,384,19,45,UCBPlayer
26292,UCBPlayer,110,210,320,12,64,UCBPlayer
26293,UCBPlayer,126,271,397,23,42,UCBPlayer
26294,UCBPlayer,105,210,315,10,65,UCBPlayer
26295,UCBPlayer,130,275,405,25,40,UCBPlayer
26296,UCBPlayer,105,210,315,10,65,UCBPlayer
26297,UCBPlayer,130,275,405,25,40,UCBPlayer
26298,UCBPlayer,106,206,312,10,66,UCBPlayer
26299,UCBPlayer,130,275,405,25,40,UCBPlayer
26300,UCBPlayer,105,210,315,10,65,UCBPlayer
26301,UCBPlayer,131,271,402,25,41,UCBPlayer
26302,UCBPlayer,105,210,315,10,65,UCBPlayer
26303,UCBPlayer,130,275,405,25,40,UCBPlayer
26304,UCBPlayer,105,210,315,10,65,UCBPlayer
26305,UCBPlayer,130,275,405,25,40,UCBPlayer
26306,UCBPlayer,103,203,306,10,68,UCBPlayer
26307,UCBPlayer,128,283,411,25,38,UCBPlayer
26308,UCBPlayer,111,186,297,10,71,UCBPlayer
26309,UCBPlayer,124,299,423,25,34,UCBPlayer
26310,UCBPlayer,115,170,285,10,75,UCBPlayer
26311,UCBPlayer,120,315,435,25,30,UCBPlayer
26312,UCBPlayer,119,154,273,10,79,UCBPlayer
26313,UCBPlayer,112,332,444,25,27,UCBPlayer
26314,UCBPlayer,127,137,264,10,82,UCBPlayer
26315,UCBPlayer,104,349,453,25,24,UCBPlayer
26316,UCBPlayer,126,126,252,7,85,Tie
26317,UCBPlayer,111,351,462,28,22,UCBPlayer
26318,UCBPlayer,116,126,242,3,87,UCBPlayer
26319,UCBPlayer,122,347,469,32,21,UCBPlayer
26320,UCBPlayer,107,132,239,0,87,UCBPlayer
26321,UCBPlayer,132,337,469,35,22,UCBPlayer
26322,UCBPlayer,103,148,251,0,83,UCBPlayer
26323,UCBPlayer,136,321,457,35,26,UCBPlayer
26324,UCBPlayer,99,164,263,0,79,UCBPlayer
26325,UCBPlayer,140,305,445,35,30,UCBPlayer
26326,UCBPlayer,95,180,275,0,75,UCBPlayer
26327,UCBPlayer,144,289,433,35,34,UCBPlayer
26328,UCBPlayer,91,196,287,0,71,UCBPlayer
26329,UCBPlayer,148,273,421,35,38,UCBPlayer
26330,UCBPlayer,87,212,299,0,67,UCBPlayer
26331,UCBPlayer,152,257,409,35,42,UCBPlayer
26332,UCBPlayer,84,224,308,0,64,UCBPlayer
26333,UCBPlayer,146,251,397,32,45,UCBPlayer
26334,UCBPlayer,89,234,323,3,60,UCBPlayer
26335,UCBPlayer,138,243,381,28,49,UCBPlayer
26336,UCBPlayer,97,242,339,7,56,UCBPlayer
26337,UCBPlayer,130,235,365,24,53,UCBPlayer
26338,UCBPlayer,105,250,355,11,52,UCBPlayer
26339,UCBPlayer,122,227,349,20,57,UCBPlayer
26340,UCBPlayer,109,259,368,15,49,UCBPlayer
26341,UCBPlayer,118,218,336,16,60,UCBPlayer
26342,UCBPlayer,117,267,384,19,45,UCBPlayer
26343,UCBPlayer,110,210,320,12,64,UCBPlayer
26344,UCBPlayer,126,271,397,23,42,UCBPlayer
26345,UCBPlayer,105,210,315,10,65,UCBPlayer
26346,UCBPlayer,130,275,405,25,40,UCBPlayer
26347,UCBPlayer,105,210,315,10,65,UCBPlayer
26348,UCBPlayer,130,275,405,25,40,UCBPlayer
26349,UCBPlayer,106,206,312,10,66,UCBPlayer
26350,UCBPlayer,130,275,405,25,40,UCBPlayer
26351,UCBPlayer,105,210,315,10,65,UCBPlayer
26352,UCBPlayer,131,271,402,25,41,UCBPlayer
26353,UCBPlayer,105,210,315,10,65,UCBPlayer
26354,UCBPlayer,130,275,405,25,40,UCBPlayer
26355,UCBPlayer,105,210,315,10,65,UCBPlayer
26356,UCBPlayer,130,275,405,25,40,UCBPlayer
26357,UCBPlayer,103,203,306,10,68,UCBPlayer
26358,UCBPlayer,128,283,411,25,38,UCBPlayer
26359,UCBPlayer,111,186,297,10,71,UCBPlayer
26360,UCBPlayer,124,299,423,25,34,UCBPlayer
26361,UCBPlayer,115,170,285,10,75,UCBPlayer
26362,UCBPlayer,120,315,435,25,30,UCBPlayer
26363,UCBPlayer,119,154,273,10,79,UCBPlayer
26364,UCBPlayer,112,332,444,25,27,UCBPlayer
26365,UCBPlayer,127,137,264,10,82,UCBPlayer
26366,UCBPlayer,104,349,453,25,24,UCBPlayer
26367,UCBPlayer,126,126,252,7,85,Tie
26368,UCBPlayer,111,351,462,28,22,UCBPlayer
26369,UCBPlayer,116,126,242,3,87,UCBPlayer
26370,UCBPlayer,122,347,469,32,21,UCBPlayer
26371,UCBPlayer,107,132,239,0,87,UCBPlayer
26372,UCBPlayer,132,337,469,35,22,UCBPlayer
26373,UCBPlayer,103,148,251,0,83,UCBPlayer
26374,UCBPlayer,136,321,457,35,26,UCBPlayer
26375,UCBPlayer,99,164,263,0,79,UCBPlayer
26376,UCBPlayer,140,305,445,35,30,UCBPlayer
26377,UCBPlayer,95,180,275,0,75,UCBPlayer
26378,UCBPlayer,144,289,433,35,34,UCBPlayer
26379,UCBPlayer,91,196,287,0,71,UCBPlayer
26380,UCBPlayer,148,273,421,35,38,UCBPlayer
26381,UCBPlayer,87,212,299,0,67,UCBPlayer
26382,UCBPlayer,152,257,409,35,42,UCBPlayer
26383,UCBPlayer,84,224,308,0,64,UCBPlayer
26384,UCBPlayer,146,251,397,32,45,UCBPlayer
26385,UCBPlayer,89,234,323,3,60,UCBPlayer
26386,UCBPlayer,138,243,381,28,49,UCBPlayer
26387,UCBPlayer,97,242,339,7,56,UCBPlayer
26388,UCBPlayer,130,235,365,24,53,UCBPlayer
26389,UCBPlayer,105,250,355,11,52,UCBPlayer
26390,UCBPlayer,122,227,349,20,57,UCBPlayer
26391,UCBPlayer,109,259,368,15,49,UCBPlayer
26392,UCBPlayer,118,218,336,16,60,UCBPlayer
26393,UCBPlayer,117,267,384,19,45,UCBPlayer
26394,UCBPlayer,110,210,320,12,64,UCBPlayer
26395,UCBPlayer,126,271,397,23,42,UCBPlayer
26396,UCBPlayer,105,210,315,10,65,UCBPlayer
26397,UCBPlayer,130,275,405,25,40,UCBPlayer
26398,UCBPlayer,105,210,315,10,65,UCBPlayer
26399,UCBPlayer,130,275,405,25,40,UCBPlayer
26400,UCBPlayer,106,206,312,10,66,UCBPlayer
26401,UCBPlayer,130,275,405,25,40,UCBPlayer
26402,UCBPlayer,105,210,315,10,65,UCBPlayer
26403,UCBPlayer,131,271,402,25,41,UCBPlayer
26404,UCBPlayer,105,210,315,10,65,UCBPlayer
26405,UCBPlayer,130,275,405,25,40,UCBPlayer
26406,UCBPlayer,105,210,315,10,65,UCBPlayer
26407,UCBPlayer,130,275,405,25,40,UCBPlayer
26408,UCBPlayer,103,203,306,10,68,UCBPlayer
26409,UCBPlayer,128,283,411,25,38,UCBPlayer
26410,UCBPlayer,111,186,297,10,71,UCBPlayer
26411,UCBPlayer,124,299,423,25,34,UCBPlayer
26412,UCBPlayer,115,170,285,10,75,UCBPlayer
26413,UCBPlayer,120,315,435,25,30,UCBPlayer
26414,UCBPlayer,119,154,273,10,79,UCBPlayer
26415,UCBPlayer,112,332,444,25,27,UCBPlayer
26416,UCBPlayer,127,137,264,10,82,UCBPlayer
26417,UCBPlayer,104,349,453,25,24,UCBPlayer
26418,UCBPlayer,126,126,252,7,85,Tie
26419,UCBPlayer,111,351,462,28,22,UCBPlayer
26420,UCBPlayer,116,126,242,3,87,UCBPlayer
26421,UCBPlayer,122,347,469,32,21,UCBPlayer
26422,UCBPlayer,107,132,239,0,87,UCBPlayer
26423,UCBPlayer,132,337,469,35,22,UCBPlayer
26424,UCBPlayer,103,148,251,0,83,UCBPlayer
26425,UCBPlayer,136,321,457,35,26,UCBPlayer
26426,UCBPlayer,99,164,263,0,79,UCBPlayer
26427,UCBPlayer,140,305,445,35,30,UCBPlayer
26428,UCBPlayer,95,180,275,0,75,UCBPlayer
26429,UCBPlayer,144,289,433,35,34,UCBPlayer
26430,UCBPlayer,91,196,287,0,71,UCBPlayer
26431,UCBPlayer,148,273,421,35,38,UCBPlayer
26432,UCBPlayer,87,212,299,0,67,UCBPlayer
26433,UCBPlayer,152,257,409,35,42,UCBPlayer
26434,UCBPlayer,84,224,308,0,64,UCBPlayer
26435,UCBPlayer,146,251,397,32,45,UCBPlayer
26436,UCBPlayer,89,234,323,3,60,UCBPlayer
26437,UCBPlayer,138,243,381,28,49,UCBPlayer
26438,UCBPlayer,97,242,339,7,56,UCBPlayer
26439,UCBPlayer,130,235,365,24,53,UCBPlayer
26440,UCBPlayer,105,250,355,11,52,UCBPlayer
26441,UCBPlayer,122,227,349,20,57,UCBPlayer
26442,UCBPlayer,109,259,368,15,49,UCBPlayer
26443,UCBPlayer,118,218,336,16,60,UCBPlayer
26444,UCBPlayer,117,267,384,19,45,UCBPlayer
26445,UCBPlayer,110,210,320,12,64,UCBPlayer
26446,UCBPlayer,126,271,397,23,42,UCBPlayer
26447,UCBPlayer,105,210,315,10,65,UCBPlayer
26448,UCBPlayer,130,275,405,25,40,UCBPlayer
26449,UCBPlayer,105,210,315,10,65,UCBPlayer
26450,UCBPlayer,130,275,405,25,40,UCBPlayer
26451,UCBPlayer,106,206,312,10,66,UCBPlayer
26452,UCBPlayer,130,275,405,25,40,UCBPlayer
26453,UCBPlayer,105,210,315,10,65,UCBPlayer
26454,UCBPlayer,131,271,402,25,41,UCBPlayer
26455,UCBPlayer,105,210,315,10,65,UCBPlayer
26456,UCBPlayer,130,275,405,25,40,UCBPlayer
26457,UCBPlayer,105,210,315,10,65,UCBPlayer
26458,UCBPlayer,130,275,405,25,40,UCBPlayer
26459,UCBPlayer,103,203,306,10,68,UCBPlayer
26460,UCBPlayer,128,283,411,25,38,UCBPlayer
26461,UCBPlayer,111,186,297,10,71,UCBPlayer
26462,UCBPlayer,124,299,423,25,34,UCBPlayer
26463,UCBPlayer,115,170,285,10,75,UCBPlayer
26464,UCBPlayer,120,315,435,25,30,UCBPlayer
26465,UCBPlayer,119,154,273,10,79,UCBPlayer
26466,UCBPlayer,112,332,444,25,27,UCBPlayer
26467,UCBPlayer,127,137,264,10,82,UCBPlayer
26468,UCBPlayer,104,349,453,25,24,UCBPlayer
26469,UCBPlayer,126,126,252,7,85,Tie
26470,UCBPlayer,111,351,462,28,22,UCBPlayer
26471,UCBPlayer,116,126,242,3,87,UCBPlayer
26472,UCBPlayer,122,347,469,32,21,UCBPlayer
26473,UCBPlayer,107,132,239,0,87,UCBPlayer
26474,UCBPlayer,132,337,469,35,22,UCBPlayer
26475,UCBPlayer,103,148,251,0,83,UCBPlayer
26476,UCBPlayer,136,321,457,35,26,UCBPlayer
26477,UCBPlayer,99,164,263,0,79,UCBPlayer
26478,UCBPlayer,140,305,445,35,30,UCBPlayer
26479,UCBPlayer,95,180,275,0,75,UCBPlayer
26480,UCBPlayer,144,289,433,35,34,UCBPlayer
26481,UCBPlayer,91,196,287,0,71,UCBPlayer
26482,UCBPlayer,148,273,421,35,38,UCBPlayer
26483,UCBPlayer,87,212,299,0,67,UCBPlayer
26484,UCBPlayer,152,257,409,35,42,UCBPlayer
26485,UCBPlayer,84,224,308,0,64,UCBPlayer
26486,UCBPlayer,146,251,397,32,45,UCBPlayer
26487,UCBPlayer,89,234,323,3,60,UCBPlayer
26488,UCBPlayer,138,243,381,28,49,UCBPlayer
26489,UCBPlayer,97,242,339,7,56,UCBPlayer
26490,UCBPlayer,130,235,365,24,53,UCBPlayer
26491,UCBPlayer,105,250,355,11,52,UCBPlayer
26492,UCBPlayer,122,227,349,20,57,UCBPlayer
26493,UCBPlayer,109,259,368,15,49,UCBPlayer
26494,UCBPlayer,118,218,336,16,60,UCBPlayer
26495,UCBPlayer,117,267,384,19,45,UCBPlayer
26496,UCBPlayer,110,210,320,12,64,UCBPlayer
26497,UCBPlayer,126,271,397,23,42,UCBPlayer
26498,UCBPlayer,105,210,315,10,65,UCBPlayer
26499,UCBPlayer,130,275,405,25,40,UCBPlayer
26500,UCBPlayer,105,210,315,10,65,UCBPlayer
26501,UCBPlayer,130,275,405,25,40,UCBPlayer
26502,UCBPlayer,106,206,312,10,66,UCBPlayer
26503,UCBPlayer,130,275,405,25,40,UCBPlayer
26504,UCBPlayer,105,210,315,10,65,UCBPlayer
26505,UCBPlayer,131,271,402,25,41,UCBPlayer
26506,UCBPlayer,105,210,315,10,65,UCBPlayer
26507,UCBPlayer,130,275,405,25,40,UCBPlayer
26508,UCBPlayer,105,210,315,10,65,UCBPlayer
26509,UCBPlayer,130,275,405,25,40,UCBPlayer
26510,UCBPlayer,103,203,306,10,68,UCBPlayer
26511,UCBPlayer,128,283,411,25,38,UCBPlayer
26512,UCBPlayer,111,186,297,10,71,UCBPlayer
26513,UCBPlayer,124,299,423,25,34,UCBPlayer
26514,UCBPlayer,115,170,285,10,75,UCBPlayer
26515,UCBPlayer,120,315,435,25,30,UCBPlayer
26516,UCBPlayer,119,154,273,10,79,UCBPlayer
26517,UCBPlayer,112,332,444,25,27,UCBPlayer
26518,UCBPlayer,127,137,264,10,82,UCBPlayer
26519,UCBPlayer,104,349,453,25,24,UCBPlayer
26520,UCBPlayer,126,126,252,7,85,Tie
26521,UCBPlayer,111,351,462,28,22,UCBPlayer
26522,UCBPlayer,116,126,242,3,87,UCBPlayer
26523,UCBPlayer,122,347,469,32,21,UCBPlayer
26524,UCBPlayer,107,132,239,0,87,UCBPlayer
26525,UCBPlayer,132,337,469,35,22,UCBPlayer
26526,UCBPlayer,103,148,251,0,83,UCBPlayer
26527,UCBPlayer,136,321,457,35,26,UCBPlayer
26528,UCBPlayer,99,164,263,0,79,UCBPlayer
26529,UCBPlayer,140,305,445,35,30,UCBPlayer
26530,UCBPlayer,95,180,275,0,75,UCBPlayer
26531,UCBPlayer,144,289,433,35,34,UCBPlayer
26532,UCBPlayer,91,196,287,0,71,UCBPlayer
26533,UCBPlayer,148,273,421,35,38,UCBPlayer
26534,UCBPlayer,87,212,299,0,67,UCBPlayer
26535,UCBPlayer,152,257,409,35,42,UCBPlayer
26536,UCBPlayer,84,224,308,0,64,UCBPlayer
26537,UCBPlayer,146,251,397,32,45,UCBPlayer
26538,UCBPlayer,89,234,323,3,60,UCBPlayer
26539,UCBPlayer,138,243,381,28,49,UCBPlayer
26540,UCBPlayer,97,242,339,7,56,UCBPlayer
26541,UCBPlayer,130,235,365,24,53,UCBPlayer
26542,UCBPlayer,105,250,355,11,52,UCBPlayer
26543,UCBPlayer,122,227,349,20,57,UCBPlayer
26544,UCBPlayer,109,259,368,15,49,UCBPlayer
26545,UCBPlayer,118,218,336,16,60,UCBPlayer
26546,UCBPlayer,117,267,384,19,45,UCBPlayer
26547,UCBPlayer,110,210,320,12,64,UCBPlayer
26548,UCBPlayer,126,271,397,23,42,UCBPlayer
26549,UCBPlayer,105,210,315,10,65,UCBPlayer
26550,UCBPlayer,130,275,405,25,40,UCBPlayer
26551,UCBPlayer,105,210,315,10,65,UCBPlayer
26552,UCBPlayer,130,275,405,25,40,UCBPlayer
26553,UCBPlayer,106,206,312,10,66,UCBPlayer
26554,UCBPlayer,130,275,405,25,40,UCBPlayer
26555,UCBPlayer,105,210,315,10,65,UCBPlayer
26556,UCBPlayer,131,271,402,25,41,UCBPlayer
26557,UCBPlayer,105,210,315,10,65,UCBPlayer
26558,UCBPlayer,130,275,405,25,40,UCBPlayer
26559,UCBPlayer,105,210,315,10,65,UCBPlayer
26560,UCBPlayer,130,275,405,25,40,UCBPlayer
26561,UCBPlayer,103,203,306,10,68,UCBPlayer
26562,UCBPlayer,128,283,411,25,38,UCBPlayer
26563,UCBPlayer,111,186,297,10,71,UCBPlayer
26564,UCBPlayer,124,299,423,25,34,UCBPlayer
26565,UCBPlayer,115,170,285,10,75,UCBPlayer
26566,UCBPlayer,120,315,435,25,30,UCBPlayer
26567,UCBPlayer,119,154,273,10,79,UCBPlayer
26568,UCBPlayer,112,332,444,25,27,UCBPlayer
26569,UCBPlayer,127,137,264,10,82,UCBPlayer
26570,UCBPlayer,104,349,453,25,24,UCBPlayer
26571,UCBPlayer,126,126,252,7,85,Tie
26572,UCBPlayer,111,351,462,28,22,UCBPlayer
26573,UCBPlayer,116,126,242,3,87,UCBPlayer
26574,UCBPlayer,122,347,469,32,21,UCBPlayer
26575,UCBPlayer,107,132,239,0,87,UCBPlayer
26576,UCBPlayer,132,337,469,35,22,UCBPlayer
26577,UCBPlayer,103,148,251,0,83,UCBPlayer
26578,UCBPlayer,136,321,457,35,26,UCBPlayer
26579,UCBPlayer,99,164,263,0,79,UCBPlayer
26580,UCBPlayer,140,305,445,35,30,UCBPlayer
26581,UCBPlayer,95,180,275,0,75,UCBPlayer
26582,UCBPlayer,144,289,433,35,34,UCBPlayer
26583,UCBPlayer,91,196,287,0,71,UCBPlayer
26584,UCBPlayer,148,273,421,35,38,UCBPlayer
26585,UCBPlayer,87,212,299,0,67,UCBPlayer
26586,UCBPlayer,152,257,409,35,42,UCBPlayer
26587,UCBPlayer,84,224,308,0,64,UCBPlayer
26588,UCBPlayer,146,251,397,32,45,UCBPlayer
26589,UCBPlayer,89,234,323,3,60,UCBPlayer
26590,UCBPlayer,138,243,381,28,49,UCBPlayer
26591,UCBPlayer,97,242,339,7,56,UCBPlayer
26592,UCBPlayer,130,235,365,24,53,UCBPlayer
26593,UCBPlayer,105,250,355,11,52,UCBPlayer
26594,UCBPlayer,122,227,349,20,57,UCBPlayer
26595,UCBPlayer,109,259,368,15,49,UCBPlayer
26596,UCBPlayer,118,218,336,16,60,UCBPlayer
26597,UCBPlayer,117,267,384,19,45,UCBPlayer
26598,UCBPlayer,110,210,320,12,64,UCBPlayer
26599,UCBPlayer,126,271,397,23,42,UCBPlayer
26600,UCBPlayer,105,210,315,10,65,UCBPlayer
26601,UCBPlayer,130,275,405,25,40,UCBPlayer
26602,UCBPlayer,105,210,315,10,65,UCBPlayer
26603,UCBPlayer,130,275,405,25,40,UCBPlayer
26604,UCBPlayer,106,206,312,10,66,UCBPlayer
26605,UCBPlayer,130,275,405,25,40,UCBPlayer
26606,UCBPlayer,105,210,315,10,65,UCBPlayer
26607,UCBPlayer,131,271,402,25,41,UCBPlayer
26608,UCBPlayer,105,210,315,10,65,UCBPlayer
26609,UCBPlayer,130,275,405,25,40,UCBPlayer
26610,UCBPlayer,105,210,315,10,65,UCBPlayer
26611,UCBPlayer,130,275,405,25,40,UCBPlayer
26612,UCBPlayer,103,203,306,10,68,UCBPlayer
26613,UCBPlayer,128,283,411,25,38,UCBPlayer
26614,UCBPlayer,111,186,297,10,71,UCBPlayer
26615,UCBPlayer,124,299,423,25,34,UCBPlayer
26616,UCBPlayer,115,170,285,10,75,UCBPlayer
26617,UCBPlayer,120,315,435,25,30,UCBPlayer
26618,UCBPlayer,119,154,273,10,79,UCBPlayer
26619,UCBPlayer,112,332,444,25,27,UCBPlayer
26620,UCBPlayer,127,137,264,10,82,UCBPlayer
26621,UCBPlayer,104,349,453,25,24,UCBPlayer
26622,UCBPlayer,126,126,252,7,85,Tie
26623,UCBPlayer,111,351,462,28,22,UCBPlayer
26624,UCBPlayer,116,126,242,3,87,UCBPlayer
26625,UCBPlayer,122,347,469,32,21,UCBPlayer
26626,UCBPlayer,107,132,239,0,87,UCBPlayer
26627,UCBPlayer,132,337,469,35,22,UCBPlayer
26628,UCBPlayer,103,148,251,0,83,UCBPlayer
26629,UCBPlayer,136,321,457,35,26,UCBPlayer
26630,UCBPlayer,99,164,263,0,79,UCBPlayer
26631,UCBPlayer,140,305,445,35,30,UCBPlayer
26632,UCBPlayer,95,180,275,0,75,UCBPlayer
26633,UCBPlayer,144,289,433,35,34,UCBPlayer
26634,UCBPlayer,91,196,287,0,71,UCBPlayer
26635,UCBPlayer,148,273,421,35,38,UCBPlayer
26636,UCBPlayer,87,212,299,0,67,UCBPlayer
26637,UCBPlayer,152,257,409,35,42,UCBPlayer
26638,UCBPlayer,84,224,308,0,64,UCBPlayer
26639,UCBPlayer,146,251,397,32,45,UCBPlayer
26640,UCBPlayer,89,234,323,3,60,UCBPlayer
26641,UCBPlayer,138,243,381,28,49,UCBPlayer
26642,UCBPlayer,97,242,339,7,56,UCBPlayer
26643,UCBPlayer,130,235,365,24,53,UCBPlayer
26644,UCBPlayer,105,250,355,11,52,UCBPlayer
26645,UCBPlayer,122,227,349,20,57,UCBPlayer
26646,UCBPlayer,109,259,368,15,49,UCBPlayer
26647,UCBPlayer,118,218,336,16,60,UCBPlayer
26648,UCBPlayer,117,267,384,19,45,UCBPlayer
26649,UCBPlayer,110,210,320,12,64,UCBPlayer
26650,UCBPlayer,126,271,397,23,42,UCBPlayer
26651,UCBPlayer,105,210,315,10,65,UCBPlayer
26652,UCBPlayer,130,275,405,25,40,UCBPlayer
26653,UCBPlayer,105,210,315,10,65,UCBPlayer
26654,UCBPlayer,130,275,405,25,40,UCBPlayer
26655,UCBPlayer,106,206,312,10,66,UCBPlayer
26656,UCBPlayer,130,275,405,25,40,UCBPlayer
26657,UCBPlayer,105,210,315,10,65,UCBPlayer
26658,UCBPlayer,131,271,402,25,41,UCBPlayer
26659,UCBPlayer,105,210,315,10,65,UCBPlayer
26660,UCBPlayer,130,275,405,25,40,UCBPlayer
26661,UCBPlayer,105,210,315,10,65,UCBPlayer
26662,UCBPlayer,130,275,405,25,40,UCBPlayer
26663,UCBPlayer,103,203,306,10,68,UCBPlayer
26664,UCBPlayer,128,283,411,25,38,UCBPlayer
26665,UCBPlayer,111,186,297,10,71,UCBPlayer
26666,UCBPlayer,124,299,423,25,34,UCBPlayer
26667,UCBPlayer,115,170,285,10,75,UCBPlayer
26668,UCBPlayer,120,315,435,25,30,UCBPlayer
26669,UCBPlayer,119,154,273,10,79,UCBPlayer
26670,UCBPlayer,112,332,444,25,27,UCBPlayer
26671,UCBPlayer,127,137,264,10,82,UCBPlayer
26672,UCBPlayer,104,349,453,25,24,UCBPlayer
26673,UCBPlayer,126,126,252,7,85,Tie
26674,UCBPlayer,111,351,462,28,22,UCBPlayer
26675,UCBPlayer,116,126,242,3,87,UCBPlayer
26676,UCBPlayer,122,347,469,32,21,UCBPlayer
26677,UCBPlayer,107,132,239,0,87,UCBPlayer
26678,UCBPlayer,132,337,469,35,22,UCBPlayer
26679,UCBPlayer,103,148,251,0,83,UCBPlayer
26680,UCBPlayer,136,321,457,35,26,UCBPlayer
26681,UCBPlayer,99,164,263,0,79,UCBPlayer
26682,UCBPlayer,140,305,445,35,30,UCBPlayer
26683,UCBPlayer,95,180,275,0,75,UCBPlayer
26684,UCBPlayer,144,289,433,35,34,UCBPlayer
26685,UCBPlayer,91,196,287,0,71,UCBPlayer
26686,UCBPlayer,148,273,421,35,38,UCBPlayer
26687,UCBPlayer,87,212,299,0,67,UCBPlayer
26688,UCBPlayer,152,257,409,35,42,UCBPlayer
26689,UCBPlayer,84,224,308,0,64,UCBPlayer
26690,UCBPlayer,146,251,397,32,45,UCBPlayer
26691,UCBPlayer,89,234,323,3,60,UCBPlayer
26692,UCBPlayer,138,243,381,28,49,UCBPlayer
26693,UCBPlayer,97,242,339,7,56,UCBPlayer
26694,UCBPlayer,130,235,365,24,53,UCBPlayer
26695,UCBPlayer,105,250,355,11,52,UCBPlayer
26696,UCBPlayer,122,227,349,20,57,UCBPlayer
26697,UCBPlayer,109,259,368,15,49,UCBPlayer
26698,UCBPlayer,118,218,336,16,60,UCBPlayer
26699,UCBPlayer,117,267,384,19,45,UCBPlayer
26700,UCBPlayer,110,210,320,12,64,UCBPlayer
26701,UCBPlayer,126,271,397,23,42,UCBPlayer
26702,UCBPlayer,105,210,315,10,65,UCBPlayer
26703,UCBPlayer,130,275,405,25,40,UCBPlayer
26704,UCBPlayer,105,210,315,10,65,UCBPlayer
26705,UCBPlayer,130,275,405,25,40,UCBPlayer
26706,UCBPlayer,106,206,312,10,66,UCBPlayer
26707,UCBPlayer,130,275,405,25,40,UCBPlayer
26708,UCBPlayer,105,210,315,10,65,UCBPlayer
26709,UCBPlayer,131,271,402,25,41,UCBPlayer
26710,UCBPlayer,105,210,315,10,65,UCBPlayer
26711,UCBPlayer,130,275,405,25,40,UCBPlayer
26712,UCBPlayer,105,210,315,10,65,UCBPlayer
26713,UCBPlayer,130,275,405,25,40,UCBPlayer
26714,UCBPlayer,103,203,306,10,68,UCBPlayer
26715,UCBPlayer,128,283,411,25,38,UCBPlayer
26716,UCBPlayer,111,186,297,10,71,UCBPlayer
26717,UCBPlayer,124,299,423,25,34,UCBPlayer
26718,UCBPlayer,115,170,285,10,75,UCBPlayer
26719,UCBPlayer,120,315,435,25,30,UCBPlayer
26720,UCBPlayer,119,154,273,10,79,UCBPlayer
26721,UCBPlayer,112,332,444,25,27,UCBPlayer
26722,UCBPlayer,127,137,264,10,82,UCBPlayer
26723,UCBPlayer,104,349,453,25,24,UCBPlayer
26724,UCBPlayer,126,126,252,7,85,Tie
26725,UCBPlayer,111,351,462,28,22,UCBPlayer
26726,UCBPlayer,116,126,242,3,87,UCBPlayer
26727,UCBPlayer,122,347,469,32,21,UCBPlayer
26728,UCBPlayer,107,132,239,0,87,UCBPlayer
26729,UCBPlayer,132,337,469,35,22,UCBPlayer
26730,UCBPlayer,103,148,251,0,83,UCBPlayer
26731,UCBPlayer,136,321,457,35,26,UCBPlayer
26732,UCBPlayer,99,164,263,0,79,UCBPlayer
26733,UCBPlayer,140,305,445,35,30,UCBPlayer
26734,UCBPlayer,95,180,275,0,75,UCBPlayer
26735,UCBPlayer,144,289,433,35,34,UCBPlayer
26736,UCBPlayer,91,196,287,0,71,UCBPlayer
26737,UCBPlayer,148,273,421,35,38,UCBPlayer
26738,UCBPlayer,87,212,299,0,67,UCBPlayer
26739,UCBPlayer,152,257,409,35,42,UCBPlayer
26740,UCBPlayer,84,224,308,0,64,UCBPlayer
26741,UCBPlayer,146,251,397,32,45,UCBPlayer
26742,UCBPlayer,89,234,323,3,60,UCBPlayer
26743,UCBPlayer,138,243,381,28,49,UCBPlayer
26744,UCBPlayer,97,242,339,7,56,UCBPlayer
26745,UCBPlayer,130,235,365,24,53,UCBPlayer
26746,UCBPlayer,105,250,355,11,52,UCBPlayer
26747,UCBPlayer,122,227,349,20,57,UCBPlayer
26748,UCBPlayer,109,259,368,15,49,UCBPlayer
26749,UCBPlayer,118,218,336,16,60,UCBPlayer
26750,UCBPlayer,117,267,384,19,45,UCBPlayer
26751,UCBPlayer,110,210,320,12,64,UCBPlayer
26752,UCBPlayer,126,271,397,23,42,UCBPlayer
26753,UCBPlayer,105,210,315,10,65,UCBPlayer
26754,UCBPlayer,130,275,405,25,40,UCBPlayer
26755,UCBPlayer,105,210,315,10,65,UCBPlayer
26756,UCBPlayer,130,275,405,25,40,UCBPlayer
26757,UCBPlayer,106,206,312,10,66,UCBPlayer
26758,UCBPlayer,130,275,405,25,40,UCBPlayer
26759,UCBPlayer,105,210,315,10,65,UCBPlayer
26760,UCBPlayer,131,271,402,25,41,UCBPlayer
26761,UCBPlayer,105,210,315,10,65,UCBPlayer
26762,UCBPlayer,130,275,405,25,40,UCBPlayer
26763,UCBPlayer,105,210,315,10,65,UCBPlayer
26764,UCBPlayer,130,275,405,25,40,UCBPlayer
26765,UCBPlayer,103,203,306,10,68,UCBPlayer
26766,UCBPlayer,128,283,411,25,38,UCBPlayer
26767,UCBPlayer,111,186,297,10,71,UCBPlayer
26768,UCBPlayer,124,299,423,25,34,UCBPlayer
26769,UCBPlayer,115,170,285,10,75,UCBPlayer
26770,UCBPlayer,120,315,435,25,30,UCBPlayer
26771,UCBPlayer,119,154,273,10,79,UCBPlayer
26772,UCBPlayer,112,332,444,25,27,UCBPlayer
26773,UCBPlayer,127,137,264,10,82,UCBPlayer
26774,UCBPlayer,104,349,453,25,24,UCBPlayer
26775,UCBPlayer,126,126,252,7,85,Tie
26776,UCBPlayer,111,351,462,28,22,UCBPlayer
26777,UCBPlayer,116,126,242,3,87,UCBPlayer
26778,UCBPlayer,122,347,469,32,21,UCBPlayer
26779,UCBPlayer,107,132,239,0,87,UCBPlayer
26780,UCBPlayer,132,337,469,35,22,UCBPlayer
26781,UCBPlayer,103,148,251,0,83,UCBPlayer
26782,UCBPlayer,136,321,457,35,26,UCBPlayer
26783,UCBPlayer,99,164,263,0,79,UCBPlayer
26784,UCBPlayer,140,305,445,35,30,UCBPlayer
26785,UCBPlayer,95,180,275,0,75,UCBPlayer
26786,UCBPlayer,144,289,433,35,34,UCBPlayer
26787,UCBPlayer,91,196,287,0,71,UCBPlayer
26788,UCBPlayer,148,273,421,35,38,UCBPlayer
26789,UCBPlayer,87,212,299,0,67,UCBPlayer
26790,UCBPlayer,152,257,409,35,42,UCBPlayer
26791,UCBPlayer,84,224,308,0,64,UCBPlayer
26792,UCBPlayer,146,251,397,32,45,UCBPlayer
26793,UCBPlayer,89,234,323,3,60,UCBPlayer
26794,UCBPlayer,138,243,381,28,49,UCBPlayer
26795,UCBPlayer,97,242,339,7,56,UCBPlayer
26796,UCBPlayer,130,235,365,24,53,UCBPlayer
26797,UCBPlayer,105,250,355,11,52,UCBPlayer
26798,UCBPlayer,122,227,349,20,57,UCBPlayer
26799,UCBPlayer,109,259,368,15,49,UCBPlayer
26800,UCBPlayer,118,218,336,16,60,UCBPlayer
26801,UCBPlayer,117,267,384,19,45,UCBPlayer
26802,UCBPlayer,110,210,320,12,64,UCBPlayer
26803,UCBPlayer,126,271,397,23,42,UCBPlayer
26804,UCBPlayer,105,210,315,10,65,UCBPlayer
26805,UCBPlayer,130,275,405,25,40,UCBPlayer
26806,UCBPlayer,105,210,315,10,65,UCBPlayer
26807,UCBPlayer,130,275,405,25,40,UCBPlayer
26808,UCBPlayer,106,206,312,10,66,UCBPlayer
26809,UCBPlayer,130,275,405,25,40,UCBPlayer
26810,UCBPlayer,105,210,315,10,65,UCBPlayer
26811,UCBPlayer,131,271,402,25,41,UCBPlayer
26812,UCBPlayer,105,210,315,10,65,UCBPlayer
26813,UCBPlayer,130,275,405,25,40,UCBPlayer
26814,UCBPlayer,105,210,315,10,65,UCBPlayer
26815,UCBPlayer,130,275,405,25,40,UCBPlayer
26816,UCBPlayer,103,203,306,10,68,UCBPlayer
26817,UCBPlayer,128,283,411,25,38,UCBPlayer
26818,UCBPlayer,111,186,297,10,71,UCBPlayer
26819,UCBPlayer,124,299,423,25,34,UCBPlayer
26820,UCBPlayer,115,170,285,10,75,UCBPlayer
26821,UCBPlayer,120,315,435,25,30,UCBPlayer
26822,UCBPlayer,119,154,273,10,79,UCBPlayer
26823,UCBPlayer,112,332,444,25,27,UCBPlayer
26824,UCBPlayer,127,137,264,10,82,UCBPlayer
26825,UCBPlayer,104,349,453,25,24,UCBPlayer
26826,UCBPlayer,126,126,252,7,85,Tie
26827,UCBPlayer,111,351,462,28,22,UCBPlayer
26828,UCBPlayer,116,126,242,3,87,UCBPlayer
26829,UCBPlayer,122,347,469,32,21,UCBPlayer
26830,UCBPlayer,107,132,239,0,87,UCBPlayer
26831,UCBPlayer,132,337,469,35,22,UCBPlayer
26832,UCBPlayer,103,148,251,0,83,UCBPlayer
26833,UCBPlayer,136,321,457,35,26,UCBPlayer
26834,UCBPlayer,99,164,263,0,79,UCBPlayer
26835,UCBPlayer,140,305,445,35,30,UCBPlayer
26836,UCBPlayer,95,180,275,0,75,UCBPlayer
26837,UCBPlayer,144,289,433,35,34,UCBPlayer
26838,UCBPlayer,91,196,287,0,71,UCBPlayer
26839,UCBPlayer,148,273,421,35,38,UCBPlayer
26840,UCBPlayer,87,212,299,0,67,UCBPlayer
26841,UCBPlayer,152,257,409,35,42,UCBPlayer
26842,UCBPlayer,84,224,308,0,64,UCBPlayer
26843,UCBPlayer,146,251,397,32,45,UCBPlayer
26844,UCBPlayer,89,234,323,3,60,UCBPlayer
26845,UCBPlayer,138,243,381,28,49,UCBPlayer
26846,UCBPlayer,97,242,339,7,56,UCBPlayer
26847,UCBPlayer,130,235,365,24,53,UCBPlayer
26848,UCBPlayer,105,250,355,11,52,UCBPlayer
26849,UCBPlayer,122,227,349,20,57,UCBPlayer
26850,UCBPlayer,109,259,368,15,49,UCBPlayer
26851,UCBPlayer,118,218,336,16,60,UCBPlayer
26852,UCBPlayer,117,267,384,19,45,UCBPlayer
26853,UCBPlayer,110,210,320,12,64,UCBPlayer
26854,UCBPlayer,126,271,397,23,42,UCBPlayer
26855,UCBPlayer,105,210,315,10,65,UCBPlayer
26856,UCBPlayer,130,275,405,25,40,UCBPlayer
26857,UCBPlayer,105,210,315,10,65,UCBPlayer
26858,UCBPlayer,130,275,405,25,40,UCBPlayer
26859,UCBPlayer,106,206,312,10,66,UCBPlayer
26860,UCBPlayer,130,275,405,25,40,UCBPlayer
26861,UCBPlayer,105,210,315,10,65,UCBPlayer
26862,UCBPlayer,131,271,402,25,41,UCBPlayer
26863,UCBPlayer,105,210,315,10,65,UCBPlayer
26864,UCBPlayer,130,275,405,25,40,UCBPlayer
26865,UCBPlayer,105,210,315,10,65,UCBPlayer
26866,UCBPlayer,130,275,405,25,40,UCBPlayer
26867,UCBPlayer,103,203,306,10,68,UCBPlayer
26868,UCBPlayer,128,283,411,25,38,UCBPlayer
26869,UCBPlayer,111,186,297,10,71,UCBPlayer
26870,UCBPlayer,124,299,423,25,34,UCBPlayer
26871,UCBPlayer,115,170,285,10,75,UCBPlayer
26872,UCBPlayer,120,315,435,25,30,UCBPlayer
26873,UCBPlayer,119,154,273,10,79,UCBPlayer
26874,UCBPlayer,112,332,444,25,27,UCBPlayer
26875,UCBPlayer,127,137,264,10,82,UCBPlayer
26876,UCBPlayer,104,349,453,25,24,UCBPlayer
26877,UCBPlayer,126,126,252,7,85,Tie
26878,UCBPlayer,111,351,462,28,22,UCBPlayer
26879,UCBPlayer,116,126,242,3,87,UCBPlayer
26880,UCBPlayer,122,347,469,32,21,UCBPlayer
26881,UCBPlayer,107,132,239,0,87,UCBPlayer
26882,UCBPlayer,132,337,469,35,22,UCBPlayer
26883,UCBPlayer,103,148,251,0,83,UCBPlayer
26884,UCBPlayer,136,321,457,35,26,UCBPlayer
26885,UCBPlayer,99,164,263,0,79,UCBPlayer
26886,UCBPlayer,140,305,445,35,30,UCBPlayer
26887,UCBPlayer,95,180,275,0,75,UCBPlayer
26888,UCBPlayer,144,289,433,35,34,UCBPlayer
26889,UCBPlayer,91,196,287,0,71,UCBPlayer
26890,UCBPlayer,148,273,421,35,38,UCBPlayer
26891,UCBPlayer,87,212,299,0,67,UCBPlayer
26892,UCBPlayer,152,257,409,35,42,UCBPlayer
26893,UCBPlayer,84,224,308,0,64,UCBPlayer
26894,UCBPlayer,146,251,397,32,45,UCBPlayer
26895,UCBPlayer,89,234,323,3,60,UCBPlayer
26896,UCBPlayer,138,243,381,28,49,UCBPlayer
26897,UCBPlayer,97,242,339,7,56,UCBPlayer
26898,UCBPlayer,130,235,365,24,53,UCBPlayer
26899,UCBPlayer,105,250,355,11,52,UCBPlayer
26900,UCBPlayer,122,227,349,20,57,UCBPlayer
26901,UCBPlayer,109,259,368,15,49,UCBPlayer
26902,UCBPlayer,118,218,336,16,60,UCBPlayer
26903,UCBPlayer,117,267,384,19,45,UCBPlayer
26904,UCBPlayer,110,210,320,12,64,UCBPlayer
26905,UCBPlayer,126,271,397,23,42,UCBPlayer
26906,UCBPlayer,105,210,315,10,65,UCBPlayer
26907,UCBPlayer,130,275,405,25,40,UCBPlayer
26908,UCBPlayer,105,210,315,10,65,UCBPlayer
26909,UCBPlayer,130,275,405,25,40,UCBPlayer
26910,UCBPlayer,106,206,312,10,66,UCBPlayer
26911,UCBPlayer,130,275,405,25,40,UCBPlayer
26912,UCBPlayer,105,210,315,10,65,UCBPlayer
26913,UCBPlayer,131,271,402,25,41,UCBPlayer
26914,UCBPlayer,105,210,315,10,65,UCBPlayer
26915,UCBPlayer,130,275,405,25,40,UCBPlayer
26916,UCBPlayer,105,210,315,10,65,UCBPlayer
26917,UCBPlayer,130,275,405,25,40,UCBPlayer
26918,UCBPlayer,103,203,306,10,68,UCBPlayer
26919,UCBPlayer,128,283,411,25,38,UCBPlayer
26920,UCBPlayer,111,186,297,10,71,UCBPlayer
26921,UCBPlayer,124,299,423,25,34,UCBPlayer
26922,UCBPlayer,115,170,285,10,75,UCBPlayer
26923,UCBPlayer,120,315,435,25,30,UCBPlayer
26924,UCBPlayer,119,154,273,10,79,UCBPlayer
26925,UCBPlayer,112,332,444,25,27,UCBPlayer
26926,UCBPlayer,127,137,264,10,82,UCBPlayer
26927,UCBPlayer,104,349,453,25,24,UCBPlayer
26928,UCBPlayer,126,126,252,7,85,Tie
26929,UCBPlayer,111,351,462,28,22,UCBPlayer
26930,UCBPlayer,116,126,242,3,87,UCBPlayer
26931,UCBPlayer,122,347,469,32,21,UCBPlayer
26932,UCBPlayer,107,132,239,0,87,UCBPlayer
26933,UCBPlayer,132,337,469,35,22,UCBPlayer
26934,UCBPlayer,103,148,251,0,83,UCBPlayer
26935,UCBPlayer,136,321,457,35,26,UCBPlayer
26936,UCBPlayer,99,164,263,0,79,UCBPlayer
26937,UCBPlayer,140,305,445,35,30,UCBPlayer
26938,UCBPlayer,95,180,275,0,75,UCBPlayer
26939,UCBPlayer,144,289,433,35,34,UCBPlayer
26940,UCBPlayer,91,196,287,0,71,UCBPlayer
26941,UCBPlayer,148,273,421,35,38,UCBPlayer
26942,UCBPlayer,87,212,299,0,67,UCBPlayer
26943,UCBPlayer,152,257,409,35,42,UCBPlayer
26944,UCBPlayer,84,224,308,0,64,UCBPlayer
26945,UCBPlayer,146,251,397,32,45,UCBPlayer
26946,UCBPlayer,89,234,323,3,60,UCBPlayer
26947,UCBPlayer,138,243,381,28,49,UCBPlayer
26948,UCBPlayer,97,242,339,7,56,UCBPlayer
26949,UCBPlayer,130,235,365,24,53,UCBPlayer
26950,UCBPlayer,105,250,355,11,52,UCBPlayer
26951,UCBPlayer,122,227,349,20,57,UCBPlayer
26952,UCBPlayer,109,259,368,15,49,UCBPlayer
26953,UCBPlayer,118,218,336,16,60,UCBPlayer
26954,UCBPlayer,117,267,384,19,45,UCBPlayer
26955,UCBPlayer,110,210,320,12,64,UCBPlayer
26956,UCBPlayer,126,271,397,23,42,UCBPlayer
26957,UCBPlayer,105,210,315,10,65,UCBPlayer
26958,UCBPlayer,130,275,405,25,40,UCBPlayer
26959,UCBPlayer,105,210,315,10,65,UCBPlayer
26960,UCBPlayer,130,275,405,25,40,UCBPlayer
26961,UCBPlayer,106,206,312,10,66,UCBPlayer
26962,UCBPlayer,130,275,405,25,40,UCBPlayer
26963,UCBPlayer,105,210,315,10,65,UCBPlayer
26964,UCBPlayer,131,271,402,25,41,UCBPlayer
26965,UCBPlayer,105,210,315,10,65,UCBPlayer
26966,UCBPlayer,130,275,405,25,40,UCBPlayer
26967,UCBPlayer,105,210,315,10,65,UCBPlayer
26968,UCBPlayer,130,275,405,25,40,UCBPlayer
26969,UCBPlayer,103,203,306,10,68,UCBPlayer
26970,UCBPlayer,128,283,411,25,38,UCBPlayer
26971,UCBPlayer,111,186,297,10,71,UCBPlayer
26972,UCBPlayer,124,299,423,25,34,UCBPlayer
26973,UCBPlayer,115,170,285,10,75,UCBPlayer
26974,UCBPlayer,120,315,435,25,30,UCBPlayer
26975,UCBPlayer,119,154,273,10,79,UCBPlayer
26976,UCBPlayer,112,332,444,25,27,UCBPlayer
26977,UCBPlayer,127,137,264,10,82,UCBPlayer
26978,UCBPlayer,104,349,453,25,24,UCBPlayer
26979,UCBPlayer,126,126,252,7,85,Tie
26980,UCBPlayer,111,351,462,28,22,UCBPlayer
26981,UCBPlayer,116,126,242,3,87,UCBPlayer
26982,UCBPlayer,122,347,469,32,21,UCBPlayer
26983,UCBPlayer,107,132,239,0,87,UCBPlayer
26984,UCBPlayer,132,337,469,35,22,UCBPlayer
26985,UCBPlayer,103,148,251,0,83,UCBPlayer
26986,UCBPlayer,136,321,457,35,26,UCBPlayer
26987,UCBPlayer,99,164,263,0,79,UCBPlayer
26988,UCBPlayer,140,305,445,35,30,UCBPlayer
26989,UCBPlayer,95,180,275,0,75,UCBPlayer
26990,UCBPlayer,144,289,433,35,34,UCBPlayer
26991,UCBPlayer,91,196,287,0,71,UCBPlayer
26992,UCBPlayer,148,273,421,35,38,UCBPlayer
26993,UCBPlayer,87,212,299,0,67,UCBPlayer
26994,UCBPlayer,152,257,409,35,42,UCBPlayer
26995,UCBPlayer,84,224,308,0,64,UCBPlayer
26996,UCBPlayer,146,251,397,32,45,UCBPlayer
26997,UCBPlayer,89,234,323,3,60,UCBPlayer
26998,UCBPlayer,138,243,381,28,49,UCBPlayer
26999,UCBPlayer,97,242,339,7,56,UCBPlayer
27000,UCBPlayer,130,235,365,24,53,UCBPlayer
27001,UCBPlayer,105,250,355,11,52,UCBPlayer
27002,UCBPlayer,122,227,349,20,57,UCBPlayer
27003,UCBPlayer,109,259,368,15,49,UCBPlayer
27004,UCBPlayer,118,218,336,16,60,UCBPlayer
27005,UCBPlayer,117,267,384,19,45,UCBPlayer
27006,UCBPlayer,110,210,320,12,64,UCBPlayer
27007,UCBPlayer,126,271,397,23,42,UCBPlayer
27008,UCBPlayer,105,210,315,10,65,UCBPlayer
27009,UCBPlayer,130,275,405,25,40,UCBPlayer
27010,UCBPlayer,105,210,315,10,65,UCBPlayer
27011,UCBPlayer,130,275,405,25,40,UCBPlayer
27012,UCBPlayer,106,206,312,10,66,UCBPlayer
27013,UCBPlayer,130,275,405,25,40,UCBPlayer
27014,UCBPlayer,105,210,315,10,65,UCBPlayer
27015,UCBPlayer,131,271,402,25,41,UCBPlayer
27016,UCBPlayer,105,210,315,10,65,UCBPlayer
27017,UCBPlayer,130,275,405,25,40,UCBPlayer
27018,UCBPlayer,105,210,315,10,65,UCBPlayer
27019,UCBPlayer,130,275,405,25,40,UCBPlayer
27020,UCBPlayer,103,203,306,10,68,UCBPlayer
27021,UCBPlayer,128,283,411,25,38,UCBPlayer
27022,UCBPlayer,111,186,297,10,71,UCBPlayer
27023,UCBPlayer,124,299,423,25,34,UCBPlayer
27024,UCBPlayer,115,170,285,10,75,UCBPlayer
27025,UCBPlayer,120,315,435,25,30,UCBPlayer
27026,UCBPlayer,119,154,273,10,79,UCBPlayer
27027,UCBPlayer,112,332,444,25,27,UCBPlayer
27028,UCBPlayer,127,137,264,10,82,UCBPlayer
27029,UCBPlayer,104,349,453,25,24,UCBPlayer
27030,UCBPlayer,126,126,252,7,85,Tie
27031,UCBPlayer,111,351,462,28,22,UCBPlayer
27032,UCBPlayer,116,126,242,3,87,UCBPlayer
27033,UCBPlayer,122,347,469,32,21,UCBPlayer
27034,UCBPlayer,107,132,239,0,87,UCBPlayer
27035,UCBPlayer,132,337,469,35,22,UCBPlayer
27036,UCBPlayer,103,148,251,0,83,UCBPlayer
27037,UCBPlayer,136,321,457,35,26,UCBPlayer
27038,UCBPlayer,99,164,263,0,79,UCBPlayer
27039,UCBPlayer,140,305,445,35,30,UCBPlayer
27040,UCBPlayer,95,180,275,0,75,UCBPlayer
27041,UCBPlayer,144,289,433,35,34,UCBPlayer
27042,UCBPlayer,91,196,287,0,71,UCBPlayer
27043,UCBPlayer,148,273,421,35,38,UCBPlayer
27044,UCBPlayer,87,212,299,0,67,UCBPlayer
27045,UCBPlayer,152,257,409,35,42,UCBPlayer
27046,UCBPlayer,84,224,308,0,64,UCBPlayer
27047,UCBPlayer,146,251,397,32,45,UCBPlayer
27048,UCBPlayer,89,234,323,3,60,UCBPlayer
27049,UCBPlayer,138,243,381,28,49,UCBPlayer
27050,UCBPlayer,97,242,339,7,56,UCBPlayer
27051,UCBPlayer,130,235,365,24,53,UCBPlayer
27052,UCBPlayer,105,250,355,11,52,UCBPlayer
27053,UCBPlayer,122,227,349,20,57,UCBPlayer
27054,UCBPlayer,109,259,368,15,49,UCBPlayer
27055,UCBPlayer,118,218,336,16,60,UCBPlayer
27056,UCBPlayer,117,267,384,19,45,UCBPlayer
27057,UCBPlayer,110,210,320,12,64,UCBPlayer
27058,UCBPlayer,126,271,397,23,42,UCBPlayer
27059,UCBPlayer,105,210,315,10,65,UCBPlayer
27060,UCBPlayer,130,275,405,25,40,UCBPlayer
27061,UCBPlayer,105,210,315,10,65,UCBPlayer
27062,UCBPlayer,130,275,405,25,40,UCBPlayer
27063,UCBPlayer,106,206,312,10,66,UCBPlayer
27064,UCBPlayer,130,275,405,25,40,UCBPlayer
27065,UCBPlayer,105,210,315,10,65,UCBPlayer
27066,UCBPlayer,131,271,402,25,41,UCBPlayer
27067,UCBPlayer,105,210,315,10,65,UCBPlayer
27068,UCBPlayer,130,275,405,25,40,UCBPlayer
27069,UCBPlayer,105,210,315,10,65,UCBPlayer
27070,UCBPlayer,130,275,405,25,40,UCBPlayer
27071,UCBPlayer,103,203,306,10,68,UCBPlayer
27072,UCBPlayer,128,283,411,25,38,UCBPlayer
27073,UCBPlayer,111,186,297,10,71,UCBPlayer
27074,UCBPlayer,124,299,423,25,34,UCBPlayer
27075,UCBPlayer,115,170,285,10,75,UCBPlayer
27076,UCBPlayer,120,315,435,25,30,UCBPlayer
27077,UCBPlayer,119,154,273,10,79,UCBPlayer
27078,UCBPlayer,112,332,444,25,27,UCBPlayer
27079,UCBPlayer,127,137,264,10,82,UCBPlayer
27080,UCBPlayer,104,349,453,25,24,UCBPlayer
27081,UCBPlayer,126,126,252,7,85,Tie
27082,UCBPlayer,111,351,462,28,22,UCBPlayer
27083,UCBPlayer,116,126,242,3,87,UCBPlayer
27084,UCBPlayer,122,347,469,32,21,UCBPlayer
27085,UCBPlayer,107,132,239,0,87,UCBPlayer
27086,UCBPlayer,132,337,469,35,22,UCBPlayer
27087,UCBPlayer,103,148,251,0,83,UCBPlayer
27088,UCBPlayer,136,321,457,35,26,UCBPlayer
27089,UCBPlayer,99,164,263,0,79,UCBPlayer
27090,UCBPlayer,140,305,445,35,30,UCBPlayer
27091,UCBPlayer,95,180,275,0,75,UCBPlayer
27092,UCBPlayer,144,289,433,35,34,UCBPlayer
27093,UCBPlayer,91,196,287,0,71,UCBPlayer
27094,UCBPlayer,148,273,421,35,38,UCBPlayer
27095,UCBPlayer,87,212,299,0,67,UCBPlayer
27096,UCBPlayer,152,257,409,35,42,UCBPlayer
27097,UCBPlayer,84,224,308,0,64,UCBPlayer
27098,UCBPlayer,146,251,397,32,45,UCBPlayer
27099,UCBPlayer,89,234,323,3,60,UCBPlayer
27100,UCBPlayer,138,243,381,28,49,UCBPlayer
27101,UCBPlayer,97,242,339,7,56,UCBPlayer
27102,UCBPlayer,130,235,365,24,53,UCBPlayer
27103,UCBPlayer,105,250,355,11,52,UCBPlayer
27104,UCBPlayer,122,227,349,20,57,UCBPlayer
27105,UCBPlayer,109,259,368,15,49,UCBPlayer
27106,UCBPlayer,118,218,336,16,60,UCBPlayer
27107,UCBPlayer,117,267,384,19,45,UCBPlayer
27108,UCBPlayer,110,210,320,12,64,UCBPlayer
27109,UCBPlayer,126,271,397,23,42,UCBPlayer
27110,UCBPlayer,105,210,315,10,65,UCBPlayer
27111,UCBPlayer,130,275,405,25,40,UCBPlayer
27112,UCBPlayer,105,210,315,10,65,UCBPlayer
27113,UCBPlayer,130,275,405,25,40,UCBPlayer
27114,UCBPlayer,106,206,312,10,66,UCBPlayer
27115,UCBPlayer,130,275,405,25,40,UCBPlayer
27116,UCBPlayer,105,210,315,10,65,UCBPlayer
27117,UCBPlayer,131,271,402,25,41,UCBPlayer
27118,UCBPlayer,105,210,315,10,65,UCBPlayer
27119,UCBPlayer,130,275,405,25,40,UCBPlayer
27120,UCBPlayer,105,210,315,10,65,UCBPlayer
27121,UCBPlayer,130,275,405,25,40,UCBPlayer
27122,UCBPlayer,103,203,306,10,68,UCBPlayer
27123,UCBPlayer,128,283,411,25,38,UCBPlayer
27124,UCBPlayer,111,186,297,10,71,UCBPlayer
27125,UCBPlayer,124,299,423,25,34,UCBPlayer
27126,UCBPlayer,115,170,285,10,75,UCBPlayer
27127,UCBPlayer,120,315,435,25,30,UCBPlayer
27128,UCBPlayer,119,154,273,10,79,UCBPlayer
27129,UCBPlayer,112,332,444,25,27,UCBPlayer
27130,UCBPlayer,127,137,264,10,82,UCBPlayer
27131,UCBPlayer,104,349,453,25,24,UCBPlayer
27132,UCBPlayer,126,126,252,7,85,Tie
27133,UCBPlayer,111,351,462,28,22,UCBPlayer
27134,UCBPlayer,116,126,242,3,87,UCBPlayer
27135,UCBPlayer,122,347,469,32,21,UCBPlayer
27136,UCBPlayer,107,132,239,0,87,UCBPlayer
27137,UCBPlayer,132,337,469,35,22,UCBPlayer
27138,UCBPlayer,103,148,251,0,83,UCBPlayer
27139,UCBPlayer,136,321,457,35,26,UCBPlayer
27140,UCBPlayer,99,164,263,0,79,UCBPlayer
27141,UCBPlayer,140,305,445,35,30,UCBPlayer
27142,UCBPlayer,95,180,275,0,75,UCBPlayer
27143,UCBPlayer,144,289,433,35,34,UCBPlayer
27144,UCBPlayer,91,196,287,0,71,UCBPlayer
27145,UCBPlayer,148,273,421,35,38,UCBPlayer
27146,UCBPlayer,87,212,299,0,67,UCBPlayer
27147,UCBPlayer,152,257,409,35,42,UCBPlayer
27148,UCBPlayer,84,224,308,0,64,UCBPlayer
27149,UCBPlayer,146,251,397,32,45,UCBPlayer
27150,UCBPlayer,89,234,323,3,60,UCBPlayer
27151,UCBPlayer,138,243,381,28,49,UCBPlayer
27152,UCBPlayer,97,242,339,7,56,UCBPlayer
27153,UCBPlayer,130,235,365,24,53,UCBPlayer
27154,UCBPlayer,105,250,355,11,52,UCBPlayer
27155,UCBPlayer,122,227,349,20,57,UCBPlayer
27156,UCBPlayer,109,259,368,15,49,UCBPlayer
27157,UCBPlayer,118,218,336,16,60,UCBPlayer
27158,UCBPlayer,117,267,384,19,45,UCBPlayer
27159,UCBPlayer,110,210,320,12,64,UCBPlayer
27160,UCBPlayer,126,271,397,23,42,UCBPlayer
27161,UCBPlayer,105,210,315,10,65,UCBPlayer
27162,UCBPlayer,130,275,405,25,40,UCBPlayer
27163,UCBPlayer,105,210,315,10,65,UCBPlayer
27164,UCBPlayer,130,275,405,25,40,UCBPlayer
27165,UCBPlayer,106,206,312,10,66,UCBPlayer
27166,UCBPlayer,130,275,405,25,40,UCBPlayer
27167,UCBPlayer,105,210,315,10,65,UCBPlayer
27168,UCBPlayer,131,271,402,25,41,UCBPlayer
27169,UCBPlayer,105,210,315,10,65,UCBPlayer
27170,UCBPlayer,130,275,405,25,40,UCBPlayer
27171,UCBPlayer,105,210,315,10,65,UCBPlayer
27172,UCBPlayer,130,275,405,25,40,UCBPlayer
27173,UCBPlayer,103,203,306,10,68,UCBPlayer
27174,UCBPlayer,128,283,411,25,38,UCBPlayer
27175,UCBPlayer,111,186,297,10,71,UCBPlayer
27176,UCBPlayer,124,299,423,25,34,UCBPlayer
27177,UCBPlayer,115,170,285,10,75,UCBPlayer
27178,UCBPlayer,120,315,435,25,30,UCBPlayer
27179,UCBPlayer,119,154,273,10,79,UCBPlayer
27180,UCBPlayer,112,332,444,25,27,UCBPlayer
27181,UCBPlayer,127,137,264,10,82,UCBPlayer
27182,UCBPlayer,104,349,453,25,24,UCBPlayer
27183,UCBPlayer,126,126,252,7,85,Tie
27184,UCBPlayer,111,351,462,28,22,UCBPlayer
27185,UCBPlayer,116,126,242,3,87,UCBPlayer
27186,UCBPlayer,122,347,469,32,21,UCBPlayer
27187,UCBPlayer,107,132,239,0,87,UCBPlayer
27188,UCBPlayer,132,337,469,35,22,UCBPlayer
27189,UCBPlayer,103,148,251,0,83,UCBPlayer
27190,UCBPlayer,136,321,457,35,26,UCBPlayer
27191,UCBPlayer,99,164,263,0,79,UCBPlayer
27192,UCBPlayer,140,305,445,35,30,UCBPlayer
27193,UCBPlayer,95,180,275,0,75,UCBPlayer
27194,UCBPlayer,144,289,433,35,34,UCBPlayer
27195,UCBPlayer,91,196,287,0,71,UCBPlayer
27196,UCBPlayer,148,273,421,35,38,UCBPlayer
27197,UCBPlayer,87,212,299,0,67,UCBPlayer
27198,UCBPlayer,152,257,409,35,42,UCBPlayer
27199,UCBPlayer,84,224,308,0,64,UCBPlayer
27200,UCBPlayer,146,251,397,32,45,UCBPlayer
27201,UCBPlayer,89,234,323,3,60,UCBPlayer
27202,UCBPlayer,138,243,381,28,49,UCBPlayer
27203,UCBPlayer,97,242,339,7,56,UCBPlayer
27204,UCBPlayer,130,235,365,24,53,UCBPlayer
27205,UCBPlayer,105,250,355,11,52,UCBPlayer
27206,UCBPlayer,122,227,349,20,57,UCBPlayer
27207,UCBPlayer,109,259,368,15,49,UCBPlayer
27208,UCBPlayer,118,218,336,16,60,UCBPlayer
27209,UCBPlayer,117,267,384,19,45,UCBPlayer
27210,UCBPlayer,110,210,320,12,64,UCBPlayer
27211,UCBPlayer,126,271,397,23,42,UCBPlayer
27212,UCBPlayer,105,210,315,10,65,UCBPlayer
27213,UCBPlayer,130,275,405,25,40,UCBPlayer
27214,UCBPlayer,105,210,315,10,65,UCBPlayer
27215,UCBPlayer,130,275,405,25,40,UCBPlayer
27216,UCBPlayer,106,206,312,10,66,UCBPlayer
27217,UCBPlayer,130,275,405,25,40,UCBPlayer
27218,UCBPlayer,105,210,315,10,65,UCBPlayer
27219,UCBPlayer,131,271,402,25,41,UCBPlayer
27220,UCBPlayer,105,210,315,10,65,UCBPlayer
27221,UCBPlayer,130,275,405,25,40,UCBPlayer
27222,UCBPlayer,105,210,315,10,65,UCBPlayer
27223,UCBPlayer,130,275,405,25,40,UCBPlayer
27224,UCBPlayer,103,203,306,10,68,UCBPlayer
27225,UCBPlayer,128,283,411,25,38,UCBPlayer
27226,UCBPlayer,111,186,297,10,71,UCBPlayer
27227,UCBPlayer,124,299,423,25,34,UCBPlayer
27228,UCBPlayer,115,170,285,10,75,UCBPlayer
27229,UCBPlayer,120,315,435,25,30,UCBPlayer
27230,UCBPlayer,119,154,273,10,79,UCBPlayer
27231,UCBPlayer,112,332,444,25,27,UCBPlayer
27232,UCBPlayer,127,137,264,10,82,UCBPlayer
27233,UCBPlayer,104,349,453,25,24,UCBPlayer
27234,UCBPlayer,126,126,252,7,85,Tie
27235,UCBPlayer,111,351,462,28,22,UCBPlayer
27236,UCBPlayer,116,126,242,3,87,UCBPlayer
27237,UCBPlayer,122,347,469,32,21,UCBPlayer
27238,UCBPlayer,107,132,239,0,87,UCBPlayer
27239,UCBPlayer,132,337,469,35,22,UCBPlayer
27240,UCBPlayer,103,148,251,0,83,UCBPlayer
27241,UCBPlayer,136,321,457,35,26,UCBPlayer
27242,UCBPlayer,99,164,263,0,79,UCBPlayer
27243,UCBPlayer,140,305,445,35,30,UCBPlayer
27244,UCBPlayer,95,180,275,0,75,UCBPlayer
27245,UCBPlayer,144,289,433,35,34,UCBPlayer
27246,UCBPlayer,91,196,287,0,71,UCBPlayer
27247,UCBPlayer,148,273,421,35,38,UCBPlayer
27248,UCBPlayer,87,212,299,0,67,UCBPlayer
27249,UCBPlayer,152,257,409,35,42,UCBPlayer
27250,UCBPlayer,84,224,308,0,64,UCBPlayer
27251,UCBPlayer,146,251,397,32,45,UCBPlayer
27252,UCBPlayer,89,234,323,3,60,UCBPlayer
27253,UCBPlayer,138,243,381,28,49,UCBPlayer
27254,UCBPlayer,97,242,339,7,56,UCBPlayer
27255,UCBPlayer,130,235,365,24,53,UCBPlayer
27256,UCBPlayer,105,250,355,11,52,UCBPlayer
27257,UCBPlayer,122,227,349,20,57,UCBPlayer
27258,UCBPlayer,109,259,368,15,49,UCBPlayer
27259,UCBPlayer,118,218,336,16,60,UCBPlayer
27260,UCBPlayer,117,267,384,19,45,UCBPlayer
27261,UCBPlayer,110,210,320,12,64,UCBPlayer
27262,UCBPlayer,126,271,397,23,42,UCBPlayer
27263,UCBPlayer,105,210,315,10,65,UCBPlayer
27264,UCBPlayer,130,275,405,25,40,UCBPlayer
27265,UCBPlayer,105,210,315,10,65,UCBPlayer
27266,UCBPlayer,130,275,405,25,40,UCBPlayer
27267,UCBPlayer,106,206,312,10,66,UCBPlayer
27268,UCBPlayer,130,275,405,25,40,UCBPlayer
27269,UCBPlayer,105,210,315,10,65,UCBPlayer
27270,UCBPlayer,131,271,402,25,41,UCBPlayer
27271,UCBPlayer,105,210,315,10,65,UCBPlayer
27272,UCBPlayer,130,275,405,25,40,UCBPlayer
27273,UCBPlayer,105,210,315,10,65,UCBPlayer
27274,UCBPlayer,130,275,405,25,40,UCBPlayer
27275,UCBPlayer,103,203,306,10,68,UCBPlayer
27276,UCBPlayer,128,283,411,25,38,UCBPlayer
27277,UCBPlayer,111,186,297,10,71,UCBPlayer
27278,UCBPlayer,124,299,423,25,34,UCBPlayer
27279,UCBPlayer,115,170,285,10,75,UCBPlayer
27280,UCBPlayer,120,315,435,25,30,UCBPlayer
27281,UCBPlayer,119,154,273,10,79,UCBPlayer
27282,UCBPlayer,112,332,444,25,27,UCBPlayer
27283,UCBPlayer,127,137,264,10,82,UCBPlayer
27284,UCBPlayer,104,349,453,25,24,UCBPlayer
27285,UCBPlayer,126,126,252,7,85,Tie
27286,UCBPlayer,111,351,462,28,22,UCBPlayer
27287,UCBPlayer,116,126,242,3,87,UCBPlayer
27288,UCBPlayer,122,347,469,32,21,UCBPlayer
27289,UCBPlayer,107,132,239,0,87,UCBPlayer
27290,UCBPlayer,132,337,469,35,22,UCBPlayer
27291,UCBPlayer,103,148,251,0,83,UCBPlayer
27292,UCBPlayer,136,321,457,35,26,UCBPlayer
27293,UCBPlayer,99,164,263,0,79,UCBPlayer
27294,UCBPlayer,140,305,445,35,30,UCBPlayer
27295,UCBPlayer,95,180,275,0,75,UCBPlayer
27296,UCBPlayer,144,289,433,35,34,UCBPlayer
27297,UCBPlayer,91,196,287,0,71,UCBPlayer
27298,UCBPlayer,148,273,421,35,38,UCBPlayer
27299,UCBPlayer,87,212,299,0,67,UCBPlayer
27300,UCBPlayer,152,257,409,35,42,UCBPlayer
27301,UCBPlayer,84,224,308,0,64,UCBPlayer
27302,UCBPlayer,146,251,397,32,45,UCBPlayer
27303,UCBPlayer,89,234,323,3,60,UCBPlayer
27304,UCBPlayer,138,243,381,28,49,UCBPlayer
27305,UCBPlayer,97,242,339,7,56,UCBPlayer
27306,UCBPlayer,130,235,365,24,53,UCBPlayer
27307,UCBPlayer,105,250,355,11,52,UCBPlayer
27308,UCBPlayer,122,227,349,20,57,UCBPlayer
27309,UCBPlayer,109,259,368,15,49,UCBPlayer
27310,UCBPlayer,118,218,336,16,60,UCBPlayer
27311,UCBPlayer,117,267,384,19,45,UCBPlayer
27312,UCBPlayer,110,210,320,12,64,UCBPlayer
27313,UCBPlayer,126,271,397,23,42,UCBPlayer
27314,UCBPlayer,105,210,315,10,65,UCBPlayer
27315,UCBPlayer,130,275,405,25,40,UCBPlayer
27316,UCBPlayer,105,210,315,10,65,UCBPlayer
27317,UCBPlayer,130,275,405,25,40,UCBPlayer
27318,UCBPlayer,106,206,312,10,66,UCBPlayer
27319,UCBPlayer,130,275,405,25,40,UCBPlayer
27320,UCBPlayer,105,210,315,10,65,UCBPlayer
27321,UCBPlayer,131,271,402,25,41,UCBPlayer
27322,UCBPlayer,105,210,315,10,65,UCBPlayer
27323,UCBPlayer,130,275,405,25,40,UCBPlayer
27324,UCBPlayer,105,210,315,10,65,UCBPlayer
27325,UCBPlayer,130,275,405,25,40,UCBPlayer
27326,UCBPlayer,103,203,306,10,68,UCBPlayer
27327,UCBPlayer,128,283,411,25,38,UCBPlayer
27328,UCBPlayer,111,186,297,10,71,UCBPlayer
27329,UCBPlayer,124,299,423,25,34,UCBPlayer
27330,UCBPlayer,115,170,285,10,75,UCBPlayer
27331,UCBPlayer,120,315,435,25,30,UCBPlayer
27332,UCBPlayer,119,154,273,10,79,UCBPlayer
27333,UCBPlayer,112,332,444,25,27,UCBPlayer
27334,UCBPlayer,127,137,264,10,82,UCBPlayer
27335,UCBPlayer,104,349,453,25,24,UCBPlayer
27336,UCBPlayer,126,126,252,7,85,Tie
27337,UCBPlayer,111,351,462,28,22,UCBPlayer
27338,UCBPlayer,116,126,242,3,87,UCBPlayer
27339,UCBPlayer,122,347,469,32,21,UCBPlayer
27340,UCBPlayer,107,132,239,0,87,UCBPlayer
27341,UCBPlayer,132,337,469,35,22,UCBPlayer
27342,UCBPlayer,103,148,251,0,83,UCBPlayer
27343,UCBPlayer,136,321,457,35,26,UCBPlayer
27344,UCBPlayer,99,164,263,0,79,UCBPlayer
27345,UCBPlayer,140,305,445,35,30,UCBPlayer
27346,UCBPlayer,95,180,275,0,75,UCBPlayer
27347,UCBPlayer,144,289,433,35,34,UCBPlayer
27348,UCBPlayer,91,196,287,0,71,UCBPlayer
27349,UCBPlayer,148,273,421,35,38,UCBPlayer
27350,UCBPlayer,87,212,299,0,67,UCBPlayer
27351,UCBPlayer,152,257,409,35,42,UCBPlayer
27352,UCBPlayer,84,224,308,0,64,UCBPlayer
27353,UCBPlayer,146,251,397,32,45,UCBPlayer
27354,UCBPlayer,89,234,323,3,60,UCBPlayer
27355,UCBPlayer,138,243,381,28,49,UCBPlayer
27356,UCBPlayer,97,242,339,7,56,UCBPlayer
27357,UCBPlayer,130,235,365,24,53,UCBPlayer
27358,UCBPlayer,105,250,355,11,52,UCBPlayer
27359,UCBPlayer,122,227,349,20,57,UCBPlayer
27360,UCBPlayer,109,259,368,15,49,UCBPlayer
27361,UCBPlayer,118,218,336,16,60,UCBPlayer
27362,UCBPlayer,117,267,384,19,45,UCBPlayer
27363,UCBPlayer,110,210,320,12,64,UCBPlayer
27364,UCBPlayer,126,271,397,23,42,UCBPlayer
27365,UCBPlayer,105,210,315,10,65,UCBPlayer
27366,UCBPlayer,130,275,405,25,40,UCBPlayer
27367,UCBPlayer,105,210,315,10,65,UCBPlayer
27368,UCBPlayer,130,275,405,25,40,UCBPlayer
27369,UCBPlayer,106,206,312,10,66,UCBPlayer
27370,UCBPlayer,130,275,405,25,40,UCBPlayer
27371,UCBPlayer,105,210,315,10,65,UCBPlayer
27372,UCBPlayer,131,271,402,25,41,UCBPlayer
27373,UCBPlayer,105,210,315,10,65,UCBPlayer
27374,UCBPlayer,130,275,405,25,40,UCBPlayer
27375,UCBPlayer,105,210,315,10,65,UCBPlayer
27376,UCBPlayer,130,275,405,25,40,UCBPlayer
27377,UCBPlayer,103,203,306,10,68,UCBPlayer
27378,UCBPlayer,128,283,411,25,38,UCBPlayer
27379,UCBPlayer,111,186,297,10,71,UCBPlayer
27380,UCBPlayer,124,299,423,25,34,UCBPlayer
27381,UCBPlayer,115,170,285,10,75,UCBPlayer
27382,UCBPlayer,120,315,435,25,30,UCBPlayer
27383,UCBPlayer,119,154,273,10,79,UCBPlayer
27384,UCBPlayer,112,332,444,25,27,UCBPlayer
27385,UCBPlayer,127,137,264,10,82,UCBPlayer
27386,UCBPlayer,104,349,453,25,24,UCBPlayer
27387,UCBPlayer,126,126,252,7,85,Tie
27388,UCBPlayer,111,351,462,28,22,UCBPlayer
27389,UCBPlayer,116,126,242,3,87,UCBPlayer
27390,UCBPlayer,122,347,469,32,21,UCBPlayer
27391,UCBPlayer,107,132,239,0,87,UCBPlayer
27392,UCBPlayer,132,337,469,35,22,UCBPlayer
27393,UCBPlayer,103,148,251,0,83,UCBPlayer
27394,UCBPlayer,136,321,457,35,26,UCBPlayer
27395,UCBPlayer,99,164,263,0,79,UCBPlayer
27396,UCBPlayer,140,305,445,35,30,UCBPlayer
27397,UCBPlayer,95,180,275,0,75,UCBPlayer
27398,UCBPlayer,144,289,433,35,34,UCBPlayer
27399,UCBPlayer,91,196,287,0,71,UCBPlayer
27400,UCBPlayer,148,273,421,35,38,UCBPlayer
27401,UCBPlayer,87,212,299,0,67,UCBPlayer
27402,UCBPlayer,152,257,409,35,42,UCBPlayer
27403,UCBPlayer,84,224,308,0,64,UCBPlayer
27404,UCBPlayer,146,251,397,32,45,UCBPlayer
27405,UCBPlayer,89,234,323,3,60,UCBPlayer
27406,UCBPlayer,138,243,381,28,49,UCBPlayer
27407,UCBPlayer,97,242,339,7,56,UCBPlayer
27408,UCBPlayer,130,235,365,24,53,UCBPlayer
27409,UCBPlayer,105,250,355,11,52,UCBPlayer
27410,UCBPlayer,122,227,349,20,57,UCBPlayer
27411,UCBPlayer,109,259,368,15,49,UCBPlayer
27412,UCBPlayer,118,218,336,16,60,UCBPlayer
27413,UCBPlayer,117,267,384,19,45,UCBPlayer
27414,UCBPlayer,110,210,320,12,64,UCBPlayer
27415,UCBPlayer,126,271,397,23,42,UCBPlayer
27416,UCBPlayer,105,210,315,10,65,UCBPlayer
27417,UCBPlayer,130,275,405,25,40,UCBPlayer
27418,UCBPlayer,105,210,315,10,65,UCBPlayer
27419,UCBPlayer,130,275,405,25,40,UCBPlayer
27420,UCBPlayer,106,206,312,10,66,UCBPlayer
27421,UCBPlayer,130,275,405,25,40,UCBPlayer
27422,UCBPlayer,105,210,315,10,65,UCBPlayer
27423,UCBPlayer,131,271,402,25,41,UCBPlayer
27424,UCBPlayer,105,210,315,10,65,UCBPlayer
27425,UCBPlayer,130,275,405,25,40,UCBPlayer
27426,UCBPlayer,105,210,315,10,65,UCBPlayer
27427,UCBPlayer,130,275,405,25,40,UCBPlayer
27428,UCBPlayer,103,203,306,10,68,UCBPlayer
27429,UCBPlayer,128,283,411,25,38,UCBPlayer
27430,UCBPlayer,111,186,297,10,71,UCBPlayer
27431,UCBPlayer,124,299,423,25,34,UCBPlayer
27432,UCBPlayer,115,170,285,10,75,UCBPlayer
27433,UCBPlayer,120,315,435,25,30,UCBPlayer
27434,UCBPlayer,119,154,273,10,79,UCBPlayer
27435,UCBPlayer,112,332,444,25,27,UCBPlayer
27436,UCBPlayer,127,137,264,10,82,UCBPlayer
27437,UCBPlayer,104,349,453,25,24,UCBPlayer
27438,UCBPlayer,126,126,252,7,85,Tie
27439,UCBPlayer,111,351,462,28,22,UCBPlayer
27440,UCBPlayer,116,126,242,3,87,UCBPlayer
27441,UCBPlayer,122,347,469,32,21,UCBPlayer
27442,UCBPlayer,107,132,239,0,87,UCBPlayer
27443,UCBPlayer,132,337,469,35,22,UCBPlayer
27444,UCBPlayer,103,148,251,0,83,UCBPlayer
27445,UCBPlayer,136,321,457,35,26,UCBPlayer
27446,UCBPlayer,99,164,263,0,79,UCBPlayer
27447,UCBPlayer,140,305,445,35,30,UCBPlayer
27448,UCBPlayer,95,180,275,0,75,UCBPlayer
27449,UCBPlayer,144,289,433,35,34,UCBPlayer
27450,UCBPlayer,91,196,287,0,71,UCBPlayer
27451,UCBPlayer,148,273,421,35,38,UCBPlayer
27452,UCBPlayer,87,212,299,0,67,UCBPlayer
27453,UCBPlayer,152,257,409,35,42,UCBPlayer
27454,UCBPlayer,84,224,308,0,64,UCBPlayer
27455,UCBPlayer,146,251,397,32,45,UCBPlayer
27456,UCBPlayer,89,234,323,3,60,UCBPlayer
27457,UCBPlayer,138,243,381,28,49,UCBPlayer
27458,UCBPlayer,97,242,339,7,56,UCBPlayer
27459,UCBPlayer,130,235,365,24,53,UCBPlayer
27460,UCBPlayer,105,250,355,11,52,UCBPlayer
27461,UCBPlayer,122,227,349,20,57,UCBPlayer
27462,UCBPlayer,109,259,368,15,49,UCBPlayer
27463,UCBPlayer,118,218,336,16,60,UCBPlayer
27464,UCBPlayer,117,267,384,19,45,UCBPlayer
27465,UCBPlayer,110,210,320,12,64,UCBPlayer
27466,UCBPlayer,126,271,397,23,42,UCBPlayer
27467,UCBPlayer,105,210,315,10,65,UCBPlayer
27468,UCBPlayer,130,275,405,25,40,UCBPlayer
27469,UCBPlayer,105,210,315,10,65,UCBPlayer
27470,UCBPlayer,130,275,405,25,40,UCBPlayer
27471,UCBPlayer,106,206,312,10,66,UCBPlayer
27472,UCBPlayer,130,275,405,25,40,UCBPlayer
27473,UCBPlayer,105,210,315,10,65,UCBPlayer
27474,UCBPlayer,131,271,402,25,41,UCBPlayer
27475,UCBPlayer,105,210,315,10,65,UCBPlayer
27476,UCBPlayer,130,275,405,25,40,UCBPlayer
27477,UCBPlayer,105,210,315,10,65,UCBPlayer
27478,UCBPlayer,130,275,405,25,40,UCBPlayer
27479,UCBPlayer,103,203,306,10,68,UCBPlayer
27480,UCBPlayer,128,283,411,25,38,UCBPlayer
27481,UCBPlayer,111,186,297,10,71,UCBPlayer
27482,UCBPlayer,124,299,423,25,34,UCBPlayer
27483,UCBPlayer,115,170,285,10,75,UCBPlayer
27484,UCBPlayer,120,315,435,25,30,UCBPlayer
27485,UCBPlayer,119,154,273,10,79,UCBPlayer
27486,UCBPlayer,112,332,444,25,27,UCBPlayer
27487,UCBPlayer,127,137,264,10,82,UCBPlayer
27488,UCBPlayer,104,349,453,25,24,UCBPlayer
27489,UCBPlayer,126,126,252,7,85,Tie
27490,UCBPlayer,111,351,462,28,22,UCBPlayer
27491,UCBPlayer,116,126,242,3,87,UCBPlayer
27492,UCBPlayer,122,347,469,32,21,UCBPlayer
27493,UCBPlayer,107,132,239,0,87,UCBPlayer
27494,UCBPlayer,132,337,469,35,22,UCBPlayer
27495,UCBPlayer,103,148,251,0,83,UCBPlayer
27496,UCBPlayer,136,321,457,35,26,UCBPlayer
27497,UCBPlayer,99,164,263,0,79,UCBPlayer
27498,UCBPlayer,140,305,445,35,30,UCBPlayer
27499,UCBPlayer,95,180,275,0,75,UCBPlayer
27500,UCBPlayer,144,289,433,35,34,UCBPlayer
27501,UCBPlayer,91,196,287,0,71,UCBPlayer
27502,UCBPlayer,148,273,421,35,38,UCBPlayer
27503,UCBPlayer,87,212,299,0,67,UCBPlayer
27504,UCBPlayer,152,257,409,35,42,UCBPlayer
27505,UCBPlayer,84,224,308,0,64,UCBPlayer
27506,UCBPlayer,146,251,397,32,45,UCBPlayer
27507,UCBPlayer,89,234,323,3,60,UCBPlayer
27508,UCBPlayer,138,243,381,28,49,UCBPlayer
27509,UCBPlayer,97,242,339,7,56,UCBPlayer
27510,UCBPlayer,130,235,365,24,53,UCBPlayer
27511,UCBPlayer,105,250,355,11,52,UCBPlayer
27512,UCBPlayer,122,227,349,20,57,UCBPlayer
27513,UCBPlayer,109,259,368,15,49,UCBPlayer
27514,UCBPlayer,118,218,336,16,60,UCBPlayer
27515,UCBPlayer,117,267,384,19,45,UCBPlayer
27516,UCBPlayer,110,210,320,12,64,UCBPlayer
27517,UCBPlayer,126,271,397,23,42,UCBPlayer
27518,UCBPlayer,105,210,315,10,65,UCBPlayer
27519,UCBPlayer,130,275,405,25,40,UCBPlayer
27520,UCBPlayer,105,210,315,10,65,UCBPlayer
27521,UCBPlayer,130,275,405,25,40,UCBPlayer
27522,UCBPlayer,106,206,312,10,66,UCBPlayer
27523,UCBPlayer,130,275,405,25,40,UCBPlayer
27524,UCBPlayer,105,210,315,10,65,UCBPlayer
27525,UCBPlayer,131,271,402,25,41,UCBPlayer
27526,UCBPlayer,105,210,315,10,65,UCBPlayer
27527,UCBPlayer,130,275,405,25,40,UCBPlayer
27528,UCBPlayer,105,210,315,10,65,UCBPlayer
27529,UCBPlayer,130,275,405,25,40,UCBPlayer
27530,UCBPlayer,103,203,306,10,68,UCBPlayer
27531,UCBPlayer,128,283,411,25,38,UCBPlayer
27532,UCBPlayer,111,186,297,10,71,UCBPlayer
27533,UCBPlayer,124,299,423,25,34,UCBPlayer
27534,UCBPlayer,115,170,285,10,75,UCBPlayer
27535,UCBPlayer,120,315,435,25,30,UCBPlayer
27536,UCBPlayer,119,154,273,10,79,UCBPlayer
27537,UCBPlayer,112,332,444,25,27,UCBPlayer
27538,UCBPlayer,127,137,264,10,82,UCBPlayer
27539,UCBPlayer,104,349,453,25,24,UCBPlayer
27540,UCBPlayer,126,126,252,7,85,Tie
27541,UCBPlayer,111,351,462,28,22,UCBPlayer
27542,UCBPlayer,116,126,242,3,87,UCBPlayer
27543,UCBPlayer,122,347,469,32,21,UCBPlayer
27544,UCBPlayer,107,132,239,0,87,UCBPlayer
27545,UCBPlayer,132,337,469,35,22,UCBPlayer
27546,UCBPlayer,103,148,251,0,83,UCBPlayer
27547,UCBPlayer,136,321,457,35,26,UCBPlayer
27548,UCBPlayer,99,164,263,0,79,UCBPlayer
27549,UCBPlayer,140,305,445,35,30,UCBPlayer
27550,UCBPlayer,95,180,275,0,75,UCBPlayer
27551,UCBPlayer,144,289,433,35,34,UCBPlayer
27552,UCBPlayer,91,196,287,0,71,UCBPlayer
27553,UCBPlayer,148,273,421,35,38,UCBPlayer
27554,UCBPlayer,87,212,299,0,67,UCBPlayer
27555,UCBPlayer,152,257,409,35,42,UCBPlayer
27556,UCBPlayer,84,224,308,0,64,UCBPlayer
27557,UCBPlayer,146,251,397,32,45,UCBPlayer
27558,UCBPlayer,89,234,323,3,60,UCBPlayer
27559,UCBPlayer,138,243,381,28,49,UCBPlayer
27560,UCBPlayer,97,242,339,7,56,UCBPlayer
27561,UCBPlayer,130,235,365,24,53,UCBPlayer
27562,UCBPlayer,105,250,355,11,52,UCBPlayer
27563,UCBPlayer,122,227,349,20,57,UCBPlayer
27564,UCBPlayer,109,259,368,15,49,UCBPlayer
27565,UCBPlayer,118,218,336,16,60,UCBPlayer
27566,UCBPlayer,117,267,384,19,45,UCBPlayer
27567,UCBPlayer,110,210,320,12,64,UCBPlayer
27568,UCBPlayer,126,271,397,23,42,UCBPlayer
27569,UCBPlayer,105,210,315,10,65,UCBPlayer
27570,UCBPlayer,130,275,405,25,40,UCBPlayer
27571,UCBPlayer,105,210,315,10,65,UCBPlayer
27572,UCBPlayer,130,275,405,25,40,UCBPlayer
27573,UCBPlayer,106,206,312,10,66,UCBPlayer
27574,UCBPlayer,130,275,405,25,40,UCBPlayer
27575,UCBPlayer,105,210,315,10,65,UCBPlayer
27576,UCBPlayer,131,271,402,25,41,UCBPlayer
27577,UCBPlayer,105,210,315,10,65,UCBPlayer
27578,UCBPlayer,130,275,405,25,40,UCBPlayer
27579,UCBPlayer,105,210,315,10,65,UCBPlayer
27580,UCBPlayer,130,275,405,25,40,UCBPlayer
27581,UCBPlayer,103,203,306,10,68,UCBPlayer
27582,UCBPlayer,128,283,411,25,38,UCBPlayer
27583,UCBPlayer,111,186,297,10,71,UCBPlayer
27584,UCBPlayer,124,299,423,25,34,UCBPlayer
27585,UCBPlayer,115,170,285,10,75,UCBPlayer
27586,UCBPlayer,120,315,435,25,30,UCBPlayer
27587,UCBPlayer,119,154,273,10,79,UCBPlayer
27588,UCBPlayer,112,332,444,25,27,UCBPlayer
27589,UCBPlayer,127,137,264,10,82,UCBPlayer
27590,UCBPlayer,104,349,453,25,24,UCBPlayer
27591,UCBPlayer,126,126,252,7,85,Tie
27592,UCBPlayer,111,351,462,28,22,UCBPlayer
27593,UCBPlayer,116,126,242,3,87,UCBPlayer
27594,UCBPlayer,122,347,469,32,21,UCBPlayer
27595,UCBPlayer,107,132,239,0,87,UCBPlayer
27596,UCBPlayer,132,337,469,35,22,UCBPlayer
27597,UCBPlayer,103,148,251,0,83,UCBPlayer
27598,UCBPlayer,136,321,457,35,26,UCBPlayer
27599,UCBPlayer,99,164,263,0,79,UCBPlayer
27600,UCBPlayer,140,305,445,35,30,UCBPlayer
27601,UCBPlayer,95,180,275,0,75,UCBPlayer
27602,UCBPlayer,144,289,433,35,34,UCBPlayer
27603,UCBPlayer,91,196,287,0,71,UCBPlayer
27604,UCBPlayer,148,273,421,35,38,UCBPlayer
27605,UCBPlayer,87,212,299,0,67,UCBPlayer
27606,UCBPlayer,152,257,409,35,42,UCBPlayer
27607,UCBPlayer,84,224,308,0,64,UCBPlayer
27608,UCBPlayer,146,251,397,32,45,UCBPlayer
27609,UCBPlayer,89,234,323,3,60,UCBPlayer
27610,UCBPlayer,138,243,381,28,49,UCBPlayer
27611,UCBPlayer,97,242,339,7,56,UCBPlayer
27612,UCBPlayer,130,235,365,24,53,UCBPlayer
27613,UCBPlayer,105,250,355,11,52,UCBPlayer
27614,UCBPlayer,122,227,349,20,57,UCBPlayer
27615,UCBPlayer,109,259,368,15,49,UCBPlayer
27616,UCBPlayer,118,218,336,16,60,UCBPlayer
27617,UCBPlayer,117,267,384,19,45,UCBPlayer
27618,UCBPlayer,110,210,320,12,64,UCBPlayer
27619,UCBPlayer,126,271,397,23,42,UCBPlayer
27620,UCBPlayer,105,210,315,10,65,UCBPlayer
27621,UCBPlayer,130,275,405,25,40,UCBPlayer
27622,UCBPlayer,105,210,315,10,65,UCBPlayer
27623,UCBPlayer,130,275,405,25,40,UCBPlayer
27624,UCBPlayer,106,206,312,10,66,UCBPlayer
27625,UCBPlayer,130,275,405,25,40,UCBPlayer
27626,UCBPlayer,105,210,315,10,65,UCBPlayer
27627,UCBPlayer,131,271,402,25,41,UCBPlayer
27628,UCBPlayer,105,210,315,10,65,UCBPlayer
27629,UCBPlayer,130,275,405,25,40,UCBPlayer
27630,UCBPlayer,105,210,315,10,65,UCBPlayer
27631,UCBPlayer,130,275,405,25,40,UCBPlayer
27632,UCBPlayer,103,203,306,10,68,UCBPlayer
27633,UCBPlayer,128,283,411,25,38,UCBPlayer
27634,UCBPlayer,111,186,297,10,71,UCBPlayer
27635,UCBPlayer,124,299,423,25,34,UCBPlayer
27636,UCBPlayer,115,170,285,10,75,UCBPlayer
27637,UCBPlayer,120,315,435,25,30,UCBPlayer
27638,UCBPlayer,119,154,273,10,79,UCBPlayer
27639,UCBPlayer,112,332,444,25,27,UCBPlayer
27640,UCBPlayer,127,137,264,10,82,UCBPlayer
27641,UCBPlayer,104,349,453,25,24,UCBPlayer
27642,UCBPlayer,126,126,252,7,85,Tie
27643,UCBPlayer,111,351,462,28,22,UCBPlayer
27644,UCBPlayer,116,126,242,3,87,UCBPlayer
27645,UCBPlayer,122,347,469,32,21,UCBPlayer
27646,UCBPlayer,107,132,239,0,87,UCBPlayer
27647,UCBPlayer,132,337,469,35,22,UCBPlayer
27648,UCBPlayer,103,148,251,0,83,UCBPlayer
27649,UCBPlayer,136,321,457,35,26,UCBPlayer
27650,UCBPlayer,99,164,263,0,79,UCBPlayer
27651,UCBPlayer,140,305,445,35,30,UCBPlayer
27652,UCBPlayer,95,180,275,0,75,UCBPlayer
27653,UCBPlayer,144,289,433,35,34,UCBPlayer
27654,UCBPlayer,91,196,287,0,71,UCBPlayer
27655,UCBPlayer,148,273,421,35,38,UCBPlayer
27656,UCBPlayer,87,212,299,0,67,UCBPlayer
27657,UCBPlayer,152,257,409,35,42,UCBPlayer
27658,UCBPlayer,84,224,308,0,64,UCBPlayer
27659,UCBPlayer,146,251,397,32,45,UCBPlayer
27660,UCBPlayer,89,234,323,3,60,UCBPlayer
27661,UCBPlayer,138,243,381,28,49,UCBPlayer
27662,UCBPlayer,97,242,339,7,56,UCBPlayer
27663,UCBPlayer,130,235,365,24,53,UCBPlayer
27664,UCBPlayer,105,250,355,11,52,UCBPlayer
27665,UCBPlayer,122,227,349,20,57,UCBPlayer
27666,UCBPlayer,109,259,368,15,49,UCBPlayer
27667,UCBPlayer,118,218,336,16,60,UCBPlayer
27668,UCBPlayer,117,267,384,19,45,UCBPlayer
27669,UCBPlayer,110,210,320,12,64,UCBPlayer
27670,UCBPlayer,126,271,397,23,42,UCBPlayer
27671,UCBPlayer,105,210,315,10,65,UCBPlayer
27672,UCBPlayer,130,275,405,25,40,UCBPlayer
27673,UCBPlayer,105,210,315,10,65,UCBPlayer
27674,UCBPlayer,130,275,405,25,40,UCBPlayer
27675,UCBPlayer,106,206,312,10,66,UCBPlayer
27676,UCBPlayer,130,275,405,25,40,UCBPlayer
27677,UCBPlayer,105,210,315,10,65,UCBPlayer
27678,UCBPlayer,131,271,402,25,41,UCBPlayer
27679,UCBPlayer,105,210,315,10,65,UCBPlayer
27680,UCBPlayer,130,275,405,25,40,UCBPlayer
27681,UCBPlayer,105,210,315,10,65,UCBPlayer
27682,UCBPlayer,130,275,405,25,40,UCBPlayer
27683,UCBPlayer,103,203,306,10,68,UCBPlayer
27684,UCBPlayer,128,283,411,25,38,UCBPlayer
27685,UCBPlayer,111,186,297,10,71,UCBPlayer
27686,UCBPlayer,124,299,423,25,34,UCBPlayer
27687,UCBPlayer,115,170,285,10,75,UCBPlayer
27688,UCBPlayer,120,315,435,25,30,UCBPlayer
27689,UCBPlayer,119,154,273,10,79,UCBPlayer
27690,UCBPlayer,112,332,444,25,27,UCBPlayer
27691,UCBPlayer,127,137,264,10,82,UCBPlayer
27692,UCBPlayer,104,349,453,25,24,UCBPlayer
27693,UCBPlayer,126,126,252,7,85,Tie
27694,UCBPlayer,111,351,462,28,22,UCBPlayer
27695,UCBPlayer,116,126,242,3,87,UCBPlayer
27696,UCBPlayer,122,347,469,32,21,UCBPlayer
27697,UCBPlayer,107,132,239,0,87,UCBPlayer
27698,UCBPlayer,132,337,469,35,22,UCBPlayer
27699,UCBPlayer,103,148,251,0,83,UCBPlayer
27700,UCBPlayer,136,321,457,35,26,UCBPlayer
27701,UCBPlayer,99,164,263,0,79,UCBPlayer
27702,UCBPlayer,140,305,445,35,30,UCBPlayer
27703,UCBPlayer,95,180,275,0,75,UCBPlayer
27704,UCBPlayer,144,289,433,35,34,UCBPlayer
27705,UCBPlayer,91,196,287,0,71,UCBPlayer
27706,UCBPlayer,148,273,421,35,38,UCBPlayer
27707,UCBPlayer,87,212,299,0,67,UCBPlayer
27708,UCBPlayer,152,257,409,35,42,UCBPlayer
27709,UCBPlayer,84,224,308,0,64,UCBPlayer
27710,UCBPlayer,146,251,397,32,45,UCBPlayer
27711,UCBPlayer,89,234,323,3,60,UCBPlayer
27712,UCBPlayer,138,243,381,28,49,UCBPlayer
27713,UCBPlayer,97,242,339,7,56,UCBPlayer
27714,UCBPlayer,130,235,365,24,53,UCBPlayer
27715,UCBPlayer,105,250,355,11,52,UCBPlayer
27716,UCBPlayer,122,227,349,20,57,UCBPlayer
27717,UCBPlayer,109,259,368,15,49,UCBPlayer
27718,UCBPlayer,118,218,336,16,60,UCBPlayer
27719,UCBPlayer,117,267,384,19,45,UCBPlayer
27720,UCBPlayer,110,210,320,12,64,UCBPlayer
27721,UCBPlayer,126,271,397,23,42,UCBPlayer
27722,UCBPlayer,105,210,315,10,65,UCBPlayer
27723,UCBPlayer,130,275,405,25,40,UCBPlayer
27724,UCBPlayer,105,210,315,10,65,UCBPlayer
27725,UCBPlayer,130,275,405,25,40,UCBPlayer
27726,UCBPlayer,106,206,312,10,66,UCBPlayer
27727,UCBPlayer,130,275,405,25,40,UCBPlayer
27728,UCBPlayer,105,210,315,10,65,UCBPlayer
27729,UCBPlayer,131,271,402,25,41,UCBPlayer
27730,UCBPlayer,105,210,315,10,65,UCBPlayer
27731,UCBPlayer,130,275,405,25,40,UCBPlayer
27732,UCBPlayer,105,210,315,10,65,UCBPlayer
27733,UCBPlayer,130,275,405,25,40,UCBPlayer
27734,UCBPlayer,103,203,306,10,68,UCBPlayer
27735,UCBPlayer,128,283,411,25,38,UCBPlayer
27736,UCBPlayer,111,186,297,10,71,UCBPlayer
27737,UCBPlayer,124,299,423,25,34,UCBPlayer
27738,UCBPlayer,115,170,285,10,75,UCBPlayer
27739,UCBPlayer,120,315,435,25,30,UCBPlayer
27740,UCBPlayer,119,154,273,10,79,UCBPlayer
27741,UCBPlayer,112,332,444,25,27,UCBPlayer
27742,UCBPlayer,127,137,264,10,82,UCBPlayer
27743,UCBPlayer,104,349,453,25,24,UCBPlayer
27744,UCBPlayer,126,126,252,7,85,Tie
27745,UCBPlayer,111,351,462,28,22,UCBPlayer
27746,UCBPlayer,116,126,242,3,87,UCBPlayer
27747,UCBPlayer,122,347,469,32,21,UCBPlayer
27748,UCBPlayer,107,132,239,0,87,UCBPlayer
27749,UCBPlayer,132,337,469,35,22,UCBPlayer
27750,UCBPlayer,103,148,251,0,83,UCBPlayer
27751,UCBPlayer,136,321,457,35,26,UCBPlayer
27752,UCBPlayer,99,164,263,0,79,UCBPlayer
27753,UCBPlayer,140,305,445,35,30,UCBPlayer
27754,UCBPlayer,95,180,275,0,75,UCBPlayer
27755,UCBPlayer,144,289,433,35,34,UCBPlayer
27756,UCBPlayer,91,196,287,0,71,UCBPlayer
27757,UCBPlayer,148,273,421,35,38,UCBPlayer
27758,UCBPlayer,87,212,299,0,67,UCBPlayer
27759,UCBPlayer,152,257,409,35,42,UCBPlayer
27760,UCBPlayer,84,224,308,0,64,UCBPlayer
27761,UCBPlayer,146,251,397,32,45,UCBPlayer
27762,UCBPlayer,89,234,323,3,60,UCBPlayer
27763,UCBPlayer,138,243,381,28,49,UCBPlayer
27764,UCBPlayer,97,242,339,7,56,UCBPlayer
27765,UCBPlayer,130,235,365,24,53,UCBPlayer
27766,UCBPlayer,105,250,355,11,52,UCBPlayer
27767,UCBPlayer,122,227,349,20,57,UCBPlayer
27768,UCBPlayer,109,259,368,15,49,UCBPlayer
27769,UCBPlayer,118,218,336,16,60,UCBPlayer
27770,UCBPlayer,117,267,384,19,45,UCBPlayer
27771,UCBPlayer,110,210,320,12,64,UCBPlayer
27772,UCBPlayer,126,271,397,23,42,UCBPlayer
27773,UCBPlayer,105,210,315,10,65,UCBPlayer
27774,UCBPlayer,130,275,405,25,40,UCBPlayer
27775,UCBPlayer,105,210,315,10,65,UCBPlayer
27776,UCBPlayer,130,275,405,25,40,UCBPlayer
27777,UCBPlayer,106,206,312,10,66,UCBPlayer
27778,UCBPlayer,130,275,405,25,40,UCBPlayer
27779,UCBPlayer,105,210,315,10,65,UCBPlayer
27780,UCBPlayer,131,271,402,25,41,UCBPlayer
27781,UCBPlayer,105,210,315,10,65,UCBPlayer
27782,UCBPlayer,130,275,405,25,40,UCBPlayer
27783,UCBPlayer,105,210,315,10,65,UCBPlayer
27784,UCBPlayer,130,275,405,25,40,UCBPlayer
27785,UCBPlayer,103,203,306,10,68,UCBPlayer
27786,UCBPlayer,128,283,411,25,38,UCBPlayer
27787,UCBPlayer,111,186,297,10,71,UCBPlayer
27788,UCBPlayer,124,299,423,25,34,UCBPlayer
27789,UCBPlayer,115,170,285,10,75,UCBPlayer
27790,UCBPlayer,120,315,435,25,30,UCBPlayer
27791,UCBPlayer,119,154,273,10,79,UCBPlayer
27792,UCBPlayer,112,332,444,25,27,UCBPlayer
27793,UCBPlayer,127,137,264,10,82,UCBPlayer
27794,UCBPlayer,104,349,453,25,24,UCBPlayer
27795,UCBPlayer,126,126,252,7,85,Tie
27796,UCBPlayer,111,351,462,28,22,UCBPlayer
27797,UCBPlayer,116,126,242,3,87,UCBPlayer
27798,UCBPlayer,122,347,469,32,21,UCBPlayer
27799,UCBPlayer,107,132,239,0,87,UCBPlayer
27800,UCBPlayer,132,337,469,35,22,UCBPlayer
27801,UCBPlayer,103,148,251,0,83,UCBPlayer
27802,UCBPlayer,136,321,457,35,26,UCBPlayer
27803,UCBPlayer,99,164,263,0,79,UCBPlayer
27804,UCBPlayer,140,305,445,35,30,UCBPlayer
27805,UCBPlayer,95,180,275,0,75,UCBPlayer
27806,UCBPlayer,144,289,433,35,34,UCBPlayer
27807,UCBPlayer,91,196,287,0,71,UCBPlayer
27808,UCBPlayer,148,273,421,35,38,UCBPlayer
27809,UCBPlayer,87,212,299,0,67,UCBPlayer
27810,UCBPlayer,152,257,409,35,42,UCBPlayer
27811,UCBPlayer,84,224,308,0,64,UCBPlayer
27812,UCBPlayer,146,251,397,32,45,UCBPlayer
27813,UCBPlayer,89,234,323,3,60,UCBPlayer
27814,UCBPlayer,138,243,381,28,49,UCBPlayer
27815,UCBPlayer,97,242,339,7,56,UCBPlayer
27816,UCBPlayer,130,235,365,24,53,UCBPlayer
27817,UCBPlayer,105,250,355,11,52,UCBPlayer
27818,UCBPlayer,122,227,349,20,57,UCBPlayer
27819,UCBPlayer,109,259,368,15,49,UCBPlayer
27820,UCBPlayer,118,218,336,16,60,UCBPlayer
27821,UCBPlayer,117,267,384,19,45,UCBPlayer
27822,UCBPlayer,110,210,320,12,64,UCBPlayer
27823,UCBPlayer,126,271,397,23,42,UCBPlayer
27824,UCBPlayer,105,210,315,10,65,UCBPlayer
27825,UCBPlayer,130,275,405,25,40,UCBPlayer
27826,UCBPlayer,105,210,315,10,65,UCBPlayer
27827,UCBPlayer,130,275,405,25,40,UCBPlayer
27828,UCBPlayer,106,206,312,10,66,UCBPlayer
27829,UCBPlayer,130,275,405,25,40,UCBPlayer
27830,UCBPlayer,105,210,315,10,65,UCBPlayer
27831,UCBPlayer,131,271,402,25,41,UCBPlayer
27832,UCBPlayer,105,210,315,10,65,UCBPlayer
27833,UCBPlayer,130,275,405,25,40,UCBPlayer
27834,UCBPlayer,105,210,315,10,65,UCBPlayer
27835,UCBPlayer,130,275,405,25,40,UCBPlayer
27836,UCBPlayer,103,203,306,10,68,UCBPlayer
27837,UCBPlayer,128,283,411,25,38,UCBPlayer
27838,UCBPlayer,111,186,297,10,71,UCBPlayer
27839,UCBPlayer,124,299,423,25,34,UCBPlayer
27840,UCBPlayer,115,170,285,10,75,UCBPlayer
27841,UCBPlayer,120,315,435,25,30,UCBPlayer
27842,UCBPlayer,119,154,273,10,79,UCBPlayer
27843,UCBPlayer,112,332,444,25,27,UCBPlayer
27844,UCBPlayer,127,137,264,10,82,UCBPlayer
27845,UCBPlayer,104,349,453,25,24,UCBPlayer
27846,UCBPlayer,126,126,252,7,85,Tie
27847,UCBPlayer,111,351,462,28,22,UCBPlayer
27848,UCBPlayer,116,126,242,3,87,UCBPlayer
27849,UCBPlayer,122,347,469,32,21,UCBPlayer
27850,UCBPlayer,107,132,239,0,87,UCBPlayer
27851,UCBPlayer,132,337,469,35,22,UCBPlayer
27852,UCBPlayer,103,148,251,0,83,UCBPlayer
27853,UCBPlayer,136,321,457,35,26,UCBPlayer
27854,UCBPlayer,99,164,263,0,79,UCBPlayer
27855,UCBPlayer,140,305,445,35,30,UCBPlayer
27856,UCBPlayer,95,180,275,0,75,UCBPlayer
27857,UCBPlayer,144,289,433,35,34,UCBPlayer
27858,UCBPlayer,91,196,287,0,71,UCBPlayer
27859,UCBPlayer,148,273,421,35,38,UCBPlayer
27860,UCBPlayer,87,212,299,0,67,UCBPlayer
27861,UCBPlayer,152,257,409,35,42,UCBPlayer
27862,UCBPlayer,84,224,308,0,64,UCBPlayer
27863,UCBPlayer,146,251,397,32,45,UCBPlayer
27864,UCBPlayer,89,234,323,3,60,UCBPlayer
27865,UCBPlayer,138,243,381,28,49,UCBPlayer
27866,UCBPlayer,97,242,339,7,56,UCBPlayer
27867,UCBPlayer,130,235,365,24,53,UCBPlayer
27868,UCBPlayer,105,250,355,11,52,UCBPlayer
27869,UCBPlayer,122,227,349,20,57,UCBPlayer
27870,UCBPlayer,109,259,368,15,49,UCBPlayer
27871,UCBPlayer,118,218,336,16,60,UCBPlayer
27872,UCBPlayer,117,267,384,19,45,UCBPlayer
27873,UCBPlayer,110,210,320,12,64,UCBPlayer
27874,UCBPlayer,126,271,397,23,42,UCBPlayer
27875,UCBPlayer,105,210,315,10,65,UCBPlayer
27876,UCBPlayer,130,275,405,25,40,UCBPlayer
27877,UCBPlayer,105,210,315,10,65,UCBPlayer
27878,UCBPlayer,130,275,405,25,40,UCBPlayer
27879,UCBPlayer,106,206,312,10,66,UCBPlayer
27880,UCBPlayer,130,275,405,25,40,UCBPlayer
27881,UCBPlayer,105,210,315,10,65,UCBPlayer
27882,UCBPlayer,131,271,402,25,41,UCBPlayer
27883,UCBPlayer,105,210,315,10,65,UCBPlayer
27884,UCBPlayer,130,275,405,25,40,UCBPlayer
27885,UCBPlayer,105,210,315,10,65,UCBPlayer
27886,UCBPlayer,130,275,405,25,40,UCBPlayer
27887,UCBPlayer,103,203,306,10,68,UCBPlayer
27888,UCBPlayer,128,283,411,25,38,UCBPlayer
27889,UCBPlayer,111,186,297,10,71,UCBPlayer
27890,UCBPlayer,124,299,423,25,34,UCBPlayer
27891,UCBPlayer,115,170,285,10,75,UCBPlayer
27892,UCBPlayer,120,315,435,25,30,UCBPlayer
27893,UCBPlayer,119,154,273,10,79,UCBPlayer
27894,UCBPlayer,112,332,444,25,27,UCBPlayer
27895,UCBPlayer,127,137,264,10,82,UCBPlayer
27896,UCBPlayer,104,349,453,25,24,UCBPlayer
27897,UCBPlayer,126,126,252,7,85,Tie
27898,UCBPlayer,111,351,462,28,22,UCBPlayer
27899,UCBPlayer,116,126,242,3,87,UCBPlayer
27900,UCBPlayer,122,347,469,32,21,UCBPlayer
27901,UCBPlayer,107,132,239,0,87,UCBPlayer
27902,UCBPlayer,132,337,469,35,22,UCBPlayer
27903,UCBPlayer,103,148,251,0,83,UCBPlayer
27904,UCBPlayer,136,321,457,35,26,UCBPlayer
27905,UCBPlayer,99,164,263,0,79,UCBPlayer
27906,UCBPlayer,140,305,445,35,30,UCBPlayer
27907,UCBPlayer,95,180,275,0,75,UCBPlayer
27908,UCBPlayer,144,289,433,35,34,UCBPlayer
27909,UCBPlayer,91,196,287,0,71,UCBPlayer
27910,UCBPlayer,148,273,421,35,38,UCBPlayer
27911,UCBPlayer,87,212,299,0,67,UCBPlayer
27912,UCBPlayer,152,257,409,35,42,UCBPlayer
27913,UCBPlayer,84,224,308,0,64,UCBPlayer
27914,UCBPlayer,146,251,397,32,45,UCBPlayer
27915,UCBPlayer,89,234,323,3,60,UCBPlayer
27916,UCBPlayer,138,243,381,28,49,UCBPlayer
27917,UCBPlayer,97,242,339,7,56,UCBPlayer
27918,UCBPlayer,130,235,365,24,53,UCBPlayer
27919,UCBPlayer,105,250,355,11,52,UCBPlayer
27920,UCBPlayer,122,227,349,20,57,UCBPlayer
27921,UCBPlayer,109,259,368,15,49,UCBPlayer
27922,UCBPlayer,118,218,336,16,60,UCBPlayer
27923,UCBPlayer,117,267,384,19,45,UCBPlayer
27924,UCBPlayer,110,210,320,12,64,UCBPlayer
27925,UCBPlayer,126,271,397,23,42,UCBPlayer
27926,UCBPlayer,105,210,315,10,65,UCBPlayer
27927,UCBPlayer,130,275,405,25,40,UCBPlayer
27928,UCBPlayer,105,210,315,10,65,UCBPlayer
27929,UCBPlayer,130,275,405,25,40,UCBPlayer
27930,UCBPlayer,106,206,312,10,66,UCBPlayer
27931,UCBPlayer,130,275,405,25,40,UCBPlayer
27932,UCBPlayer,105,210,315,10,65,UCBPlayer
27933,UCBPlayer,131,271,402,25,41,UCBPlayer
27934,UCBPlayer,105,210,315,10,65,UCBPlayer
27935,UCBPlayer,130,275,405,25,40,UCBPlayer
27936,UCBPlayer,105,210,315,10,65,UCBPlayer
27937,UCBPlayer,130,275,405,25,40,UCBPlayer
27938,UCBPlayer,103,203,306,10,68,UCBPlayer
27939,UCBPlayer,128,283,411,25,38,UCBPlayer
27940,UCBPlayer,111,186,297,10,71,UCBPlayer
27941,UCBPlayer,124,299,423,25,34,UCBPlayer
27942,UCBPlayer,115,170,285,10,75,UCBPlayer
27943,UCBPlayer,120,315,435,25,30,UCBPlayer
27944,UCBPlayer,119,154,273,10,79,UCBPlayer
27945,UCBPlayer,112,332,444,25,27,UCBPlayer
27946,UCBPlayer,127,137,264,10,82,UCBPlayer
27947,UCBPlayer,104,349,453,25,24,UCBPlayer
27948,UCBPlayer,126,126,252,7,85,Tie
27949,UCBPlayer,111,351,462,28,22,UCBPlayer
27950,UCBPlayer,116,126,242,3,87,UCBPlayer
27951,UCBPlayer,122,347,469,32,21,UCBPlayer
27952,UCBPlayer,107,132,239,0,87,UCBPlayer
27953,UCBPlayer,132,337,469,35,22,UCBPlayer
27954,UCBPlayer,103,148,251,0,83,UCBPlayer
27955,UCBPlayer,136,321,457,35,26,UCBPlayer
27956,UCBPlayer,99,164,263,0,79,UCBPlayer
27957,UCBPlayer,140,305,445,35,30,UCBPlayer
27958,UCBPlayer,95,180,275,0,75,UCBPlayer
27959,UCBPlayer,144,289,433,35,34,UCBPlayer
27960,UCBPlayer,91,196,287,0,71,UCBPlayer
27961,UCBPlayer,148,273,421,35,38,UCBPlayer
27962,UCBPlayer,87,212,299,0,67,UCBPlayer
27963,UCBPlayer,152,257,409,35,42,UCBPlayer
27964,UCBPlayer,84,224,308,0,64,UCBPlayer
27965,UCBPlayer,146,251,397,32,45,UCBPlayer
27966,UCBPlayer,89,234,323,3,60,UCBPlayer
27967,UCBPlayer,138,243,381,28,49,UCBPlayer
27968,UCBPlayer,97,242,339,7,56,UCBPlayer
27969,UCBPlayer,130,235,365,24,53,UCBPlayer
27970,UCBPlayer,105,250,355,11,52,UCBPlayer
27971,UCBPlayer,122,227,349,20,57,UCBPlayer
27972,UCBPlayer,109,259,368,15,49,UCBPlayer
27973,UCBPlayer,118,218,336,16,60,UCBPlayer
27974,UCBPlayer,117,267,384,19,45,UCBPlayer
27975,UCBPlayer,110,210,320,12,64,UCBPlayer
27976,UCBPlayer,126,271,397,23,42,UCBPlayer
27977,UCBPlayer,105,210,315,10,65,UCBPlayer
27978,UCBPlayer,130,275,405,25,40,UCBPlayer
27979,UCBPlayer,105,210,315,10,65,UCBPlayer
27980,UCBPlayer,130,275,405,25,40,UCBPlayer
27981,UCBPlayer,106,206,312,10,66,UCBPlayer
27982,UCBPlayer,130,275,405,25,40,UCBPlayer
27983,UCBPlayer,105,210,315,10,65,UCBPlayer
27984,UCBPlayer,131,271,402,25,41,UCBPlayer
27985,UCBPlayer,105,210,315,10,65,UCBPlayer
27986,UCBPlayer,130,275,405,25,40,UCBPlayer
27987,UCBPlayer,105,210,315,10,65,UCBPlayer
27988,UCBPlayer,130,275,405,25,40,UCBPlayer
27989,UCBPlayer,103,203,306,10,68,UCBPlayer
27990,UCBPlayer,128,283,411,25,38,UCBPlayer
27991,UCBPlayer,111,186,297,10,71,UCBPlayer
27992,UCBPlayer,124,299,423,25,34,UCBPlayer
27993,UCBPlayer,115,170,285,10,75,UCBPlayer
27994,UCBPlayer,120,315,435,25,30,UCBPlayer
27995,UCBPlayer,119,154,273,10,79,UCBPlayer
27996,UCBPlayer,112,332,444,25,27,UCBPlayer
27997,UCBPlayer,127,137,264,10,82,UCBPlayer
27998,UCBPlayer,104,349,453,25,24,UCBPlayer
27999,UCBPlayer,126,126,252,7,85,Tie
28000,UCBPlayer,111,351,462,28,22,UCBPlayer
28001,UCBPlayer,116,126,242,3,87,UCBPlayer
28002,UCBPlayer,122,347,469,32,21,UCBPlayer
28003,UCBPlayer,107,132,239,0,87,UCBPlayer
28004,UCBPlayer,132,337,469,35,22,UCBPlayer
28005,UCBPlayer,103,148,251,0,83,UCBPlayer
28006,UCBPlayer,136,321,457,35,26,UCBPlayer
28007,UCBPlayer,99,164,263,0,79,UCBPlayer
28008,UCBPlayer,140,305,445,35,30,UCBPlayer
28009,UCBPlayer,95,180,275,0,75,UCBPlayer
28010,UCBPlayer,144,289,433,35,34,UCBPlayer
28011,UCBPlayer,91,196,287,0,71,UCBPlayer
28012,UCBPlayer,148,273,421,35,38,UCBPlayer
28013,UCBPlayer,87,212,299,0,67,UCBPlayer
28014,UCBPlayer,152,257,409,35,42,UCBPlayer
28015,UCBPlayer,84,224,308,0,64,UCBPlayer
28016,UCBPlayer,146,251,397,32,45,UCBPlayer
28017,UCBPlayer,89,234,323,3,60,UCBPlayer
28018,UCBPlayer,138,243,381,28,49,UCBPlayer
28019,UCBPlayer,97,242,339,7,56,UCBPlayer
28020,UCBPlayer,130,235,365,24,53,UCBPlayer
28021,UCBPlayer,105,250,355,11,52,UCBPlayer
28022,UCBPlayer,122,227,349,20,57,UCBPlayer
28023,UCBPlayer,109,259,368,15,49,UCBPlayer
28024,UCBPlayer,118,218,336,16,60,UCBPlayer
28025,UCBPlayer,117,267,384,19,45,UCBPlayer
28026,UCBPlayer,110,210,320,12,64,UCBPlayer
28027,UCBPlayer,126,271,397,23,42,UCBPlayer
28028,UCBPlayer,105,210,315,10,65,UCBPlayer
28029,UCBPlayer,130,275,405,25,40,UCBPlayer
28030,UCBPlayer,105,210,315,10,65,UCBPlayer
28031,UCBPlayer,130,275,405,25,40,UCBPlayer
28032,UCBPlayer,106,206,312,10,66,UCBPlayer
28033,UCBPlayer,130,275,405,25,40,UCBPlayer
28034,UCBPlayer,105,210,315,10,65,UCBPlayer
28035,UCBPlayer,131,271,402,25,41,UCBPlayer
28036,UCBPlayer,105,210,315,10,65,UCBPlayer
28037,UCBPlayer,130,275,405,25,40,UCBPlayer
28038,UCBPlayer,105,210,315,10,65,UCBPlayer
28039,UCBPlayer,130,275,405,25,40,UCBPlayer
28040,UCBPlayer,103,203,306,10,68,UCBPlayer
28041,UCBPlayer,128,283,411,25,38,UCBPlayer
28042,UCBPlayer,111,186,297,10,71,UCBPlayer
28043,UCBPlayer,124,299,423,25,34,UCBPlayer
28044,UCBPlayer,115,170,285,10,75,UCBPlayer
28045,UCBPlayer,120,315,435,25,30,UCBPlayer
28046,UCBPlayer,119,154,273,10,79,UCBPlayer
28047,UCBPlayer,112,332,444,25,27,UCBPlayer
28048,UCBPlayer,127,137,264,10,82,UCBPlayer
28049,UCBPlayer,104,349,453,25,24,UCBPlayer
28050,UCBPlayer,126,126,252,7,85,Tie
28051,UCBPlayer,111,351,462,28,22,UCBPlayer
28052,UCBPlayer,116,126,242,3,87,UCBPlayer
28053,UCBPlayer,122,347,469,32,21,UCBPlayer
28054,UCBPlayer,107,132,239,0,87,UCBPlayer
28055,UCBPlayer,132,337,469,35,22,UCBPlayer
28056,UCBPlayer,103,148,251,0,83,UCBPlayer
28057,UCBPlayer,136,321,457,35,26,UCBPlayer
28058,UCBPlayer,99,164,263,0,79,UCBPlayer
28059,UCBPlayer,140,305,445,35,30,UCBPlayer
28060,UCBPlayer,95,180,275,0,75,UCBPlayer
28061,UCBPlayer,144,289,433,35,34,UCBPlayer
28062,UCBPlayer,91,196,287,0,71,UCBPlayer
28063,UCBPlayer,148,273,421,35,38,UCBPlayer
28064,UCBPlayer,87,212,299,0,67,UCBPlayer
28065,UCBPlayer,152,257,409,35,42,UCBPlayer
28066,UCBPlayer,84,224,308,0,64,UCBPlayer
28067,UCBPlayer,146,251,397,32,45,UCBPlayer
28068,UCBPlayer,89,234,323,3,60,UCBPlayer
28069,UCBPlayer,138,243,381,28,49,UCBPlayer
28070,UCBPlayer,97,242,339,7,56,UCBPlayer
28071,UCBPlayer,130,235,365,24,53,UCBPlayer
28072,UCBPlayer,105,250,355,11,52,UCBPlayer
28073,UCBPlayer,122,227,349,20,57,UCBPlayer
28074,UCBPlayer,109,259,368,15,49,UCBPlayer
28075,UCBPlayer,118,218,336,16,60,UCBPlayer
28076,UCBPlayer,117,267,384,19,45,UCBPlayer
28077,UCBPlayer,110,210,320,12,64,UCBPlayer
28078,UCBPlayer,126,271,397,23,42,UCBPlayer
28079,UCBPlayer,105,210,315,10,65,UCBPlayer
28080,UCBPlayer,130,275,405,25,40,UCBPlayer
28081,UCBPlayer,105,210,315,10,65,UCBPlayer
28082,UCBPlayer,130,275,405,25,40,UCBPlayer
28083,UCBPlayer,106,206,312,10,66,UCBPlayer
28084,UCBPlayer,130,275,405,25,40,UCBPlayer
28085,UCBPlayer,105,210,315,10,65,UCBPlayer
28086,UCBPlayer,131,271,402,25,41,UCBPlayer
28087,UCBPlayer,105,210,315,10,65,UCBPlayer
28088,UCBPlayer,130,275,405,25,40,UCBPlayer
28089,UCBPlayer,105,210,315,10,65,UCBPlayer
28090,UCBPlayer,130,275,405,25,40,UCBPlayer
28091,UCBPlayer,103,203,306,10,68,UCBPlayer
28092,UCBPlayer,128,283,411,25,38,UCBPlayer
28093,UCBPlayer,111,186,297,10,71,UCBPlayer
28094,UCBPlayer,124,299,423,25,34,UCBPlayer
28095,UCBPlayer,115,170,285,10,75,UCBPlayer
28096,UCBPlayer,120,315,435,25,30,UCBPlayer
28097,UCBPlayer,119,154,273,10,79,UCBPlayer
28098,UCBPlayer,112,332,444,25,27,UCBPlayer
28099,UCBPlayer,127,137,264,10,82,UCBPlayer
28100,UCBPlayer,104,349,453,25,24,UCBPlayer
28101,UCBPlayer,126,126,252,7,85,Tie
28102,UCBPlayer,111,351,462,28,22,UCBPlayer
28103,UCBPlayer,116,126,242,3,87,UCBPlayer
28104,UCBPlayer,122,347,469,32,21,UCBPlayer
28105,UCBPlayer,107,132,239,0,87,UCBPlayer
28106,UCBPlayer,132,337,469,35,22,UCBPlayer
28107,UCBPlayer,103,148,251,0,83,UCBPlayer
28108,UCBPlayer,136,321,457,35,26,UCBPlayer
28109,UCBPlayer,99,164,263,0,79,UCBPlayer
28110,UCBPlayer,140,305,445,35,30,UCBPlayer
28111,UCBPlayer,95,180,275,0,75,UCBPlayer
28112,UCBPlayer,144,289,433,35,34,UCBPlayer
28113,UCBPlayer,91,196,287,0,71,UCBPlayer
28114,UCBPlayer,148,273,421,35,38,UCBPlayer
28115,UCBPlayer,87,212,299,0,67,UCBPlayer
28116,UCBPlayer,152,257,409,35,42,UCBPlayer
28117,UCBPlayer,84,224,308,0,64,UCBPlayer
28118,UCBPlayer,146,251,397,32,45,UCBPlayer
28119,UCBPlayer,89,234,323,3,60,UCBPlayer
28120,UCBPlayer,138,243,381,28,49,UCBPlayer
28121,UCBPlayer,97,242,339,7,56,UCBPlayer
28122,UCBPlayer,130,235,365,24,53,UCBPlayer
28123,UCBPlayer,105,250,355,11,52,UCBPlayer
28124,UCBPlayer,122,227,349,20,57,UCBPlayer
28125,UCBPlayer,109,259,368,15,49,UCBPlayer
28126,UCBPlayer,118,218,336,16,60,UCBPlayer
28127,UCBPlayer,117,267,384,19,45,UCBPlayer
28128,UCBPlayer,110,210,320,12,64,UCBPlayer
28129,UCBPlayer,126,271,397,23,42,UCBPlayer
28130,UCBPlayer,105,210,315,10,65,UCBPlayer
28131,UCBPlayer,130,275,405,25,40,UCBPlayer
28132,UCBPlayer,105,210,315,10,65,UCBPlayer
28133,UCBPlayer,130,275,405,25,40,UCBPlayer
28134,UCBPlayer,106,206,312,10,66,UCBPlayer
28135,UCBPlayer,130,275,405,25,40,UCBPlayer
28136,UCBPlayer,105,210,315,10,65,UCBPlayer
28137,UCBPlayer,131,271,402,25,41,UCBPlayer
28138,UCBPlayer,105,210,315,10,65,UCBPlayer
28139,UCBPlayer,130,275,405,25,40,UCBPlayer
28140,UCBPlayer,105,210,315,10,65,UCBPlayer
28141,UCBPlayer,130,275,405,25,40,UCBPlayer
28142,UCBPlayer,103,203,306,10,68,UCBPlayer
28143,UCBPlayer,128,283,411,25,38,UCBPlayer
28144,UCBPlayer,111,186,297,10,71,UCBPlayer
28145,UCBPlayer,124,299,423,25,34,UCBPlayer
28146,UCBPlayer,115,170,285,10,75,UCBPlayer
28147,UCBPlayer,120,315,435,25,30,UCBPlayer
28148,UCBPlayer,119,154,273,10,79,UCBPlayer
28149,UCBPlayer,112,332,444,25,27,UCBPlayer
28150,UCBPlayer,127,137,264,10,82,UCBPlayer
28151,UCBPlayer,104,349,453,25,24,UCBPlayer
28152,UCBPlayer,126,126,252,7,85,Tie
28153,UCBPlayer,111,351,462,28,22,UCBPlayer
28154,UCBPlayer,116,126,242,3,87,UCBPlayer
28155,UCBPlayer,122,347,469,32,21,UCBPlayer
28156,UCBPlayer,107,132,239,0,87,UCBPlayer
28157,UCBPlayer,132,337,469,35,22,UCBPlayer
28158,UCBPlayer,103,148,251,0,83,UCBPlayer
28159,UCBPlayer,136,321,457,35,26,UCBPlayer
28160,UCBPlayer,99,164,263,0,79,UCBPlayer
28161,UCBPlayer,140,305,445,35,30,UCBPlayer
28162,UCBPlayer,95,180,275,0,75,UCBPlayer
28163,UCBPlayer,144,289,433,35,34,UCBPlayer
28164,UCBPlayer,91,196,287,0,71,UCBPlayer
28165,UCBPlayer,148,273,421,35,38,UCBPlayer
28166,UCBPlayer,87,212,299,0,67,UCBPlayer
28167,UCBPlayer,152,257,409,35,42,UCBPlayer
28168,UCBPlayer,84,224,308,0,64,UCBPlayer
28169,UCBPlayer,146,251,397,32,45,UCBPlayer
28170,UCBPlayer,89,234,323,3,60,UCBPlayer
28171,UCBPlayer,138,243,381,28,49,UCBPlayer
28172,UCBPlayer,97,242,339,7,56,UCBPlayer
28173,UCBPlayer,130,235,365,24,53,UCBPlayer
28174,UCBPlayer,105,250,355,11,52,UCBPlayer
28175,UCBPlayer,122,227,349,20,57,UCBPlayer
28176,UCBPlayer,109,259,368,15,49,UCBPlayer
28177,UCBPlayer,118,218,336,16,60,UCBPlayer
28178,UCBPlayer,117,267,384,19,45,UCBPlayer
28179,UCBPlayer,110,210,320,12,64,UCBPlayer
28180,UCBPlayer,126,271,397,23,42,UCBPlayer
28181,UCBPlayer,105,210,315,10,65,UCBPlayer
28182,UCBPlayer,130,275,405,25,40,UCBPlayer
28183,UCBPlayer,105,210,315,10,65,UCBPlayer
28184,UCBPlayer,130,275,405,25,40,UCBPlayer
28185,UCBPlayer,106,206,312,10,66,UCBPlayer
28186,UCBPlayer,130,275,405,25,40,UCBPlayer
28187,UCBPlayer,105,210,315,10,65,UCBPlayer
28188,UCBPlayer,131,271,402,25,41,UCBPlayer
28189,UCBPlayer,105,210,315,10,65,UCBPlayer
28190,UCBPlayer,130,275,405,25,40,UCBPlayer
28191,UCBPlayer,105,210,315,10,65,UCBPlayer
28192,UCBPlayer,130,275,405,25,40,UCBPlayer
28193,UCBPlayer,103,203,306,10,68,UCBPlayer
28194,UCBPlayer,128,283,411,25,38,UCBPlayer
28195,UCBPlayer,111,186,297,10,71,UCBPlayer
28196,UCBPlayer,124,299,423,25,34,UCBPlayer
28197,UCBPlayer,115,170,285,10,75,UCBPlayer
28198,UCBPlayer,120,315,435,25,30,UCBPlayer
28199,UCBPlayer,119,154,273,10,79,UCBPlayer
28200,UCBPlayer,112,332,444,25,27,UCBPlayer
28201,UCBPlayer,127,137,264,10,82,UCBPlayer
28202,UCBPlayer,104,349,453,25,24,UCBPlayer
28203,UCBPlayer,126,126,252,7,85,Tie
28204,UCBPlayer,111,351,462,28,22,UCBPlayer
28205,UCBPlayer,116,126,242,3,87,UCBPlayer
28206,UCBPlayer,122,347,469,32,21,UCBPlayer
28207,UCBPlayer,107,132,239,0,87,UCBPlayer
28208,UCBPlayer,132,337,469,35,22,UCBPlayer
28209,UCBPlayer,103,148,251,0,83,UCBPlayer
28210,UCBPlayer,136,321,457,35,26,UCBPlayer
28211,UCBPlayer,99,164,263,0,79,UCBPlayer
28212,UCBPlayer,140,305,445,35,30,UCBPlayer
28213,UCBPlayer,95,180,275,0,75,UCBPlayer
28214,UCBPlayer,144,289,433,35,34,UCBPlayer
28215,UCBPlayer,91,196,287,0,71,UCBPlayer
28216,UCBPlayer,148,273,421,35,38,UCBPlayer
28217,UCBPlayer,87,212,299,0,67,UCBPlayer
28218,UCBPlayer,152,257,409,35,42,UCBPlayer
28219,UCBPlayer,84,224,308,0,64,UCBPlayer
28220,UCBPlayer,146,251,397,32,45,UCBPlayer
28221,UCBPlayer,89,234,323,3,60,UCBPlayer
28222,UCBPlayer,138,243,381,28,49,UCBPlayer
28223,UCBPlayer,97,242,339,7,56,UCBPlayer
28224,UCBPlayer,130,235,365,24,53,UCBPlayer
28225,UCBPlayer,105,250,355,11,52,UCBPlayer
28226,UCBPlayer,122,227,349,20,57,UCBPlayer
28227,UCBPlayer,109,259,368,15,49,UCBPlayer
28228,UCBPlayer,118,218,336,16,60,UCBPlayer
28229,UCBPlayer,117,267,384,19,45,UCBPlayer
28230,UCBPlayer,110,210,320,12,64,UCBPlayer
28231,UCBPlayer,126,271,397,23,42,UCBPlayer
28232,UCBPlayer,105,210,315,10,65,UCBPlayer
28233,UCBPlayer,130,275,405,25,40,UCBPlayer
28234,UCBPlayer,105,210,315,10,65,UCBPlayer
28235,UCBPlayer,130,275,405,25,40,UCBPlayer
28236,UCBPlayer,106,206,312,10,66,UCBPlayer
28237,UCBPlayer,130,275,405,25,40,UCBPlayer
28238,UCBPlayer,105,210,315,10,65,UCBPlayer
28239,UCBPlayer,131,271,402,25,41,UCBPlayer
28240,UCBPlayer,105,210,315,10,65,UCBPlayer
28241,UCBPlayer,130,275,405,25,40,UCBPlayer
28242,UCBPlayer,105,210,315,10,65,UCBPlayer
28243,UCBPlayer,130,275,405,25,40,UCBPlayer
28244,UCBPlayer,103,203,306,10,68,UCBPlayer
28245,UCBPlayer,128,283,411,25,38,UCBPlayer
28246,UCBPlayer,111,186,297,10,71,UCBPlayer
28247,UCBPlayer,124,299,423,25,34,UCBPlayer
28248,UCBPlayer,115,170,285,10,75,UCBPlayer
28249,UCBPlayer,120,315,435,25,30,UCBPlayer
28250,UCBPlayer,119,154,273,10,79,UCBPlayer
28251,UCBPlayer,112,332,444,25,27,UCBPlayer
28252,UCBPlayer,127,137,264,10,82,UCBPlayer
28253,UCBPlayer,104,349,453,25,24,UCBPlayer
28254,UCBPlayer,126,126,252,7,85,Tie
28255,UCBPlayer,111,351,462,28,22,UCBPlayer
28256,UCBPlayer,116,126,242,3,87,UCBPlayer
28257,UCBPlayer,122,347,469,32,21,UCBPlayer
28258,UCBPlayer,107,132,239,0,87,UCBPlayer
28259,UCBPlayer,132,337,469,35,22,UCBPlayer
28260,UCBPlayer,103,148,251,0,83,UCBPlayer
28261,UCBPlayer,136,321,457,35,26,UCBPlayer
28262,UCBPlayer,99,164,263,0,79,UCBPlayer
28263,UCBPlayer,140,305,445,35,30,UCBPlayer
28264,UCBPlayer,95,180,275,0,75,UCBPlayer
28265,UCBPlayer,144,289,433,35,34,UCBPlayer
28266,UCBPlayer,91,196,287,0,71,UCBPlayer
28267,UCBPlayer,148,273,421,35,38,UCBPlayer
28268,UCBPlayer,87,212,299,0,67,UCBPlayer
28269,UCBPlayer,152,257,409,35,42,UCBPlayer
28270,UCBPlayer,84,224,308,0,64,UCBPlayer
28271,UCBPlayer,146,251,397,32,45,UCBPlayer
28272,UCBPlayer,89,234,323,3,60,UCBPlayer
28273,UCBPlayer,138,243,381,28,49,UCBPlayer
28274,UCBPlayer,97,242,339,7,56,UCBPlayer
28275,UCBPlayer,130,235,365,24,53,UCBPlayer
28276,UCBPlayer,105,250,355,11,52,UCBPlayer
28277,UCBPlayer,122,227,349,20,57,UCBPlayer
28278,UCBPlayer,109,259,368,15,49,UCBPlayer
28279,UCBPlayer,118,218,336,16,60,UCBPlayer
28280,UCBPlayer,117,267,384,19,45,UCBPlayer
28281,UCBPlayer,110,210,320,12,64,UCBPlayer
28282,UCBPlayer,126,271,397,23,42,UCBPlayer
28283,UCBPlayer,105,210,315,10,65,UCBPlayer
28284,UCBPlayer,130,275,405,25,40,UCBPlayer
28285,UCBPlayer,105,210,315,10,65,UCBPlayer
28286,UCBPlayer,130,275,405,25,40,UCBPlayer
28287,UCBPlayer,106,206,312,10,66,UCBPlayer
28288,UCBPlayer,130,275,405,25,40,UCBPlayer
28289,UCBPlayer,105,210,315,10,65,UCBPlayer
28290,UCBPlayer,131,271,402,25,41,UCBPlayer
28291,UCBPlayer,105,210,315,10,65,UCBPlayer
28292,UCBPlayer,130,275,405,25,40,UCBPlayer
28293,UCBPlayer,105,210,315,10,65,UCBPlayer
28294,UCBPlayer,130,275,405,25,40,UCBPlayer
28295,UCBPlayer,103,203,306,10,68,UCBPlayer
28296,UCBPlayer,128,283,411,25,38,UCBPlayer
28297,UCBPlayer,111,186,297,10,71,UCBPlayer
28298,UCBPlayer,124,299,423,25,34,UCBPlayer
28299,UCBPlayer,115,170,285,10,75,UCBPlayer
28300,UCBPlayer,120,315,435,25,30,UCBPlayer
28301,UCBPlayer,119,154,273,10,79,UCBPlayer
28302,UCBPlayer,112,332,444,25,27,UCBPlayer
28303,UCBPlayer,127,137,264,10,82,UCBPlayer
28304,UCBPlayer,104,349,453,25,24,UCBPlayer
28305,UCBPlayer,126,126,252,7,85,Tie
28306,UCBPlayer,111,351,462,28,22,UCBPlayer
28307,UCBPlayer,116,126,242,3,87,UCBPlayer
28308,UCBPlayer,122,347,469,32,21,UCBPlayer
28309,UCBPlayer,107,132,239,0,87,UCBPlayer
28310,UCBPlayer,132,337,469,35,22,UCBPlayer
28311,UCBPlayer,103,148,251,0,83,UCBPlayer
28312,UCBPlayer,136,321,457,35,26,UCBPlayer
28313,UCBPlayer,99,164,263,0,79,UCBPlayer
28314,UCBPlayer,140,305,445,35,30,UCBPlayer
28315,UCBPlayer,95,180,275,0,75,UCBPlayer
28316,UCBPlayer,144,289,433,35,34,UCBPlayer
28317,UCBPlayer,91,196,287,0,71,UCBPlayer
28318,UCBPlayer,148,273,421,35,38,UCBPlayer
28319,UCBPlayer,87,212,299,0,67,UCBPlayer
28320,UCBPlayer,152,257,409,35,42,UCBPlayer
28321,UCBPlayer,84,224,308,0,64,UCBPlayer
28322,UCBPlayer,146,251,397,32,45,UCBPlayer
28323,UCBPlayer,89,234,323,3,60,UCBPlayer
28324,UCBPlayer,138,243,381,28,49,UCBPlayer
28325,UCBPlayer,97,242,339,7,56,UCBPlayer
28326,UCBPlayer,130,235,365,24,53,UCBPlayer
28327,UCBPlayer,105,250,355,11,52,UCBPlayer
28328,UCBPlayer,122,227,349,20,57,UCBPlayer
28329,UCBPlayer,109,259,368,15,49,UCBPlayer
28330,UCBPlayer,118,218,336,16,60,UCBPlayer
28331,UCBPlayer,117,267,384,19,45,UCBPlayer
28332,UCBPlayer,110,210,320,12,64,UCBPlayer
28333,UCBPlayer,126,271,397,23,42,UCBPlayer
28334,UCBPlayer,105,210,315,10,65,UCBPlayer
28335,UCBPlayer,130,275,405,25,40,UCBPlayer
28336,UCBPlayer,105,210,315,10,65,UCBPlayer
28337,UCBPlayer,130,275,405,25,40,UCBPlayer
28338,UCBPlayer,106,206,312,10,66,UCBPlayer
28339,UCBPlayer,130,275,405,25,40,UCBPlayer
28340,UCBPlayer,105,210,315,10,65,UCBPlayer
28341,UCBPlayer,131,271,402,25,41,UCBPlayer
28342,UCBPlayer,105,210,315,10,65,UCBPlayer
28343,UCBPlayer,130,275,405,25,40,UCBPlayer
28344,UCBPlayer,105,210,315,10,65,UCBPlayer
28345,UCBPlayer,130,275,405,25,40,UCBPlayer
28346,UCBPlayer,103,203,306,10,68,UCBPlayer
28347,UCBPlayer,128,283,411,25,38,UCBPlayer
28348,UCBPlayer,111,186,297,10,71,UCBPlayer
28349,UCBPlayer,124,299,423,25,34,UCBPlayer
28350,UCBPlayer,115,170,285,10,75,UCBPlayer
28351,UCBPlayer,120,315,435,25,30,UCBPlayer
28352,UCBPlayer,119,154,273,10,79,UCBPlayer
28353,UCBPlayer,112,332,444,25,27,UCBPlayer
28354,UCBPlayer,127,137,264,10,82,UCBPlayer
28355,UCBPlayer,104,349,453,25,24,UCBPlayer
28356,UCBPlayer,126,126,252,7,85,Tie
28357,UCBPlayer,111,351,462,28,22,UCBPlayer
28358,UCBPlayer,116,126,242,3,87,UCBPlayer
28359,UCBPlayer,122,347,469,32,21,UCBPlayer
28360,UCBPlayer,107,132,239,0,87,UCBPlayer
28361,UCBPlayer,132,337,469,35,22,UCBPlayer
28362,UCBPlayer,103,148,251,0,83,UCBPlayer
28363,UCBPlayer,136,321,457,35,26,UCBPlayer
28364,UCBPlayer,99,164,263,0,79,UCBPlayer
28365,UCBPlayer,140,305,445,35,30,UCBPlayer
28366,UCBPlayer,95,180,275,0,75,UCBPlayer
28367,UCBPlayer,144,289,433,35,34,UCBPlayer
28368,UCBPlayer,91,196,287,0,71,UCBPlayer
28369,UCBPlayer,148,273,421,35,38,UCBPlayer
28370,UCBPlayer,87,212,299,0,67,UCBPlayer
28371,UCBPlayer,152,257,409,35,42,UCBPlayer
28372,UCBPlayer,84,224,308,0,64,UCBPlayer
28373,UCBPlayer,146,251,397,32,45,UCBPlayer
28374,UCBPlayer,89,234,323,3,60,UCBPlayer
28375,UCBPlayer,138,243,381,28,49,UCBPlayer
28376,UCBPlayer,97,242,339,7,56,UCBPlayer
28377,UCBPlayer,130,235,365,24,53,UCBPlayer
28378,UCBPlayer,105,250,355,11,52,UCBPlayer
28379,UCBPlayer,122,227,349,20,57,UCBPlayer
28380,UCBPlayer,109,259,368,15,49,UCBPlayer
28381,UCBPlayer,118,218,336,16,60,UCBPlayer
28382,UCBPlayer,117,267,384,19,45,UCBPlayer
28383,UCBPlayer,110,210,320,12,64,UCBPlayer
28384,UCBPlayer,126,271,397,23,42,UCBPlayer
28385,UCBPlayer,105,210,315,10,65,UCBPlayer
28386,UCBPlayer,130,275,405,25,40,UCBPlayer
28387,UCBPlayer,105,210,315,10,65,UCBPlayer
28388,UCBPlayer,130,275,405,25,40,UCBPlayer
28389,UCBPlayer,106,206,312,10,66,UCBPlayer
28390,UCBPlayer,130,275,405,25,40,UCBPlayer
28391,UCBPlayer,105,210,315,10,65,UCBPlayer
28392,UCBPlayer,131,271,402,25,41,UCBPlayer
28393,UCBPlayer,105,210,315,10,65,UCBPlayer
28394,UCBPlayer,130,275,405,25,40,UCBPlayer
28395,UCBPlayer,105,210,315,10,65,UCBPlayer
28396,UCBPlayer,130,275,405,25,40,UCBPlayer
28397,UCBPlayer,103,203,306,10,68,UCBPlayer
28398,UCBPlayer,128,283,411,25,38,UCBPlayer
28399,UCBPlayer,111,186,297,10,71,UCBPlayer
28400,UCBPlayer,124,299,423,25,34,UCBPlayer
28401,UCBPlayer,115,170,285,10,75,UCBPlayer
28402,UCBPlayer,120,315,435,25,30,UCBPlayer
28403,UCBPlayer,119,154,273,10,79,UCBPlayer
28404,UCBPlayer,112,332,444,25,27,UCBPlayer
28405,UCBPlayer,127,137,264,10,82,UCBPlayer
28406,UCBPlayer,104,349,453,25,24,UCBPlayer
28407,UCBPlayer,126,126,252,7,85,Tie
28408,UCBPlayer,111,351,462,28,22,UCBPlayer
28409,UCBPlayer,116,126,242,3,87,UCBPlayer
28410,UCBPlayer,122,347,469,32,21,UCBPlayer
28411,UCBPlayer,107,132,239,0,87,UCBPlayer
28412,UCBPlayer,132,337,469,35,22,UCBPlayer
28413,UCBPlayer,103,148,251,0,83,UCBPlayer
28414,UCBPlayer,136,321,457,35,26,UCBPlayer
28415,UCBPlayer,99,164,263,0,79,UCBPlayer
28416,UCBPlayer,140,305,445,35,30,UCBPlayer
28417,UCBPlayer,95,180,275,0,75,UCBPlayer
28418,UCBPlayer,144,289,433,35,34,UCBPlayer
28419,UCBPlayer,91,196,287,0,71,UCBPlayer
28420,UCBPlayer,148,273,421,35,38,UCBPlayer
28421,UCBPlayer,87,212,299,0,67,UCBPlayer
28422,UCBPlayer,152,257,409,35,42,UCBPlayer
28423,UCBPlayer,84,224,308,0,64,UCBPlayer
28424,UCBPlayer,146,251,397,32,45,UCBPlayer
28425,UCBPlayer,89,234,323,3,60,UCBPlayer
28426,UCBPlayer,138,243,381,28,49,UCBPlayer
28427,UCBPlayer,97,242,339,7,56,UCBPlayer
28428,UCBPlayer,130,235,365,24,53,UCBPlayer
28429,UCBPlayer,105,250,355,11,52,UCBPlayer
28430,UCBPlayer,122,227,349,20,57,UCBPlayer
28431,UCBPlayer,109,259,368,15,49,UCBPlayer
28432,UCBPlayer,118,218,336,16,60,UCBPlayer
28433,UCBPlayer,117,267,384,19,45,UCBPlayer
28434,UCBPlayer,110,210,320,12,64,UCBPlayer
28435,UCBPlayer,126,271,397,23,42,UCBPlayer
28436,UCBPlayer,105,210,315,10,65,UCBPlayer
28437,UCBPlayer,130,275,405,25,40,UCBPlayer
28438,UCBPlayer,105,210,315,10,65,UCBPlayer
28439,UCBPlayer,130,275,405,25,40,UCBPlayer
28440,UCBPlayer,106,206,312,10,66,UCBPlayer
28441,UCBPlayer,130,275,405,25,40,UCBPlayer
28442,UCBPlayer,105,210,315,10,65,UCBPlayer
28443,UCBPlayer,131,271,402,25,41,UCBPlayer
28444,UCBPlayer,105,210,315,10,65,UCBPlayer
28445,UCBPlayer,130,275,405,25,40,UCBPlayer
28446,UCBPlayer,105,210,315,10,65,UCBPlayer
28447,UCBPlayer,130,275,405,25,40,UCBPlayer
28448,UCBPlayer,103,203,306,10,68,UCBPlayer
28449,UCBPlayer,128,283,411,25,38,UCBPlayer
28450,UCBPlayer,111,186,297,10,71,UCBPlayer
28451,UCBPlayer,124,299,423,25,34,UCBPlayer
28452,UCBPlayer,115,170,285,10,75,UCBPlayer
28453,UCBPlayer,120,315,435,25,30,UCBPlayer
28454,UCBPlayer,119,154,273,10,79,UCBPlayer
28455,UCBPlayer,112,332,444,25,27,UCBPlayer
28456,UCBPlayer,127,137,264,10,82,UCBPlayer
28457,UCBPlayer,104,349,453,25,24,UCBPlayer
28458,UCBPlayer,126,126,252,7,85,Tie
28459,UCBPlayer,111,351,462,28,22,UCBPlayer
28460,UCBPlayer,116,126,242,3,87,UCBPlayer
28461,UCBPlayer,122,347,469,32,21,UCBPlayer
28462,UCBPlayer,107,132,239,0,87,UCBPlayer
28463,UCBPlayer,132,337,469,35,22,UCBPlayer
28464,UCBPlayer,103,148,251,0,83,UCBPlayer
28465,UCBPlayer,136,321,457,35,26,UCBPlayer
28466,UCBPlayer,99,164,263,0,79,UCBPlayer
28467,UCBPlayer,140,305,445,35,30,UCBPlayer
28468,UCBPlayer,95,180,275,0,75,UCBPlayer
28469,UCBPlayer,144,289,433,35,34,UCBPlayer
28470,UCBPlayer,91,196,287,0,71,UCBPlayer
28471,UCBPlayer,148,273,421,35,38,UCBPlayer
28472,UCBPlayer,87,212,299,0,67,UCBPlayer
28473,UCBPlayer,152,257,409,35,42,UCBPlayer
28474,UCBPlayer,84,224,308,0,64,UCBPlayer
28475,UCBPlayer,146,251,397,32,45,UCBPlayer
28476,UCBPlayer,89,234,323,3,60,UCBPlayer
28477,UCBPlayer,138,243,381,28,49,UCBPlayer
28478,UCBPlayer,97,242,339,7,56,UCBPlayer
28479,UCBPlayer,130,235,365,24,53,UCBPlayer
28480,UCBPlayer,105,250,355,11,52,UCBPlayer
28481,UCBPlayer,122,227,349,20,57,UCBPlayer
28482,UCBPlayer,109,259,368,15,49,UCBPlayer
28483,UCBPlayer,118,218,336,16,60,UCBPlayer
28484,UCBPlayer,117,267,384,19,45,UCBPlayer
28485,UCBPlayer,110,210,320,12,64,UCBPlayer
28486,UCBPlayer,126,271,397,23,42,UCBPlayer
28487,UCBPlayer,105,210,315,10,65,UCBPlayer
28488,UCBPlayer,130,275,405,25,40,UCBPlayer
28489,UCBPlayer,105,210,315,10,65,UCBPlayer
28490,UCBPlayer,130,275,405,25,40,UCBPlayer
28491,UCBPlayer,106,206,312,10,66,UCBPlayer
28492,UCBPlayer,130,275,405,25,40,UCBPlayer
28493,UCBPlayer,105,210,315,10,65,UCBPlayer
28494,UCBPlayer,131,271,402,25,41,UCBPlayer
28495,UCBPlayer,105,210,315,10,65,UCBPlayer
28496,UCBPlayer,130,275,405,25,40,UCBPlayer
28497,UCBPlayer,105,210,315,10,65,UCBPlayer
28498,UCBPlayer,130,275,405,25,40,UCBPlayer
28499,UCBPlayer,103,203,306,10,68,UCBPlayer
28500,UCBPlayer,128,283,411,25,38,UCBPlayer
28501,UCBPlayer,111,186,297,10,71,UCBPlayer
28502,UCBPlayer,124,299,423,25,34,UCBPlayer
28503,UCBPlayer,115,170,285,10,75,UCBPlayer
28504,UCBPlayer,120,315,435,25,30,UCBPlayer
28505,UCBPlayer,119,154,273,10,79,UCBPlayer
28506,UCBPlayer,112,332,444,25,27,UCBPlayer
28507,UCBPlayer,127,137,264,10,82,UCBPlayer
28508,UCBPlayer,104,349,453,25,24,UCBPlayer
28509,UCBPlayer,126,126,252,7,85,Tie
28510,UCBPlayer,111,351,462,28,22,UCBPlayer
28511,UCBPlayer,116,126,242,3,87,UCBPlayer
28512,UCBPlayer,122,347,469,32,21,UCBPlayer
28513,UCBPlayer,107,132,239,0,87,UCBPlayer
28514,UCBPlayer,132,337,469,35,22,UCBPlayer
28515,UCBPlayer,103,148,251,0,83,UCBPlayer
28516,UCBPlayer,136,321,457,35,26,UCBPlayer
28517,UCBPlayer,99,164,263,0,79,UCBPlayer
28518,UCBPlayer,140,305,445,35,30,UCBPlayer
28519,UCBPlayer,95,180,275,0,75,UCBPlayer
28520,UCBPlayer,144,289,433,35,34,UCBPlayer
28521,UCBPlayer,91,196,287,0,71,UCBPlayer
28522,UCBPlayer,148,273,421,35,38,UCBPlayer
28523,UCBPlayer,87,212,299,0,67,UCBPlayer
28524,UCBPlayer,152,257,409,35,42,UCBPlayer
28525,UCBPlayer,84,224,308,0,64,UCBPlayer
28526,UCBPlayer,146,251,397,32,45,UCBPlayer
28527,UCBPlayer,89,234,323,3,60,UCBPlayer
28528,UCBPlayer,138,243,381,28,49,UCBPlayer
28529,UCBPlayer,97,242,339,7,56,UCBPlayer
28530,UCBPlayer,130,235,365,24,53,UCBPlayer
28531,UCBPlayer,105,250,355,11,52,UCBPlayer
28532,UCBPlayer,122,227,349,20,57,UCBPlayer
28533,UCBPlayer,109,259,368,15,49,UCBPlayer
28534,UCBPlayer,118,218,336,16,60,UCBPlayer
28535,UCBPlayer,117,267,384,19,45,UCBPlayer
28536,UCBPlayer,110,210,320,12,64,UCBPlayer
28537,UCBPlayer,126,271,397,23,42,UCBPlayer
28538,UCBPlayer,105,210,315,10,65,UCBPlayer
28539,UCBPlayer,130,275,405,25,40,UCBPlayer
28540,UCBPlayer,105,210,315,10,65,UCBPlayer
28541,UCBPlayer,130,275,405,25,40,UCBPlayer
28542,UCBPlayer,106,206,312,10,66,UCBPlayer
28543,UCBPlayer,130,275,405,25,40,UCBPlayer
28544,UCBPlayer,105,210,315,10,65,UCBPlayer
28545,UCBPlayer,131,271,402,25,41,UCBPlayer
28546,UCBPlayer,105,210,315,10,65,UCBPlayer
28547,UCBPlayer,130,275,405,25,40,UCBPlayer
28548,UCBPlayer,105,210,315,10,65,UCBPlayer
28549,UCBPlayer,130,275,405,25,40,UCBPlayer
28550,UCBPlayer,103,203,306,10,68,UCBPlayer
28551,UCBPlayer,128,283,411,25,38,UCBPlayer
28552,UCBPlayer,111,186,297,10,71,UCBPlayer
28553,UCBPlayer,124,299,423,25,34,UCBPlayer
28554,UCBPlayer,115,170,285,10,75,UCBPlayer
28555,UCBPlayer,120,315,435,25,30,UCBPlayer
28556,UCBPlayer,119,154,273,10,79,UCBPlayer
28557,UCBPlayer,112,332,444,25,27,UCBPlayer
28558,UCBPlayer,127,137,264,10,82,UCBPlayer
28559,UCBPlayer,104,349,453,25,24,UCBPlayer
28560,UCBPlayer,126,126,252,7,85,Tie
28561,UCBPlayer,111,351,462,28,22,UCBPlayer
28562,UCBPlayer,116,126,242,3,87,UCBPlayer
28563,UCBPlayer,122,347,469,32,21,UCBPlayer
28564,UCBPlayer,107,132,239,0,87,UCBPlayer
28565,UCBPlayer,132,337,469,35,22,UCBPlayer
28566,UCBPlayer,103,148,251,0,83,UCBPlayer
28567,UCBPlayer,136,321,457,35,26,UCBPlayer
28568,UCBPlayer,99,164,263,0,79,UCBPlayer
28569,UCBPlayer,140,305,445,35,30,UCBPlayer
28570,UCBPlayer,95,180,275,0,75,UCBPlayer
28571,UCBPlayer,144,289,433,35,34,UCBPlayer
28572,UCBPlayer,91,196,287,0,71,UCBPlayer
28573,UCBPlayer,148,273,421,35,38,UCBPlayer
28574,UCBPlayer,87,212,299,0,67,UCBPlayer
28575,UCBPlayer,152,257,409,35,42,UCBPlayer
28576,UCBPlayer,84,224,308,0,64,UCBPlayer
28577,UCBPlayer,146,251,397,32,45,UCBPlayer
28578,UCBPlayer,89,234,323,3,60,UCBPlayer
28579,UCBPlayer,138,243,381,28,49,UCBPlayer
28580,UCBPlayer,97,242,339,7,56,UCBPlayer
28581,UCBPlayer,130,235,365,24,53,UCBPlayer
28582,UCBPlayer,105,250,355,11,52,UCBPlayer
28583,UCBPlayer,122,227,349,20,57,UCBPlayer
28584,UCBPlayer,109,259,368,15,49,UCBPlayer
28585,UCBPlayer,118,218,336,16,60,UCBPlayer
28586,UCBPlayer,117,267,384,19,45,UCBPlayer
28587,UCBPlayer,110,210,320,12,64,UCBPlayer
28588,UCBPlayer,126,271,397,23,42,UCBPlayer
28589,UCBPlayer,105,210,315,10,65,UCBPlayer
28590,UCBPlayer,130,275,405,25,40,UCBPlayer
28591,UCBPlayer,105,210,315,10,65,UCBPlayer
28592,UCBPlayer,130,275,405,25,40,UCBPlayer
28593,UCBPlayer,106,206,312,10,66,UCBPlayer
28594,UCBPlayer,130,275,405,25,40,UCBPlayer
28595,UCBPlayer,105,210,315,10,65,UCBPlayer
28596,UCBPlayer,131,271,402,25,41,UCBPlayer
28597,UCBPlayer,105,210,315,10,65,UCBPlayer
28598,UCBPlayer,130,275,405,25,40,UCBPlayer
28599,UCBPlayer,105,210,315,10,65,UCBPlayer
28600,UCBPlayer,130,275,405,25,40,UCBPlayer
28601,UCBPlayer,103,203,306,10,68,UCBPlayer
28602,UCBPlayer,128,283,411,25,38,UCBPlayer
28603,UCBPlayer,111,186,297,10,71,UCBPlayer
28604,UCBPlayer,124,299,423,25,34,UCBPlayer
28605,UCBPlayer,115,170,285,10,75,UCBPlayer
28606,UCBPlayer,120,315,435,25,30,UCBPlayer
28607,UCBPlayer,119,154,273,10,79,UCBPlayer
28608,UCBPlayer,112,332,444,25,27,UCBPlayer
28609,UCBPlayer,127,137,264,10,82,UCBPlayer
28610,UCBPlayer,104,349,453,25,24,UCBPlayer
28611,UCBPlayer,126,126,252,7,85,Tie
28612,UCBPlayer,111,351,462,28,22,UCBPlayer
28613,UCBPlayer,116,126,242,3,87,UCBPlayer
28614,UCBPlayer,122,347,469,32,21,UCBPlayer
28615,UCBPlayer,107,132,239,0,87,UCBPlayer
28616,UCBPlayer,132,337,469,35,22,UCBPlayer
28617,UCBPlayer,103,148,251,0,83,UCBPlayer
28618,UCBPlayer,136,321,457,35,26,UCBPlayer
28619,UCBPlayer,99,164,263,0,79,UCBPlayer
28620,UCBPlayer,140,305,445,35,30,UCBPlayer
28621,UCBPlayer,95,180,275,0,75,UCBPlayer
28622,UCBPlayer,144,289,433,35,34,UCBPlayer
28623,UCBPlayer,91,196,287,0,71,UCBPlayer
28624,UCBPlayer,148,273,421,35,38,UCBPlayer
28625,UCBPlayer,87,212,299,0,67,UCBPlayer
28626,UCBPlayer,152,257,409,35,42,UCBPlayer
28627,UCBPlayer,84,224,308,0,64,UCBPlayer
28628,UCBPlayer,146,251,397,32,45,UCBPlayer
28629,UCBPlayer,89,234,323,3,60,UCBPlayer
28630,UCBPlayer,138,243,381,28,49,UCBPlayer
28631,UCBPlayer,97,242,339,7,56,UCBPlayer
28632,UCBPlayer,130,235,365,24,53,UCBPlayer
28633,UCBPlayer,105,250,355,11,52,UCBPlayer
28634,UCBPlayer,122,227,349,20,57,UCBPlayer
28635,UCBPlayer,109,259,368,15,49,UCBPlayer
28636,UCBPlayer,118,218,336,16,60,UCBPlayer
28637,UCBPlayer,117,267,384,19,45,UCBPlayer
28638,UCBPlayer,110,210,320,12,64,UCBPlayer
28639,UCBPlayer,126,271,397,23,42,UCBPlayer
28640,UCBPlayer,105,210,315,10,65,UCBPlayer
28641,UCBPlayer,130,275,405,25,40,UCBPlayer
28642,UCBPlayer,105,210,315,10,65,UCBPlayer
28643,UCBPlayer,130,275,405,25,40,UCBPlayer
28644,UCBPlayer,106,206,312,10,66,UCBPlayer
28645,UCBPlayer,130,275,405,25,40,UCBPlayer
28646,UCBPlayer,105,210,315,10,65,UCBPlayer
28647,UCBPlayer,131,271,402,25,41,UCBPlayer
28648,UCBPlayer,105,210,315,10,65,UCBPlayer
28649,UCBPlayer,130,275,405,25,40,UCBPlayer
28650,UCBPlayer,105,210,315,10,65,UCBPlayer
28651,UCBPlayer,130,275,405,25,40,UCBPlayer
28652,UCBPlayer,103,203,306,10,68,UCBPlayer
28653,UCBPlayer,128,283,411,25,38,UCBPlayer
28654,UCBPlayer,111,186,297,10,71,UCBPlayer
28655,UCBPlayer,124,299,423,25,34,UCBPlayer
28656,UCBPlayer,115,170,285,10,75,UCBPlayer
28657,UCBPlayer,120,315,435,25,30,UCBPlayer
28658,UCBPlayer,119,154,273,10,79,UCBPlayer
28659,UCBPlayer,112,332,444,25,27,UCBPlayer
28660,UCBPlayer,127,137,264,10,82,UCBPlayer
28661,UCBPlayer,104,349,453,25,24,UCBPlayer
28662,UCBPlayer,126,126,252,7,85,Tie
28663,UCBPlayer,111,351,462,28,22,UCBPlayer
28664,UCBPlayer,116,126,242,3,87,UCBPlayer
28665,UCBPlayer,122,347,469,32,21,UCBPlayer
28666,UCBPlayer,107,132,239,0,87,UCBPlayer
28667,UCBPlayer,132,337,469,35,22,UCBPlayer
28668,UCBPlayer,103,148,251,0,83,UCBPlayer
28669,UCBPlayer,136,321,457,35,26,UCBPlayer
28670,UCBPlayer,99,164,263,0,79,UCBPlayer
28671,UCBPlayer,140,305,445,35,30,UCBPlayer
28672,UCBPlayer,95,180,275,0,75,UCBPlayer
28673,UCBPlayer,144,289,433,35,34,UCBPlayer
28674,UCBPlayer,91,196,287,0,71,UCBPlayer
28675,UCBPlayer,148,273,421,35,38,UCBPlayer
28676,UCBPlayer,87,212,299,0,67,UCBPlayer
28677,UCBPlayer,152,257,409,35,42,UCBPlayer
28678,UCBPlayer,84,224,308,0,64,UCBPlayer
28679,UCBPlayer,146,251,397,32,45,UCBPlayer
28680,UCBPlayer,89,234,323,3,60,UCBPlayer
28681,UCBPlayer,138,243,381,28,49,UCBPlayer
28682,UCBPlayer,97,242,339,7,56,UCBPlayer
28683,UCBPlayer,130,235,365,24,53,UCBPlayer
28684,UCBPlayer,105,250,355,11,52,UCBPlayer
28685,UCBPlayer,122,227,349,20,57,UCBPlayer
28686,UCBPlayer,109,259,368,15,49,UCBPlayer
28687,UCBPlayer,118,218,336,16,60,UCBPlayer
28688,UCBPlayer,117,267,384,19,45,UCBPlayer
28689,UCBPlayer,110,210,320,12,64,UCBPlayer
28690,UCBPlayer,126,271,397,23,42,UCBPlayer
28691,UCBPlayer,105,210,315,10,65,UCBPlayer
28692,UCBPlayer,130,275,405,25,40,UCBPlayer
28693,UCBPlayer,105,210,315,10,65,UCBPlayer
28694,UCBPlayer,130,275,405,25,40,UCBPlayer
28695,UCBPlayer,106,206,312,10,66,UCBPlayer
28696,UCBPlayer,130,275,405,25,40,UCBPlayer
28697,UCBPlayer,105,210,315,10,65,UCBPlayer
28698,UCBPlayer,131,271,402,25,41,UCBPlayer
28699,UCBPlayer,105,210,315,10,65,UCBPlayer
28700,UCBPlayer,130,275,405,25,40,UCBPlayer
28701,UCBPlayer,105,210,315,10,65,UCBPlayer
28702,UCBPlayer,130,275,405,25,40,UCBPlayer
28703,UCBPlayer,103,203,306,10,68,UCBPlayer
28704,UCBPlayer,128,283,411,25,38,UCBPlayer
28705,UCBPlayer,111,186,297,10,71,UCBPlayer
28706,UCBPlayer,124,299,423,25,34,UCBPlayer
28707,UCBPlayer,115,170,285,10,75,UCBPlayer
28708,UCBPlayer,120,315,435,25,30,UCBPlayer
28709,UCBPlayer,119,154,273,10,79,UCBPlayer
28710,UCBPlayer,112,332,444,25,27,UCBPlayer
28711,UCBPlayer,127,137,264,10,82,UCBPlayer
28712,UCBPlayer,104,349,453,25,24,UCBPlayer
28713,UCBPlayer,126,126,252,7,85,Tie
28714,UCBPlayer,111,351,462,28,22,UCBPlayer
28715,UCBPlayer,116,126,242,3,87,UCBPlayer
28716,UCBPlayer,122,347,469,32,21,UCBPlayer
28717,UCBPlayer,107,132,239,0,87,UCBPlayer
28718,UCBPlayer,132,337,469,35,22,UCBPlayer
28719,UCBPlayer,103,148,251,0,83,UCBPlayer
28720,UCBPlayer,136,321,457,35,26,UCBPlayer
28721,UCBPlayer,99,164,263,0,79,UCBPlayer
28722,UCBPlayer,140,305,445,35,30,UCBPlayer
28723,UCBPlayer,95,180,275,0,75,UCBPlayer
28724,UCBPlayer,144,289,433,35,34,UCBPlayer
28725,UCBPlayer,91,196,287,0,71,UCBPlayer
28726,UCBPlayer,148,273,421,35,38,UCBPlayer
28727,UCBPlayer,87,212,299,0,67,UCBPlayer
28728,UCBPlayer,152,257,409,35,42,UCBPlayer
28729,UCBPlayer,84,224,308,0,64,UCBPlayer
28730,UCBPlayer,146,251,397,32,45,UCBPlayer
28731,UCBPlayer,89,234,323,3,60,UCBPlayer
28732,UCBPlayer,138,243,381,28,49,UCBPlayer
28733,UCBPlayer,97,242,339,7,56,UCBPlayer
28734,UCBPlayer,130,235,365,24,53,UCBPlayer
28735,UCBPlayer,105,250,355,11,52,UCBPlayer
28736,UCBPlayer,122,227,349,20,57,UCBPlayer
28737,UCBPlayer,109,259,368,15,49,UCBPlayer
28738,UCBPlayer,118,218,336,16,60,UCBPlayer
28739,UCBPlayer,117,267,384,19,45,UCBPlayer
28740,UCBPlayer,110,210,320,12,64,UCBPlayer
28741,UCBPlayer,126,271,397,23,42,UCBPlayer
28742,UCBPlayer,105,210,315,10,65,UCBPlayer
28743,UCBPlayer,130,275,405,25,40,UCBPlayer
28744,UCBPlayer,105,210,315,10,65,UCBPlayer
28745,UCBPlayer,130,275,405,25,40,UCBPlayer
28746,UCBPlayer,106,206,312,10,66,UCBPlayer
28747,UCBPlayer,130,275,405,25,40,UCBPlayer
28748,UCBPlayer,105,210,315,10,65,UCBPlayer
28749,UCBPlayer,131,271,402,25,41,UCBPlayer
28750,UCBPlayer,105,210,315,10,65,UCBPlayer
28751,UCBPlayer,130,275,405,25,40,UCBPlayer
28752,UCBPlayer,105,210,315,10,65,UCBPlayer
28753,UCBPlayer,130,275,405,25,40,UCBPlayer
28754,UCBPlayer,103,203,306,10,68,UCBPlayer
28755,UCBPlayer,128,283,411,25,38,UCBPlayer
28756,UCBPlayer,111,186,297,10,71,UCBPlayer
28757,UCBPlayer,124,299,423,25,34,UCBPlayer
28758,UCBPlayer,115,170,285,10,75,UCBPlayer
28759,UCBPlayer,120,315,435,25,30,UCBPlayer
28760,UCBPlayer,119,154,273,10,79,UCBPlayer
28761,UCBPlayer,112,332,444,25,27,UCBPlayer
28762,UCBPlayer,127,137,264,10,82,UCBPlayer
28763,UCBPlayer,104,349,453,25,24,UCBPlayer
28764,UCBPlayer,126,126,252,7,85,Tie
28765,UCBPlayer,111,351,462,28,22,UCBPlayer
28766,UCBPlayer,116,126,242,3,87,UCBPlayer
28767,UCBPlayer,122,347,469,32,21,UCBPlayer
28768,UCBPlayer,107,132,239,0,87,UCBPlayer
28769,UCBPlayer,132,337,469,35,22,UCBPlayer
28770,UCBPlayer,103,148,251,0,83,UCBPlayer
28771,UCBPlayer,136,321,457,35,26,UCBPlayer
28772,UCBPlayer,99,164,263,0,79,UCBPlayer
28773,UCBPlayer,140,305,445,35,30,UCBPlayer
28774,UCBPlayer,95,180,275,0,75,UCBPlayer
28775,UCBPlayer,144,289,433,35,34,UCBPlayer
28776,UCBPlayer,91,196,287,0,71,UCBPlayer
28777,UCBPlayer,148,273,421,35,38,UCBPlayer
28778,UCBPlayer,87,212,299,0,67,UCBPlayer
28779,UCBPlayer,152,257,409,35,42,UCBPlayer
28780,UCBPlayer,84,224,308,0,64,UCBPlayer
28781,UCBPlayer,146,251,397,32,45,UCBPlayer
28782,UCBPlayer,89,234,323,3,60,UCBPlayer
28783,UCBPlayer,138,243,381,28,49,UCBPlayer
28784,UCBPlayer,97,242,339,7,56,UCBPlayer
28785,UCBPlayer,130,235,365,24,53,UCBPlayer
28786,UCBPlayer,105,250,355,11,52,UCBPlayer
28787,UCBPlayer,122,227,349,20,57,UCBPlayer
28788,UCBPlayer,109,259,368,15,49,UCBPlayer
28789,UCBPlayer,118,218,336,16,60,UCBPlayer
28790,UCBPlayer,117,267,384,19,45,UCBPlayer
28791,UCBPlayer,110,210,320,12,64,UCBPlayer
28792,UCBPlayer,126,271,397,23,42,UCBPlayer
28793,UCBPlayer,105,210,315,10,65,UCBPlayer
28794,UCBPlayer,130,275,405,25,40,UCBPlayer
28795,UCBPlayer,105,210,315,10,65,UCBPlayer
28796,UCBPlayer,130,275,405,25,40,UCBPlayer
28797,UCBPlayer,106,206,312,10,66,UCBPlayer
28798,UCBPlayer,130,275,405,25,40,UCBPlayer
28799,UCBPlayer,105,210,315,10,65,UCBPlayer
28800,UCBPlayer,131,271,402,25,41,UCBPlayer
28801,UCBPlayer,105,210,315,10,65,UCBPlayer
28802,UCBPlayer,130,275,405,25,40,UCBPlayer
28803,UCBPlayer,105,210,315,10,65,UCBPlayer
28804,UCBPlayer,130,275,405,25,40,UCBPlayer
28805,UCBPlayer,103,203,306,10,68,UCBPlayer
28806,UCBPlayer,128,283,411,25,38,UCBPlayer
28807,UCBPlayer,111,186,297,10,71,UCBPlayer
28808,UCBPlayer,124,299,423,25,34,UCBPlayer
28809,UCBPlayer,115,170,285,10,75,UCBPlayer
28810,UCBPlayer,120,315,435,25,30,UCBPlayer
28811,UCBPlayer,119,154,273,10,79,UCBPlayer
28812,UCBPlayer,112,332,444,25,27,UCBPlayer
28813,UCBPlayer,127,137,264,10,82,UCBPlayer
28814,UCBPlayer,104,349,453,25,24,UCBPlayer
28815,UCBPlayer,126,126,252,7,85,Tie
28816,UCBPlayer,111,351,462,28,22,UCBPlayer
28817,UCBPlayer,116,126,242,3,87,UCBPlayer
28818,UCBPlayer,122,347,469,32,21,UCBPlayer
28819,UCBPlayer,107,132,239,0,87,UCBPlayer
28820,UCBPlayer,132,337,469,35,22,UCBPlayer
28821,UCBPlayer,103,148,251,0,83,UCBPlayer
28822,UCBPlayer,136,321,457,35,26,UCBPlayer
28823,UCBPlayer,99,164,263,0,79,UCBPlayer
28824,UCBPlayer,140,305,445,35,30,UCBPlayer
28825,UCBPlayer,95,180,275,0,75,UCBPlayer
28826,UCBPlayer,144,289,433,35,34,UCBPlayer
28827,UCBPlayer,91,196,287,0,71,UCBPlayer
28828,UCBPlayer,148,273,421,35,38,UCBPlayer
28829,UCBPlayer,87,212,299,0,67,UCBPlayer
28830,UCBPlayer,152,257,409,35,42,UCBPlayer
28831,UCBPlayer,84,224,308,0,64,UCBPlayer
28832,UCBPlayer,146,251,397,32,45,UCBPlayer
28833,UCBPlayer,89,234,323,3,60,UCBPlayer
28834,UCBPlayer,138,243,381,28,49,UCBPlayer
28835,UCBPlayer,97,242,339,7,56,UCBPlayer
28836,UCBPlayer,130,235,365,24,53,UCBPlayer
28837,UCBPlayer,105,250,355,11,52,UCBPlayer
28838,UCBPlayer,122,227,349,20,57,UCBPlayer
28839,UCBPlayer,109,259,368,15,49,UCBPlayer
28840,UCBPlayer,118,218,336,16,60,UCBPlayer
28841,UCBPlayer,117,267,384,19,45,UCBPlayer
28842,UCBPlayer,110,210,320,12,64,UCBPlayer
28843,UCBPlayer,126,271,397,23,42,UCBPlayer
28844,UCBPlayer,105,210,315,10,65,UCBPlayer
28845,UCBPlayer,130,275,405,25,40,UCBPlayer
28846,UCBPlayer,105,210,315,10,65,UCBPlayer
28847,UCBPlayer,130,275,405,25,40,UCBPlayer
28848,UCBPlayer,106,206,312,10,66,UCBPlayer
28849,UCBPlayer,130,275,405,25,40,UCBPlayer
28850,UCBPlayer,105,210,315,10,65,UCBPlayer
28851,UCBPlayer,131,271,402,25,41,UCBPlayer
28852,UCBPlayer,105,210,315,10,65,UCBPlayer
28853,UCBPlayer,130,275,405,25,40,UCBPlayer
28854,UCBPlayer,105,210,315,10,65,UCBPlayer
28855,UCBPlayer,130,275,405,25,40,UCBPlayer
28856,UCBPlayer,103,203,306,10,68,UCBPlayer
28857,UCBPlayer,128,283,411,25,38,UCBPlayer
28858,UCBPlayer,111,186,297,10,71,UCBPlayer
28859,UCBPlayer,124,299,423,25,34,UCBPlayer
28860,UCBPlayer,115,170,285,10,75,UCBPlayer
28861,UCBPlayer,120,315,435,25,30,UCBPlayer
28862,UCBPlayer,119,154,273,10,79,UCBPlayer
28863,UCBPlayer,112,332,444,25,27,UCBPlayer
28864,UCBPlayer,127,137,264,10,82,UCBPlayer
28865,UCBPlayer,104,349,453,25,24,UCBPlayer
28866,UCBPlayer,126,126,252,7,85,Tie
28867,UCBPlayer,111,351,462,28,22,UCBPlayer
28868,UCBPlayer,116,126,242,3,87,UCBPlayer
28869,UCBPlayer,122,347,469,32,21,UCBPlayer
28870,UCBPlayer,107,132,239,0,87,UCBPlayer
28871,UCBPlayer,132,337,469,35,22,UCBPlayer
28872,UCBPlayer,103,148,251,0,83,UCBPlayer
28873,UCBPlayer,136,321,457,35,26,UCBPlayer
28874,UCBPlayer,99,164,263,0,79,UCBPlayer
28875,UCBPlayer,140,305,445,35,30,UCBPlayer
28876,UCBPlayer,95,180,275,0,75,UCBPlayer
28877,UCBPlayer,144,289,433,35,34,UCBPlayer
28878,UCBPlayer,91,196,287,0,71,UCBPlayer
28879,UCBPlayer,148,273,421,35,38,UCBPlayer
28880,UCBPlayer,87,212,299,0,67,UCBPlayer
28881,UCBPlayer,152,257,409,35,42,UCBPlayer
28882,UCBPlayer,84,224,308,0,64,UCBPlayer
28883,UCBPlayer,146,251,397,32,45,UCBPlayer
28884,UCBPlayer,89,234,323,3,60,UCBPlayer
28885,UCBPlayer,138,243,381,28,49,UCBPlayer
28886,UCBPlayer,97,242,339,7,56,UCBPlayer
28887,UCBPlayer,130,235,365,24,53,UCBPlayer
28888,UCBPlayer,105,250,355,11,52,UCBPlayer
28889,UCBPlayer,122,227,349,20,57,UCBPlayer
28890,UCBPlayer,109,259,368,15,49,UCBPlayer
28891,UCBPlayer,118,218,336,16,60,UCBPlayer
28892,UCBPlayer,117,267,384,19,45,UCBPlayer
28893,UCBPlayer,110,210,320,12,64,UCBPlayer
28894,UCBPlayer,126,271,397,23,42,UCBPlayer
28895,UCBPlayer,105,210,315,10,65,UCBPlayer
28896,UCBPlayer,130,275,405,25,40,UCBPlayer
28897,UCBPlayer,105,210,315,10,65,UCBPlayer
28898,UCBPlayer,130,275,405,25,40,UCBPlayer
28899,UCBPlayer,106,206,312,10,66,UCBPlayer
28900,UCBPlayer,130,275,405,25,40,UCBPlayer
28901,UCBPlayer,105,210,315,10,65,UCBPlayer
28902,UCBPlayer,131,271,402,25,41,UCBPlayer
28903,UCBPlayer,105,210,315,10,65,UCBPlayer
28904,UCBPlayer,130,275,405,25,40,UCBPlayer
28905,UCBPlayer,105,210,315,10,65,UCBPlayer
28906,UCBPlayer,130,275,405,25,40,UCBPlayer
28907,UCBPlayer,103,203,306,10,68,UCBPlayer
28908,UCBPlayer,128,283,411,25,38,UCBPlayer
28909,UCBPlayer,111,186,297,10,71,UCBPlayer
28910,UCBPlayer,124,299,423,25,34,UCBPlayer
28911,UCBPlayer,115,170,285,10,75,UCBPlayer
28912,UCBPlayer,120,315,435,25,30,UCBPlayer
28913,UCBPlayer,119,154,273,10,79,UCBPlayer
28914,UCBPlayer,112,332,444,25,27,UCBPlayer
28915,UCBPlayer,127,137,264,10,82,UCBPlayer
28916,UCBPlayer,104,349,453,25,24,UCBPlayer
28917,UCBPlayer,126,126,252,7,85,Tie
28918,UCBPlayer,111,351,462,28,22,UCBPlayer
28919,UCBPlayer,116,126,242,3,87,UCBPlayer
28920,UCBPlayer,122,347,469,32,21,UCBPlayer
28921,UCBPlayer,107,132,239,0,87,UCBPlayer
28922,UCBPlayer,132,337,469,35,22,UCBPlayer
28923,UCBPlayer,103,148,251,0,83,UCBPlayer
28924,UCBPlayer,136,321,457,35,26,UCBPlayer
28925,UCBPlayer,99,164,263,0,79,UCBPlayer
28926,UCBPlayer,140,305,445,35,30,UCBPlayer
28927,UCBPlayer,95,180,275,0,75,UCBPlayer
28928,UCBPlayer,144,289,433,35,34,UCBPlayer
28929,UCBPlayer,91,196,287,0,71,UCBPlayer
28930,UCBPlayer,148,273,421,35,38,UCBPlayer
28931,UCBPlayer,87,212,299,0,67,UCBPlayer
28932,UCBPlayer,152,257,409,35,42,UCBPlayer
28933,UCBPlayer,84,224,308,0,64,UCBPlayer
28934,UCBPlayer,146,251,397,32,45,UCBPlayer
28935,UCBPlayer,89,234,323,3,60,UCBPlayer
28936,UCBPlayer,138,243,381,28,49,UCBPlayer
28937,UCBPlayer,97,242,339,7,56,UCBPlayer
28938,UCBPlayer,130,235,365,24,53,UCBPlayer
28939,UCBPlayer,105,250,355,11,52,UCBPlayer
28940,UCBPlayer,122,227,349,20,57,UCBPlayer
28941,UCBPlayer,109,259,368,15,49,UCBPlayer
28942,UCBPlayer,118,218,336,16,60,UCBPlayer
28943,UCBPlayer,117,267,384,19,45,UCBPlayer
28944,UCBPlayer,110,210,320,12,64,UCBPlayer
28945,UCBPlayer,126,271,397,23,42,UCBPlayer
28946,UCBPlayer,105,210,315,10,65,UCBPlayer
28947,UCBPlayer,130,275,405,25,40,UCBPlayer
28948,UCBPlayer,105,210,315,10,65,UCBPlayer
28949,UCBPlayer,130,275,405,25,40,UCBPlayer
28950,UCBPlayer,106,206,312,10,66,UCBPlayer
28951,UCBPlayer,130,275,405,25,40,UCBPlayer
28952,UCBPlayer,105,210,315,10,65,UCBPlayer
28953,UCBPlayer,131,271,402,25,41,UCBPlayer
28954,UCBPlayer,105,210,315,10,65,UCBPlayer
28955,UCBPlayer,130,275,405,25,40,UCBPlayer
28956,UCBPlayer,105,210,315,10,65,UCBPlayer
28957,UCBPlayer,130,275,405,25,40,UCBPlayer
28958,UCBPlayer,103,203,306,10,68,UCBPlayer
28959,UCBPlayer,128,283,411,25,38,UCBPlayer
28960,UCBPlayer,111,186,297,10,71,UCBPlayer
28961,UCBPlayer,124,299,423,25,34,UCBPlayer
28962,UCBPlayer,115,170,285,10,75,UCBPlayer
28963,UCBPlayer,120,315,435,25,30,UCBPlayer
28964,UCBPlayer,119,154,273,10,79,UCBPlayer
28965,UCBPlayer,112,332,444,25,27,UCBPlayer
28966,UCBPlayer,127,137,264,10,82,UCBPlayer
28967,UCBPlayer,104,349,453,25,24,UCBPlayer
28968,UCBPlayer,126,126,252,7,85,Tie
28969,UCBPlayer,111,351,462,28,22,UCBPlayer
28970,UCBPlayer,116,126,242,3,87,UCBPlayer
28971,UCBPlayer,122,347,469,32,21,UCBPlayer
28972,UCBPlayer,107,132,239,0,87,UCBPlayer
28973,UCBPlayer,132,337,469,35,22,UCBPlayer
28974,UCBPlayer,103,148,251,0,83,UCBPlayer
28975,UCBPlayer,136,321,457,35,26,UCBPlayer
28976,UCBPlayer,99,164,263,0,79,UCBPlayer
28977,UCBPlayer,140,305,445,35,30,UCBPlayer
28978,UCBPlayer,95,180,275,0,75,UCBPlayer
28979,UCBPlayer,144,289,433,35,34,UCBPlayer
28980,UCBPlayer,91,196,287,0,71,UCBPlayer
28981,UCBPlayer,148,273,421,35,38,UCBPlayer
28982,UCBPlayer,87,212,299,0,67,UCBPlayer
28983,UCBPlayer,152,257,409,35,42,UCBPlayer
28984,UCBPlayer,84,224,308,0,64,UCBPlayer
28985,UCBPlayer,146,251,397,32,45,UCBPlayer
28986,UCBPlayer,89,234,323,3,60,UCBPlayer
28987,UCBPlayer,138,243,381,28,49,UCBPlayer
28988,UCBPlayer,97,242,339,7,56,UCBPlayer
28989,UCBPlayer,130,235,365,24,53,UCBPlayer
28990,UCBPlayer,105,250,355,11,52,UCBPlayer
28991,UCBPlayer,122,227,349,20,57,UCBPlayer
28992,UCBPlayer,109,259,368,15,49,UCBPlayer
28993,UCBPlayer,118,218,336,16,60,UCBPlayer
28994,UCBPlayer,117,267,384,19,45,UCBPlayer
28995,UCBPlayer,110,210,320,12,64,UCBPlayer
28996,UCBPlayer,126,271,397,23,42,UCBPlayer
28997,UCBPlayer,105,210,315,10,65,UCBPlayer
28998,UCBPlayer,130,275,405,25,40,UCBPlayer
28999,UCBPlayer,105,210,315,10,65,UCBPlayer
29000,UCBPlayer,130,275,405,25,40,UCBPlayer
29001,UCBPlayer,106,206,312,10,66,UCBPlayer
29002,UCBPlayer,130,275,405,25,40,UCBPlayer
29003,UCBPlayer,105,210,315,10,65,UCBPlayer
29004,UCBPlayer,131,271,402,25,41,UCBPlayer
29005,UCBPlayer,105,210,315,10,65,UCBPlayer
29006,UCBPlayer,130,275,405,25,40,UCBPlayer
29007,UCBPlayer,105,210,315,10,65,UCBPlayer
29008,UCBPlayer,130,275,405,25,40,UCBPlayer
29009,UCBPlayer,103,203,306,10,68,UCBPlayer
29010,UCBPlayer,128,283,411,25,38,UCBPlayer
29011,UCBPlayer,111,186,297,10,71,UCBPlayer
29012,UCBPlayer,124,299,423,25,34,UCBPlayer
29013,UCBPlayer,115,170,285,10,75,UCBPlayer
29014,UCBPlayer,120,315,435,25,30,UCBPlayer
29015,UCBPlayer,119,154,273,10,79,UCBPlayer
29016,UCBPlayer,112,332,444,25,27,UCBPlayer
29017,UCBPlayer,127,137,264,10,82,UCBPlayer
29018,UCBPlayer,104,349,453,25,24,UCBPlayer
29019,UCBPlayer,126,126,252,7,85,Tie
29020,UCBPlayer,111,351,462,28,22,UCBPlayer
29021,UCBPlayer,116,126,242,3,87,UCBPlayer
29022,UCBPlayer,122,347,469,32,21,UCBPlayer
29023,UCBPlayer,107,132,239,0,87,UCBPlayer
29024,UCBPlayer,132,337,469,35,22,UCBPlayer
29025,UCBPlayer,103,148,251,0,83,UCBPlayer
29026,UCBPlayer,136,321,457,35,26,UCBPlayer
29027,UCBPlayer,99,164,263,0,79,UCBPlayer
29028,UCBPlayer,140,305,445,35,30,UCBPlayer
29029,UCBPlayer,95,180,275,0,75,UCBPlayer
29030,UCBPlayer,144,289,433,35,34,UCBPlayer
29031,UCBPlayer,91,196,287,0,71,UCBPlayer
29032,UCBPlayer,148,273,421,35,38,UCBPlayer
29033,UCBPlayer,87,212,299,0,67,UCBPlayer
29034,UCBPlayer,152,257,409,35,42,UCBPlayer
29035,UCBPlayer,84,224,308,0,64,UCBPlayer
29036,UCBPlayer,146,251,397,32,45,UCBPlayer
29037,UCBPlayer,89,234,323,3,60,UCBPlayer
29038,UCBPlayer,138,243,381,28,49,UCBPlayer
29039,UCBPlayer,97,242,339,7,56,UCBPlayer
29040,UCBPlayer,130,235,365,24,53,UCBPlayer
29041,UCBPlayer,105,250,355,11,52,UCBPlayer
29042,UCBPlayer,122,227,349,20,57,UCBPlayer
29043,UCBPlayer,109,259,368,15,49,UCBPlayer
29044,UCBPlayer,118,218,336,16,60,UCBPlayer
29045,UCBPlayer,117,267,384,19,45,UCBPlayer
29046,UCBPlayer,110,210,320,12,64,UCBPlayer
29047,UCBPlayer,126,271,397,23,42,UCBPlayer
29048,UCBPlayer,105,210,315,10,65,UCBPlayer
29049,UCBPlayer,130,275,405,25,40,UCBPlayer
29050,UCBPlayer,105,210,315,10,65,UCBPlayer
29051,UCBPlayer,130,275,405,25,40,UCBPlayer
29052,UCBPlayer,106,206,312,10,66,UCBPlayer
29053,UCBPlayer,130,275,405,25,40,UCBPlayer
29054,UCBPlayer,105,210,315,10,65,UCBPlayer
29055,UCBPlayer,131,271,402,25,41,UCBPlayer
29056,UCBPlayer,105,210,315,10,65,UCBPlayer
29057,UCBPlayer,130,275,405,25,40,UCBPlayer
29058,UCBPlayer,105,210,315,10,65,UCBPlayer
29059,UCBPlayer,130,275,405,25,40,UCBPlayer
29060,UCBPlayer,103,203,306,10,68,UCBPlayer
29061,UCBPlayer,128,283,411,25,38,UCBPlayer
29062,UCBPlayer,111,186,297,10,71,UCBPlayer
29063,UCBPlayer,124,299,423,25,34,UCBPlayer
29064,UCBPlayer,115,170,285,10,75,UCBPlayer
29065,UCBPlayer,120,315,435,25,30,UCBPlayer
29066,UCBPlayer,119,154,273,10,79,UCBPlayer
29067,UCBPlayer,112,332,444,25,27,UCBPlayer
29068,UCBPlayer,127,137,264,10,82,UCBPlayer
29069,UCBPlayer,104,349,453,25,24,UCBPlayer
29070,UCBPlayer,126,126,252,7,85,Tie
29071,UCBPlayer,111,351,462,28,22,UCBPlayer
29072,UCBPlayer,116,126,242,3,87,UCBPlayer
29073,UCBPlayer,122,347,469,32,21,UCBPlayer
29074,UCBPlayer,107,132,239,0,87,UCBPlayer
29075,UCBPlayer,132,337,469,35,22,UCBPlayer
29076,UCBPlayer,103,148,251,0,83,UCBPlayer
29077,UCBPlayer,136,321,457,35,26,UCBPlayer
29078,UCBPlayer,99,164,263,0,79,UCBPlayer
29079,UCBPlayer,140,305,445,35,30,UCBPlayer
29080,UCBPlayer,95,180,275,0,75,UCBPlayer
29081,UCBPlayer,144,289,433,35,34,UCBPlayer
29082,UCBPlayer,91,196,287,0,71,UCBPlayer
29083,UCBPlayer,148,273,421,35,38,UCBPlayer
29084,UCBPlayer,87,212,299,0,67,UCBPlayer
29085,UCBPlayer,152,257,409,35,42,UCBPlayer
29086,UCBPlayer,84,224,308,0,64,UCBPlayer
29087,UCBPlayer,146,251,397,32,45,UCBPlayer
29088,UCBPlayer,89,234,323,3,60,UCBPlayer
29089,UCBPlayer,138,243,381,28,49,UCBPlayer
29090,UCBPlayer,97,242,339,7,56,UCBPlayer
29091,UCBPlayer,130,235,365,24,53,UCBPlayer
29092,UCBPlayer,105,250,355,11,52,UCBPlayer
29093,UCBPlayer,122,227,349,20,57,UCBPlayer
29094,UCBPlayer,109,259,368,15,49,UCBPlayer
29095,UCBPlayer,118,218,336,16,60,UCBPlayer
29096,UCBPlayer,117,267,384,19,45,UCBPlayer
29097,UCBPlayer,110,210,320,12,64,UCBPlayer
29098,UCBPlayer,126,271,397,23,42,UCBPlayer
29099,UCBPlayer,105,210,315,10,65,UCBPlayer
29100,UCBPlayer,130,275,405,25,40,UCBPlayer
29101,UCBPlayer,105,210,315,10,65,UCBPlayer
29102,UCBPlayer,130,275,405,25,40,UCBPlayer
29103,UCBPlayer,106,206,312,10,66,UCBPlayer
29104,UCBPlayer,130,275,405,25,40,UCBPlayer
29105,UCBPlayer,105,210,315,10,65,UCBPlayer
29106,UCBPlayer,131,271,402,25,41,UCBPlayer
29107,UCBPlayer,105,210,315,10,65,UCBPlayer
29108,UCBPlayer,130,275,405,25,40,UCBPlayer
29109,UCBPlayer,105,210,315,10,65,UCBPlayer
29110,UCBPlayer,130,275,405,25,40,UCBPlayer
29111,UCBPlayer,103,203,306,10,68,UCBPlayer
29112,UCBPlayer,128,283,411,25,38,UCBPlayer
29113,UCBPlayer,111,186,297,10,71,UCBPlayer
29114,UCBPlayer,124,299,423,25,34,UCBPlayer
29115,UCBPlayer,115,170,285,10,75,UCBPlayer
29116,UCBPlayer,120,315,435,25,30,UCBPlayer
29117,UCBPlayer,119,154,273,10,79,UCBPlayer
29118,UCBPlayer,112,332,444,25,27,UCBPlayer
29119,UCBPlayer,127,137,264,10,82,UCBPlayer
29120,UCBPlayer,104,349,453,25,24,UCBPlayer
29121,UCBPlayer,126,126,252,7,85,Tie
29122,UCBPlayer,111,351,462,28,22,UCBPlayer
29123,UCBPlayer,116,126,242,3,87,UCBPlayer
29124,UCBPlayer,122,347,469,32,21,UCBPlayer
29125,UCBPlayer,107,132,239,0,87,UCBPlayer
29126,UCBPlayer,132,337,469,35,22,UCBPlayer
29127,UCBPlayer,103,148,251,0,83,UCBPlayer
29128,UCBPlayer,136,321,457,35,26,UCBPlayer
29129,UCBPlayer,99,164,263,0,79,UCBPlayer
29130,UCBPlayer,140,305,445,35,30,UCBPlayer
29131,UCBPlayer,95,180,275,0,75,UCBPlayer
29132,UCBPlayer,144,289,433,35,34,UCBPlayer
29133,UCBPlayer,91,196,287,0,71,UCBPlayer
29134,UCBPlayer,148,273,421,35,38,UCBPlayer
29135,UCBPlayer,87,212,299,0,67,UCBPlayer
29136,UCBPlayer,152,257,409,35,42,UCBPlayer
29137,UCBPlayer,84,224,308,0,64,UCBPlayer
29138,UCBPlayer,146,251,397,32,45,UCBPlayer
29139,UCBPlayer,89,234,323,3,60,UCBPlayer
29140,UCBPlayer,138,243,381,28,49,UCBPlayer
29141,UCBPlayer,97,242,339,7,56,UCBPlayer
29142,UCBPlayer,130,235,365,24,53,UCBPlayer
29143,UCBPlayer,105,250,355,11,52,UCBPlayer
29144,UCBPlayer,122,227,349,20,57,UCBPlayer
29145,UCBPlayer,109,259,368,15,49,UCBPlayer
29146,UCBPlayer,118,218,336,16,60,UCBPlayer
29147,UCBPlayer,117,267,384,19,45,UCBPlayer
29148,UCBPlayer,110,210,320,12,64,UCBPlayer
29149,UCBPlayer,126,271,397,23,42,UCBPlayer
29150,UCBPlayer,105,210,315,10,65,UCBPlayer
29151,UCBPlayer,130,275,405,25,40,UCBPlayer
29152,UCBPlayer,105,210,315,10,65,UCBPlayer
29153,UCBPlayer,130,275,405,25,40,UCBPlayer
29154,UCBPlayer,106,206,312,10,66,UCBPlayer
29155,UCBPlayer,130,275,405,25,40,UCBPlayer
29156,UCBPlayer,105,210,315,10,65,UCBPlayer
29157,UCBPlayer,131,271,402,25,41,UCBPlayer
29158,UCBPlayer,105,210,315,10,65,UCBPlayer
29159,UCBPlayer,130,275,405,25,40,UCBPlayer
29160,UCBPlayer,105,210,315,10,65,UCBPlayer
29161,UCBPlayer,130,275,405,25,40,UCBPlayer
29162,UCBPlayer,103,203,306,10,68,UCBPlayer
29163,UCBPlayer,128,283,411,25,38,UCBPlayer
29164,UCBPlayer,111,186,297,10,71,UCBPlayer
29165,UCBPlayer,124,299,423,25,34,UCBPlayer
29166,UCBPlayer,115,170,285,10,75,UCBPlayer
29167,UCBPlayer,120,315,435,25,30,UCBPlayer
29168,UCBPlayer,119,154,273,10,79,UCBPlayer
29169,UCBPlayer,112,332,444,25,27,UCBPlayer
29170,UCBPlayer,127,137,264,10,82,UCBPlayer
29171,UCBPlayer,104,349,453,25,24,UCBPlayer
29172,UCBPlayer,126,126,252,7,85,Tie
29173,UCBPlayer,111,351,462,28,22,UCBPlayer
29174,UCBPlayer,116,126,242,3,87,UCBPlayer
29175,UCBPlayer,122,347,469,32,21,UCBPlayer
29176,UCBPlayer,107,132,239,0,87,UCBPlayer
29177,UCBPlayer,132,337,469,35,22,UCBPlayer
29178,UCBPlayer,103,148,251,0,83,UCBPlayer
29179,UCBPlayer,136,321,457,35,26,UCBPlayer
29180,UCBPlayer,99,164,263,0,79,UCBPlayer
29181,UCBPlayer,140,305,445,35,30,UCBPlayer
29182,UCBPlayer,95,180,275,0,75,UCBPlayer
29183,UCBPlayer,144,289,433,35,34,UCBPlayer
29184,UCBPlayer,91,196,287,0,71,UCBPlayer
29185,UCBPlayer,148,273,421,35,38,UCBPlayer
29186,UCBPlayer,87,212,299,0,67,UCBPlayer
29187,UCBPlayer,152,257,409,35,42,UCBPlayer
29188,UCBPlayer,84,224,308,0,64,UCBPlayer
29189,UCBPlayer,146,251,397,32,45,UCBPlayer
29190,UCBPlayer,89,234,323,3,60,UCBPlayer
29191,UCBPlayer,138,243,381,28,49,UCBPlayer
29192,UCBPlayer,97,242,339,7,56,UCBPlayer
29193,UCBPlayer,130,235,365,24,53,UCBPlayer
29194,UCBPlayer,105,250,355,11,52,UCBPlayer
29195,UCBPlayer,122,227,349,20,57,UCBPlayer
29196,UCBPlayer,109,259,368,15,49,UCBPlayer
29197,UCBPlayer,118,218,336,16,60,UCBPlayer
29198,UCBPlayer,117,267,384,19,45,UCBPlayer
29199,UCBPlayer,110,210,320,12,64,UCBPlayer
29200,UCBPlayer,126,271,397,23,42,UCBPlayer
29201,UCBPlayer,105,210,315,10,65,UCBPlayer
29202,UCBPlayer,130,275,405,25,40,UCBPlayer
29203,UCBPlayer,105,210,315,10,65,UCBPlayer
29204,UCBPlayer,130,275,405,25,40,UCBPlayer
29205,UCBPlayer,106,206,312,10,66,UCBPlayer
29206,UCBPlayer,130,275,405,25,40,UCBPlayer
29207,UCBPlayer,105,210,315,10,65,UCBPlayer
29208,UCBPlayer,131,271,402,25,41,UCBPlayer
29209,UCBPlayer,105,210,315,10,65,UCBPlayer
29210,UCBPlayer,130,275,405,25,40,UCBPlayer
29211,UCBPlayer,105,210,315,10,65,UCBPlayer
29212,UCBPlayer,130,275,405,25,40,UCBPlayer
29213,UCBPlayer,103,203,306,10,68,UCBPlayer
29214,UCBPlayer,128,283,411,25,38,UCBPlayer
29215,UCBPlayer,111,186,297,10,71,UCBPlayer
29216,UCBPlayer,124,299,423,25,34,UCBPlayer
29217,UCBPlayer,115,170,285,10,75,UCBPlayer
29218,UCBPlayer,120,315,435,25,30,UCBPlayer
29219,UCBPlayer,119,154,273,10,79,UCBPlayer
29220,UCBPlayer,112,332,444,25,27,UCBPlayer
29221,UCBPlayer,127,137,264,10,82,UCBPlayer
29222,UCBPlayer,104,349,453,25,24,UCBPlayer
29223,UCBPlayer,126,126,252,7,85,Tie
29224,UCBPlayer,111,351,462,28,22,UCBPlayer
29225,UCBPlayer,116,126,242,3,87,UCBPlayer
29226,UCBPlayer,122,347,469,32,21,UCBPlayer
29227,UCBPlayer,107,132,239,0,87,UCBPlayer
29228,UCBPlayer,132,337,469,35,22,UCBPlayer
29229,UCBPlayer,103,148,251,0,83,UCBPlayer
29230,UCBPlayer,136,321,457,35,26,UCBPlayer
29231,UCBPlayer,99,164,263,0,79,UCBPlayer
29232,UCBPlayer,140,305,445,35,30,UCBPlayer
29233,UCBPlayer,95,180,275,0,75,UCBPlayer
29234,UCBPlayer,144,289,433,35,34,UCBPlayer
29235,UCBPlayer,91,196,287,0,71,UCBPlayer
29236,UCBPlayer,148,273,421,35,38,UCBPlayer
29237,UCBPlayer,87,212,299,0,67,UCBPlayer
29238,UCBPlayer,152,257,409,35,42,UCBPlayer
29239,UCBPlayer,84,224,308,0,64,UCBPlayer
29240,UCBPlayer,146,251,397,32,45,UCBPlayer
29241,UCBPlayer,89,234,323,3,60,UCBPlayer
29242,UCBPlayer,138,243,381,28,49,UCBPlayer
29243,UCBPlayer,97,242,339,7,56,UCBPlayer
29244,UCBPlayer,130,235,365,24,53,UCBPlayer
29245,UCBPlayer,105,250,355,11,52,UCBPlayer
29246,UCBPlayer,122,227,349,20,57,UCBPlayer
29247,UCBPlayer,109,259,368,15,49,UCBPlayer
29248,UCBPlayer,118,218,336,16,60,UCBPlayer
29249,UCBPlayer,117,267,384,19,45,UCBPlayer
29250,UCBPlayer,110,210,320,12,64,UCBPlayer
29251,UCBPlayer,126,271,397,23,42,UCBPlayer
29252,UCBPlayer,105,210,315,10,65,UCBPlayer
29253,UCBPlayer,130,275,405,25,40,UCBPlayer
29254,UCBPlayer,105,210,315,10,65,UCBPlayer
29255,UCBPlayer,130,275,405,25,40,UCBPlayer
29256,UCBPlayer,106,206,312,10,66,UCBPlayer
29257,UCBPlayer,130,275,405,25,40,UCBPlayer
29258,UCBPlayer,105,210,315,10,65,UCBPlayer
29259,UCBPlayer,131,271,402,25,41,UCBPlayer
29260,UCBPlayer,105,210,315,10,65,UCBPlayer
29261,UCBPlayer,130,275,405,25,40,UCBPlayer
29262,UCBPlayer,105,210,315,10,65,UCBPlayer
29263,UCBPlayer,130,275,405,25,40,UCBPlayer
29264,UCBPlayer,103,203,306,10,68,UCBPlayer
29265,UCBPlayer,128,283,411,25,38,UCBPlayer
29266,UCBPlayer,111,186,297,10,71,UCBPlayer
29267,UCBPlayer,124,299,423,25,34,UCBPlayer
29268,UCBPlayer,115,170,285,10,75,UCBPlayer
29269,UCBPlayer,120,315,435,25,30,UCBPlayer
29270,UCBPlayer,119,154,273,10,79,UCBPlayer
29271,UCBPlayer,112,332,444,25,27,UCBPlayer
29272,UCBPlayer,127,137,264,10,82,UCBPlayer
29273,UCBPlayer,104,349,453,25,24,UCBPlayer
29274,UCBPlayer,126,126,252,7,85,Tie
29275,UCBPlayer,111,351,462,28,22,UCBPlayer
29276,UCBPlayer,116,126,242,3,87,UCBPlayer
29277,UCBPlayer,122,347,469,32,21,UCBPlayer
29278,UCBPlayer,107,132,239,0,87,UCBPlayer
29279,UCBPlayer,132,337,469,35,22,UCBPlayer
29280,UCBPlayer,103,148,251,0,83,UCBPlayer
29281,UCBPlayer,136,321,457,35,26,UCBPlayer
29282,UCBPlayer,99,164,263,0,79,UCBPlayer
29283,UCBPlayer,140,305,445,35,30,UCBPlayer
29284,UCBPlayer,95,180,275,0,75,UCBPlayer
29285,UCBPlayer,144,289,433,35,34,UCBPlayer
29286,UCBPlayer,91,196,287,0,71,UCBPlayer
29287,UCBPlayer,148,273,421,35,38,UCBPlayer
29288,UCBPlayer,87,212,299,0,67,UCBPlayer
29289,UCBPlayer,152,257,409,35,42,UCBPlayer
29290,UCBPlayer,84,224,308,0,64,UCBPlayer
29291,UCBPlayer,146,251,397,32,45,UCBPlayer
29292,UCBPlayer,89,234,323,3,60,UCBPlayer
29293,UCBPlayer,138,243,381,28,49,UCBPlayer
29294,UCBPlayer,97,242,339,7,56,UCBPlayer
29295,UCBPlayer,130,235,365,24,53,UCBPlayer
29296,UCBPlayer,105,250,355,11,52,UCBPlayer
29297,UCBPlayer,122,227,349,20,57,UCBPlayer
29298,UCBPlayer,109,259,368,15,49,UCBPlayer
29299,UCBPlayer,118,218,336,16,60,UCBPlayer
29300,UCBPlayer,117,267,384,19,45,UCBPlayer
29301,UCBPlayer,110,210,320,12,64,UCBPlayer
29302,UCBPlayer,126,271,397,23,42,UCBPlayer
29303,UCBPlayer,105,210,315,10,65,UCBPlayer
29304,UCBPlayer,130,275,405,25,40,UCBPlayer
29305,UCBPlayer,105,210,315,10,65,UCBPlayer
29306,UCBPlayer,130,275,405,25,40,UCBPlayer
29307,UCBPlayer,106,206,312,10,66,UCBPlayer
29308,UCBPlayer,130,275,405,25,40,UCBPlayer
29309,UCBPlayer,105,210,315,10,65,UCBPlayer
29310,UCBPlayer,131,271,402,25,41,UCBPlayer
29311,UCBPlayer,105,210,315,10,65,UCBPlayer
29312,UCBPlayer,130,275,405,25,40,UCBPlayer
29313,UCBPlayer,105,210,315,10,65,UCBPlayer
29314,UCBPlayer,130,275,405,25,40,UCBPlayer
29315,UCBPlayer,103,203,306,10,68,UCBPlayer
29316,UCBPlayer,128,283,411,25,38,UCBPlayer
29317,UCBPlayer,111,186,297,10,71,UCBPlayer
29318,UCBPlayer,124,299,423,25,34,UCBPlayer
29319,UCBPlayer,115,170,285,10,75,UCBPlayer
29320,UCBPlayer,120,315,435,25,30,UCBPlayer
29321,UCBPlayer,119,154,273,10,79,UCBPlayer
29322,UCBPlayer,112,332,444,25,27,UCBPlayer
29323,UCBPlayer,127,137,264,10,82,UCBPlayer
29324,UCBPlayer,104,349,453,25,24,UCBPlayer
29325,UCBPlayer,126,126,252,7,85,Tie
29326,UCBPlayer,111,351,462,28,22,UCBPlayer
29327,UCBPlayer,116,126,242,3,87,UCBPlayer
29328,UCBPlayer,122,347,469,32,21,UCBPlayer
29329,UCBPlayer,107,132,239,0,87,UCBPlayer
29330,UCBPlayer,132,337,469,35,22,UCBPlayer
29331,UCBPlayer,103,148,251,0,83,UCBPlayer
29332,UCBPlayer,136,321,457,35,26,UCBPlayer
29333,UCBPlayer,99,164,263,0,79,UCBPlayer
29334,UCBPlayer,140,305,445,35,30,UCBPlayer
29335,UCBPlayer,95,180,275,0,75,UCBPlayer
29336,UCBPlayer,144,289,433,35,34,UCBPlayer
29337,UCBPlayer,91,196,287,0,71,UCBPlayer
29338,UCBPlayer,148,273,421,35,38,UCBPlayer
29339,UCBPlayer,87,212,299,0,67,UCBPlayer
29340,UCBPlayer,152,257,409,35,42,UCBPlayer
29341,UCBPlayer,84,224,308,0,64,UCBPlayer
29342,UCBPlayer,146,251,397,32,45,UCBPlayer
29343,UCBPlayer,89,234,323,3,60,UCBPlayer
29344,UCBPlayer,138,243,381,28,49,UCBPlayer
29345,UCBPlayer,97,242,339,7,56,UCBPlayer
29346,UCBPlayer,130,235,365,24,53,UCBPlayer
29347,UCBPlayer,105,250,355,11,52,UCBPlayer
29348,UCBPlayer,122,227,349,20,57,UCBPlayer
29349,UCBPlayer,109,259,368,15,49,UCBPlayer
29350,UCBPlayer,118,218,336,16,60,UCBPlayer
29351,UCBPlayer,117,267,384,19,45,UCBPlayer
29352,UCBPlayer,110,210,320,12,64,UCBPlayer
29353,UCBPlayer,126,271,397,23,42,UCBPlayer
29354,UCBPlayer,105,210,315,10,65,UCBPlayer
29355,UCBPlayer,130,275,405,25,40,UCBPlayer
29356,UCBPlayer,105,210,315,10,65,UCBPlayer
29357,UCBPlayer,130,275,405,25,40,UCBPlayer
29358,UCBPlayer,106,206,312,10,66,UCBPlayer
29359,UCBPlayer,130,275,405,25,40,UCBPlayer
29360,UCBPlayer,105,210,315,10,65,UCBPlayer
29361,UCBPlayer,131,271,402,25,41,UCBPlayer
29362,UCBPlayer,105,210,315,10,65,UCBPlayer
29363,UCBPlayer,130,275,405,25,40,UCBPlayer
29364,UCBPlayer,105,210,315,10,65,UCBPlayer
29365,UCBPlayer,130,275,405,25,40,UCBPlayer
29366,UCBPlayer,103,203,306,10,68,UCBPlayer
29367,UCBPlayer,128,283,411,25,38,UCBPlayer
29368,UCBPlayer,111,186,297,10,71,UCBPlayer
29369,UCBPlayer,124,299,423,25,34,UCBPlayer
29370,UCBPlayer,115,170,285,10,75,UCBPlayer
29371,UCBPlayer,120,315,435,25,30,UCBPlayer
29372,UCBPlayer,119,154,273,10,79,UCBPlayer
29373,UCBPlayer,112,332,444,25,27,UCBPlayer
29374,UCBPlayer,127,137,264,10,82,UCBPlayer
29375,UCBPlayer,104,349,453,25,24,UCBPlayer
29376,UCBPlayer,126,126,252,7,85,Tie
29377,UCBPlayer,111,351,462,28,22,UCBPlayer
29378,UCBPlayer,116,126,242,3,87,UCBPlayer
29379,UCBPlayer,122,347,469,32,21,UCBPlayer
29380,UCBPlayer,107,132,239,0,87,UCBPlayer
29381,UCBPlayer,132,337,469,35,22,UCBPlayer
29382,UCBPlayer,103,148,251,0,83,UCBPlayer
29383,UCBPlayer,136,321,457,35,26,UCBPlayer
29384,UCBPlayer,99,164,263,0,79,UCBPlayer
29385,UCBPlayer,140,305,445,35,30,UCBPlayer
29386,UCBPlayer,95,180,275,0,75,UCBPlayer
29387,UCBPlayer,144,289,433,35,34,UCBPlayer
29388,UCBPlayer,91,196,287,0,71,UCBPlayer
29389,UCBPlayer,148,273,421,35,38,UCBPlayer
29390,UCBPlayer,87,212,299,0,67,UCBPlayer
29391,UCBPlayer,152,257,409,35,42,UCBPlayer
29392,UCBPlayer,84,224,308,0,64,UCBPlayer
29393,UCBPlayer,146,251,397,32,45,UCBPlayer
29394,UCBPlayer,89,234,323,3,60,UCBPlayer
29395,UCBPlayer,138,243,381,28,49,UCBPlayer
29396,UCBPlayer,97,242,339,7,56,UCBPlayer
29397,UCBPlayer,130,235,365,24,53,UCBPlayer
29398,UCBPlayer,105,250,355,11,52,UCBPlayer
29399,UCBPlayer,122,227,349,20,57,UCBPlayer
29400,UCBPlayer,109,259,368,15,49,UCBPlayer
29401,UCBPlayer,118,218,336,16,60,UCBPlayer
29402,UCBPlayer,117,267,384,19,45,UCBPlayer
29403,UCBPlayer,110,210,320,12,64,UCBPlayer
29404,UCBPlayer,126,271,397,23,42,UCBPlayer
29405,UCBPlayer,105,210,315,10,65,UCBPlayer
29406,UCBPlayer,130,275,405,25,40,UCBPlayer
29407,UCBPlayer,105,210,315,10,65,UCBPlayer
29408,UCBPlayer,130,275,405,25,40,UCBPlayer
29409,UCBPlayer,106,206,312,10,66,UCBPlayer
29410,UCBPlayer,130,275,405,25,40,UCBPlayer
29411,UCBPlayer,105,210,315,10,65,UCBPlayer
29412,UCBPlayer,131,271,402,25,41,UCBPlayer
29413,UCBPlayer,105,210,315,10,65,UCBPlayer
29414,UCBPlayer,130,275,405,25,40,UCBPlayer
29415,UCBPlayer,105,210,315,10,65,UCBPlayer
29416,UCBPlayer,130,275,405,25,40,UCBPlayer
29417,UCBPlayer,103,203,306,10,68,UCBPlayer
29418,UCBPlayer,128,283,411,25,38,UCBPlayer
29419,UCBPlayer,111,186,297,10,71,UCBPlayer
29420,UCBPlayer,124,299,423,25,34,UCBPlayer
29421,UCBPlayer,115,170,285,10,75,UCBPlayer
29422,UCBPlayer,120,315,435,25,30,UCBPlayer
29423,UCBPlayer,119,154,273,10,79,UCBPlayer
29424,UCBPlayer,112,332,444,25,27,UCBPlayer
29425,UCBPlayer,127,137,264,10,82,UCBPlayer
29426,UCBPlayer,104,349,453,25,24,UCBPlayer
29427,UCBPlayer,126,126,252,7,85,Tie
29428,UCBPlayer,111,351,462,28,22,UCBPlayer
29429,UCBPlayer,116,126,242,3,87,UCBPlayer
29430,UCBPlayer,122,347,469,32,21,UCBPlayer
29431,UCBPlayer,107,132,239,0,87,UCBPlayer
29432,UCBPlayer,132,337,469,35,22,UCBPlayer
29433,UCBPlayer,103,148,251,0,83,UCBPlayer
29434,UCBPlayer,136,321,457,35,26,UCBPlayer
29435,UCBPlayer,99,164,263,0,79,UCBPlayer
29436,UCBPlayer,140,305,445,35,30,UCBPlayer
29437,UCBPlayer,95,180,275,0,75,UCBPlayer
29438,UCBPlayer,144,289,433,35,34,UCBPlayer
29439,UCBPlayer,91,196,287,0,71,UCBPlayer
29440,UCBPlayer,148,273,421,35,38,UCBPlayer
29441,UCBPlayer,87,212,299,0,67,UCBPlayer
29442,UCBPlayer,152,257,409,35,42,UCBPlayer
29443,UCBPlayer,84,224,308,0,64,UCBPlayer
29444,UCBPlayer,146,251,397,32,45,UCBPlayer
29445,UCBPlayer,89,234,323,3,60,UCBPlayer
29446,UCBPlayer,138,243,381,28,49,UCBPlayer
29447,UCBPlayer,97,242,339,7,56,UCBPlayer
29448,UCBPlayer,130,235,365,24,53,UCBPlayer
29449,UCBPlayer,105,250,355,11,52,UCBPlayer
29450,UCBPlayer,122,227,349,20,57,UCBPlayer
29451,UCBPlayer,109,259,368,15,49,UCBPlayer
29452,UCBPlayer,118,218,336,16,60,UCBPlayer
29453,UCBPlayer,117,267,384,19,45,UCBPlayer
29454,UCBPlayer,110,210,320,12,64,UCBPlayer
29455,UCBPlayer,126,271,397,23,42,UCBPlayer
29456,UCBPlayer,105,210,315,10,65,UCBPlayer
29457,UCBPlayer,130,275,405,25,40,UCBPlayer
29458,UCBPlayer,105,210,315,10,65,UCBPlayer
29459,UCBPlayer,130,275,405,25,40,UCBPlayer
29460,UCBPlayer,106,206,312,10,66,UCBPlayer
29461,UCBPlayer,130,275,405,25,40,UCBPlayer
29462,UCBPlayer,105,210,315,10,65,UCBPlayer
29463,UCBPlayer,131,271,402,25,41,UCBPlayer
29464,UCBPlayer,105,210,315,10,65,UCBPlayer
29465,UCBPlayer,130,275,405,25,40,UCBPlayer
29466,UCBPlayer,105,210,315,10,65,UCBPlayer
29467,UCBPlayer,130,275,405,25,40,UCBPlayer
29468,UCBPlayer,103,203,306,10,68,UCBPlayer
29469,UCBPlayer,128,283,411,25,38,UCBPlayer
29470,UCBPlayer,111,186,297,10,71,UCBPlayer
29471,UCBPlayer,124,299,423,25,34,UCBPlayer
29472,UCBPlayer,115,170,285,10,75,UCBPlayer
29473,UCBPlayer,120,315,435,25,30,UCBPlayer
29474,UCBPlayer,119,154,273,10,79,UCBPlayer
29475,UCBPlayer,112,332,444,25,27,UCBPlayer
29476,UCBPlayer,127,137,264,10,82,UCBPlayer
29477,UCBPlayer,104,349,453,25,24,UCBPlayer
29478,UCBPlayer,126,126,252,7,85,Tie
29479,UCBPlayer,111,351,462,28,22,UCBPlayer
29480,UCBPlayer,116,126,242,3,87,UCBPlayer
29481,UCBPlayer,122,347,469,32,21,UCBPlayer
29482,UCBPlayer,107,132,239,0,87,UCBPlayer
29483,UCBPlayer,132,337,469,35,22,UCBPlayer
29484,UCBPlayer,103,148,251,0,83,UCBPlayer
29485,UCBPlayer,136,321,457,35,26,UCBPlayer
29486,UCBPlayer,99,164,263,0,79,UCBPlayer
29487,UCBPlayer,140,305,445,35,30,UCBPlayer
29488,UCBPlayer,95,180,275,0,75,UCBPlayer
29489,UCBPlayer,144,289,433,35,34,UCBPlayer
29490,UCBPlayer,91,196,287,0,71,UCBPlayer
29491,UCBPlayer,148,273,421,35,38,UCBPlayer
29492,UCBPlayer,87,212,299,0,67,UCBPlayer
29493,UCBPlayer,152,257,409,35,42,UCBPlayer
29494,UCBPlayer,84,224,308,0,64,UCBPlayer
29495,UCBPlayer,146,251,397,32,45,UCBPlayer
29496,UCBPlayer,89,234,323,3,60,UCBPlayer
29497,UCBPlayer,138,243,381,28,49,UCBPlayer
29498,UCBPlayer,97,242,339,7,56,UCBPlayer
29499,UCBPlayer,130,235,365,24,53,UCBPlayer
29500,UCBPlayer,105,250,355,11,52,UCBPlayer
29501,UCBPlayer,122,227,349,20,57,UCBPlayer
29502,UCBPlayer,109,259,368,15,49,UCBPlayer
29503,UCBPlayer,118,218,336,16,60,UCBPlayer
29504,UCBPlayer,117,267,384,19,45,UCBPlayer
29505,UCBPlayer,110,210,320,12,64,UCBPlayer
29506,UCBPlayer,126,271,397,23,42,UCBPlayer
29507,UCBPlayer,105,210,315,10,65,UCBPlayer
29508,UCBPlayer,130,275,405,25,40,UCBPlayer
29509,UCBPlayer,105,210,315,10,65,UCBPlayer
29510,UCBPlayer,130,275,405,25,40,UCBPlayer
29511,UCBPlayer,106,206,312,10,66,UCBPlayer
29512,UCBPlayer,130,275,405,25,40,UCBPlayer
29513,UCBPlayer,105,210,315,10,65,UCBPlayer
29514,UCBPlayer,131,271,402,25,41,UCBPlayer
29515,UCBPlayer,105,210,315,10,65,UCBPlayer
29516,UCBPlayer,130,275,405,25,40,UCBPlayer
29517,UCBPlayer,105,210,315,10,65,UCBPlayer
29518,UCBPlayer,130,275,405,25,40,UCBPlayer
29519,UCBPlayer,103,203,306,10,68,UCBPlayer
29520,UCBPlayer,128,283,411,25,38,UCBPlayer
29521,UCBPlayer,111,186,297,10,71,UCBPlayer
29522,UCBPlayer,124,299,423,25,34,UCBPlayer
29523,UCBPlayer,115,170,285,10,75,UCBPlayer
29524,UCBPlayer,120,315,435,25,30,UCBPlayer
29525,UCBPlayer,119,154,273,10,79,UCBPlayer
29526,UCBPlayer,112,332,444,25,27,UCBPlayer
29527,UCBPlayer,127,137,264,10,82,UCBPlayer
29528,UCBPlayer,104,349,453,25,24,UCBPlayer
29529,UCBPlayer,126,126,252,7,85,Tie
29530,UCBPlayer,111,351,462,28,22,UCBPlayer
29531,UCBPlayer,116,126,242,3,87,UCBPlayer
29532,UCBPlayer,122,347,469,32,21,UCBPlayer
29533,UCBPlayer,107,132,239,0,87,UCBPlayer
29534,UCBPlayer,132,337,469,35,22,UCBPlayer
29535,UCBPlayer,103,148,251,0,83,UCBPlayer
29536,UCBPlayer,136,321,457,35,26,UCBPlayer
29537,UCBPlayer,99,164,263,0,79,UCBPlayer
29538,UCBPlayer,140,305,445,35,30,UCBPlayer
29539,UCBPlayer,95,180,275,0,75,UCBPlayer
29540,UCBPlayer,144,289,433,35,34,UCBPlayer
29541,UCBPlayer,91,196,287,0,71,UCBPlayer
29542,UCBPlayer,148,273,421,35,38,UCBPlayer
29543,UCBPlayer,87,212,299,0,67,UCBPlayer
29544,UCBPlayer,152,257,409,35,42,UCBPlayer
29545,UCBPlayer,84,224,308,0,64,UCBPlayer
29546,UCBPlayer,146,251,397,32,45,UCBPlayer
29547,UCBPlayer,89,234,323,3,60,UCBPlayer
29548,UCBPlayer,138,243,381,28,49,UCBPlayer
29549,UCBPlayer,97,242,339,7,56,UCBPlayer
29550,UCBPlayer,130,235,365,24,53,UCBPlayer
29551,UCBPlayer,105,250,355,11,52,UCBPlayer
29552,UCBPlayer,122,227,349,20,57,UCBPlayer
29553,UCBPlayer,109,259,368,15,49,UCBPlayer
29554,UCBPlayer,118,218,336,16,60,UCBPlayer
29555,UCBPlayer,117,267,384,19,45,UCBPlayer
29556,UCBPlayer,110,210,320,12,64,UCBPlayer
29557,UCBPlayer,126,271,397,23,42,UCBPlayer
29558,UCBPlayer,105,210,315,10,65,UCBPlayer
29559,UCBPlayer,130,275,405,25,40,UCBPlayer
29560,UCBPlayer,105,210,315,10,65,UCBPlayer
29561,UCBPlayer,130,275,405,25,40,UCBPlayer
29562,UCBPlayer,106,206,312,10,66,UCBPlayer
29563,UCBPlayer,130,275,405,25,40,UCBPlayer
29564,UCBPlayer,105,210,315,10,65,UCBPlayer
29565,UCBPlayer,131,271,402,25,41,UCBPlayer
29566,UCBPlayer,105,210,315,10,65,UCBPlayer
29567,UCBPlayer,130,275,405,25,40,UCBPlayer
29568,UCBPlayer,105,210,315,10,65,UCBPlayer
29569,UCBPlayer,130,275,405,25,40,UCBPlayer
29570,UCBPlayer,103,203,306,10,68,UCBPlayer
29571,UCBPlayer,128,283,411,25,38,UCBPlayer
29572,UCBPlayer,111,186,297,10,71,UCBPlayer
29573,UCBPlayer,124,299,423,25,34,UCBPlayer
29574,UCBPlayer,115,170,285,10,75,UCBPlayer
29575,UCBPlayer,120,315,435,25,30,UCBPlayer
29576,UCBPlayer,119,154,273,10,79,UCBPlayer
29577,UCBPlayer,112,332,444,25,27,UCBPlayer
29578,UCBPlayer,127,137,264,10,82,UCBPlayer
29579,UCBPlayer,104,349,453,25,24,UCBPlayer
29580,UCBPlayer,126,126,252,7,85,Tie
29581,UCBPlayer,111,351,462,28,22,UCBPlayer
29582,UCBPlayer,116,126,242,3,87,UCBPlayer
29583,UCBPlayer,122,347,469,32,21,UCBPlayer
29584,UCBPlayer,107,132,239,0,87,UCBPlayer
29585,UCBPlayer,132,337,469,35,22,UCBPlayer
29586,UCBPlayer,103,148,251,0,83,UCBPlayer
29587,UCBPlayer,136,321,457,35,26,UCBPlayer
29588,UCBPlayer,99,164,263,0,79,UCBPlayer
29589,UCBPlayer,140,305,445,35,30,UCBPlayer
29590,UCBPlayer,95,180,275,0,75,UCBPlayer
29591,UCBPlayer,144,289,433,35,34,UCBPlayer
29592,UCBPlayer,91,196,287,0,71,UCBPlayer
29593,UCBPlayer,148,273,421,35,38,UCBPlayer
29594,UCBPlayer,87,212,299,0,67,UCBPlayer
29595,UCBPlayer,152,257,409,35,42,UCBPlayer
29596,UCBPlayer,84,224,308,0,64,UCBPlayer
29597,UCBPlayer,146,251,397,32,45,UCBPlayer
29598,UCBPlayer,89,234,323,3,60,UCBPlayer
29599,UCBPlayer,138,243,381,28,49,UCBPlayer
29600,UCBPlayer,97,242,339,7,56,UCBPlayer
29601,UCBPlayer,130,235,365,24,53,UCBPlayer
29602,UCBPlayer,105,250,355,11,52,UCBPlayer
29603,UCBPlayer,122,227,349,20,57,UCBPlayer
29604,UCBPlayer,109,259,368,15,49,UCBPlayer
29605,UCBPlayer,118,218,336,16,60,UCBPlayer
29606,UCBPlayer,117,267,384,19,45,UCBPlayer
29607,UCBPlayer,110,210,320,12,64,UCBPlayer
29608,UCBPlayer,126,271,397,23,42,UCBPlayer
29609,UCBPlayer,105,210,315,10,65,UCBPlayer
29610,UCBPlayer,130,275,405,25,40,UCBPlayer
29611,UCBPlayer,105,210,315,10,65,UCBPlayer
29612,UCBPlayer,130,275,405,25,40,UCBPlayer
29613,UCBPlayer,106,206,312,10,66,UCBPlayer
29614,UCBPlayer,130,275,405,25,40,UCBPlayer
29615,UCBPlayer,105,210,315,10,65,UCBPlayer
29616,UCBPlayer,131,271,402,25,41,UCBPlayer
29617,UCBPlayer,105,210,315,10,65,UCBPlayer
29618,UCBPlayer,130,275,405,25,40,UCBPlayer
29619,UCBPlayer,105,210,315,10,65,UCBPlayer
29620,UCBPlayer,130,275,405,25,40,UCBPlayer
29621,UCBPlayer,103,203,306,10,68,UCBPlayer
29622,UCBPlayer,128,283,411,25,38,UCBPlayer
29623,UCBPlayer,111,186,297,10,71,UCBPlayer
29624,UCBPlayer,124,299,423,25,34,UCBPlayer
29625,UCBPlayer,115,170,285,10,75,UCBPlayer
29626,UCBPlayer,120,315,435,25,30,UCBPlayer
29627,UCBPlayer,119,154,273,10,79,UCBPlayer
29628,UCBPlayer,112,332,444,25,27,UCBPlayer
29629,UCBPlayer,127,137,264,10,82,UCBPlayer
29630,UCBPlayer,104,349,453,25,24,UCBPlayer
29631,UCBPlayer,126,126,252,7,85,Tie
29632,UCBPlayer,111,351,462,28,22,UCBPlayer
29633,UCBPlayer,116,126,242,3,87,UCBPlayer
29634,UCBPlayer,122,347,469,32,21,UCBPlayer
29635,UCBPlayer,107,132,239,0,87,UCBPlayer
29636,UCBPlayer,132,337,469,35,22,UCBPlayer
29637,UCBPlayer,103,148,251,0,83,UCBPlayer
29638,UCBPlayer,136,321,457,35,26,UCBPlayer
29639,UCBPlayer,99,164,263,0,79,UCBPlayer
29640,UCBPlayer,140,305,445,35,30,UCBPlayer
29641,UCBPlayer,95,180,275,0,75,UCBPlayer
29642,UCBPlayer,144,289,433,35,34,UCBPlayer
29643,UCBPlayer,91,196,287,0,71,UCBPlayer
29644,UCBPlayer,148,273,421,35,38,UCBPlayer
29645,UCBPlayer,87,212,299,0,67,UCBPlayer
29646,UCBPlayer,152,257,409,35,42,UCBPlayer
29647,UCBPlayer,84,224,308,0,64,UCBPlayer
29648,UCBPlayer,146,251,397,32,45,UCBPlayer
29649,UCBPlayer,89,234,323,3,60,UCBPlayer
29650,UCBPlayer,138,243,381,28,49,UCBPlayer
29651,UCBPlayer,97,242,339,7,56,UCBPlayer
29652,UCBPlayer,130,235,365,24,53,UCBPlayer
29653,UCBPlayer,105,250,355,11,52,UCBPlayer
29654,UCBPlayer,122,227,349,20,57,UCBPlayer
29655,UCBPlayer,109,259,368,15,49,UCBPlayer
29656,UCBPlayer,118,218,336,16,60,UCBPlayer
29657,UCBPlayer,117,267,384,19,45,UCBPlayer
29658,UCBPlayer,110,210,320,12,64,UCBPlayer
29659,UCBPlayer,126,271,397,23,42,UCBPlayer
29660,UCBPlayer,105,210,315,10,65,UCBPlayer
29661,UCBPlayer,130,275,405,25,40,UCBPlayer
29662,UCBPlayer,105,210,315,10,65,UCBPlayer
29663,UCBPlayer,130,275,405,25,40,UCBPlayer
29664,UCBPlayer,106,206,312,10,66,UCBPlayer
29665,UCBPlayer,130,275,405,25,40,UCBPlayer
29666,UCBPlayer,105,210,315,10,65,UCBPlayer
29667,UCBPlayer,131,271,402,25,41,UCBPlayer
29668,UCBPlayer,105,210,315,10,65,UCBPlayer
29669,UCBPlayer,130,275,405,25,40,UCBPlayer
29670,UCBPlayer,105,210,315,10,65,UCBPlayer
29671,UCBPlayer,130,275,405,25,40,UCBPlayer
29672,UCBPlayer,103,203,306,10,68,UCBPlayer
29673,UCBPlayer,128,283,411,25,38,UCBPlayer
29674,UCBPlayer,111,186,297,10,71,UCBPlayer
29675,UCBPlayer,124,299,423,25,34,UCBPlayer
29676,UCBPlayer,115,170,285,10,75,UCBPlayer
29677,UCBPlayer,120,315,435,25,30,UCBPlayer
29678,UCBPlayer,119,154,273,10,79,UCBPlayer
29679,UCBPlayer,112,332,444,25,27,UCBPlayer
29680,UCBPlayer,127,137,264,10,82,UCBPlayer
29681,UCBPlayer,104,349,453,25,24,UCBPlayer
29682,UCBPlayer,126,126,252,7,85,Tie
29683,UCBPlayer,111,351,462,28,22,UCBPlayer
29684,UCBPlayer,116,126,242,3,87,UCBPlayer
29685,UCBPlayer,122,347,469,32,21,UCBPlayer
29686,UCBPlayer,107,132,239,0,87,UCBPlayer
29687,UCBPlayer,132,337,469,35,22,UCBPlayer
29688,UCBPlayer,103,148,251,0,83,UCBPlayer
29689,UCBPlayer,136,321,457,35,26,UCBPlayer
29690,UCBPlayer,99,164,263,0,79,UCBPlayer
29691,UCBPlayer,140,305,445,35,30,UCBPlayer
29692,UCBPlayer,95,180,275,0,75,UCBPlayer
29693,UCBPlayer,144,289,433,35,34,UCBPlayer
29694,UCBPlayer,91,196,287,0,71,UCBPlayer
29695,UCBPlayer,148,273,421,35,38,UCBPlayer
29696,UCBPlayer,87,212,299,0,67,UCBPlayer
29697,UCBPlayer,152,257,409,35,42,UCBPlayer
29698,UCBPlayer,84,224,308,0,64,UCBPlayer
29699,UCBPlayer,146,251,397,32,45,UCBPlayer
29700,UCBPlayer,89,234,323,3,60,UCBPlayer
29701,UCBPlayer,138,243,381,28,49,UCBPlayer
29702,UCBPlayer,97,242,339,7,56,UCBPlayer
29703,UCBPlayer,130,235,365,24,53,UCBPlayer
29704,UCBPlayer,105,250,355,11,52,UCBPlayer
29705,UCBPlayer,122,227,349,20,57,UCBPlayer
29706,UCBPlayer,109,259,368,15,49,UCBPlayer
29707,UCBPlayer,118,218,336,16,60,UCBPlayer
29708,UCBPlayer,117,267,384,19,45,UCBPlayer
29709,UCBPlayer,110,210,320,12,64,UCBPlayer
29710,UCBPlayer,126,271,397,23,42,UCBPlayer
29711,UCBPlayer,105,210,315,10,65,UCBPlayer
29712,UCBPlayer,130,275,405,25,40,UCBPlayer
29713,UCBPlayer,105,210,315,10,65,UCBPlayer
29714,UCBPlayer,130,275,405,25,40,UCBPlayer
29715,UCBPlayer,106,206,312,10,66,UCBPlayer
29716,UCBPlayer,130,275,405,25,40,UCBPlayer
29717,UCBPlayer,105,210,315,10,65,UCBPlayer
29718,UCBPlayer,131,271,402,25,41,UCBPlayer
29719,UCBPlayer,105,210,315,10,65,UCBPlayer
29720,UCBPlayer,130,275,405,25,40,UCBPlayer
29721,UCBPlayer,105,210,315,10,65,UCBPlayer
29722,UCBPlayer,130,275,405,25,40,UCBPlayer
29723,UCBPlayer,103,203,306,10,68,UCBPlayer
29724,UCBPlayer,128,283,411,25,38,UCBPlayer
29725,UCBPlayer,111,186,297,10,71,UCBPlayer
29726,UCBPlayer,124,299,423,25,34,UCBPlayer
29727,UCBPlayer,115,170,285,10,75,UCBPlayer
29728,UCBPlayer,120,315,435,25,30,UCBPlayer
29729,UCBPlayer,119,154,273,10,79,UCBPlayer
29730,UCBPlayer,112,332,444,25,27,UCBPlayer
29731,UCBPlayer,127,137,264,10,82,UCBPlayer
29732,UCBPlayer,104,349,453,25,24,UCBPlayer
29733,UCBPlayer,126,126,252,7,85,Tie
29734,UCBPlayer,111,351,462,28,22,UCBPlayer
29735,UCBPlayer,116,126,242,3,87,UCBPlayer
29736,UCBPlayer,122,347,469,32,21,UCBPlayer
29737,UCBPlayer,107,132,239,0,87,UCBPlayer
29738,UCBPlayer,132,337,469,35,22,UCBPlayer
29739,UCBPlayer,103,148,251,0,83,UCBPlayer
29740,UCBPlayer,136,321,457,35,26,UCBPlayer
29741,UCBPlayer,99,164,263,0,79,UCBPlayer
29742,UCBPlayer,140,305,445,35,30,UCBPlayer
29743,UCBPlayer,95,180,275,0,75,UCBPlayer
29744,UCBPlayer,144,289,433,35,34,UCBPlayer
29745,UCBPlayer,91,196,287,0,71,UCBPlayer
29746,UCBPlayer,148,273,421,35,38,UCBPlayer
29747,UCBPlayer,87,212,299,0,67,UCBPlayer
29748,UCBPlayer,152,257,409,35,42,UCBPlayer
29749,UCBPlayer,84,224,308,0,64,UCBPlayer
29750,UCBPlayer,146,251,397,32,45,UCBPlayer
29751,UCBPlayer,89,234,323,3,60,UCBPlayer
29752,UCBPlayer,138,243,381,28,49,UCBPlayer
29753,UCBPlayer,97,242,339,7,56,UCBPlayer
29754,UCBPlayer,130,235,365,24,53,UCBPlayer
29755,UCBPlayer,105,250,355,11,52,UCBPlayer
29756,UCBPlayer,122,227,349,20,57,UCBPlayer
29757,UCBPlayer,109,259,368,15,49,UCBPlayer
29758,UCBPlayer,118,218,336,16,60,UCBPlayer
29759,UCBPlayer,117,267,384,19,45,UCBPlayer
29760,UCBPlayer,110,210,320,12,64,UCBPlayer
29761,UCBPlayer,126,271,397,23,42,UCBPlayer
29762,UCBPlayer,105,210,315,10,65,UCBPlayer
29763,UCBPlayer,130,275,405,25,40,UCBPlayer
29764,UCBPlayer,105,210,315,10,65,UCBPlayer
29765,UCBPlayer,130,275,405,25,40,UCBPlayer
29766,UCBPlayer,106,206,312,10,66,UCBPlayer
29767,UCBPlayer,130,275,405,25,40,UCBPlayer
29768,UCBPlayer,105,210,315,10,65,UCBPlayer
29769,UCBPlayer,131,271,402,25,41,UCBPlayer
29770,UCBPlayer,105,210,315,10,65,UCBPlayer
29771,UCBPlayer,130,275,405,25,40,UCBPlayer
29772,UCBPlayer,105,210,315,10,65,UCBPlayer
29773,UCBPlayer,130,275,405,25,40,UCBPlayer
29774,UCBPlayer,103,203,306,10,68,UCBPlayer
29775,UCBPlayer,128,283,411,25,38,UCBPlayer
29776,UCBPlayer,111,186,297,10,71,UCBPlayer
29777,UCBPlayer,124,299,423,25,34,UCBPlayer
29778,UCBPlayer,115,170,285,10,75,UCBPlayer
29779,UCBPlayer,120,315,435,25,30,UCBPlayer
29780,UCBPlayer,119,154,273,10,79,UCBPlayer
29781,UCBPlayer,112,332,444,25,27,UCBPlayer
29782,UCBPlayer,127,137,264,10,82,UCBPlayer
29783,UCBPlayer,104,349,453,25,24,UCBPlayer
29784,UCBPlayer,126,126,252,7,85,Tie
29785,UCBPlayer,111,351,462,28,22,UCBPlayer
29786,UCBPlayer,116,126,242,3,87,UCBPlayer
29787,UCBPlayer,122,347,469,32,21,UCBPlayer
29788,UCBPlayer,107,132,239,0,87,UCBPlayer
29789,UCBPlayer,132,337,469,35,22,UCBPlayer
29790,UCBPlayer,103,148,251,0,83,UCBPlayer
29791,UCBPlayer,136,321,457,35,26,UCBPlayer
29792,UCBPlayer,99,164,263,0,79,UCBPlayer
29793,UCBPlayer,140,305,445,35,30,UCBPlayer
29794,UCBPlayer,95,180,275,0,75,UCBPlayer
29795,UCBPlayer,144,289,433,35,34,UCBPlayer
29796,UCBPlayer,91,196,287,0,71,UCBPlayer
29797,UCBPlayer,148,273,421,35,38,UCBPlayer
29798,UCBPlayer,87,212,299,0,67,UCBPlayer
29799,UCBPlayer,152,257,409,35,42,UCBPlayer
29800,UCBPlayer,84,224,308,0,64,UCBPlayer
29801,UCBPlayer,146,251,397,32,45,UCBPlayer
29802,UCBPlayer,89,234,323,3,60,UCBPlayer
29803,UCBPlayer,138,243,381,28,49,UCBPlayer
29804,UCBPlayer,97,242,339,7,56,UCBPlayer
29805,UCBPlayer,130,235,365,24,53,UCBPlayer
29806,UCBPlayer,105,250,355,11,52,UCBPlayer
29807,UCBPlayer,122,227,349,20,57,UCBPlayer
29808,UCBPlayer,109,259,368,15,49,UCBPlayer
29809,UCBPlayer,118,218,336,16,60,UCBPlayer
29810,UCBPlayer,117,267,384,19,45,UCBPlayer
29811,UCBPlayer,110,210,320,12,64,UCBPlayer
29812,UCBPlayer,126,271,397,23,42,UCBPlayer
29813,UCBPlayer,105,210,315,10,65,UCBPlayer
29814,UCBPlayer,130,275,405,25,40,UCBPlayer
29815,UCBPlayer,105,210,315,10,65,UCBPlayer
29816,UCBPlayer,130,275,405,25,40,UCBPlayer
29817,UCBPlayer,106,206,312,10,66,UCBPlayer
29818,UCBPlayer,130,275,405,25,40,UCBPlayer
29819,UCBPlayer,105,210,315,10,65,UCBPlayer
29820,UCBPlayer,131,271,402,25,41,UCBPlayer
29821,UCBPlayer,105,210,315,10,65,UCBPlayer
29822,UCBPlayer,130,275,405,25,40,UCBPlayer
29823,UCBPlayer,105,210,315,10,65,UCBPlayer
29824,UCBPlayer,130,275,405,25,40,UCBPlayer
29825,UCBPlayer,103,203,306,10,68,UCBPlayer
29826,UCBPlayer,128,283,411,25,38,UCBPlayer
29827,UCBPlayer,111,186,297,10,71,UCBPlayer
29828,UCBPlayer,124,299,423,25,34,UCBPlayer
29829,UCBPlayer,115,170,285,10,75,UCBPlayer
29830,UCBPlayer,120,315,435,25,30,UCBPlayer
29831,UCBPlayer,119,154,273,10,79,UCBPlayer
29832,UCBPlayer,112,332,444,25,27,UCBPlayer
29833,UCBPlayer,127,137,264,10,82,UCBPlayer
29834,UCBPlayer,104,349,453,25,24,UCBPlayer
29835,UCBPlayer,126,126,252,7,85,Tie
29836,UCBPlayer,111,351,462,28,22,UCBPlayer
29837,UCBPlayer,116,126,242,3,87,UCBPlayer
29838,UCBPlayer,122,347,469,32,21,UCBPlayer
29839,UCBPlayer,107,132,239,0,87,UCBPlayer
29840,UCBPlayer,132,337,469,35,22,UCBPlayer
29841,UCBPlayer,103,148,251,0,83,UCBPlayer
29842,UCBPlayer,136,321,457,35,26,UCBPlayer
29843,UCBPlayer,99,164,263,0,79,UCBPlayer
29844,UCBPlayer,140,305,445,35,30,UCBPlayer
29845,UCBPlayer,95,180,275,0,75,UCBPlayer
29846,UCBPlayer,144,289,433,35,34,UCBPlayer
29847,UCBPlayer,91,196,287,0,71,UCBPlayer
29848,UCBPlayer,148,273,421,35,38,UCBPlayer
29849,UCBPlayer,87,212,299,0,67,UCBPlayer
29850,UCBPlayer,152,257,409,35,42,UCBPlayer
29851,UCBPlayer,84,224,308,0,64,UCBPlayer
29852,UCBPlayer,146,251,397,32,45,UCBPlayer
29853,UCBPlayer,89,234,323,3,60,UCBPlayer
29854,UCBPlayer,138,243,381,28,49,UCBPlayer
29855,UCBPlayer,97,242,339,7,56,UCBPlayer
29856,UCBPlayer,130,235,365,24,53,UCBPlayer
29857,UCBPlayer,105,250,355,11,52,UCBPlayer
29858,UCBPlayer,122,227,349,20,57,UCBPlayer
29859,UCBPlayer,109,259,368,15,49,UCBPlayer
29860,UCBPlayer,118,218,336,16,60,UCBPlayer
29861,UCBPlayer,117,267,384,19,45,UCBPlayer
29862,UCBPlayer,110,210,320,12,64,UCBPlayer
29863,UCBPlayer,126,271,397,23,42,UCBPlayer
29864,UCBPlayer,105,210,315,10,65,UCBPlayer
29865,UCBPlayer,130,275,405,25,40,UCBPlayer
29866,UCBPlayer,105,210,315,10,65,UCBPlayer
29867,UCBPlayer,130,275,405,25,40,UCBPlayer
29868,UCBPlayer,106,206,312,10,66,UCBPlayer
29869,UCBPlayer,130,275,405,25,40,UCBPlayer
29870,UCBPlayer,105,210,315,10,65,UCBPlayer
29871,UCBPlayer,131,271,402,25,41,UCBPlayer
29872,UCBPlayer,105,210,315,10,65,UCBPlayer
29873,UCBPlayer,130,275,405,25,40,UCBPlayer
29874,UCBPlayer,105,210,315,10,65,UCBPlayer
29875,UCBPlayer,130,275,405,25,40,UCBPlayer
29876,UCBPlayer,103,203,306,10,68,UCBPlayer
29877,UCBPlayer,128,283,411,25,38,UCBPlayer
29878,UCBPlayer,111,186,297,10,71,UCBPlayer
29879,UCBPlayer,124,299,423,25,34,UCBPlayer
29880,UCBPlayer,115,170,285,10,75,UCBPlayer
29881,UCBPlayer,120,315,435,25,30,UCBPlayer
29882,UCBPlayer,119,154,273,10,79,UCBPlayer
29883,UCBPlayer,112,332,444,25,27,UCBPlayer
29884,UCBPlayer,127,137,264,10,82,UCBPlayer
29885,UCBPlayer,104,349,453,25,24,UCBPlayer
29886,UCBPlayer,126,126,252,7,85,Tie
29887,UCBPlayer,111,351,462,28,22,UCBPlayer
29888,UCBPlayer,116,126,242,3,87,UCBPlayer
29889,UCBPlayer,122,347,469,32,21,UCBPlayer
29890,UCBPlayer,107,132,239,0,87,UCBPlayer
29891,UCBPlayer,132,337,469,35,22,UCBPlayer
29892,UCBPlayer,103,148,251,0,83,UCBPlayer
29893,UCBPlayer,136,321,457,35,26,UCBPlayer
29894,UCBPlayer,99,164,263,0,79,UCBPlayer
29895,UCBPlayer,140,305,445,35,30,UCBPlayer
29896,UCBPlayer,95,180,275,0,75,UCBPlayer
29897,UCBPlayer,144,289,433,35,34,UCBPlayer
29898,UCBPlayer,91,196,287,0,71,UCBPlayer
29899,UCBPlayer,148,273,421,35,38,UCBPlayer
29900,UCBPlayer,87,212,299,0,67,UCBPlayer
29901,UCBPlayer,152,257,409,35,42,UCBPlayer
29902,UCBPlayer,84,224,308,0,64,UCBPlayer
29903,UCBPlayer,146,251,397,32,45,UCBPlayer
29904,UCBPlayer,89,234,323,3,60,UCBPlayer
29905,UCBPlayer,138,243,381,28,49,UCBPlayer
29906,UCBPlayer,97,242,339,7,56,UCBPlayer
29907,UCBPlayer,130,235,365,24,53,UCBPlayer
29908,UCBPlayer,105,250,355,11,52,UCBPlayer
29909,UCBPlayer,122,227,349,20,57,UCBPlayer
29910,UCBPlayer,109,259,368,15,49,UCBPlayer
29911,UCBPlayer,118,218,336,16,60,UCBPlayer
29912,UCBPlayer,117,267,384,19,45,UCBPlayer
29913,UCBPlayer,110,210,320,12,64,UCBPlayer
29914,UCBPlayer,126,271,397,23,42,UCBPlayer
29915,UCBPlayer,105,210,315,10,65,UCBPlayer
29916,UCBPlayer,130,275,405,25,40,UCBPlayer
29917,UCBPlayer,105,210,315,10,65,UCBPlayer
29918,UCBPlayer,130,275,405,25,40,UCBPlayer
29919,UCBPlayer,106,206,312,10,66,UCBPlayer
29920,UCBPlayer,130,275,405,25,40,UCBPlayer
29921,UCBPlayer,105,210,315,10,65,UCBPlayer
29922,UCBPlayer,131,271,402,25,41,UCBPlayer
29923,UCBPlayer,105,210,315,10,65,UCBPlayer
29924,UCBPlayer,130,275,405,25,40,UCBPlayer
29925,UCBPlayer,105,210,315,10,65,UCBPlayer
29926,UCBPlayer,130,275,405,25,40,UCBPlayer
29927,UCBPlayer,103,203,306,10,68,UCBPlayer
29928,UCBPlayer,128,283,411,25,38,UCBPlayer
29929,UCBPlayer,111,186,297,10,71,UCBPlayer
29930,UCBPlayer,124,299,423,25,34,UCBPlayer
29931,UCBPlayer,115,170,285,10,75,UCBPlayer
29932,UCBPlayer,120,315,435,25,30,UCBPlayer
29933,UCBPlayer,119,154,273,10,79,UCBPlayer
29934,UCBPlayer,112,332,444,25,27,UCBPlayer
29935,UCBPlayer,127,137,264,10,82,UCBPlayer
29936,UCBPlayer,104,349,453,25,24,UCBPlayer
29937,UCBPlayer,126,126,252,7,85,Tie
29938,UCBPlayer,111,351,462,28,22,UCBPlayer
29939,UCBPlayer,116,126,242,3,87,UCBPlayer
29940,UCBPlayer,122,347,469,32,21,UCBPlayer
29941,UCBPlayer,107,132,239,0,87,UCBPlayer
29942,UCBPlayer,132,337,469,35,22,UCBPlayer
29943,UCBPlayer,103,148,251,0,83,UCBPlayer
29944,UCBPlayer,136,321,457,35,26,UCBPlayer
29945,UCBPlayer,99,164,263,0,79,UCBPlayer
29946,UCBPlayer,140,305,445,35,30,UCBPlayer
29947,UCBPlayer,95,180,275,0,75,UCBPlayer
29948,UCBPlayer,144,289,433,35,34,UCBPlayer
29949,UCBPlayer,91,196,287,0,71,UCBPlayer
29950,UCBPlayer,148,273,421,35,38,UCBPlayer
29951,UCBPlayer,87,212,299,0,67,UCBPlayer
29952,UCBPlayer,152,257,409,35,42,UCBPlayer
29953,UCBPlayer,84,224,308,0,64,UCBPlayer
29954,UCBPlayer,146,251,397,32,45,UCBPlayer
29955,UCBPlayer,89,234,323,3,60,UCBPlayer
29956,UCBPlayer,138,243,381,28,49,UCBPlayer
29957,UCBPlayer,97,242,339,7,56,UCBPlayer
29958,UCBPlayer,130,235,365,24,53,UCBPlayer
29959,UCBPlayer,105,250,355,11,52,UCBPlayer
29960,UCBPlayer,122,227,349,20,57,UCBPlayer
29961,UCBPlayer,109,259,368,15,49,UCBPlayer
29962,UCBPlayer,118,218,336,16,60,UCBPlayer
29963,UCBPlayer,117,267,384,19,45,UCBPlayer
29964,UCBPlayer,110,210,320,12,64,UCBPlayer
29965,UCBPlayer,126,271,397,23,42,UCBPlayer
29966,UCBPlayer,105,210,315,10,65,UCBPlayer
29967,UCBPlayer,130,275,405,25,40,UCBPlayer
29968,UCBPlayer,105,210,315,10,65,UCBPlayer
29969,UCBPlayer,130,275,405,25,40,UCBPlayer
29970,UCBPlayer,106,206,312,10,66,UCBPlayer
29971,UCBPlayer,130,275,405,25,40,UCBPlayer
29972,UCBPlayer,105,210,315,10,65,UCBPlayer
29973,UCBPlayer,131,271,402,25,41,UCBPlayer
29974,UCBPlayer,105,210,315,10,65,UCBPlayer
29975,UCBPlayer,130,275,405,25,40,UCBPlayer
29976,UCBPlayer,105,210,315,10,65,UCBPlayer
29977,UCBPlayer,130,275,405,25,40,UCBPlayer
29978,UCBPlayer,103,203,306,10,68,UCBPlayer
29979,UCBPlayer,128,283,411,25,38,UCBPlayer
29980,UCBPlayer,111,186,297,10,71,UCBPlayer
29981,UCBPlayer,124,299,423,25,34,UCBPlayer
29982,UCBPlayer,115,170,285,10,75,UCBPlayer
29983,UCBPlayer,120,315,435,25,30,UCBPlayer
29984,UCBPlayer,119,154,273,10,79,UCBPlayer
29985,UCBPlayer,112,332,444,25,27,UCBPlayer
29986,UCBPlayer,127,137,264,10,82,UCBPlayer
29987,UCBPlayer,104,349,453,25,24,UCBPlayer
29988,UCBPlayer,126,126,252,7,85,Tie
29989,UCBPlayer,111,351,462,28,22,UCBPlayer
29990,UCBPlayer,116,126,242,3,87,UCBPlayer
29991,UCBPlayer,122,347,469,32,21,UCBPlayer
29992,UCBPlayer,107,132,239,0,87,UCBPlayer
29993,UCBPlayer,132,337,469,35,22,UCBPlayer
29994,UCBPlayer,103,148,251,0,83,UCBPlayer
29995,UCBPlayer,136,321,457,35,26,UCBPlayer
29996,UCBPlayer,99,164,263,0,79,UCBPlayer
29997,UCBPlayer,140,305,445,35,30,UCBPlayer
29998,UCBPlayer,95,180,275,0,75,UCBPlayer
29999,UCBPlayer,144,289,433,35,34,UCBPlayer
30000,UCBPlayer,91,196,287,0,71,UCBPlayer
30001,UCBPlayer,148,273,421,35,38,UCBPlayer
30002,UCBPlayer,87,212,299,0,67,UCBPlayer
30003,UCBPlayer,152,257,409,35,42,UCBPlayer
30004,UCBPlayer,84,224,308,0,64,UCBPlayer
30005,UCBPlayer,146,251,397,32,45,UCBPlayer
30006,UCBPlayer,89,234,323,3,60,UCBPlayer
30007,UCBPlayer,138,243,381,28,49,UCBPlayer
30008,UCBPlayer,97,242,339,7,56,UCBPlayer
30009,UCBPlayer,130,235,365,24,53,UCBPlayer
30010,UCBPlayer,105,250,355,11,52,UCBPlayer
30011,UCBPlayer,122,227,349,20,57,UCBPlayer
30012,UCBPlayer,109,259,368,15,49,UCBPlayer
30013,UCBPlayer,118,218,336,16,60,UCBPlayer
30014,UCBPlayer,117,267,384,19,45,UCBPlayer
30015,UCBPlayer,110,210,320,12,64,UCBPlayer
30016,UCBPlayer,126,271,397,23,42,UCBPlayer
30017,UCBPlayer,105,210,315,10,65,UCBPlayer
30018,UCBPlayer,130,275,405,25,40,UCBPlayer
30019,UCBPlayer,105,210,315,10,65,UCBPlayer
30020,UCBPlayer,130,275,405,25,40,UCBPlayer
30021,UCBPlayer,106,206,312,10,66,UCBPlayer
30022,UCBPlayer,130,275,405,25,40,UCBPlayer
30023,UCBPlayer,105,210,315,10,65,UCBPlayer
30024,UCBPlayer,131,271,402,25,41,UCBPlayer
30025,UCBPlayer,105,210,315,10,65,UCBPlayer
30026,UCBPlayer,130,275,405,25,40,UCBPlayer
30027,UCBPlayer,105,210,315,10,65,UCBPlayer
30028,UCBPlayer,130,275,405,25,40,UCBPlayer
30029,UCBPlayer,103,203,306,10,68,UCBPlayer
30030,UCBPlayer,128,283,411,25,38,UCBPlayer
30031,UCBPlayer,111,186,297,10,71,UCBPlayer
30032,UCBPlayer,124,299,423,25,34,UCBPlayer
30033,UCBPlayer,115,170,285,10,75,UCBPlayer
30034,UCBPlayer,120,315,435,25,30,UCBPlayer
30035,UCBPlayer,119,154,273,10,79,UCBPlayer
30036,UCBPlayer,112,332,444,25,27,UCBPlayer
30037,UCBPlayer,127,137,264,10,82,UCBPlayer
30038,UCBPlayer,104,349,453,25,24,UCBPlayer
30039,UCBPlayer,126,126,252,7,85,Tie
30040,UCBPlayer,111,351,462,28,22,UCBPlayer
30041,UCBPlayer,116,126,242,3,87,UCBPlayer
30042,UCBPlayer,122,347,469,32,21,UCBPlayer
30043,UCBPlayer,107,132,239,0,87,UCBPlayer
30044,UCBPlayer,132,337,469,35,22,UCBPlayer
30045,UCBPlayer,103,148,251,0,83,UCBPlayer
30046,UCBPlayer,136,321,457,35,26,UCBPlayer
30047,UCBPlayer,99,164,263,0,79,UCBPlayer
30048,UCBPlayer,140,305,445,35,30,UCBPlayer
30049,UCBPlayer,95,180,275,0,75,UCBPlayer
30050,UCBPlayer,144,289,433,35,34,UCBPlayer
30051,UCBPlayer,91,196,287,0,71,UCBPlayer
30052,UCBPlayer,148,273,421,35,38,UCBPlayer
30053,UCBPlayer,87,212,299,0,67,UCBPlayer
30054,UCBPlayer,152,257,409,35,42,UCBPlayer
30055,UCBPlayer,84,224,308,0,64,UCBPlayer
30056,UCBPlayer,146,251,397,32,45,UCBPlayer
30057,UCBPlayer,89,234,323,3,60,UCBPlayer
30058,UCBPlayer,138,243,381,28,49,UCBPlayer
30059,UCBPlayer,97,242,339,7,56,UCBPlayer
30060,UCBPlayer,130,235,365,24,53,UCBPlayer
30061,UCBPlayer,105,250,355,11,52,UCBPlayer
30062,UCBPlayer,122,227,349,20,57,UCBPlayer
30063,UCBPlayer,109,259,368,15,49,UCBPlayer
30064,UCBPlayer,118,218,336,16,60,UCBPlayer
30065,UCBPlayer,117,267,384,19,45,UCBPlayer
30066,UCBPlayer,110,210,320,12,64,UCBPlayer
30067,UCBPlayer,126,271,397,23,42,UCBPlayer
30068,UCBPlayer,105,210,315,10,65,UCBPlayer
30069,UCBPlayer,130,275,405,25,40,UCBPlayer
30070,UCBPlayer,105,210,315,10,65,UCBPlayer
30071,UCBPlayer,130,275,405,25,40,UCBPlayer
30072,UCBPlayer,106,206,312,10,66,UCBPlayer
30073,UCBPlayer,130,275,405,25,40,UCBPlayer
30074,UCBPlayer,105,210,315,10,65,UCBPlayer
30075,UCBPlayer,131,271,402,25,41,UCBPlayer
30076,UCBPlayer,105,210,315,10,65,UCBPlayer
30077,UCBPlayer,130,275,405,25,40,UCBPlayer
30078,UCBPlayer,105,210,315,10,65,UCBPlayer
30079,UCBPlayer,130,275,405,25,40,UCBPlayer
30080,UCBPlayer,103,203,306,10,68,UCBPlayer
30081,UCBPlayer,128,283,411,25,38,UCBPlayer
30082,UCBPlayer,111,186,297,10,71,UCBPlayer
30083,UCBPlayer,124,299,423,25,34,UCBPlayer
30084,UCBPlayer,115,170,285,10,75,UCBPlayer
30085,UCBPlayer,120,315,435,25,30,UCBPlayer
30086,UCBPlayer,119,154,273,10,79,UCBPlayer
30087,UCBPlayer,112,332,444,25,27,UCBPlayer
30088,UCBPlayer,127,137,264,10,82,UCBPlayer
30089,UCBPlayer,104,349,453,25,24,UCBPlayer
30090,UCBPlayer,126,126,252,7,85,Tie
30091,UCBPlayer,111,351,462,28,22,UCBPlayer
30092,UCBPlayer,116,126,242,3,87,UCBPlayer
30093,UCBPlayer,122,347,469,32,21,UCBPlayer
30094,UCBPlayer,107,132,239,0,87,UCBPlayer
30095,UCBPlayer,132,337,469,35,22,UCBPlayer
30096,UCBPlayer,103,148,251,0,83,UCBPlayer
30097,UCBPlayer,136,321,457,35,26,UCBPlayer
30098,UCBPlayer,99,164,263,0,79,UCBPlayer
30099,UCBPlayer,140,305,445,35,30,UCBPlayer
30100,UCBPlayer,95,180,275,0,75,UCBPlayer
30101,UCBPlayer,144,289,433,35,34,UCBPlayer
30102,UCBPlayer,91,196,287,0,71,UCBPlayer
30103,UCBPlayer,148,273,421,35,38,UCBPlayer
30104,UCBPlayer,87,212,299,0,67,UCBPlayer
30105,UCBPlayer,152,257,409,35,42,UCBPlayer
30106,UCBPlayer,84,224,308,0,64,UCBPlayer
30107,UCBPlayer,146,251,397,32,45,UCBPlayer
30108,UCBPlayer,89,234,323,3,60,UCBPlayer
30109,UCBPlayer,138,243,381,28,49,UCBPlayer
30110,UCBPlayer,97,242,339,7,56,UCBPlayer
30111,UCBPlayer,130,235,365,24,53,UCBPlayer
30112,UCBPlayer,105,250,355,11,52,UCBPlayer
30113,UCBPlayer,122,227,349,20,57,UCBPlayer
30114,UCBPlayer,109,259,368,15,49,UCBPlayer
30115,UCBPlayer,118,218,336,16,60,UCBPlayer
30116,UCBPlayer,117,267,384,19,45,UCBPlayer
30117,UCBPlayer,110,210,320,12,64,UCBPlayer
30118,UCBPlayer,126,271,397,23,42,UCBPlayer
30119,UCBPlayer,105,210,315,10,65,UCBPlayer
30120,UCBPlayer,130,275,405,25,40,UCBPlayer
30121,UCBPlayer,105,210,315,10,65,UCBPlayer
30122,UCBPlayer,130,275,405,25,40,UCBPlayer
30123,UCBPlayer,106,206,312,10,66,UCBPlayer
30124,UCBPlayer,130,275,405,25,40,UCBPlayer
30125,UCBPlayer,105,210,315,10,65,UCBPlayer
30126,UCBPlayer,131,271,402,25,41,UCBPlayer
30127,UCBPlayer,105,210,315,10,65,UCBPlayer
30128,UCBPlayer,130,275,405,25,40,UCBPlayer
30129,UCBPlayer,105,210,315,10,65,UCBPlayer
30130,UCBPlayer,130,275,405,25,40,UCBPlayer
30131,UCBPlayer,103,203,306,10,68,UCBPlayer
30132,UCBPlayer,128,283,411,25,38,UCBPlayer
30133,UCBPlayer,111,186,297,10,71,UCBPlayer
30134,UCBPlayer,124,299,423,25,34,UCBPlayer
30135,UCBPlayer,115,170,285,10,75,UCBPlayer
30136,UCBPlayer,120,315,435,25,30,UCBPlayer
30137,UCBPlayer,119,154,273,10,79,UCBPlayer
30138,UCBPlayer,112,332,444,25,27,UCBPlayer
30139,UCBPlayer,127,137,264,10,82,UCBPlayer
30140,UCBPlayer,104,349,453,25,24,UCBPlayer
30141,UCBPlayer,126,126,252,7,85,Tie
30142,UCBPlayer,111,351,462,28,22,UCBPlayer
30143,UCBPlayer,116,126,242,3,87,UCBPlayer
30144,UCBPlayer,122,347,469,32,21,UCBPlayer
30145,UCBPlayer,107,132,239,0,87,UCBPlayer
30146,UCBPlayer,132,337,469,35,22,UCBPlayer
30147,UCBPlayer,103,148,251,0,83,UCBPlayer
30148,UCBPlayer,136,321,457,35,26,UCBPlayer
30149,UCBPlayer,99,164,263,0,79,UCBPlayer
30150,UCBPlayer,140,305,445,35,30,UCBPlayer
30151,UCBPlayer,95,180,275,0,75,UCBPlayer
30152,UCBPlayer,144,289,433,35,34,UCBPlayer
30153,UCBPlayer,91,196,287,0,71,UCBPlayer
30154,UCBPlayer,148,273,421,35,38,UCBPlayer
30155,UCBPlayer,87,212,299,0,67,UCBPlayer
30156,UCBPlayer,152,257,409,35,42,UCBPlayer
30157,UCBPlayer,84,224,308,0,64,UCBPlayer
30158,UCBPlayer,146,251,397,32,45,UCBPlayer
30159,UCBPlayer,89,234,323,3,60,UCBPlayer
30160,UCBPlayer,138,243,381,28,49,UCBPlayer
30161,UCBPlayer,97,242,339,7,56,UCBPlayer
30162,UCBPlayer,130,235,365,24,53,UCBPlayer
30163,UCBPlayer,105,250,355,11,52,UCBPlayer
30164,UCBPlayer,122,227,349,20,57,UCBPlayer
30165,UCBPlayer,109,259,368,15,49,UCBPlayer
30166,UCBPlayer,118,218,336,16,60,UCBPlayer
30167,UCBPlayer,117,267,384,19,45,UCBPlayer
30168,UCBPlayer,110,210,320,12,64,UCBPlayer
30169,UCBPlayer,126,271,397,23,42,UCBPlayer
30170,UCBPlayer,105,210,315,10,65,UCBPlayer
30171,UCBPlayer,130,275,405,25,40,UCBPlayer
30172,UCBPlayer,105,210,315,10,65,UCBPlayer
30173,UCBPlayer,130,275,405,25,40,UCBPlayer
30174,UCBPlayer,106,206,312,10,66,UCBPlayer
30175,UCBPlayer,130,275,405,25,40,UCBPlayer
30176,UCBPlayer,105,210,315,10,65,UCBPlayer
30177,UCBPlayer,131,271,402,25,41,UCBPlayer
30178,UCBPlayer,105,210,315,10,65,UCBPlayer
30179,UCBPlayer,130,275,405,25,40,UCBPlayer
30180,UCBPlayer,105,210,315,10,65,UCBPlayer
30181,UCBPlayer,130,275,405,25,40,UCBPlayer
30182,UCBPlayer,103,203,306,10,68,UCBPlayer
30183,UCBPlayer,128,283,411,25,38,UCBPlayer
30184,UCBPlayer,111,186,297,10,71,UCBPlayer
30185,UCBPlayer,124,299,423,25,34,UCBPlayer
30186,UCBPlayer,115,170,285,10,75,UCBPlayer
30187,UCBPlayer,120,315,435,25,30,UCBPlayer
30188,UCBPlayer,119,154,273,10,79,UCBPlayer
30189,UCBPlayer,112,332,444,25,27,UCBPlayer
30190,UCBPlayer,127,137,264,10,82,UCBPlayer
30191,UCBPlayer,104,349,453,25,24,UCBPlayer
30192,UCBPlayer,126,126,252,7,85,Tie
30193,UCBPlayer,111,351,462,28,22,UCBPlayer
30194,UCBPlayer,116,126,242,3,87,UCBPlayer
30195,UCBPlayer,122,347,469,32,21,UCBPlayer
30196,UCBPlayer,107,132,239,0,87,UCBPlayer
30197,UCBPlayer,132,337,469,35,22,UCBPlayer
30198,UCBPlayer,103,148,251,0,83,UCBPlayer
30199,UCBPlayer,136,321,457,35,26,UCBPlayer
30200,UCBPlayer,99,164,263,0,79,UCBPlayer
30201,UCBPlayer,140,305,445,35,30,UCBPlayer
30202,UCBPlayer,95,180,275,0,75,UCBPlayer
30203,UCBPlayer,144,289,433,35,34,UCBPlayer
30204,UCBPlayer,91,196,287,0,71,UCBPlayer
30205,UCBPlayer,148,273,421,35,38,UCBPlayer
30206,UCBPlayer,87,212,299,0,67,UCBPlayer
30207,UCBPlayer,152,257,409,35,42,UCBPlayer
30208,UCBPlayer,84,224,308,0,64,UCBPlayer
30209,UCBPlayer,146,251,397,32,45,UCBPlayer
30210,UCBPlayer,89,234,323,3,60,UCBPlayer
30211,UCBPlayer,138,243,381,28,49,UCBPlayer
30212,UCBPlayer,97,242,339,7,56,UCBPlayer
30213,UCBPlayer,130,235,365,24,53,UCBPlayer
30214,UCBPlayer,105,250,355,11,52,UCBPlayer
30215,UCBPlayer,122,227,349,20,57,UCBPlayer
30216,UCBPlayer,109,259,368,15,49,UCBPlayer
30217,UCBPlayer,118,218,336,16,60,UCBPlayer
30218,UCBPlayer,117,267,384,19,45,UCBPlayer
30219,UCBPlayer,110,210,320,12,64,UCBPlayer
30220,UCBPlayer,126,271,397,23,42,UCBPlayer
30221,UCBPlayer,105,210,315,10,65,UCBPlayer
30222,UCBPlayer,130,275,405,25,40,UCBPlayer
30223,UCBPlayer,105,210,315,10,65,UCBPlayer
30224,UCBPlayer,130,275,405,25,40,UCBPlayer
30225,UCBPlayer,106,206,312,10,66,UCBPlayer
30226,UCBPlayer,130,275,405,25,40,UCBPlayer
30227,UCBPlayer,105,210,315,10,65,UCBPlayer
30228,UCBPlayer,131,271,402,25,41,UCBPlayer
30229,UCBPlayer,105,210,315,10,65,UCBPlayer
30230,UCBPlayer,130,275,405,25,40,UCBPlayer
30231,UCBPlayer,105,210,315,10,65,UCBPlayer
30232,UCBPlayer,130,275,405,25,40,UCBPlayer
30233,UCBPlayer,103,203,306,10,68,UCBPlayer
30234,UCBPlayer,128,283,411,25,38,UCBPlayer
30235,UCBPlayer,111,186,297,10,71,UCBPlayer
30236,UCBPlayer,124,299,423,25,34,UCBPlayer
30237,UCBPlayer,115,170,285,10,75,UCBPlayer
30238,UCBPlayer,120,315,435,25,30,UCBPlayer
30239,UCBPlayer,119,154,273,10,79,UCBPlayer
30240,UCBPlayer,112,332,444,25,27,UCBPlayer
30241,UCBPlayer,127,137,264,10,82,UCBPlayer
30242,UCBPlayer,104,349,453,25,24,UCBPlayer
30243,UCBPlayer,126,126,252,7,85,Tie
30244,UCBPlayer,111,351,462,28,22,UCBPlayer
30245,UCBPlayer,116,126,242,3,87,UCBPlayer
30246,UCBPlayer,122,347,469,32,21,UCBPlayer
30247,UCBPlayer,107,132,239,0,87,UCBPlayer
30248,UCBPlayer,132,337,469,35,22,UCBPlayer
30249,UCBPlayer,103,148,251,0,83,UCBPlayer
30250,UCBPlayer,136,321,457,35,26,UCBPlayer
30251,UCBPlayer,99,164,263,0,79,UCBPlayer
30252,UCBPlayer,140,305,445,35,30,UCBPlayer
30253,UCBPlayer,95,180,275,0,75,UCBPlayer
30254,UCBPlayer,144,289,433,35,34,UCBPlayer
30255,UCBPlayer,91,196,287,0,71,UCBPlayer
30256,UCBPlayer,148,273,421,35,38,UCBPlayer
30257,UCBPlayer,87,212,299,0,67,UCBPlayer
30258,UCBPlayer,152,257,409,35,42,UCBPlayer
30259,UCBPlayer,84,224,308,0,64,UCBPlayer
30260,UCBPlayer,146,251,397,32,45,UCBPlayer
30261,UCBPlayer,89,234,323,3,60,UCBPlayer
30262,UCBPlayer,138,243,381,28,49,UCBPlayer
30263,UCBPlayer,97,242,339,7,56,UCBPlayer
30264,UCBPlayer,130,235,365,24,53,UCBPlayer
30265,UCBPlayer,105,250,355,11,52,UCBPlayer
30266,UCBPlayer,122,227,349,20,57,UCBPlayer
30267,UCBPlayer,109,259,368,15,49,UCBPlayer
30268,UCBPlayer,118,218,336,16,60,UCBPlayer
30269,UCBPlayer,117,267,384,19,45,UCBPlayer
30270,UCBPlayer,110,210,320,12,64,UCBPlayer
30271,UCBPlayer,126,271,397,23,42,UCBPlayer
30272,UCBPlayer,105,210,315,10,65,UCBPlayer
30273,UCBPlayer,130,275,405,25,40,UCBPlayer
30274,UCBPlayer,105,210,315,10,65,UCBPlayer
30275,UCBPlayer,130,275,405,25,40,UCBPlayer
30276,UCBPlayer,106,206,312,10,66,UCBPlayer
30277,UCBPlayer,130,275,405,25,40,UCBPlayer
30278,UCBPlayer,105,210,315,10,65,UCBPlayer
30279,UCBPlayer,131,271,402,25,41,UCBPlayer
30280,UCBPlayer,105,210,315,10,65,UCBPlayer
30281,UCBPlayer,130,275,405,25,40,UCBPlayer
30282,UCBPlayer,105,210,315,10,65,UCBPlayer
30283,UCBPlayer,130,275,405,25,40,UCBPlayer
30284,UCBPlayer,103,203,306,10,68,UCBPlayer
30285,UCBPlayer,128,283,411,25,38,UCBPlayer
30286,UCBPlayer,111,186,297,10,71,UCBPlayer
30287,UCBPlayer,124,299,423,25,34,UCBPlayer
30288,UCBPlayer,115,170,285,10,75,UCBPlayer
30289,UCBPlayer,120,315,435,25,30,UCBPlayer
30290,UCBPlayer,119,154,273,10,79,UCBPlayer
30291,UCBPlayer,112,332,444,25,27,UCBPlayer
30292,UCBPlayer,127,137,264,10,82,UCBPlayer
30293,UCBPlayer,104,349,453,25,24,UCBPlayer
30294,UCBPlayer,126,126,252,7,85,Tie
30295,UCBPlayer,111,351,462,28,22,UCBPlayer
30296,UCBPlayer,116,126,242,3,87,UCBPlayer
30297,UCBPlayer,122,347,469,32,21,UCBPlayer
30298,UCBPlayer,107,132,239,0,87,UCBPlayer
30299,UCBPlayer,132,337,469,35,22,UCBPlayer
30300,UCBPlayer,103,148,251,0,83,UCBPlayer
30301,UCBPlayer,136,321,457,35,26,UCBPlayer
30302,UCBPlayer,99,164,263,0,79,UCBPlayer
30303,UCBPlayer,140,305,445,35,30,UCBPlayer
30304,UCBPlayer,95,180,275,0,75,UCBPlayer
30305,UCBPlayer,144,289,433,35,34,UCBPlayer
30306,UCBPlayer,91,196,287,0,71,UCBPlayer
30307,UCBPlayer,148,273,421,35,38,UCBPlayer
30308,UCBPlayer,87,212,299,0,67,UCBPlayer
30309,UCBPlayer,152,257,409,35,42,UCBPlayer
30310,UCBPlayer,84,224,308,0,64,UCBPlayer
30311,UCBPlayer,146,251,397,32,45,UCBPlayer
30312,UCBPlayer,89,234,323,3,60,UCBPlayer
30313,UCBPlayer,138,243,381,28,49,UCBPlayer
30314,UCBPlayer,97,242,339,7,56,UCBPlayer
30315,UCBPlayer,130,235,365,24,53,UCBPlayer
30316,UCBPlayer,105,250,355,11,52,UCBPlayer
30317,UCBPlayer,122,227,349,20,57,UCBPlayer
30318,UCBPlayer,109,259,368,15,49,UCBPlayer
30319,UCBPlayer,118,218,336,16,60,UCBPlayer
30320,UCBPlayer,117,267,384,19,45,UCBPlayer
30321,UCBPlayer,110,210,320,12,64,UCBPlayer
30322,UCBPlayer,126,271,397,23,42,UCBPlayer
30323,UCBPlayer,105,210,315,10,65,UCBPlayer
30324,UCBPlayer,130,275,405,25,40,UCBPlayer
30325,UCBPlayer,105,210,315,10,65,UCBPlayer
30326,UCBPlayer,130,275,405,25,40,UCBPlayer
30327,UCBPlayer,106,206,312,10,66,UCBPlayer
30328,UCBPlayer,130,275,405,25,40,UCBPlayer
30329,UCBPlayer,105,210,315,10,65,UCBPlayer
30330,UCBPlayer,131,271,402,25,41,UCBPlayer
30331,UCBPlayer,105,210,315,10,65,UCBPlayer
30332,UCBPlayer,130,275,405,25,40,UCBPlayer
30333,UCBPlayer,105,210,315,10,65,UCBPlayer
30334,UCBPlayer,130,275,405,25,40,UCBPlayer
30335,UCBPlayer,103,203,306,10,68,UCBPlayer
30336,UCBPlayer,128,283,411,25,38,UCBPlayer
30337,UCBPlayer,111,186,297,10,71,UCBPlayer
30338,UCBPlayer,124,299,423,25,34,UCBPlayer
30339,UCBPlayer,115,170,285,10,75,UCBPlayer
30340,UCBPlayer,120,315,435,25,30,UCBPlayer
30341,UCBPlayer,119,154,273,10,79,UCBPlayer
30342,UCBPlayer,112,332,444,25,27,UCBPlayer
30343,UCBPlayer,127,137,264,10,82,UCBPlayer
30344,UCBPlayer,104,349,453,25,24,UCBPlayer
30345,UCBPlayer,126,126,252,7,85,Tie
30346,UCBPlayer,111,351,462,28,22,UCBPlayer
30347,UCBPlayer,116,126,242,3,87,UCBPlayer
30348,UCBPlayer,122,347,469,32,21,UCBPlayer
30349,UCBPlayer,107,132,239,0,87,UCBPlayer
30350,UCBPlayer,132,337,469,35,22,UCBPlayer
30351,UCBPlayer,103,148,251,0,83,UCBPlayer
30352,UCBPlayer,136,321,457,35,26,UCBPlayer
30353,UCBPlayer,99,164,263,0,79,UCBPlayer
30354,UCBPlayer,140,305,445,35,30,UCBPlayer
30355,UCBPlayer,95,180,275,0,75,UCBPlayer
30356,UCBPlayer,144,289,433,35,34,UCBPlayer
30357,UCBPlayer,91,196,287,0,71,UCBPlayer
30358,UCBPlayer,148,273,421,35,38,UCBPlayer
30359,UCBPlayer,87,212,299,0,67,UCBPlayer
30360,UCBPlayer,152,257,409,35,42,UCBPlayer
30361,UCBPlayer,84,224,308,0,64,UCBPlayer
30362,UCBPlayer,146,251,397,32,45,UCBPlayer
30363,UCBPlayer,89,234,323,3,60,UCBPlayer
30364,UCBPlayer,138,243,381,28,49,UCBPlayer
30365,UCBPlayer,97,242,339,7,56,UCBPlayer
30366,UCBPlayer,130,235,365,24,53,UCBPlayer
30367,UCBPlayer,105,250,355,11,52,UCBPlayer
30368,UCBPlayer,122,227,349,20,57,UCBPlayer
30369,UCBPlayer,109,259,368,15,49,UCBPlayer
30370,UCBPlayer,118,218,336,16,60,UCBPlayer
30371,UCBPlayer,117,267,384,19,45,UCBPlayer
30372,UCBPlayer,110,210,320,12,64,UCBPlayer
30373,UCBPlayer,126,271,397,23,42,UCBPlayer
30374,UCBPlayer,105,210,315,10,65,UCBPlayer
30375,UCBPlayer,130,275,405,25,40,UCBPlayer
30376,UCBPlayer,105,210,315,10,65,UCBPlayer
30377,UCBPlayer,130,275,405,25,40,UCBPlayer
30378,UCBPlayer,106,206,312,10,66,UCBPlayer
30379,UCBPlayer,130,275,405,25,40,UCBPlayer
30380,UCBPlayer,105,210,315,10,65,UCBPlayer
30381,UCBPlayer,131,271,402,25,41,UCBPlayer
30382,UCBPlayer,105,210,315,10,65,UCBPlayer
30383,UCBPlayer,130,275,405,25,40,UCBPlayer
30384,UCBPlayer,105,210,315,10,65,UCBPlayer
30385,UCBPlayer,130,275,405,25,40,UCBPlayer
30386,UCBPlayer,103,203,306,10,68,UCBPlayer
30387,UCBPlayer,128,283,411,25,38,UCBPlayer
30388,UCBPlayer,111,186,297,10,71,UCBPlayer
30389,UCBPlayer,124,299,423,25,34,UCBPlayer
30390,UCBPlayer,115,170,285,10,75,UCBPlayer
30391,UCBPlayer,120,315,435,25,30,UCBPlayer
30392,UCBPlayer,119,154,273,10,79,UCBPlayer
30393,UCBPlayer,112,332,444,25,27,UCBPlayer
30394,UCBPlayer,127,137,264,10,82,UCBPlayer
30395,UCBPlayer,104,349,453,25,24,UCBPlayer
30396,UCBPlayer,126,126,252,7,85,Tie
30397,UCBPlayer,111,351,462,28,22,UCBPlayer
30398,UCBPlayer,116,126,242,3,87,UCBPlayer
30399,UCBPlayer,122,347,469,32,21,UCBPlayer
30400,UCBPlayer,107,132,239,0,87,UCBPlayer
30401,UCBPlayer,132,337,469,35,22,UCBPlayer
30402,UCBPlayer,103,148,251,0,83,UCBPlayer
30403,UCBPlayer,136,321,457,35,26,UCBPlayer
30404,UCBPlayer,99,164,263,0,79,UCBPlayer
30405,UCBPlayer,140,305,445,35,30,UCBPlayer
30406,UCBPlayer,95,180,275,0,75,UCBPlayer
30407,UCBPlayer,144,289,433,35,34,UCBPlayer
30408,UCBPlayer,91,196,287,0,71,UCBPlayer
30409,UCBPlayer,148,273,421,35,38,UCBPlayer
30410,UCBPlayer,87,212,299,0,67,UCBPlayer
30411,UCBPlayer,152,257,409,35,42,UCBPlayer
30412,UCBPlayer,84,224,308,0,64,UCBPlayer
30413,UCBPlayer,146,251,397,32,45,UCBPlayer
30414,UCBPlayer,89,234,323,3,60,UCBPlayer
30415,UCBPlayer,138,243,381,28,49,UCBPlayer
30416,UCBPlayer,97,242,339,7,56,UCBPlayer
30417,UCBPlayer,130,235,365,24,53,UCBPlayer
30418,UCBPlayer,105,250,355,11,52,UCBPlayer
30419,UCBPlayer,122,227,349,20,57,UCBPlayer
30420,UCBPlayer,109,259,368,15,49,UCBPlayer
30421,UCBPlayer,118,218,336,16,60,UCBPlayer
30422,UCBPlayer,117,267,384,19,45,UCBPlayer
30423,UCBPlayer,110,210,320,12,64,UCBPlayer
30424,UCBPlayer,126,271,397,23,42,UCBPlayer
30425,UCBPlayer,105,210,315,10,65,UCBPlayer
30426,UCBPlayer,130,275,405,25,40,UCBPlayer
30427,UCBPlayer,105,210,315,10,65,UCBPlayer
30428,UCBPlayer,130,275,405,25,40,UCBPlayer
30429,UCBPlayer,106,206,312,10,66,UCBPlayer
30430,UCBPlayer,130,275,405,25,40,UCBPlayer
30431,UCBPlayer,105,210,315,10,65,UCBPlayer
30432,UCBPlayer,131,271,402,25,41,UCBPlayer
30433,UCBPlayer,105,210,315,10,65,UCBPlayer
30434,UCBPlayer,130,275,405,25,40,UCBPlayer
30435,UCBPlayer,105,210,315,10,65,UCBPlayer
30436,UCBPlayer,130,275,405,25,40,UCBPlayer
30437,UCBPlayer,103,203,306,10,68,UCBPlayer
30438,UCBPlayer,128,283,411,25,38,UCBPlayer
30439,UCBPlayer,111,186,297,10,71,UCBPlayer
30440,UCBPlayer,124,299,423,25,34,UCBPlayer
30441,UCBPlayer,115,170,285,10,75,UCBPlayer
30442,UCBPlayer,120,315,435,25,30,UCBPlayer
30443,UCBPlayer,119,154,273,10,79,UCBPlayer
30444,UCBPlayer,112,332,444,25,27,UCBPlayer
30445,UCBPlayer,127,137,264,10,82,UCBPlayer
30446,UCBPlayer,104,349,453,25,24,UCBPlayer
30447,UCBPlayer,126,126,252,7,85,Tie
30448,UCBPlayer,111,351,462,28,22,UCBPlayer
30449,UCBPlayer,116,126,242,3,87,UCBPlayer
30450,UCBPlayer,122,347,469,32,21,UCBPlayer
30451,UCBPlayer,107,132,239,0,87,UCBPlayer
30452,UCBPlayer,132,337,469,35,22,UCBPlayer
30453,UCBPlayer,103,148,251,0,83,UCBPlayer
30454,UCBPlayer,136,321,457,35,26,UCBPlayer
30455,UCBPlayer,99,164,263,0,79,UCBPlayer
30456,UCBPlayer,140,305,445,35,30,UCBPlayer
30457,UCBPlayer,95,180,275,0,75,UCBPlayer
30458,UCBPlayer,144,289,433,35,34,UCBPlayer
30459,UCBPlayer,91,196,287,0,71,UCBPlayer
30460,UCBPlayer,148,273,421,35,38,UCBPlayer
30461,UCBPlayer,87,212,299,0,67,UCBPlayer
30462,UCBPlayer,152,257,409,35,42,UCBPlayer
30463,UCBPlayer,84,224,308,0,64,UCBPlayer
30464,UCBPlayer,146,251,397,32,45,UCBPlayer
30465,UCBPlayer,89,234,323,3,60,UCBPlayer
30466,UCBPlayer,138,243,381,28,49,UCBPlayer
30467,UCBPlayer,97,242,339,7,56,UCBPlayer
30468,UCBPlayer,130,235,365,24,53,UCBPlayer
30469,UCBPlayer,105,250,355,11,52,UCBPlayer
30470,UCBPlayer,122,227,349,20,57,UCBPlayer
30471,UCBPlayer,109,259,368,15,49,UCBPlayer
30472,UCBPlayer,118,218,336,16,60,UCBPlayer
30473,UCBPlayer,117,267,384,19,45,UCBPlayer
30474,UCBPlayer,110,210,320,12,64,UCBPlayer
30475,UCBPlayer,126,271,397,23,42,UCBPlayer
30476,UCBPlayer,105,210,315,10,65,UCBPlayer
30477,UCBPlayer,130,275,405,25,40,UCBPlayer
30478,UCBPlayer,105,210,315,10,65,UCBPlayer
30479,UCBPlayer,130,275,405,25,40,UCBPlayer
30480,UCBPlayer,106,206,312,10,66,UCBPlayer
30481,UCBPlayer,130,275,405,25,40,UCBPlayer
30482,UCBPlayer,105,210,315,10,65,UCBPlayer
30483,UCBPlayer,131,271,402,25,41,UCBPlayer
30484,UCBPlayer,105,210,315,10,65,UCBPlayer
30485,UCBPlayer,130,275,405,25,40,UCBPlayer
30486,UCBPlayer,105,210,315,10,65,UCBPlayer
30487,UCBPlayer,130,275,405,25,40,UCBPlayer
30488,UCBPlayer,103,203,306,10,68,UCBPlayer
30489,UCBPlayer,128,283,411,25,38,UCBPlayer
30490,UCBPlayer,111,186,297,10,71,UCBPlayer
30491,UCBPlayer,124,299,423,25,34,UCBPlayer
30492,UCBPlayer,115,170,285,10,75,UCBPlayer
30493,UCBPlayer,120,315,435,25,30,UCBPlayer
30494,UCBPlayer,119,154,273,10,79,UCBPlayer
30495,UCBPlayer,112,332,444,25,27,UCBPlayer
30496,UCBPlayer,127,137,264,10,82,UCBPlayer
30497,UCBPlayer,104,349,453,25,24,UCBPlayer
30498,UCBPlayer,126,126,252,7,85,Tie
30499,UCBPlayer,111,351,462,28,22,UCBPlayer
30500,UCBPlayer,116,126,242,3,87,UCBPlayer
30501,UCBPlayer,122,347,469,32,21,UCBPlayer
30502,UCBPlayer,107,132,239,0,87,UCBPlayer
30503,UCBPlayer,132,337,469,35,22,UCBPlayer
30504,UCBPlayer,103,148,251,0,83,UCBPlayer
30505,UCBPlayer,136,321,457,35,26,UCBPlayer
30506,UCBPlayer,99,164,263,0,79,UCBPlayer
30507,UCBPlayer,140,305,445,35,30,UCBPlayer
30508,UCBPlayer,95,180,275,0,75,UCBPlayer
30509,UCBPlayer,144,289,433,35,34,UCBPlayer
30510,UCBPlayer,91,196,287,0,71,UCBPlayer
30511,UCBPlayer,148,273,421,35,38,UCBPlayer
30512,UCBPlayer,87,212,299,0,67,UCBPlayer
30513,UCBPlayer,152,257,409,35,42,UCBPlayer
30514,UCBPlayer,84,224,308,0,64,UCBPlayer
30515,UCBPlayer,146,251,397,32,45,UCBPlayer
30516,UCBPlayer,89,234,323,3,60,UCBPlayer
30517,UCBPlayer,138,243,381,28,49,UCBPlayer
30518,UCBPlayer,97,242,339,7,56,UCBPlayer
30519,UCBPlayer,130,235,365,24,53,UCBPlayer
30520,UCBPlayer,105,250,355,11,52,UCBPlayer
30521,UCBPlayer,122,227,349,20,57,UCBPlayer
30522,UCBPlayer,109,259,368,15,49,UCBPlayer
30523,UCBPlayer,118,218,336,16,60,UCBPlayer
30524,UCBPlayer,117,267,384,19,45,UCBPlayer
30525,UCBPlayer,110,210,320,12,64,UCBPlayer
30526,UCBPlayer,126,271,397,23,42,UCBPlayer
30527,UCBPlayer,105,210,315,10,65,UCBPlayer
30528,UCBPlayer,130,275,405,25,40,UCBPlayer
30529,UCBPlayer,105,210,315,10,65,UCBPlayer
30530,UCBPlayer,130,275,405,25,40,UCBPlayer
30531,UCBPlayer,106,206,312,10,66,UCBPlayer
30532,UCBPlayer,130,275,405,25,40,UCBPlayer
30533,UCBPlayer,105,210,315,10,65,UCBPlayer
30534,UCBPlayer,131,271,402,25,41,UCBPlayer
30535,UCBPlayer,105,210,315,10,65,UCBPlayer
30536,UCBPlayer,130,275,405,25,40,UCBPlayer
30537,UCBPlayer,105,210,315,10,65,UCBPlayer
30538,UCBPlayer,130,275,405,25,40,UCBPlayer
30539,UCBPlayer,103,203,306,10,68,UCBPlayer
30540,UCBPlayer,128,283,411,25,38,UCBPlayer
30541,UCBPlayer,111,186,297,10,71,UCBPlayer
30542,UCBPlayer,124,299,423,25,34,UCBPlayer
30543,UCBPlayer,115,170,285,10,75,UCBPlayer
30544,UCBPlayer,120,315,435,25,30,UCBPlayer
30545,UCBPlayer,119,154,273,10,79,UCBPlayer
30546,UCBPlayer,112,332,444,25,27,UCBPlayer
30547,UCBPlayer,127,137,264,10,82,UCBPlayer
30548,UCBPlayer,104,349,453,25,24,UCBPlayer
30549,UCBPlayer,126,126,252,7,85,Tie
30550,UCBPlayer,111,351,462,28,22,UCBPlayer
30551,UCBPlayer,116,126,242,3,87,UCBPlayer
30552,UCBPlayer,122,347,469,32,21,UCBPlayer
30553,UCBPlayer,107,132,239,0,87,UCBPlayer
30554,UCBPlayer,132,337,469,35,22,UCBPlayer
30555,UCBPlayer,103,148,251,0,83,UCBPlayer
30556,UCBPlayer,136,321,457,35,26,UCBPlayer
30557,UCBPlayer,99,164,263,0,79,UCBPlayer
30558,UCBPlayer,140,305,445,35,30,UCBPlayer
30559,UCBPlayer,95,180,275,0,75,UCBPlayer
30560,UCBPlayer,144,289,433,35,34,UCBPlayer
30561,UCBPlayer,91,196,287,0,71,UCBPlayer
30562,UCBPlayer,148,273,421,35,38,UCBPlayer
30563,UCBPlayer,87,212,299,0,67,UCBPlayer
30564,UCBPlayer,152,257,409,35,42,UCBPlayer
30565,UCBPlayer,84,224,308,0,64,UCBPlayer
30566,UCBPlayer,146,251,397,32,45,UCBPlayer
30567,UCBPlayer,89,234,323,3,60,UCBPlayer
30568,UCBPlayer,138,243,381,28,49,UCBPlayer
30569,UCBPlayer,97,242,339,7,56,UCBPlayer
30570,UCBPlayer,130,235,365,24,53,UCBPlayer
30571,UCBPlayer,105,250,355,11,52,UCBPlayer
30572,UCBPlayer,122,227,349,20,57,UCBPlayer
30573,UCBPlayer,109,259,368,15,49,UCBPlayer
30574,UCBPlayer,118,218,336,16,60,UCBPlayer
30575,UCBPlayer,117,267,384,19,45,UCBPlayer
30576,UCBPlayer,110,210,320,12,64,UCBPlayer
30577,UCBPlayer,126,271,397,23,42,UCBPlayer
30578,UCBPlayer,105,210,315,10,65,UCBPlayer
30579,UCBPlayer,130,275,405,25,40,UCBPlayer
30580,UCBPlayer,105,210,315,10,65,UCBPlayer
30581,UCBPlayer,130,275,405,25,40,UCBPlayer
30582,UCBPlayer,106,206,312,10,66,UCBPlayer
30583,UCBPlayer,130,275,405,25,40,UCBPlayer
30584,UCBPlayer,105,210,315,10,65,UCBPlayer
30585,UCBPlayer,131,271,402,25,41,UCBPlayer
30586,UCBPlayer,105,210,315,10,65,UCBPlayer
30587,UCBPlayer,130,275,405,25,40,UCBPlayer
30588,UCBPlayer,105,210,315,10,65,UCBPlayer
30589,UCBPlayer,130,275,405,25,40,UCBPlayer
30590,UCBPlayer,103,203,306,10,68,UCBPlayer
30591,UCBPlayer,128,283,411,25,38,UCBPlayer
30592,UCBPlayer,111,186,297,10,71,UCBPlayer
30593,UCBPlayer,124,299,423,25,34,UCBPlayer
30594,UCBPlayer,115,170,285,10,75,UCBPlayer
30595,UCBPlayer,120,315,435,25,30,UCBPlayer
30596,UCBPlayer,119,154,273,10,79,UCBPlayer
30597,UCBPlayer,112,332,444,25,27,UCBPlayer
30598,UCBPlayer,127,137,264,10,82,UCBPlayer
30599,UCBPlayer,104,349,453,25,24,UCBPlayer
30600,UCBPlayer,126,126,252,7,85,Tie
30601,UCBPlayer,111,351,462,28,22,UCBPlayer
30602,UCBPlayer,116,126,242,3,87,UCBPlayer
30603,UCBPlayer,122,347,469,32,21,UCBPlayer
30604,UCBPlayer,107,132,239,0,87,UCBPlayer
30605,UCBPlayer,132,337,469,35,22,UCBPlayer
30606,UCBPlayer,103,148,251,0,83,UCBPlayer
30607,UCBPlayer,136,321,457,35,26,UCBPlayer
30608,UCBPlayer,99,164,263,0,79,UCBPlayer
30609,UCBPlayer,140,305,445,35,30,UCBPlayer
30610,UCBPlayer,95,180,275,0,75,UCBPlayer
30611,UCBPlayer,144,289,433,35,34,UCBPlayer
30612,UCBPlayer,91,196,287,0,71,UCBPlayer
30613,UCBPlayer,148,273,421,35,38,UCBPlayer
30614,UCBPlayer,87,212,299,0,67,UCBPlayer
30615,UCBPlayer,152,257,409,35,42,UCBPlayer
30616,UCBPlayer,84,224,308,0,64,UCBPlayer
30617,UCBPlayer,146,251,397,32,45,UCBPlayer
30618,UCBPlayer,89,234,323,3,60,UCBPlayer
30619,UCBPlayer,138,243,381,28,49,UCBPlayer
30620,UCBPlayer,97,242,339,7,56,UCBPlayer
30621,UCBPlayer,130,235,365,24,53,UCBPlayer
30622,UCBPlayer,105,250,355,11,52,UCBPlayer
30623,UCBPlayer,122,227,349,20,57,UCBPlayer
30624,UCBPlayer,109,259,368,15,49,UCBPlayer
30625,UCBPlayer,118,218,336,16,60,UCBPlayer
30626,UCBPlayer,117,267,384,19,45,UCBPlayer
30627,UCBPlayer,110,210,320,12,64,UCBPlayer
30628,UCBPlayer,126,271,397,23,42,UCBPlayer
30629,UCBPlayer,105,210,315,10,65,UCBPlayer
30630,UCBPlayer,130,275,405,25,40,UCBPlayer
30631,UCBPlayer,105,210,315,10,65,UCBPlayer
30632,UCBPlayer,130,275,405,25,40,UCBPlayer
30633,UCBPlayer,106,206,312,10,66,UCBPlayer
30634,UCBPlayer,130,275,405,25,40,UCBPlayer
30635,UCBPlayer,105,210,315,10,65,UCBPlayer
30636,UCBPlayer,131,271,402,25,41,UCBPlayer
30637,UCBPlayer,105,210,315,10,65,UCBPlayer
30638,UCBPlayer,130,275,405,25,40,UCBPlayer
30639,UCBPlayer,105,210,315,10,65,UCBPlayer
30640,UCBPlayer,130,275,405,25,40,UCBPlayer
30641,UCBPlayer,103,203,306,10,68,UCBPlayer
30642,UCBPlayer,128,283,411,25,38,UCBPlayer
30643,UCBPlayer,111,186,297,10,71,UCBPlayer
30644,UCBPlayer,124,299,423,25,34,UCBPlayer
30645,UCBPlayer,115,170,285,10,75,UCBPlayer
30646,UCBPlayer,120,315,435,25,30,UCBPlayer
30647,UCBPlayer,119,154,273,10,79,UCBPlayer
30648,UCBPlayer,112,332,444,25,27,UCBPlayer
30649,UCBPlayer,127,137,264,10,82,UCBPlayer
30650,UCBPlayer,104,349,453,25,24,UCBPlayer
30651,UCBPlayer,126,126,252,7,85,Tie
30652,UCBPlayer,111,351,462,28,22,UCBPlayer
30653,UCBPlayer,116,126,242,3,87,UCBPlayer
30654,UCBPlayer,122,347,469,32,21,UCBPlayer
30655,UCBPlayer,107,132,239,0,87,UCBPlayer
30656,UCBPlayer,132,337,469,35,22,UCBPlayer
30657,UCBPlayer,103,148,251,0,83,UCBPlayer
30658,UCBPlayer,136,321,457,35,26,UCBPlayer
30659,UCBPlayer,99,164,263,0,79,UCBPlayer
30660,UCBPlayer,140,305,445,35,30,UCBPlayer
30661,UCBPlayer,95,180,275,0,75,UCBPlayer
30662,UCBPlayer,144,289,433,35,34,UCBPlayer
30663,UCBPlayer,91,196,287,0,71,UCBPlayer
30664,UCBPlayer,148,273,421,35,38,UCBPlayer
30665,UCBPlayer,87,212,299,0,67,UCBPlayer
30666,UCBPlayer,152,257,409,35,42,UCBPlayer
30667,UCBPlayer,84,224,308,0,64,UCBPlayer
30668,UCBPlayer,146,251,397,32,45,UCBPlayer
30669,UCBPlayer,89,234,323,3,60,UCBPlayer
30670,UCBPlayer,138,243,381,28,49,UCBPlayer
30671,UCBPlayer,97,242,339,7,56,UCBPlayer
30672,UCBPlayer,130,235,365,24,53,UCBPlayer
30673,UCBPlayer,105,250,355,11,52,UCBPlayer
30674,UCBPlayer,122,227,349,20,57,UCBPlayer
30675,UCBPlayer,109,259,368,15,49,UCBPlayer
30676,UCBPlayer,118,218,336,16,60,UCBPlayer
30677,UCBPlayer,117,267,384,19,45,UCBPlayer
30678,UCBPlayer,110,210,320,12,64,UCBPlayer
30679,UCBPlayer,126,271,397,23,42,UCBPlayer
30680,UCBPlayer,105,210,315,10,65,UCBPlayer
30681,UCBPlayer,130,275,405,25,40,UCBPlayer
30682,UCBPlayer,105,210,315,10,65,UCBPlayer
30683,UCBPlayer,130,275,405,25,40,UCBPlayer
30684,UCBPlayer,106,206,312,10,66,UCBPlayer
30685,UCBPlayer,130,275,405,25,40,UCBPlayer
30686,UCBPlayer,105,210,315,10,65,UCBPlayer
30687,UCBPlayer,131,271,402,25,41,UCBPlayer
30688,UCBPlayer,105,210,315,10,65,UCBPlayer
30689,UCBPlayer,130,275,405,25,40,UCBPlayer
30690,UCBPlayer,105,210,315,10,65,UCBPlayer
30691,UCBPlayer,130,275,405,25,40,UCBPlayer
30692,UCBPlayer,103,203,306,10,68,UCBPlayer
30693,UCBPlayer,128,283,411,25,38,UCBPlayer
30694,UCBPlayer,111,186,297,10,71,UCBPlayer
30695,UCBPlayer,124,299,423,25,34,UCBPlayer
30696,UCBPlayer,115,170,285,10,75,UCBPlayer
30697,UCBPlayer,120,315,435,25,30,UCBPlayer
30698,UCBPlayer,119,154,273,10,79,UCBPlayer
30699,UCBPlayer,112,332,444,25,27,UCBPlayer
30700,UCBPlayer,127,137,264,10,82,UCBPlayer
30701,UCBPlayer,104,349,453,25,24,UCBPlayer
30702,UCBPlayer,126,126,252,7,85,Tie
30703,UCBPlayer,111,351,462,28,22,UCBPlayer
30704,UCBPlayer,116,126,242,3,87,UCBPlayer
30705,UCBPlayer,122,347,469,32,21,UCBPlayer
30706,UCBPlayer,107,132,239,0,87,UCBPlayer
30707,UCBPlayer,132,337,469,35,22,UCBPlayer
30708,UCBPlayer,103,148,251,0,83,UCBPlayer
30709,UCBPlayer,136,321,457,35,26,UCBPlayer
30710,UCBPlayer,99,164,263,0,79,UCBPlayer
30711,UCBPlayer,140,305,445,35,30,UCBPlayer
30712,UCBPlayer,95,180,275,0,75,UCBPlayer
30713,UCBPlayer,144,289,433,35,34,UCBPlayer
30714,UCBPlayer,91,196,287,0,71,UCBPlayer
30715,UCBPlayer,148,273,421,35,38,UCBPlayer
30716,UCBPlayer,87,212,299,0,67,UCBPlayer
30717,UCBPlayer,152,257,409,35,42,UCBPlayer
30718,UCBPlayer,84,224,308,0,64,UCBPlayer
30719,UCBPlayer,146,251,397,32,45,UCBPlayer
30720,UCBPlayer,89,234,323,3,60,UCBPlayer
30721,UCBPlayer,138,243,381,28,49,UCBPlayer
30722,UCBPlayer,97,242,339,7,56,UCBPlayer
30723,UCBPlayer,130,235,365,24,53,UCBPlayer
30724,UCBPlayer,105,250,355,11,52,UCBPlayer
30725,UCBPlayer,122,227,349,20,57,UCBPlayer
30726,UCBPlayer,109,259,368,15,49,UCBPlayer
30727,UCBPlayer,118,218,336,16,60,UCBPlayer
30728,UCBPlayer,117,267,384,19,45,UCBPlayer
30729,UCBPlayer,110,210,320,12,64,UCBPlayer
30730,UCBPlayer,126,271,397,23,42,UCBPlayer
30731,UCBPlayer,105,210,315,10,65,UCBPlayer
30732,UCBPlayer,130,275,405,25,40,UCBPlayer
30733,UCBPlayer,105,210,315,10,65,UCBPlayer
30734,UCBPlayer,130,275,405,25,40,UCBPlayer
30735,UCBPlayer,106,206,312,10,66,UCBPlayer
30736,UCBPlayer,130,275,405,25,40,UCBPlayer
30737,UCBPlayer,105,210,315,10,65,UCBPlayer
30738,UCBPlayer,131,271,402,25,41,UCBPlayer
30739,UCBPlayer,105,210,315,10,65,UCBPlayer
30740,UCBPlayer,130,275,405,25,40,UCBPlayer
30741,UCBPlayer,105,210,315,10,65,UCBPlayer
30742,UCBPlayer,130,275,405,25,40,UCBPlayer
30743,UCBPlayer,103,203,306,10,68,UCBPlayer
30744,UCBPlayer,128,283,411,25,38,UCBPlayer
30745,UCBPlayer,111,186,297,10,71,UCBPlayer
30746,UCBPlayer,124,299,423,25,34,UCBPlayer
30747,UCBPlayer,115,170,285,10,75,UCBPlayer
30748,UCBPlayer,120,315,435,25,30,UCBPlayer
30749,UCBPlayer,119,154,273,10,79,UCBPlayer
30750,UCBPlayer,112,332,444,25,27,UCBPlayer
30751,UCBPlayer,127,137,264,10,82,UCBPlayer
30752,UCBPlayer,104,349,453,25,24,UCBPlayer
30753,UCBPlayer,126,126,252,7,85,Tie
30754,UCBPlayer,111,351,462,28,22,UCBPlayer
30755,UCBPlayer,116,126,242,3,87,UCBPlayer
30756,UCBPlayer,122,347,469,32,21,UCBPlayer
30757,UCBPlayer,107,132,239,0,87,UCBPlayer
30758,UCBPlayer,132,337,469,35,22,UCBPlayer
30759,UCBPlayer,103,148,251,0,83,UCBPlayer
30760,UCBPlayer,136,321,457,35,26,UCBPlayer
30761,UCBPlayer,99,164,263,0,79,UCBPlayer
30762,UCBPlayer,140,305,445,35,30,UCBPlayer
30763,UCBPlayer,95,180,275,0,75,UCBPlayer
30764,UCBPlayer,144,289,433,35,34,UCBPlayer
30765,UCBPlayer,91,196,287,0,71,UCBPlayer
30766,UCBPlayer,148,273,421,35,38,UCBPlayer
30767,UCBPlayer,87,212,299,0,67,UCBPlayer
30768,UCBPlayer,152,257,409,35,42,UCBPlayer
30769,UCBPlayer,84,224,308,0,64,UCBPlayer
30770,UCBPlayer,146,251,397,32,45,UCBPlayer
30771,UCBPlayer,89,234,323,3,60,UCBPlayer
30772,UCBPlayer,138,243,381,28,49,UCBPlayer
30773,UCBPlayer,97,242,339,7,56,UCBPlayer
30774,UCBPlayer,130,235,365,24,53,UCBPlayer
30775,UCBPlayer,105,250,355,11,52,UCBPlayer
30776,UCBPlayer,122,227,349,20,57,UCBPlayer
30777,UCBPlayer,109,259,368,15,49,UCBPlayer
30778,UCBPlayer,118,218,336,16,60,UCBPlayer
30779,UCBPlayer,117,267,384,19,45,UCBPlayer
30780,UCBPlayer,110,210,320,12,64,UCBPlayer
30781,UCBPlayer,126,271,397,23,42,UCBPlayer
30782,UCBPlayer,105,210,315,10,65,UCBPlayer
30783,UCBPlayer,130,275,405,25,40,UCBPlayer
30784,UCBPlayer,105,210,315,10,65,UCBPlayer
30785,UCBPlayer,130,275,405,25,40,UCBPlayer
30786,UCBPlayer,106,206,312,10,66,UCBPlayer
30787,UCBPlayer,130,275,405,25,40,UCBPlayer
30788,UCBPlayer,105,210,315,10,65,UCBPlayer
30789,UCBPlayer,131,271,402,25,41,UCBPlayer
30790,UCBPlayer,105,210,315,10,65,UCBPlayer
30791,UCBPlayer,130,275,405,25,40,UCBPlayer
30792,UCBPlayer,105,210,315,10,65,UCBPlayer
30793,UCBPlayer,130,275,405,25,40,UCBPlayer
30794,UCBPlayer,103,203,306,10,68,UCBPlayer
30795,UCBPlayer,128,283,411,25,38,UCBPlayer
30796,UCBPlayer,111,186,297,10,71,UCBPlayer
30797,UCBPlayer,124,299,423,25,34,UCBPlayer
30798,UCBPlayer,115,170,285,10,75,UCBPlayer
30799,UCBPlayer,120,315,435,25,30,UCBPlayer
30800,UCBPlayer,119,154,273,10,79,UCBPlayer
30801,UCBPlayer,112,332,444,25,27,UCBPlayer
30802,UCBPlayer,127,137,264,10,82,UCBPlayer
30803,UCBPlayer,104,349,453,25,24,UCBPlayer
30804,UCBPlayer,126,126,252,7,85,Tie
30805,UCBPlayer,111,351,462,28,22,UCBPlayer
30806,UCBPlayer,116,126,242,3,87,UCBPlayer
30807,UCBPlayer,122,347,469,32,21,UCBPlayer
30808,UCBPlayer,107,132,239,0,87,UCBPlayer
30809,UCBPlayer,132,337,469,35,22,UCBPlayer
30810,UCBPlayer,103,148,251,0,83,UCBPlayer
30811,UCBPlayer,136,321,457,35,26,UCBPlayer
30812,UCBPlayer,99,164,263,0,79,UCBPlayer
30813,UCBPlayer,140,305,445,35,30,UCBPlayer
30814,UCBPlayer,95,180,275,0,75,UCBPlayer
30815,UCBPlayer,144,289,433,35,34,UCBPlayer
30816,UCBPlayer,91,196,287,0,71,UCBPlayer
30817,UCBPlayer,148,273,421,35,38,UCBPlayer
30818,UCBPlayer,87,212,299,0,67,UCBPlayer
30819,UCBPlayer,152,257,409,35,42,UCBPlayer
30820,UCBPlayer,84,224,308,0,64,UCBPlayer
30821,UCBPlayer,146,251,397,32,45,UCBPlayer
30822,UCBPlayer,89,234,323,3,60,UCBPlayer
30823,UCBPlayer,138,243,381,28,49,UCBPlayer
30824,UCBPlayer,97,242,339,7,56,UCBPlayer
30825,UCBPlayer,130,235,365,24,53,UCBPlayer
30826,UCBPlayer,105,250,355,11,52,UCBPlayer
30827,UCBPlayer,122,227,349,20,57,UCBPlayer
30828,UCBPlayer,109,259,368,15,49,UCBPlayer
30829,UCBPlayer,118,218,336,16,60,UCBPlayer
30830,UCBPlayer,117,267,384,19,45,UCBPlayer
30831,UCBPlayer,110,210,320,12,64,UCBPlayer
30832,UCBPlayer,126,271,397,23,42,UCBPlayer
30833,UCBPlayer,105,210,315,10,65,UCBPlayer
30834,UCBPlayer,130,275,405,25,40,UCBPlayer
30835,UCBPlayer,105,210,315,10,65,UCBPlayer
30836,UCBPlayer,130,275,405,25,40,UCBPlayer
30837,UCBPlayer,106,206,312,10,66,UCBPlayer
30838,UCBPlayer,130,275,405,25,40,UCBPlayer
30839,UCBPlayer,105,210,315,10,65,UCBPlayer
30840,UCBPlayer,131,271,402,25,41,UCBPlayer
30841,UCBPlayer,105,210,315,10,65,UCBPlayer
30842,UCBPlayer,130,275,405,25,40,UCBPlayer
30843,UCBPlayer,105,210,315,10,65,UCBPlayer
30844,UCBPlayer,130,275,405,25,40,UCBPlayer
30845,UCBPlayer,103,203,306,10,68,UCBPlayer
30846,UCBPlayer,128,283,411,25,38,UCBPlayer
30847,UCBPlayer,111,186,297,10,71,UCBPlayer
30848,UCBPlayer,124,299,423,25,34,UCBPlayer
30849,UCBPlayer,115,170,285,10,75,UCBPlayer
30850,UCBPlayer,120,315,435,25,30,UCBPlayer
30851,UCBPlayer,119,154,273,10,79,UCBPlayer
30852,UCBPlayer,112,332,444,25,27,UCBPlayer
30853,UCBPlayer,127,137,264,10,82,UCBPlayer
30854,UCBPlayer,104,349,453,25,24,UCBPlayer
30855,UCBPlayer,126,126,252,7,85,Tie
30856,UCBPlayer,111,351,462,28,22,UCBPlayer
30857,UCBPlayer,116,126,242,3,87,UCBPlayer
30858,UCBPlayer,122,347,469,32,21,UCBPlayer
30859,UCBPlayer,107,132,239,0,87,UCBPlayer
30860,UCBPlayer,132,337,469,35,22,UCBPlayer
30861,UCBPlayer,103,148,251,0,83,UCBPlayer
30862,UCBPlayer,136,321,457,35,26,UCBPlayer
30863,UCBPlayer,99,164,263,0,79,UCBPlayer
30864,UCBPlayer,140,305,445,35,30,UCBPlayer
30865,UCBPlayer,95,180,275,0,75,UCBPlayer
30866,UCBPlayer,144,289,433,35,34,UCBPlayer
30867,UCBPlayer,91,196,287,0,71,UCBPlayer
30868,UCBPlayer,148,273,421,35,38,UCBPlayer
30869,UCBPlayer,87,212,299,0,67,UCBPlayer
30870,UCBPlayer,152,257,409,35,42,UCBPlayer
30871,UCBPlayer,84,224,308,0,64,UCBPlayer
30872,UCBPlayer,146,251,397,32,45,UCBPlayer
30873,UCBPlayer,89,234,323,3,60,UCBPlayer
30874,UCBPlayer,138,243,381,28,49,UCBPlayer
30875,UCBPlayer,97,242,339,7,56,UCBPlayer
30876,UCBPlayer,130,235,365,24,53,UCBPlayer
30877,UCBPlayer,105,250,355,11,52,UCBPlayer
30878,UCBPlayer,122,227,349,20,57,UCBPlayer
30879,UCBPlayer,109,259,368,15,49,UCBPlayer
30880,UCBPlayer,118,218,336,16,60,UCBPlayer
30881,UCBPlayer,117,267,384,19,45,UCBPlayer
30882,UCBPlayer,110,210,320,12,64,UCBPlayer
30883,UCBPlayer,126,271,397,23,42,UCBPlayer
30884,UCBPlayer,105,210,315,10,65,UCBPlayer
30885,UCBPlayer,130,275,405,25,40,UCBPlayer
30886,UCBPlayer,105,210,315,10,65,UCBPlayer
30887,UCBPlayer,130,275,405,25,40,UCBPlayer
30888,UCBPlayer,106,206,312,10,66,UCBPlayer
30889,UCBPlayer,130,275,405,25,40,UCBPlayer
30890,UCBPlayer,105,210,315,10,65,UCBPlayer
30891,UCBPlayer,131,271,402,25,41,UCBPlayer
30892,UCBPlayer,105,210,315,10,65,UCBPlayer
30893,UCBPlayer,130,275,405,25,40,UCBPlayer
30894,UCBPlayer,105,210,315,10,65,UCBPlayer
30895,UCBPlayer,130,275,405,25,40,UCBPlayer
30896,UCBPlayer,103,203,306,10,68,UCBPlayer
30897,UCBPlayer,128,283,411,25,38,UCBPlayer
30898,UCBPlayer,111,186,297,10,71,UCBPlayer
30899,UCBPlayer,124,299,423,25,34,UCBPlayer
30900,UCBPlayer,115,170,285,10,75,UCBPlayer
30901,UCBPlayer,120,315,435,25,30,UCBPlayer
30902,UCBPlayer,119,154,273,10,79,UCBPlayer
30903,UCBPlayer,112,332,444,25,27,UCBPlayer
30904,UCBPlayer,127,137,264,10,82,UCBPlayer
30905,UCBPlayer,104,349,453,25,24,UCBPlayer
30906,UCBPlayer,126,126,252,7,85,Tie
30907,UCBPlayer,111,351,462,28,22,UCBPlayer
30908,UCBPlayer,116,126,242,3,87,UCBPlayer
30909,UCBPlayer,122,347,469,32,21,UCBPlayer
30910,UCBPlayer,107,132,239,0,87,UCBPlayer
30911,UCBPlayer,132,337,469,35,22,UCBPlayer
30912,UCBPlayer,103,148,251,0,83,UCBPlayer
30913,UCBPlayer,136,321,457,35,26,UCBPlayer
30914,UCBPlayer,99,164,263,0,79,UCBPlayer
30915,UCBPlayer,140,305,445,35,30,UCBPlayer
30916,UCBPlayer,95,180,275,0,75,UCBPlayer
30917,UCBPlayer,144,289,433,35,34,UCBPlayer
30918,UCBPlayer,91,196,287,0,71,UCBPlayer
30919,UCBPlayer,148,273,421,35,38,UCBPlayer
30920,UCBPlayer,87,212,299,0,67,UCBPlayer
30921,UCBPlayer,152,257,409,35,42,UCBPlayer
30922,UCBPlayer,84,224,308,0,64,UCBPlayer
30923,UCBPlayer,146,251,397,32,45,UCBPlayer
30924,UCBPlayer,89,234,323,3,60,UCBPlayer
30925,UCBPlayer,138,243,381,28,49,UCBPlayer
30926,UCBPlayer,97,242,339,7,56,UCBPlayer
30927,UCBPlayer,130,235,365,24,53,UCBPlayer
30928,UCBPlayer,105,250,355,11,52,UCBPlayer
30929,UCBPlayer,122,227,349,20,57,UCBPlayer
30930,UCBPlayer,109,259,368,15,49,UCBPlayer
30931,UCBPlayer,118,218,336,16,60,UCBPlayer
30932,UCBPlayer,117,267,384,19,45,UCBPlayer
30933,UCBPlayer,110,210,320,12,64,UCBPlayer
30934,UCBPlayer,126,271,397,23,42,UCBPlayer
30935,UCBPlayer,105,210,315,10,65,UCBPlayer
30936,UCBPlayer,130,275,405,25,40,UCBPlayer
30937,UCBPlayer,105,210,315,10,65,UCBPlayer
30938,UCBPlayer,130,275,405,25,40,UCBPlayer
30939,UCBPlayer,106,206,312,10,66,UCBPlayer
30940,UCBPlayer,130,275,405,25,40,UCBPlayer
30941,UCBPlayer,105,210,315,10,65,UCBPlayer
30942,UCBPlayer,131,271,402,25,41,UCBPlayer
30943,UCBPlayer,105,210,315,10,65,UCBPlayer
30944,UCBPlayer,130,275,405,25,40,UCBPlayer
30945,UCBPlayer,105,210,315,10,65,UCBPlayer
30946,UCBPlayer,130,275,405,25,40,UCBPlayer
30947,UCBPlayer,103,203,306,10,68,UCBPlayer
30948,UCBPlayer,128,283,411,25,38,UCBPlayer
30949,UCBPlayer,111,186,297,10,71,UCBPlayer
30950,UCBPlayer,124,299,423,25,34,UCBPlayer
30951,UCBPlayer,115,170,285,10,75,UCBPlayer
30952,UCBPlayer,120,315,435,25,30,UCBPlayer
30953,UCBPlayer,119,154,273,10,79,UCBPlayer
30954,UCBPlayer,112,332,444,25,27,UCBPlayer
30955,UCBPlayer,127,137,264,10,82,UCBPlayer
30956,UCBPlayer,104,349,453,25,24,UCBPlayer
30957,UCBPlayer,126,126,252,7,85,Tie
30958,UCBPlayer,111,351,462,28,22,UCBPlayer
30959,UCBPlayer,116,126,242,3,87,UCBPlayer
30960,UCBPlayer,122,347,469,32,21,UCBPlayer
30961,UCBPlayer,107,132,239,0,87,UCBPlayer
30962,UCBPlayer,132,337,469,35,22,UCBPlayer
30963,UCBPlayer,103,148,251,0,83,UCBPlayer
30964,UCBPlayer,136,321,457,35,26,UCBPlayer
30965,UCBPlayer,99,164,263,0,79,UCBPlayer
30966,UCBPlayer,140,305,445,35,30,UCBPlayer
30967,UCBPlayer,95,180,275,0,75,UCBPlayer
30968,UCBPlayer,144,289,433,35,34,UCBPlayer
30969,UCBPlayer,91,196,287,0,71,UCBPlayer
30970,UCBPlayer,148,273,421,35,38,UCBPlayer
30971,UCBPlayer,87,212,299,0,67,UCBPlayer
30972,UCBPlayer,152,257,409,35,42,UCBPlayer
30973,UCBPlayer,84,224,308,0,64,UCBPlayer
30974,UCBPlayer,146,251,397,32,45,UCBPlayer
30975,UCBPlayer,89,234,323,3,60,UCBPlayer
30976,UCBPlayer,138,243,381,28,49,UCBPlayer
30977,UCBPlayer,97,242,339,7,56,UCBPlayer
30978,UCBPlayer,130,235,365,24,53,UCBPlayer
30979,UCBPlayer,105,250,355,11,52,UCBPlayer
30980,UCBPlayer,122,227,349,20,57,UCBPlayer
30981,UCBPlayer,109,259,368,15,49,UCBPlayer
30982,UCBPlayer,118,218,336,16,60,UCBPlayer
30983,UCBPlayer,117,267,384,19,45,UCBPlayer
30984,UCBPlayer,110,210,320,12,64,UCBPlayer
30985,UCBPlayer,126,271,397,23,42,UCBPlayer
30986,UCBPlayer,105,210,315,10,65,UCBPlayer
30987,UCBPlayer,130,275,405,25,40,UCBPlayer
30988,UCBPlayer,105,210,315,10,65,UCBPlayer
30989,UCBPlayer,130,275,405,25,40,UCBPlayer
30990,UCBPlayer,106,206,312,10,66,UCBPlayer
30991,UCBPlayer,130,275,405,25,40,UCBPlayer
30992,UCBPlayer,105,210,315,10,65,UCBPlayer
30993,UCBPlayer,131,271,402,25,41,UCBPlayer
30994,UCBPlayer,105,210,315,10,65,UCBPlayer
30995,UCBPlayer,130,275,405,25,40,UCBPlayer
30996,UCBPlayer,105,210,315,10,65,UCBPlayer
30997,UCBPlayer,130,275,405,25,40,UCBPlayer
30998,UCBPlayer,103,203,306,10,68,UCBPlayer
30999,UCBPlayer,128,283,411,25,38,UCBPlayer
31000,UCBPlayer,111,186,297,10,71,UCBPlayer
31001,UCBPlayer,124,299,423,25,34,UCBPlayer
31002,UCBPlayer,115,170,285,10,75,UCBPlayer
31003,UCBPlayer,120,315,435,25,30,UCBPlayer
31004,UCBPlayer,119,154,273,10,79,UCBPlayer
31005,UCBPlayer,112,332,444,25,27,UCBPlayer
31006,UCBPlayer,127,137,264,10,82,UCBPlayer
31007,UCBPlayer,104,349,453,25,24,UCBPlayer
31008,UCBPlayer,126,126,252,7,85,Tie
31009,UCBPlayer,111,351,462,28,22,UCBPlayer
31010,UCBPlayer,116,126,242,3,87,UCBPlayer
31011,UCBPlayer,122,347,469,32,21,UCBPlayer
31012,UCBPlayer,107,132,239,0,87,UCBPlayer
31013,UCBPlayer,132,337,469,35,22,UCBPlayer
31014,UCBPlayer,103,148,251,0,83,UCBPlayer
31015,UCBPlayer,136,321,457,35,26,UCBPlayer
31016,UCBPlayer,99,164,263,0,79,UCBPlayer
31017,UCBPlayer,140,305,445,35,30,UCBPlayer
31018,UCBPlayer,95,180,275,0,75,UCBPlayer
31019,UCBPlayer,144,289,433,35,34,UCBPlayer
31020,UCBPlayer,91,196,287,0,71,UCBPlayer
31021,UCBPlayer,148,273,421,35,38,UCBPlayer
31022,UCBPlayer,87,212,299,0,67,UCBPlayer
31023,UCBPlayer,152,257,409,35,42,UCBPlayer
31024,UCBPlayer,84,224,308,0,64,UCBPlayer
31025,UCBPlayer,146,251,397,32,45,UCBPlayer
31026,UCBPlayer,89,234,323,3,60,UCBPlayer
31027,UCBPlayer,138,243,381,28,49,UCBPlayer
31028,UCBPlayer,97,242,339,7,56,UCBPlayer
31029,UCBPlayer,130,235,365,24,53,UCBPlayer
31030,UCBPlayer,105,250,355,11,52,UCBPlayer
31031,UCBPlayer,122,227,349,20,57,UCBPlayer
31032,UCBPlayer,109,259,368,15,49,UCBPlayer
31033,UCBPlayer,118,218,336,16,60,UCBPlayer
31034,UCBPlayer,117,267,384,19,45,UCBPlayer
31035,UCBPlayer,110,210,320,12,64,UCBPlayer
31036,UCBPlayer,126,271,397,23,42,UCBPlayer
31037,UCBPlayer,105,210,315,10,65,UCBPlayer
31038,UCBPlayer,130,275,405,25,40,UCBPlayer
31039,UCBPlayer,105,210,315,10,65,UCBPlayer
31040,UCBPlayer,130,275,405,25,40,UCBPlayer
31041,UCBPlayer,106,206,312,10,66,UCBPlayer
31042,UCBPlayer,130,275,405,25,40,UCBPlayer
31043,UCBPlayer,105,210,315,10,65,UCBPlayer
31044,UCBPlayer,131,271,402,25,41,UCBPlayer
31045,UCBPlayer,105,210,315,10,65,UCBPlayer
31046,UCBPlayer,130,275,405,25,40,UCBPlayer
31047,UCBPlayer,105,210,315,10,65,UCBPlayer
31048,UCBPlayer,130,275,405,25,40,UCBPlayer
31049,UCBPlayer,103,203,306,10,68,UCBPlayer
31050,UCBPlayer,128,283,411,25,38,UCBPlayer
31051,UCBPlayer,111,186,297,10,71,UCBPlayer
31052,UCBPlayer,124,299,423,25,34,UCBPlayer
31053,UCBPlayer,115,170,285,10,75,UCBPlayer
31054,UCBPlayer,120,315,435,25,30,UCBPlayer
31055,UCBPlayer,119,154,273,10,79,UCBPlayer
31056,UCBPlayer,112,332,444,25,27,UCBPlayer
31057,UCBPlayer,127,137,264,10,82,UCBPlayer
31058,UCBPlayer,104,349,453,25,24,UCBPlayer
31059,UCBPlayer,126,126,252,7,85,Tie
31060,UCBPlayer,111,351,462,28,22,UCBPlayer
31061,UCBPlayer,116,126,242,3,87,UCBPlayer
31062,UCBPlayer,122,347,469,32,21,UCBPlayer
31063,UCBPlayer,107,132,239,0,87,UCBPlayer
31064,UCBPlayer,132,337,469,35,22,UCBPlayer
31065,UCBPlayer,103,148,251,0,83,UCBPlayer
31066,UCBPlayer,136,321,457,35,26,UCBPlayer
31067,UCBPlayer,99,164,263,0,79,UCBPlayer
31068,UCBPlayer,140,305,445,35,30,UCBPlayer
31069,UCBPlayer,95,180,275,0,75,UCBPlayer
31070,UCBPlayer,144,289,433,35,34,UCBPlayer
31071,UCBPlayer,91,196,287,0,71,UCBPlayer
31072,UCBPlayer,148,273,421,35,38,UCBPlayer
31073,UCBPlayer,87,212,299,0,67,UCBPlayer
31074,UCBPlayer,152,257,409,35,42,UCBPlayer
31075,UCBPlayer,84,224,308,0,64,UCBPlayer
31076,UCBPlayer,146,251,397,32,45,UCBPlayer
31077,UCBPlayer,89,234,323,3,60,UCBPlayer
31078,UCBPlayer,138,243,381,28,49,UCBPlayer
31079,UCBPlayer,97,242,339,7,56,UCBPlayer
31080,UCBPlayer,130,235,365,24,53,UCBPlayer
31081,UCBPlayer,105,250,355,11,52,UCBPlayer
31082,UCBPlayer,122,227,349,20,57,UCBPlayer
31083,UCBPlayer,109,259,368,15,49,UCBPlayer
31084,UCBPlayer,118,218,336,16,60,UCBPlayer
31085,UCBPlayer,117,267,384,19,45,UCBPlayer
31086,UCBPlayer,110,210,320,12,64,UCBPlayer
31087,UCBPlayer,126,271,397,23,42,UCBPlayer
31088,UCBPlayer,105,210,315,10,65,UCBPlayer
31089,UCBPlayer,130,275,405,25,40,UCBPlayer
31090,UCBPlayer,105,210,315,10,65,UCBPlayer
31091,UCBPlayer,130,275,405,25,40,UCBPlayer
31092,UCBPlayer,106,206,312,10,66,UCBPlayer
31093,UCBPlayer,130,275,405,25,40,UCBPlayer
31094,UCBPlayer,105,210,315,10,65,UCBPlayer
31095,UCBPlayer,131,271,402,25,41,UCBPlayer
31096,UCBPlayer,105,210,315,10,65,UCBPlayer
31097,UCBPlayer,130,275,405,25,40,UCBPlayer
31098,UCBPlayer,105,210,315,10,65,UCBPlayer
31099,UCBPlayer,130,275,405,25,40,UCBPlayer
31100,UCBPlayer,103,203,306,10,68,UCBPlayer
31101,UCBPlayer,128,283,411,25,38,UCBPlayer
31102,UCBPlayer,111,186,297,10,71,UCBPlayer
31103,UCBPlayer,124,299,423,25,34,UCBPlayer
31104,UCBPlayer,115,170,285,10,75,UCBPlayer
31105,UCBPlayer,120,315,435,25,30,UCBPlayer
31106,UCBPlayer,119,154,273,10,79,UCBPlayer
31107,UCBPlayer,112,332,444,25,27,UCBPlayer
31108,UCBPlayer,127,137,264,10,82,UCBPlayer
31109,UCBPlayer,104,349,453,25,24,UCBPlayer
31110,UCBPlayer,126,126,252,7,85,Tie
31111,UCBPlayer,111,351,462,28,22,UCBPlayer
31112,UCBPlayer,116,126,242,3,87,UCBPlayer
31113,UCBPlayer,122,347,469,32,21,UCBPlayer
31114,UCBPlayer,107,132,239,0,87,UCBPlayer
31115,UCBPlayer,132,337,469,35,22,UCBPlayer
31116,UCBPlayer,103,148,251,0,83,UCBPlayer
31117,UCBPlayer,136,321,457,35,26,UCBPlayer
31118,UCBPlayer,99,164,263,0,79,UCBPlayer
31119,UCBPlayer,140,305,445,35,30,UCBPlayer
31120,UCBPlayer,95,180,275,0,75,UCBPlayer
31121,UCBPlayer,144,289,433,35,34,UCBPlayer
31122,UCBPlayer,91,196,287,0,71,UCBPlayer
31123,UCBPlayer,148,273,421,35,38,UCBPlayer
31124,UCBPlayer,87,212,299,0,67,UCBPlayer
31125,UCBPlayer,152,257,409,35,42,UCBPlayer
31126,UCBPlayer,84,224,308,0,64,UCBPlayer
31127,UCBPlayer,146,251,397,32,45,UCBPlayer
31128,UCBPlayer,89,234,323,3,60,UCBPlayer
31129,UCBPlayer,138,243,381,28,49,UCBPlayer
31130,UCBPlayer,97,242,339,7,56,UCBPlayer
31131,UCBPlayer,130,235,365,24,53,UCBPlayer
31132,UCBPlayer,105,250,355,11,52,UCBPlayer
31133,UCBPlayer,122,227,349,20,57,UCBPlayer
31134,UCBPlayer,109,259,368,15,49,UCBPlayer
31135,UCBPlayer,118,218,336,16,60,UCBPlayer
31136,UCBPlayer,117,267,384,19,45,UCBPlayer
31137,UCBPlayer,110,210,320,12,64,UCBPlayer
31138,UCBPlayer,126,271,397,23,42,UCBPlayer
31139,UCBPlayer,105,210,315,10,65,UCBPlayer
31140,UCBPlayer,130,275,405,25,40,UCBPlayer
31141,UCBPlayer,105,210,315,10,65,UCBPlayer
31142,UCBPlayer,130,275,405,25,40,UCBPlayer
31143,UCBPlayer,106,206,312,10,66,UCBPlayer
31144,UCBPlayer,130,275,405,25,40,UCBPlayer
31145,UCBPlayer,105,210,315,10,65,UCBPlayer
31146,UCBPlayer,131,271,402,25,41,UCBPlayer
31147,UCBPlayer,105,210,315,10,65,UCBPlayer
31148,UCBPlayer,130,275,405,25,40,UCBPlayer
31149,UCBPlayer,105,210,315,10,65,UCBPlayer
31150,UCBPlayer,130,275,405,25,40,UCBPlayer
31151,UCBPlayer,103,203,306,10,68,UCBPlayer
31152,UCBPlayer,128,283,411,25,38,UCBPlayer
31153,UCBPlayer,111,186,297,10,71,UCBPlayer
31154,UCBPlayer,124,299,423,25,34,UCBPlayer
31155,UCBPlayer,115,170,285,10,75,UCBPlayer
31156,UCBPlayer,120,315,435,25,30,UCBPlayer
31157,UCBPlayer,119,154,273,10,79,UCBPlayer
31158,UCBPlayer,112,332,444,25,27,UCBPlayer
31159,UCBPlayer,127,137,264,10,82,UCBPlayer
31160,UCBPlayer,104,349,453,25,24,UCBPlayer
31161,UCBPlayer,126,126,252,7,85,Tie
31162,UCBPlayer,111,351,462,28,22,UCBPlayer
31163,UCBPlayer,116,126,242,3,87,UCBPlayer
31164,UCBPlayer,122,347,469,32,21,UCBPlayer
31165,UCBPlayer,107,132,239,0,87,UCBPlayer
31166,UCBPlayer,132,337,469,35,22,UCBPlayer
31167,UCBPlayer,103,148,251,0,83,UCBPlayer
31168,UCBPlayer,136,321,457,35,26,UCBPlayer
31169,UCBPlayer,99,164,263,0,79,UCBPlayer
31170,UCBPlayer,140,305,445,35,30,UCBPlayer
31171,UCBPlayer,95,180,275,0,75,UCBPlayer
31172,UCBPlayer,144,289,433,35,34,UCBPlayer
31173,UCBPlayer,91,196,287,0,71,UCBPlayer
31174,UCBPlayer,148,273,421,35,38,UCBPlayer
31175,UCBPlayer,87,212,299,0,67,UCBPlayer
31176,UCBPlayer,152,257,409,35,42,UCBPlayer
31177,UCBPlayer,84,224,308,0,64,UCBPlayer
31178,UCBPlayer,146,251,397,32,45,UCBPlayer
31179,UCBPlayer,89,234,323,3,60,UCBPlayer
31180,UCBPlayer,138,243,381,28,49,UCBPlayer
31181,UCBPlayer,97,242,339,7,56,UCBPlayer
31182,UCBPlayer,130,235,365,24,53,UCBPlayer
31183,UCBPlayer,105,250,355,11,52,UCBPlayer
31184,UCBPlayer,122,227,349,20,57,UCBPlayer
31185,UCBPlayer,109,259,368,15,49,UCBPlayer
31186,UCBPlayer,118,218,336,16,60,UCBPlayer
31187,UCBPlayer,117,267,384,19,45,UCBPlayer
31188,UCBPlayer,110,210,320,12,64,UCBPlayer
31189,UCBPlayer,126,271,397,23,42,UCBPlayer
31190,UCBPlayer,105,210,315,10,65,UCBPlayer
31191,UCBPlayer,130,275,405,25,40,UCBPlayer
31192,UCBPlayer,105,210,315,10,65,UCBPlayer
31193,UCBPlayer,130,275,405,25,40,UCBPlayer
31194,UCBPlayer,106,206,312,10,66,UCBPlayer
31195,UCBPlayer,130,275,405,25,40,UCBPlayer
31196,UCBPlayer,105,210,315,10,65,UCBPlayer
31197,UCBPlayer,131,271,402,25,41,UCBPlayer
31198,UCBPlayer,105,210,315,10,65,UCBPlayer
31199,UCBPlayer,130,275,405,25,40,UCBPlayer
31200,UCBPlayer,105,210,315,10,65,UCBPlayer
31201,UCBPlayer,130,275,405,25,40,UCBPlayer
31202,UCBPlayer,103,203,306,10,68,UCBPlayer
31203,UCBPlayer,128,283,411,25,38,UCBPlayer
31204,UCBPlayer,111,186,297,10,71,UCBPlayer
31205,UCBPlayer,124,299,423,25,34,UCBPlayer
31206,UCBPlayer,115,170,285,10,75,UCBPlayer
31207,UCBPlayer,120,315,435,25,30,UCBPlayer
31208,UCBPlayer,119,154,273,10,79,UCBPlayer
31209,UCBPlayer,112,332,444,25,27,UCBPlayer
31210,UCBPlayer,127,137,264,10,82,UCBPlayer
31211,UCBPlayer,104,349,453,25,24,UCBPlayer
31212,UCBPlayer,126,126,252,7,85,Tie
31213,UCBPlayer,111,351,462,28,22,UCBPlayer
31214,UCBPlayer,116,126,242,3,87,UCBPlayer
31215,UCBPlayer,122,347,469,32,21,UCBPlayer
31216,UCBPlayer,107,132,239,0,87,UCBPlayer
31217,UCBPlayer,132,337,469,35,22,UCBPlayer
31218,UCBPlayer,103,148,251,0,83,UCBPlayer
31219,UCBPlayer,136,321,457,35,26,UCBPlayer
31220,UCBPlayer,99,164,263,0,79,UCBPlayer
31221,UCBPlayer,140,305,445,35,30,UCBPlayer
31222,UCBPlayer,95,180,275,0,75,UCBPlayer
31223,UCBPlayer,144,289,433,35,34,UCBPlayer
31224,UCBPlayer,91,196,287,0,71,UCBPlayer
31225,UCBPlayer,148,273,421,35,38,UCBPlayer
31226,UCBPlayer,87,212,299,0,67,UCBPlayer
31227,UCBPlayer,152,257,409,35,42,UCBPlayer
31228,UCBPlayer,84,224,308,0,64,UCBPlayer
31229,UCBPlayer,146,251,397,32,45,UCBPlayer
31230,UCBPlayer,89,234,323,3,60,UCBPlayer
31231,UCBPlayer,138,243,381,28,49,UCBPlayer
31232,UCBPlayer,97,242,339,7,56,UCBPlayer
31233,UCBPlayer,130,235,365,24,53,UCBPlayer
31234,UCBPlayer,105,250,355,11,52,UCBPlayer
31235,UCBPlayer,122,227,349,20,57,UCBPlayer
31236,UCBPlayer,109,259,368,15,49,UCBPlayer
31237,UCBPlayer,118,218,336,16,60,UCBPlayer
31238,UCBPlayer,117,267,384,19,45,UCBPlayer
31239,UCBPlayer,110,210,320,12,64,UCBPlayer
31240,UCBPlayer,126,271,397,23,42,UCBPlayer
31241,UCBPlayer,105,210,315,10,65,UCBPlayer
31242,UCBPlayer,130,275,405,25,40,UCBPlayer
31243,UCBPlayer,105,210,315,10,65,UCBPlayer
31244,UCBPlayer,130,275,405,25,40,UCBPlayer
31245,UCBPlayer,106,206,312,10,66,UCBPlayer
31246,UCBPlayer,130,275,405,25,40,UCBPlayer
31247,UCBPlayer,105,210,315,10,65,UCBPlayer
31248,UCBPlayer,131,271,402,25,41,UCBPlayer
31249,UCBPlayer,105,210,315,10,65,UCBPlayer
31250,UCBPlayer,130,275,405,25,40,UCBPlayer
31251,UCBPlayer,105,210,315,10,65,UCBPlayer
31252,UCBPlayer,130,275,405,25,40,UCBPlayer
31253,UCBPlayer,103,203,306,10,68,UCBPlayer
31254,UCBPlayer,128,283,411,25,38,UCBPlayer
31255,UCBPlayer,111,186,297,10,71,UCBPlayer
31256,UCBPlayer,124,299,423,25,34,UCBPlayer
31257,UCBPlayer,115,170,285,10,75,UCBPlayer
31258,UCBPlayer,120,315,435,25,30,UCBPlayer
31259,UCBPlayer,119,154,273,10,79,UCBPlayer
31260,UCBPlayer,112,332,444,25,27,UCBPlayer
31261,UCBPlayer,127,137,264,10,82,UCBPlayer
31262,UCBPlayer,104,349,453,25,24,UCBPlayer
31263,UCBPlayer,126,126,252,7,85,Tie
31264,UCBPlayer,111,351,462,28,22,UCBPlayer
31265,UCBPlayer,116,126,242,3,87,UCBPlayer
31266,UCBPlayer,122,347,469,32,21,UCBPlayer
31267,UCBPlayer,107,132,239,0,87,UCBPlayer
31268,UCBPlayer,132,337,469,35,22,UCBPlayer
31269,UCBPlayer,103,148,251,0,83,UCBPlayer
31270,UCBPlayer,136,321,457,35,26,UCBPlayer
31271,UCBPlayer,99,164,263,0,79,UCBPlayer
31272,UCBPlayer,140,305,445,35,30,UCBPlayer
31273,UCBPlayer,95,180,275,0,75,UCBPlayer
31274,UCBPlayer,144,289,433,35,34,UCBPlayer
31275,UCBPlayer,91,196,287,0,71,UCBPlayer
31276,UCBPlayer,148,273,421,35,38,UCBPlayer
31277,UCBPlayer,87,212,299,0,67,UCBPlayer
31278,UCBPlayer,152,257,409,35,42,UCBPlayer
31279,UCBPlayer,84,224,308,0,64,UCBPlayer
31280,UCBPlayer,146,251,397,32,45,UCBPlayer
31281,UCBPlayer,89,234,323,3,60,UCBPlayer
31282,UCBPlayer,138,243,381,28,49,UCBPlayer
31283,UCBPlayer,97,242,339,7,56,UCBPlayer
31284,UCBPlayer,130,235,365,24,53,UCBPlayer
31285,UCBPlayer,105,250,355,11,52,UCBPlayer
31286,UCBPlayer,122,227,349,20,57,UCBPlayer
31287,UCBPlayer,109,259,368,15,49,UCBPlayer
31288,UCBPlayer,118,218,336,16,60,UCBPlayer
31289,UCBPlayer,117,267,384,19,45,UCBPlayer
31290,UCBPlayer,110,210,320,12,64,UCBPlayer
31291,UCBPlayer,126,271,397,23,42,UCBPlayer
31292,UCBPlayer,105,210,315,10,65,UCBPlayer
31293,UCBPlayer,130,275,405,25,40,UCBPlayer
31294,UCBPlayer,105,210,315,10,65,UCBPlayer
31295,UCBPlayer,130,275,405,25,40,UCBPlayer
31296,UCBPlayer,106,206,312,10,66,UCBPlayer
31297,UCBPlayer,130,275,405,25,40,UCBPlayer
31298,UCBPlayer,105,210,315,10,65,UCBPlayer
31299,UCBPlayer,131,271,402,25,41,UCBPlayer
31300,UCBPlayer,105,210,315,10,65,UCBPlayer
31301,UCBPlayer,130,275,405,25,40,UCBPlayer
31302,UCBPlayer,105,210,315,10,65,UCBPlayer
31303,UCBPlayer,130,275,405,25,40,UCBPlayer
31304,UCBPlayer,103,203,306,10,68,UCBPlayer
31305,UCBPlayer,128,283,411,25,38,UCBPlayer
31306,UCBPlayer,111,186,297,10,71,UCBPlayer
31307,UCBPlayer,124,299,423,25,34,UCBPlayer
31308,UCBPlayer,115,170,285,10,75,UCBPlayer
31309,UCBPlayer,120,315,435,25,30,UCBPlayer
31310,UCBPlayer,119,154,273,10,79,UCBPlayer
31311,UCBPlayer,112,332,444,25,27,UCBPlayer
31312,UCBPlayer,127,137,264,10,82,UCBPlayer
31313,UCBPlayer,104,349,453,25,24,UCBPlayer
31314,UCBPlayer,126,126,252,7,85,Tie
31315,UCBPlayer,111,351,462,28,22,UCBPlayer
31316,UCBPlayer,116,126,242,3,87,UCBPlayer
31317,UCBPlayer,122,347,469,32,21,UCBPlayer
31318,UCBPlayer,107,132,239,0,87,UCBPlayer
31319,UCBPlayer,132,337,469,35,22,UCBPlayer
31320,UCBPlayer,103,148,251,0,83,UCBPlayer
31321,UCBPlayer,136,321,457,35,26,UCBPlayer
31322,UCBPlayer,99,164,263,0,79,UCBPlayer
31323,UCBPlayer,140,305,445,35,30,UCBPlayer
31324,UCBPlayer,95,180,275,0,75,UCBPlayer
31325,UCBPlayer,144,289,433,35,34,UCBPlayer
31326,UCBPlayer,91,196,287,0,71,UCBPlayer
31327,UCBPlayer,148,273,421,35,38,UCBPlayer
31328,UCBPlayer,87,212,299,0,67,UCBPlayer
31329,UCBPlayer,152,257,409,35,42,UCBPlayer
31330,UCBPlayer,84,224,308,0,64,UCBPlayer
31331,UCBPlayer,146,251,397,32,45,UCBPlayer
31332,UCBPlayer,89,234,323,3,60,UCBPlayer
31333,UCBPlayer,138,243,381,28,49,UCBPlayer
31334,UCBPlayer,97,242,339,7,56,UCBPlayer
31335,UCBPlayer,130,235,365,24,53,UCBPlayer
31336,UCBPlayer,105,250,355,11,52,UCBPlayer
31337,UCBPlayer,122,227,349,20,57,UCBPlayer
31338,UCBPlayer,109,259,368,15,49,UCBPlayer
31339,UCBPlayer,118,218,336,16,60,UCBPlayer
31340,UCBPlayer,117,267,384,19,45,UCBPlayer
31341,UCBPlayer,110,210,320,12,64,UCBPlayer
31342,UCBPlayer,126,271,397,23,42,UCBPlayer
31343,UCBPlayer,105,210,315,10,65,UCBPlayer
31344,UCBPlayer,130,275,405,25,40,UCBPlayer
31345,UCBPlayer,105,210,315,10,65,UCBPlayer
31346,UCBPlayer,130,275,405,25,40,UCBPlayer
31347,UCBPlayer,106,206,312,10,66,UCBPlayer
31348,UCBPlayer,130,275,405,25,40,UCBPlayer
31349,UCBPlayer,105,210,315,10,65,UCBPlayer
31350,UCBPlayer,131,271,402,25,41,UCBPlayer
31351,UCBPlayer,105,210,315,10,65,UCBPlayer
31352,UCBPlayer,130,275,405,25,40,UCBPlayer
31353,UCBPlayer,105,210,315,10,65,UCBPlayer
31354,UCBPlayer,130,275,405,25,40,UCBPlayer
31355,UCBPlayer,103,203,306,10,68,UCBPlayer
31356,UCBPlayer,128,283,411,25,38,UCBPlayer
31357,UCBPlayer,111,186,297,10,71,UCBPlayer
31358,UCBPlayer,124,299,423,25,34,UCBPlayer
31359,UCBPlayer,115,170,285,10,75,UCBPlayer
31360,UCBPlayer,120,315,435,25,30,UCBPlayer
31361,UCBPlayer,119,154,273,10,79,UCBPlayer
31362,UCBPlayer,112,332,444,25,27,UCBPlayer
31363,UCBPlayer,127,137,264,10,82,UCBPlayer
31364,UCBPlayer,104,349,453,25,24,UCBPlayer
31365,UCBPlayer,126,126,252,7,85,Tie
31366,UCBPlayer,111,351,462,28,22,UCBPlayer
31367,UCBPlayer,116,126,242,3,87,UCBPlayer
31368,UCBPlayer,122,347,469,32,21,UCBPlayer
31369,UCBPlayer,107,132,239,0,87,UCBPlayer
31370,UCBPlayer,132,337,469,35,22,UCBPlayer
31371,UCBPlayer,103,148,251,0,83,UCBPlayer
31372,UCBPlayer,136,321,457,35,26,UCBPlayer
31373,UCBPlayer,99,164,263,0,79,UCBPlayer
31374,UCBPlayer,140,305,445,35,30,UCBPlayer
31375,UCBPlayer,95,180,275,0,75,UCBPlayer
31376,UCBPlayer,144,289,433,35,34,UCBPlayer
31377,UCBPlayer,91,196,287,0,71,UCBPlayer
31378,UCBPlayer,148,273,421,35,38,UCBPlayer
31379,UCBPlayer,87,212,299,0,67,UCBPlayer
31380,UCBPlayer,152,257,409,35,42,UCBPlayer
31381,UCBPlayer,84,224,308,0,64,UCBPlayer
31382,UCBPlayer,146,251,397,32,45,UCBPlayer
31383,UCBPlayer,89,234,323,3,60,UCBPlayer
31384,UCBPlayer,138,243,381,28,49,UCBPlayer
31385,UCBPlayer,97,242,339,7,56,UCBPlayer
31386,UCBPlayer,130,235,365,24,53,UCBPlayer
31387,UCBPlayer,105,250,355,11,52,UCBPlayer
31388,UCBPlayer,122,227,349,20,57,UCBPlayer
31389,UCBPlayer,109,259,368,15,49,UCBPlayer
31390,UCBPlayer,118,218,336,16,60,UCBPlayer
31391,UCBPlayer,117,267,384,19,45,UCBPlayer
31392,UCBPlayer,110,210,320,12,64,UCBPlayer
31393,UCBPlayer,126,271,397,23,42,UCBPlayer
31394,UCBPlayer,105,210,315,10,65,UCBPlayer
31395,UCBPlayer,130,275,405,25,40,UCBPlayer
31396,UCBPlayer,105,210,315,10,65,UCBPlayer
31397,UCBPlayer,130,275,405,25,40,UCBPlayer
31398,UCBPlayer,106,206,312,10,66,UCBPlayer
31399,UCBPlayer,130,275,405,25,40,UCBPlayer
31400,UCBPlayer,105,210,315,10,65,UCBPlayer
31401,UCBPlayer,131,271,402,25,41,UCBPlayer
31402,UCBPlayer,105,210,315,10,65,UCBPlayer
31403,UCBPlayer,130,275,405,25,40,UCBPlayer
31404,UCBPlayer,105,210,315,10,65,UCBPlayer
31405,UCBPlayer,130,275,405,25,40,UCBPlayer
31406,UCBPlayer,103,203,306,10,68,UCBPlayer
31407,UCBPlayer,128,283,411,25,38,UCBPlayer
31408,UCBPlayer,111,186,297,10,71,UCBPlayer
31409,UCBPlayer,124,299,423,25,34,UCBPlayer
31410,UCBPlayer,115,170,285,10,75,UCBPlayer
31411,UCBPlayer,120,315,435,25,30,UCBPlayer
31412,UCBPlayer,119,154,273,10,79,UCBPlayer
31413,UCBPlayer,112,332,444,25,27,UCBPlayer
31414,UCBPlayer,127,137,264,10,82,UCBPlayer
31415,UCBPlayer,104,349,453,25,24,UCBPlayer
31416,UCBPlayer,126,126,252,7,85,Tie
31417,UCBPlayer,111,351,462,28,22,UCBPlayer
31418,UCBPlayer,116,126,242,3,87,UCBPlayer
31419,UCBPlayer,122,347,469,32,21,UCBPlayer
31420,UCBPlayer,107,132,239,0,87,UCBPlayer
31421,UCBPlayer,132,337,469,35,22,UCBPlayer
31422,UCBPlayer,103,148,251,0,83,UCBPlayer
31423,UCBPlayer,136,321,457,35,26,UCBPlayer
31424,UCBPlayer,99,164,263,0,79,UCBPlayer
31425,UCBPlayer,140,305,445,35,30,UCBPlayer
31426,UCBPlayer,95,180,275,0,75,UCBPlayer
31427,UCBPlayer,144,289,433,35,34,UCBPlayer
31428,UCBPlayer,91,196,287,0,71,UCBPlayer
31429,UCBPlayer,148,273,421,35,38,UCBPlayer
31430,UCBPlayer,87,212,299,0,67,UCBPlayer
31431,UCBPlayer,152,257,409,35,42,UCBPlayer
31432,UCBPlayer,84,224,308,0,64,UCBPlayer
31433,UCBPlayer,146,251,397,32,45,UCBPlayer
31434,UCBPlayer,89,234,323,3,60,UCBPlayer
31435,UCBPlayer,138,243,381,28,49,UCBPlayer
31436,UCBPlayer,97,242,339,7,56,UCBPlayer
31437,UCBPlayer,130,235,365,24,53,UCBPlayer
31438,UCBPlayer,105,250,355,11,52,UCBPlayer
31439,UCBPlayer,122,227,349,20,57,UCBPlayer
31440,UCBPlayer,109,259,368,15,49,UCBPlayer
31441,UCBPlayer,118,218,336,16,60,UCBPlayer
31442,UCBPlayer,117,267,384,19,45,UCBPlayer
31443,UCBPlayer,110,210,320,12,64,UCBPlayer
31444,UCBPlayer,126,271,397,23,42,UCBPlayer
31445,UCBPlayer,105,210,315,10,65,UCBPlayer
31446,UCBPlayer,130,275,405,25,40,UCBPlayer
31447,UCBPlayer,105,210,315,10,65,UCBPlayer
31448,UCBPlayer,130,275,405,25,40,UCBPlayer
31449,UCBPlayer,106,206,312,10,66,UCBPlayer
31450,UCBPlayer,130,275,405,25,40,UCBPlayer
31451,UCBPlayer,105,210,315,10,65,UCBPlayer
31452,UCBPlayer,131,271,402,25,41,UCBPlayer
31453,UCBPlayer,105,210,315,10,65,UCBPlayer
31454,UCBPlayer,130,275,405,25,40,UCBPlayer
31455,UCBPlayer,105,210,315,10,65,UCBPlayer
31456,UCBPlayer,130,275,405,25,40,UCBPlayer
31457,UCBPlayer,103,203,306,10,68,UCBPlayer
31458,UCBPlayer,128,283,411,25,38,UCBPlayer
31459,UCBPlayer,111,186,297,10,71,UCBPlayer
31460,UCBPlayer,124,299,423,25,34,UCBPlayer
31461,UCBPlayer,115,170,285,10,75,UCBPlayer
31462,UCBPlayer,120,315,435,25,30,UCBPlayer
31463,UCBPlayer,119,154,273,10,79,UCBPlayer
31464,UCBPlayer,112,332,444,25,27,UCBPlayer
31465,UCBPlayer,127,137,264,10,82,UCBPlayer
31466,UCBPlayer,104,349,453,25,24,UCBPlayer
31467,UCBPlayer,126,126,252,7,85,Tie
31468,UCBPlayer,111,351,462,28,22,UCBPlayer
31469,UCBPlayer,116,126,242,3,87,UCBPlayer
31470,UCBPlayer,122,347,469,32,21,UCBPlayer
31471,UCBPlayer,107,132,239,0,87,UCBPlayer
31472,UCBPlayer,132,337,469,35,22,UCBPlayer
31473,UCBPlayer,103,148,251,0,83,UCBPlayer
31474,UCBPlayer,136,321,457,35,26,UCBPlayer
31475,UCBPlayer,99,164,263,0,79,UCBPlayer
31476,UCBPlayer,140,305,445,35,30,UCBPlayer
31477,UCBPlayer,95,180,275,0,75,UCBPlayer
31478,UCBPlayer,144,289,433,35,34,UCBPlayer
31479,UCBPlayer,91,196,287,0,71,UCBPlayer
31480,UCBPlayer,148,273,421,35,38,UCBPlayer
31481,UCBPlayer,87,212,299,0,67,UCBPlayer
31482,UCBPlayer,152,257,409,35,42,UCBPlayer
31483,UCBPlayer,84,224,308,0,64,UCBPlayer
31484,UCBPlayer,146,251,397,32,45,UCBPlayer
31485,UCBPlayer,89,234,323,3,60,UCBPlayer
31486,UCBPlayer,138,243,381,28,49,UCBPlayer
31487,UCBPlayer,97,242,339,7,56,UCBPlayer
31488,UCBPlayer,130,235,365,24,53,UCBPlayer
31489,UCBPlayer,105,250,355,11,52,UCBPlayer
31490,UCBPlayer,122,227,349,20,57,UCBPlayer
31491,UCBPlayer,109,259,368,15,49,UCBPlayer
31492,UCBPlayer,118,218,336,16,60,UCBPlayer
31493,UCBPlayer,117,267,384,19,45,UCBPlayer
31494,UCBPlayer,110,210,320,12,64,UCBPlayer
31495,UCBPlayer,126,271,397,23,42,UCBPlayer
31496,UCBPlayer,105,210,315,10,65,UCBPlayer
31497,UCBPlayer,130,275,405,25,40,UCBPlayer
31498,UCBPlayer,105,210,315,10,65,UCBPlayer
31499,UCBPlayer,130,275,405,25,40,UCBPlayer
31500,UCBPlayer,106,206,312,10,66,UCBPlayer
31501,UCBPlayer,130,275,405,25,40,UCBPlayer
31502,UCBPlayer,105,210,315,10,65,UCBPlayer
31503,UCBPlayer,131,271,402,25,41,UCBPlayer
31504,UCBPlayer,105,210,315,10,65,UCBPlayer
31505,UCBPlayer,130,275,405,25,40,UCBPlayer
31506,UCBPlayer,105,210,315,10,65,UCBPlayer
31507,UCBPlayer,130,275,405,25,40,UCBPlayer
31508,UCBPlayer,103,203,306,10,68,UCBPlayer
31509,UCBPlayer,128,283,411,25,38,UCBPlayer
31510,UCBPlayer,111,186,297,10,71,UCBPlayer
31511,UCBPlayer,124,299,423,25,34,UCBPlayer
31512,UCBPlayer,115,170,285,10,75,UCBPlayer
31513,UCBPlayer,120,315,435,25,30,UCBPlayer
31514,UCBPlayer,119,154,273,10,79,UCBPlayer
31515,UCBPlayer,112,332,444,25,27,UCBPlayer
31516,UCBPlayer,127,137,264,10,82,UCBPlayer
31517,UCBPlayer,104,349,453,25,24,UCBPlayer
31518,UCBPlayer,126,126,252,7,85,Tie
31519,UCBPlayer,111,351,462,28,22,UCBPlayer
31520,UCBPlayer,116,126,242,3,87,UCBPlayer
31521,UCBPlayer,122,347,469,32,21,UCBPlayer
31522,UCBPlayer,107,132,239,0,87,UCBPlayer
31523,UCBPlayer,132,337,469,35,22,UCBPlayer
31524,UCBPlayer,103,148,251,0,83,UCBPlayer
31525,UCBPlayer,136,321,457,35,26,UCBPlayer
31526,UCBPlayer,99,164,263,0,79,UCBPlayer
31527,UCBPlayer,140,305,445,35,30,UCBPlayer
31528,UCBPlayer,95,180,275,0,75,UCBPlayer
31529,UCBPlayer,144,289,433,35,34,UCBPlayer
31530,UCBPlayer,91,196,287,0,71,UCBPlayer
31531,UCBPlayer,148,273,421,35,38,UCBPlayer
31532,UCBPlayer,87,212,299,0,67,UCBPlayer
31533,UCBPlayer,152,257,409,35,42,UCBPlayer
31534,UCBPlayer,84,224,308,0,64,UCBPlayer
31535,UCBPlayer,146,251,397,32,45,UCBPlayer
31536,UCBPlayer,89,234,323,3,60,UCBPlayer
31537,UCBPlayer,138,243,381,28,49,UCBPlayer
31538,UCBPlayer,97,242,339,7,56,UCBPlayer
31539,UCBPlayer,130,235,365,24,53,UCBPlayer
31540,UCBPlayer,105,250,355,11,52,UCBPlayer
31541,UCBPlayer,122,227,349,20,57,UCBPlayer
31542,UCBPlayer,109,259,368,15,49,UCBPlayer
31543,UCBPlayer,118,218,336,16,60,UCBPlayer
31544,UCBPlayer,117,267,384,19,45,UCBPlayer
31545,UCBPlayer,110,210,320,12,64,UCBPlayer
31546,UCBPlayer,126,271,397,23,42,UCBPlayer
31547,UCBPlayer,105,210,315,10,65,UCBPlayer
31548,UCBPlayer,130,275,405,25,40,UCBPlayer
31549,UCBPlayer,105,210,315,10,65,UCBPlayer
31550,UCBPlayer,130,275,405,25,40,UCBPlayer
31551,UCBPlayer,106,206,312,10,66,UCBPlayer
31552,UCBPlayer,130,275,405,25,40,UCBPlayer
31553,UCBPlayer,105,210,315,10,65,UCBPlayer
31554,UCBPlayer,131,271,402,25,41,UCBPlayer
31555,UCBPlayer,105,210,315,10,65,UCBPlayer
31556,UCBPlayer,130,275,405,25,40,UCBPlayer
31557,UCBPlayer,105,210,315,10,65,UCBPlayer
31558,UCBPlayer,130,275,405,25,40,UCBPlayer
31559,UCBPlayer,103,203,306,10,68,UCBPlayer
31560,UCBPlayer,128,283,411,25,38,UCBPlayer
31561,UCBPlayer,111,186,297,10,71,UCBPlayer
31562,UCBPlayer,124,299,423,25,34,UCBPlayer
31563,UCBPlayer,115,170,285,10,75,UCBPlayer
31564,UCBPlayer,120,315,435,25,30,UCBPlayer
31565,UCBPlayer,119,154,273,10,79,UCBPlayer
31566,UCBPlayer,112,332,444,25,27,UCBPlayer
31567,UCBPlayer,127,137,264,10,82,UCBPlayer
31568,UCBPlayer,104,349,453,25,24,UCBPlayer
31569,UCBPlayer,126,126,252,7,85,Tie
31570,UCBPlayer,111,351,462,28,22,UCBPlayer
31571,UCBPlayer,116,126,242,3,87,UCBPlayer
31572,UCBPlayer,122,347,469,32,21,UCBPlayer
31573,UCBPlayer,107,132,239,0,87,UCBPlayer
31574,UCBPlayer,132,337,469,35,22,UCBPlayer
31575,UCBPlayer,103,148,251,0,83,UCBPlayer
31576,UCBPlayer,136,321,457,35,26,UCBPlayer
31577,UCBPlayer,99,164,263,0,79,UCBPlayer
31578,UCBPlayer,140,305,445,35,30,UCBPlayer
31579,UCBPlayer,95,180,275,0,75,UCBPlayer
31580,UCBPlayer,144,289,433,35,34,UCBPlayer
31581,UCBPlayer,91,196,287,0,71,UCBPlayer
31582,UCBPlayer,148,273,421,35,38,UCBPlayer
31583,UCBPlayer,87,212,299,0,67,UCBPlayer
31584,UCBPlayer,152,257,409,35,42,UCBPlayer
31585,UCBPlayer,84,224,308,0,64,UCBPlayer
31586,UCBPlayer,146,251,397,32,45,UCBPlayer
31587,UCBPlayer,89,234,323,3,60,UCBPlayer
31588,UCBPlayer,138,243,381,28,49,UCBPlayer
31589,UCBPlayer,97,242,339,7,56,UCBPlayer
31590,UCBPlayer,130,235,365,24,53,UCBPlayer
31591,UCBPlayer,105,250,355,11,52,UCBPlayer
31592,UCBPlayer,122,227,349,20,57,UCBPlayer
31593,UCBPlayer,109,259,368,15,49,UCBPlayer
31594,UCBPlayer,118,218,336,16,60,UCBPlayer
31595,UCBPlayer,117,267,384,19,45,UCBPlayer
31596,UCBPlayer,110,210,320,12,64,UCBPlayer
31597,UCBPlayer,126,271,397,23,42,UCBPlayer
31598,UCBPlayer,105,210,315,10,65,UCBPlayer
31599,UCBPlayer,130,275,405,25,40,UCBPlayer
31600,UCBPlayer,105,210,315,10,65,UCBPlayer
31601,UCBPlayer,130,275,405,25,40,UCBPlayer
31602,UCBPlayer,106,206,312,10,66,UCBPlayer
31603,UCBPlayer,130,275,405,25,40,UCBPlayer
31604,UCBPlayer,105,210,315,10,65,UCBPlayer
31605,UCBPlayer,131,271,402,25,41,UCBPlayer
31606,UCBPlayer,105,210,315,10,65,UCBPlayer
31607,UCBPlayer,130,275,405,25,40,UCBPlayer
31608,UCBPlayer,105,210,315,10,65,UCBPlayer
31609,UCBPlayer,130,275,405,25,40,UCBPlayer
31610,UCBPlayer,103,203,306,10,68,UCBPlayer
31611,UCBPlayer,128,283,411,25,38,UCBPlayer
31612,UCBPlayer,111,186,297,10,71,UCBPlayer
31613,UCBPlayer,124,299,423,25,34,UCBPlayer
31614,UCBPlayer,115,170,285,10,75,UCBPlayer
31615,UCBPlayer,120,315,435,25,30,UCBPlayer
31616,UCBPlayer,119,154,273,10,79,UCBPlayer
31617,UCBPlayer,112,332,444,25,27,UCBPlayer
31618,UCBPlayer,127,137,264,10,82,UCBPlayer
31619,UCBPlayer,104,349,453,25,24,UCBPlayer
31620,UCBPlayer,126,126,252,7,85,Tie
31621,UCBPlayer,111,351,462,28,22,UCBPlayer
31622,UCBPlayer,116,126,242,3,87,UCBPlayer
31623,UCBPlayer,122,347,469,32,21,UCBPlayer
31624,UCBPlayer,107,132,239,0,87,UCBPlayer
31625,UCBPlayer,132,337,469,35,22,UCBPlayer
31626,UCBPlayer,103,148,251,0,83,UCBPlayer
31627,UCBPlayer,136,321,457,35,26,UCBPlayer
31628,UCBPlayer,99,164,263,0,79,UCBPlayer
31629,UCBPlayer,140,305,445,35,30,UCBPlayer
31630,UCBPlayer,95,180,275,0,75,UCBPlayer
31631,UCBPlayer,144,289,433,35,34,UCBPlayer
31632,UCBPlayer,91,196,287,0,71,UCBPlayer
31633,UCBPlayer,148,273,421,35,38,UCBPlayer
31634,UCBPlayer,87,212,299,0,67,UCBPlayer
31635,UCBPlayer,152,257,409,35,42,UCBPlayer
31636,UCBPlayer,84,224,308,0,64,UCBPlayer
31637,UCBPlayer,146,251,397,32,45,UCBPlayer
31638,UCBPlayer,89,234,323,3,60,UCBPlayer
31639,UCBPlayer,138,243,381,28,49,UCBPlayer
31640,UCBPlayer,97,242,339,7,56,UCBPlayer
31641,UCBPlayer,130,235,365,24,53,UCBPlayer
31642,UCBPlayer,105,250,355,11,52,UCBPlayer
31643,UCBPlayer,122,227,349,20,57,UCBPlayer
31644,UCBPlayer,109,259,368,15,49,UCBPlayer
31645,UCBPlayer,118,218,336,16,60,UCBPlayer
31646,UCBPlayer,117,267,384,19,45,UCBPlayer
31647,UCBPlayer,110,210,320,12,64,UCBPlayer
31648,UCBPlayer,126,271,397,23,42,UCBPlayer
31649,UCBPlayer,105,210,315,10,65,UCBPlayer
31650,UCBPlayer,130,275,405,25,40,UCBPlayer
31651,UCBPlayer,105,210,315,10,65,UCBPlayer
31652,UCBPlayer,130,275,405,25,40,UCBPlayer
31653,UCBPlayer,106,206,312,10,66,UCBPlayer
31654,UCBPlayer,130,275,405,25,40,UCBPlayer
31655,UCBPlayer,105,210,315,10,65,UCBPlayer
31656,UCBPlayer,131,271,402,25,41,UCBPlayer
31657,UCBPlayer,105,210,315,10,65,UCBPlayer
31658,UCBPlayer,130,275,405,25,40,UCBPlayer
31659,UCBPlayer,105,210,315,10,65,UCBPlayer
31660,UCBPlayer,130,275,405,25,40,UCBPlayer
31661,UCBPlayer,103,203,306,10,68,UCBPlayer
31662,UCBPlayer,128,283,411,25,38,UCBPlayer
31663,UCBPlayer,111,186,297,10,71,UCBPlayer
31664,UCBPlayer,124,299,423,25,34,UCBPlayer
31665,UCBPlayer,115,170,285,10,75,UCBPlayer
31666,UCBPlayer,120,315,435,25,30,UCBPlayer
31667,UCBPlayer,119,154,273,10,79,UCBPlayer
31668,UCBPlayer,112,332,444,25,27,UCBPlayer
31669,UCBPlayer,127,137,264,10,82,UCBPlayer
31670,UCBPlayer,104,349,453,25,24,UCBPlayer
31671,UCBPlayer,126,126,252,7,85,Tie
31672,UCBPlayer,111,351,462,28,22,UCBPlayer
31673,UCBPlayer,116,126,242,3,87,UCBPlayer
31674,UCBPlayer,122,347,469,32,21,UCBPlayer
31675,UCBPlayer,107,132,239,0,87,UCBPlayer
31676,UCBPlayer,132,337,469,35,22,UCBPlayer
31677,UCBPlayer,103,148,251,0,83,UCBPlayer
31678,UCBPlayer,136,321,457,35,26,UCBPlayer
31679,UCBPlayer,99,164,263,0,79,UCBPlayer
31680,UCBPlayer,140,305,445,35,30,UCBPlayer
31681,UCBPlayer,95,180,275,0,75,UCBPlayer
31682,UCBPlayer,144,289,433,35,34,UCBPlayer
31683,UCBPlayer,91,196,287,0,71,UCBPlayer
31684,UCBPlayer,148,273,421,35,38,UCBPlayer
31685,UCBPlayer,87,212,299,0,67,UCBPlayer
31686,UCBPlayer,152,257,409,35,42,UCBPlayer
31687,UCBPlayer,84,224,308,0,64,UCBPlayer
31688,UCBPlayer,146,251,397,32,45,UCBPlayer
31689,UCBPlayer,89,234,323,3,60,UCBPlayer
31690,UCBPlayer,138,243,381,28,49,UCBPlayer
31691,UCBPlayer,97,242,339,7,56,UCBPlayer
31692,UCBPlayer,130,235,365,24,53,UCBPlayer
31693,UCBPlayer,105,250,355,11,52,UCBPlayer
31694,UCBPlayer,122,227,349,20,57,UCBPlayer
31695,UCBPlayer,109,259,368,15,49,UCBPlayer
31696,UCBPlayer,118,218,336,16,60,UCBPlayer
31697,UCBPlayer,117,267,384,19,45,UCBPlayer
31698,UCBPlayer,110,210,320,12,64,UCBPlayer
31699,UCBPlayer,126,271,397,23,42,UCBPlayer
31700,UCBPlayer,105,210,315,10,65,UCBPlayer
31701,UCBPlayer,130,275,405,25,40,UCBPlayer
31702,UCBPlayer,105,210,315,10,65,UCBPlayer
31703,UCBPlayer,130,275,405,25,40,UCBPlayer
31704,UCBPlayer,106,206,312,10,66,UCBPlayer
31705,UCBPlayer,130,275,405,25,40,UCBPlayer
31706,UCBPlayer,105,210,315,10,65,UCBPlayer
31707,UCBPlayer,131,271,402,25,41,UCBPlayer
31708,UCBPlayer,105,210,315,10,65,UCBPlayer
31709,UCBPlayer,130,275,405,25,40,UCBPlayer
31710,UCBPlayer,105,210,315,10,65,UCBPlayer
31711,UCBPlayer,130,275,405,25,40,UCBPlayer
31712,UCBPlayer,103,203,306,10,68,UCBPlayer
31713,UCBPlayer,128,283,411,25,38,UCBPlayer
31714,UCBPlayer,111,186,297,10,71,UCBPlayer
31715,UCBPlayer,124,299,423,25,34,UCBPlayer
31716,UCBPlayer,115,170,285,10,75,UCBPlayer
31717,UCBPlayer,120,315,435,25,30,UCBPlayer
31718,UCBPlayer,119,154,273,10,79,UCBPlayer
31719,UCBPlayer,112,332,444,25,27,UCBPlayer
31720,UCBPlayer,127,137,264,10,82,UCBPlayer
31721,UCBPlayer,104,349,453,25,24,UCBPlayer
31722,UCBPlayer,126,126,252,7,85,Tie
31723,UCBPlayer,111,351,462,28,22,UCBPlayer
31724,UCBPlayer,116,126,242,3,87,UCBPlayer
31725,UCBPlayer,122,347,469,32,21,UCBPlayer
31726,UCBPlayer,107,132,239,0,87,UCBPlayer
31727,UCBPlayer,132,337,469,35,22,UCBPlayer
31728,UCBPlayer,103,148,251,0,83,UCBPlayer
31729,UCBPlayer,136,321,457,35,26,UCBPlayer
31730,UCBPlayer,99,164,263,0,79,UCBPlayer
31731,UCBPlayer,140,305,445,35,30,UCBPlayer
31732,UCBPlayer,95,180,275,0,75,UCBPlayer
31733,UCBPlayer,144,289,433,35,34,UCBPlayer
31734,UCBPlayer,91,196,287,0,71,UCBPlayer
31735,UCBPlayer,148,273,421,35,38,UCBPlayer
31736,UCBPlayer,87,212,299,0,67,UCBPlayer
31737,UCBPlayer,152,257,409,35,42,UCBPlayer
31738,UCBPlayer,84,224,308,0,64,UCBPlayer
31739,UCBPlayer,146,251,397,32,45,UCBPlayer
31740,UCBPlayer,89,234,323,3,60,UCBPlayer
31741,UCBPlayer,138,243,381,28,49,UCBPlayer
31742,UCBPlayer,97,242,339,7,56,UCBPlayer
31743,UCBPlayer,130,235,365,24,53,UCBPlayer
31744,UCBPlayer,105,250,355,11,52,UCBPlayer
31745,UCBPlayer,122,227,349,20,57,UCBPlayer
31746,UCBPlayer,109,259,368,15,49,UCBPlayer
31747,UCBPlayer,118,218,336,16,60,UCBPlayer
31748,UCBPlayer,117,267,384,19,45,UCBPlayer
31749,UCBPlayer,110,210,320,12,64,UCBPlayer
31750,UCBPlayer,126,271,397,23,42,UCBPlayer
31751,UCBPlayer,105,210,315,10,65,UCBPlayer
31752,UCBPlayer,130,275,405,25,40,UCBPlayer
31753,UCBPlayer,105,210,315,10,65,UCBPlayer
31754,UCBPlayer,130,275,405,25,40,UCBPlayer
31755,UCBPlayer,106,206,312,10,66,UCBPlayer
31756,UCBPlayer,130,275,405,25,40,UCBPlayer
31757,UCBPlayer,105,210,315,10,65,UCBPlayer
31758,UCBPlayer,131,271,402,25,41,UCBPlayer
31759,UCBPlayer,105,210,315,10,65,UCBPlayer
31760,UCBPlayer,130,275,405,25,40,UCBPlayer
31761,UCBPlayer,105,210,315,10,65,UCBPlayer
31762,UCBPlayer,130,275,405,25,40,UCBPlayer
31763,UCBPlayer,103,203,306,10,68,UCBPlayer
31764,UCBPlayer,128,283,411,25,38,UCBPlayer
31765,UCBPlayer,111,186,297,10,71,UCBPlayer
31766,UCBPlayer,124,299,423,25,34,UCBPlayer
31767,UCBPlayer,115,170,285,10,75,UCBPlayer
31768,UCBPlayer,120,315,435,25,30,UCBPlayer
31769,UCBPlayer,119,154,273,10,79,UCBPlayer
31770,UCBPlayer,112,332,444,25,27,UCBPlayer
31771,UCBPlayer,127,137,264,10,82,UCBPlayer
31772,UCBPlayer,104,349,453,25,24,UCBPlayer
31773,UCBPlayer,126,126,252,7,85,Tie
31774,UCBPlayer,111,351,462,28,22,UCBPlayer
31775,UCBPlayer,116,126,242,3,87,UCBPlayer
31776,UCBPlayer,122,347,469,32,21,UCBPlayer
31777,UCBPlayer,107,132,239,0,87,UCBPlayer
31778,UCBPlayer,132,337,469,35,22,UCBPlayer
31779,UCBPlayer,103,148,251,0,83,UCBPlayer
31780,UCBPlayer,136,321,457,35,26,UCBPlayer
31781,UCBPlayer,99,164,263,0,79,UCBPlayer
31782,UCBPlayer,140,305,445,35,30,UCBPlayer
31783,UCBPlayer,95,180,275,0,75,UCBPlayer
31784,UCBPlayer,144,289,433,35,34,UCBPlayer
31785,UCBPlayer,91,196,287,0,71,UCBPlayer
31786,UCBPlayer,148,273,421,35,38,UCBPlayer
31787,UCBPlayer,87,212,299,0,67,UCBPlayer
31788,UCBPlayer,152,257,409,35,42,UCBPlayer
31789,UCBPlayer,84,224,308,0,64,UCBPlayer
31790,UCBPlayer,146,251,397,32,45,UCBPlayer
31791,UCBPlayer,89,234,323,3,60,UCBPlayer
31792,UCBPlayer,138,243,381,28,49,UCBPlayer
31793,UCBPlayer,97,242,339,7,56,UCBPlayer
31794,UCBPlayer,130,235,365,24,53,UCBPlayer
31795,UCBPlayer,105,250,355,11,52,UCBPlayer
31796,UCBPlayer,122,227,349,20,57,UCBPlayer
31797,UCBPlayer,109,259,368,15,49,UCBPlayer
31798,UCBPlayer,118,218,336,16,60,UCBPlayer
31799,UCBPlayer,117,267,384,19,45,UCBPlayer
31800,UCBPlayer,110,210,320,12,64,UCBPlayer
31801,UCBPlayer,126,271,397,23,42,UCBPlayer
31802,UCBPlayer,105,210,315,10,65,UCBPlayer
31803,UCBPlayer,130,275,405,25,40,UCBPlayer
31804,UCBPlayer,105,210,315,10,65,UCBPlayer
31805,UCBPlayer,130,275,405,25,40,UCBPlayer
31806,UCBPlayer,106,206,312,10,66,UCBPlayer
31807,UCBPlayer,130,275,405,25,40,UCBPlayer
31808,UCBPlayer,105,210,315,10,65,UCBPlayer
31809,UCBPlayer,131,271,402,25,41,UCBPlayer
31810,UCBPlayer,105,210,315,10,65,UCBPlayer
31811,UCBPlayer,130,275,405,25,40,UCBPlayer
31812,UCBPlayer,105,210,315,10,65,UCBPlayer
31813,UCBPlayer,130,275,405,25,40,UCBPlayer
31814,UCBPlayer,103,203,306,10,68,UCBPlayer
31815,UCBPlayer,128,283,411,25,38,UCBPlayer
31816,UCBPlayer,111,186,297,10,71,UCBPlayer
31817,UCBPlayer,124,299,423,25,34,UCBPlayer
31818,UCBPlayer,115,170,285,10,75,UCBPlayer
31819,UCBPlayer,120,315,435,25,30,UCBPlayer
31820,UCBPlayer,119,154,273,10,79,UCBPlayer
31821,UCBPlayer,112,332,444,25,27,UCBPlayer
31822,UCBPlayer,127,137,264,10,82,UCBPlayer
31823,UCBPlayer,104,349,453,25,24,UCBPlayer
31824,UCBPlayer,126,126,252,7,85,Tie
31825,UCBPlayer,111,351,462,28,22,UCBPlayer
31826,UCBPlayer,116,126,242,3,87,UCBPlayer
31827,UCBPlayer,122,347,469,32,21,UCBPlayer
31828,UCBPlayer,107,132,239,0,87,UCBPlayer
31829,UCBPlayer,132,337,469,35,22,UCBPlayer
31830,UCBPlayer,103,148,251,0,83,UCBPlayer
31831,UCBPlayer,136,321,457,35,26,UCBPlayer
31832,UCBPlayer,99,164,263,0,79,UCBPlayer
31833,UCBPlayer,140,305,445,35,30,UCBPlayer
31834,UCBPlayer,95,180,275,0,75,UCBPlayer
31835,UCBPlayer,144,289,433,35,34,UCBPlayer
31836,UCBPlayer,91,196,287,0,71,UCBPlayer
31837,UCBPlayer,148,273,421,35,38,UCBPlayer
31838,UCBPlayer,87,212,299,0,67,UCBPlayer
31839,UCBPlayer,152,257,409,35,42,UCBPlayer
31840,UCBPlayer,84,224,308,0,64,UCBPlayer
31841,UCBPlayer,146,251,397,32,45,UCBPlayer
31842,UCBPlayer,89,234,323,3,60,UCBPlayer
31843,UCBPlayer,138,243,381,28,49,UCBPlayer
31844,UCBPlayer,97,242,339,7,56,UCBPlayer
31845,UCBPlayer,130,235,365,24,53,UCBPlayer
31846,UCBPlayer,105,250,355,11,52,UCBPlayer
31847,UCBPlayer,122,227,349,20,57,UCBPlayer
31848,UCBPlayer,109,259,368,15,49,UCBPlayer
31849,UCBPlayer,118,218,336,16,60,UCBPlayer
31850,UCBPlayer,117,267,384,19,45,UCBPlayer
31851,UCBPlayer,110,210,320,12,64,UCBPlayer
31852,UCBPlayer,126,271,397,23,42,UCBPlayer
31853,UCBPlayer,105,210,315,10,65,UCBPlayer
31854,UCBPlayer,130,275,405,25,40,UCBPlayer
31855,UCBPlayer,105,210,315,10,65,UCBPlayer
31856,UCBPlayer,130,275,405,25,40,UCBPlayer
31857,UCBPlayer,106,206,312,10,66,UCBPlayer
31858,UCBPlayer,130,275,405,25,40,UCBPlayer
31859,UCBPlayer,105,210,315,10,65,UCBPlayer
31860,UCBPlayer,131,271,402,25,41,UCBPlayer
31861,UCBPlayer,105,210,315,10,65,UCBPlayer
31862,UCBPlayer,130,275,405,25,40,UCBPlayer
31863,UCBPlayer,105,210,315,10,65,UCBPlayer
31864,UCBPlayer,130,275,405,25,40,UCBPlayer
31865,UCBPlayer,103,203,306,10,68,UCBPlayer
31866,UCBPlayer,128,283,411,25,38,UCBPlayer
31867,UCBPlayer,111,186,297,10,71,UCBPlayer
31868,UCBPlayer,124,299,423,25,34,UCBPlayer
31869,UCBPlayer,115,170,285,10,75,UCBPlayer
31870,UCBPlayer,120,315,435,25,30,UCBPlayer
31871,UCBPlayer,119,154,273,10,79,UCBPlayer
31872,UCBPlayer,112,332,444,25,27,UCBPlayer
31873,UCBPlayer,127,137,264,10,82,UCBPlayer
31874,UCBPlayer,104,349,453,25,24,UCBPlayer
31875,UCBPlayer,126,126,252,7,85,Tie
31876,UCBPlayer,111,351,462,28,22,UCBPlayer
31877,UCBPlayer,116,126,242,3,87,UCBPlayer
31878,UCBPlayer,122,347,469,32,21,UCBPlayer
31879,UCBPlayer,107,132,239,0,87,UCBPlayer
31880,UCBPlayer,132,337,469,35,22,UCBPlayer
31881,UCBPlayer,103,148,251,0,83,UCBPlayer
31882,UCBPlayer,136,321,457,35,26,UCBPlayer
31883,UCBPlayer,99,164,263,0,79,UCBPlayer
31884,UCBPlayer,140,305,445,35,30,UCBPlayer
31885,UCBPlayer,95,180,275,0,75,UCBPlayer
31886,UCBPlayer,144,289,433,35,34,UCBPlayer
31887,UCBPlayer,91,196,287,0,71,UCBPlayer
31888,UCBPlayer,148,273,421,35,38,UCBPlayer
31889,UCBPlayer,87,212,299,0,67,UCBPlayer
31890,UCBPlayer,152,257,409,35,42,UCBPlayer
31891,UCBPlayer,84,224,308,0,64,UCBPlayer
31892,UCBPlayer,146,251,397,32,45,UCBPlayer
31893,UCBPlayer,89,234,323,3,60,UCBPlayer
31894,UCBPlayer,138,243,381,28,49,UCBPlayer
31895,UCBPlayer,97,242,339,7,56,UCBPlayer
31896,UCBPlayer,130,235,365,24,53,UCBPlayer
31897,UCBPlayer,105,250,355,11,52,UCBPlayer
31898,UCBPlayer,122,227,349,20,57,UCBPlayer
31899,UCBPlayer,109,259,368,15,49,UCBPlayer
31900,UCBPlayer,118,218,336,16,60,UCBPlayer
31901,UCBPlayer,117,267,384,19,45,UCBPlayer
31902,UCBPlayer,110,210,320,12,64,UCBPlayer
31903,UCBPlayer,126,271,397,23,42,UCBPlayer
31904,UCBPlayer,105,210,315,10,65,UCBPlayer
31905,UCBPlayer,130,275,405,25,40,UCBPlayer
31906,UCBPlayer,105,210,315,10,65,UCBPlayer
31907,UCBPlayer,130,275,405,25,40,UCBPlayer
31908,UCBPlayer,106,206,312,10,66,UCBPlayer
31909,UCBPlayer,130,275,405,25,40,UCBPlayer
31910,UCBPlayer,105,210,315,10,65,UCBPlayer
31911,UCBPlayer,131,271,402,25,41,UCBPlayer
31912,UCBPlayer,105,210,315,10,65,UCBPlayer
31913,UCBPlayer,130,275,405,25,40,UCBPlayer
31914,UCBPlayer,105,210,315,10,65,UCBPlayer
31915,UCBPlayer,130,275,405,25,40,UCBPlayer
31916,UCBPlayer,103,203,306,10,68,UCBPlayer
31917,UCBPlayer,128,283,411,25,38,UCBPlayer
31918,UCBPlayer,111,186,297,10,71,UCBPlayer
31919,UCBPlayer,124,299,423,25,34,UCBPlayer
31920,UCBPlayer,115,170,285,10,75,UCBPlayer
31921,UCBPlayer,120,315,435,25,30,UCBPlayer
31922,UCBPlayer,119,154,273,10,79,UCBPlayer
31923,UCBPlayer,112,332,444,25,27,UCBPlayer
31924,UCBPlayer,127,137,264,10,82,UCBPlayer
31925,UCBPlayer,104,349,453,25,24,UCBPlayer
31926,UCBPlayer,126,126,252,7,85,Tie
31927,UCBPlayer,111,351,462,28,22,UCBPlayer
31928,UCBPlayer,116,126,242,3,87,UCBPlayer
31929,UCBPlayer,122,347,469,32,21,UCBPlayer
31930,UCBPlayer,107,132,239,0,87,UCBPlayer
31931,UCBPlayer,132,337,469,35,22,UCBPlayer
31932,UCBPlayer,103,148,251,0,83,UCBPlayer
31933,UCBPlayer,136,321,457,35,26,UCBPlayer
31934,UCBPlayer,99,164,263,0,79,UCBPlayer
31935,UCBPlayer,140,305,445,35,30,UCBPlayer
31936,UCBPlayer,95,180,275,0,75,UCBPlayer
31937,UCBPlayer,144,289,433,35,34,UCBPlayer
31938,UCBPlayer,91,196,287,0,71,UCBPlayer
31939,UCBPlayer,148,273,421,35,38,UCBPlayer
31940,UCBPlayer,87,212,299,0,67,UCBPlayer
31941,UCBPlayer,152,257,409,35,42,UCBPlayer
31942,UCBPlayer,84,224,308,0,64,UCBPlayer
31943,UCBPlayer,146,251,397,32,45,UCBPlayer
31944,UCBPlayer,89,234,323,3,60,UCBPlayer
31945,UCBPlayer,138,243,381,28,49,UCBPlayer
31946,UCBPlayer,97,242,339,7,56,UCBPlayer
31947,UCBPlayer,130,235,365,24,53,UCBPlayer
31948,UCBPlayer,105,250,355,11,52,UCBPlayer
31949,UCBPlayer,122,227,349,20,57,UCBPlayer
31950,UCBPlayer,109,259,368,15,49,UCBPlayer
31951,UCBPlayer,118,218,336,16,60,UCBPlayer
31952,UCBPlayer,117,267,384,19,45,UCBPlayer
31953,UCBPlayer,110,210,320,12,64,UCBPlayer
31954,UCBPlayer,126,271,397,23,42,UCBPlayer
31955,UCBPlayer,105,210,315,10,65,UCBPlayer
31956,UCBPlayer,130,275,405,25,40,UCBPlayer
31957,UCBPlayer,105,210,315,10,65,UCBPlayer
31958,UCBPlayer,130,275,405,25,40,UCBPlayer
31959,UCBPlayer,106,206,312,10,66,UCBPlayer
31960,UCBPlayer,130,275,405,25,40,UCBPlayer
31961,UCBPlayer,105,210,315,10,65,UCBPlayer
31962,UCBPlayer,131,271,402,25,41,UCBPlayer
31963,UCBPlayer,105,210,315,10,65,UCBPlayer
31964,UCBPlayer,130,275,405,25,40,UCBPlayer
31965,UCBPlayer,105,210,315,10,65,UCBPlayer
31966,UCBPlayer,130,275,405,25,40,UCBPlayer
31967,UCBPlayer,103,203,306,10,68,UCBPlayer
31968,UCBPlayer,128,283,411,25,38,UCBPlayer
31969,UCBPlayer,111,186,297,10,71,UCBPlayer
31970,UCBPlayer,124,299,423,25,34,UCBPlayer
31971,UCBPlayer,115,170,285,10,75,UCBPlayer
31972,UCBPlayer,120,315,435,25,30,UCBPlayer
31973,UCBPlayer,119,154,273,10,79,UCBPlayer
31974,UCBPlayer,112,332,444,25,27,UCBPlayer
31975,UCBPlayer,127,137,264,10,82,UCBPlayer
31976,UCBPlayer,104,349,453,25,24,UCBPlayer
31977,UCBPlayer,126,126,252,7,85,Tie
31978,UCBPlayer,111,351,462,28,22,UCBPlayer
31979,UCBPlayer,116,126,242,3,87,UCBPlayer
31980,UCBPlayer,122,347,469,32,21,UCBPlayer
31981,UCBPlayer,107,132,239,0,87,UCBPlayer
31982,UCBPlayer,132,337,469,35,22,UCBPlayer
31983,UCBPlayer,103,148,251,0,83,UCBPlayer
31984,UCBPlayer,136,321,457,35,26,UCBPlayer
31985,UCBPlayer,99,164,263,0,79,UCBPlayer
31986,UCBPlayer,140,305,445,35,30,UCBPlayer
31987,UCBPlayer,95,180,275,0,75,UCBPlayer
31988,UCBPlayer,144,289,433,35,34,UCBPlayer
31989,UCBPlayer,91,196,287,0,71,UCBPlayer
31990,UCBPlayer,148,273,421,35,38,UCBPlayer
31991,UCBPlayer,87,212,299,0,67,UCBPlayer
31992,UCBPlayer,152,257,409,35,42,UCBPlayer
31993,UCBPlayer,84,224,308,0,64,UCBPlayer
31994,UCBPlayer,146,251,397,32,45,UCBPlayer
31995,UCBPlayer,89,234,323,3,60,UCBPlayer
31996,UCBPlayer,138,243,381,28,49,UCBPlayer
31997,UCBPlayer,97,242,339,7,56,UCBPlayer
31998,UCBPlayer,130,235,365,24,53,UCBPlayer
31999,UCBPlayer,105,250,355,11,52,UCBPlayer
32000,UCBPlayer,122,227,349,20,57,UCBPlayer
32001,UCBPlayer,109,259,368,15,49,UCBPlayer
32002,UCBPlayer,118,218,336,16,60,UCBPlayer
32003,UCBPlayer,117,267,384,19,45,UCBPlayer
32004,UCBPlayer,110,210,320,12,64,UCBPlayer
32005,UCBPlayer,126,271,397,23,42,UCBPlayer
32006,UCBPlayer,105,210,315,10,65,UCBPlayer
32007,UCBPlayer,130,275,405,25,40,UCBPlayer
32008,UCBPlayer,105,210,315,10,65,UCBPlayer
32009,UCBPlayer,130,275,405,25,40,UCBPlayer
32010,UCBPlayer,106,206,312,10,66,UCBPlayer
32011,UCBPlayer,130,275,405,25,40,UCBPlayer
32012,UCBPlayer,105,210,315,10,65,UCBPlayer
32013,UCBPlayer,131,271,402,25,41,UCBPlayer
32014,UCBPlayer,105,210,315,10,65,UCBPlayer
32015,UCBPlayer,130,275,405,25,40,UCBPlayer
32016,UCBPlayer,105,210,315,10,65,UCBPlayer
32017,UCBPlayer,130,275,405,25,40,UCBPlayer
32018,UCBPlayer,103,203,306,10,68,UCBPlayer
32019,UCBPlayer,128,283,411,25,38,UCBPlayer
32020,UCBPlayer,111,186,297,10,71,UCBPlayer
32021,UCBPlayer,124,299,423,25,34,UCBPlayer
32022,UCBPlayer,115,170,285,10,75,UCBPlayer
32023,UCBPlayer,120,315,435,25,30,UCBPlayer
32024,UCBPlayer,119,154,273,10,79,UCBPlayer
32025,UCBPlayer,112,332,444,25,27,UCBPlayer
32026,UCBPlayer,127,137,264,10,82,UCBPlayer
32027,UCBPlayer,104,349,453,25,24,UCBPlayer
32028,UCBPlayer,126,126,252,7,85,Tie
32029,UCBPlayer,111,351,462,28,22,UCBPlayer
32030,UCBPlayer,116,126,242,3,87,UCBPlayer
32031,UCBPlayer,122,347,469,32,21,UCBPlayer
32032,UCBPlayer,107,132,239,0,87,UCBPlayer
32033,UCBPlayer,132,337,469,35,22,UCBPlayer
32034,UCBPlayer,103,148,251,0,83,UCBPlayer
32035,UCBPlayer,136,321,457,35,26,UCBPlayer
32036,UCBPlayer,99,164,263,0,79,UCBPlayer
32037,UCBPlayer,140,305,445,35,30,UCBPlayer
32038,UCBPlayer,95,180,275,0,75,UCBPlayer
32039,UCBPlayer,144,289,433,35,34,UCBPlayer
32040,UCBPlayer,91,196,287,0,71,UCBPlayer
32041,UCBPlayer,148,273,421,35,38,UCBPlayer
32042,UCBPlayer,87,212,299,0,67,UCBPlayer
32043,UCBPlayer,152,257,409,35,42,UCBPlayer
32044,UCBPlayer,84,224,308,0,64,UCBPlayer
32045,UCBPlayer,146,251,397,32,45,UCBPlayer
32046,UCBPlayer,89,234,323,3,60,UCBPlayer
32047,UCBPlayer,138,243,381,28,49,UCBPlayer
32048,UCBPlayer,97,242,339,7,56,UCBPlayer
32049,UCBPlayer,130,235,365,24,53,UCBPlayer
32050,UCBPlayer,105,250,355,11,52,UCBPlayer
32051,UCBPlayer,122,227,349,20,57,UCBPlayer
32052,UCBPlayer,109,259,368,15,49,UCBPlayer
32053,UCBPlayer,118,218,336,16,60,UCBPlayer
32054,UCBPlayer,117,267,384,19,45,UCBPlayer
32055,UCBPlayer,110,210,320,12,64,UCBPlayer
32056,UCBPlayer,126,271,397,23,42,UCBPlayer
32057,UCBPlayer,105,210,315,10,65,UCBPlayer
32058,UCBPlayer,130,275,405,25,40,UCBPlayer
32059,UCBPlayer,105,210,315,10,65,UCBPlayer
32060,UCBPlayer,130,275,405,25,40,UCBPlayer
32061,UCBPlayer,106,206,312,10,66,UCBPlayer
32062,UCBPlayer,130,275,405,25,40,UCBPlayer
32063,UCBPlayer,105,210,315,10,65,UCBPlayer
32064,UCBPlayer,131,271,402,25,41,UCBPlayer
32065,UCBPlayer,105,210,315,10,65,UCBPlayer
32066,UCBPlayer,130,275,405,25,40,UCBPlayer
32067,UCBPlayer,105,210,315,10,65,UCBPlayer
32068,UCBPlayer,130,275,405,25,40,UCBPlayer
32069,UCBPlayer,103,203,306,10,68,UCBPlayer
32070,UCBPlayer,128,283,411,25,38,UCBPlayer
32071,UCBPlayer,111,186,297,10,71,UCBPlayer
32072,UCBPlayer,124,299,423,25,34,UCBPlayer
32073,UCBPlayer,115,170,285,10,75,UCBPlayer
32074,UCBPlayer,120,315,435,25,30,UCBPlayer
32075,UCBPlayer,119,154,273,10,79,UCBPlayer
32076,UCBPlayer,112,332,444,25,27,UCBPlayer
32077,UCBPlayer,127,137,264,10,82,UCBPlayer
32078,UCBPlayer,104,349,453,25,24,UCBPlayer
32079,UCBPlayer,126,126,252,7,85,Tie
32080,UCBPlayer,111,351,462,28,22,UCBPlayer
32081,UCBPlayer,116,126,242,3,87,UCBPlayer
32082,UCBPlayer,122,347,469,32,21,UCBPlayer
32083,UCBPlayer,107,132,239,0,87,UCBPlayer
32084,UCBPlayer,132,337,469,35,22,UCBPlayer
32085,UCBPlayer,103,148,251,0,83,UCBPlayer
32086,UCBPlayer,136,321,457,35,26,UCBPlayer
32087,UCBPlayer,99,164,263,0,79,UCBPlayer
32088,UCBPlayer,140,305,445,35,30,UCBPlayer
32089,UCBPlayer,95,180,275,0,75,UCBPlayer
32090,UCBPlayer,144,289,433,35,34,UCBPlayer
32091,UCBPlayer,91,196,287,0,71,UCBPlayer
32092,UCBPlayer,148,273,421,35,38,UCBPlayer
32093,UCBPlayer,87,212,299,0,67,UCBPlayer
32094,UCBPlayer,152,257,409,35,42,UCBPlayer
32095,UCBPlayer,84,224,308,0,64,UCBPlayer
32096,UCBPlayer,146,251,397,32,45,UCBPlayer
32097,UCBPlayer,89,234,323,3,60,UCBPlayer
32098,UCBPlayer,138,243,381,28,49,UCBPlayer
32099,UCBPlayer,97,242,339,7,56,UCBPlayer
32100,UCBPlayer,130,235,365,24,53,UCBPlayer
32101,UCBPlayer,105,250,355,11,52,UCBPlayer
32102,UCBPlayer,122,227,349,20,57,UCBPlayer
32103,UCBPlayer,109,259,368,15,49,UCBPlayer
32104,UCBPlayer,118,218,336,16,60,UCBPlayer
32105,UCBPlayer,117,267,384,19,45,UCBPlayer
32106,UCBPlayer,110,210,320,12,64,UCBPlayer
32107,UCBPlayer,126,271,397,23,42,UCBPlayer
32108,UCBPlayer,105,210,315,10,65,UCBPlayer
32109,UCBPlayer,130,275,405,25,40,UCBPlayer
32110,UCBPlayer,105,210,315,10,65,UCBPlayer
32111,UCBPlayer,130,275,405,25,40,UCBPlayer
32112,UCBPlayer,106,206,312,10,66,UCBPlayer
32113,UCBPlayer,130,275,405,25,40,UCBPlayer
32114,UCBPlayer,105,210,315,10,65,UCBPlayer
32115,UCBPlayer,131,271,402,25,41,UCBPlayer
32116,UCBPlayer,105,210,315,10,65,UCBPlayer
32117,UCBPlayer,130,275,405,25,40,UCBPlayer
32118,UCBPlayer,105,210,315,10,65,UCBPlayer
32119,UCBPlayer,130,275,405,25,40,UCBPlayer
32120,UCBPlayer,103,203,306,10,68,UCBPlayer
32121,UCBPlayer,128,283,411,25,38,UCBPlayer
32122,UCBPlayer,111,186,297,10,71,UCBPlayer
32123,UCBPlayer,124,299,423,25,34,UCBPlayer
32124,UCBPlayer,115,170,285,10,75,UCBPlayer
32125,UCBPlayer,120,315,435,25,30,UCBPlayer
32126,UCBPlayer,119,154,273,10,79,UCBPlayer
32127,UCBPlayer,112,332,444,25,27,UCBPlayer
32128,UCBPlayer,127,137,264,10,82,UCBPlayer
32129,UCBPlayer,104,349,453,25,24,UCBPlayer
32130,UCBPlayer,126,126,252,7,85,Tie
32131,UCBPlayer,111,351,462,28,22,UCBPlayer
32132,UCBPlayer,116,126,242,3,87,UCBPlayer
32133,UCBPlayer,122,347,469,32,21,UCBPlayer
32134,UCBPlayer,107,132,239,0,87,UCBPlayer
32135,UCBPlayer,132,337,469,35,22,UCBPlayer
32136,UCBPlayer,103,148,251,0,83,UCBPlayer
32137,UCBPlayer,136,321,457,35,26,UCBPlayer
32138,UCBPlayer,99,164,263,0,79,UCBPlayer
32139,UCBPlayer,140,305,445,35,30,UCBPlayer
32140,UCBPlayer,95,180,275,0,75,UCBPlayer
32141,UCBPlayer,144,289,433,35,34,UCBPlayer
32142,UCBPlayer,91,196,287,0,71,UCBPlayer
32143,UCBPlayer,148,273,421,35,38,UCBPlayer
32144,UCBPlayer,87,212,299,0,67,UCBPlayer
32145,UCBPlayer,152,257,409,35,42,UCBPlayer
32146,UCBPlayer,84,224,308,0,64,UCBPlayer
32147,UCBPlayer,146,251,397,32,45,UCBPlayer
32148,UCBPlayer,89,234,323,3,60,UCBPlayer
32149,UCBPlayer,138,243,381,28,49,UCBPlayer
32150,UCBPlayer,97,242,339,7,56,UCBPlayer
32151,UCBPlayer,130,235,365,24,53,UCBPlayer
32152,UCBPlayer,105,250,355,11,52,UCBPlayer
32153,UCBPlayer,122,227,349,20,57,UCBPlayer
32154,UCBPlayer,109,259,368,15,49,UCBPlayer
32155,UCBPlayer,118,218,336,16,60,UCBPlayer
32156,UCBPlayer,117,267,384,19,45,UCBPlayer
32157,UCBPlayer,110,210,320,12,64,UCBPlayer
32158,UCBPlayer,126,271,397,23,42,UCBPlayer
32159,UCBPlayer,105,210,315,10,65,UCBPlayer
32160,UCBPlayer,130,275,405,25,40,UCBPlayer
32161,UCBPlayer,105,210,315,10,65,UCBPlayer
32162,UCBPlayer,130,275,405,25,40,UCBPlayer
32163,UCBPlayer,106,206,312,10,66,UCBPlayer
32164,UCBPlayer,130,275,405,25,40,UCBPlayer
32165,UCBPlayer,105,210,315,10,65,UCBPlayer
32166,UCBPlayer,131,271,402,25,41,UCBPlayer
32167,UCBPlayer,105,210,315,10,65,UCBPlayer
32168,UCBPlayer,130,275,405,25,40,UCBPlayer
32169,UCBPlayer,105,210,315,10,65,UCBPlayer
32170,UCBPlayer,130,275,405,25,40,UCBPlayer
32171,UCBPlayer,103,203,306,10,68,UCBPlayer
32172,UCBPlayer,128,283,411,25,38,UCBPlayer
32173,UCBPlayer,111,186,297,10,71,UCBPlayer
32174,UCBPlayer,124,299,423,25,34,UCBPlayer
32175,UCBPlayer,115,170,285,10,75,UCBPlayer
32176,UCBPlayer,120,315,435,25,30,UCBPlayer
32177,UCBPlayer,119,154,273,10,79,UCBPlayer
32178,UCBPlayer,112,332,444,25,27,UCBPlayer
32179,UCBPlayer,127,137,264,10,82,UCBPlayer
32180,UCBPlayer,104,349,453,25,24,UCBPlayer
32181,UCBPlayer,126,126,252,7,85,Tie
32182,UCBPlayer,111,351,462,28,22,UCBPlayer
32183,UCBPlayer,116,126,242,3,87,UCBPlayer
32184,UCBPlayer,122,347,469,32,21,UCBPlayer
32185,UCBPlayer,107,132,239,0,87,UCBPlayer
32186,UCBPlayer,132,337,469,35,22,UCBPlayer
32187,UCBPlayer,103,148,251,0,83,UCBPlayer
32188,UCBPlayer,136,321,457,35,26,UCBPlayer
32189,UCBPlayer,99,164,263,0,79,UCBPlayer
32190,UCBPlayer,140,305,445,35,30,UCBPlayer
32191,UCBPlayer,95,180,275,0,75,UCBPlayer
32192,UCBPlayer,144,289,433,35,34,UCBPlayer
32193,UCBPlayer,91,196,287,0,71,UCBPlayer
32194,UCBPlayer,148,273,421,35,38,UCBPlayer
32195,UCBPlayer,87,212,299,0,67,UCBPlayer
32196,UCBPlayer,152,257,409,35,42,UCBPlayer
32197,UCBPlayer,84,224,308,0,64,UCBPlayer
32198,UCBPlayer,146,251,397,32,45,UCBPlayer
32199,UCBPlayer,89,234,323,3,60,UCBPlayer
32200,UCBPlayer,138,243,381,28,49,UCBPlayer
32201,UCBPlayer,97,242,339,7,56,UCBPlayer
32202,UCBPlayer,130,235,365,24,53,UCBPlayer
32203,UCBPlayer,105,250,355,11,52,UCBPlayer
32204,UCBPlayer,122,227,349,20,57,UCBPlayer
32205,UCBPlayer,109,259,368,15,49,UCBPlayer
32206,UCBPlayer,118,218,336,16,60,UCBPlayer
32207,UCBPlayer,117,267,384,19,45,UCBPlayer
32208,UCBPlayer,110,210,320,12,64,UCBPlayer
32209,UCBPlayer,126,271,397,23,42,UCBPlayer
32210,UCBPlayer,105,210,315,10,65,UCBPlayer
32211,UCBPlayer,130,275,405,25,40,UCBPlayer
32212,UCBPlayer,105,210,315,10,65,UCBPlayer
32213,UCBPlayer,130,275,405,25,40,UCBPlayer
32214,UCBPlayer,106,206,312,10,66,UCBPlayer
32215,UCBPlayer,130,275,405,25,40,UCBPlayer
32216,UCBPlayer,105,210,315,10,65,UCBPlayer
32217,UCBPlayer,131,271,402,25,41,UCBPlayer
32218,UCBPlayer,105,210,315,10,65,UCBPlayer
32219,UCBPlayer,130,275,405,25,40,UCBPlayer
32220,UCBPlayer,105,210,315,10,65,UCBPlayer
32221,UCBPlayer,130,275,405,25,40,UCBPlayer
32222,UCBPlayer,103,203,306,10,68,UCBPlayer
32223,UCBPlayer,128,283,411,25,38,UCBPlayer
32224,UCBPlayer,111,186,297,10,71,UCBPlayer
32225,UCBPlayer,124,299,423,25,34,UCBPlayer
32226,UCBPlayer,115,170,285,10,75,UCBPlayer
32227,UCBPlayer,120,315,435,25,30,UCBPlayer
32228,UCBPlayer,119,154,273,10,79,UCBPlayer
32229,UCBPlayer,112,332,444,25,27,UCBPlayer
32230,UCBPlayer,127,137,264,10,82,UCBPlayer
32231,UCBPlayer,104,349,453,25,24,UCBPlayer
32232,UCBPlayer,126,126,252,7,85,Tie
32233,UCBPlayer,111,351,462,28,22,UCBPlayer
32234,UCBPlayer,116,126,242,3,87,UCBPlayer
32235,UCBPlayer,122,347,469,32,21,UCBPlayer
32236,UCBPlayer,107,132,239,0,87,UCBPlayer
32237,UCBPlayer,132,337,469,35,22,UCBPlayer
32238,UCBPlayer,103,148,251,0,83,UCBPlayer
32239,UCBPlayer,136,321,457,35,26,UCBPlayer
32240,UCBPlayer,99,164,263,0,79,UCBPlayer
32241,UCBPlayer,140,305,445,35,30,UCBPlayer
32242,UCBPlayer,95,180,275,0,75,UCBPlayer
32243,UCBPlayer,144,289,433,35,34,UCBPlayer
32244,UCBPlayer,91,196,287,0,71,UCBPlayer
32245,UCBPlayer,148,273,421,35,38,UCBPlayer
32246,UCBPlayer,87,212,299,0,67,UCBPlayer
32247,UCBPlayer,152,257,409,35,42,UCBPlayer
32248,UCBPlayer,84,224,308,0,64,UCBPlayer
32249,UCBPlayer,146,251,397,32,45,UCBPlayer
32250,UCBPlayer,89,234,323,3,60,UCBPlayer
32251,UCBPlayer,138,243,381,28,49,UCBPlayer
32252,UCBPlayer,97,242,339,7,56,UCBPlayer
32253,UCBPlayer,130,235,365,24,53,UCBPlayer
32254,UCBPlayer,105,250,355,11,52,UCBPlayer
32255,UCBPlayer,122,227,349,20,57,UCBPlayer
32256,UCBPlayer,109,259,368,15,49,UCBPlayer
32257,UCBPlayer,118,218,336,16,60,UCBPlayer
32258,UCBPlayer,117,267,384,19,45,UCBPlayer
32259,UCBPlayer,110,210,320,12,64,UCBPlayer
32260,UCBPlayer,126,271,397,23,42,UCBPlayer
32261,UCBPlayer,105,210,315,10,65,UCBPlayer
32262,UCBPlayer,130,275,405,25,40,UCBPlayer
32263,UCBPlayer,105,210,315,10,65,UCBPlayer
32264,UCBPlayer,130,275,405,25,40,UCBPlayer
32265,UCBPlayer,106,206,312,10,66,UCBPlayer
32266,UCBPlayer,130,275,405,25,40,UCBPlayer
32267,UCBPlayer,105,210,315,10,65,UCBPlayer
32268,UCBPlayer,131,271,402,25,41,UCBPlayer
32269,UCBPlayer,105,210,315,10,65,UCBPlayer
32270,UCBPlayer,130,275,405,25,40,UCBPlayer
32271,UCBPlayer,105,210,315,10,65,UCBPlayer
32272,UCBPlayer,130,275,405,25,40,UCBPlayer
32273,UCBPlayer,103,203,306,10,68,UCBPlayer
32274,UCBPlayer,128,283,411,25,38,UCBPlayer
32275,UCBPlayer,111,186,297,10,71,UCBPlayer
32276,UCBPlayer,124,299,423,25,34,UCBPlayer
32277,UCBPlayer,115,170,285,10,75,UCBPlayer
32278,UCBPlayer,120,315,435,25,30,UCBPlayer
32279,UCBPlayer,119,154,273,10,79,UCBPlayer
32280,UCBPlayer,112,332,444,25,27,UCBPlayer
32281,UCBPlayer,127,137,264,10,82,UCBPlayer
32282,UCBPlayer,104,349,453,25,24,UCBPlayer
32283,UCBPlayer,126,126,252,7,85,Tie
32284,UCBPlayer,111,351,462,28,22,UCBPlayer
32285,UCBPlayer,116,126,242,3,87,UCBPlayer
32286,UCBPlayer,122,347,469,32,21,UCBPlayer
32287,UCBPlayer,107,132,239,0,87,UCBPlayer
32288,UCBPlayer,132,337,469,35,22,UCBPlayer
32289,UCBPlayer,103,148,251,0,83,UCBPlayer
32290,UCBPlayer,136,321,457,35,26,UCBPlayer
32291,UCBPlayer,99,164,263,0,79,UCBPlayer
32292,UCBPlayer,140,305,445,35,30,UCBPlayer
32293,UCBPlayer,95,180,275,0,75,UCBPlayer
32294,UCBPlayer,144,289,433,35,34,UCBPlayer
32295,UCBPlayer,91,196,287,0,71,UCBPlayer
32296,UCBPlayer,148,273,421,35,38,UCBPlayer
32297,UCBPlayer,87,212,299,0,67,UCBPlayer
32298,UCBPlayer,152,257,409,35,42,UCBPlayer
32299,UCBPlayer,84,224,308,0,64,UCBPlayer
32300,UCBPlayer,146,251,397,32,45,UCBPlayer
32301,UCBPlayer,89,234,323,3,60,UCBPlayer
32302,UCBPlayer,138,243,381,28,49,UCBPlayer
32303,UCBPlayer,97,242,339,7,56,UCBPlayer
32304,UCBPlayer,130,235,365,24,53,UCBPlayer
32305,UCBPlayer,105,250,355,11,52,UCBPlayer
32306,UCBPlayer,122,227,349,20,57,UCBPlayer
32307,UCBPlayer,109,259,368,15,49,UCBPlayer
32308,UCBPlayer,118,218,336,16,60,UCBPlayer
32309,UCBPlayer,117,267,384,19,45,UCBPlayer
32310,UCBPlayer,110,210,320,12,64,UCBPlayer
32311,UCBPlayer,126,271,397,23,42,UCBPlayer
32312,UCBPlayer,105,210,315,10,65,UCBPlayer
32313,UCBPlayer,130,275,405,25,40,UCBPlayer
32314,UCBPlayer,105,210,315,10,65,UCBPlayer
32315,UCBPlayer,130,275,405,25,40,UCBPlayer
32316,UCBPlayer,106,206,312,10,66,UCBPlayer
32317,UCBPlayer,130,275,405,25,40,UCBPlayer
32318,UCBPlayer,105,210,315,10,65,UCBPlayer
32319,UCBPlayer,131,271,402,25,41,UCBPlayer
32320,UCBPlayer,105,210,315,10,65,UCBPlayer
32321,UCBPlayer,130,275,405,25,40,UCBPlayer
32322,UCBPlayer,105,210,315,10,65,UCBPlayer
32323,UCBPlayer,130,275,405,25,40,UCBPlayer
32324,UCBPlayer,103,203,306,10,68,UCBPlayer
32325,UCBPlayer,128,283,411,25,38,UCBPlayer
32326,UCBPlayer,111,186,297,10,71,UCBPlayer
32327,UCBPlayer,124,299,423,25,34,UCBPlayer
32328,UCBPlayer,115,170,285,10,75,UCBPlayer
32329,UCBPlayer,120,315,435,25,30,UCBPlayer
32330,UCBPlayer,119,154,273,10,79,UCBPlayer
32331,UCBPlayer,112,332,444,25,27,UCBPlayer
32332,UCBPlayer,127,137,264,10,82,UCBPlayer
32333,UCBPlayer,104,349,453,25,24,UCBPlayer
32334,UCBPlayer,126,126,252,7,85,Tie
32335,UCBPlayer,111,351,462,28,22,UCBPlayer
32336,UCBPlayer,116,126,242,3,87,UCBPlayer
32337,UCBPlayer,122,347,469,32,21,UCBPlayer
32338,UCBPlayer,107,132,239,0,87,UCBPlayer
32339,UCBPlayer,132,337,469,35,22,UCBPlayer
32340,UCBPlayer,103,148,251,0,83,UCBPlayer
32341,UCBPlayer,136,321,457,35,26,UCBPlayer
32342,UCBPlayer,99,164,263,0,79,UCBPlayer
32343,UCBPlayer,140,305,445,35,30,UCBPlayer
32344,UCBPlayer,95,180,275,0,75,UCBPlayer
32345,UCBPlayer,144,289,433,35,34,UCBPlayer
32346,UCBPlayer,91,196,287,0,71,UCBPlayer
32347,UCBPlayer,148,273,421,35,38,UCBPlayer
32348,UCBPlayer,87,212,299,0,67,UCBPlayer
32349,UCBPlayer,152,257,409,35,42,UCBPlayer
32350,UCBPlayer,84,224,308,0,64,UCBPlayer
32351,UCBPlayer,146,251,397,32,45,UCBPlayer
32352,UCBPlayer,89,234,323,3,60,UCBPlayer
32353,UCBPlayer,138,243,381,28,49,UCBPlayer
32354,UCBPlayer,97,242,339,7,56,UCBPlayer
32355,UCBPlayer,130,235,365,24,53,UCBPlayer
32356,UCBPlayer,105,250,355,11,52,UCBPlayer
32357,UCBPlayer,122,227,349,20,57,UCBPlayer
32358,UCBPlayer,109,259,368,15,49,UCBPlayer
32359,UCBPlayer,118,218,336,16,60,UCBPlayer
32360,UCBPlayer,117,267,384,19,45,UCBPlayer
32361,UCBPlayer,110,210,320,12,64,UCBPlayer
32362,UCBPlayer,126,271,397,23,42,UCBPlayer
32363,UCBPlayer,105,210,315,10,65,UCBPlayer
32364,UCBPlayer,130,275,405,25,40,UCBPlayer
32365,UCBPlayer,105,210,315,10,65,UCBPlayer
32366,UCBPlayer,130,275,405,25,40,UCBPlayer
32367,UCBPlayer,106,206,312,10,66,UCBPlayer
32368,UCBPlayer,130,275,405,25,40,UCBPlayer
32369,UCBPlayer,105,210,315,10,65,UCBPlayer
32370,UCBPlayer,131,271,402,25,41,UCBPlayer
32371,UCBPlayer,105,210,315,10,65,UCBPlayer
32372,UCBPlayer,130,275,405,25,40,UCBPlayer
32373,UCBPlayer,105,210,315,10,65,UCBPlayer
32374,UCBPlayer,130,275,405,25,40,UCBPlayer
32375,UCBPlayer,103,203,306,10,68,UCBPlayer
32376,UCBPlayer,128,283,411,25,38,UCBPlayer
32377,UCBPlayer,111,186,297,10,71,UCBPlayer
32378,UCBPlayer,124,299,423,25,34,UCBPlayer
32379,UCBPlayer,115,170,285,10,75,UCBPlayer
32380,UCBPlayer,120,315,435,25,30,UCBPlayer
32381,UCBPlayer,119,154,273,10,79,UCBPlayer
32382,UCBPlayer,112,332,444,25,27,UCBPlayer
32383,UCBPlayer,127,137,264,10,82,UCBPlayer
32384,UCBPlayer,104,349,453,25,24,UCBPlayer
32385,UCBPlayer,126,126,252,7,85,Tie
32386,UCBPlayer,111,351,462,28,22,UCBPlayer
32387,UCBPlayer,116,126,242,3,87,UCBPlayer
32388,UCBPlayer,122,347,469,32,21,UCBPlayer
32389,UCBPlayer,107,132,239,0,87,UCBPlayer
32390,UCBPlayer,132,337,469,35,22,UCBPlayer
32391,UCBPlayer,103,148,251,0,83,UCBPlayer
32392,UCBPlayer,136,321,457,35,26,UCBPlayer
32393,UCBPlayer,99,164,263,0,79,UCBPlayer
32394,UCBPlayer,140,305,445,35,30,UCBPlayer
32395,UCBPlayer,95,180,275,0,75,UCBPlayer
32396,UCBPlayer,144,289,433,35,34,UCBPlayer
32397,UCBPlayer,91,196,287,0,71,UCBPlayer
32398,UCBPlayer,148,273,421,35,38,UCBPlayer
32399,UCBPlayer,87,212,299,0,67,UCBPlayer
32400,UCBPlayer,152,257,409,35,42,UCBPlayer
32401,UCBPlayer,84,224,308,0,64,UCBPlayer
32402,UCBPlayer,146,251,397,32,45,UCBPlayer
32403,UCBPlayer,89,234,323,3,60,UCBPlayer
32404,UCBPlayer,138,243,381,28,49,UCBPlayer
32405,UCBPlayer,97,242,339,7,56,UCBPlayer
32406,UCBPlayer,130,235,365,24,53,UCBPlayer
32407,UCBPlayer,105,250,355,11,52,UCBPlayer
32408,UCBPlayer,122,227,349,20,57,UCBPlayer
32409,UCBPlayer,109,259,368,15,49,UCBPlayer
32410,UCBPlayer,118,218,336,16,60,UCBPlayer
32411,UCBPlayer,117,267,384,19,45,UCBPlayer
32412,UCBPlayer,110,210,320,12,64,UCBPlayer
32413,UCBPlayer,126,271,397,23,42,UCBPlayer
32414,UCBPlayer,105,210,315,10,65,UCBPlayer
32415,UCBPlayer,130,275,405,25,40,UCBPlayer
32416,UCBPlayer,105,210,315,10,65,UCBPlayer
32417,UCBPlayer,130,275,405,25,40,UCBPlayer
32418,UCBPlayer,106,206,312,10,66,UCBPlayer
32419,UCBPlayer,130,275,405,25,40,UCBPlayer
32420,UCBPlayer,105,210,315,10,65,UCBPlayer
32421,UCBPlayer,131,271,402,25,41,UCBPlayer
32422,UCBPlayer,105,210,315,10,65,UCBPlayer
32423,UCBPlayer,130,275,405,25,40,UCBPlayer
32424,UCBPlayer,105,210,315,10,65,UCBPlayer
32425,UCBPlayer,130,275,405,25,40,UCBPlayer
32426,UCBPlayer,103,203,306,10,68,UCBPlayer
32427,UCBPlayer,128,283,411,25,38,UCBPlayer
32428,UCBPlayer,111,186,297,10,71,UCBPlayer
32429,UCBPlayer,124,299,423,25,34,UCBPlayer
32430,UCBPlayer,115,170,285,10,75,UCBPlayer
32431,UCBPlayer,120,315,435,25,30,UCBPlayer
32432,UCBPlayer,119,154,273,10,79,UCBPlayer
32433,UCBPlayer,112,332,444,25,27,UCBPlayer
32434,UCBPlayer,127,137,264,10,82,UCBPlayer
32435,UCBPlayer,104,349,453,25,24,UCBPlayer
32436,UCBPlayer,126,126,252,7,85,Tie
32437,UCBPlayer,111,351,462,28,22,UCBPlayer
32438,UCBPlayer,116,126,242,3,87,UCBPlayer
32439,UCBPlayer,122,347,469,32,21,UCBPlayer
32440,UCBPlayer,107,132,239,0,87,UCBPlayer
32441,UCBPlayer,132,337,469,35,22,UCBPlayer
32442,UCBPlayer,103,148,251,0,83,UCBPlayer
32443,UCBPlayer,136,321,457,35,26,UCBPlayer
32444,UCBPlayer,99,164,263,0,79,UCBPlayer
32445,UCBPlayer,140,305,445,35,30,UCBPlayer
32446,UCBPlayer,95,180,275,0,75,UCBPlayer
32447,UCBPlayer,144,289,433,35,34,UCBPlayer
32448,UCBPlayer,91,196,287,0,71,UCBPlayer
32449,UCBPlayer,148,273,421,35,38,UCBPlayer
32450,UCBPlayer,87,212,299,0,67,UCBPlayer
32451,UCBPlayer,152,257,409,35,42,UCBPlayer
32452,UCBPlayer,84,224,308,0,64,UCBPlayer
32453,UCBPlayer,146,251,397,32,45,UCBPlayer
32454,UCBPlayer,89,234,323,3,60,UCBPlayer
32455,UCBPlayer,138,243,381,28,49,UCBPlayer
32456,UCBPlayer,97,242,339,7,56,UCBPlayer
32457,UCBPlayer,130,235,365,24,53,UCBPlayer
32458,UCBPlayer,105,250,355,11,52,UCBPlayer
32459,UCBPlayer,122,227,349,20,57,UCBPlayer
32460,UCBPlayer,109,259,368,15,49,UCBPlayer
32461,UCBPlayer,118,218,336,16,60,UCBPlayer
32462,UCBPlayer,117,267,384,19,45,UCBPlayer
32463,UCBPlayer,110,210,320,12,64,UCBPlayer
32464,UCBPlayer,126,271,397,23,42,UCBPlayer
32465,UCBPlayer,105,210,315,10,65,UCBPlayer
32466,UCBPlayer,130,275,405,25,40,UCBPlayer
32467,UCBPlayer,105,210,315,10,65,UCBPlayer
32468,UCBPlayer,130,275,405,25,40,UCBPlayer
32469,UCBPlayer,106,206,312,10,66,UCBPlayer
32470,UCBPlayer,130,275,405,25,40,UCBPlayer
32471,UCBPlayer,105,210,315,10,65,UCBPlayer
32472,UCBPlayer,131,271,402,25,41,UCBPlayer
32473,UCBPlayer,105,210,315,10,65,UCBPlayer
32474,UCBPlayer,130,275,405,25,40,UCBPlayer
32475,UCBPlayer,105,210,315,10,65,UCBPlayer
32476,UCBPlayer,130,275,405,25,40,UCBPlayer
32477,UCBPlayer,103,203,306,10,68,UCBPlayer
32478,UCBPlayer,128,283,411,25,38,UCBPlayer
32479,UCBPlayer,111,186,297,10,71,UCBPlayer
32480,UCBPlayer,124,299,423,25,34,UCBPlayer
32481,UCBPlayer,115,170,285,10,75,UCBPlayer
32482,UCBPlayer,120,315,435,25,30,UCBPlayer
32483,UCBPlayer,119,154,273,10,79,UCBPlayer
32484,UCBPlayer,112,332,444,25,27,UCBPlayer
32485,UCBPlayer,127,137,264,10,82,UCBPlayer
32486,UCBPlayer,104,349,453,25,24,UCBPlayer
32487,UCBPlayer,126,126,252,7,85,Tie
32488,UCBPlayer,111,351,462,28,22,UCBPlayer
32489,UCBPlayer,116,126,242,3,87,UCBPlayer
32490,UCBPlayer,122,347,469,32,21,UCBPlayer
32491,UCBPlayer,107,132,239,0,87,UCBPlayer
32492,UCBPlayer,132,337,469,35,22,UCBPlayer
32493,UCBPlayer,103,148,251,0,83,UCBPlayer
32494,UCBPlayer,136,321,457,35,26,UCBPlayer
32495,UCBPlayer,99,164,263,0,79,UCBPlayer
32496,UCBPlayer,140,305,445,35,30,UCBPlayer
32497,UCBPlayer,95,180,275,0,75,UCBPlayer
32498,UCBPlayer,144,289,433,35,34,UCBPlayer
32499,UCBPlayer,91,196,287,0,71,UCBPlayer
32500,UCBPlayer,148,273,421,35,38,UCBPlayer
32501,UCBPlayer,87,212,299,0,67,UCBPlayer
32502,UCBPlayer,152,257,409,35,42,UCBPlayer
32503,UCBPlayer,84,224,308,0,64,UCBPlayer
32504,UCBPlayer,146,251,397,32,45,UCBPlayer
32505,UCBPlayer,89,234,323,3,60,UCBPlayer
32506,UCBPlayer,138,243,381,28,49,UCBPlayer
32507,UCBPlayer,97,242,339,7,56,UCBPlayer
32508,UCBPlayer,130,235,365,24,53,UCBPlayer
32509,UCBPlayer,105,250,355,11,52,UCBPlayer
32510,UCBPlayer,122,227,349,20,57,UCBPlayer
32511,UCBPlayer,109,259,368,15,49,UCBPlayer
32512,UCBPlayer,118,218,336,16,60,UCBPlayer
32513,UCBPlayer,117,267,384,19,45,UCBPlayer
32514,UCBPlayer,110,210,320,12,64,UCBPlayer
32515,UCBPlayer,126,271,397,23,42,UCBPlayer
32516,UCBPlayer,105,210,315,10,65,UCBPlayer
32517,UCBPlayer,130,275,405,25,40,UCBPlayer
32518,UCBPlayer,105,210,315,10,65,UCBPlayer
32519,UCBPlayer,130,275,405,25,40,UCBPlayer
32520,UCBPlayer,106,206,312,10,66,UCBPlayer
32521,UCBPlayer,130,275,405,25,40,UCBPlayer
32522,UCBPlayer,105,210,315,10,65,UCBPlayer
32523,UCBPlayer,131,271,402,25,41,UCBPlayer
32524,UCBPlayer,105,210,315,10,65,UCBPlayer
32525,UCBPlayer,130,275,405,25,40,UCBPlayer
32526,UCBPlayer,105,210,315,10,65,UCBPlayer
32527,UCBPlayer,130,275,405,25,40,UCBPlayer
32528,UCBPlayer,103,203,306,10,68,UCBPlayer
32529,UCBPlayer,128,283,411,25,38,UCBPlayer
32530,UCBPlayer,111,186,297,10,71,UCBPlayer
32531,UCBPlayer,124,299,423,25,34,UCBPlayer
32532,UCBPlayer,115,170,285,10,75,UCBPlayer
32533,UCBPlayer,120,315,435,25,30,UCBPlayer
32534,UCBPlayer,119,154,273,10,79,UCBPlayer
32535,UCBPlayer,112,332,444,25,27,UCBPlayer
32536,UCBPlayer,127,137,264,10,82,UCBPlayer
32537,UCBPlayer,104,349,453,25,24,UCBPlayer
32538,UCBPlayer,126,126,252,7,85,Tie
32539,UCBPlayer,111,351,462,28,22,UCBPlayer
32540,UCBPlayer,116,126,242,3,87,UCBPlayer
32541,UCBPlayer,122,347,469,32,21,UCBPlayer
32542,UCBPlayer,107,132,239,0,87,UCBPlayer
32543,UCBPlayer,132,337,469,35,22,UCBPlayer
32544,UCBPlayer,103,148,251,0,83,UCBPlayer
32545,UCBPlayer,136,321,457,35,26,UCBPlayer
32546,UCBPlayer,99,164,263,0,79,UCBPlayer
32547,UCBPlayer,140,305,445,35,30,UCBPlayer
32548,UCBPlayer,95,180,275,0,75,UCBPlayer
32549,UCBPlayer,144,289,433,35,34,UCBPlayer
32550,UCBPlayer,91,196,287,0,71,UCBPlayer
32551,UCBPlayer,148,273,421,35,38,UCBPlayer
32552,UCBPlayer,87,212,299,0,67,UCBPlayer
32553,UCBPlayer,152,257,409,35,42,UCBPlayer
32554,UCBPlayer,84,224,308,0,64,UCBPlayer
32555,UCBPlayer,146,251,397,32,45,UCBPlayer
32556,UCBPlayer,89,234,323,3,60,UCBPlayer
32557,UCBPlayer,138,243,381,28,49,UCBPlayer
32558,UCBPlayer,97,242,339,7,56,UCBPlayer
32559,UCBPlayer,130,235,365,24,53,UCBPlayer
32560,UCBPlayer,105,250,355,11,52,UCBPlayer
32561,UCBPlayer,122,227,349,20,57,UCBPlayer
32562,UCBPlayer,109,259,368,15,49,UCBPlayer
32563,UCBPlayer,118,218,336,16,60,UCBPlayer
32564,UCBPlayer,117,267,384,19,45,UCBPlayer
32565,UCBPlayer,110,210,320,12,64,UCBPlayer
32566,UCBPlayer,126,271,397,23,42,UCBPlayer
32567,UCBPlayer,105,210,315,10,65,UCBPlayer
32568,UCBPlayer,130,275,405,25,40,UCBPlayer
32569,UCBPlayer,105,210,315,10,65,UCBPlayer
32570,UCBPlayer,130,275,405,25,40,UCBPlayer
32571,UCBPlayer,106,206,312,10,66,UCBPlayer
32572,UCBPlayer,130,275,405,25,40,UCBPlayer
32573,UCBPlayer,105,210,315,10,65,UCBPlayer
32574,UCBPlayer,131,271,402,25,41,UCBPlayer
32575,UCBPlayer,105,210,315,10,65,UCBPlayer
32576,UCBPlayer,130,275,405,25,40,UCBPlayer
32577,UCBPlayer,105,210,315,10,65,UCBPlayer
32578,UCBPlayer,130,275,405,25,40,UCBPlayer
32579,UCBPlayer,103,203,306,10,68,UCBPlayer
32580,UCBPlayer,128,283,411,25,38,UCBPlayer
32581,UCBPlayer,111,186,297,10,71,UCBPlayer
32582,UCBPlayer,124,299,423,25,34,UCBPlayer
32583,UCBPlayer,115,170,285,10,75,UCBPlayer
32584,UCBPlayer,120,315,435,25,30,UCBPlayer
32585,UCBPlayer,119,154,273,10,79,UCBPlayer
32586,UCBPlayer,112,332,444,25,27,UCBPlayer
32587,UCBPlayer,127,137,264,10,82,UCBPlayer
32588,UCBPlayer,104,349,453,25,24,UCBPlayer
32589,UCBPlayer,126,126,252,7,85,Tie
32590,UCBPlayer,111,351,462,28,22,UCBPlayer
32591,UCBPlayer,116,126,242,3,87,UCBPlayer
32592,UCBPlayer,122,347,469,32,21,UCBPlayer
32593,UCBPlayer,107,132,239,0,87,UCBPlayer
32594,UCBPlayer,132,337,469,35,22,UCBPlayer
32595,UCBPlayer,103,148,251,0,83,UCBPlayer
32596,UCBPlayer,136,321,457,35,26,UCBPlayer
32597,UCBPlayer,99,164,263,0,79,UCBPlayer
32598,UCBPlayer,140,305,445,35,30,UCBPlayer
32599,UCBPlayer,95,180,275,0,75,UCBPlayer
32600,UCBPlayer,144,289,433,35,34,UCBPlayer
32601,UCBPlayer,91,196,287,0,71,UCBPlayer
32602,UCBPlayer,148,273,421,35,38,UCBPlayer
32603,UCBPlayer,87,212,299,0,67,UCBPlayer
32604,UCBPlayer,152,257,409,35,42,UCBPlayer
32605,UCBPlayer,84,224,308,0,64,UCBPlayer
32606,UCBPlayer,146,251,397,32,45,UCBPlayer
32607,UCBPlayer,89,234,323,3,60,UCBPlayer
32608,UCBPlayer,138,243,381,28,49,UCBPlayer
32609,UCBPlayer,97,242,339,7,56,UCBPlayer
32610,UCBPlayer,130,235,365,24,53,UCBPlayer
32611,UCBPlayer,105,250,355,11,52,UCBPlayer
32612,UCBPlayer,122,227,349,20,57,UCBPlayer
32613,UCBPlayer,109,259,368,15,49,UCBPlayer
32614,UCBPlayer,118,218,336,16,60,UCBPlayer
32615,UCBPlayer,117,267,384,19,45,UCBPlayer
32616,UCBPlayer,110,210,320,12,64,UCBPlayer
32617,UCBPlayer,126,271,397,23,42,UCBPlayer
32618,UCBPlayer,105,210,315,10,65,UCBPlayer
32619,UCBPlayer,130,275,405,25,40,UCBPlayer
32620,UCBPlayer,105,210,315,10,65,UCBPlayer
32621,UCBPlayer,130,275,405,25,40,UCBPlayer
32622,UCBPlayer,106,206,312,10,66,UCBPlayer
32623,UCBPlayer,130,275,405,25,40,UCBPlayer
32624,UCBPlayer,105,210,315,10,65,UCBPlayer
32625,UCBPlayer,131,271,402,25,41,UCBPlayer
32626,UCBPlayer,105,210,315,10,65,UCBPlayer
32627,UCBPlayer,130,275,405,25,40,UCBPlayer
32628,UCBPlayer,105,210,315,10,65,UCBPlayer
32629,UCBPlayer,130,275,405,25,40,UCBPlayer
32630,UCBPlayer,103,203,306,10,68,UCBPlayer
32631,UCBPlayer,128,283,411,25,38,UCBPlayer
32632,UCBPlayer,111,186,297,10,71,UCBPlayer
32633,UCBPlayer,124,299,423,25,34,UCBPlayer
32634,UCBPlayer,115,170,285,10,75,UCBPlayer
32635,UCBPlayer,120,315,435,25,30,UCBPlayer
32636,UCBPlayer,119,154,273,10,79,UCBPlayer
32637,UCBPlayer,112,332,444,25,27,UCBPlayer
32638,UCBPlayer,127,137,264,10,82,UCBPlayer
32639,UCBPlayer,104,349,453,25,24,UCBPlayer
32640,UCBPlayer,126,126,252,7,85,Tie
32641,UCBPlayer,111,351,462,28,22,UCBPlayer
32642,UCBPlayer,116,126,242,3,87,UCBPlayer
32643,UCBPlayer,122,347,469,32,21,UCBPlayer
32644,UCBPlayer,107,132,239,0,87,UCBPlayer
32645,UCBPlayer,132,337,469,35,22,UCBPlayer
32646,UCBPlayer,103,148,251,0,83,UCBPlayer
32647,UCBPlayer,136,321,457,35,26,UCBPlayer
32648,UCBPlayer,99,164,263,0,79,UCBPlayer
32649,UCBPlayer,140,305,445,35,30,UCBPlayer
32650,UCBPlayer,95,180,275,0,75,UCBPlayer
32651,UCBPlayer,144,289,433,35,34,UCBPlayer
32652,UCBPlayer,91,196,287,0,71,UCBPlayer
32653,UCBPlayer,148,273,421,35,38,UCBPlayer
32654,UCBPlayer,87,212,299,0,67,UCBPlayer
32655,UCBPlayer,152,257,409,35,42,UCBPlayer
32656,UCBPlayer,84,224,308,0,64,UCBPlayer
32657,UCBPlayer,146,251,397,32,45,UCBPlayer
32658,UCBPlayer,89,234,323,3,60,UCBPlayer
32659,UCBPlayer,138,243,381,28,49,UCBPlayer
32660,UCBPlayer,97,242,339,7,56,UCBPlayer
32661,UCBPlayer,130,235,365,24,53,UCBPlayer
32662,UCBPlayer,105,250,355,11,52,UCBPlayer
32663,UCBPlayer,122,227,349,20,57,UCBPlayer
32664,UCBPlayer,109,259,368,15,49,UCBPlayer
32665,UCBPlayer,118,218,336,16,60,UCBPlayer
32666,UCBPlayer,117,267,384,19,45,UCBPlayer
32667,UCBPlayer,110,210,320,12,64,UCBPlayer
32668,UCBPlayer,126,271,397,23,42,UCBPlayer
32669,UCBPlayer,105,210,315,10,65,UCBPlayer
32670,UCBPlayer,130,275,405,25,40,UCBPlayer
32671,UCBPlayer,105,210,315,10,65,UCBPlayer
32672,UCBPlayer,130,275,405,25,40,UCBPlayer
32673,UCBPlayer,106,206,312,10,66,UCBPlayer
32674,UCBPlayer,130,275,405,25,40,UCBPlayer
32675,UCBPlayer,105,210,315,10,65,UCBPlayer
32676,UCBPlayer,131,271,402,25,41,UCBPlayer
32677,UCBPlayer,105,210,315,10,65,UCBPlayer
32678,UCBPlayer,130,275,405,25,40,UCBPlayer
32679,UCBPlayer,105,210,315,10,65,UCBPlayer
32680,UCBPlayer,130,275,405,25,40,UCBPlayer
32681,UCBPlayer,103,203,306,10,68,UCBPlayer
32682,UCBPlayer,128,283,411,25,38,UCBPlayer
32683,UCBPlayer,111,186,297,10,71,UCBPlayer
32684,UCBPlayer,124,299,423,25,34,UCBPlayer
32685,UCBPlayer,115,170,285,10,75,UCBPlayer
32686,UCBPlayer,120,315,435,25,30,UCBPlayer
32687,UCBPlayer,119,154,273,10,79,UCBPlayer
32688,UCBPlayer,112,332,444,25,27,UCBPlayer
32689,UCBPlayer,127,137,264,10,82,UCBPlayer
32690,UCBPlayer,104,349,453,25,24,UCBPlayer
32691,UCBPlayer,126,126,252,7,85,Tie
32692,UCBPlayer,111,351,462,28,22,UCBPlayer
32693,UCBPlayer,116,126,242,3,87,UCBPlayer
32694,UCBPlayer,122,347,469,32,21,UCBPlayer
32695,UCBPlayer,107,132,239,0,87,UCBPlayer
32696,UCBPlayer,132,337,469,35,22,UCBPlayer
32697,UCBPlayer,103,148,251,0,83,UCBPlayer
32698,UCBPlayer,136,321,457,35,26,UCBPlayer
32699,UCBPlayer,99,164,263,0,79,UCBPlayer
32700,UCBPlayer,140,305,445,35,30,UCBPlayer
32701,UCBPlayer,95,180,275,0,75,UCBPlayer
32702,UCBPlayer,144,289,433,35,34,UCBPlayer
32703,UCBPlayer,91,196,287,0,71,UCBPlayer
32704,UCBPlayer,148,273,421,35,38,UCBPlayer
32705,UCBPlayer,87,212,299,0,67,UCBPlayer
32706,UCBPlayer,152,257,409,35,42,UCBPlayer
32707,UCBPlayer,84,224,308,0,64,UCBPlayer
32708,UCBPlayer,146,251,397,32,45,UCBPlayer
32709,UCBPlayer,89,234,323,3,60,UCBPlayer
32710,UCBPlayer,138,243,381,28,49,UCBPlayer
32711,UCBPlayer,97,242,339,7,56,UCBPlayer
32712,UCBPlayer,130,235,365,24,53,UCBPlayer
32713,UCBPlayer,105,250,355,11,52,UCBPlayer
32714,UCBPlayer,122,227,349,20,57,UCBPlayer
32715,UCBPlayer,109,259,368,15,49,UCBPlayer
32716,UCBPlayer,118,218,336,16,60,UCBPlayer
32717,UCBPlayer,117,267,384,19,45,UCBPlayer
32718,UCBPlayer,110,210,320,12,64,UCBPlayer
32719,UCBPlayer,126,271,397,23,42,UCBPlayer
32720,UCBPlayer,105,210,315,10,65,UCBPlayer
32721,UCBPlayer,130,275,405,25,40,UCBPlayer
32722,UCBPlayer,105,210,315,10,65,UCBPlayer
32723,UCBPlayer,130,275,405,25,40,UCBPlayer
32724,UCBPlayer,106,206,312,10,66,UCBPlayer
32725,UCBPlayer,130,275,405,25,40,UCBPlayer
32726,UCBPlayer,105,210,315,10,65,UCBPlayer
32727,UCBPlayer,131,271,402,25,41,UCBPlayer
32728,UCBPlayer,105,210,315,10,65,UCBPlayer
32729,UCBPlayer,130,275,405,25,40,UCBPlayer
32730,UCBPlayer,105,210,315,10,65,UCBPlayer
32731,UCBPlayer,130,275,405,25,40,UCBPlayer
32732,UCBPlayer,103,203,306,10,68,UCBPlayer
32733,UCBPlayer,128,283,411,25,38,UCBPlayer
32734,UCBPlayer,111,186,297,10,71,UCBPlayer
32735,UCBPlayer,124,299,423,25,34,UCBPlayer
32736,UCBPlayer,115,170,285,10,75,UCBPlayer
32737,UCBPlayer,120,315,435,25,30,UCBPlayer
32738,UCBPlayer,119,154,273,10,79,UCBPlayer
32739,UCBPlayer,112,332,444,25,27,UCBPlayer
32740,UCBPlayer,127,137,264,10,82,UCBPlayer
32741,UCBPlayer,104,349,453,25,24,UCBPlayer
32742,UCBPlayer,126,126,252,7,85,Tie
32743,UCBPlayer,111,351,462,28,22,UCBPlayer
32744,UCBPlayer,116,126,242,3,87,UCBPlayer
32745,UCBPlayer,122,347,469,32,21,UCBPlayer
32746,UCBPlayer,107,132,239,0,87,UCBPlayer
32747,UCBPlayer,132,337,469,35,22,UCBPlayer
32748,UCBPlayer,103,148,251,0,83,UCBPlayer
32749,UCBPlayer,136,321,457,35,26,UCBPlayer
32750,UCBPlayer,99,164,263,0,79,UCBPlayer
32751,UCBPlayer,140,305,445,35,30,UCBPlayer
32752,UCBPlayer,95,180,275,0,75,UCBPlayer
32753,UCBPlayer,144,289,433,35,34,UCBPlayer
32754,UCBPlayer,91,196,287,0,71,UCBPlayer
32755,UCBPlayer,148,273,421,35,38,UCBPlayer
32756,UCBPlayer,87,212,299,0,67,UCBPlayer
32757,UCBPlayer,152,257,409,35,42,UCBPlayer
32758,UCBPlayer,84,224,308,0,64,UCBPlayer
32759,UCBPlayer,146,251,397,32,45,UCBPlayer
32760,UCBPlayer,89,234,323,3,60,UCBPlayer
32761,UCBPlayer,138,243,381,28,49,UCBPlayer
32762,UCBPlayer,97,242,339,7,56,UCBPlayer
32763,UCBPlayer,130,235,365,24,53,UCBPlayer
32764,UCBPlayer,105,250,355,11,52,UCBPlayer
32765,UCBPlayer,122,227,349,20,57,UCBPlayer
32766,UCBPlayer,109,259,368,15,49,UCBPlayer
32767,UCBPlayer,118,218,336,16,60,UCBPlayer
32768,UCBPlayer,117,267,384,19,45,UCBPlayer
32769,UCBPlayer,110,210,320,12,64,UCBPlayer
32770,UCBPlayer,126,271,397,23,42,UCBPlayer
32771,UCBPlayer,105,210,315,10,65,UCBPlayer
32772,UCBPlayer,130,275,405,25,40,UCBPlayer
32773,UCBPlayer,105,210,315,10,65,UCBPlayer
32774,UCBPlayer,130,275,405,25,40,UCBPlayer
32775,UCBPlayer,106,206,312,10,66,UCBPlayer
32776,UCBPlayer,130,275,405,25,40,UCBPlayer
32777,UCBPlayer,105,210,315,10,65,UCBPlayer
32778,UCBPlayer,131,271,402,25,41,UCBPlayer
32779,UCBPlayer,105,210,315,10,65,UCBPlayer
32780,UCBPlayer,130,275,405,25,40,UCBPlayer
32781,UCBPlayer,105,210,315,10,65,UCBPlayer
32782,UCBPlayer,130,275,405,25,40,UCBPlayer
32783,UCBPlayer,103,203,306,10,68,UCBPlayer
32784,UCBPlayer,128,283,411,25,38,UCBPlayer
32785,UCBPlayer,111,186,297,10,71,UCBPlayer
32786,UCBPlayer,124,299,423,25,34,UCBPlayer
32787,UCBPlayer,115,170,285,10,75,UCBPlayer
32788,UCBPlayer,120,315,435,25,30,UCBPlayer
32789,UCBPlayer,119,154,273,10,79,UCBPlayer
32790,UCBPlayer,112,332,444,25,27,UCBPlayer
32791,UCBPlayer,127,137,264,10,82,UCBPlayer
32792,UCBPlayer,104,349,453,25,24,UCBPlayer
32793,UCBPlayer,126,126,252,7,85,Tie
32794,UCBPlayer,111,351,462,28,22,UCBPlayer
32795,UCBPlayer,116,126,242,3,87,UCBPlayer
32796,UCBPlayer,122,347,469,32,21,UCBPlayer
32797,UCBPlayer,107,132,239,0,87,UCBPlayer
32798,UCBPlayer,132,337,469,35,22,UCBPlayer
32799,UCBPlayer,103,148,251,0,83,UCBPlayer
32800,UCBPlayer,136,321,457,35,26,UCBPlayer
32801,UCBPlayer,99,164,263,0,79,UCBPlayer
32802,UCBPlayer,140,305,445,35,30,UCBPlayer
32803,UCBPlayer,95,180,275,0,75,UCBPlayer
32804,UCBPlayer,144,289,433,35,34,UCBPlayer
32805,UCBPlayer,91,196,287,0,71,UCBPlayer
32806,UCBPlayer,148,273,421,35,38,UCBPlayer
32807,UCBPlayer,87,212,299,0,67,UCBPlayer
32808,UCBPlayer,152,257,409,35,42,UCBPlayer
32809,UCBPlayer,84,224,308,0,64,UCBPlayer
32810,UCBPlayer,146,251,397,32,45,UCBPlayer
32811,UCBPlayer,89,234,323,3,60,UCBPlayer
32812,UCBPlayer,138,243,381,28,49,UCBPlayer
32813,UCBPlayer,97,242,339,7,56,UCBPlayer
32814,UCBPlayer,130,235,365,24,53,UCBPlayer
32815,UCBPlayer,105,250,355,11,52,UCBPlayer
32816,UCBPlayer,122,227,349,20,57,UCBPlayer
32817,UCBPlayer,109,259,368,15,49,UCBPlayer
32818,UCBPlayer,118,218,336,16,60,UCBPlayer
32819,UCBPlayer,117,267,384,19,45,UCBPlayer
32820,UCBPlayer,110,210,320,12,64,UCBPlayer
32821,UCBPlayer,126,271,397,23,42,UCBPlayer
32822,UCBPlayer,105,210,315,10,65,UCBPlayer
32823,UCBPlayer,130,275,405,25,40,UCBPlayer
32824,UCBPlayer,105,210,315,10,65,UCBPlayer
32825,UCBPlayer,130,275,405,25,40,UCBPlayer
32826,UCBPlayer,106,206,312,10,66,UCBPlayer
32827,UCBPlayer,130,275,405,25,40,UCBPlayer
32828,UCBPlayer,105,210,315,10,65,UCBPlayer
32829,UCBPlayer,131,271,402,25,41,UCBPlayer
32830,UCBPlayer,105,210,315,10,65,UCBPlayer
32831,UCBPlayer,130,275,405,25,40,UCBPlayer
32832,UCBPlayer,105,210,315,10,65,UCBPlayer
32833,UCBPlayer,130,275,405,25,40,UCBPlayer
32834,UCBPlayer,103,203,306,10,68,UCBPlayer
32835,UCBPlayer,128,283,411,25,38,UCBPlayer
32836,UCBPlayer,111,186,297,10,71,UCBPlayer
32837,UCBPlayer,124,299,423,25,34,UCBPlayer
32838,UCBPlayer,115,170,285,10,75,UCBPlayer
32839,UCBPlayer,120,315,435,25,30,UCBPlayer
32840,UCBPlayer,119,154,273,10,79,UCBPlayer
32841,UCBPlayer,112,332,444,25,27,UCBPlayer
32842,UCBPlayer,127,137,264,10,82,UCBPlayer
32843,UCBPlayer,104,349,453,25,24,UCBPlayer
32844,UCBPlayer,126,126,252,7,85,Tie
32845,UCBPlayer,111,351,462,28,22,UCBPlayer
32846,UCBPlayer,116,126,242,3,87,UCBPlayer
32847,UCBPlayer,122,347,469,32,21,UCBPlayer
32848,UCBPlayer,107,132,239,0,87,UCBPlayer
32849,UCBPlayer,132,337,469,35,22,UCBPlayer
32850,UCBPlayer,103,148,251,0,83,UCBPlayer
32851,UCBPlayer,136,321,457,35,26,UCBPlayer
32852,UCBPlayer,99,164,263,0,79,UCBPlayer
32853,UCBPlayer,140,305,445,35,30,UCBPlayer
32854,UCBPlayer,95,180,275,0,75,UCBPlayer
32855,UCBPlayer,144,289,433,35,34,UCBPlayer
32856,UCBPlayer,91,196,287,0,71,UCBPlayer
32857,UCBPlayer,148,273,421,35,38,UCBPlayer
32858,UCBPlayer,87,212,299,0,67,UCBPlayer
32859,UCBPlayer,152,257,409,35,42,UCBPlayer
32860,UCBPlayer,84,224,308,0,64,UCBPlayer
32861,UCBPlayer,146,251,397,32,45,UCBPlayer
32862,UCBPlayer,89,234,323,3,60,UCBPlayer
32863,UCBPlayer,138,243,381,28,49,UCBPlayer
32864,UCBPlayer,97,242,339,7,56,UCBPlayer
32865,UCBPlayer,130,235,365,24,53,UCBPlayer
32866,UCBPlayer,105,250,355,11,52,UCBPlayer
32867,UCBPlayer,122,227,349,20,57,UCBPlayer
32868,UCBPlayer,109,259,368,15,49,UCBPlayer
32869,UCBPlayer,118,218,336,16,60,UCBPlayer
32870,UCBPlayer,117,267,384,19,45,UCBPlayer
32871,UCBPlayer,110,210,320,12,64,UCBPlayer
32872,UCBPlayer,126,271,397,23,42,UCBPlayer
32873,UCBPlayer,105,210,315,10,65,UCBPlayer
32874,UCBPlayer,130,275,405,25,40,UCBPlayer
32875,UCBPlayer,105,210,315,10,65,UCBPlayer
32876,UCBPlayer,130,275,405,25,40,UCBPlayer
32877,UCBPlayer,106,206,312,10,66,UCBPlayer
32878,UCBPlayer,130,275,405,25,40,UCBPlayer
32879,UCBPlayer,105,210,315,10,65,UCBPlayer
32880,UCBPlayer,131,271,402,25,41,UCBPlayer
32881,UCBPlayer,105,210,315,10,65,UCBPlayer
32882,UCBPlayer,130,275,405,25,40,UCBPlayer
32883,UCBPlayer,105,210,315,10,65,UCBPlayer
32884,UCBPlayer,130,275,405,25,40,UCBPlayer
32885,UCBPlayer,103,203,306,10,68,UCBPlayer
32886,UCBPlayer,128,283,411,25,38,UCBPlayer
32887,UCBPlayer,111,186,297,10,71,UCBPlayer
32888,UCBPlayer,124,299,423,25,34,UCBPlayer
32889,UCBPlayer,115,170,285,10,75,UCBPlayer
32890,UCBPlayer,120,315,435,25,30,UCBPlayer
32891,UCBPlayer,119,154,273,10,79,UCBPlayer
32892,UCBPlayer,112,332,444,25,27,UCBPlayer
32893,UCBPlayer,127,137,264,10,82,UCBPlayer
32894,UCBPlayer,104,349,453,25,24,UCBPlayer
32895,UCBPlayer,126,126,252,7,85,Tie
32896,UCBPlayer,111,351,462,28,22,UCBPlayer
32897,UCBPlayer,116,126,242,3,87,UCBPlayer
32898,UCBPlayer,122,347,469,32,21,UCBPlayer
32899,UCBPlayer,107,132,239,0,87,UCBPlayer
32900,UCBPlayer,132,337,469,35,22,UCBPlayer
32901,UCBPlayer,103,148,251,0,83,UCBPlayer
32902,UCBPlayer,136,321,457,35,26,UCBPlayer
32903,UCBPlayer,99,164,263,0,79,UCBPlayer
32904,UCBPlayer,140,305,445,35,30,UCBPlayer
32905,UCBPlayer,95,180,275,0,75,UCBPlayer
32906,UCBPlayer,144,289,433,35,34,UCBPlayer
32907,UCBPlayer,91,196,287,0,71,UCBPlayer
32908,UCBPlayer,148,273,421,35,38,UCBPlayer
32909,UCBPlayer,87,212,299,0,67,UCBPlayer
32910,UCBPlayer,152,257,409,35,42,UCBPlayer
32911,UCBPlayer,84,224,308,0,64,UCBPlayer
32912,UCBPlayer,146,251,397,32,45,UCBPlayer
32913,UCBPlayer,89,234,323,3,60,UCBPlayer
32914,UCBPlayer,138,243,381,28,49,UCBPlayer
32915,UCBPlayer,97,242,339,7,56,UCBPlayer
32916,UCBPlayer,130,235,365,24,53,UCBPlayer
32917,UCBPlayer,105,250,355,11,52,UCBPlayer
32918,UCBPlayer,122,227,349,20,57,UCBPlayer
32919,UCBPlayer,109,259,368,15,49,UCBPlayer
32920,UCBPlayer,118,218,336,16,60,UCBPlayer
32921,UCBPlayer,117,267,384,19,45,UCBPlayer
32922,UCBPlayer,110,210,320,12,64,UCBPlayer
32923,UCBPlayer,126,271,397,23,42,UCBPlayer
32924,UCBPlayer,105,210,315,10,65,UCBPlayer
32925,UCBPlayer,130,275,405,25,40,UCBPlayer
32926,UCBPlayer,105,210,315,10,65,UCBPlayer
32927,UCBPlayer,130,275,405,25,40,UCBPlayer
32928,UCBPlayer,106,206,312,10,66,UCBPlayer
32929,UCBPlayer,130,275,405,25,40,UCBPlayer
32930,UCBPlayer,105,210,315,10,65,UCBPlayer
32931,UCBPlayer,131,271,402,25,41,UCBPlayer
32932,UCBPlayer,105,210,315,10,65,UCBPlayer
32933,UCBPlayer,130,275,405,25,40,UCBPlayer
32934,UCBPlayer,105,210,315,10,65,UCBPlayer
32935,UCBPlayer,130,275,405,25,40,UCBPlayer
32936,UCBPlayer,103,203,306,10,68,UCBPlayer
32937,UCBPlayer,128,283,411,25,38,UCBPlayer
32938,UCBPlayer,111,186,297,10,71,UCBPlayer
32939,UCBPlayer,124,299,423,25,34,UCBPlayer
32940,UCBPlayer,115,170,285,10,75,UCBPlayer
32941,UCBPlayer,120,315,435,25,30,UCBPlayer
32942,UCBPlayer,119,154,273,10,79,UCBPlayer
32943,UCBPlayer,112,332,444,25,27,UCBPlayer
32944,UCBPlayer,127,137,264,10,82,UCBPlayer
32945,UCBPlayer,104,349,453,25,24,UCBPlayer
32946,UCBPlayer,126,126,252,7,85,Tie
32947,UCBPlayer,111,351,462,28,22,UCBPlayer
32948,UCBPlayer,116,126,242,3,87,UCBPlayer
32949,UCBPlayer,122,347,469,32,21,UCBPlayer
32950,UCBPlayer,107,132,239,0,87,UCBPlayer
32951,UCBPlayer,132,337,469,35,22,UCBPlayer
32952,UCBPlayer,103,148,251,0,83,UCBPlayer
32953,UCBPlayer,136,321,457,35,26,UCBPlayer
32954,UCBPlayer,99,164,263,0,79,UCBPlayer
32955,UCBPlayer,140,305,445,35,30,UCBPlayer
32956,UCBPlayer,95,180,275,0,75,UCBPlayer
32957,UCBPlayer,144,289,433,35,34,UCBPlayer
32958,UCBPlayer,91,196,287,0,71,UCBPlayer
32959,UCBPlayer,148,273,421,35,38,UCBPlayer
32960,UCBPlayer,87,212,299,0,67,UCBPlayer
32961,UCBPlayer,152,257,409,35,42,UCBPlayer
32962,UCBPlayer,84,224,308,0,64,UCBPlayer
32963,UCBPlayer,146,251,397,32,45,UCBPlayer
32964,UCBPlayer,89,234,323,3,60,UCBPlayer
32965,UCBPlayer,138,243,381,28,49,UCBPlayer
32966,UCBPlayer,97,242,339,7,56,UCBPlayer
32967,UCBPlayer,130,235,365,24,53,UCBPlayer
32968,UCBPlayer,105,250,355,11,52,UCBPlayer
32969,UCBPlayer,122,227,349,20,57,UCBPlayer
32970,UCBPlayer,109,259,368,15,49,UCBPlayer
32971,UCBPlayer,118,218,336,16,60,UCBPlayer
32972,UCBPlayer,117,267,384,19,45,UCBPlayer
32973,UCBPlayer,110,210,320,12,64,UCBPlayer
32974,UCBPlayer,126,271,397,23,42,UCBPlayer
32975,UCBPlayer,105,210,315,10,65,UCBPlayer
32976,UCBPlayer,130,275,405,25,40,UCBPlayer
32977,UCBPlayer,105,210,315,10,65,UCBPlayer
32978,UCBPlayer,130,275,405,25,40,UCBPlayer
32979,UCBPlayer,106,206,312,10,66,UCBPlayer
32980,UCBPlayer,130,275,405,25,40,UCBPlayer
32981,UCBPlayer,105,210,315,10,65,UCBPlayer
32982,UCBPlayer,131,271,402,25,41,UCBPlayer
32983,UCBPlayer,105,210,315,10,65,UCBPlayer
32984,UCBPlayer,130,275,405,25,40,UCBPlayer
32985,UCBPlayer,105,210,315,10,65,UCBPlayer
32986,UCBPlayer,130,275,405,25,40,UCBPlayer
32987,UCBPlayer,103,203,306,10,68,UCBPlayer
32988,UCBPlayer,128,283,411,25,38,UCBPlayer
32989,UCBPlayer,111,186,297,10,71,UCBPlayer
32990,UCBPlayer,124,299,423,25,34,UCBPlayer
32991,UCBPlayer,115,170,285,10,75,UCBPlayer
32992,UCBPlayer,120,315,435,25,30,UCBPlayer
32993,UCBPlayer,119,154,273,10,79,UCBPlayer
32994,UCBPlayer,112,332,444,25,27,UCBPlayer
32995,UCBPlayer,127,137,264,10,82,UCBPlayer
32996,UCBPlayer,104,349,453,25,24,UCBPlayer
32997,UCBPlayer,126,126,252,7,85,Tie
32998,UCBPlayer,111,351,462,28,22,UCBPlayer
32999,UCBPlayer,116,126,242,3,87,UCBPlayer
33000,UCBPlayer,122,347,469,32,21,UCBPlayer
33001,UCBPlayer,107,132,239,0,87,UCBPlayer
33002,UCBPlayer,132,337,469,35,22,UCBPlayer
33003,UCBPlayer,103,148,251,0,83,UCBPlayer
33004,UCBPlayer,136,321,457,35,26,UCBPlayer
33005,UCBPlayer,99,164,263,0,79,UCBPlayer
33006,UCBPlayer,140,305,445,35,30,UCBPlayer
33007,UCBPlayer,95,180,275,0,75,UCBPlayer
33008,UCBPlayer,144,289,433,35,34,UCBPlayer
33009,UCBPlayer,91,196,287,0,71,UCBPlayer
33010,UCBPlayer,148,273,421,35,38,UCBPlayer
33011,UCBPlayer,87,212,299,0,67,UCBPlayer
33012,UCBPlayer,152,257,409,35,42,UCBPlayer
33013,UCBPlayer,84,224,308,0,64,UCBPlayer
33014,UCBPlayer,146,251,397,32,45,UCBPlayer
33015,UCBPlayer,89,234,323,3,60,UCBPlayer
33016,UCBPlayer,138,243,381,28,49,UCBPlayer
33017,UCBPlayer,97,242,339,7,56,UCBPlayer
33018,UCBPlayer,130,235,365,24,53,UCBPlayer
33019,UCBPlayer,105,250,355,11,52,UCBPlayer
33020,UCBPlayer,122,227,349,20,57,UCBPlayer
33021,UCBPlayer,109,259,368,15,49,UCBPlayer
33022,UCBPlayer,118,218,336,16,60,UCBPlayer
33023,UCBPlayer,117,267,384,19,45,UCBPlayer
33024,UCBPlayer,110,210,320,12,64,UCBPlayer
33025,UCBPlayer,126,271,397,23,42,UCBPlayer
33026,UCBPlayer,105,210,315,10,65,UCBPlayer
33027,UCBPlayer,130,275,405,25,40,UCBPlayer
33028,UCBPlayer,105,210,315,10,65,UCBPlayer
33029,UCBPlayer,130,275,405,25,40,UCBPlayer
33030,UCBPlayer,106,206,312,10,66,UCBPlayer
33031,UCBPlayer,130,275,405,25,40,UCBPlayer
33032,UCBPlayer,105,210,315,10,65,UCBPlayer
33033,UCBPlayer,131,271,402,25,41,UCBPlayer
33034,UCBPlayer,105,210,315,10,65,UCBPlayer
33035,UCBPlayer,130,275,405,25,40,UCBPlayer
33036,UCBPlayer,105,210,315,10,65,UCBPlayer
33037,UCBPlayer,130,275,405,25,40,UCBPlayer
33038,UCBPlayer,103,203,306,10,68,UCBPlayer
33039,UCBPlayer,128,283,411,25,38,UCBPlayer
33040,UCBPlayer,111,186,297,10,71,UCBPlayer
33041,UCBPlayer,124,299,423,25,34,UCBPlayer
33042,UCBPlayer,115,170,285,10,75,UCBPlayer
33043,UCBPlayer,120,315,435,25,30,UCBPlayer
33044,UCBPlayer,119,154,273,10,79,UCBPlayer
33045,UCBPlayer,112,332,444,25,27,UCBPlayer
33046,UCBPlayer,127,137,264,10,82,UCBPlayer
33047,UCBPlayer,104,349,453,25,24,UCBPlayer
33048,UCBPlayer,126,126,252,7,85,Tie
33049,UCBPlayer,111,351,462,28,22,UCBPlayer
33050,UCBPlayer,116,126,242,3,87,UCBPlayer
33051,UCBPlayer,122,347,469,32,21,UCBPlayer
33052,UCBPlayer,107,132,239,0,87,UCBPlayer
33053,UCBPlayer,132,337,469,35,22,UCBPlayer
33054,UCBPlayer,103,148,251,0,83,UCBPlayer
33055,UCBPlayer,136,321,457,35,26,UCBPlayer
33056,UCBPlayer,99,164,263,0,79,UCBPlayer
33057,UCBPlayer,140,305,445,35,30,UCBPlayer
33058,UCBPlayer,95,180,275,0,75,UCBPlayer
33059,UCBPlayer,144,289,433,35,34,UCBPlayer
33060,UCBPlayer,91,196,287,0,71,UCBPlayer
33061,UCBPlayer,148,273,421,35,38,UCBPlayer
33062,UCBPlayer,87,212,299,0,67,UCBPlayer
33063,UCBPlayer,152,257,409,35,42,UCBPlayer
33064,UCBPlayer,84,224,308,0,64,UCBPlayer
33065,UCBPlayer,146,251,397,32,45,UCBPlayer
33066,UCBPlayer,89,234,323,3,60,UCBPlayer
33067,UCBPlayer,138,243,381,28,49,UCBPlayer
33068,UCBPlayer,97,242,339,7,56,UCBPlayer
33069,UCBPlayer,130,235,365,24,53,UCBPlayer
33070,UCBPlayer,105,250,355,11,52,UCBPlayer
33071,UCBPlayer,122,227,349,20,57,UCBPlayer
33072,UCBPlayer,109,259,368,15,49,UCBPlayer
33073,UCBPlayer,118,218,336,16,60,UCBPlayer
33074,UCBPlayer,117,267,384,19,45,UCBPlayer
33075,UCBPlayer,110,210,320,12,64,UCBPlayer
33076,UCBPlayer,126,271,397,23,42,UCBPlayer
33077,UCBPlayer,105,210,315,10,65,UCBPlayer
33078,UCBPlayer,130,275,405,25,40,UCBPlayer
33079,UCBPlayer,105,210,315,10,65,UCBPlayer
33080,UCBPlayer,130,275,405,25,40,UCBPlayer
33081,UCBPlayer,106,206,312,10,66,UCBPlayer
33082,UCBPlayer,130,275,405,25,40,UCBPlayer
33083,UCBPlayer,105,210,315,10,65,UCBPlayer
33084,UCBPlayer,131,271,402,25,41,UCBPlayer
33085,UCBPlayer,105,210,315,10,65,UCBPlayer
33086,UCBPlayer,130,275,405,25,40,UCBPlayer
33087,UCBPlayer,105,210,315,10,65,UCBPlayer
33088,UCBPlayer,130,275,405,25,40,UCBPlayer
33089,UCBPlayer,103,203,306,10,68,UCBPlayer
33090,UCBPlayer,128,283,411,25,38,UCBPlayer
33091,UCBPlayer,111,186,297,10,71,UCBPlayer
33092,UCBPlayer,124,299,423,25,34,UCBPlayer
33093,UCBPlayer,115,170,285,10,75,UCBPlayer
33094,UCBPlayer,120,315,435,25,30,UCBPlayer
33095,UCBPlayer,119,154,273,10,79,UCBPlayer
33096,UCBPlayer,112,332,444,25,27,UCBPlayer
33097,UCBPlayer,127,137,264,10,82,UCBPlayer
33098,UCBPlayer,104,349,453,25,24,UCBPlayer
33099,UCBPlayer,126,126,252,7,85,Tie
33100,UCBPlayer,111,351,462,28,22,UCBPlayer
33101,UCBPlayer,116,126,242,3,87,UCBPlayer
33102,UCBPlayer,122,347,469,32,21,UCBPlayer
33103,UCBPlayer,107,132,239,0,87,UCBPlayer
33104,UCBPlayer,132,337,469,35,22,UCBPlayer
33105,UCBPlayer,103,148,251,0,83,UCBPlayer
33106,UCBPlayer,136,321,457,35,26,UCBPlayer
33107,UCBPlayer,99,164,263,0,79,UCBPlayer
33108,UCBPlayer,140,305,445,35,30,UCBPlayer
33109,UCBPlayer,95,180,275,0,75,UCBPlayer
33110,UCBPlayer,144,289,433,35,34,UCBPlayer
33111,UCBPlayer,91,196,287,0,71,UCBPlayer
33112,UCBPlayer,148,273,421,35,38,UCBPlayer
33113,UCBPlayer,87,212,299,0,67,UCBPlayer
33114,UCBPlayer,152,257,409,35,42,UCBPlayer
33115,UCBPlayer,84,224,308,0,64,UCBPlayer
33116,UCBPlayer,146,251,397,32,45,UCBPlayer
33117,UCBPlayer,89,234,323,3,60,UCBPlayer
33118,UCBPlayer,138,243,381,28,49,UCBPlayer
33119,UCBPlayer,97,242,339,7,56,UCBPlayer
33120,UCBPlayer,130,235,365,24,53,UCBPlayer
33121,UCBPlayer,105,250,355,11,52,UCBPlayer
33122,UCBPlayer,122,227,349,20,57,UCBPlayer
33123,UCBPlayer,109,259,368,15,49,UCBPlayer
33124,UCBPlayer,118,218,336,16,60,UCBPlayer
33125,UCBPlayer,117,267,384,19,45,UCBPlayer
33126,UCBPlayer,110,210,320,12,64,UCBPlayer
33127,UCBPlayer,126,271,397,23,42,UCBPlayer
33128,UCBPlayer,105,210,315,10,65,UCBPlayer
33129,UCBPlayer,130,275,405,25,40,UCBPlayer
33130,UCBPlayer,105,210,315,10,65,UCBPlayer
33131,UCBPlayer,130,275,405,25,40,UCBPlayer
33132,UCBPlayer,106,206,312,10,66,UCBPlayer
33133,UCBPlayer,130,275,405,25,40,UCBPlayer
33134,UCBPlayer,105,210,315,10,65,UCBPlayer
33135,UCBPlayer,131,271,402,25,41,UCBPlayer
33136,UCBPlayer,105,210,315,10,65,UCBPlayer
33137,UCBPlayer,130,275,405,25,40,UCBPlayer
33138,UCBPlayer,105,210,315,10,65,UCBPlayer
33139,UCBPlayer,130,275,405,25,40,UCBPlayer
33140,UCBPlayer,103,203,306,10,68,UCBPlayer
33141,UCBPlayer,128,283,411,25,38,UCBPlayer
33142,UCBPlayer,111,186,297,10,71,UCBPlayer
33143,UCBPlayer,124,299,423,25,34,UCBPlayer
33144,UCBPlayer,115,170,285,10,75,UCBPlayer
33145,UCBPlayer,120,315,435,25,30,UCBPlayer
33146,UCBPlayer,119,154,273,10,79,UCBPlayer
33147,UCBPlayer,112,332,444,25,27,UCBPlayer
33148,UCBPlayer,127,137,264,10,82,UCBPlayer
33149,UCBPlayer,104,349,453,25,24,UCBPlayer
33150,UCBPlayer,126,126,252,7,85,Tie
33151,UCBPlayer,111,351,462,28,22,UCBPlayer
33152,UCBPlayer,116,126,242,3,87,UCBPlayer
33153,UCBPlayer,122,347,469,32,21,UCBPlayer
33154,UCBPlayer,107,132,239,0,87,UCBPlayer
33155,UCBPlayer,132,337,469,35,22,UCBPlayer
33156,UCBPlayer,103,148,251,0,83,UCBPlayer
33157,UCBPlayer,136,321,457,35,26,UCBPlayer
33158,UCBPlayer,99,164,263,0,79,UCBPlayer
33159,UCBPlayer,140,305,445,35,30,UCBPlayer
33160,UCBPlayer,95,180,275,0,75,UCBPlayer
33161,UCBPlayer,144,289,433,35,34,UCBPlayer
33162,UCBPlayer,91,196,287,0,71,UCBPlayer
33163,UCBPlayer,148,273,421,35,38,UCBPlayer
33164,UCBPlayer,87,212,299,0,67,UCBPlayer
33165,UCBPlayer,152,257,409,35,42,UCBPlayer
33166,UCBPlayer,84,224,308,0,64,UCBPlayer
33167,UCBPlayer,146,251,397,32,45,UCBPlayer
33168,UCBPlayer,89,234,323,3,60,UCBPlayer
33169,UCBPlayer,138,243,381,28,49,UCBPlayer
33170,UCBPlayer,97,242,339,7,56,UCBPlayer
33171,UCBPlayer,130,235,365,24,53,UCBPlayer
33172,UCBPlayer,105,250,355,11,52,UCBPlayer
33173,UCBPlayer,122,227,349,20,57,UCBPlayer
33174,UCBPlayer,109,259,368,15,49,UCBPlayer
33175,UCBPlayer,118,218,336,16,60,UCBPlayer
33176,UCBPlayer,117,267,384,19,45,UCBPlayer
33177,UCBPlayer,110,210,320,12,64,UCBPlayer
33178,UCBPlayer,126,271,397,23,42,UCBPlayer
33179,UCBPlayer,105,210,315,10,65,UCBPlayer
33180,UCBPlayer,130,275,405,25,40,UCBPlayer
33181,UCBPlayer,105,210,315,10,65,UCBPlayer
33182,UCBPlayer,130,275,405,25,40,UCBPlayer
33183,UCBPlayer,106,206,312,10,66,UCBPlayer
33184,UCBPlayer,130,275,405,25,40,UCBPlayer
33185,UCBPlayer,105,210,315,10,65,UCBPlayer
33186,UCBPlayer,131,271,402,25,41,UCBPlayer
33187,UCBPlayer,105,210,315,10,65,UCBPlayer
33188,UCBPlayer,130,275,405,25,40,UCBPlayer
33189,UCBPlayer,105,210,315,10,65,UCBPlayer
33190,UCBPlayer,130,275,405,25,40,UCBPlayer
33191,UCBPlayer,103,203,306,10,68,UCBPlayer
33192,UCBPlayer,128,283,411,25,38,UCBPlayer
33193,UCBPlayer,111,186,297,10,71,UCBPlayer
33194,UCBPlayer,124,299,423,25,34,UCBPlayer
33195,UCBPlayer,115,170,285,10,75,UCBPlayer
33196,UCBPlayer,120,315,435,25,30,UCBPlayer
33197,UCBPlayer,119,154,273,10,79,UCBPlayer
33198,UCBPlayer,112,332,444,25,27,UCBPlayer
33199,UCBPlayer,127,137,264,10,82,UCBPlayer
33200,UCBPlayer,104,349,453,25,24,UCBPlayer
33201,UCBPlayer,126,126,252,7,85,Tie
33202,UCBPlayer,111,351,462,28,22,UCBPlayer
33203,UCBPlayer,116,126,242,3,87,UCBPlayer
33204,UCBPlayer,122,347,469,32,21,UCBPlayer
33205,UCBPlayer,107,132,239,0,87,UCBPlayer
33206,UCBPlayer,132,337,469,35,22,UCBPlayer
33207,UCBPlayer,103,148,251,0,83,UCBPlayer
33208,UCBPlayer,136,321,457,35,26,UCBPlayer
33209,UCBPlayer,99,164,263,0,79,UCBPlayer
33210,UCBPlayer,140,305,445,35,30,UCBPlayer
33211,UCBPlayer,95,180,275,0,75,UCBPlayer
33212,UCBPlayer,144,289,433,35,34,UCBPlayer
33213,UCBPlayer,91,196,287,0,71,UCBPlayer
33214,UCBPlayer,148,273,421,35,38,UCBPlayer
33215,UCBPlayer,87,212,299,0,67,UCBPlayer
33216,UCBPlayer,152,257,409,35,42,UCBPlayer
33217,UCBPlayer,84,224,308,0,64,UCBPlayer
33218,UCBPlayer,146,251,397,32,45,UCBPlayer
33219,UCBPlayer,89,234,323,3,60,UCBPlayer
33220,UCBPlayer,138,243,381,28,49,UCBPlayer
33221,UCBPlayer,97,242,339,7,56,UCBPlayer
33222,UCBPlayer,130,235,365,24,53,UCBPlayer
33223,UCBPlayer,105,250,355,11,52,UCBPlayer
33224,UCBPlayer,122,227,349,20,57,UCBPlayer
33225,UCBPlayer,109,259,368,15,49,UCBPlayer
33226,UCBPlayer,118,218,336,16,60,UCBPlayer
33227,UCBPlayer,117,267,384,19,45,UCBPlayer
33228,UCBPlayer,110,210,320,12,64,UCBPlayer
33229,UCBPlayer,126,271,397,23,42,UCBPlayer
33230,UCBPlayer,105,210,315,10,65,UCBPlayer
33231,UCBPlayer,130,275,405,25,40,UCBPlayer
33232,UCBPlayer,105,210,315,10,65,UCBPlayer
33233,UCBPlayer,130,275,405,25,40,UCBPlayer
33234,UCBPlayer,106,206,312,10,66,UCBPlayer
33235,UCBPlayer,130,275,405,25,40,UCBPlayer
33236,UCBPlayer,105,210,315,10,65,UCBPlayer
33237,UCBPlayer,131,271,402,25,41,UCBPlayer
33238,UCBPlayer,105,210,315,10,65,UCBPlayer
33239,UCBPlayer,130,275,405,25,40,UCBPlayer
33240,UCBPlayer,105,210,315,10,65,UCBPlayer
33241,UCBPlayer,130,275,405,25,40,UCBPlayer
33242,UCBPlayer,103,203,306,10,68,UCBPlayer
33243,UCBPlayer,128,283,411,25,38,UCBPlayer
33244,UCBPlayer,111,186,297,10,71,UCBPlayer
33245,UCBPlayer,124,299,423,25,34,UCBPlayer
33246,UCBPlayer,115,170,285,10,75,UCBPlayer
33247,UCBPlayer,120,315,435,25,30,UCBPlayer
33248,UCBPlayer,119,154,273,10,79,UCBPlayer
33249,UCBPlayer,112,332,444,25,27,UCBPlayer
33250,UCBPlayer,127,137,264,10,82,UCBPlayer
33251,UCBPlayer,104,349,453,25,24,UCBPlayer
33252,UCBPlayer,126,126,252,7,85,Tie
33253,UCBPlayer,111,351,462,28,22,UCBPlayer
33254,UCBPlayer,116,126,242,3,87,UCBPlayer
33255,UCBPlayer,122,347,469,32,21,UCBPlayer
33256,UCBPlayer,107,132,239,0,87,UCBPlayer
33257,UCBPlayer,132,337,469,35,22,UCBPlayer
33258,UCBPlayer,103,148,251,0,83,UCBPlayer
33259,UCBPlayer,136,321,457,35,26,UCBPlayer
33260,UCBPlayer,99,164,263,0,79,UCBPlayer
33261,UCBPlayer,140,305,445,35,30,UCBPlayer
33262,UCBPlayer,95,180,275,0,75,UCBPlayer
33263,UCBPlayer,144,289,433,35,34,UCBPlayer
33264,UCBPlayer,91,196,287,0,71,UCBPlayer
33265,UCBPlayer,148,273,421,35,38,UCBPlayer
33266,UCBPlayer,87,212,299,0,67,UCBPlayer
33267,UCBPlayer,152,257,409,35,42,UCBPlayer
33268,UCBPlayer,84,224,308,0,64,UCBPlayer
33269,UCBPlayer,146,251,397,32,45,UCBPlayer
33270,UCBPlayer,89,234,323,3,60,UCBPlayer
33271,UCBPlayer,138,243,381,28,49,UCBPlayer
33272,UCBPlayer,97,242,339,7,56,UCBPlayer
33273,UCBPlayer,130,235,365,24,53,UCBPlayer
33274,UCBPlayer,105,250,355,11,52,UCBPlayer
33275,UCBPlayer,122,227,349,20,57,UCBPlayer
33276,UCBPlayer,109,259,368,15,49,UCBPlayer
33277,UCBPlayer,118,218,336,16,60,UCBPlayer
33278,UCBPlayer,117,267,384,19,45,UCBPlayer
33279,UCBPlayer,110,210,320,12,64,UCBPlayer
33280,UCBPlayer,126,271,397,23,42,UCBPlayer
33281,UCBPlayer,105,210,315,10,65,UCBPlayer
33282,UCBPlayer,130,275,405,25,40,UCBPlayer
33283,UCBPlayer,105,210,315,10,65,UCBPlayer
33284,UCBPlayer,130,275,405,25,40,UCBPlayer
33285,UCBPlayer,106,206,312,10,66,UCBPlayer
33286,UCBPlayer,130,275,405,25,40,UCBPlayer
33287,UCBPlayer,105,210,315,10,65,UCBPlayer
33288,UCBPlayer,131,271,402,25,41,UCBPlayer
33289,UCBPlayer,105,210,315,10,65,UCBPlayer
33290,UCBPlayer,130,275,405,25,40,UCBPlayer
33291,UCBPlayer,105,210,315,10,65,UCBPlayer
33292,UCBPlayer,130,275,405,25,40,UCBPlayer
33293,UCBPlayer,103,203,306,10,68,UCBPlayer
33294,UCBPlayer,128,283,411,25,38,UCBPlayer
33295,UCBPlayer,111,186,297,10,71,UCBPlayer
33296,UCBPlayer,124,299,423,25,34,UCBPlayer
33297,UCBPlayer,115,170,285,10,75,UCBPlayer
33298,UCBPlayer,120,315,435,25,30,UCBPlayer
33299,UCBPlayer,119,154,273,10,79,UCBPlayer
33300,UCBPlayer,112,332,444,25,27,UCBPlayer
33301,UCBPlayer,127,137,264,10,82,UCBPlayer
33302,UCBPlayer,104,349,453,25,24,UCBPlayer
33303,UCBPlayer,126,126,252,7,85,Tie
33304,UCBPlayer,111,351,462,28,22,UCBPlayer
33305,UCBPlayer,116,126,242,3,87,UCBPlayer
33306,UCBPlayer,122,347,469,32,21,UCBPlayer
33307,UCBPlayer,107,132,239,0,87,UCBPlayer
33308,UCBPlayer,132,337,469,35,22,UCBPlayer
33309,UCBPlayer,103,148,251,0,83,UCBPlayer
33310,UCBPlayer,136,321,457,35,26,UCBPlayer
33311,UCBPlayer,99,164,263,0,79,UCBPlayer
33312,UCBPlayer,140,305,445,35,30,UCBPlayer
33313,UCBPlayer,95,180,275,0,75,UCBPlayer
33314,UCBPlayer,144,289,433,35,34,UCBPlayer
33315,UCBPlayer,91,196,287,0,71,UCBPlayer
33316,UCBPlayer,148,273,421,35,38,UCBPlayer
33317,UCBPlayer,87,212,299,0,67,UCBPlayer
33318,UCBPlayer,152,257,409,35,42,UCBPlayer
33319,UCBPlayer,84,224,308,0,64,UCBPlayer
33320,UCBPlayer,146,251,397,32,45,UCBPlayer
33321,UCBPlayer,89,234,323,3,60,UCBPlayer
33322,UCBPlayer,138,243,381,28,49,UCBPlayer
33323,UCBPlayer,97,242,339,7,56,UCBPlayer
33324,UCBPlayer,130,235,365,24,53,UCBPlayer
33325,UCBPlayer,105,250,355,11,52,UCBPlayer
33326,UCBPlayer,122,227,349,20,57,UCBPlayer
33327,UCBPlayer,109,259,368,15,49,UCBPlayer
33328,UCBPlayer,118,218,336,16,60,UCBPlayer
33329,UCBPlayer,117,267,384,19,45,UCBPlayer
33330,UCBPlayer,110,210,320,12,64,UCBPlayer
33331,UCBPlayer,126,271,397,23,42,UCBPlayer
33332,UCBPlayer,105,210,315,10,65,UCBPlayer
33333,UCBPlayer,130,275,405,25,40,UCBPlayer
33334,UCBPlayer,105,210,315,10,65,UCBPlayer
33335,UCBPlayer,130,275,405,25,40,UCBPlayer
33336,UCBPlayer,106,206,312,10,66,UCBPlayer
33337,UCBPlayer,130,275,405,25,40,UCBPlayer
33338,UCBPlayer,105,210,315,10,65,UCBPlayer
33339,UCBPlayer,131,271,402,25,41,UCBPlayer
33340,UCBPlayer,105,210,315,10,65,UCBPlayer
33341,UCBPlayer,130,275,405,25,40,UCBPlayer
33342,UCBPlayer,105,210,315,10,65,UCBPlayer
33343,UCBPlayer,130,275,405,25,40,UCBPlayer
33344,UCBPlayer,103,203,306,10,68,UCBPlayer
33345,UCBPlayer,128,283,411,25,38,UCBPlayer
33346,UCBPlayer,111,186,297,10,71,UCBPlayer
33347,UCBPlayer,124,299,423,25,34,UCBPlayer
33348,UCBPlayer,115,170,285,10,75,UCBPlayer
33349,UCBPlayer,120,315,435,25,30,UCBPlayer
33350,UCBPlayer,119,154,273,10,79,UCBPlayer
33351,UCBPlayer,112,332,444,25,27,UCBPlayer
33352,UCBPlayer,127,137,264,10,82,UCBPlayer
33353,UCBPlayer,104,349,453,25,24,UCBPlayer
33354,UCBPlayer,126,126,252,7,85,Tie
33355,UCBPlayer,111,351,462,28,22,UCBPlayer
33356,UCBPlayer,116,126,242,3,87,UCBPlayer
33357,UCBPlayer,122,347,469,32,21,UCBPlayer
33358,UCBPlayer,107,132,239,0,87,UCBPlayer
33359,UCBPlayer,132,337,469,35,22,UCBPlayer
33360,UCBPlayer,103,148,251,0,83,UCBPlayer
33361,UCBPlayer,136,321,457,35,26,UCBPlayer
33362,UCBPlayer,99,164,263,0,79,UCBPlayer
33363,UCBPlayer,140,305,445,35,30,UCBPlayer
33364,UCBPlayer,95,180,275,0,75,UCBPlayer
33365,UCBPlayer,144,289,433,35,34,UCBPlayer
33366,UCBPlayer,91,196,287,0,71,UCBPlayer
33367,UCBPlayer,148,273,421,35,38,UCBPlayer
33368,UCBPlayer,87,212,299,0,67,UCBPlayer
33369,UCBPlayer,152,257,409,35,42,UCBPlayer
33370,UCBPlayer,84,224,308,0,64,UCBPlayer
33371,UCBPlayer,146,251,397,32,45,UCBPlayer
33372,UCBPlayer,89,234,323,3,60,UCBPlayer
33373,UCBPlayer,138,243,381,28,49,UCBPlayer
33374,UCBPlayer,97,242,339,7,56,UCBPlayer
33375,UCBPlayer,130,235,365,24,53,UCBPlayer
33376,UCBPlayer,105,250,355,11,52,UCBPlayer
33377,UCBPlayer,122,227,349,20,57,UCBPlayer
33378,UCBPlayer,109,259,368,15,49,UCBPlayer
33379,UCBPlayer,118,218,336,16,60,UCBPlayer
33380,UCBPlayer,117,267,384,19,45,UCBPlayer
33381,UCBPlayer,110,210,320,12,64,UCBPlayer
33382,UCBPlayer,126,271,397,23,42,UCBPlayer
33383,UCBPlayer,105,210,315,10,65,UCBPlayer
33384,UCBPlayer,130,275,405,25,40,UCBPlayer
33385,UCBPlayer,105,210,315,10,65,UCBPlayer
33386,UCBPlayer,130,275,405,25,40,UCBPlayer
33387,UCBPlayer,106,206,312,10,66,UCBPlayer
33388,UCBPlayer,130,275,405,25,40,UCBPlayer
33389,UCBPlayer,105,210,315,10,65,UCBPlayer
33390,UCBPlayer,131,271,402,25,41,UCBPlayer
33391,UCBPlayer,105,210,315,10,65,UCBPlayer
33392,UCBPlayer,130,275,405,25,40,UCBPlayer
33393,UCBPlayer,105,210,315,10,65,UCBPlayer
33394,UCBPlayer,130,275,405,25,40,UCBPlayer
33395,UCBPlayer,103,203,306,10,68,UCBPlayer
33396,UCBPlayer,128,283,411,25,38,UCBPlayer
33397,UCBPlayer,111,186,297,10,71,UCBPlayer
33398,UCBPlayer,124,299,423,25,34,UCBPlayer
33399,UCBPlayer,115,170,285,10,75,UCBPlayer
33400,UCBPlayer,120,315,435,25,30,UCBPlayer
33401,UCBPlayer,119,154,273,10,79,UCBPlayer
33402,UCBPlayer,112,332,444,25,27,UCBPlayer
33403,UCBPlayer,127,137,264,10,82,UCBPlayer
33404,UCBPlayer,104,349,453,25,24,UCBPlayer
33405,UCBPlayer,126,126,252,7,85,Tie
33406,UCBPlayer,111,351,462,28,22,UCBPlayer
33407,UCBPlayer,116,126,242,3,87,UCBPlayer
33408,UCBPlayer,122,347,469,32,21,UCBPlayer
33409,UCBPlayer,107,132,239,0,87,UCBPlayer
33410,UCBPlayer,132,337,469,35,22,UCBPlayer
33411,UCBPlayer,103,148,251,0,83,UCBPlayer
33412,UCBPlayer,136,321,457,35,26,UCBPlayer
33413,UCBPlayer,99,164,263,0,79,UCBPlayer
33414,UCBPlayer,140,305,445,35,30,UCBPlayer
33415,UCBPlayer,95,180,275,0,75,UCBPlayer
33416,UCBPlayer,144,289,433,35,34,UCBPlayer
33417,UCBPlayer,91,196,287,0,71,UCBPlayer
33418,UCBPlayer,148,273,421,35,38,UCBPlayer
33419,UCBPlayer,87,212,299,0,67,UCBPlayer
33420,UCBPlayer,152,257,409,35,42,UCBPlayer
33421,UCBPlayer,84,224,308,0,64,UCBPlayer
33422,UCBPlayer,146,251,397,32,45,UCBPlayer
33423,UCBPlayer,89,234,323,3,60,UCBPlayer
33424,UCBPlayer,138,243,381,28,49,UCBPlayer
33425,UCBPlayer,97,242,339,7,56,UCBPlayer
33426,UCBPlayer,130,235,365,24,53,UCBPlayer
33427,UCBPlayer,105,250,355,11,52,UCBPlayer
33428,UCBPlayer,122,227,349,20,57,UCBPlayer
33429,UCBPlayer,109,259,368,15,49,UCBPlayer
33430,UCBPlayer,118,218,336,16,60,UCBPlayer
33431,UCBPlayer,117,267,384,19,45,UCBPlayer
33432,UCBPlayer,110,210,320,12,64,UCBPlayer
33433,UCBPlayer,126,271,397,23,42,UCBPlayer
33434,UCBPlayer,105,210,315,10,65,UCBPlayer
33435,UCBPlayer,130,275,405,25,40,UCBPlayer
33436,UCBPlayer,105,210,315,10,65,UCBPlayer
33437,UCBPlayer,130,275,405,25,40,UCBPlayer
33438,UCBPlayer,106,206,312,10,66,UCBPlayer
33439,UCBPlayer,130,275,405,25,40,UCBPlayer
33440,UCBPlayer,105,210,315,10,65,UCBPlayer
33441,UCBPlayer,131,271,402,25,41,UCBPlayer
33442,UCBPlayer,105,210,315,10,65,UCBPlayer
33443,UCBPlayer,130,275,405,25,40,UCBPlayer
33444,UCBPlayer,105,210,315,10,65,UCBPlayer
33445,UCBPlayer,130,275,405,25,40,UCBPlayer
33446,UCBPlayer,103,203,306,10,68,UCBPlayer
33447,UCBPlayer,128,283,411,25,38,UCBPlayer
33448,UCBPlayer,111,186,297,10,71,UCBPlayer
33449,UCBPlayer,124,299,423,25,34,UCBPlayer
33450,UCBPlayer,115,170,285,10,75,UCBPlayer
33451,UCBPlayer,120,315,435,25,30,UCBPlayer
33452,UCBPlayer,119,154,273,10,79,UCBPlayer
33453,UCBPlayer,112,332,444,25,27,UCBPlayer
33454,UCBPlayer,127,137,264,10,82,UCBPlayer
33455,UCBPlayer,104,349,453,25,24,UCBPlayer
33456,UCBPlayer,126,126,252,7,85,Tie
33457,UCBPlayer,111,351,462,28,22,UCBPlayer
33458,UCBPlayer,116,126,242,3,87,UCBPlayer
33459,UCBPlayer,122,347,469,32,21,UCBPlayer
33460,UCBPlayer,107,132,239,0,87,UCBPlayer
33461,UCBPlayer,132,337,469,35,22,UCBPlayer
33462,UCBPlayer,103,148,251,0,83,UCBPlayer
33463,UCBPlayer,136,321,457,35,26,UCBPlayer
33464,UCBPlayer,99,164,263,0,79,UCBPlayer
33465,UCBPlayer,140,305,445,35,30,UCBPlayer
33466,UCBPlayer,95,180,275,0,75,UCBPlayer
33467,UCBPlayer,144,289,433,35,34,UCBPlayer
33468,UCBPlayer,91,196,287,0,71,UCBPlayer
33469,UCBPlayer,148,273,421,35,38,UCBPlayer
33470,UCBPlayer,87,212,299,0,67,UCBPlayer
33471,UCBPlayer,152,257,409,35,42,UCBPlayer
33472,UCBPlayer,84,224,308,0,64,UCBPlayer
33473,UCBPlayer,146,251,397,32,45,UCBPlayer
33474,UCBPlayer,89,234,323,3,60,UCBPlayer
33475,UCBPlayer,138,243,381,28,49,UCBPlayer
33476,UCBPlayer,97,242,339,7,56,UCBPlayer
33477,UCBPlayer,130,235,365,24,53,UCBPlayer
33478,UCBPlayer,105,250,355,11,52,UCBPlayer
33479,UCBPlayer,122,227,349,20,57,UCBPlayer
33480,UCBPlayer,109,259,368,15,49,UCBPlayer
33481,UCBPlayer,118,218,336,16,60,UCBPlayer
33482,UCBPlayer,117,267,384,19,45,UCBPlayer
33483,UCBPlayer,110,210,320,12,64,UCBPlayer
33484,UCBPlayer,126,271,397,23,42,UCBPlayer
33485,UCBPlayer,105,210,315,10,65,UCBPlayer
33486,UCBPlayer,130,275,405,25,40,UCBPlayer
33487,UCBPlayer,105,210,315,10,65,UCBPlayer
33488,UCBPlayer,130,275,405,25,40,UCBPlayer
33489,UCBPlayer,106,206,312,10,66,UCBPlayer
33490,UCBPlayer,130,275,405,25,40,UCBPlayer
33491,UCBPlayer,105,210,315,10,65,UCBPlayer
33492,UCBPlayer,131,271,402,25,41,UCBPlayer
33493,UCBPlayer,105,210,315,10,65,UCBPlayer
33494,UCBPlayer,130,275,405,25,40,UCBPlayer
33495,UCBPlayer,105,210,315,10,65,UCBPlayer
33496,UCBPlayer,130,275,405,25,40,UCBPlayer
33497,UCBPlayer,103,203,306,10,68,UCBPlayer
33498,UCBPlayer,128,283,411,25,38,UCBPlayer
33499,UCBPlayer,111,186,297,10,71,UCBPlayer
33500,UCBPlayer,124,299,423,25,34,UCBPlayer
33501,UCBPlayer,115,170,285,10,75,UCBPlayer
33502,UCBPlayer,120,315,435,25,30,UCBPlayer
33503,UCBPlayer,119,154,273,10,79,UCBPlayer
33504,UCBPlayer,112,332,444,25,27,UCBPlayer
33505,UCBPlayer,127,137,264,10,82,UCBPlayer
33506,UCBPlayer,104,349,453,25,24,UCBPlayer
33507,UCBPlayer,126,126,252,7,85,Tie
33508,UCBPlayer,111,351,462,28,22,UCBPlayer
33509,UCBPlayer,116,126,242,3,87,UCBPlayer
33510,UCBPlayer,122,347,469,32,21,UCBPlayer
33511,UCBPlayer,107,132,239,0,87,UCBPlayer
33512,UCBPlayer,132,337,469,35,22,UCBPlayer
33513,UCBPlayer,103,148,251,0,83,UCBPlayer
33514,UCBPlayer,136,321,457,35,26,UCBPlayer
33515,UCBPlayer,99,164,263,0,79,UCBPlayer
33516,UCBPlayer,140,305,445,35,30,UCBPlayer
33517,UCBPlayer,95,180,275,0,75,UCBPlayer
33518,UCBPlayer,144,289,433,35,34,UCBPlayer
33519,UCBPlayer,91,196,287,0,71,UCBPlayer
33520,UCBPlayer,148,273,421,35,38,UCBPlayer
33521,UCBPlayer,87,212,299,0,67,UCBPlayer
33522,UCBPlayer,152,257,409,35,42,UCBPlayer
33523,UCBPlayer,84,224,308,0,64,UCBPlayer
33524,UCBPlayer,146,251,397,32,45,UCBPlayer
33525,UCBPlayer,89,234,323,3,60,UCBPlayer
33526,UCBPlayer,138,243,381,28,49,UCBPlayer
33527,UCBPlayer,97,242,339,7,56,UCBPlayer
33528,UCBPlayer,130,235,365,24,53,UCBPlayer
33529,UCBPlayer,105,250,355,11,52,UCBPlayer
33530,UCBPlayer,122,227,349,20,57,UCBPlayer
33531,UCBPlayer,109,259,368,15,49,UCBPlayer
33532,UCBPlayer,118,218,336,16,60,UCBPlayer
33533,UCBPlayer,117,267,384,19,45,UCBPlayer
33534,UCBPlayer,110,210,320,12,64,UCBPlayer
33535,UCBPlayer,126,271,397,23,42,UCBPlayer
33536,UCBPlayer,105,210,315,10,65,UCBPlayer
33537,UCBPlayer,130,275,405,25,40,UCBPlayer
33538,UCBPlayer,105,210,315,10,65,UCBPlayer
33539,UCBPlayer,130,275,405,25,40,UCBPlayer
33540,UCBPlayer,106,206,312,10,66,UCBPlayer
33541,UCBPlayer,130,275,405,25,40,UCBPlayer
33542,UCBPlayer,105,210,315,10,65,UCBPlayer
33543,UCBPlayer,131,271,402,25,41,UCBPlayer
33544,UCBPlayer,105,210,315,10,65,UCBPlayer
33545,UCBPlayer,130,275,405,25,40,UCBPlayer
33546,UCBPlayer,105,210,315,10,65,UCBPlayer
33547,UCBPlayer,130,275,405,25,40,UCBPlayer
33548,UCBPlayer,103,203,306,10,68,UCBPlayer
33549,UCBPlayer,128,283,411,25,38,UCBPlayer
33550,UCBPlayer,111,186,297,10,71,UCBPlayer
33551,UCBPlayer,124,299,423,25,34,UCBPlayer
33552,UCBPlayer,115,170,285,10,75,UCBPlayer
33553,UCBPlayer,120,315,435,25,30,UCBPlayer
33554,UCBPlayer,119,154,273,10,79,UCBPlayer
33555,UCBPlayer,112,332,444,25,27,UCBPlayer
33556,UCBPlayer,127,137,264,10,82,UCBPlayer
33557,UCBPlayer,104,349,453,25,24,UCBPlayer
33558,UCBPlayer,126,126,252,7,85,Tie
33559,UCBPlayer,111,351,462,28,22,UCBPlayer
33560,UCBPlayer,116,126,242,3,87,UCBPlayer
33561,UCBPlayer,122,347,469,32,21,UCBPlayer
33562,UCBPlayer,107,132,239,0,87,UCBPlayer
33563,UCBPlayer,132,337,469,35,22,UCBPlayer
33564,UCBPlayer,103,148,251,0,83,UCBPlayer
33565,UCBPlayer,136,321,457,35,26,UCBPlayer
33566,UCBPlayer,99,164,263,0,79,UCBPlayer
33567,UCBPlayer,140,305,445,35,30,UCBPlayer
33568,UCBPlayer,95,180,275,0,75,UCBPlayer
33569,UCBPlayer,144,289,433,35,34,UCBPlayer
33570,UCBPlayer,91,196,287,0,71,UCBPlayer
33571,UCBPlayer,148,273,421,35,38,UCBPlayer
33572,UCBPlayer,87,212,299,0,67,UCBPlayer
33573,UCBPlayer,152,257,409,35,42,UCBPlayer
33574,UCBPlayer,84,224,308,0,64,UCBPlayer
33575,UCBPlayer,146,251,397,32,45,UCBPlayer
33576,UCBPlayer,89,234,323,3,60,UCBPlayer
33577,UCBPlayer,138,243,381,28,49,UCBPlayer
33578,UCBPlayer,97,242,339,7,56,UCBPlayer
33579,UCBPlayer,130,235,365,24,53,UCBPlayer
33580,UCBPlayer,105,250,355,11,52,UCBPlayer
33581,UCBPlayer,122,227,349,20,57,UCBPlayer
33582,UCBPlayer,109,259,368,15,49,UCBPlayer
33583,UCBPlayer,118,218,336,16,60,UCBPlayer
33584,UCBPlayer,117,267,384,19,45,UCBPlayer
33585,UCBPlayer,110,210,320,12,64,UCBPlayer
33586,UCBPlayer,126,271,397,23,42,UCBPlayer
33587,UCBPlayer,105,210,315,10,65,UCBPlayer
33588,UCBPlayer,130,275,405,25,40,UCBPlayer
33589,UCBPlayer,105,210,315,10,65,UCBPlayer
33590,UCBPlayer,130,275,405,25,40,UCBPlayer
33591,UCBPlayer,106,206,312,10,66,UCBPlayer
33592,UCBPlayer,130,275,405,25,40,UCBPlayer
33593,UCBPlayer,105,210,315,10,65,UCBPlayer
33594,UCBPlayer,131,271,402,25,41,UCBPlayer
33595,UCBPlayer,105,210,315,10,65,UCBPlayer
33596,UCBPlayer,130,275,405,25,40,UCBPlayer
33597,UCBPlayer,105,210,315,10,65,UCBPlayer
33598,UCBPlayer,130,275,405,25,40,UCBPlayer
33599,UCBPlayer,103,203,306,10,68,UCBPlayer
33600,UCBPlayer,128,283,411,25,38,UCBPlayer
33601,UCBPlayer,111,186,297,10,71,UCBPlayer
33602,UCBPlayer,124,299,423,25,34,UCBPlayer
33603,UCBPlayer,115,170,285,10,75,UCBPlayer
33604,UCBPlayer,120,315,435,25,30,UCBPlayer
33605,UCBPlayer,119,154,273,10,79,UCBPlayer
33606,UCBPlayer,112,332,444,25,27,UCBPlayer
33607,UCBPlayer,127,137,264,10,82,UCBPlayer
33608,UCBPlayer,104,349,453,25,24,UCBPlayer
33609,UCBPlayer,126,126,252,7,85,Tie
33610,UCBPlayer,111,351,462,28,22,UCBPlayer
33611,UCBPlayer,116,126,242,3,87,UCBPlayer
33612,UCBPlayer,122,347,469,32,21,UCBPlayer
33613,UCBPlayer,107,132,239,0,87,UCBPlayer
33614,UCBPlayer,132,337,469,35,22,UCBPlayer
33615,UCBPlayer,103,148,251,0,83,UCBPlayer
33616,UCBPlayer,136,321,457,35,26,UCBPlayer
33617,UCBPlayer,99,164,263,0,79,UCBPlayer
33618,UCBPlayer,140,305,445,35,30,UCBPlayer
33619,UCBPlayer,95,180,275,0,75,UCBPlayer
33620,UCBPlayer,144,289,433,35,34,UCBPlayer
33621,UCBPlayer,91,196,287,0,71,UCBPlayer
33622,UCBPlayer,148,273,421,35,38,UCBPlayer
33623,UCBPlayer,87,212,299,0,67,UCBPlayer
33624,UCBPlayer,152,257,409,35,42,UCBPlayer
33625,UCBPlayer,84,224,308,0,64,UCBPlayer
33626,UCBPlayer,146,251,397,32,45,UCBPlayer
33627,UCBPlayer,89,234,323,3,60,UCBPlayer
33628,UCBPlayer,138,243,381,28,49,UCBPlayer
33629,UCBPlayer,97,242,339,7,56,UCBPlayer
33630,UCBPlayer,130,235,365,24,53,UCBPlayer
33631,UCBPlayer,105,250,355,11,52,UCBPlayer
33632,UCBPlayer,122,227,349,20,57,UCBPlayer
33633,UCBPlayer,109,259,368,15,49,UCBPlayer
33634,UCBPlayer,118,218,336,16,60,UCBPlayer
33635,UCBPlayer,117,267,384,19,45,UCBPlayer
33636,UCBPlayer,110,210,320,12,64,UCBPlayer
33637,UCBPlayer,126,271,397,23,42,UCBPlayer
33638,UCBPlayer,105,210,315,10,65,UCBPlayer
33639,UCBPlayer,130,275,405,25,40,UCBPlayer
33640,UCBPlayer,105,210,315,10,65,UCBPlayer
33641,UCBPlayer,130,275,405,25,40,UCBPlayer
33642,UCBPlayer,106,206,312,10,66,UCBPlayer
33643,UCBPlayer,130,275,405,25,40,UCBPlayer
33644,UCBPlayer,105,210,315,10,65,UCBPlayer
33645,UCBPlayer,131,271,402,25,41,UCBPlayer
33646,UCBPlayer,105,210,315,10,65,UCBPlayer
33647,UCBPlayer,130,275,405,25,40,UCBPlayer
33648,UCBPlayer,105,210,315,10,65,UCBPlayer
33649,UCBPlayer,130,275,405,25,40,UCBPlayer
33650,UCBPlayer,103,203,306,10,68,UCBPlayer
33651,UCBPlayer,128,283,411,25,38,UCBPlayer
33652,UCBPlayer,111,186,297,10,71,UCBPlayer
33653,UCBPlayer,124,299,423,25,34,UCBPlayer
33654,UCBPlayer,115,170,285,10,75,UCBPlayer
33655,UCBPlayer,120,315,435,25,30,UCBPlayer
33656,UCBPlayer,119,154,273,10,79,UCBPlayer
33657,UCBPlayer,112,332,444,25,27,UCBPlayer
33658,UCBPlayer,127,137,264,10,82,UCBPlayer
33659,UCBPlayer,104,349,453,25,24,UCBPlayer
33660,UCBPlayer,126,126,252,7,85,Tie
33661,UCBPlayer,111,351,462,28,22,UCBPlayer
33662,UCBPlayer,116,126,242,3,87,UCBPlayer
33663,UCBPlayer,122,347,469,32,21,UCBPlayer
33664,UCBPlayer,107,132,239,0,87,UCBPlayer
33665,UCBPlayer,132,337,469,35,22,UCBPlayer
33666,UCBPlayer,103,148,251,0,83,UCBPlayer
33667,UCBPlayer,136,321,457,35,26,UCBPlayer
33668,UCBPlayer,99,164,263,0,79,UCBPlayer
33669,UCBPlayer,140,305,445,35,30,UCBPlayer
33670,UCBPlayer,95,180,275,0,75,UCBPlayer
33671,UCBPlayer,144,289,433,35,34,UCBPlayer
33672,UCBPlayer,91,196,287,0,71,UCBPlayer
33673,UCBPlayer,148,273,421,35,38,UCBPlayer
33674,UCBPlayer,87,212,299,0,67,UCBPlayer
33675,UCBPlayer,152,257,409,35,42,UCBPlayer
33676,UCBPlayer,84,224,308,0,64,UCBPlayer
33677,UCBPlayer,146,251,397,32,45,UCBPlayer
33678,UCBPlayer,89,234,323,3,60,UCBPlayer
33679,UCBPlayer,138,243,381,28,49,UCBPlayer
33680,UCBPlayer,97,242,339,7,56,UCBPlayer
33681,UCBPlayer,130,235,365,24,53,UCBPlayer
33682,UCBPlayer,105,250,355,11,52,UCBPlayer
33683,UCBPlayer,122,227,349,20,57,UCBPlayer
33684,UCBPlayer,109,259,368,15,49,UCBPlayer
33685,UCBPlayer,118,218,336,16,60,UCBPlayer
33686,UCBPlayer,117,267,384,19,45,UCBPlayer
33687,UCBPlayer,110,210,320,12,64,UCBPlayer
33688,UCBPlayer,126,271,397,23,42,UCBPlayer
33689,UCBPlayer,105,210,315,10,65,UCBPlayer
33690,UCBPlayer,130,275,405,25,40,UCBPlayer
33691,UCBPlayer,105,210,315,10,65,UCBPlayer
33692,UCBPlayer,130,275,405,25,40,UCBPlayer
33693,UCBPlayer,106,206,312,10,66,UCBPlayer
33694,UCBPlayer,130,275,405,25,40,UCBPlayer
33695,UCBPlayer,105,210,315,10,65,UCBPlayer
33696,UCBPlayer,131,271,402,25,41,UCBPlayer
33697,UCBPlayer,105,210,315,10,65,UCBPlayer
33698,UCBPlayer,130,275,405,25,40,UCBPlayer
33699,UCBPlayer,105,210,315,10,65,UCBPlayer
33700,UCBPlayer,130,275,405,25,40,UCBPlayer
33701,UCBPlayer,103,203,306,10,68,UCBPlayer
33702,UCBPlayer,128,283,411,25,38,UCBPlayer
33703,UCBPlayer,111,186,297,10,71,UCBPlayer
33704,UCBPlayer,124,299,423,25,34,UCBPlayer
33705,UCBPlayer,115,170,285,10,75,UCBPlayer
33706,UCBPlayer,120,315,435,25,30,UCBPlayer
33707,UCBPlayer,119,154,273,10,79,UCBPlayer
33708,UCBPlayer,112,332,444,25,27,UCBPlayer
33709,UCBPlayer,127,137,264,10,82,UCBPlayer
33710,UCBPlayer,104,349,453,25,24,UCBPlayer
33711,UCBPlayer,126,126,252,7,85,Tie
33712,UCBPlayer,111,351,462,28,22,UCBPlayer
33713,UCBPlayer,116,126,242,3,87,UCBPlayer
33714,UCBPlayer,122,347,469,32,21,UCBPlayer
33715,UCBPlayer,107,132,239,0,87,UCBPlayer
33716,UCBPlayer,132,337,469,35,22,UCBPlayer
33717,UCBPlayer,103,148,251,0,83,UCBPlayer
33718,UCBPlayer,136,321,457,35,26,UCBPlayer
33719,UCBPlayer,99,164,263,0,79,UCBPlayer
33720,UCBPlayer,140,305,445,35,30,UCBPlayer
33721,UCBPlayer,95,180,275,0,75,UCBPlayer
33722,UCBPlayer,144,289,433,35,34,UCBPlayer
33723,UCBPlayer,91,196,287,0,71,UCBPlayer
33724,UCBPlayer,148,273,421,35,38,UCBPlayer
33725,UCBPlayer,87,212,299,0,67,UCBPlayer
33726,UCBPlayer,152,257,409,35,42,UCBPlayer
33727,UCBPlayer,84,224,308,0,64,UCBPlayer
33728,UCBPlayer,146,251,397,32,45,UCBPlayer
33729,UCBPlayer,89,234,323,3,60,UCBPlayer
33730,UCBPlayer,138,243,381,28,49,UCBPlayer
33731,UCBPlayer,97,242,339,7,56,UCBPlayer
33732,UCBPlayer,130,235,365,24,53,UCBPlayer
33733,UCBPlayer,105,250,355,11,52,UCBPlayer
33734,UCBPlayer,122,227,349,20,57,UCBPlayer
33735,UCBPlayer,109,259,368,15,49,UCBPlayer
33736,UCBPlayer,118,218,336,16,60,UCBPlayer
33737,UCBPlayer,117,267,384,19,45,UCBPlayer
33738,UCBPlayer,110,210,320,12,64,UCBPlayer
33739,UCBPlayer,126,271,397,23,42,UCBPlayer
33740,UCBPlayer,105,210,315,10,65,UCBPlayer
33741,UCBPlayer,130,275,405,25,40,UCBPlayer
33742,UCBPlayer,105,210,315,10,65,UCBPlayer
33743,UCBPlayer,130,275,405,25,40,UCBPlayer
33744,UCBPlayer,106,206,312,10,66,UCBPlayer
33745,UCBPlayer,130,275,405,25,40,UCBPlayer
33746,UCBPlayer,105,210,315,10,65,UCBPlayer
33747,UCBPlayer,131,271,402,25,41,UCBPlayer
33748,UCBPlayer,105,210,315,10,65,UCBPlayer
33749,UCBPlayer,130,275,405,25,40,UCBPlayer
33750,UCBPlayer,105,210,315,10,65,UCBPlayer
33751,UCBPlayer,130,275,405,25,40,UCBPlayer
33752,UCBPlayer,103,203,306,10,68,UCBPlayer
33753,UCBPlayer,128,283,411,25,38,UCBPlayer
33754,UCBPlayer,111,186,297,10,71,UCBPlayer
33755,UCBPlayer,124,299,423,25,34,UCBPlayer
33756,UCBPlayer,115,170,285,10,75,UCBPlayer
33757,UCBPlayer,120,315,435,25,30,UCBPlayer
33758,UCBPlayer,119,154,273,10,79,UCBPlayer
33759,UCBPlayer,112,332,444,25,27,UCBPlayer
33760,UCBPlayer,127,137,264,10,82,UCBPlayer
33761,UCBPlayer,104,349,453,25,24,UCBPlayer
33762,UCBPlayer,126,126,252,7,85,Tie
33763,UCBPlayer,111,351,462,28,22,UCBPlayer
33764,UCBPlayer,116,126,242,3,87,UCBPlayer
33765,UCBPlayer,122,347,469,32,21,UCBPlayer
33766,UCBPlayer,107,132,239,0,87,UCBPlayer
33767,UCBPlayer,132,337,469,35,22,UCBPlayer
33768,UCBPlayer,103,148,251,0,83,UCBPlayer
33769,UCBPlayer,136,321,457,35,26,UCBPlayer
33770,UCBPlayer,99,164,263,0,79,UCBPlayer
33771,UCBPlayer,140,305,445,35,30,UCBPlayer
33772,UCBPlayer,95,180,275,0,75,UCBPlayer
33773,UCBPlayer,144,289,433,35,34,UCBPlayer
33774,UCBPlayer,91,196,287,0,71,UCBPlayer
33775,UCBPlayer,148,273,421,35,38,UCBPlayer
33776,UCBPlayer,87,212,299,0,67,UCBPlayer
33777,UCBPlayer,152,257,409,35,42,UCBPlayer
33778,UCBPlayer,84,224,308,0,64,UCBPlayer
33779,UCBPlayer,146,251,397,32,45,UCBPlayer
33780,UCBPlayer,89,234,323,3,60,UCBPlayer
33781,UCBPlayer,138,243,381,28,49,UCBPlayer
33782,UCBPlayer,97,242,339,7,56,UCBPlayer
33783,UCBPlayer,130,235,365,24,53,UCBPlayer
33784,UCBPlayer,105,250,355,11,52,UCBPlayer
33785,UCBPlayer,122,227,349,20,57,UCBPlayer
33786,UCBPlayer,109,259,368,15,49,UCBPlayer
33787,UCBPlayer,118,218,336,16,60,UCBPlayer
33788,UCBPlayer,117,267,384,19,45,UCBPlayer
33789,UCBPlayer,110,210,320,12,64,UCBPlayer
33790,UCBPlayer,126,271,397,23,42,UCBPlayer
33791,UCBPlayer,105,210,315,10,65,UCBPlayer
33792,UCBPlayer,130,275,405,25,40,UCBPlayer
33793,UCBPlayer,105,210,315,10,65,UCBPlayer
33794,UCBPlayer,130,275,405,25,40,UCBPlayer
33795,UCBPlayer,106,206,312,10,66,UCBPlayer
33796,UCBPlayer,130,275,405,25,40,UCBPlayer
33797,UCBPlayer,105,210,315,10,65,UCBPlayer
33798,UCBPlayer,131,271,402,25,41,UCBPlayer
33799,UCBPlayer,105,210,315,10,65,UCBPlayer
33800,UCBPlayer,130,275,405,25,40,UCBPlayer
33801,UCBPlayer,105,210,315,10,65,UCBPlayer
33802,UCBPlayer,130,275,405,25,40,UCBPlayer
33803,UCBPlayer,103,203,306,10,68,UCBPlayer
33804,UCBPlayer,128,283,411,25,38,UCBPlayer
33805,UCBPlayer,111,186,297,10,71,UCBPlayer
33806,UCBPlayer,124,299,423,25,34,UCBPlayer
33807,UCBPlayer,115,170,285,10,75,UCBPlayer
33808,UCBPlayer,120,315,435,25,30,UCBPlayer
33809,UCBPlayer,119,154,273,10,79,UCBPlayer
33810,UCBPlayer,112,332,444,25,27,UCBPlayer
33811,UCBPlayer,127,137,264,10,82,UCBPlayer
33812,UCBPlayer,104,349,453,25,24,UCBPlayer
33813,UCBPlayer,126,126,252,7,85,Tie
33814,UCBPlayer,111,351,462,28,22,UCBPlayer
33815,UCBPlayer,116,126,242,3,87,UCBPlayer
33816,UCBPlayer,122,347,469,32,21,UCBPlayer
33817,UCBPlayer,107,132,239,0,87,UCBPlayer
33818,UCBPlayer,132,337,469,35,22,UCBPlayer
33819,UCBPlayer,103,148,251,0,83,UCBPlayer
33820,UCBPlayer,136,321,457,35,26,UCBPlayer
33821,UCBPlayer,99,164,263,0,79,UCBPlayer
33822,UCBPlayer,140,305,445,35,30,UCBPlayer
33823,UCBPlayer,95,180,275,0,75,UCBPlayer
33824,UCBPlayer,144,289,433,35,34,UCBPlayer
33825,UCBPlayer,91,196,287,0,71,UCBPlayer
33826,UCBPlayer,148,273,421,35,38,UCBPlayer
33827,UCBPlayer,87,212,299,0,67,UCBPlayer
33828,UCBPlayer,152,257,409,35,42,UCBPlayer
33829,UCBPlayer,84,224,308,0,64,UCBPlayer
33830,UCBPlayer,146,251,397,32,45,UCBPlayer
33831,UCBPlayer,89,234,323,3,60,UCBPlayer
33832,UCBPlayer,138,243,381,28,49,UCBPlayer
33833,UCBPlayer,97,242,339,7,56,UCBPlayer
33834,UCBPlayer,130,235,365,24,53,UCBPlayer
33835,UCBPlayer,105,250,355,11,52,UCBPlayer
33836,UCBPlayer,122,227,349,20,57,UCBPlayer
33837,UCBPlayer,109,259,368,15,49,UCBPlayer
33838,UCBPlayer,118,218,336,16,60,UCBPlayer
33839,UCBPlayer,117,267,384,19,45,UCBPlayer
33840,UCBPlayer,110,210,320,12,64,UCBPlayer
33841,UCBPlayer,126,271,397,23,42,UCBPlayer
33842,UCBPlayer,105,210,315,10,65,UCBPlayer
33843,UCBPlayer,130,275,405,25,40,UCBPlayer
33844,UCBPlayer,105,210,315,10,65,UCBPlayer
33845,UCBPlayer,130,275,405,25,40,UCBPlayer
33846,UCBPlayer,106,206,312,10,66,UCBPlayer
33847,UCBPlayer,130,275,405,25,40,UCBPlayer
33848,UCBPlayer,105,210,315,10,65,UCBPlayer
33849,UCBPlayer,131,271,402,25,41,UCBPlayer
33850,UCBPlayer,105,210,315,10,65,UCBPlayer
33851,UCBPlayer,130,275,405,25,40,UCBPlayer
33852,UCBPlayer,105,210,315,10,65,UCBPlayer
33853,UCBPlayer,130,275,405,25,40,UCBPlayer
33854,UCBPlayer,103,203,306,10,68,UCBPlayer
33855,UCBPlayer,128,283,411,25,38,UCBPlayer
33856,UCBPlayer,111,186,297,10,71,UCBPlayer
33857,UCBPlayer,124,299,423,25,34,UCBPlayer
33858,UCBPlayer,115,170,285,10,75,UCBPlayer
33859,UCBPlayer,120,315,435,25,30,UCBPlayer
33860,UCBPlayer,119,154,273,10,79,UCBPlayer
33861,UCBPlayer,112,332,444,25,27,UCBPlayer
33862,UCBPlayer,127,137,264,10,82,UCBPlayer
33863,UCBPlayer,104,349,453,25,24,UCBPlayer
33864,UCBPlayer,126,126,252,7,85,Tie
33865,UCBPlayer,111,351,462,28,22,UCBPlayer
33866,UCBPlayer,116,126,242,3,87,UCBPlayer
33867,UCBPlayer,122,347,469,32,21,UCBPlayer
33868,UCBPlayer,107,132,239,0,87,UCBPlayer
33869,UCBPlayer,132,337,469,35,22,UCBPlayer
33870,UCBPlayer,103,148,251,0,83,UCBPlayer
33871,UCBPlayer,136,321,457,35,26,UCBPlayer
33872,UCBPlayer,99,164,263,0,79,UCBPlayer
33873,UCBPlayer,140,305,445,35,30,UCBPlayer
33874,UCBPlayer,95,180,275,0,75,UCBPlayer
33875,UCBPlayer,144,289,433,35,34,UCBPlayer
33876,UCBPlayer,91,196,287,0,71,UCBPlayer
33877,UCBPlayer,148,273,421,35,38,UCBPlayer
33878,UCBPlayer,87,212,299,0,67,UCBPlayer
33879,UCBPlayer,152,257,409,35,42,UCBPlayer
33880,UCBPlayer,84,224,308,0,64,UCBPlayer
33881,UCBPlayer,146,251,397,32,45,UCBPlayer
33882,UCBPlayer,89,234,323,3,60,UCBPlayer
33883,UCBPlayer,138,243,381,28,49,UCBPlayer
33884,UCBPlayer,97,242,339,7,56,UCBPlayer
33885,UCBPlayer,130,235,365,24,53,UCBPlayer
33886,UCBPlayer,105,250,355,11,52,UCBPlayer
33887,UCBPlayer,122,227,349,20,57,UCBPlayer
33888,UCBPlayer,109,259,368,15,49,UCBPlayer
33889,UCBPlayer,118,218,336,16,60,UCBPlayer
33890,UCBPlayer,117,267,384,19,45,UCBPlayer
33891,UCBPlayer,110,210,320,12,64,UCBPlayer
33892,UCBPlayer,126,271,397,23,42,UCBPlayer
33893,UCBPlayer,105,210,315,10,65,UCBPlayer
33894,UCBPlayer,130,275,405,25,40,UCBPlayer
33895,UCBPlayer,105,210,315,10,65,UCBPlayer
33896,UCBPlayer,130,275,405,25,40,UCBPlayer
33897,UCBPlayer,106,206,312,10,66,UCBPlayer
33898,UCBPlayer,130,275,405,25,40,UCBPlayer
33899,UCBPlayer,105,210,315,10,65,UCBPlayer
33900,UCBPlayer,131,271,402,25,41,UCBPlayer
33901,UCBPlayer,105,210,315,10,65,UCBPlayer
33902,UCBPlayer,130,275,405,25,40,UCBPlayer
33903,UCBPlayer,105,210,315,10,65,UCBPlayer
33904,UCBPlayer,130,275,405,25,40,UCBPlayer
33905,UCBPlayer,103,203,306,10,68,UCBPlayer
33906,UCBPlayer,128,283,411,25,38,UCBPlayer
33907,UCBPlayer,111,186,297,10,71,UCBPlayer
33908,UCBPlayer,124,299,423,25,34,UCBPlayer
33909,UCBPlayer,115,170,285,10,75,UCBPlayer
33910,UCBPlayer,120,315,435,25,30,UCBPlayer
33911,UCBPlayer,119,154,273,10,79,UCBPlayer
33912,UCBPlayer,112,332,444,25,27,UCBPlayer
33913,UCBPlayer,127,137,264,10,82,UCBPlayer
33914,UCBPlayer,104,349,453,25,24,UCBPlayer
33915,UCBPlayer,126,126,252,7,85,Tie
33916,UCBPlayer,111,351,462,28,22,UCBPlayer
33917,UCBPlayer,116,126,242,3,87,UCBPlayer
33918,UCBPlayer,122,347,469,32,21,UCBPlayer
33919,UCBPlayer,107,132,239,0,87,UCBPlayer
33920,UCBPlayer,132,337,469,35,22,UCBPlayer
33921,UCBPlayer,103,148,251,0,83,UCBPlayer
33922,UCBPlayer,136,321,457,35,26,UCBPlayer
33923,UCBPlayer,99,164,263,0,79,UCBPlayer
33924,UCBPlayer,140,305,445,35,30,UCBPlayer
33925,UCBPlayer,95,180,275,0,75,UCBPlayer
33926,UCBPlayer,144,289,433,35,34,UCBPlayer
33927,UCBPlayer,91,196,287,0,71,UCBPlayer
33928,UCBPlayer,148,273,421,35,38,UCBPlayer
33929,UCBPlayer,87,212,299,0,67,UCBPlayer
33930,UCBPlayer,152,257,409,35,42,UCBPlayer
33931,UCBPlayer,84,224,308,0,64,UCBPlayer
33932,UCBPlayer,146,251,397,32,45,UCBPlayer
33933,UCBPlayer,89,234,323,3,60,UCBPlayer
33934,UCBPlayer,138,243,381,28,49,UCBPlayer
33935,UCBPlayer,97,242,339,7,56,UCBPlayer
33936,UCBPlayer,130,235,365,24,53,UCBPlayer
33937,UCBPlayer,105,250,355,11,52,UCBPlayer
33938,UCBPlayer,122,227,349,20,57,UCBPlayer
33939,UCBPlayer,109,259,368,15,49,UCBPlayer
33940,UCBPlayer,118,218,336,16,60,UCBPlayer
33941,UCBPlayer,117,267,384,19,45,UCBPlayer
33942,UCBPlayer,110,210,320,12,64,UCBPlayer
33943,UCBPlayer,126,271,397,23,42,UCBPlayer
33944,UCBPlayer,105,210,315,10,65,UCBPlayer
33945,UCBPlayer,130,275,405,25,40,UCBPlayer
33946,UCBPlayer,105,210,315,10,65,UCBPlayer
33947,UCBPlayer,130,275,405,25,40,UCBPlayer
33948,UCBPlayer,106,206,312,10,66,UCBPlayer
33949,UCBPlayer,130,275,405,25,40,UCBPlayer
33950,UCBPlayer,105,210,315,10,65,UCBPlayer
33951,UCBPlayer,131,271,402,25,41,UCBPlayer
33952,UCBPlayer,105,210,315,10,65,UCBPlayer
33953,UCBPlayer,130,275,405,25,40,UCBPlayer
33954,UCBPlayer,105,210,315,10,65,UCBPlayer
33955,UCBPlayer,130,275,405,25,40,UCBPlayer
33956,UCBPlayer,103,203,306,10,68,UCBPlayer
33957,UCBPlayer,128,283,411,25,38,UCBPlayer
33958,UCBPlayer,111,186,297,10,71,UCBPlayer
33959,UCBPlayer,124,299,423,25,34,UCBPlayer
33960,UCBPlayer,115,170,285,10,75,UCBPlayer
33961,UCBPlayer,120,315,435,25,30,UCBPlayer
33962,UCBPlayer,119,154,273,10,79,UCBPlayer
33963,UCBPlayer,112,332,444,25,27,UCBPlayer
33964,UCBPlayer,127,137,264,10,82,UCBPlayer
33965,UCBPlayer,104,349,453,25,24,UCBPlayer
33966,UCBPlayer,126,126,252,7,85,Tie
33967,UCBPlayer,111,351,462,28,22,UCBPlayer
33968,UCBPlayer,116,126,242,3,87,UCBPlayer
33969,UCBPlayer,122,347,469,32,21,UCBPlayer
33970,UCBPlayer,107,132,239,0,87,UCBPlayer
33971,UCBPlayer,132,337,469,35,22,UCBPlayer
33972,UCBPlayer,103,148,251,0,83,UCBPlayer
33973,UCBPlayer,136,321,457,35,26,UCBPlayer
33974,UCBPlayer,99,164,263,0,79,UCBPlayer
33975,UCBPlayer,140,305,445,35,30,UCBPlayer
33976,UCBPlayer,95,180,275,0,75,UCBPlayer
33977,UCBPlayer,144,289,433,35,34,UCBPlayer
33978,UCBPlayer,91,196,287,0,71,UCBPlayer
33979,UCBPlayer,148,273,421,35,38,UCBPlayer
33980,UCBPlayer,87,212,299,0,67,UCBPlayer
33981,UCBPlayer,152,257,409,35,42,UCBPlayer
33982,UCBPlayer,84,224,308,0,64,UCBPlayer
33983,UCBPlayer,146,251,397,32,45,UCBPlayer
33984,UCBPlayer,89,234,323,3,60,UCBPlayer
33985,UCBPlayer,138,243,381,28,49,UCBPlayer
33986,UCBPlayer,97,242,339,7,56,UCBPlayer
33987,UCBPlayer,130,235,365,24,53,UCBPlayer
33988,UCBPlayer,105,250,355,11,52,UCBPlayer
33989,UCBPlayer,122,227,349,20,57,UCBPlayer
33990,UCBPlayer,109,259,368,15,49,UCBPlayer
33991,UCBPlayer,118,218,336,16,60,UCBPlayer
33992,UCBPlayer,117,267,384,19,45,UCBPlayer
33993,UCBPlayer,110,210,320,12,64,UCBPlayer
33994,UCBPlayer,126,271,397,23,42,UCBPlayer
33995,UCBPlayer,105,210,315,10,65,UCBPlayer
33996,UCBPlayer,130,275,405,25,40,UCBPlayer
33997,UCBPlayer,105,210,315,10,65,UCBPlayer
33998,UCBPlayer,130,275,405,25,40,UCBPlayer
33999,UCBPlayer,106,206,312,10,66,UCBPlayer
34000,UCBPlayer,130,275,405,25,40,UCBPlayer
34001,UCBPlayer,105,210,315,10,65,UCBPlayer
34002,UCBPlayer,131,271,402,25,41,UCBPlayer
34003,UCBPlayer,105,210,315,10,65,UCBPlayer
34004,UCBPlayer,130,275,405,25,40,UCBPlayer
34005,UCBPlayer,105,210,315,10,65,UCBPlayer
34006,UCBPlayer,130,275,405,25,40,UCBPlayer
34007,UCBPlayer,103,203,306,10,68,UCBPlayer
34008,UCBPlayer,128,283,411,25,38,UCBPlayer
34009,UCBPlayer,111,186,297,10,71,UCBPlayer
34010,UCBPlayer,124,299,423,25,34,UCBPlayer
34011,UCBPlayer,115,170,285,10,75,UCBPlayer
34012,UCBPlayer,120,315,435,25,30,UCBPlayer
34013,UCBPlayer,119,154,273,10,79,UCBPlayer
34014,UCBPlayer,112,332,444,25,27,UCBPlayer
34015,UCBPlayer,127,137,264,10,82,UCBPlayer
34016,UCBPlayer,104,349,453,25,24,UCBPlayer
34017,UCBPlayer,126,126,252,7,85,Tie
34018,UCBPlayer,111,351,462,28,22,UCBPlayer
34019,UCBPlayer,116,126,242,3,87,UCBPlayer
34020,UCBPlayer,122,347,469,32,21,UCBPlayer
34021,UCBPlayer,107,132,239,0,87,UCBPlayer
34022,UCBPlayer,132,337,469,35,22,UCBPlayer
34023,UCBPlayer,103,148,251,0,83,UCBPlayer
34024,UCBPlayer,136,321,457,35,26,UCBPlayer
34025,UCBPlayer,99,164,263,0,79,UCBPlayer
34026,UCBPlayer,140,305,445,35,30,UCBPlayer
34027,UCBPlayer,95,180,275,0,75,UCBPlayer
34028,UCBPlayer,144,289,433,35,34,UCBPlayer
34029,UCBPlayer,91,196,287,0,71,UCBPlayer
34030,UCBPlayer,148,273,421,35,38,UCBPlayer
34031,UCBPlayer,87,212,299,0,67,UCBPlayer
34032,UCBPlayer,152,257,409,35,42,UCBPlayer
34033,UCBPlayer,84,224,308,0,64,UCBPlayer
34034,UCBPlayer,146,251,397,32,45,UCBPlayer
34035,UCBPlayer,89,234,323,3,60,UCBPlayer
34036,UCBPlayer,138,243,381,28,49,UCBPlayer
34037,UCBPlayer,97,242,339,7,56,UCBPlayer
34038,UCBPlayer,130,235,365,24,53,UCBPlayer
34039,UCBPlayer,105,250,355,11,52,UCBPlayer
34040,UCBPlayer,122,227,349,20,57,UCBPlayer
34041,UCBPlayer,109,259,368,15,49,UCBPlayer
34042,UCBPlayer,118,218,336,16,60,UCBPlayer
34043,UCBPlayer,117,267,384,19,45,UCBPlayer
34044,UCBPlayer,110,210,320,12,64,UCBPlayer
34045,UCBPlayer,126,271,397,23,42,UCBPlayer
34046,UCBPlayer,105,210,315,10,65,UCBPlayer
34047,UCBPlayer,130,275,405,25,40,UCBPlayer
34048,UCBPlayer,105,210,315,10,65,UCBPlayer
34049,UCBPlayer,130,275,405,25,40,UCBPlayer
34050,UCBPlayer,106,206,312,10,66,UCBPlayer
34051,UCBPlayer,130,275,405,25,40,UCBPlayer
34052,UCBPlayer,105,210,315,10,65,UCBPlayer
34053,UCBPlayer,131,271,402,25,41,UCBPlayer
34054,UCBPlayer,105,210,315,10,65,UCBPlayer
34055,UCBPlayer,130,275,405,25,40,UCBPlayer
34056,UCBPlayer,105,210,315,10,65,UCBPlayer
34057,UCBPlayer,130,275,405,25,40,UCBPlayer
34058,UCBPlayer,103,203,306,10,68,UCBPlayer
34059,UCBPlayer,128,283,411,25,38,UCBPlayer
34060,UCBPlayer,111,186,297,10,71,UCBPlayer
34061,UCBPlayer,124,299,423,25,34,UCBPlayer
34062,UCBPlayer,115,170,285,10,75,UCBPlayer
34063,UCBPlayer,120,315,435,25,30,UCBPlayer
34064,UCBPlayer,119,154,273,10,79,UCBPlayer
34065,UCBPlayer,112,332,444,25,27,UCBPlayer
34066,UCBPlayer,127,137,264,10,82,UCBPlayer
34067,UCBPlayer,104,349,453,25,24,UCBPlayer
34068,UCBPlayer,126,126,252,7,85,Tie
34069,UCBPlayer,111,351,462,28,22,UCBPlayer
34070,UCBPlayer,116,126,242,3,87,UCBPlayer
34071,UCBPlayer,122,347,469,32,21,UCBPlayer
34072,UCBPlayer,107,132,239,0,87,UCBPlayer
34073,UCBPlayer,132,337,469,35,22,UCBPlayer
34074,UCBPlayer,103,148,251,0,83,UCBPlayer
34075,UCBPlayer,136,321,457,35,26,UCBPlayer
34076,UCBPlayer,99,164,263,0,79,UCBPlayer
34077,UCBPlayer,140,305,445,35,30,UCBPlayer
34078,UCBPlayer,95,180,275,0,75,UCBPlayer
34079,UCBPlayer,144,289,433,35,34,UCBPlayer
34080,UCBPlayer,91,196,287,0,71,UCBPlayer
34081,UCBPlayer,148,273,421,35,38,UCBPlayer
34082,UCBPlayer,87,212,299,0,67,UCBPlayer
34083,UCBPlayer,152,257,409,35,42,UCBPlayer
34084,UCBPlayer,84,224,308,0,64,UCBPlayer
34085,UCBPlayer,146,251,397,32,45,UCBPlayer
34086,UCBPlayer,89,234,323,3,60,UCBPlayer
34087,UCBPlayer,138,243,381,28,49,UCBPlayer
34088,UCBPlayer,97,242,339,7,56,UCBPlayer
34089,UCBPlayer,130,235,365,24,53,UCBPlayer
34090,UCBPlayer,105,250,355,11,52,UCBPlayer
34091,UCBPlayer,122,227,349,20,57,UCBPlayer
34092,UCBPlayer,109,259,368,15,49,UCBPlayer
34093,UCBPlayer,118,218,336,16,60,UCBPlayer
34094,UCBPlayer,117,267,384,19,45,UCBPlayer
34095,UCBPlayer,110,210,320,12,64,UCBPlayer
34096,UCBPlayer,126,271,397,23,42,UCBPlayer
34097,UCBPlayer,105,210,315,10,65,UCBPlayer
34098,UCBPlayer,130,275,405,25,40,UCBPlayer
34099,UCBPlayer,105,210,315,10,65,UCBPlayer
34100,UCBPlayer,130,275,405,25,40,UCBPlayer
34101,UCBPlayer,106,206,312,10,66,UCBPlayer
34102,UCBPlayer,130,275,405,25,40,UCBPlayer
34103,UCBPlayer,105,210,315,10,65,UCBPlayer
34104,UCBPlayer,131,271,402,25,41,UCBPlayer
34105,UCBPlayer,105,210,315,10,65,UCBPlayer
34106,UCBPlayer,130,275,405,25,40,UCBPlayer
34107,UCBPlayer,105,210,315,10,65,UCBPlayer
34108,UCBPlayer,130,275,405,25,40,UCBPlayer
34109,UCBPlayer,103,203,306,10,68,UCBPlayer
34110,UCBPlayer,128,283,411,25,38,UCBPlayer
34111,UCBPlayer,111,186,297,10,71,UCBPlayer
34112,UCBPlayer,124,299,423,25,34,UCBPlayer
34113,UCBPlayer,115,170,285,10,75,UCBPlayer
34114,UCBPlayer,120,315,435,25,30,UCBPlayer
34115,UCBPlayer,119,154,273,10,79,UCBPlayer
34116,UCBPlayer,112,332,444,25,27,UCBPlayer
34117,UCBPlayer,127,137,264,10,82,UCBPlayer
34118,UCBPlayer,104,349,453,25,24,UCBPlayer
34119,UCBPlayer,126,126,252,7,85,Tie
34120,UCBPlayer,111,351,462,28,22,UCBPlayer
34121,UCBPlayer,116,126,242,3,87,UCBPlayer
34122,UCBPlayer,122,347,469,32,21,UCBPlayer
34123,UCBPlayer,107,132,239,0,87,UCBPlayer
34124,UCBPlayer,132,337,469,35,22,UCBPlayer
34125,UCBPlayer,103,148,251,0,83,UCBPlayer
34126,UCBPlayer,136,321,457,35,26,UCBPlayer
34127,UCBPlayer,99,164,263,0,79,UCBPlayer
34128,UCBPlayer,140,305,445,35,30,UCBPlayer
34129,UCBPlayer,95,180,275,0,75,UCBPlayer
34130,UCBPlayer,144,289,433,35,34,UCBPlayer
34131,UCBPlayer,91,196,287,0,71,UCBPlayer
34132,UCBPlayer,148,273,421,35,38,UCBPlayer
34133,UCBPlayer,87,212,299,0,67,UCBPlayer
34134,UCBPlayer,152,257,409,35,42,UCBPlayer
34135,UCBPlayer,84,224,308,0,64,UCBPlayer
34136,UCBPlayer,146,251,397,32,45,UCBPlayer
34137,UCBPlayer,89,234,323,3,60,UCBPlayer
34138,UCBPlayer,138,243,381,28,49,UCBPlayer
34139,UCBPlayer,97,242,339,7,56,UCBPlayer
34140,UCBPlayer,130,235,365,24,53,UCBPlayer
34141,UCBPlayer,105,250,355,11,52,UCBPlayer
34142,UCBPlayer,122,227,349,20,57,UCBPlayer
34143,UCBPlayer,109,259,368,15,49,UCBPlayer
34144,UCBPlayer,118,218,336,16,60,UCBPlayer
34145,UCBPlayer,117,267,384,19,45,UCBPlayer
34146,UCBPlayer,110,210,320,12,64,UCBPlayer
34147,UCBPlayer,126,271,397,23,42,UCBPlayer
34148,UCBPlayer,105,210,315,10,65,UCBPlayer
34149,UCBPlayer,130,275,405,25,40,UCBPlayer
34150,UCBPlayer,105,210,315,10,65,UCBPlayer
34151,UCBPlayer,130,275,405,25,40,UCBPlayer
34152,UCBPlayer,106,206,312,10,66,UCBPlayer
34153,UCBPlayer,130,275,405,25,40,UCBPlayer
34154,UCBPlayer,105,210,315,10,65,UCBPlayer
34155,UCBPlayer,131,271,402,25,41,UCBPlayer
34156,UCBPlayer,105,210,315,10,65,UCBPlayer
34157,UCBPlayer,130,275,405,25,40,UCBPlayer
34158,UCBPlayer,105,210,315,10,65,UCBPlayer
34159,UCBPlayer,130,275,405,25,40,UCBPlayer
34160,UCBPlayer,103,203,306,10,68,UCBPlayer
34161,UCBPlayer,128,283,411,25,38,UCBPlayer
34162,UCBPlayer,111,186,297,10,71,UCBPlayer
34163,UCBPlayer,124,299,423,25,34,UCBPlayer
34164,UCBPlayer,115,170,285,10,75,UCBPlayer
34165,UCBPlayer,120,315,435,25,30,UCBPlayer
34166,UCBPlayer,119,154,273,10,79,UCBPlayer
34167,UCBPlayer,112,332,444,25,27,UCBPlayer
34168,UCBPlayer,127,137,264,10,82,UCBPlayer
34169,UCBPlayer,104,349,453,25,24,UCBPlayer
34170,UCBPlayer,126,126,252,7,85,Tie
34171,UCBPlayer,111,351,462,28,22,UCBPlayer
34172,UCBPlayer,116,126,242,3,87,UCBPlayer
34173,UCBPlayer,122,347,469,32,21,UCBPlayer
34174,UCBPlayer,107,132,239,0,87,UCBPlayer
34175,UCBPlayer,132,337,469,35,22,UCBPlayer
34176,UCBPlayer,103,148,251,0,83,UCBPlayer
34177,UCBPlayer,136,321,457,35,26,UCBPlayer
34178,UCBPlayer,99,164,263,0,79,UCBPlayer
34179,UCBPlayer,140,305,445,35,30,UCBPlayer
34180,UCBPlayer,95,180,275,0,75,UCBPlayer
34181,UCBPlayer,144,289,433,35,34,UCBPlayer
34182,UCBPlayer,91,196,287,0,71,UCBPlayer
34183,UCBPlayer,148,273,421,35,38,UCBPlayer
34184,UCBPlayer,87,212,299,0,67,UCBPlayer
34185,UCBPlayer,152,257,409,35,42,UCBPlayer
34186,UCBPlayer,84,224,308,0,64,UCBPlayer
34187,UCBPlayer,146,251,397,32,45,UCBPlayer
34188,UCBPlayer,89,234,323,3,60,UCBPlayer
34189,UCBPlayer,138,243,381,28,49,UCBPlayer
34190,UCBPlayer,97,242,339,7,56,UCBPlayer
34191,UCBPlayer,130,235,365,24,53,UCBPlayer
34192,UCBPlayer,105,250,355,11,52,UCBPlayer
34193,UCBPlayer,122,227,349,20,57,UCBPlayer
34194,UCBPlayer,109,259,368,15,49,UCBPlayer
34195,UCBPlayer,118,218,336,16,60,UCBPlayer
34196,UCBPlayer,117,267,384,19,45,UCBPlayer
34197,UCBPlayer,110,210,320,12,64,UCBPlayer
34198,UCBPlayer,126,271,397,23,42,UCBPlayer
34199,UCBPlayer,105,210,315,10,65,UCBPlayer
34200,UCBPlayer,130,275,405,25,40,UCBPlayer
34201,UCBPlayer,105,210,315,10,65,UCBPlayer
34202,UCBPlayer,130,275,405,25,40,UCBPlayer
34203,UCBPlayer,106,206,312,10,66,UCBPlayer
34204,UCBPlayer,130,275,405,25,40,UCBPlayer
34205,UCBPlayer,105,210,315,10,65,UCBPlayer
34206,UCBPlayer,131,271,402,25,41,UCBPlayer
34207,UCBPlayer,105,210,315,10,65,UCBPlayer
34208,UCBPlayer,130,275,405,25,40,UCBPlayer
34209,UCBPlayer,105,210,315,10,65,UCBPlayer
34210,UCBPlayer,130,275,405,25,40,UCBPlayer
34211,UCBPlayer,103,203,306,10,68,UCBPlayer
34212,UCBPlayer,128,283,411,25,38,UCBPlayer
34213,UCBPlayer,111,186,297,10,71,UCBPlayer
34214,UCBPlayer,124,299,423,25,34,UCBPlayer
34215,UCBPlayer,115,170,285,10,75,UCBPlayer
34216,UCBPlayer,120,315,435,25,30,UCBPlayer
34217,UCBPlayer,119,154,273,10,79,UCBPlayer
34218,UCBPlayer,112,332,444,25,27,UCBPlayer
34219,UCBPlayer,127,137,264,10,82,UCBPlayer
34220,UCBPlayer,104,349,453,25,24,UCBPlayer
34221,UCBPlayer,126,126,252,7,85,Tie
34222,UCBPlayer,111,351,462,28,22,UCBPlayer
34223,UCBPlayer,116,126,242,3,87,UCBPlayer
34224,UCBPlayer,122,347,469,32,21,UCBPlayer
34225,UCBPlayer,107,132,239,0,87,UCBPlayer
34226,UCBPlayer,132,337,469,35,22,UCBPlayer
34227,UCBPlayer,103,148,251,0,83,UCBPlayer
34228,UCBPlayer,136,321,457,35,26,UCBPlayer
34229,UCBPlayer,99,164,263,0,79,UCBPlayer
34230,UCBPlayer,140,305,445,35,30,UCBPlayer
34231,UCBPlayer,95,180,275,0,75,UCBPlayer
34232,UCBPlayer,144,289,433,35,34,UCBPlayer
34233,UCBPlayer,91,196,287,0,71,UCBPlayer
34234,UCBPlayer,148,273,421,35,38,UCBPlayer
34235,UCBPlayer,87,212,299,0,67,UCBPlayer
34236,UCBPlayer,152,257,409,35,42,UCBPlayer
34237,UCBPlayer,84,224,308,0,64,UCBPlayer
34238,UCBPlayer,146,251,397,32,45,UCBPlayer
34239,UCBPlayer,89,234,323,3,60,UCBPlayer
34240,UCBPlayer,138,243,381,28,49,UCBPlayer
34241,UCBPlayer,97,242,339,7,56,UCBPlayer
34242,UCBPlayer,130,235,365,24,53,UCBPlayer
34243,UCBPlayer,105,250,355,11,52,UCBPlayer
34244,UCBPlayer,122,227,349,20,57,UCBPlayer
34245,UCBPlayer,109,259,368,15,49,UCBPlayer
34246,UCBPlayer,118,218,336,16,60,UCBPlayer
34247,UCBPlayer,117,267,384,19,45,UCBPlayer
34248,UCBPlayer,110,210,320,12,64,UCBPlayer
34249,UCBPlayer,126,271,397,23,42,UCBPlayer
34250,UCBPlayer,105,210,315,10,65,UCBPlayer
34251,UCBPlayer,130,275,405,25,40,UCBPlayer
34252,UCBPlayer,105,210,315,10,65,UCBPlayer
34253,UCBPlayer,130,275,405,25,40,UCBPlayer
34254,UCBPlayer,106,206,312,10,66,UCBPlayer
34255,UCBPlayer,130,275,405,25,40,UCBPlayer
34256,UCBPlayer,105,210,315,10,65,UCBPlayer
34257,UCBPlayer,131,271,402,25,41,UCBPlayer
34258,UCBPlayer,105,210,315,10,65,UCBPlayer
34259,UCBPlayer,130,275,405,25,40,UCBPlayer
34260,UCBPlayer,105,210,315,10,65,UCBPlayer
34261,UCBPlayer,130,275,405,25,40,UCBPlayer
34262,UCBPlayer,103,203,306,10,68,UCBPlayer
34263,UCBPlayer,128,283,411,25,38,UCBPlayer
34264,UCBPlayer,111,186,297,10,71,UCBPlayer
34265,UCBPlayer,124,299,423,25,34,UCBPlayer
34266,UCBPlayer,115,170,285,10,75,UCBPlayer
34267,UCBPlayer,120,315,435,25,30,UCBPlayer
34268,UCBPlayer,119,154,273,10,79,UCBPlayer
34269,UCBPlayer,112,332,444,25,27,UCBPlayer
34270,UCBPlayer,127,137,264,10,82,UCBPlayer
34271,UCBPlayer,104,349,453,25,24,UCBPlayer
34272,UCBPlayer,126,126,252,7,85,Tie
34273,UCBPlayer,111,351,462,28,22,UCBPlayer
34274,UCBPlayer,116,126,242,3,87,UCBPlayer
34275,UCBPlayer,122,347,469,32,21,UCBPlayer
34276,UCBPlayer,107,132,239,0,87,UCBPlayer
34277,UCBPlayer,132,337,469,35,22,UCBPlayer
34278,UCBPlayer,103,148,251,0,83,UCBPlayer
34279,UCBPlayer,136,321,457,35,26,UCBPlayer
34280,UCBPlayer,99,164,263,0,79,UCBPlayer
34281,UCBPlayer,140,305,445,35,30,UCBPlayer
34282,UCBPlayer,95,180,275,0,75,UCBPlayer
34283,UCBPlayer,144,289,433,35,34,UCBPlayer
34284,UCBPlayer,91,196,287,0,71,UCBPlayer
34285,UCBPlayer,148,273,421,35,38,UCBPlayer
34286,UCBPlayer,87,212,299,0,67,UCBPlayer
34287,UCBPlayer,152,257,409,35,42,UCBPlayer
34288,UCBPlayer,84,224,308,0,64,UCBPlayer
34289,UCBPlayer,146,251,397,32,45,UCBPlayer
34290,UCBPlayer,89,234,323,3,60,UCBPlayer
34291,UCBPlayer,138,243,381,28,49,UCBPlayer
34292,UCBPlayer,97,242,339,7,56,UCBPlayer
34293,UCBPlayer,130,235,365,24,53,UCBPlayer
34294,UCBPlayer,105,250,355,11,52,UCBPlayer
34295,UCBPlayer,122,227,349,20,57,UCBPlayer
34296,UCBPlayer,109,259,368,15,49,UCBPlayer
34297,UCBPlayer,118,218,336,16,60,UCBPlayer
34298,UCBPlayer,117,267,384,19,45,UCBPlayer
34299,UCBPlayer,110,210,320,12,64,UCBPlayer
34300,UCBPlayer,126,271,397,23,42,UCBPlayer
34301,UCBPlayer,105,210,315,10,65,UCBPlayer
34302,UCBPlayer,130,275,405,25,40,UCBPlayer
34303,UCBPlayer,105,210,315,10,65,UCBPlayer
34304,UCBPlayer,130,275,405,25,40,UCBPlayer
34305,UCBPlayer,106,206,312,10,66,UCBPlayer
34306,UCBPlayer,130,275,405,25,40,UCBPlayer
34307,UCBPlayer,105,210,315,10,65,UCBPlayer
34308,UCBPlayer,131,271,402,25,41,UCBPlayer
34309,UCBPlayer,105,210,315,10,65,UCBPlayer
34310,UCBPlayer,130,275,405,25,40,UCBPlayer
34311,UCBPlayer,105,210,315,10,65,UCBPlayer
34312,UCBPlayer,130,275,405,25,40,UCBPlayer
34313,UCBPlayer,103,203,306,10,68,UCBPlayer
34314,UCBPlayer,128,283,411,25,38,UCBPlayer
34315,UCBPlayer,111,186,297,10,71,UCBPlayer
34316,UCBPlayer,124,299,423,25,34,UCBPlayer
34317,UCBPlayer,115,170,285,10,75,UCBPlayer
34318,UCBPlayer,120,315,435,25,30,UCBPlayer
34319,UCBPlayer,119,154,273,10,79,UCBPlayer
34320,UCBPlayer,112,332,444,25,27,UCBPlayer
34321,UCBPlayer,127,137,264,10,82,UCBPlayer
34322,UCBPlayer,104,349,453,25,24,UCBPlayer
34323,UCBPlayer,126,126,252,7,85,Tie
34324,UCBPlayer,111,351,462,28,22,UCBPlayer
34325,UCBPlayer,116,126,242,3,87,UCBPlayer
34326,UCBPlayer,122,347,469,32,21,UCBPlayer
34327,UCBPlayer,107,132,239,0,87,UCBPlayer
34328,UCBPlayer,132,337,469,35,22,UCBPlayer
34329,UCBPlayer,103,148,251,0,83,UCBPlayer
34330,UCBPlayer,136,321,457,35,26,UCBPlayer
34331,UCBPlayer,99,164,263,0,79,UCBPlayer
34332,UCBPlayer,140,305,445,35,30,UCBPlayer
34333,UCBPlayer,95,180,275,0,75,UCBPlayer
34334,UCBPlayer,144,289,433,35,34,UCBPlayer
34335,UCBPlayer,91,196,287,0,71,UCBPlayer
34336,UCBPlayer,148,273,421,35,38,UCBPlayer
34337,UCBPlayer,87,212,299,0,67,UCBPlayer
34338,UCBPlayer,152,257,409,35,42,UCBPlayer
34339,UCBPlayer,84,224,308,0,64,UCBPlayer
34340,UCBPlayer,146,251,397,32,45,UCBPlayer
34341,UCBPlayer,89,234,323,3,60,UCBPlayer
34342,UCBPlayer,138,243,381,28,49,UCBPlayer
34343,UCBPlayer,97,242,339,7,56,UCBPlayer
34344,UCBPlayer,130,235,365,24,53,UCBPlayer
34345,UCBPlayer,105,250,355,11,52,UCBPlayer
34346,UCBPlayer,122,227,349,20,57,UCBPlayer
34347,UCBPlayer,109,259,368,15,49,UCBPlayer
34348,UCBPlayer,118,218,336,16,60,UCBPlayer
34349,UCBPlayer,117,267,384,19,45,UCBPlayer
34350,UCBPlayer,110,210,320,12,64,UCBPlayer
34351,UCBPlayer,126,271,397,23,42,UCBPlayer
34352,UCBPlayer,105,210,315,10,65,UCBPlayer
34353,UCBPlayer,130,275,405,25,40,UCBPlayer
34354,UCBPlayer,105,210,315,10,65,UCBPlayer
34355,UCBPlayer,130,275,405,25,40,UCBPlayer
34356,UCBPlayer,106,206,312,10,66,UCBPlayer
34357,UCBPlayer,130,275,405,25,40,UCBPlayer
34358,UCBPlayer,105,210,315,10,65,UCBPlayer
34359,UCBPlayer,131,271,402,25,41,UCBPlayer
34360,UCBPlayer,105,210,315,10,65,UCBPlayer
34361,UCBPlayer,130,275,405,25,40,UCBPlayer
34362,UCBPlayer,105,210,315,10,65,UCBPlayer
34363,UCBPlayer,130,275,405,25,40,UCBPlayer
34364,UCBPlayer,103,203,306,10,68,UCBPlayer
34365,UCBPlayer,128,283,411,25,38,UCBPlayer
34366,UCBPlayer,111,186,297,10,71,UCBPlayer
34367,UCBPlayer,124,299,423,25,34,UCBPlayer
34368,UCBPlayer,115,170,285,10,75,UCBPlayer
34369,UCBPlayer,120,315,435,25,30,UCBPlayer
34370,UCBPlayer,119,154,273,10,79,UCBPlayer
34371,UCBPlayer,112,332,444,25,27,UCBPlayer
34372,UCBPlayer,127,137,264,10,82,UCBPlayer
34373,UCBPlayer,104,349,453,25,24,UCBPlayer
34374,UCBPlayer,126,126,252,7,85,Tie
34375,UCBPlayer,111,351,462,28,22,UCBPlayer
34376,UCBPlayer,116,126,242,3,87,UCBPlayer
34377,UCBPlayer,122,347,469,32,21,UCBPlayer
34378,UCBPlayer,107,132,239,0,87,UCBPlayer
34379,UCBPlayer,132,337,469,35,22,UCBPlayer
34380,UCBPlayer,103,148,251,0,83,UCBPlayer
34381,UCBPlayer,136,321,457,35,26,UCBPlayer
34382,UCBPlayer,99,164,263,0,79,UCBPlayer
34383,UCBPlayer,140,305,445,35,30,UCBPlayer
34384,UCBPlayer,95,180,275,0,75,UCBPlayer
34385,UCBPlayer,144,289,433,35,34,UCBPlayer
34386,UCBPlayer,91,196,287,0,71,UCBPlayer
34387,UCBPlayer,148,273,421,35,38,UCBPlayer
34388,UCBPlayer,87,212,299,0,67,UCBPlayer
34389,UCBPlayer,152,257,409,35,42,UCBPlayer
34390,UCBPlayer,84,224,308,0,64,UCBPlayer
34391,UCBPlayer,146,251,397,32,45,UCBPlayer
34392,UCBPlayer,89,234,323,3,60,UCBPlayer
34393,UCBPlayer,138,243,381,28,49,UCBPlayer
34394,UCBPlayer,97,242,339,7,56,UCBPlayer
34395,UCBPlayer,130,235,365,24,53,UCBPlayer
34396,UCBPlayer,105,250,355,11,52,UCBPlayer
34397,UCBPlayer,122,227,349,20,57,UCBPlayer
34398,UCBPlayer,109,259,368,15,49,UCBPlayer
34399,UCBPlayer,118,218,336,16,60,UCBPlayer
34400,UCBPlayer,117,267,384,19,45,UCBPlayer
34401,UCBPlayer,110,210,320,12,64,UCBPlayer
34402,UCBPlayer,126,271,397,23,42,UCBPlayer
34403,UCBPlayer,105,210,315,10,65,UCBPlayer
34404,UCBPlayer,130,275,405,25,40,UCBPlayer
34405,UCBPlayer,105,210,315,10,65,UCBPlayer
34406,UCBPlayer,130,275,405,25,40,UCBPlayer
34407,UCBPlayer,106,206,312,10,66,UCBPlayer
34408,UCBPlayer,130,275,405,25,40,UCBPlayer
34409,UCBPlayer,105,210,315,10,65,UCBPlayer
34410,UCBPlayer,131,271,402,25,41,UCBPlayer
34411,UCBPlayer,105,210,315,10,65,UCBPlayer
34412,UCBPlayer,130,275,405,25,40,UCBPlayer
34413,UCBPlayer,105,210,315,10,65,UCBPlayer
34414,UCBPlayer,130,275,405,25,40,UCBPlayer
34415,UCBPlayer,103,203,306,10,68,UCBPlayer
34416,UCBPlayer,128,283,411,25,38,UCBPlayer
34417,UCBPlayer,111,186,297,10,71,UCBPlayer
34418,UCBPlayer,124,299,423,25,34,UCBPlayer
34419,UCBPlayer,115,170,285,10,75,UCBPlayer
34420,UCBPlayer,120,315,435,25,30,UCBPlayer
34421,UCBPlayer,119,154,273,10,79,UCBPlayer
34422,UCBPlayer,112,332,444,25,27,UCBPlayer
34423,UCBPlayer,127,137,264,10,82,UCBPlayer
34424,UCBPlayer,104,349,453,25,24,UCBPlayer
34425,UCBPlayer,126,126,252,7,85,Tie
34426,UCBPlayer,111,351,462,28,22,UCBPlayer
34427,UCBPlayer,116,126,242,3,87,UCBPlayer
34428,UCBPlayer,122,347,469,32,21,UCBPlayer
34429,UCBPlayer,107,132,239,0,87,UCBPlayer
34430,UCBPlayer,132,337,469,35,22,UCBPlayer
34431,UCBPlayer,103,148,251,0,83,UCBPlayer
34432,UCBPlayer,136,321,457,35,26,UCBPlayer
34433,UCBPlayer,99,164,263,0,79,UCBPlayer
34434,UCBPlayer,140,305,445,35,30,UCBPlayer
34435,UCBPlayer,95,180,275,0,75,UCBPlayer
34436,UCBPlayer,144,289,433,35,34,UCBPlayer
34437,UCBPlayer,91,196,287,0,71,UCBPlayer
34438,UCBPlayer,148,273,421,35,38,UCBPlayer
34439,UCBPlayer,87,212,299,0,67,UCBPlayer
34440,UCBPlayer,152,257,409,35,42,UCBPlayer
34441,UCBPlayer,84,224,308,0,64,UCBPlayer
34442,UCBPlayer,146,251,397,32,45,UCBPlayer
34443,UCBPlayer,89,234,323,3,60,UCBPlayer
34444,UCBPlayer,138,243,381,28,49,UCBPlayer
34445,UCBPlayer,97,242,339,7,56,UCBPlayer
34446,UCBPlayer,130,235,365,24,53,UCBPlayer
34447,UCBPlayer,105,250,355,11,52,UCBPlayer
34448,UCBPlayer,122,227,349,20,57,UCBPlayer
34449,UCBPlayer,109,259,368,15,49,UCBPlayer
34450,UCBPlayer,118,218,336,16,60,UCBPlayer
34451,UCBPlayer,117,267,384,19,45,UCBPlayer
34452,UCBPlayer,110,210,320,12,64,UCBPlayer
34453,UCBPlayer,126,271,397,23,42,UCBPlayer
34454,UCBPlayer,105,210,315,10,65,UCBPlayer
34455,UCBPlayer,130,275,405,25,40,UCBPlayer
34456,UCBPlayer,105,210,315,10,65,UCBPlayer
34457,UCBPlayer,130,275,405,25,40,UCBPlayer
34458,UCBPlayer,106,206,312,10,66,UCBPlayer
34459,UCBPlayer,130,275,405,25,40,UCBPlayer
34460,UCBPlayer,105,210,315,10,65,UCBPlayer
34461,UCBPlayer,131,271,402,25,41,UCBPlayer
34462,UCBPlayer,105,210,315,10,65,UCBPlayer
34463,UCBPlayer,130,275,405,25,40,UCBPlayer
34464,UCBPlayer,105,210,315,10,65,UCBPlayer
34465,UCBPlayer,130,275,405,25,40,UCBPlayer
34466,UCBPlayer,103,203,306,10,68,UCBPlayer
34467,UCBPlayer,128,283,411,25,38,UCBPlayer
34468,UCBPlayer,111,186,297,10,71,UCBPlayer
34469,UCBPlayer,124,299,423,25,34,UCBPlayer
34470,UCBPlayer,115,170,285,10,75,UCBPlayer
34471,UCBPlayer,120,315,435,25,30,UCBPlayer
34472,UCBPlayer,119,154,273,10,79,UCBPlayer
34473,UCBPlayer,112,332,444,25,27,UCBPlayer
34474,UCBPlayer,127,137,264,10,82,UCBPlayer
34475,UCBPlayer,104,349,453,25,24,UCBPlayer
34476,UCBPlayer,126,126,252,7,85,Tie
34477,UCBPlayer,111,351,462,28,22,UCBPlayer
34478,UCBPlayer,116,126,242,3,87,UCBPlayer
34479,UCBPlayer,122,347,469,32,21,UCBPlayer
34480,UCBPlayer,107,132,239,0,87,UCBPlayer
34481,UCBPlayer,132,337,469,35,22,UCBPlayer
34482,UCBPlayer,103,148,251,0,83,UCBPlayer
34483,UCBPlayer,136,321,457,35,26,UCBPlayer
34484,UCBPlayer,99,164,263,0,79,UCBPlayer
34485,UCBPlayer,140,305,445,35,30,UCBPlayer
34486,UCBPlayer,95,180,275,0,75,UCBPlayer
34487,UCBPlayer,144,289,433,35,34,UCBPlayer
34488,UCBPlayer,91,196,287,0,71,UCBPlayer
34489,UCBPlayer,148,273,421,35,38,UCBPlayer
34490,UCBPlayer,87,212,299,0,67,UCBPlayer
34491,UCBPlayer,152,257,409,35,42,UCBPlayer
34492,UCBPlayer,84,224,308,0,64,UCBPlayer
34493,UCBPlayer,146,251,397,32,45,UCBPlayer
34494,UCBPlayer,89,234,323,3,60,UCBPlayer
34495,UCBPlayer,138,243,381,28,49,UCBPlayer
34496,UCBPlayer,97,242,339,7,56,UCBPlayer
34497,UCBPlayer,130,235,365,24,53,UCBPlayer
34498,UCBPlayer,105,250,355,11,52,UCBPlayer
34499,UCBPlayer,122,227,349,20,57,UCBPlayer
34500,UCBPlayer,109,259,368,15,49,UCBPlayer
34501,UCBPlayer,118,218,336,16,60,UCBPlayer
34502,UCBPlayer,117,267,384,19,45,UCBPlayer
34503,UCBPlayer,110,210,320,12,64,UCBPlayer
34504,UCBPlayer,126,271,397,23,42,UCBPlayer
34505,UCBPlayer,105,210,315,10,65,UCBPlayer
34506,UCBPlayer,130,275,405,25,40,UCBPlayer
34507,UCBPlayer,105,210,315,10,65,UCBPlayer
34508,UCBPlayer,130,275,405,25,40,UCBPlayer
34509,UCBPlayer,106,206,312,10,66,UCBPlayer
34510,UCBPlayer,130,275,405,25,40,UCBPlayer
34511,UCBPlayer,105,210,315,10,65,UCBPlayer
34512,UCBPlayer,131,271,402,25,41,UCBPlayer
34513,UCBPlayer,105,210,315,10,65,UCBPlayer
34514,UCBPlayer,130,275,405,25,40,UCBPlayer
34515,UCBPlayer,105,210,315,10,65,UCBPlayer
34516,UCBPlayer,130,275,405,25,40,UCBPlayer
34517,UCBPlayer,103,203,306,10,68,UCBPlayer
34518,UCBPlayer,128,283,411,25,38,UCBPlayer
34519,UCBPlayer,111,186,297,10,71,UCBPlayer
34520,UCBPlayer,124,299,423,25,34,UCBPlayer
34521,UCBPlayer,115,170,285,10,75,UCBPlayer
34522,UCBPlayer,120,315,435,25,30,UCBPlayer
34523,UCBPlayer,119,154,273,10,79,UCBPlayer
34524,UCBPlayer,112,332,444,25,27,UCBPlayer
34525,UCBPlayer,127,137,264,10,82,UCBPlayer
34526,UCBPlayer,104,349,453,25,24,UCBPlayer
34527,UCBPlayer,126,126,252,7,85,Tie
34528,UCBPlayer,111,351,462,28,22,UCBPlayer
34529,UCBPlayer,116,126,242,3,87,UCBPlayer
34530,UCBPlayer,122,347,469,32,21,UCBPlayer
34531,UCBPlayer,107,132,239,0,87,UCBPlayer
34532,UCBPlayer,132,337,469,35,22,UCBPlayer
34533,UCBPlayer,103,148,251,0,83,UCBPlayer
34534,UCBPlayer,136,321,457,35,26,UCBPlayer
34535,UCBPlayer,99,164,263,0,79,UCBPlayer
34536,UCBPlayer,140,305,445,35,30,UCBPlayer
34537,UCBPlayer,95,180,275,0,75,UCBPlayer
34538,UCBPlayer,144,289,433,35,34,UCBPlayer
34539,UCBPlayer,91,196,287,0,71,UCBPlayer
34540,UCBPlayer,148,273,421,35,38,UCBPlayer
34541,UCBPlayer,87,212,299,0,67,UCBPlayer
34542,UCBPlayer,152,257,409,35,42,UCBPlayer
34543,UCBPlayer,84,224,308,0,64,UCBPlayer
34544,UCBPlayer,146,251,397,32,45,UCBPlayer
34545,UCBPlayer,89,234,323,3,60,UCBPlayer
34546,UCBPlayer,138,243,381,28,49,UCBPlayer
34547,UCBPlayer,97,242,339,7,56,UCBPlayer
34548,UCBPlayer,130,235,365,24,53,UCBPlayer
34549,UCBPlayer,105,250,355,11,52,UCBPlayer
34550,UCBPlayer,122,227,349,20,57,UCBPlayer
34551,UCBPlayer,109,259,368,15,49,UCBPlayer
34552,UCBPlayer,118,218,336,16,60,UCBPlayer
34553,UCBPlayer,117,267,384,19,45,UCBPlayer
34554,UCBPlayer,110,210,320,12,64,UCBPlayer
34555,UCBPlayer,126,271,397,23,42,UCBPlayer
34556,UCBPlayer,105,210,315,10,65,UCBPlayer
34557,UCBPlayer,130,275,405,25,40,UCBPlayer
34558,UCBPlayer,105,210,315,10,65,UCBPlayer
34559,UCBPlayer,130,275,405,25,40,UCBPlayer
34560,UCBPlayer,106,206,312,10,66,UCBPlayer
34561,UCBPlayer,130,275,405,25,40,UCBPlayer
34562,UCBPlayer,105,210,315,10,65,UCBPlayer
34563,UCBPlayer,131,271,402,25,41,UCBPlayer
34564,UCBPlayer,105,210,315,10,65,UCBPlayer
34565,UCBPlayer,130,275,405,25,40,UCBPlayer
34566,UCBPlayer,105,210,315,10,65,UCBPlayer
34567,UCBPlayer,130,275,405,25,40,UCBPlayer
34568,UCBPlayer,103,203,306,10,68,UCBPlayer
34569,UCBPlayer,128,283,411,25,38,UCBPlayer
34570,UCBPlayer,111,186,297,10,71,UCBPlayer
34571,UCBPlayer,124,299,423,25,34,UCBPlayer
34572,UCBPlayer,115,170,285,10,75,UCBPlayer
34573,UCBPlayer,120,315,435,25,30,UCBPlayer
34574,UCBPlayer,119,154,273,10,79,UCBPlayer
34575,UCBPlayer,112,332,444,25,27,UCBPlayer
34576,UCBPlayer,127,137,264,10,82,UCBPlayer
34577,UCBPlayer,104,349,453,25,24,UCBPlayer
34578,UCBPlayer,126,126,252,7,85,Tie
34579,UCBPlayer,111,351,462,28,22,UCBPlayer
34580,UCBPlayer,116,126,242,3,87,UCBPlayer
34581,UCBPlayer,122,347,469,32,21,UCBPlayer
34582,UCBPlayer,107,132,239,0,87,UCBPlayer
34583,UCBPlayer,132,337,469,35,22,UCBPlayer
34584,UCBPlayer,103,148,251,0,83,UCBPlayer
34585,UCBPlayer,136,321,457,35,26,UCBPlayer
34586,UCBPlayer,99,164,263,0,79,UCBPlayer
34587,UCBPlayer,140,305,445,35,30,UCBPlayer
34588,UCBPlayer,95,180,275,0,75,UCBPlayer
34589,UCBPlayer,144,289,433,35,34,UCBPlayer
34590,UCBPlayer,91,196,287,0,71,UCBPlayer
34591,UCBPlayer,148,273,421,35,38,UCBPlayer
34592,UCBPlayer,87,212,299,0,67,UCBPlayer
34593,UCBPlayer,152,257,409,35,42,UCBPlayer
34594,UCBPlayer,84,224,308,0,64,UCBPlayer
34595,UCBPlayer,146,251,397,32,45,UCBPlayer
34596,UCBPlayer,89,234,323,3,60,UCBPlayer
34597,UCBPlayer,138,243,381,28,49,UCBPlayer
34598,UCBPlayer,97,242,339,7,56,UCBPlayer
34599,UCBPlayer,130,235,365,24,53,UCBPlayer
34600,UCBPlayer,105,250,355,11,52,UCBPlayer
34601,UCBPlayer,122,227,349,20,57,UCBPlayer
34602,UCBPlayer,109,259,368,15,49,UCBPlayer
34603,UCBPlayer,118,218,336,16,60,UCBPlayer
34604,UCBPlayer,117,267,384,19,45,UCBPlayer
34605,UCBPlayer,110,210,320,12,64,UCBPlayer
34606,UCBPlayer,126,271,397,23,42,UCBPlayer
34607,UCBPlayer,105,210,315,10,65,UCBPlayer
34608,UCBPlayer,130,275,405,25,40,UCBPlayer
34609,UCBPlayer,105,210,315,10,65,UCBPlayer
34610,UCBPlayer,130,275,405,25,40,UCBPlayer
34611,UCBPlayer,106,206,312,10,66,UCBPlayer
34612,UCBPlayer,130,275,405,25,40,UCBPlayer
34613,UCBPlayer,105,210,315,10,65,UCBPlayer
34614,UCBPlayer,131,271,402,25,41,UCBPlayer
34615,UCBPlayer,105,210,315,10,65,UCBPlayer
34616,UCBPlayer,130,275,405,25,40,UCBPlayer
34617,UCBPlayer,105,210,315,10,65,UCBPlayer
34618,UCBPlayer,130,275,405,25,40,UCBPlayer
34619,UCBPlayer,103,203,306,10,68,UCBPlayer
34620,UCBPlayer,128,283,411,25,38,UCBPlayer
34621,UCBPlayer,111,186,297,10,71,UCBPlayer
34622,UCBPlayer,124,299,423,25,34,UCBPlayer
34623,UCBPlayer,115,170,285,10,75,UCBPlayer
34624,UCBPlayer,120,315,435,25,30,UCBPlayer
34625,UCBPlayer,119,154,273,10,79,UCBPlayer
34626,UCBPlayer,112,332,444,25,27,UCBPlayer
34627,UCBPlayer,127,137,264,10,82,UCBPlayer
34628,UCBPlayer,104,349,453,25,24,UCBPlayer
34629,UCBPlayer,126,126,252,7,85,Tie
34630,UCBPlayer,111,351,462,28,22,UCBPlayer
34631,UCBPlayer,116,126,242,3,87,UCBPlayer
34632,UCBPlayer,122,347,469,32,21,UCBPlayer
34633,UCBPlayer,107,132,239,0,87,UCBPlayer
34634,UCBPlayer,132,337,469,35,22,UCBPlayer
34635,UCBPlayer,103,148,251,0,83,UCBPlayer
34636,UCBPlayer,136,321,457,35,26,UCBPlayer
34637,UCBPlayer,99,164,263,0,79,UCBPlayer
34638,UCBPlayer,140,305,445,35,30,UCBPlayer
34639,UCBPlayer,95,180,275,0,75,UCBPlayer
34640,UCBPlayer,144,289,433,35,34,UCBPlayer
34641,UCBPlayer,91,196,287,0,71,UCBPlayer
34642,UCBPlayer,148,273,421,35,38,UCBPlayer
34643,UCBPlayer,87,212,299,0,67,UCBPlayer
34644,UCBPlayer,152,257,409,35,42,UCBPlayer
34645,UCBPlayer,84,224,308,0,64,UCBPlayer
34646,UCBPlayer,146,251,397,32,45,UCBPlayer
34647,UCBPlayer,89,234,323,3,60,UCBPlayer
34648,UCBPlayer,138,243,381,28,49,UCBPlayer
34649,UCBPlayer,97,242,339,7,56,UCBPlayer
34650,UCBPlayer,130,235,365,24,53,UCBPlayer
34651,UCBPlayer,105,250,355,11,52,UCBPlayer
34652,UCBPlayer,122,227,349,20,57,UCBPlayer
34653,UCBPlayer,109,259,368,15,49,UCBPlayer
34654,UCBPlayer,118,218,336,16,60,UCBPlayer
34655,UCBPlayer,117,267,384,19,45,UCBPlayer
34656,UCBPlayer,110,210,320,12,64,UCBPlayer
34657,UCBPlayer,126,271,397,23,42,UCBPlayer
34658,UCBPlayer,105,210,315,10,65,UCBPlayer
34659,UCBPlayer,130,275,405,25,40,UCBPlayer
34660,UCBPlayer,105,210,315,10,65,UCBPlayer
34661,UCBPlayer,130,275,405,25,40,UCBPlayer
34662,UCBPlayer,106,206,312,10,66,UCBPlayer
34663,UCBPlayer,130,275,405,25,40,UCBPlayer
34664,UCBPlayer,105,210,315,10,65,UCBPlayer
34665,UCBPlayer,131,271,402,25,41,UCBPlayer
34666,UCBPlayer,105,210,315,10,65,UCBPlayer
34667,UCBPlayer,130,275,405,25,40,UCBPlayer
34668,UCBPlayer,105,210,315,10,65,UCBPlayer
34669,UCBPlayer,130,275,405,25,40,UCBPlayer
34670,UCBPlayer,103,203,306,10,68,UCBPlayer
34671,UCBPlayer,128,283,411,25,38,UCBPlayer
34672,UCBPlayer,111,186,297,10,71,UCBPlayer
34673,UCBPlayer,124,299,423,25,34,UCBPlayer
34674,UCBPlayer,115,170,285,10,75,UCBPlayer
34675,UCBPlayer,120,315,435,25,30,UCBPlayer
34676,UCBPlayer,119,154,273,10,79,UCBPlayer
34677,UCBPlayer,112,332,444,25,27,UCBPlayer
34678,UCBPlayer,127,137,264,10,82,UCBPlayer
34679,UCBPlayer,104,349,453,25,24,UCBPlayer
34680,UCBPlayer,126,126,252,7,85,Tie
34681,UCBPlayer,111,351,462,28,22,UCBPlayer
34682,UCBPlayer,116,126,242,3,87,UCBPlayer
34683,UCBPlayer,122,347,469,32,21,UCBPlayer
34684,UCBPlayer,107,132,239,0,87,UCBPlayer
34685,UCBPlayer,132,337,469,35,22,UCBPlayer
34686,UCBPlayer,103,148,251,0,83,UCBPlayer
34687,UCBPlayer,136,321,457,35,26,UCBPlayer
34688,UCBPlayer,99,164,263,0,79,UCBPlayer
34689,UCBPlayer,140,305,445,35,30,UCBPlayer
34690,UCBPlayer,95,180,275,0,75,UCBPlayer
34691,UCBPlayer,144,289,433,35,34,UCBPlayer
34692,UCBPlayer,91,196,287,0,71,UCBPlayer
34693,UCBPlayer,148,273,421,35,38,UCBPlayer
34694,UCBPlayer,87,212,299,0,67,UCBPlayer
34695,UCBPlayer,152,257,409,35,42,UCBPlayer
34696,UCBPlayer,84,224,308,0,64,UCBPlayer
34697,UCBPlayer,146,251,397,32,45,UCBPlayer
34698,UCBPlayer,89,234,323,3,60,UCBPlayer
34699,UCBPlayer,138,243,381,28,49,UCBPlayer
34700,UCBPlayer,97,242,339,7,56,UCBPlayer
34701,UCBPlayer,130,235,365,24,53,UCBPlayer
34702,UCBPlayer,105,250,355,11,52,UCBPlayer
34703,UCBPlayer,122,227,349,20,57,UCBPlayer
34704,UCBPlayer,109,259,368,15,49,UCBPlayer
34705,UCBPlayer,118,218,336,16,60,UCBPlayer
34706,UCBPlayer,117,267,384,19,45,UCBPlayer
34707,UCBPlayer,110,210,320,12,64,UCBPlayer
34708,UCBPlayer,126,271,397,23,42,UCBPlayer
34709,UCBPlayer,105,210,315,10,65,UCBPlayer
34710,UCBPlayer,130,275,405,25,40,UCBPlayer
34711,UCBPlayer,105,210,315,10,65,UCBPlayer
34712,UCBPlayer,130,275,405,25,40,UCBPlayer
34713,UCBPlayer,106,206,312,10,66,UCBPlayer
34714,UCBPlayer,130,275,405,25,40,UCBPlayer
34715,UCBPlayer,105,210,315,10,65,UCBPlayer
34716,UCBPlayer,131,271,402,25,41,UCBPlayer
34717,UCBPlayer,105,210,315,10,65,UCBPlayer
34718,UCBPlayer,130,275,405,25,40,UCBPlayer
34719,UCBPlayer,105,210,315,10,65,UCBPlayer
34720,UCBPlayer,130,275,405,25,40,UCBPlayer
34721,UCBPlayer,103,203,306,10,68,UCBPlayer
34722,UCBPlayer,128,283,411,25,38,UCBPlayer
34723,UCBPlayer,111,186,297,10,71,UCBPlayer
34724,UCBPlayer,124,299,423,25,34,UCBPlayer
34725,UCBPlayer,115,170,285,10,75,UCBPlayer
34726,UCBPlayer,120,315,435,25,30,UCBPlayer
34727,UCBPlayer,119,154,273,10,79,UCBPlayer
34728,UCBPlayer,112,332,444,25,27,UCBPlayer
34729,UCBPlayer,127,137,264,10,82,UCBPlayer
34730,UCBPlayer,104,349,453,25,24,UCBPlayer
34731,UCBPlayer,126,126,252,7,85,Tie
34732,UCBPlayer,111,351,462,28,22,UCBPlayer
34733,UCBPlayer,116,126,242,3,87,UCBPlayer
34734,UCBPlayer,122,347,469,32,21,UCBPlayer
34735,UCBPlayer,107,132,239,0,87,UCBPlayer
34736,UCBPlayer,132,337,469,35,22,UCBPlayer
34737,UCBPlayer,103,148,251,0,83,UCBPlayer
34738,UCBPlayer,136,321,457,35,26,UCBPlayer
34739,UCBPlayer,99,164,263,0,79,UCBPlayer
34740,UCBPlayer,140,305,445,35,30,UCBPlayer
34741,UCBPlayer,95,180,275,0,75,UCBPlayer
34742,UCBPlayer,144,289,433,35,34,UCBPlayer
34743,UCBPlayer,91,196,287,0,71,UCBPlayer
34744,UCBPlayer,148,273,421,35,38,UCBPlayer
34745,UCBPlayer,87,212,299,0,67,UCBPlayer
34746,UCBPlayer,152,257,409,35,42,UCBPlayer
34747,UCBPlayer,84,224,308,0,64,UCBPlayer
34748,UCBPlayer,146,251,397,32,45,UCBPlayer
34749,UCBPlayer,89,234,323,3,60,UCBPlayer
34750,UCBPlayer,138,243,381,28,49,UCBPlayer
34751,UCBPlayer,97,242,339,7,56,UCBPlayer
34752,UCBPlayer,130,235,365,24,53,UCBPlayer
34753,UCBPlayer,105,250,355,11,52,UCBPlayer
34754,UCBPlayer,122,227,349,20,57,UCBPlayer
34755,UCBPlayer,109,259,368,15,49,UCBPlayer
34756,UCBPlayer,118,218,336,16,60,UCBPlayer
34757,UCBPlayer,117,267,384,19,45,UCBPlayer
34758,UCBPlayer,110,210,320,12,64,UCBPlayer
34759,UCBPlayer,126,271,397,23,42,UCBPlayer
34760,UCBPlayer,105,210,315,10,65,UCBPlayer
34761,UCBPlayer,130,275,405,25,40,UCBPlayer
34762,UCBPlayer,105,210,315,10,65,UCBPlayer
34763,UCBPlayer,130,275,405,25,40,UCBPlayer
34764,UCBPlayer,106,206,312,10,66,UCBPlayer
34765,UCBPlayer,130,275,405,25,40,UCBPlayer
34766,UCBPlayer,105,210,315,10,65,UCBPlayer
34767,UCBPlayer,131,271,402,25,41,UCBPlayer
34768,UCBPlayer,105,210,315,10,65,UCBPlayer
34769,UCBPlayer,130,275,405,25,40,UCBPlayer
34770,UCBPlayer,105,210,315,10,65,UCBPlayer
34771,UCBPlayer,130,275,405,25,40,UCBPlayer
34772,UCBPlayer,103,203,306,10,68,UCBPlayer
34773,UCBPlayer,128,283,411,25,38,UCBPlayer
34774,UCBPlayer,111,186,297,10,71,UCBPlayer
34775,UCBPlayer,124,299,423,25,34,UCBPlayer
34776,UCBPlayer,115,170,285,10,75,UCBPlayer
34777,UCBPlayer,120,315,435,25,30,UCBPlayer
34778,UCBPlayer,119,154,273,10,79,UCBPlayer
34779,UCBPlayer,112,332,444,25,27,UCBPlayer
34780,UCBPlayer,127,137,264,10,82,UCBPlayer
34781,UCBPlayer,104,349,453,25,24,UCBPlayer
34782,UCBPlayer,126,126,252,7,85,Tie
34783,UCBPlayer,111,351,462,28,22,UCBPlayer
34784,UCBPlayer,116,126,242,3,87,UCBPlayer
34785,UCBPlayer,122,347,469,32,21,UCBPlayer
34786,UCBPlayer,107,132,239,0,87,UCBPlayer
34787,UCBPlayer,132,337,469,35,22,UCBPlayer
34788,UCBPlayer,103,148,251,0,83,UCBPlayer
34789,UCBPlayer,136,321,457,35,26,UCBPlayer
34790,UCBPlayer,99,164,263,0,79,UCBPlayer
34791,UCBPlayer,140,305,445,35,30,UCBPlayer
34792,UCBPlayer,95,180,275,0,75,UCBPlayer
34793,UCBPlayer,144,289,433,35,34,UCBPlayer
34794,UCBPlayer,91,196,287,0,71,UCBPlayer
34795,UCBPlayer,148,273,421,35,38,UCBPlayer
34796,UCBPlayer,87,212,299,0,67,UCBPlayer
34797,UCBPlayer,152,257,409,35,42,UCBPlayer
34798,UCBPlayer,84,224,308,0,64,UCBPlayer
34799,UCBPlayer,146,251,397,32,45,UCBPlayer
34800,UCBPlayer,89,234,323,3,60,UCBPlayer
34801,UCBPlayer,138,243,381,28,49,UCBPlayer
34802,UCBPlayer,97,242,339,7,56,UCBPlayer
34803,UCBPlayer,130,235,365,24,53,UCBPlayer
34804,UCBPlayer,105,250,355,11,52,UCBPlayer
34805,UCBPlayer,122,227,349,20,57,UCBPlayer
34806,UCBPlayer,109,259,368,15,49,UCBPlayer
34807,UCBPlayer,118,218,336,16,60,UCBPlayer
34808,UCBPlayer,117,267,384,19,45,UCBPlayer
34809,UCBPlayer,110,210,320,12,64,UCBPlayer
34810,UCBPlayer,126,271,397,23,42,UCBPlayer
34811,UCBPlayer,105,210,315,10,65,UCBPlayer
34812,UCBPlayer,130,275,405,25,40,UCBPlayer
34813,UCBPlayer,105,210,315,10,65,UCBPlayer
34814,UCBPlayer,130,275,405,25,40,UCBPlayer
34815,UCBPlayer,106,206,312,10,66,UCBPlayer
34816,UCBPlayer,130,275,405,25,40,UCBPlayer
34817,UCBPlayer,105,210,315,10,65,UCBPlayer
34818,UCBPlayer,131,271,402,25,41,UCBPlayer
34819,UCBPlayer,105,210,315,10,65,UCBPlayer
34820,UCBPlayer,130,275,405,25,40,UCBPlayer
34821,UCBPlayer,105,210,315,10,65,UCBPlayer
34822,UCBPlayer,130,275,405,25,40,UCBPlayer
34823,UCBPlayer,103,203,306,10,68,UCBPlayer
34824,UCBPlayer,128,283,411,25,38,UCBPlayer
34825,UCBPlayer,111,186,297,10,71,UCBPlayer
34826,UCBPlayer,124,299,423,25,34,UCBPlayer
34827,UCBPlayer,115,170,285,10,75,UCBPlayer
34828,UCBPlayer,120,315,435,25,30,UCBPlayer
34829,UCBPlayer,119,154,273,10,79,UCBPlayer
34830,UCBPlayer,112,332,444,25,27,UCBPlayer
34831,UCBPlayer,127,137,264,10,82,UCBPlayer
34832,UCBPlayer,104,349,453,25,24,UCBPlayer
34833,UCBPlayer,126,126,252,7,85,Tie
34834,UCBPlayer,111,351,462,28,22,UCBPlayer
34835,UCBPlayer,116,126,242,3,87,UCBPlayer
34836,UCBPlayer,122,347,469,32,21,UCBPlayer
34837,UCBPlayer,107,132,239,0,87,UCBPlayer
34838,UCBPlayer,132,337,469,35,22,UCBPlayer
34839,UCBPlayer,103,148,251,0,83,UCBPlayer
34840,UCBPlayer,136,321,457,35,26,UCBPlayer
34841,UCBPlayer,99,164,263,0,79,UCBPlayer
34842,UCBPlayer,140,305,445,35,30,UCBPlayer
34843,UCBPlayer,95,180,275,0,75,UCBPlayer
34844,UCBPlayer,144,289,433,35,34,UCBPlayer
34845,UCBPlayer,91,196,287,0,71,UCBPlayer
34846,UCBPlayer,148,273,421,35,38,UCBPlayer
34847,UCBPlayer,87,212,299,0,67,UCBPlayer
34848,UCBPlayer,152,257,409,35,42,UCBPlayer
34849,UCBPlayer,84,224,308,0,64,UCBPlayer
34850,UCBPlayer,146,251,397,32,45,UCBPlayer
34851,UCBPlayer,89,234,323,3,60,UCBPlayer
34852,UCBPlayer,138,243,381,28,49,UCBPlayer
34853,UCBPlayer,97,242,339,7,56,UCBPlayer
34854,UCBPlayer,130,235,365,24,53,UCBPlayer
34855,UCBPlayer,105,250,355,11,52,UCBPlayer
34856,UCBPlayer,122,227,349,20,57,UCBPlayer
34857,UCBPlayer,109,259,368,15,49,UCBPlayer
34858,UCBPlayer,118,218,336,16,60,UCBPlayer
34859,UCBPlayer,117,267,384,19,45,UCBPlayer
34860,UCBPlayer,110,210,320,12,64,UCBPlayer
34861,UCBPlayer,126,271,397,23,42,UCBPlayer
34862,UCBPlayer,105,210,315,10,65,UCBPlayer
34863,UCBPlayer,130,275,405,25,40,UCBPlayer
34864,UCBPlayer,105,210,315,10,65,UCBPlayer
34865,UCBPlayer,130,275,405,25,40,UCBPlayer
34866,UCBPlayer,106,206,312,10,66,UCBPlayer
34867,UCBPlayer,130,275,405,25,40,UCBPlayer
34868,UCBPlayer,105,210,315,10,65,UCBPlayer
34869,UCBPlayer,131,271,402,25,41,UCBPlayer
34870,UCBPlayer,105,210,315,10,65,UCBPlayer
34871,UCBPlayer,130,275,405,25,40,UCBPlayer
34872,UCBPlayer,105,210,315,10,65,UCBPlayer
34873,UCBPlayer,130,275,405,25,40,UCBPlayer
34874,UCBPlayer,103,203,306,10,68,UCBPlayer
34875,UCBPlayer,128,283,411,25,38,UCBPlayer
34876,UCBPlayer,111,186,297,10,71,UCBPlayer
34877,UCBPlayer,124,299,423,25,34,UCBPlayer
34878,UCBPlayer,115,170,285,10,75,UCBPlayer
34879,UCBPlayer,120,315,435,25,30,UCBPlayer
34880,UCBPlayer,119,154,273,10,79,UCBPlayer
34881,UCBPlayer,112,332,444,25,27,UCBPlayer
34882,UCBPlayer,127,137,264,10,82,UCBPlayer
34883,UCBPlayer,104,349,453,25,24,UCBPlayer
34884,UCBPlayer,126,126,252,7,85,Tie
34885,UCBPlayer,111,351,462,28,22,UCBPlayer
34886,UCBPlayer,116,126,242,3,87,UCBPlayer
34887,UCBPlayer,122,347,469,32,21,UCBPlayer
34888,UCBPlayer,107,132,239,0,87,UCBPlayer
34889,UCBPlayer,132,337,469,35,22,UCBPlayer
34890,UCBPlayer,103,148,251,0,83,UCBPlayer
34891,UCBPlayer,136,321,457,35,26,UCBPlayer
34892,UCBPlayer,99,164,263,0,79,UCBPlayer
34893,UCBPlayer,140,305,445,35,30,UCBPlayer
34894,UCBPlayer,95,180,275,0,75,UCBPlayer
34895,UCBPlayer,144,289,433,35,34,UCBPlayer
34896,UCBPlayer,91,196,287,0,71,UCBPlayer
34897,UCBPlayer,148,273,421,35,38,UCBPlayer
34898,UCBPlayer,87,212,299,0,67,UCBPlayer
34899,UCBPlayer,152,257,409,35,42,UCBPlayer
34900,UCBPlayer,84,224,308,0,64,UCBPlayer
34901,UCBPlayer,146,251,397,32,45,UCBPlayer
34902,UCBPlayer,89,234,323,3,60,UCBPlayer
34903,UCBPlayer,138,243,381,28,49,UCBPlayer
34904,UCBPlayer,97,242,339,7,56,UCBPlayer
34905,UCBPlayer,130,235,365,24,53,UCBPlayer
34906,UCBPlayer,105,250,355,11,52,UCBPlayer
34907,UCBPlayer,122,227,349,20,57,UCBPlayer
34908,UCBPlayer,109,259,368,15,49,UCBPlayer
34909,UCBPlayer,118,218,336,16,60,UCBPlayer
34910,UCBPlayer,117,267,384,19,45,UCBPlayer
34911,UCBPlayer,110,210,320,12,64,UCBPlayer
34912,UCBPlayer,126,271,397,23,42,UCBPlayer
34913,UCBPlayer,105,210,315,10,65,UCBPlayer
34914,UCBPlayer,130,275,405,25,40,UCBPlayer
34915,UCBPlayer,105,210,315,10,65,UCBPlayer
34916,UCBPlayer,130,275,405,25,40,UCBPlayer
34917,UCBPlayer,106,206,312,10,66,UCBPlayer
34918,UCBPlayer,130,275,405,25,40,UCBPlayer
34919,UCBPlayer,105,210,315,10,65,UCBPlayer
34920,UCBPlayer,131,271,402,25,41,UCBPlayer
34921,UCBPlayer,105,210,315,10,65,UCBPlayer
34922,UCBPlayer,130,275,405,25,40,UCBPlayer
34923,UCBPlayer,105,210,315,10,65,UCBPlayer
34924,UCBPlayer,130,275,405,25,40,UCBPlayer
34925,UCBPlayer,103,203,306,10,68,UCBPlayer
34926,UCBPlayer,128,283,411,25,38,UCBPlayer
34927,UCBPlayer,111,186,297,10,71,UCBPlayer
34928,UCBPlayer,124,299,423,25,34,UCBPlayer
34929,UCBPlayer,115,170,285,10,75,UCBPlayer
34930,UCBPlayer,120,315,435,25,30,UCBPlayer
34931,UCBPlayer,119,154,273,10,79,UCBPlayer
34932,UCBPlayer,112,332,444,25,27,UCBPlayer
34933,UCBPlayer,127,137,264,10,82,UCBPlayer
34934,UCBPlayer,104,349,453,25,24,UCBPlayer
34935,UCBPlayer,126,126,252,7,85,Tie
34936,UCBPlayer,111,351,462,28,22,UCBPlayer
34937,UCBPlayer,116,126,242,3,87,UCBPlayer
34938,UCBPlayer,122,347,469,32,21,UCBPlayer
34939,UCBPlayer,107,132,239,0,87,UCBPlayer
34940,UCBPlayer,132,337,469,35,22,UCBPlayer
34941,UCBPlayer,103,148,251,0,83,UCBPlayer
34942,UCBPlayer,136,321,457,35,26,UCBPlayer
34943,UCBPlayer,99,164,263,0,79,UCBPlayer
34944,UCBPlayer,140,305,445,35,30,UCBPlayer
34945,UCBPlayer,95,180,275,0,75,UCBPlayer
34946,UCBPlayer,144,289,433,35,34,UCBPlayer
34947,UCBPlayer,91,196,287,0,71,UCBPlayer
34948,UCBPlayer,148,273,421,35,38,UCBPlayer
34949,UCBPlayer,87,212,299,0,67,UCBPlayer
34950,UCBPlayer,152,257,409,35,42,UCBPlayer
34951,UCBPlayer,84,224,308,0,64,UCBPlayer
34952,UCBPlayer,146,251,397,32,45,UCBPlayer
34953,UCBPlayer,89,234,323,3,60,UCBPlayer
34954,UCBPlayer,138,243,381,28,49,UCBPlayer
34955,UCBPlayer,97,242,339,7,56,UCBPlayer
34956,UCBPlayer,130,235,365,24,53,UCBPlayer
34957,UCBPlayer,105,250,355,11,52,UCBPlayer
34958,UCBPlayer,122,227,349,20,57,UCBPlayer
34959,UCBPlayer,109,259,368,15,49,UCBPlayer
34960,UCBPlayer,118,218,336,16,60,UCBPlayer
34961,UCBPlayer,117,267,384,19,45,UCBPlayer
34962,UCBPlayer,110,210,320,12,64,UCBPlayer
34963,UCBPlayer,126,271,397,23,42,UCBPlayer
34964,UCBPlayer,105,210,315,10,65,UCBPlayer
34965,UCBPlayer,130,275,405,25,40,UCBPlayer
34966,UCBPlayer,105,210,315,10,65,UCBPlayer
34967,UCBPlayer,130,275,405,25,40,UCBPlayer
34968,UCBPlayer,106,206,312,10,66,UCBPlayer
34969,UCBPlayer,130,275,405,25,40,UCBPlayer
34970,UCBPlayer,105,210,315,10,65,UCBPlayer
34971,UCBPlayer,131,271,402,25,41,UCBPlayer
34972,UCBPlayer,105,210,315,10,65,UCBPlayer
34973,UCBPlayer,130,275,405,25,40,UCBPlayer
34974,UCBPlayer,105,210,315,10,65,UCBPlayer
34975,UCBPlayer,130,275,405,25,40,UCBPlayer
34976,UCBPlayer,103,203,306,10,68,UCBPlayer
34977,UCBPlayer,128,283,411,25,38,UCBPlayer
34978,UCBPlayer,111,186,297,10,71,UCBPlayer
34979,UCBPlayer,124,299,423,25,34,UCBPlayer
34980,UCBPlayer,115,170,285,10,75,UCBPlayer
34981,UCBPlayer,120,315,435,25,30,UCBPlayer
34982,UCBPlayer,119,154,273,10,79,UCBPlayer
34983,UCBPlayer,112,332,444,25,27,UCBPlayer
34984,UCBPlayer,127,137,264,10,82,UCBPlayer
34985,UCBPlayer,104,349,453,25,24,UCBPlayer
34986,UCBPlayer,126,126,252,7,85,Tie
34987,UCBPlayer,111,351,462,28,22,UCBPlayer
34988,UCBPlayer,116,126,242,3,87,UCBPlayer
34989,UCBPlayer,122,347,469,32,21,UCBPlayer
34990,UCBPlayer,107,132,239,0,87,UCBPlayer
34991,UCBPlayer,132,337,469,35,22,UCBPlayer
34992,UCBPlayer,103,148,251,0,83,UCBPlayer
34993,UCBPlayer,136,321,457,35,26,UCBPlayer
34994,UCBPlayer,99,164,263,0,79,UCBPlayer
34995,UCBPlayer,140,305,445,35,30,UCBPlayer
34996,UCBPlayer,95,180,275,0,75,UCBPlayer
34997,UCBPlayer,144,289,433,35,34,UCBPlayer
34998,UCBPlayer,91,196,287,0,71,UCBPlayer
34999,UCBPlayer,148,273,421,35,38,UCBPlayer
35000,UCBPlayer,87,212,299,0,67,UCBPlayer
35001,UCBPlayer,152,257,409,35,42,UCBPlayer
35002,UCBPlayer,84,224,308,0,64,UCBPlayer
35003,UCBPlayer,146,251,397,32,45,UCBPlayer
35004,UCBPlayer,89,234,323,3,60,UCBPlayer
35005,UCBPlayer,138,243,381,28,49,UCBPlayer
35006,UCBPlayer,97,242,339,7,56,UCBPlayer
35007,UCBPlayer,130,235,365,24,53,UCBPlayer
35008,UCBPlayer,105,250,355,11,52,UCBPlayer
35009,UCBPlayer,122,227,349,20,57,UCBPlayer
35010,UCBPlayer,109,259,368,15,49,UCBPlayer
35011,UCBPlayer,118,218,336,16,60,UCBPlayer
35012,UCBPlayer,117,267,384,19,45,UCBPlayer
35013,UCBPlayer,110,210,320,12,64,UCBPlayer
35014,UCBPlayer,126,271,397,23,42,UCBPlayer
35015,UCBPlayer,105,210,315,10,65,UCBPlayer
35016,UCBPlayer,130,275,405,25,40,UCBPlayer
35017,UCBPlayer,105,210,315,10,65,UCBPlayer
35018,UCBPlayer,130,275,405,25,40,UCBPlayer
35019,UCBPlayer,106,206,312,10,66,UCBPlayer
35020,UCBPlayer,130,275,405,25,40,UCBPlayer
35021,UCBPlayer,105,210,315,10,65,UCBPlayer
35022,UCBPlayer,131,271,402,25,41,UCBPlayer
35023,UCBPlayer,105,210,315,10,65,UCBPlayer
35024,UCBPlayer,130,275,405,25,40,UCBPlayer
35025,UCBPlayer,105,210,315,10,65,UCBPlayer
35026,UCBPlayer,130,275,405,25,40,UCBPlayer
35027,UCBPlayer,103,203,306,10,68,UCBPlayer
35028,UCBPlayer,128,283,411,25,38,UCBPlayer
35029,UCBPlayer,111,186,297,10,71,UCBPlayer
35030,UCBPlayer,124,299,423,25,34,UCBPlayer
35031,UCBPlayer,115,170,285,10,75,UCBPlayer
35032,UCBPlayer,120,315,435,25,30,UCBPlayer
35033,UCBPlayer,119,154,273,10,79,UCBPlayer
35034,UCBPlayer,112,332,444,25,27,UCBPlayer
35035,UCBPlayer,127,137,264,10,82,UCBPlayer
35036,UCBPlayer,104,349,453,25,24,UCBPlayer
35037,UCBPlayer,126,126,252,7,85,Tie
35038,UCBPlayer,111,351,462,28,22,UCBPlayer
35039,UCBPlayer,116,126,242,3,87,UCBPlayer
35040,UCBPlayer,122,347,469,32,21,UCBPlayer
35041,UCBPlayer,107,132,239,0,87,UCBPlayer
35042,UCBPlayer,132,337,469,35,22,UCBPlayer
35043,UCBPlayer,103,148,251,0,83,UCBPlayer
35044,UCBPlayer,136,321,457,35,26,UCBPlayer
35045,UCBPlayer,99,164,263,0,79,UCBPlayer
35046,UCBPlayer,140,305,445,35,30,UCBPlayer
35047,UCBPlayer,95,180,275,0,75,UCBPlayer
35048,UCBPlayer,144,289,433,35,34,UCBPlayer
35049,UCBPlayer,91,196,287,0,71,UCBPlayer
35050,UCBPlayer,148,273,421,35,38,UCBPlayer
35051,UCBPlayer,87,212,299,0,67,UCBPlayer
35052,UCBPlayer,152,257,409,35,42,UCBPlayer
35053,UCBPlayer,84,224,308,0,64,UCBPlayer
35054,UCBPlayer,146,251,397,32,45,UCBPlayer
35055,UCBPlayer,89,234,323,3,60,UCBPlayer
35056,UCBPlayer,138,243,381,28,49,UCBPlayer
35057,UCBPlayer,97,242,339,7,56,UCBPlayer
35058,UCBPlayer,130,235,365,24,53,UCBPlayer
35059,UCBPlayer,105,250,355,11,52,UCBPlayer
35060,UCBPlayer,122,227,349,20,57,UCBPlayer
35061,UCBPlayer,109,259,368,15,49,UCBPlayer
35062,UCBPlayer,118,218,336,16,60,UCBPlayer
35063,UCBPlayer,117,267,384,19,45,UCBPlayer
35064,UCBPlayer,110,210,320,12,64,UCBPlayer
35065,UCBPlayer,126,271,397,23,42,UCBPlayer
35066,UCBPlayer,105,210,315,10,65,UCBPlayer
35067,UCBPlayer,130,275,405,25,40,UCBPlayer
35068,UCBPlayer,105,210,315,10,65,UCBPlayer
35069,UCBPlayer,130,275,405,25,40,UCBPlayer
35070,UCBPlayer,106,206,312,10,66,UCBPlayer
35071,UCBPlayer,130,275,405,25,40,UCBPlayer
35072,UCBPlayer,105,210,315,10,65,UCBPlayer
35073,UCBPlayer,131,271,402,25,41,UCBPlayer
35074,UCBPlayer,105,210,315,10,65,UCBPlayer
35075,UCBPlayer,130,275,405,25,40,UCBPlayer
35076,UCBPlayer,105,210,315,10,65,UCBPlayer
35077,UCBPlayer,130,275,405,25,40,UCBPlayer
35078,UCBPlayer,103,203,306,10,68,UCBPlayer
35079,UCBPlayer,128,283,411,25,38,UCBPlayer
35080,UCBPlayer,111,186,297,10,71,UCBPlayer
35081,UCBPlayer,124,299,423,25,34,UCBPlayer
35082,UCBPlayer,115,170,285,10,75,UCBPlayer
35083,UCBPlayer,120,315,435,25,30,UCBPlayer
35084,UCBPlayer,119,154,273,10,79,UCBPlayer
35085,UCBPlayer,112,332,444,25,27,UCBPlayer
35086,UCBPlayer,127,137,264,10,82,UCBPlayer
35087,UCBPlayer,104,349,453,25,24,UCBPlayer
35088,UCBPlayer,126,126,252,7,85,Tie
35089,UCBPlayer,111,351,462,28,22,UCBPlayer
35090,UCBPlayer,116,126,242,3,87,UCBPlayer
35091,UCBPlayer,122,347,469,32,21,UCBPlayer
35092,UCBPlayer,107,132,239,0,87,UCBPlayer
35093,UCBPlayer,132,337,469,35,22,UCBPlayer
35094,UCBPlayer,103,148,251,0,83,UCBPlayer
35095,UCBPlayer,136,321,457,35,26,UCBPlayer
35096,UCBPlayer,99,164,263,0,79,UCBPlayer
35097,UCBPlayer,140,305,445,35,30,UCBPlayer
35098,UCBPlayer,95,180,275,0,75,UCBPlayer
35099,UCBPlayer,144,289,433,35,34,UCBPlayer
35100,UCBPlayer,91,196,287,0,71,UCBPlayer
35101,UCBPlayer,148,273,421,35,38,UCBPlayer
35102,UCBPlayer,87,212,299,0,67,UCBPlayer
35103,UCBPlayer,152,257,409,35,42,UCBPlayer
35104,UCBPlayer,84,224,308,0,64,UCBPlayer
35105,UCBPlayer,146,251,397,32,45,UCBPlayer
35106,UCBPlayer,89,234,323,3,60,UCBPlayer
35107,UCBPlayer,138,243,381,28,49,UCBPlayer
35108,UCBPlayer,97,242,339,7,56,UCBPlayer
35109,UCBPlayer,130,235,365,24,53,UCBPlayer
35110,UCBPlayer,105,250,355,11,52,UCBPlayer
35111,UCBPlayer,122,227,349,20,57,UCBPlayer
35112,UCBPlayer,109,259,368,15,49,UCBPlayer
35113,UCBPlayer,118,218,336,16,60,UCBPlayer
35114,UCBPlayer,117,267,384,19,45,UCBPlayer
35115,UCBPlayer,110,210,320,12,64,UCBPlayer
35116,UCBPlayer,126,271,397,23,42,UCBPlayer
35117,UCBPlayer,105,210,315,10,65,UCBPlayer
35118,UCBPlayer,130,275,405,25,40,UCBPlayer
35119,UCBPlayer,105,210,315,10,65,UCBPlayer
35120,UCBPlayer,130,275,405,25,40,UCBPlayer
35121,UCBPlayer,106,206,312,10,66,UCBPlayer
35122,UCBPlayer,130,275,405,25,40,UCBPlayer
35123,UCBPlayer,105,210,315,10,65,UCBPlayer
35124,UCBPlayer,131,271,402,25,41,UCBPlayer
35125,UCBPlayer,105,210,315,10,65,UCBPlayer
35126,UCBPlayer,130,275,405,25,40,UCBPlayer
35127,UCBPlayer,105,210,315,10,65,UCBPlayer
35128,UCBPlayer,130,275,405,25,40,UCBPlayer
35129,UCBPlayer,103,203,306,10,68,UCBPlayer
35130,UCBPlayer,128,283,411,25,38,UCBPlayer
35131,UCBPlayer,111,186,297,10,71,UCBPlayer
35132,UCBPlayer,124,299,423,25,34,UCBPlayer
35133,UCBPlayer,115,170,285,10,75,UCBPlayer
35134,UCBPlayer,120,315,435,25,30,UCBPlayer
35135,UCBPlayer,119,154,273,10,79,UCBPlayer
35136,UCBPlayer,112,332,444,25,27,UCBPlayer
35137,UCBPlayer,127,137,264,10,82,UCBPlayer
35138,UCBPlayer,104,349,453,25,24,UCBPlayer
35139,UCBPlayer,126,126,252,7,85,Tie
35140,UCBPlayer,111,351,462,28,22,UCBPlayer
35141,UCBPlayer,116,126,242,3,87,UCBPlayer
35142,UCBPlayer,122,347,469,32,21,UCBPlayer
35143,UCBPlayer,107,132,239,0,87,UCBPlayer
35144,UCBPlayer,132,337,469,35,22,UCBPlayer
35145,UCBPlayer,103,148,251,0,83,UCBPlayer
35146,UCBPlayer,136,321,457,35,26,UCBPlayer
35147,UCBPlayer,99,164,263,0,79,UCBPlayer
35148,UCBPlayer,140,305,445,35,30,UCBPlayer
35149,UCBPlayer,95,180,275,0,75,UCBPlayer
35150,UCBPlayer,144,289,433,35,34,UCBPlayer
35151,UCBPlayer,91,196,287,0,71,UCBPlayer
35152,UCBPlayer,148,273,421,35,38,UCBPlayer
35153,UCBPlayer,87,212,299,0,67,UCBPlayer
35154,UCBPlayer,152,257,409,35,42,UCBPlayer
35155,UCBPlayer,84,224,308,0,64,UCBPlayer
35156,UCBPlayer,146,251,397,32,45,UCBPlayer
35157,UCBPlayer,89,234,323,3,60,UCBPlayer
35158,UCBPlayer,138,243,381,28,49,UCBPlayer
35159,UCBPlayer,97,242,339,7,56,UCBPlayer
35160,UCBPlayer,130,235,365,24,53,UCBPlayer
35161,UCBPlayer,105,250,355,11,52,UCBPlayer
35162,UCBPlayer,122,227,349,20,57,UCBPlayer
35163,UCBPlayer,109,259,368,15,49,UCBPlayer
35164,UCBPlayer,118,218,336,16,60,UCBPlayer
35165,UCBPlayer,117,267,384,19,45,UCBPlayer
35166,UCBPlayer,110,210,320,12,64,UCBPlayer
35167,UCBPlayer,126,271,397,23,42,UCBPlayer
35168,UCBPlayer,105,210,315,10,65,UCBPlayer
35169,UCBPlayer,130,275,405,25,40,UCBPlayer
35170,UCBPlayer,105,210,315,10,65,UCBPlayer
35171,UCBPlayer,130,275,405,25,40,UCBPlayer
35172,UCBPlayer,106,206,312,10,66,UCBPlayer
35173,UCBPlayer,130,275,405,25,40,UCBPlayer
35174,UCBPlayer,105,210,315,10,65,UCBPlayer
35175,UCBPlayer,131,271,402,25,41,UCBPlayer
35176,UCBPlayer,105,210,315,10,65,UCBPlayer
35177,UCBPlayer,130,275,405,25,40,UCBPlayer
35178,UCBPlayer,105,210,315,10,65,UCBPlayer
35179,UCBPlayer,130,275,405,25,40,UCBPlayer
35180,UCBPlayer,103,203,306,10,68,UCBPlayer
35181,UCBPlayer,128,283,411,25,38,UCBPlayer
35182,UCBPlayer,111,186,297,10,71,UCBPlayer
35183,UCBPlayer,124,299,423,25,34,UCBPlayer
35184,UCBPlayer,115,170,285,10,75,UCBPlayer
35185,UCBPlayer,120,315,435,25,30,UCBPlayer
35186,UCBPlayer,119,154,273,10,79,UCBPlayer
35187,UCBPlayer,112,332,444,25,27,UCBPlayer
35188,UCBPlayer,127,137,264,10,82,UCBPlayer
35189,UCBPlayer,104,349,453,25,24,UCBPlayer
35190,UCBPlayer,126,126,252,7,85,Tie
35191,UCBPlayer,111,351,462,28,22,UCBPlayer
35192,UCBPlayer,116,126,242,3,87,UCBPlayer
35193,UCBPlayer,122,347,469,32,21,UCBPlayer
35194,UCBPlayer,107,132,239,0,87,UCBPlayer
35195,UCBPlayer,132,337,469,35,22,UCBPlayer
35196,UCBPlayer,103,148,251,0,83,UCBPlayer
35197,UCBPlayer,136,321,457,35,26,UCBPlayer
35198,UCBPlayer,99,164,263,0,79,UCBPlayer
35199,UCBPlayer,140,305,445,35,30,UCBPlayer
35200,UCBPlayer,95,180,275,0,75,UCBPlayer
35201,UCBPlayer,144,289,433,35,34,UCBPlayer
35202,UCBPlayer,91,196,287,0,71,UCBPlayer
35203,UCBPlayer,148,273,421,35,38,UCBPlayer
35204,UCBPlayer,87,212,299,0,67,UCBPlayer
35205,UCBPlayer,152,257,409,35,42,UCBPlayer
35206,UCBPlayer,84,224,308,0,64,UCBPlayer
35207,UCBPlayer,146,251,397,32,45,UCBPlayer
35208,UCBPlayer,89,234,323,3,60,UCBPlayer
35209,UCBPlayer,138,243,381,28,49,UCBPlayer
35210,UCBPlayer,97,242,339,7,56,UCBPlayer
35211,UCBPlayer,130,235,365,24,53,UCBPlayer
35212,UCBPlayer,105,250,355,11,52,UCBPlayer
35213,UCBPlayer,122,227,349,20,57,UCBPlayer
35214,UCBPlayer,109,259,368,15,49,UCBPlayer
35215,UCBPlayer,118,218,336,16,60,UCBPlayer
35216,UCBPlayer,117,267,384,19,45,UCBPlayer
35217,UCBPlayer,110,210,320,12,64,UCBPlayer
35218,UCBPlayer,126,271,397,23,42,UCBPlayer
35219,UCBPlayer,105,210,315,10,65,UCBPlayer
35220,UCBPlayer,130,275,405,25,40,UCBPlayer
35221,UCBPlayer,105,210,315,10,65,UCBPlayer
35222,UCBPlayer,130,275,405,25,40,UCBPlayer
35223,UCBPlayer,106,206,312,10,66,UCBPlayer
35224,UCBPlayer,130,275,405,25,40,UCBPlayer
35225,UCBPlayer,105,210,315,10,65,UCBPlayer
35226,UCBPlayer,131,271,402,25,41,UCBPlayer
35227,UCBPlayer,105,210,315,10,65,UCBPlayer
35228,UCBPlayer,130,275,405,25,40,UCBPlayer
35229,UCBPlayer,105,210,315,10,65,UCBPlayer
35230,UCBPlayer,130,275,405,25,40,UCBPlayer
35231,UCBPlayer,103,203,306,10,68,UCBPlayer
35232,UCBPlayer,128,283,411,25,38,UCBPlayer
35233,UCBPlayer,111,186,297,10,71,UCBPlayer
35234,UCBPlayer,124,299,423,25,34,UCBPlayer
35235,UCBPlayer,115,170,285,10,75,UCBPlayer
35236,UCBPlayer,120,315,435,25,30,UCBPlayer
35237,UCBPlayer,119,154,273,10,79,UCBPlayer
35238,UCBPlayer,112,332,444,25,27,UCBPlayer
35239,UCBPlayer,127,137,264,10,82,UCBPlayer
35240,UCBPlayer,104,349,453,25,24,UCBPlayer
35241,UCBPlayer,126,126,252,7,85,Tie
35242,UCBPlayer,111,351,462,28,22,UCBPlayer
35243,UCBPlayer,116,126,242,3,87,UCBPlayer
35244,UCBPlayer,122,347,469,32,21,UCBPlayer
35245,UCBPlayer,107,132,239,0,87,UCBPlayer
35246,UCBPlayer,132,337,469,35,22,UCBPlayer
35247,UCBPlayer,103,148,251,0,83,UCBPlayer
35248,UCBPlayer,136,321,457,35,26,UCBPlayer
35249,UCBPlayer,99,164,263,0,79,UCBPlayer
35250,UCBPlayer,140,305,445,35,30,UCBPlayer
35251,UCBPlayer,95,180,275,0,75,UCBPlayer
35252,UCBPlayer,144,289,433,35,34,UCBPlayer
35253,UCBPlayer,91,196,287,0,71,UCBPlayer
35254,UCBPlayer,148,273,421,35,38,UCBPlayer
35255,UCBPlayer,87,212,299,0,67,UCBPlayer
35256,UCBPlayer,152,257,409,35,42,UCBPlayer
35257,UCBPlayer,84,224,308,0,64,UCBPlayer
35258,UCBPlayer,146,251,397,32,45,UCBPlayer
35259,UCBPlayer,89,234,323,3,60,UCBPlayer
35260,UCBPlayer,138,243,381,28,49,UCBPlayer
35261,UCBPlayer,97,242,339,7,56,UCBPlayer
35262,UCBPlayer,130,235,365,24,53,UCBPlayer
35263,UCBPlayer,105,250,355,11,52,UCBPlayer
35264,UCBPlayer,122,227,349,20,57,UCBPlayer
35265,UCBPlayer,109,259,368,15,49,UCBPlayer
35266,UCBPlayer,118,218,336,16,60,UCBPlayer
35267,UCBPlayer,117,267,384,19,45,UCBPlayer
35268,UCBPlayer,110,210,320,12,64,UCBPlayer
35269,UCBPlayer,126,271,397,23,42,UCBPlayer
35270,UCBPlayer,105,210,315,10,65,UCBPlayer
35271,UCBPlayer,130,275,405,25,40,UCBPlayer
35272,UCBPlayer,105,210,315,10,65,UCBPlayer
35273,UCBPlayer,130,275,405,25,40,UCBPlayer
35274,UCBPlayer,106,206,312,10,66,UCBPlayer
35275,UCBPlayer,130,275,405,25,40,UCBPlayer
35276,UCBPlayer,105,210,315,10,65,UCBPlayer
35277,UCBPlayer,131,271,402,25,41,UCBPlayer
35278,UCBPlayer,105,210,315,10,65,UCBPlayer
35279,UCBPlayer,130,275,405,25,40,UCBPlayer
35280,UCBPlayer,105,210,315,10,65,UCBPlayer
35281,UCBPlayer,130,275,405,25,40,UCBPlayer
35282,UCBPlayer,103,203,306,10,68,UCBPlayer
35283,UCBPlayer,128,283,411,25,38,UCBPlayer
35284,UCBPlayer,111,186,297,10,71,UCBPlayer
35285,UCBPlayer,124,299,423,25,34,UCBPlayer
35286,UCBPlayer,115,170,285,10,75,UCBPlayer
35287,UCBPlayer,120,315,435,25,30,UCBPlayer
35288,UCBPlayer,119,154,273,10,79,UCBPlayer
35289,UCBPlayer,112,332,444,25,27,UCBPlayer
35290,UCBPlayer,127,137,264,10,82,UCBPlayer
35291,UCBPlayer,104,349,453,25,24,UCBPlayer
35292,UCBPlayer,126,126,252,7,85,Tie
35293,UCBPlayer,111,351,462,28,22,UCBPlayer
35294,UCBPlayer,116,126,242,3,87,UCBPlayer
35295,UCBPlayer,122,347,469,32,21,UCBPlayer
35296,UCBPlayer,107,132,239,0,87,UCBPlayer
35297,UCBPlayer,132,337,469,35,22,UCBPlayer
35298,UCBPlayer,103,148,251,0,83,UCBPlayer
35299,UCBPlayer,136,321,457,35,26,UCBPlayer
35300,UCBPlayer,99,164,263,0,79,UCBPlayer
35301,UCBPlayer,140,305,445,35,30,UCBPlayer
35302,UCBPlayer,95,180,275,0,75,UCBPlayer
35303,UCBPlayer,144,289,433,35,34,UCBPlayer
35304,UCBPlayer,91,196,287,0,71,UCBPlayer
35305,UCBPlayer,148,273,421,35,38,UCBPlayer
35306,UCBPlayer,87,212,299,0,67,UCBPlayer
35307,UCBPlayer,152,257,409,35,42,UCBPlayer
35308,UCBPlayer,84,224,308,0,64,UCBPlayer
35309,UCBPlayer,146,251,397,32,45,UCBPlayer
35310,UCBPlayer,89,234,323,3,60,UCBPlayer
35311,UCBPlayer,138,243,381,28,49,UCBPlayer
35312,UCBPlayer,97,242,339,7,56,UCBPlayer
35313,UCBPlayer,130,235,365,24,53,UCBPlayer
35314,UCBPlayer,105,250,355,11,52,UCBPlayer
35315,UCBPlayer,122,227,349,20,57,UCBPlayer
35316,UCBPlayer,109,259,368,15,49,UCBPlayer
35317,UCBPlayer,118,218,336,16,60,UCBPlayer
35318,UCBPlayer,117,267,384,19,45,UCBPlayer
35319,UCBPlayer,110,210,320,12,64,UCBPlayer
35320,UCBPlayer,126,271,397,23,42,UCBPlayer
35321,UCBPlayer,105,210,315,10,65,UCBPlayer
35322,UCBPlayer,130,275,405,25,40,UCBPlayer
35323,UCBPlayer,105,210,315,10,65,UCBPlayer
35324,UCBPlayer,130,275,405,25,40,UCBPlayer
35325,UCBPlayer,106,206,312,10,66,UCBPlayer
35326,UCBPlayer,130,275,405,25,40,UCBPlayer
35327,UCBPlayer,105,210,315,10,65,UCBPlayer
35328,UCBPlayer,131,271,402,25,41,UCBPlayer
35329,UCBPlayer,105,210,315,10,65,UCBPlayer
35330,UCBPlayer,130,275,405,25,40,UCBPlayer
35331,UCBPlayer,105,210,315,10,65,UCBPlayer
35332,UCBPlayer,130,275,405,25,40,UCBPlayer
35333,UCBPlayer,103,203,306,10,68,UCBPlayer
35334,UCBPlayer,128,283,411,25,38,UCBPlayer
35335,UCBPlayer,111,186,297,10,71,UCBPlayer
35336,UCBPlayer,124,299,423,25,34,UCBPlayer
35337,UCBPlayer,115,170,285,10,75,UCBPlayer
35338,UCBPlayer,120,315,435,25,30,UCBPlayer
35339,UCBPlayer,119,154,273,10,79,UCBPlayer
35340,UCBPlayer,112,332,444,25,27,UCBPlayer
35341,UCBPlayer,127,137,264,10,82,UCBPlayer
35342,UCBPlayer,104,349,453,25,24,UCBPlayer
35343,UCBPlayer,126,126,252,7,85,Tie
35344,UCBPlayer,111,351,462,28,22,UCBPlayer
35345,UCBPlayer,116,126,242,3,87,UCBPlayer
35346,UCBPlayer,122,347,469,32,21,UCBPlayer
35347,UCBPlayer,107,132,239,0,87,UCBPlayer
35348,UCBPlayer,132,337,469,35,22,UCBPlayer
35349,UCBPlayer,103,148,251,0,83,UCBPlayer
35350,UCBPlayer,136,321,457,35,26,UCBPlayer
35351,UCBPlayer,99,164,263,0,79,UCBPlayer
35352,UCBPlayer,140,305,445,35,30,UCBPlayer
35353,UCBPlayer,95,180,275,0,75,UCBPlayer
35354,UCBPlayer,144,289,433,35,34,UCBPlayer
35355,UCBPlayer,91,196,287,0,71,UCBPlayer
35356,UCBPlayer,148,273,421,35,38,UCBPlayer
35357,UCBPlayer,87,212,299,0,67,UCBPlayer
35358,UCBPlayer,152,257,409,35,42,UCBPlayer
35359,UCBPlayer,84,224,308,0,64,UCBPlayer
35360,UCBPlayer,146,251,397,32,45,UCBPlayer
35361,UCBPlayer,89,234,323,3,60,UCBPlayer
35362,UCBPlayer,138,243,381,28,49,UCBPlayer
35363,UCBPlayer,97,242,339,7,56,UCBPlayer
35364,UCBPlayer,130,235,365,24,53,UCBPlayer
35365,UCBPlayer,105,250,355,11,52,UCBPlayer
35366,UCBPlayer,122,227,349,20,57,UCBPlayer
35367,UCBPlayer,109,259,368,15,49,UCBPlayer
35368,UCBPlayer,118,218,336,16,60,UCBPlayer
35369,UCBPlayer,117,267,384,19,45,UCBPlayer
35370,UCBPlayer,110,210,320,12,64,UCBPlayer
35371,UCBPlayer,126,271,397,23,42,UCBPlayer
35372,UCBPlayer,105,210,315,10,65,UCBPlayer
35373,UCBPlayer,130,275,405,25,40,UCBPlayer
35374,UCBPlayer,105,210,315,10,65,UCBPlayer
35375,UCBPlayer,130,275,405,25,40,UCBPlayer
35376,UCBPlayer,106,206,312,10,66,UCBPlayer
35377,UCBPlayer,130,275,405,25,40,UCBPlayer
35378,UCBPlayer,105,210,315,10,65,UCBPlayer
35379,UCBPlayer,131,271,402,25,41,UCBPlayer
35380,UCBPlayer,105,210,315,10,65,UCBPlayer
35381,UCBPlayer,130,275,405,25,40,UCBPlayer
35382,UCBPlayer,105,210,315,10,65,UCBPlayer
35383,UCBPlayer,130,275,405,25,40,UCBPlayer
35384,UCBPlayer,103,203,306,10,68,UCBPlayer
35385,UCBPlayer,128,283,411,25,38,UCBPlayer
35386,UCBPlayer,111,186,297,10,71,UCBPlayer
35387,UCBPlayer,124,299,423,25,34,UCBPlayer
35388,UCBPlayer,115,170,285,10,75,UCBPlayer
35389,UCBPlayer,120,315,435,25,30,UCBPlayer
35390,UCBPlayer,119,154,273,10,79,UCBPlayer
35391,UCBPlayer,112,332,444,25,27,UCBPlayer
35392,UCBPlayer,127,137,264,10,82,UCBPlayer
35393,UCBPlayer,104,349,453,25,24,UCBPlayer
35394,UCBPlayer,126,126,252,7,85,Tie
35395,UCBPlayer,111,351,462,28,22,UCBPlayer
35396,UCBPlayer,116,126,242,3,87,UCBPlayer
35397,UCBPlayer,122,347,469,32,21,UCBPlayer
35398,UCBPlayer,107,132,239,0,87,UCBPlayer
35399,UCBPlayer,132,337,469,35,22,UCBPlayer
35400,UCBPlayer,103,148,251,0,83,UCBPlayer
35401,UCBPlayer,136,321,457,35,26,UCBPlayer
35402,UCBPlayer,99,164,263,0,79,UCBPlayer
35403,UCBPlayer,140,305,445,35,30,UCBPlayer
35404,UCBPlayer,95,180,275,0,75,UCBPlayer
35405,UCBPlayer,144,289,433,35,34,UCBPlayer
35406,UCBPlayer,91,196,287,0,71,UCBPlayer
35407,UCBPlayer,148,273,421,35,38,UCBPlayer
35408,UCBPlayer,87,212,299,0,67,UCBPlayer
35409,UCBPlayer,152,257,409,35,42,UCBPlayer
35410,UCBPlayer,84,224,308,0,64,UCBPlayer
35411,UCBPlayer,146,251,397,32,45,UCBPlayer
35412,UCBPlayer,89,234,323,3,60,UCBPlayer
35413,UCBPlayer,138,243,381,28,49,UCBPlayer
35414,UCBPlayer,97,242,339,7,56,UCBPlayer
35415,UCBPlayer,130,235,365,24,53,UCBPlayer
35416,UCBPlayer,105,250,355,11,52,UCBPlayer
35417,UCBPlayer,122,227,349,20,57,UCBPlayer
35418,UCBPlayer,109,259,368,15,49,UCBPlayer
35419,UCBPlayer,118,218,336,16,60,UCBPlayer
35420,UCBPlayer,117,267,384,19,45,UCBPlayer
35421,UCBPlayer,110,210,320,12,64,UCBPlayer
35422,UCBPlayer,126,271,397,23,42,UCBPlayer
35423,UCBPlayer,105,210,315,10,65,UCBPlayer
35424,UCBPlayer,130,275,405,25,40,UCBPlayer
35425,UCBPlayer,105,210,315,10,65,UCBPlayer
35426,UCBPlayer,130,275,405,25,40,UCBPlayer
35427,UCBPlayer,106,206,312,10,66,UCBPlayer
35428,UCBPlayer,130,275,405,25,40,UCBPlayer
35429,UCBPlayer,105,210,315,10,65,UCBPlayer
35430,UCBPlayer,131,271,402,25,41,UCBPlayer
35431,UCBPlayer,105,210,315,10,65,UCBPlayer
35432,UCBPlayer,130,275,405,25,40,UCBPlayer
35433,UCBPlayer,105,210,315,10,65,UCBPlayer
35434,UCBPlayer,130,275,405,25,40,UCBPlayer
35435,UCBPlayer,103,203,306,10,68,UCBPlayer
35436,UCBPlayer,128,283,411,25,38,UCBPlayer
35437,UCBPlayer,111,186,297,10,71,UCBPlayer
35438,UCBPlayer,124,299,423,25,34,UCBPlayer
35439,UCBPlayer,115,170,285,10,75,UCBPlayer
35440,UCBPlayer,120,315,435,25,30,UCBPlayer
35441,UCBPlayer,119,154,273,10,79,UCBPlayer
35442,UCBPlayer,112,332,444,25,27,UCBPlayer
35443,UCBPlayer,127,137,264,10,82,UCBPlayer
35444,UCBPlayer,104,349,453,25,24,UCBPlayer
35445,UCBPlayer,126,126,252,7,85,Tie
35446,UCBPlayer,111,351,462,28,22,UCBPlayer
35447,UCBPlayer,116,126,242,3,87,UCBPlayer
35448,UCBPlayer,122,347,469,32,21,UCBPlayer
35449,UCBPlayer,107,132,239,0,87,UCBPlayer
35450,UCBPlayer,132,337,469,35,22,UCBPlayer
35451,UCBPlayer,103,148,251,0,83,UCBPlayer
35452,UCBPlayer,136,321,457,35,26,UCBPlayer
35453,UCBPlayer,99,164,263,0,79,UCBPlayer
35454,UCBPlayer,140,305,445,35,30,UCBPlayer
35455,UCBPlayer,95,180,275,0,75,UCBPlayer
35456,UCBPlayer,144,289,433,35,34,UCBPlayer
35457,UCBPlayer,91,196,287,0,71,UCBPlayer
35458,UCBPlayer,148,273,421,35,38,UCBPlayer
35459,UCBPlayer,87,212,299,0,67,UCBPlayer
35460,UCBPlayer,152,257,409,35,42,UCBPlayer
35461,UCBPlayer,84,224,308,0,64,UCBPlayer
35462,UCBPlayer,146,251,397,32,45,UCBPlayer
35463,UCBPlayer,89,234,323,3,60,UCBPlayer
35464,UCBPlayer,138,243,381,28,49,UCBPlayer
35465,UCBPlayer,97,242,339,7,56,UCBPlayer
35466,UCBPlayer,130,235,365,24,53,UCBPlayer
35467,UCBPlayer,105,250,355,11,52,UCBPlayer
35468,UCBPlayer,122,227,349,20,57,UCBPlayer
35469,UCBPlayer,109,259,368,15,49,UCBPlayer
35470,UCBPlayer,118,218,336,16,60,UCBPlayer
35471,UCBPlayer,117,267,384,19,45,UCBPlayer
35472,UCBPlayer,110,210,320,12,64,UCBPlayer
35473,UCBPlayer,126,271,397,23,42,UCBPlayer
35474,UCBPlayer,105,210,315,10,65,UCBPlayer
35475,UCBPlayer,130,275,405,25,40,UCBPlayer
35476,UCBPlayer,105,210,315,10,65,UCBPlayer
35477,UCBPlayer,130,275,405,25,40,UCBPlayer
35478,UCBPlayer,106,206,312,10,66,UCBPlayer
35479,UCBPlayer,130,275,405,25,40,UCBPlayer
35480,UCBPlayer,105,210,315,10,65,UCBPlayer
35481,UCBPlayer,131,271,402,25,41,UCBPlayer
35482,UCBPlayer,105,210,315,10,65,UCBPlayer
35483,UCBPlayer,130,275,405,25,40,UCBPlayer
35484,UCBPlayer,105,210,315,10,65,UCBPlayer
35485,UCBPlayer,130,275,405,25,40,UCBPlayer
35486,UCBPlayer,103,203,306,10,68,UCBPlayer
35487,UCBPlayer,128,283,411,25,38,UCBPlayer
35488,UCBPlayer,111,186,297,10,71,UCBPlayer
35489,UCBPlayer,124,299,423,25,34,UCBPlayer
35490,UCBPlayer,115,170,285,10,75,UCBPlayer
35491,UCBPlayer,120,315,435,25,30,UCBPlayer
35492,UCBPlayer,119,154,273,10,79,UCBPlayer
35493,UCBPlayer,112,332,444,25,27,UCBPlayer
35494,UCBPlayer,127,137,264,10,82,UCBPlayer
35495,UCBPlayer,104,349,453,25,24,UCBPlayer
35496,UCBPlayer,126,126,252,7,85,Tie
35497,UCBPlayer,111,351,462,28,22,UCBPlayer
35498,UCBPlayer,116,126,242,3,87,UCBPlayer
35499,UCBPlayer,122,347,469,32,21,UCBPlayer
35500,UCBPlayer,107,132,239,0,87,UCBPlayer
35501,UCBPlayer,132,337,469,35,22,UCBPlayer
35502,UCBPlayer,103,148,251,0,83,UCBPlayer
35503,UCBPlayer,136,321,457,35,26,UCBPlayer
35504,UCBPlayer,99,164,263,0,79,UCBPlayer
35505,UCBPlayer,140,305,445,35,30,UCBPlayer
35506,UCBPlayer,95,180,275,0,75,UCBPlayer
35507,UCBPlayer,144,289,433,35,34,UCBPlayer
35508,UCBPlayer,91,196,287,0,71,UCBPlayer
35509,UCBPlayer,148,273,421,35,38,UCBPlayer
35510,UCBPlayer,87,212,299,0,67,UCBPlayer
35511,UCBPlayer,152,257,409,35,42,UCBPlayer
35512,UCBPlayer,84,224,308,0,64,UCBPlayer
35513,UCBPlayer,146,251,397,32,45,UCBPlayer
35514,UCBPlayer,89,234,323,3,60,UCBPlayer
35515,UCBPlayer,138,243,381,28,49,UCBPlayer
35516,UCBPlayer,97,242,339,7,56,UCBPlayer
35517,UCBPlayer,130,235,365,24,53,UCBPlayer
35518,UCBPlayer,105,250,355,11,52,UCBPlayer
35519,UCBPlayer,122,227,349,20,57,UCBPlayer
35520,UCBPlayer,109,259,368,15,49,UCBPlayer
35521,UCBPlayer,118,218,336,16,60,UCBPlayer
35522,UCBPlayer,117,267,384,19,45,UCBPlayer
35523,UCBPlayer,110,210,320,12,64,UCBPlayer
35524,UCBPlayer,126,271,397,23,42,UCBPlayer
35525,UCBPlayer,105,210,315,10,65,UCBPlayer
35526,UCBPlayer,130,275,405,25,40,UCBPlayer
35527,UCBPlayer,105,210,315,10,65,UCBPlayer
35528,UCBPlayer,130,275,405,25,40,UCBPlayer
35529,UCBPlayer,106,206,312,10,66,UCBPlayer
35530,UCBPlayer,130,275,405,25,40,UCBPlayer
35531,UCBPlayer,105,210,315,10,65,UCBPlayer
35532,UCBPlayer,131,271,402,25,41,UCBPlayer
35533,UCBPlayer,105,210,315,10,65,UCBPlayer
35534,UCBPlayer,130,275,405,25,40,UCBPlayer
35535,UCBPlayer,105,210,315,10,65,UCBPlayer
35536,UCBPlayer,130,275,405,25,40,UCBPlayer
35537,UCBPlayer,103,203,306,10,68,UCBPlayer
35538,UCBPlayer,128,283,411,25,38,UCBPlayer
35539,UCBPlayer,111,186,297,10,71,UCBPlayer
35540,UCBPlayer,124,299,423,25,34,UCBPlayer
35541,UCBPlayer,115,170,285,10,75,UCBPlayer
35542,UCBPlayer,120,315,435,25,30,UCBPlayer
35543,UCBPlayer,119,154,273,10,79,UCBPlayer
35544,UCBPlayer,112,332,444,25,27,UCBPlayer
35545,UCBPlayer,127,137,264,10,82,UCBPlayer
35546,UCBPlayer,104,349,453,25,24,UCBPlayer
35547,UCBPlayer,126,126,252,7,85,Tie
35548,UCBPlayer,111,351,462,28,22,UCBPlayer
35549,UCBPlayer,116,126,242,3,87,UCBPlayer
35550,UCBPlayer,122,347,469,32,21,UCBPlayer
35551,UCBPlayer,107,132,239,0,87,UCBPlayer
35552,UCBPlayer,132,337,469,35,22,UCBPlayer
35553,UCBPlayer,103,148,251,0,83,UCBPlayer
35554,UCBPlayer,136,321,457,35,26,UCBPlayer
35555,UCBPlayer,99,164,263,0,79,UCBPlayer
35556,UCBPlayer,140,305,445,35,30,UCBPlayer
35557,UCBPlayer,95,180,275,0,75,UCBPlayer
35558,UCBPlayer,144,289,433,35,34,UCBPlayer
35559,UCBPlayer,91,196,287,0,71,UCBPlayer
35560,UCBPlayer,148,273,421,35,38,UCBPlayer
35561,UCBPlayer,87,212,299,0,67,UCBPlayer
35562,UCBPlayer,152,257,409,35,42,UCBPlayer
35563,UCBPlayer,84,224,308,0,64,UCBPlayer
35564,UCBPlayer,146,251,397,32,45,UCBPlayer
35565,UCBPlayer,89,234,323,3,60,UCBPlayer
35566,UCBPlayer,138,243,381,28,49,UCBPlayer
35567,UCBPlayer,97,242,339,7,56,UCBPlayer
35568,UCBPlayer,130,235,365,24,53,UCBPlayer
35569,UCBPlayer,105,250,355,11,52,UCBPlayer
35570,UCBPlayer,122,227,349,20,57,UCBPlayer
35571,UCBPlayer,109,259,368,15,49,UCBPlayer
35572,UCBPlayer,118,218,336,16,60,UCBPlayer
35573,UCBPlayer,117,267,384,19,45,UCBPlayer
35574,UCBPlayer,110,210,320,12,64,UCBPlayer
35575,UCBPlayer,126,271,397,23,42,UCBPlayer
35576,UCBPlayer,105,210,315,10,65,UCBPlayer
35577,UCBPlayer,130,275,405,25,40,UCBPlayer
35578,UCBPlayer,105,210,315,10,65,UCBPlayer
35579,UCBPlayer,130,275,405,25,40,UCBPlayer
35580,UCBPlayer,106,206,312,10,66,UCBPlayer
35581,UCBPlayer,130,275,405,25,40,UCBPlayer
35582,UCBPlayer,105,210,315,10,65,UCBPlayer
35583,UCBPlayer,131,271,402,25,41,UCBPlayer
35584,UCBPlayer,105,210,315,10,65,UCBPlayer
35585,UCBPlayer,130,275,405,25,40,UCBPlayer
35586,UCBPlayer,105,210,315,10,65,UCBPlayer
35587,UCBPlayer,130,275,405,25,40,UCBPlayer
35588,UCBPlayer,103,203,306,10,68,UCBPlayer
35589,UCBPlayer,128,283,411,25,38,UCBPlayer
35590,UCBPlayer,111,186,297,10,71,UCBPlayer
35591,UCBPlayer,124,299,423,25,34,UCBPlayer
35592,UCBPlayer,115,170,285,10,75,UCBPlayer
35593,UCBPlayer,120,315,435,25,30,UCBPlayer
35594,UCBPlayer,119,154,273,10,79,UCBPlayer
35595,UCBPlayer,112,332,444,25,27,UCBPlayer
35596,UCBPlayer,127,137,264,10,82,UCBPlayer
35597,UCBPlayer,104,349,453,25,24,UCBPlayer
35598,UCBPlayer,126,126,252,7,85,Tie
35599,UCBPlayer,111,351,462,28,22,UCBPlayer
35600,UCBPlayer,116,126,242,3,87,UCBPlayer
35601,UCBPlayer,122,347,469,32,21,UCBPlayer
35602,UCBPlayer,107,132,239,0,87,UCBPlayer
35603,UCBPlayer,132,337,469,35,22,UCBPlayer
35604,UCBPlayer,103,148,251,0,83,UCBPlayer
35605,UCBPlayer,136,321,457,35,26,UCBPlayer
35606,UCBPlayer,99,164,263,0,79,UCBPlayer
35607,UCBPlayer,140,305,445,35,30,UCBPlayer
35608,UCBPlayer,95,180,275,0,75,UCBPlayer
35609,UCBPlayer,144,289,433,35,34,UCBPlayer
35610,UCBPlayer,91,196,287,0,71,UCBPlayer
35611,UCBPlayer,148,273,421,35,38,UCBPlayer
35612,UCBPlayer,87,212,299,0,67,UCBPlayer
35613,UCBPlayer,152,257,409,35,42,UCBPlayer
35614,UCBPlayer,84,224,308,0,64,UCBPlayer
35615,UCBPlayer,146,251,397,32,45,UCBPlayer
35616,UCBPlayer,89,234,323,3,60,UCBPlayer
35617,UCBPlayer,138,243,381,28,49,UCBPlayer
35618,UCBPlayer,97,242,339,7,56,UCBPlayer
35619,UCBPlayer,130,235,365,24,53,UCBPlayer
35620,UCBPlayer,105,250,355,11,52,UCBPlayer
35621,UCBPlayer,122,227,349,20,57,UCBPlayer
35622,UCBPlayer,109,259,368,15,49,UCBPlayer
35623,UCBPlayer,118,218,336,16,60,UCBPlayer
35624,UCBPlayer,117,267,384,19,45,UCBPlayer
35625,UCBPlayer,110,210,320,12,64,UCBPlayer
35626,UCBPlayer,126,271,397,23,42,UCBPlayer
35627,UCBPlayer,105,210,315,10,65,UCBPlayer
35628,UCBPlayer,130,275,405,25,40,UCBPlayer
35629,UCBPlayer,105,210,315,10,65,UCBPlayer
35630,UCBPlayer,130,275,405,25,40,UCBPlayer
35631,UCBPlayer,106,206,312,10,66,UCBPlayer
35632,UCBPlayer,130,275,405,25,40,UCBPlayer
35633,UCBPlayer,105,210,315,10,65,UCBPlayer
35634,UCBPlayer,131,271,402,25,41,UCBPlayer
35635,UCBPlayer,105,210,315,10,65,UCBPlayer
35636,UCBPlayer,130,275,405,25,40,UCBPlayer
35637,UCBPlayer,105,210,315,10,65,UCBPlayer
35638,UCBPlayer,130,275,405,25,40,UCBPlayer
35639,UCBPlayer,103,203,306,10,68,UCBPlayer
35640,UCBPlayer,128,283,411,25,38,UCBPlayer
35641,UCBPlayer,111,186,297,10,71,UCBPlayer
35642,UCBPlayer,124,299,423,25,34,UCBPlayer
35643,UCBPlayer,115,170,285,10,75,UCBPlayer
35644,UCBPlayer,120,315,435,25,30,UCBPlayer
35645,UCBPlayer,119,154,273,10,79,UCBPlayer
35646,UCBPlayer,112,332,444,25,27,UCBPlayer
35647,UCBPlayer,127,137,264,10,82,UCBPlayer
35648,UCBPlayer,104,349,453,25,24,UCBPlayer
35649,UCBPlayer,126,126,252,7,85,Tie
35650,UCBPlayer,111,351,462,28,22,UCBPlayer
35651,UCBPlayer,116,126,242,3,87,UCBPlayer
35652,UCBPlayer,122,347,469,32,21,UCBPlayer
35653,UCBPlayer,107,132,239,0,87,UCBPlayer
35654,UCBPlayer,132,337,469,35,22,UCBPlayer
35655,UCBPlayer,103,148,251,0,83,UCBPlayer
35656,UCBPlayer,136,321,457,35,26,UCBPlayer
35657,UCBPlayer,99,164,263,0,79,UCBPlayer
35658,UCBPlayer,140,305,445,35,30,UCBPlayer
35659,UCBPlayer,95,180,275,0,75,UCBPlayer
35660,UCBPlayer,144,289,433,35,34,UCBPlayer
35661,UCBPlayer,91,196,287,0,71,UCBPlayer
35662,UCBPlayer,148,273,421,35,38,UCBPlayer
35663,UCBPlayer,87,212,299,0,67,UCBPlayer
35664,UCBPlayer,152,257,409,35,42,UCBPlayer
35665,UCBPlayer,84,224,308,0,64,UCBPlayer
35666,UCBPlayer,146,251,397,32,45,UCBPlayer
35667,UCBPlayer,89,234,323,3,60,UCBPlayer
35668,UCBPlayer,138,243,381,28,49,UCBPlayer
35669,UCBPlayer,97,242,339,7,56,UCBPlayer
35670,UCBPlayer,130,235,365,24,53,UCBPlayer
35671,UCBPlayer,105,250,355,11,52,UCBPlayer
35672,UCBPlayer,122,227,349,20,57,UCBPlayer
35673,UCBPlayer,109,259,368,15,49,UCBPlayer
35674,UCBPlayer,118,218,336,16,60,UCBPlayer
35675,UCBPlayer,117,267,384,19,45,UCBPlayer
35676,UCBPlayer,110,210,320,12,64,UCBPlayer
35677,UCBPlayer,126,271,397,23,42,UCBPlayer
35678,UCBPlayer,105,210,315,10,65,UCBPlayer
35679,UCBPlayer,130,275,405,25,40,UCBPlayer
35680,UCBPlayer,105,210,315,10,65,UCBPlayer
35681,UCBPlayer,130,275,405,25,40,UCBPlayer
35682,UCBPlayer,106,206,312,10,66,UCBPlayer
35683,UCBPlayer,130,275,405,25,40,UCBPlayer
35684,UCBPlayer,105,210,315,10,65,UCBPlayer
35685,UCBPlayer,131,271,402,25,41,UCBPlayer
35686,UCBPlayer,105,210,315,10,65,UCBPlayer
35687,UCBPlayer,130,275,405,25,40,UCBPlayer
35688,UCBPlayer,105,210,315,10,65,UCBPlayer
35689,UCBPlayer,130,275,405,25,40,UCBPlayer
35690,UCBPlayer,103,203,306,10,68,UCBPlayer
35691,UCBPlayer,128,283,411,25,38,UCBPlayer
35692,UCBPlayer,111,186,297,10,71,UCBPlayer
35693,UCBPlayer,124,299,423,25,34,UCBPlayer
35694,UCBPlayer,115,170,285,10,75,UCBPlayer
35695,UCBPlayer,120,315,435,25,30,UCBPlayer
35696,UCBPlayer,119,154,273,10,79,UCBPlayer
35697,UCBPlayer,112,332,444,25,27,UCBPlayer
35698,UCBPlayer,127,137,264,10,82,UCBPlayer
35699,UCBPlayer,104,349,453,25,24,UCBPlayer
35700,UCBPlayer,126,126,252,7,85,Tie
35701,UCBPlayer,111,351,462,28,22,UCBPlayer
35702,UCBPlayer,116,126,242,3,87,UCBPlayer
35703,UCBPlayer,122,347,469,32,21,UCBPlayer
35704,UCBPlayer,107,132,239,0,87,UCBPlayer
35705,UCBPlayer,132,337,469,35,22,UCBPlayer
35706,UCBPlayer,103,148,251,0,83,UCBPlayer
35707,UCBPlayer,136,321,457,35,26,UCBPlayer
35708,UCBPlayer,99,164,263,0,79,UCBPlayer
35709,UCBPlayer,140,305,445,35,30,UCBPlayer
35710,UCBPlayer,95,180,275,0,75,UCBPlayer
35711,UCBPlayer,144,289,433,35,34,UCBPlayer
35712,UCBPlayer,91,196,287,0,71,UCBPlayer
35713,UCBPlayer,148,273,421,35,38,UCBPlayer
35714,UCBPlayer,87,212,299,0,67,UCBPlayer
35715,UCBPlayer,152,257,409,35,42,UCBPlayer
35716,UCBPlayer,84,224,308,0,64,UCBPlayer
35717,UCBPlayer,146,251,397,32,45,UCBPlayer
35718,UCBPlayer,89,234,323,3,60,UCBPlayer
35719,UCBPlayer,138,243,381,28,49,UCBPlayer
35720,UCBPlayer,97,242,339,7,56,UCBPlayer
35721,UCBPlayer,130,235,365,24,53,UCBPlayer
35722,UCBPlayer,105,250,355,11,52,UCBPlayer
35723,UCBPlayer,122,227,349,20,57,UCBPlayer
35724,UCBPlayer,109,259,368,15,49,UCBPlayer
35725,UCBPlayer,118,218,336,16,60,UCBPlayer
35726,UCBPlayer,117,267,384,19,45,UCBPlayer
35727,UCBPlayer,110,210,320,12,64,UCBPlayer
35728,UCBPlayer,126,271,397,23,42,UCBPlayer
35729,UCBPlayer,105,210,315,10,65,UCBPlayer
35730,UCBPlayer,130,275,405,25,40,UCBPlayer
35731,UCBPlayer,105,210,315,10,65,UCBPlayer
35732,UCBPlayer,130,275,405,25,40,UCBPlayer
35733,UCBPlayer,106,206,312,10,66,UCBPlayer
35734,UCBPlayer,130,275,405,25,40,UCBPlayer
35735,UCBPlayer,105,210,315,10,65,UCBPlayer
35736,UCBPlayer,131,271,402,25,41,UCBPlayer
35737,UCBPlayer,105,210,315,10,65,UCBPlayer
35738,UCBPlayer,130,275,405,25,40,UCBPlayer
35739,UCBPlayer,105,210,315,10,65,UCBPlayer
35740,UCBPlayer,130,275,405,25,40,UCBPlayer
35741,UCBPlayer,103,203,306,10,68,UCBPlayer
35742,UCBPlayer,128,283,411,25,38,UCBPlayer
35743,UCBPlayer,111,186,297,10,71,UCBPlayer
35744,UCBPlayer,124,299,423,25,34,UCBPlayer
35745,UCBPlayer,115,170,285,10,75,UCBPlayer
35746,UCBPlayer,120,315,435,25,30,UCBPlayer
35747,UCBPlayer,119,154,273,10,79,UCBPlayer
35748,UCBPlayer,112,332,444,25,27,UCBPlayer
35749,UCBPlayer,127,137,264,10,82,UCBPlayer
35750,UCBPlayer,104,349,453,25,24,UCBPlayer
35751,UCBPlayer,126,126,252,7,85,Tie
35752,UCBPlayer,111,351,462,28,22,UCBPlayer
35753,UCBPlayer,116,126,242,3,87,UCBPlayer
35754,UCBPlayer,122,347,469,32,21,UCBPlayer
35755,UCBPlayer,107,132,239,0,87,UCBPlayer
35756,UCBPlayer,132,337,469,35,22,UCBPlayer
35757,UCBPlayer,103,148,251,0,83,UCBPlayer
35758,UCBPlayer,136,321,457,35,26,UCBPlayer
35759,UCBPlayer,99,164,263,0,79,UCBPlayer
35760,UCBPlayer,140,305,445,35,30,UCBPlayer
35761,UCBPlayer,95,180,275,0,75,UCBPlayer
35762,UCBPlayer,144,289,433,35,34,UCBPlayer
35763,UCBPlayer,91,196,287,0,71,UCBPlayer
35764,UCBPlayer,148,273,421,35,38,UCBPlayer
35765,UCBPlayer,87,212,299,0,67,UCBPlayer
35766,UCBPlayer,152,257,409,35,42,UCBPlayer
35767,UCBPlayer,84,224,308,0,64,UCBPlayer
35768,UCBPlayer,146,251,397,32,45,UCBPlayer
35769,UCBPlayer,89,234,323,3,60,UCBPlayer
35770,UCBPlayer,138,243,381,28,49,UCBPlayer
35771,UCBPlayer,97,242,339,7,56,UCBPlayer
35772,UCBPlayer,130,235,365,24,53,UCBPlayer
35773,UCBPlayer,105,250,355,11,52,UCBPlayer
35774,UCBPlayer,122,227,349,20,57,UCBPlayer
35775,UCBPlayer,109,259,368,15,49,UCBPlayer
35776,UCBPlayer,118,218,336,16,60,UCBPlayer
35777,UCBPlayer,117,267,384,19,45,UCBPlayer
35778,UCBPlayer,110,210,320,12,64,UCBPlayer
35779,UCBPlayer,126,271,397,23,42,UCBPlayer
35780,UCBPlayer,105,210,315,10,65,UCBPlayer
35781,UCBPlayer,130,275,405,25,40,UCBPlayer
35782,UCBPlayer,105,210,315,10,65,UCBPlayer
35783,UCBPlayer,130,275,405,25,40,UCBPlayer
35784,UCBPlayer,106,206,312,10,66,UCBPlayer
35785,UCBPlayer,130,275,405,25,40,UCBPlayer
35786,UCBPlayer,105,210,315,10,65,UCBPlayer
35787,UCBPlayer,131,271,402,25,41,UCBPlayer
35788,UCBPlayer,105,210,315,10,65,UCBPlayer
35789,UCBPlayer,130,275,405,25,40,UCBPlayer
35790,UCBPlayer,105,210,315,10,65,UCBPlayer
35791,UCBPlayer,130,275,405,25,40,UCBPlayer
35792,UCBPlayer,103,203,306,10,68,UCBPlayer
35793,UCBPlayer,128,283,411,25,38,UCBPlayer
35794,UCBPlayer,111,186,297,10,71,UCBPlayer
35795,UCBPlayer,124,299,423,25,34,UCBPlayer
35796,UCBPlayer,115,170,285,10,75,UCBPlayer
35797,UCBPlayer,120,315,435,25,30,UCBPlayer
35798,UCBPlayer,119,154,273,10,79,UCBPlayer
35799,UCBPlayer,112,332,444,25,27,UCBPlayer
35800,UCBPlayer,127,137,264,10,82,UCBPlayer
35801,UCBPlayer,104,349,453,25,24,UCBPlayer
35802,UCBPlayer,126,126,252,7,85,Tie
35803,UCBPlayer,111,351,462,28,22,UCBPlayer
35804,UCBPlayer,116,126,242,3,87,UCBPlayer
35805,UCBPlayer,122,347,469,32,21,UCBPlayer
35806,UCBPlayer,107,132,239,0,87,UCBPlayer
35807,UCBPlayer,132,337,469,35,22,UCBPlayer
35808,UCBPlayer,103,148,251,0,83,UCBPlayer
35809,UCBPlayer,136,321,457,35,26,UCBPlayer
35810,UCBPlayer,99,164,263,0,79,UCBPlayer
35811,UCBPlayer,140,305,445,35,30,UCBPlayer
35812,UCBPlayer,95,180,275,0,75,UCBPlayer
35813,UCBPlayer,144,289,433,35,34,UCBPlayer
35814,UCBPlayer,91,196,287,0,71,UCBPlayer
35815,UCBPlayer,148,273,421,35,38,UCBPlayer
35816,UCBPlayer,87,212,299,0,67,UCBPlayer
35817,UCBPlayer,152,257,409,35,42,UCBPlayer
35818,UCBPlayer,84,224,308,0,64,UCBPlayer
35819,UCBPlayer,146,251,397,32,45,UCBPlayer
35820,UCBPlayer,89,234,323,3,60,UCBPlayer
35821,UCBPlayer,138,243,381,28,49,UCBPlayer
35822,UCBPlayer,97,242,339,7,56,UCBPlayer
35823,UCBPlayer,130,235,365,24,53,UCBPlayer
35824,UCBPlayer,105,250,355,11,52,UCBPlayer
35825,UCBPlayer,122,227,349,20,57,UCBPlayer
35826,UCBPlayer,109,259,368,15,49,UCBPlayer
35827,UCBPlayer,118,218,336,16,60,UCBPlayer
35828,UCBPlayer,117,267,384,19,45,UCBPlayer
35829,UCBPlayer,110,210,320,12,64,UCBPlayer
35830,UCBPlayer,126,271,397,23,42,UCBPlayer
35831,UCBPlayer,105,210,315,10,65,UCBPlayer
35832,UCBPlayer,130,275,405,25,40,UCBPlayer
35833,UCBPlayer,105,210,315,10,65,UCBPlayer
35834,UCBPlayer,130,275,405,25,40,UCBPlayer
35835,UCBPlayer,106,206,312,10,66,UCBPlayer
35836,UCBPlayer,130,275,405,25,40,UCBPlayer
35837,UCBPlayer,105,210,315,10,65,UCBPlayer
35838,UCBPlayer,131,271,402,25,41,UCBPlayer
35839,UCBPlayer,105,210,315,10,65,UCBPlayer
35840,UCBPlayer,130,275,405,25,40,UCBPlayer
35841,UCBPlayer,105,210,315,10,65,UCBPlayer
35842,UCBPlayer,130,275,405,25,40,UCBPlayer
35843,UCBPlayer,103,203,306,10,68,UCBPlayer
35844,UCBPlayer,128,283,411,25,38,UCBPlayer
35845,UCBPlayer,111,186,297,10,71,UCBPlayer
35846,UCBPlayer,124,299,423,25,34,UCBPlayer
35847,UCBPlayer,115,170,285,10,75,UCBPlayer
35848,UCBPlayer,120,315,435,25,30,UCBPlayer
35849,UCBPlayer,119,154,273,10,79,UCBPlayer
35850,UCBPlayer,112,332,444,25,27,UCBPlayer
35851,UCBPlayer,127,137,264,10,82,UCBPlayer
35852,UCBPlayer,104,349,453,25,24,UCBPlayer
35853,UCBPlayer,126,126,252,7,85,Tie
35854,UCBPlayer,111,351,462,28,22,UCBPlayer
35855,UCBPlayer,116,126,242,3,87,UCBPlayer
35856,UCBPlayer,122,347,469,32,21,UCBPlayer
35857,UCBPlayer,107,132,239,0,87,UCBPlayer
35858,UCBPlayer,132,337,469,35,22,UCBPlayer
35859,UCBPlayer,103,148,251,0,83,UCBPlayer
35860,UCBPlayer,136,321,457,35,26,UCBPlayer
35861,UCBPlayer,99,164,263,0,79,UCBPlayer
35862,UCBPlayer,140,305,445,35,30,UCBPlayer
35863,UCBPlayer,95,180,275,0,75,UCBPlayer
35864,UCBPlayer,144,289,433,35,34,UCBPlayer
35865,UCBPlayer,91,196,287,0,71,UCBPlayer
35866,UCBPlayer,148,273,421,35,38,UCBPlayer
35867,UCBPlayer,87,212,299,0,67,UCBPlayer
35868,UCBPlayer,152,257,409,35,42,UCBPlayer
35869,UCBPlayer,84,224,308,0,64,UCBPlayer
35870,UCBPlayer,146,251,397,32,45,UCBPlayer
35871,UCBPlayer,89,234,323,3,60,UCBPlayer
35872,UCBPlayer,138,243,381,28,49,UCBPlayer
35873,UCBPlayer,97,242,339,7,56,UCBPlayer
35874,UCBPlayer,130,235,365,24,53,UCBPlayer
35875,UCBPlayer,105,250,355,11,52,UCBPlayer
35876,UCBPlayer,122,227,349,20,57,UCBPlayer
35877,UCBPlayer,109,259,368,15,49,UCBPlayer
35878,UCBPlayer,118,218,336,16,60,UCBPlayer
35879,UCBPlayer,117,267,384,19,45,UCBPlayer
35880,UCBPlayer,110,210,320,12,64,UCBPlayer
35881,UCBPlayer,126,271,397,23,42,UCBPlayer
35882,UCBPlayer,105,210,315,10,65,UCBPlayer
35883,UCBPlayer,130,275,405,25,40,UCBPlayer
35884,UCBPlayer,105,210,315,10,65,UCBPlayer
35885,UCBPlayer,130,275,405,25,40,UCBPlayer
35886,UCBPlayer,106,206,312,10,66,UCBPlayer
35887,UCBPlayer,130,275,405,25,40,UCBPlayer
35888,UCBPlayer,105,210,315,10,65,UCBPlayer
35889,UCBPlayer,131,271,402,25,41,UCBPlayer
35890,UCBPlayer,105,210,315,10,65,UCBPlayer
35891,UCBPlayer,130,275,405,25,40,UCBPlayer
35892,UCBPlayer,105,210,315,10,65,UCBPlayer
35893,UCBPlayer,130,275,405,25,40,UCBPlayer
35894,UCBPlayer,103,203,306,10,68,UCBPlayer
35895,UCBPlayer,128,283,411,25,38,UCBPlayer
35896,UCBPlayer,111,186,297,10,71,UCBPlayer
35897,UCBPlayer,124,299,423,25,34,UCBPlayer
35898,UCBPlayer,115,170,285,10,75,UCBPlayer
35899,UCBPlayer,120,315,435,25,30,UCBPlayer
35900,UCBPlayer,119,154,273,10,79,UCBPlayer
35901,UCBPlayer,112,332,444,25,27,UCBPlayer
35902,UCBPlayer,127,137,264,10,82,UCBPlayer
35903,UCBPlayer,104,349,453,25,24,UCBPlayer
35904,UCBPlayer,126,126,252,7,85,Tie
35905,UCBPlayer,111,351,462,28,22,UCBPlayer
35906,UCBPlayer,116,126,242,3,87,UCBPlayer
35907,UCBPlayer,122,347,469,32,21,UCBPlayer
35908,UCBPlayer,107,132,239,0,87,UCBPlayer
35909,UCBPlayer,132,337,469,35,22,UCBPlayer
35910,UCBPlayer,103,148,251,0,83,UCBPlayer
35911,UCBPlayer,136,321,457,35,26,UCBPlayer
35912,UCBPlayer,99,164,263,0,79,UCBPlayer
35913,UCBPlayer,140,305,445,35,30,UCBPlayer
35914,UCBPlayer,95,180,275,0,75,UCBPlayer
35915,UCBPlayer,144,289,433,35,34,UCBPlayer
35916,UCBPlayer,91,196,287,0,71,UCBPlayer
35917,UCBPlayer,148,273,421,35,38,UCBPlayer
35918,UCBPlayer,87,212,299,0,67,UCBPlayer
35919,UCBPlayer,152,257,409,35,42,UCBPlayer
35920,UCBPlayer,84,224,308,0,64,UCBPlayer
35921,UCBPlayer,146,251,397,32,45,UCBPlayer
35922,UCBPlayer,89,234,323,3,60,UCBPlayer
35923,UCBPlayer,138,243,381,28,49,UCBPlayer
35924,UCBPlayer,97,242,339,7,56,UCBPlayer
35925,UCBPlayer,130,235,365,24,53,UCBPlayer
35926,UCBPlayer,105,250,355,11,52,UCBPlayer
35927,UCBPlayer,122,227,349,20,57,UCBPlayer
35928,UCBPlayer,109,259,368,15,49,UCBPlayer
35929,UCBPlayer,118,218,336,16,60,UCBPlayer
35930,UCBPlayer,117,267,384,19,45,UCBPlayer
35931,UCBPlayer,110,210,320,12,64,UCBPlayer
35932,UCBPlayer,126,271,397,23,42,UCBPlayer
35933,UCBPlayer,105,210,315,10,65,UCBPlayer
35934,UCBPlayer,130,275,405,25,40,UCBPlayer
35935,UCBPlayer,105,210,315,10,65,UCBPlayer
35936,UCBPlayer,130,275,405,25,40,UCBPlayer
35937,UCBPlayer,106,206,312,10,66,UCBPlayer
35938,UCBPlayer,130,275,405,25,40,UCBPlayer
35939,UCBPlayer,105,210,315,10,65,UCBPlayer
35940,UCBPlayer,131,271,402,25,41,UCBPlayer
35941,UCBPlayer,105,210,315,10,65,UCBPlayer
35942,UCBPlayer,130,275,405,25,40,UCBPlayer
35943,UCBPlayer,105,210,315,10,65,UCBPlayer
35944,UCBPlayer,130,275,405,25,40,UCBPlayer
35945,UCBPlayer,103,203,306,10,68,UCBPlayer
35946,UCBPlayer,128,283,411,25,38,UCBPlayer
35947,UCBPlayer,111,186,297,10,71,UCBPlayer
35948,UCBPlayer,124,299,423,25,34,UCBPlayer
35949,UCBPlayer,115,170,285,10,75,UCBPlayer
35950,UCBPlayer,120,315,435,25,30,UCBPlayer
35951,UCBPlayer,119,154,273,10,79,UCBPlayer
35952,UCBPlayer,112,332,444,25,27,UCBPlayer
35953,UCBPlayer,127,137,264,10,82,UCBPlayer
35954,UCBPlayer,104,349,453,25,24,UCBPlayer
35955,UCBPlayer,126,126,252,7,85,Tie
35956,UCBPlayer,111,351,462,28,22,UCBPlayer
35957,UCBPlayer,116,126,242,3,87,UCBPlayer
35958,UCBPlayer,122,347,469,32,21,UCBPlayer
35959,UCBPlayer,107,132,239,0,87,UCBPlayer
35960,UCBPlayer,132,337,469,35,22,UCBPlayer
35961,UCBPlayer,103,148,251,0,83,UCBPlayer
35962,UCBPlayer,136,321,457,35,26,UCBPlayer
35963,UCBPlayer,99,164,263,0,79,UCBPlayer
35964,UCBPlayer,140,305,445,35,30,UCBPlayer
35965,UCBPlayer,95,180,275,0,75,UCBPlayer
35966,UCBPlayer,144,289,433,35,34,UCBPlayer
35967,UCBPlayer,91,196,287,0,71,UCBPlayer
35968,UCBPlayer,148,273,421,35,38,UCBPlayer
35969,UCBPlayer,87,212,299,0,67,UCBPlayer
35970,UCBPlayer,152,257,409,35,42,UCBPlayer
35971,UCBPlayer,84,224,308,0,64,UCBPlayer
35972,UCBPlayer,146,251,397,32,45,UCBPlayer
35973,UCBPlayer,89,234,323,3,60,UCBPlayer
35974,UCBPlayer,138,243,381,28,49,UCBPlayer
35975,UCBPlayer,97,242,339,7,56,UCBPlayer
35976,UCBPlayer,130,235,365,24,53,UCBPlayer
35977,UCBPlayer,105,250,355,11,52,UCBPlayer
35978,UCBPlayer,122,227,349,20,57,UCBPlayer
35979,UCBPlayer,109,259,368,15,49,UCBPlayer
35980,UCBPlayer,118,218,336,16,60,UCBPlayer
35981,UCBPlayer,117,267,384,19,45,UCBPlayer
35982,UCBPlayer,110,210,320,12,64,UCBPlayer
35983,UCBPlayer,126,271,397,23,42,UCBPlayer
35984,UCBPlayer,105,210,315,10,65,UCBPlayer
35985,UCBPlayer,130,275,405,25,40,UCBPlayer
35986,UCBPlayer,105,210,315,10,65,UCBPlayer
35987,UCBPlayer,130,275,405,25,40,UCBPlayer
35988,UCBPlayer,106,206,312,10,66,UCBPlayer
35989,UCBPlayer,130,275,405,25,40,UCBPlayer
35990,UCBPlayer,105,210,315,10,65,UCBPlayer
35991,UCBPlayer,131,271,402,25,41,UCBPlayer
35992,UCBPlayer,105,210,315,10,65,UCBPlayer
35993,UCBPlayer,130,275,405,25,40,UCBPlayer
35994,UCBPlayer,105,210,315,10,65,UCBPlayer
35995,UCBPlayer,130,275,405,25,40,UCBPlayer
35996,UCBPlayer,103,203,306,10,68,UCBPlayer
35997,UCBPlayer,128,283,411,25,38,UCBPlayer
35998,UCBPlayer,111,186,297,10,71,UCBPlayer
35999,UCBPlayer,124,299,423,25,34,UCBPlayer
36000,UCBPlayer,115,170,285,10,75,UCBPlayer
36001,UCBPlayer,120,315,435,25,30,UCBPlayer
36002,UCBPlayer,119,154,273,10,79,UCBPlayer
36003,UCBPlayer,112,332,444,25,27,UCBPlayer
36004,UCBPlayer,127,137,264,10,82,UCBPlayer
36005,UCBPlayer,104,349,453,25,24,UCBPlayer
36006,UCBPlayer,126,126,252,7,85,Tie
36007,UCBPlayer,111,351,462,28,22,UCBPlayer
36008,UCBPlayer,116,126,242,3,87,UCBPlayer
36009,UCBPlayer,122,347,469,32,21,UCBPlayer
36010,UCBPlayer,107,132,239,0,87,UCBPlayer
36011,UCBPlayer,132,337,469,35,22,UCBPlayer
36012,UCBPlayer,103,148,251,0,83,UCBPlayer
36013,UCBPlayer,136,321,457,35,26,UCBPlayer
36014,UCBPlayer,99,164,263,0,79,UCBPlayer
36015,UCBPlayer,140,305,445,35,30,UCBPlayer
36016,UCBPlayer,95,180,275,0,75,UCBPlayer
36017,UCBPlayer,144,289,433,35,34,UCBPlayer
36018,UCBPlayer,91,196,287,0,71,UCBPlayer
36019,UCBPlayer,148,273,421,35,38,UCBPlayer
36020,UCBPlayer,87,212,299,0,67,UCBPlayer
36021,UCBPlayer,152,257,409,35,42,UCBPlayer
36022,UCBPlayer,84,224,308,0,64,UCBPlayer
36023,UCBPlayer,146,251,397,32,45,UCBPlayer
36024,UCBPlayer,89,234,323,3,60,UCBPlayer
36025,UCBPlayer,138,243,381,28,49,UCBPlayer
36026,UCBPlayer,97,242,339,7,56,UCBPlayer
36027,UCBPlayer,130,235,365,24,53,UCBPlayer
36028,UCBPlayer,105,250,355,11,52,UCBPlayer
36029,UCBPlayer,122,227,349,20,57,UCBPlayer
36030,UCBPlayer,109,259,368,15,49,UCBPlayer
36031,UCBPlayer,118,218,336,16,60,UCBPlayer
36032,UCBPlayer,117,267,384,19,45,UCBPlayer
36033,UCBPlayer,110,210,320,12,64,UCBPlayer
36034,UCBPlayer,126,271,397,23,42,UCBPlayer
36035,UCBPlayer,105,210,315,10,65,UCBPlayer
36036,UCBPlayer,130,275,405,25,40,UCBPlayer
36037,UCBPlayer,105,210,315,10,65,UCBPlayer
36038,UCBPlayer,130,275,405,25,40,UCBPlayer
36039,UCBPlayer,106,206,312,10,66,UCBPlayer
36040,UCBPlayer,130,275,405,25,40,UCBPlayer
36041,UCBPlayer,105,210,315,10,65,UCBPlayer
36042,UCBPlayer,131,271,402,25,41,UCBPlayer
36043,UCBPlayer,105,210,315,10,65,UCBPlayer
36044,UCBPlayer,130,275,405,25,40,UCBPlayer
36045,UCBPlayer,105,210,315,10,65,UCBPlayer
36046,UCBPlayer,130,275,405,25,40,UCBPlayer
36047,UCBPlayer,103,203,306,10,68,UCBPlayer
36048,UCBPlayer,128,283,411,25,38,UCBPlayer
36049,UCBPlayer,111,186,297,10,71,UCBPlayer
36050,UCBPlayer,124,299,423,25,34,UCBPlayer
36051,UCBPlayer,115,170,285,10,75,UCBPlayer
36052,UCBPlayer,120,315,435,25,30,UCBPlayer
36053,UCBPlayer,119,154,273,10,79,UCBPlayer
36054,UCBPlayer,112,332,444,25,27,UCBPlayer
36055,UCBPlayer,127,137,264,10,82,UCBPlayer
36056,UCBPlayer,104,349,453,25,24,UCBPlayer
36057,UCBPlayer,126,126,252,7,85,Tie
36058,UCBPlayer,111,351,462,28,22,UCBPlayer
36059,UCBPlayer,116,126,242,3,87,UCBPlayer
36060,UCBPlayer,122,347,469,32,21,UCBPlayer
36061,UCBPlayer,107,132,239,0,87,UCBPlayer
36062,UCBPlayer,132,337,469,35,22,UCBPlayer
36063,UCBPlayer,103,148,251,0,83,UCBPlayer
36064,UCBPlayer,136,321,457,35,26,UCBPlayer
36065,UCBPlayer,99,164,263,0,79,UCBPlayer
36066,UCBPlayer,140,305,445,35,30,UCBPlayer
36067,UCBPlayer,95,180,275,0,75,UCBPlayer
36068,UCBPlayer,144,289,433,35,34,UCBPlayer
36069,UCBPlayer,91,196,287,0,71,UCBPlayer
36070,UCBPlayer,148,273,421,35,38,UCBPlayer
36071,UCBPlayer,87,212,299,0,67,UCBPlayer
36072,UCBPlayer,152,257,409,35,42,UCBPlayer
36073,UCBPlayer,84,224,308,0,64,UCBPlayer
36074,UCBPlayer,146,251,397,32,45,UCBPlayer
36075,UCBPlayer,89,234,323,3,60,UCBPlayer
36076,UCBPlayer,138,243,381,28,49,UCBPlayer
36077,UCBPlayer,97,242,339,7,56,UCBPlayer
36078,UCBPlayer,130,235,365,24,53,UCBPlayer
36079,UCBPlayer,105,250,355,11,52,UCBPlayer
36080,UCBPlayer,122,227,349,20,57,UCBPlayer
36081,UCBPlayer,109,259,368,15,49,UCBPlayer
36082,UCBPlayer,118,218,336,16,60,UCBPlayer
36083,UCBPlayer,117,267,384,19,45,UCBPlayer
36084,UCBPlayer,110,210,320,12,64,UCBPlayer
36085,UCBPlayer,126,271,397,23,42,UCBPlayer
36086,UCBPlayer,105,210,315,10,65,UCBPlayer
36087,UCBPlayer,130,275,405,25,40,UCBPlayer
36088,UCBPlayer,105,210,315,10,65,UCBPlayer
36089,UCBPlayer,130,275,405,25,40,UCBPlayer
36090,UCBPlayer,106,206,312,10,66,UCBPlayer
36091,UCBPlayer,130,275,405,25,40,UCBPlayer
36092,UCBPlayer,105,210,315,10,65,UCBPlayer
36093,UCBPlayer,131,271,402,25,41,UCBPlayer
36094,UCBPlayer,105,210,315,10,65,UCBPlayer
36095,UCBPlayer,130,275,405,25,40,UCBPlayer
36096,UCBPlayer,105,210,315,10,65,UCBPlayer
36097,UCBPlayer,130,275,405,25,40,UCBPlayer
36098,UCBPlayer,103,203,306,10,68,UCBPlayer
36099,UCBPlayer,128,283,411,25,38,UCBPlayer
36100,UCBPlayer,111,186,297,10,71,UCBPlayer
36101,UCBPlayer,124,299,423,25,34,UCBPlayer
36102,UCBPlayer,115,170,285,10,75,UCBPlayer
36103,UCBPlayer,120,315,435,25,30,UCBPlayer
36104,UCBPlayer,119,154,273,10,79,UCBPlayer
36105,UCBPlayer,112,332,444,25,27,UCBPlayer
36106,UCBPlayer,127,137,264,10,82,UCBPlayer
36107,UCBPlayer,104,349,453,25,24,UCBPlayer
36108,UCBPlayer,126,126,252,7,85,Tie
36109,UCBPlayer,111,351,462,28,22,UCBPlayer
36110,UCBPlayer,116,126,242,3,87,UCBPlayer
36111,UCBPlayer,122,347,469,32,21,UCBPlayer
36112,UCBPlayer,107,132,239,0,87,UCBPlayer
36113,UCBPlayer,132,337,469,35,22,UCBPlayer
36114,UCBPlayer,103,148,251,0,83,UCBPlayer
36115,UCBPlayer,136,321,457,35,26,UCBPlayer
36116,UCBPlayer,99,164,263,0,79,UCBPlayer
36117,UCBPlayer,140,305,445,35,30,UCBPlayer
36118,UCBPlayer,95,180,275,0,75,UCBPlayer
36119,UCBPlayer,144,289,433,35,34,UCBPlayer
36120,UCBPlayer,91,196,287,0,71,UCBPlayer
36121,UCBPlayer,148,273,421,35,38,UCBPlayer
36122,UCBPlayer,87,212,299,0,67,UCBPlayer
36123,UCBPlayer,152,257,409,35,42,UCBPlayer
36124,UCBPlayer,84,224,308,0,64,UCBPlayer
36125,UCBPlayer,146,251,397,32,45,UCBPlayer
36126,UCBPlayer,89,234,323,3,60,UCBPlayer
36127,UCBPlayer,138,243,381,28,49,UCBPlayer
36128,UCBPlayer,97,242,339,7,56,UCBPlayer
36129,UCBPlayer,130,235,365,24,53,UCBPlayer
36130,UCBPlayer,105,250,355,11,52,UCBPlayer
36131,UCBPlayer,122,227,349,20,57,UCBPlayer
36132,UCBPlayer,109,259,368,15,49,UCBPlayer
36133,UCBPlayer,118,218,336,16,60,UCBPlayer
36134,UCBPlayer,117,267,384,19,45,UCBPlayer
36135,UCBPlayer,110,210,320,12,64,UCBPlayer
36136,UCBPlayer,126,271,397,23,42,UCBPlayer
36137,UCBPlayer,105,210,315,10,65,UCBPlayer
36138,UCBPlayer,130,275,405,25,40,UCBPlayer
36139,UCBPlayer,105,210,315,10,65,UCBPlayer
36140,UCBPlayer,130,275,405,25,40,UCBPlayer
36141,UCBPlayer,106,206,312,10,66,UCBPlayer
36142,UCBPlayer,130,275,405,25,40,UCBPlayer
36143,UCBPlayer,105,210,315,10,65,UCBPlayer
36144,UCBPlayer,131,271,402,25,41,UCBPlayer
36145,UCBPlayer,105,210,315,10,65,UCBPlayer
36146,UCBPlayer,130,275,405,25,40,UCBPlayer
36147,UCBPlayer,105,210,315,10,65,UCBPlayer
36148,UCBPlayer,130,275,405,25,40,UCBPlayer
36149,UCBPlayer,103,203,306,10,68,UCBPlayer
36150,UCBPlayer,128,283,411,25,38,UCBPlayer
36151,UCBPlayer,111,186,297,10,71,UCBPlayer
36152,UCBPlayer,124,299,423,25,34,UCBPlayer
36153,UCBPlayer,115,170,285,10,75,UCBPlayer
36154,UCBPlayer,120,315,435,25,30,UCBPlayer
36155,UCBPlayer,119,154,273,10,79,UCBPlayer
36156,UCBPlayer,112,332,444,25,27,UCBPlayer
36157,UCBPlayer,127,137,264,10,82,UCBPlayer
36158,UCBPlayer,104,349,453,25,24,UCBPlayer
36159,UCBPlayer,126,126,252,7,85,Tie
36160,UCBPlayer,111,351,462,28,22,UCBPlayer
36161,UCBPlayer,116,126,242,3,87,UCBPlayer
36162,UCBPlayer,122,347,469,32,21,UCBPlayer
36163,UCBPlayer,107,132,239,0,87,UCBPlayer
36164,UCBPlayer,132,337,469,35,22,UCBPlayer
36165,UCBPlayer,103,148,251,0,83,UCBPlayer
36166,UCBPlayer,136,321,457,35,26,UCBPlayer
36167,UCBPlayer,99,164,263,0,79,UCBPlayer
36168,UCBPlayer,140,305,445,35,30,UCBPlayer
36169,UCBPlayer,95,180,275,0,75,UCBPlayer
36170,UCBPlayer,144,289,433,35,34,UCBPlayer
36171,UCBPlayer,91,196,287,0,71,UCBPlayer
36172,UCBPlayer,148,273,421,35,38,UCBPlayer
36173,UCBPlayer,87,212,299,0,67,UCBPlayer
36174,UCBPlayer,152,257,409,35,42,UCBPlayer
36175,UCBPlayer,84,224,308,0,64,UCBPlayer
36176,UCBPlayer,146,251,397,32,45,UCBPlayer
36177,UCBPlayer,89,234,323,3,60,UCBPlayer
36178,UCBPlayer,138,243,381,28,49,UCBPlayer
36179,UCBPlayer,97,242,339,7,56,UCBPlayer
36180,UCBPlayer,130,235,365,24,53,UCBPlayer
36181,UCBPlayer,105,250,355,11,52,UCBPlayer
36182,UCBPlayer,122,227,349,20,57,UCBPlayer
36183,UCBPlayer,109,259,368,15,49,UCBPlayer
36184,UCBPlayer,118,218,336,16,60,UCBPlayer
36185,UCBPlayer,117,267,384,19,45,UCBPlayer
36186,UCBPlayer,110,210,320,12,64,UCBPlayer
36187,UCBPlayer,126,271,397,23,42,UCBPlayer
36188,UCBPlayer,105,210,315,10,65,UCBPlayer
36189,UCBPlayer,130,275,405,25,40,UCBPlayer
36190,UCBPlayer,105,210,315,10,65,UCBPlayer
36191,UCBPlayer,130,275,405,25,40,UCBPlayer
36192,UCBPlayer,106,206,312,10,66,UCBPlayer
36193,UCBPlayer,130,275,405,25,40,UCBPlayer
36194,UCBPlayer,105,210,315,10,65,UCBPlayer
36195,UCBPlayer,131,271,402,25,41,UCBPlayer
36196,UCBPlayer,105,210,315,10,65,UCBPlayer
36197,UCBPlayer,130,275,405,25,40,UCBPlayer
36198,UCBPlayer,105,210,315,10,65,UCBPlayer
36199,UCBPlayer,130,275,405,25,40,UCBPlayer
36200,UCBPlayer,103,203,306,10,68,UCBPlayer
36201,UCBPlayer,128,283,411,25,38,UCBPlayer
36202,UCBPlayer,111,186,297,10,71,UCBPlayer
36203,UCBPlayer,124,299,423,25,34,UCBPlayer
36204,UCBPlayer,115,170,285,10,75,UCBPlayer
36205,UCBPlayer,120,315,435,25,30,UCBPlayer
36206,UCBPlayer,119,154,273,10,79,UCBPlayer
36207,UCBPlayer,112,332,444,25,27,UCBPlayer
36208,UCBPlayer,127,137,264,10,82,UCBPlayer
36209,UCBPlayer,104,349,453,25,24,UCBPlayer
36210,UCBPlayer,126,126,252,7,85,Tie
36211,UCBPlayer,111,351,462,28,22,UCBPlayer
36212,UCBPlayer,116,126,242,3,87,UCBPlayer
36213,UCBPlayer,122,347,469,32,21,UCBPlayer
36214,UCBPlayer,107,132,239,0,87,UCBPlayer
36215,UCBPlayer,132,337,469,35,22,UCBPlayer
36216,UCBPlayer,103,148,251,0,83,UCBPlayer
36217,UCBPlayer,136,321,457,35,26,UCBPlayer
36218,UCBPlayer,99,164,263,0,79,UCBPlayer
36219,UCBPlayer,140,305,445,35,30,UCBPlayer
36220,UCBPlayer,95,180,275,0,75,UCBPlayer
36221,UCBPlayer,144,289,433,35,34,UCBPlayer
36222,UCBPlayer,91,196,287,0,71,UCBPlayer
36223,UCBPlayer,148,273,421,35,38,UCBPlayer
36224,UCBPlayer,87,212,299,0,67,UCBPlayer
36225,UCBPlayer,152,257,409,35,42,UCBPlayer
36226,UCBPlayer,84,224,308,0,64,UCBPlayer
36227,UCBPlayer,146,251,397,32,45,UCBPlayer
36228,UCBPlayer,89,234,323,3,60,UCBPlayer
36229,UCBPlayer,138,243,381,28,49,UCBPlayer
36230,UCBPlayer,97,242,339,7,56,UCBPlayer
36231,UCBPlayer,130,235,365,24,53,UCBPlayer
36232,UCBPlayer,105,250,355,11,52,UCBPlayer
36233,UCBPlayer,122,227,349,20,57,UCBPlayer
36234,UCBPlayer,109,259,368,15,49,UCBPlayer
36235,UCBPlayer,118,218,336,16,60,UCBPlayer
36236,UCBPlayer,117,267,384,19,45,UCBPlayer
36237,UCBPlayer,110,210,320,12,64,UCBPlayer
36238,UCBPlayer,126,271,397,23,42,UCBPlayer
36239,UCBPlayer,105,210,315,10,65,UCBPlayer
36240,UCBPlayer,130,275,405,25,40,UCBPlayer
36241,UCBPlayer,105,210,315,10,65,UCBPlayer
36242,UCBPlayer,130,275,405,25,40,UCBPlayer
36243,UCBPlayer,106,206,312,10,66,UCBPlayer
36244,UCBPlayer,130,275,405,25,40,UCBPlayer
36245,UCBPlayer,105,210,315,10,65,UCBPlayer
36246,UCBPlayer,131,271,402,25,41,UCBPlayer
36247,UCBPlayer,105,210,315,10,65,UCBPlayer
36248,UCBPlayer,130,275,405,25,40,UCBPlayer
36249,UCBPlayer,105,210,315,10,65,UCBPlayer
36250,UCBPlayer,130,275,405,25,40,UCBPlayer
36251,UCBPlayer,103,203,306,10,68,UCBPlayer
36252,UCBPlayer,128,283,411,25,38,UCBPlayer
36253,UCBPlayer,111,186,297,10,71,UCBPlayer
36254,UCBPlayer,124,299,423,25,34,UCBPlayer
36255,UCBPlayer,115,170,285,10,75,UCBPlayer
36256,UCBPlayer,120,315,435,25,30,UCBPlayer
36257,UCBPlayer,119,154,273,10,79,UCBPlayer
36258,UCBPlayer,112,332,444,25,27,UCBPlayer
36259,UCBPlayer,127,137,264,10,82,UCBPlayer
36260,UCBPlayer,104,349,453,25,24,UCBPlayer
36261,UCBPlayer,126,126,252,7,85,Tie
36262,UCBPlayer,111,351,462,28,22,UCBPlayer
36263,UCBPlayer,116,126,242,3,87,UCBPlayer
36264,UCBPlayer,122,347,469,32,21,UCBPlayer
36265,UCBPlayer,107,132,239,0,87,UCBPlayer
36266,UCBPlayer,132,337,469,35,22,UCBPlayer
36267,UCBPlayer,103,148,251,0,83,UCBPlayer
36268,UCBPlayer,136,321,457,35,26,UCBPlayer
36269,UCBPlayer,99,164,263,0,79,UCBPlayer
36270,UCBPlayer,140,305,445,35,30,UCBPlayer
36271,UCBPlayer,95,180,275,0,75,UCBPlayer
36272,UCBPlayer,144,289,433,35,34,UCBPlayer
36273,UCBPlayer,91,196,287,0,71,UCBPlayer
36274,UCBPlayer,148,273,421,35,38,UCBPlayer
36275,UCBPlayer,87,212,299,0,67,UCBPlayer
36276,UCBPlayer,152,257,409,35,42,UCBPlayer
36277,UCBPlayer,84,224,308,0,64,UCBPlayer
36278,UCBPlayer,146,251,397,32,45,UCBPlayer
36279,UCBPlayer,89,234,323,3,60,UCBPlayer
36280,UCBPlayer,138,243,381,28,49,UCBPlayer
36281,UCBPlayer,97,242,339,7,56,UCBPlayer
36282,UCBPlayer,130,235,365,24,53,UCBPlayer
36283,UCBPlayer,105,250,355,11,52,UCBPlayer
36284,UCBPlayer,122,227,349,20,57,UCBPlayer
36285,UCBPlayer,109,259,368,15,49,UCBPlayer
36286,UCBPlayer,118,218,336,16,60,UCBPlayer
36287,UCBPlayer,117,267,384,19,45,UCBPlayer
36288,UCBPlayer,110,210,320,12,64,UCBPlayer
36289,UCBPlayer,126,271,397,23,42,UCBPlayer
36290,UCBPlayer,105,210,315,10,65,UCBPlayer
36291,UCBPlayer,130,275,405,25,40,UCBPlayer
36292,UCBPlayer,105,210,315,10,65,UCBPlayer
36293,UCBPlayer,130,275,405,25,40,UCBPlayer
36294,UCBPlayer,106,206,312,10,66,UCBPlayer
36295,UCBPlayer,130,275,405,25,40,UCBPlayer
36296,UCBPlayer,105,210,315,10,65,UCBPlayer
36297,UCBPlayer,131,271,402,25,41,UCBPlayer
36298,UCBPlayer,105,210,315,10,65,UCBPlayer
36299,UCBPlayer,130,275,405,25,40,UCBPlayer
36300,UCBPlayer,105,210,315,10,65,UCBPlayer
36301,UCBPlayer,130,275,405,25,40,UCBPlayer
36302,UCBPlayer,103,203,306,10,68,UCBPlayer
36303,UCBPlayer,128,283,411,25,38,UCBPlayer
36304,UCBPlayer,111,186,297,10,71,UCBPlayer
36305,UCBPlayer,124,299,423,25,34,UCBPlayer
36306,UCBPlayer,115,170,285,10,75,UCBPlayer
36307,UCBPlayer,120,315,435,25,30,UCBPlayer
36308,UCBPlayer,119,154,273,10,79,UCBPlayer
36309,UCBPlayer,112,332,444,25,27,UCBPlayer
36310,UCBPlayer,127,137,264,10,82,UCBPlayer
36311,UCBPlayer,104,349,453,25,24,UCBPlayer
36312,UCBPlayer,126,126,252,7,85,Tie
36313,UCBPlayer,111,351,462,28,22,UCBPlayer
36314,UCBPlayer,116,126,242,3,87,UCBPlayer
36315,UCBPlayer,122,347,469,32,21,UCBPlayer
36316,UCBPlayer,107,132,239,0,87,UCBPlayer
36317,UCBPlayer,132,337,469,35,22,UCBPlayer
36318,UCBPlayer,103,148,251,0,83,UCBPlayer
36319,UCBPlayer,136,321,457,35,26,UCBPlayer
36320,UCBPlayer,99,164,263,0,79,UCBPlayer
36321,UCBPlayer,140,305,445,35,30,UCBPlayer
36322,UCBPlayer,95,180,275,0,75,UCBPlayer
36323,UCBPlayer,144,289,433,35,34,UCBPlayer
36324,UCBPlayer,91,196,287,0,71,UCBPlayer
36325,UCBPlayer,148,273,421,35,38,UCBPlayer
36326,UCBPlayer,87,212,299,0,67,UCBPlayer
36327,UCBPlayer,152,257,409,35,42,UCBPlayer
36328,UCBPlayer,84,224,308,0,64,UCBPlayer
36329,UCBPlayer,146,251,397,32,45,UCBPlayer
36330,UCBPlayer,89,234,323,3,60,UCBPlayer
36331,UCBPlayer,138,243,381,28,49,UCBPlayer
36332,UCBPlayer,97,242,339,7,56,UCBPlayer
36333,UCBPlayer,130,235,365,24,53,UCBPlayer
36334,UCBPlayer,105,250,355,11,52,UCBPlayer
36335,UCBPlayer,122,227,349,20,57,UCBPlayer
36336,UCBPlayer,109,259,368,15,49,UCBPlayer
36337,UCBPlayer,118,218,336,16,60,UCBPlayer
36338,UCBPlayer,117,267,384,19,45,UCBPlayer
36339,UCBPlayer,110,210,320,12,64,UCBPlayer
36340,UCBPlayer,126,271,397,23,42,UCBPlayer
36341,UCBPlayer,105,210,315,10,65,UCBPlayer
36342,UCBPlayer,130,275,405,25,40,UCBPlayer
36343,UCBPlayer,105,210,315,10,65,UCBPlayer
36344,UCBPlayer,130,275,405,25,40,UCBPlayer
36345,UCBPlayer,106,206,312,10,66,UCBPlayer
36346,UCBPlayer,130,275,405,25,40,UCBPlayer
36347,UCBPlayer,105,210,315,10,65,UCBPlayer
36348,UCBPlayer,131,271,402,25,41,UCBPlayer
36349,UCBPlayer,105,210,315,10,65,UCBPlayer
36350,UCBPlayer,130,275,405,25,40,UCBPlayer
36351,UCBPlayer,105,210,315,10,65,UCBPlayer
36352,UCBPlayer,130,275,405,25,40,UCBPlayer
36353,UCBPlayer,103,203,306,10,68,UCBPlayer
36354,UCBPlayer,128,283,411,25,38,UCBPlayer
36355,UCBPlayer,111,186,297,10,71,UCBPlayer
36356,UCBPlayer,124,299,423,25,34,UCBPlayer
36357,UCBPlayer,115,170,285,10,75,UCBPlayer
36358,UCBPlayer,120,315,435,25,30,UCBPlayer
36359,UCBPlayer,119,154,273,10,79,UCBPlayer
36360,UCBPlayer,112,332,444,25,27,UCBPlayer
36361,UCBPlayer,127,137,264,10,82,UCBPlayer
36362,UCBPlayer,104,349,453,25,24,UCBPlayer
36363,UCBPlayer,126,126,252,7,85,Tie
36364,UCBPlayer,111,351,462,28,22,UCBPlayer
36365,UCBPlayer,116,126,242,3,87,UCBPlayer
36366,UCBPlayer,122,347,469,32,21,UCBPlayer
36367,UCBPlayer,107,132,239,0,87,UCBPlayer
36368,UCBPlayer,132,337,469,35,22,UCBPlayer
36369,UCBPlayer,103,148,251,0,83,UCBPlayer
36370,UCBPlayer,136,321,457,35,26,UCBPlayer
36371,UCBPlayer,99,164,263,0,79,UCBPlayer
36372,UCBPlayer,140,305,445,35,30,UCBPlayer
36373,UCBPlayer,95,180,275,0,75,UCBPlayer
36374,UCBPlayer,144,289,433,35,34,UCBPlayer
36375,UCBPlayer,91,196,287,0,71,UCBPlayer
36376,UCBPlayer,148,273,421,35,38,UCBPlayer
36377,UCBPlayer,87,212,299,0,67,UCBPlayer
36378,UCBPlayer,152,257,409,35,42,UCBPlayer
36379,UCBPlayer,84,224,308,0,64,UCBPlayer
36380,UCBPlayer,146,251,397,32,45,UCBPlayer
36381,UCBPlayer,89,234,323,3,60,UCBPlayer
36382,UCBPlayer,138,243,381,28,49,UCBPlayer
36383,UCBPlayer,97,242,339,7,56,UCBPlayer
36384,UCBPlayer,130,235,365,24,53,UCBPlayer
36385,UCBPlayer,105,250,355,11,52,UCBPlayer
36386,UCBPlayer,122,227,349,20,57,UCBPlayer
36387,UCBPlayer,109,259,368,15,49,UCBPlayer
36388,UCBPlayer,118,218,336,16,60,UCBPlayer
36389,UCBPlayer,117,267,384,19,45,UCBPlayer
36390,UCBPlayer,110,210,320,12,64,UCBPlayer
36391,UCBPlayer,126,271,397,23,42,UCBPlayer
36392,UCBPlayer,105,210,315,10,65,UCBPlayer
36393,UCBPlayer,130,275,405,25,40,UCBPlayer
36394,UCBPlayer,105,210,315,10,65,UCBPlayer
36395,UCBPlayer,130,275,405,25,40,UCBPlayer
36396,UCBPlayer,106,206,312,10,66,UCBPlayer
36397,UCBPlayer,130,275,405,25,40,UCBPlayer
36398,UCBPlayer,105,210,315,10,65,UCBPlayer
36399,UCBPlayer,131,271,402,25,41,UCBPlayer
36400,UCBPlayer,105,210,315,10,65,UCBPlayer
36401,UCBPlayer,130,275,405,25,40,UCBPlayer
36402,UCBPlayer,105,210,315,10,65,UCBPlayer
36403,UCBPlayer,130,275,405,25,40,UCBPlayer
36404,UCBPlayer,103,203,306,10,68,UCBPlayer
36405,UCBPlayer,128,283,411,25,38,UCBPlayer
36406,UCBPlayer,111,186,297,10,71,UCBPlayer
36407,UCBPlayer,124,299,423,25,34,UCBPlayer
36408,UCBPlayer,115,170,285,10,75,UCBPlayer
36409,UCBPlayer,120,315,435,25,30,UCBPlayer
36410,UCBPlayer,119,154,273,10,79,UCBPlayer
36411,UCBPlayer,112,332,444,25,27,UCBPlayer
36412,UCBPlayer,127,137,264,10,82,UCBPlayer
36413,UCBPlayer,104,349,453,25,24,UCBPlayer
36414,UCBPlayer,126,126,252,7,85,Tie
36415,UCBPlayer,111,351,462,28,22,UCBPlayer
36416,UCBPlayer,116,126,242,3,87,UCBPlayer
36417,UCBPlayer,122,347,469,32,21,UCBPlayer
36418,UCBPlayer,107,132,239,0,87,UCBPlayer
36419,UCBPlayer,132,337,469,35,22,UCBPlayer
36420,UCBPlayer,103,148,251,0,83,UCBPlayer
36421,UCBPlayer,136,321,457,35,26,UCBPlayer
36422,UCBPlayer,99,164,263,0,79,UCBPlayer
36423,UCBPlayer,140,305,445,35,30,UCBPlayer
36424,UCBPlayer,95,180,275,0,75,UCBPlayer
36425,UCBPlayer,144,289,433,35,34,UCBPlayer
36426,UCBPlayer,91,196,287,0,71,UCBPlayer
36427,UCBPlayer,148,273,421,35,38,UCBPlayer
36428,UCBPlayer,87,212,299,0,67,UCBPlayer
36429,UCBPlayer,152,257,409,35,42,UCBPlayer
36430,UCBPlayer,84,224,308,0,64,UCBPlayer
36431,UCBPlayer,146,251,397,32,45,UCBPlayer
36432,UCBPlayer,89,234,323,3,60,UCBPlayer
36433,UCBPlayer,138,243,381,28,49,UCBPlayer
36434,UCBPlayer,97,242,339,7,56,UCBPlayer
36435,UCBPlayer,130,235,365,24,53,UCBPlayer
36436,UCBPlayer,105,250,355,11,52,UCBPlayer
36437,UCBPlayer,122,227,349,20,57,UCBPlayer
36438,UCBPlayer,109,259,368,15,49,UCBPlayer
36439,UCBPlayer,118,218,336,16,60,UCBPlayer
36440,UCBPlayer,117,267,384,19,45,UCBPlayer
36441,UCBPlayer,110,210,320,12,64,UCBPlayer
36442,UCBPlayer,126,271,397,23,42,UCBPlayer
36443,UCBPlayer,105,210,315,10,65,UCBPlayer
36444,UCBPlayer,130,275,405,25,40,UCBPlayer
36445,UCBPlayer,105,210,315,10,65,UCBPlayer
36446,UCBPlayer,130,275,405,25,40,UCBPlayer
36447,UCBPlayer,106,206,312,10,66,UCBPlayer
36448,UCBPlayer,130,275,405,25,40,UCBPlayer
36449,UCBPlayer,105,210,315,10,65,UCBPlayer
36450,UCBPlayer,131,271,402,25,41,UCBPlayer
36451,UCBPlayer,105,210,315,10,65,UCBPlayer
36452,UCBPlayer,130,275,405,25,40,UCBPlayer
36453,UCBPlayer,105,210,315,10,65,UCBPlayer
36454,UCBPlayer,130,275,405,25,40,UCBPlayer
36455,UCBPlayer,103,203,306,10,68,UCBPlayer
36456,UCBPlayer,128,283,411,25,38,UCBPlayer
36457,UCBPlayer,111,186,297,10,71,UCBPlayer
36458,UCBPlayer,124,299,423,25,34,UCBPlayer
36459,UCBPlayer,115,170,285,10,75,UCBPlayer
36460,UCBPlayer,120,315,435,25,30,UCBPlayer
36461,UCBPlayer,119,154,273,10,79,UCBPlayer
36462,UCBPlayer,112,332,444,25,27,UCBPlayer
36463,UCBPlayer,127,137,264,10,82,UCBPlayer
36464,UCBPlayer,104,349,453,25,24,UCBPlayer
36465,UCBPlayer,126,126,252,7,85,Tie
36466,UCBPlayer,111,351,462,28,22,UCBPlayer
36467,UCBPlayer,116,126,242,3,87,UCBPlayer
36468,UCBPlayer,122,347,469,32,21,UCBPlayer
36469,UCBPlayer,107,132,239,0,87,UCBPlayer
36470,UCBPlayer,132,337,469,35,22,UCBPlayer
36471,UCBPlayer,103,148,251,0,83,UCBPlayer
36472,UCBPlayer,136,321,457,35,26,UCBPlayer
36473,UCBPlayer,99,164,263,0,79,UCBPlayer
36474,UCBPlayer,140,305,445,35,30,UCBPlayer
36475,UCBPlayer,95,180,275,0,75,UCBPlayer
36476,UCBPlayer,144,289,433,35,34,UCBPlayer
36477,UCBPlayer,91,196,287,0,71,UCBPlayer
36478,UCBPlayer,148,273,421,35,38,UCBPlayer
36479,UCBPlayer,87,212,299,0,67,UCBPlayer
36480,UCBPlayer,152,257,409,35,42,UCBPlayer
36481,UCBPlayer,84,224,308,0,64,UCBPlayer
36482,UCBPlayer,146,251,397,32,45,UCBPlayer
36483,UCBPlayer,89,234,323,3,60,UCBPlayer
36484,UCBPlayer,138,243,381,28,49,UCBPlayer
36485,UCBPlayer,97,242,339,7,56,UCBPlayer
36486,UCBPlayer,130,235,365,24,53,UCBPlayer
36487,UCBPlayer,105,250,355,11,52,UCBPlayer
36488,UCBPlayer,122,227,349,20,57,UCBPlayer
36489,UCBPlayer,109,259,368,15,49,UCBPlayer
36490,UCBPlayer,118,218,336,16,60,UCBPlayer
36491,UCBPlayer,117,267,384,19,45,UCBPlayer
36492,UCBPlayer,110,210,320,12,64,UCBPlayer
36493,UCBPlayer,126,271,397,23,42,UCBPlayer
36494,UCBPlayer,105,210,315,10,65,UCBPlayer
36495,UCBPlayer,130,275,405,25,40,UCBPlayer
36496,UCBPlayer,105,210,315,10,65,UCBPlayer
36497,UCBPlayer,130,275,405,25,40,UCBPlayer
36498,UCBPlayer,106,206,312,10,66,UCBPlayer
36499,UCBPlayer,130,275,405,25,40,UCBPlayer
36500,UCBPlayer,105,210,315,10,65,UCBPlayer
36501,UCBPlayer,131,271,402,25,41,UCBPlayer
36502,UCBPlayer,105,210,315,10,65,UCBPlayer
36503,UCBPlayer,130,275,405,25,40,UCBPlayer
36504,UCBPlayer,105,210,315,10,65,UCBPlayer
36505,UCBPlayer,130,275,405,25,40,UCBPlayer
36506,UCBPlayer,103,203,306,10,68,UCBPlayer
36507,UCBPlayer,128,283,411,25,38,UCBPlayer
36508,UCBPlayer,111,186,297,10,71,UCBPlayer
36509,UCBPlayer,124,299,423,25,34,UCBPlayer
36510,UCBPlayer,115,170,285,10,75,UCBPlayer
36511,UCBPlayer,120,315,435,25,30,UCBPlayer
36512,UCBPlayer,119,154,273,10,79,UCBPlayer
36513,UCBPlayer,112,332,444,25,27,UCBPlayer
36514,UCBPlayer,127,137,264,10,82,UCBPlayer
36515,UCBPlayer,104,349,453,25,24,UCBPlayer
36516,UCBPlayer,126,126,252,7,85,Tie
36517,UCBPlayer,111,351,462,28,22,UCBPlayer
36518,UCBPlayer,116,126,242,3,87,UCBPlayer
36519,UCBPlayer,122,347,469,32,21,UCBPlayer
36520,UCBPlayer,107,132,239,0,87,UCBPlayer
36521,UCBPlayer,132,337,469,35,22,UCBPlayer
36522,UCBPlayer,103,148,251,0,83,UCBPlayer
36523,UCBPlayer,136,321,457,35,26,UCBPlayer
36524,UCBPlayer,99,164,263,0,79,UCBPlayer
36525,UCBPlayer,140,305,445,35,30,UCBPlayer
36526,UCBPlayer,95,180,275,0,75,UCBPlayer
36527,UCBPlayer,144,289,433,35,34,UCBPlayer
36528,UCBPlayer,91,196,287,0,71,UCBPlayer
36529,UCBPlayer,148,273,421,35,38,UCBPlayer
36530,UCBPlayer,87,212,299,0,67,UCBPlayer
36531,UCBPlayer,152,257,409,35,42,UCBPlayer
36532,UCBPlayer,84,224,308,0,64,UCBPlayer
36533,UCBPlayer,146,251,397,32,45,UCBPlayer
36534,UCBPlayer,89,234,323,3,60,UCBPlayer
36535,UCBPlayer,138,243,381,28,49,UCBPlayer
36536,UCBPlayer,97,242,339,7,56,UCBPlayer
36537,UCBPlayer,130,235,365,24,53,UCBPlayer
36538,UCBPlayer,105,250,355,11,52,UCBPlayer
36539,UCBPlayer,122,227,349,20,57,UCBPlayer
36540,UCBPlayer,109,259,368,15,49,UCBPlayer
36541,UCBPlayer,118,218,336,16,60,UCBPlayer
36542,UCBPlayer,117,267,384,19,45,UCBPlayer
36543,UCBPlayer,110,210,320,12,64,UCBPlayer
36544,UCBPlayer,126,271,397,23,42,UCBPlayer
36545,UCBPlayer,105,210,315,10,65,UCBPlayer
36546,UCBPlayer,130,275,405,25,40,UCBPlayer
36547,UCBPlayer,105,210,315,10,65,UCBPlayer
36548,UCBPlayer,130,275,405,25,40,UCBPlayer
36549,UCBPlayer,106,206,312,10,66,UCBPlayer
36550,UCBPlayer,130,275,405,25,40,UCBPlayer
36551,UCBPlayer,105,210,315,10,65,UCBPlayer
36552,UCBPlayer,131,271,402,25,41,UCBPlayer
36553,UCBPlayer,105,210,315,10,65,UCBPlayer
36554,UCBPlayer,130,275,405,25,40,UCBPlayer
36555,UCBPlayer,105,210,315,10,65,UCBPlayer
36556,UCBPlayer,130,275,405,25,40,UCBPlayer
36557,UCBPlayer,103,203,306,10,68,UCBPlayer
36558,UCBPlayer,128,283,411,25,38,UCBPlayer
36559,UCBPlayer,111,186,297,10,71,UCBPlayer
36560,UCBPlayer,124,299,423,25,34,UCBPlayer
36561,UCBPlayer,115,170,285,10,75,UCBPlayer
36562,UCBPlayer,120,315,435,25,30,UCBPlayer
36563,UCBPlayer,119,154,273,10,79,UCBPlayer
36564,UCBPlayer,112,332,444,25,27,UCBPlayer
36565,UCBPlayer,127,137,264,10,82,UCBPlayer
36566,UCBPlayer,104,349,453,25,24,UCBPlayer
36567,UCBPlayer,126,126,252,7,85,Tie
36568,UCBPlayer,111,351,462,28,22,UCBPlayer
36569,UCBPlayer,116,126,242,3,87,UCBPlayer
36570,UCBPlayer,122,347,469,32,21,UCBPlayer
36571,UCBPlayer,107,132,239,0,87,UCBPlayer
36572,UCBPlayer,132,337,469,35,22,UCBPlayer
36573,UCBPlayer,103,148,251,0,83,UCBPlayer
36574,UCBPlayer,136,321,457,35,26,UCBPlayer
36575,UCBPlayer,99,164,263,0,79,UCBPlayer
36576,UCBPlayer,140,305,445,35,30,UCBPlayer
36577,UCBPlayer,95,180,275,0,75,UCBPlayer
36578,UCBPlayer,144,289,433,35,34,UCBPlayer
36579,UCBPlayer,91,196,287,0,71,UCBPlayer
36580,UCBPlayer,148,273,421,35,38,UCBPlayer
36581,UCBPlayer,87,212,299,0,67,UCBPlayer
36582,UCBPlayer,152,257,409,35,42,UCBPlayer
36583,UCBPlayer,84,224,308,0,64,UCBPlayer
36584,UCBPlayer,146,251,397,32,45,UCBPlayer
36585,UCBPlayer,89,234,323,3,60,UCBPlayer
36586,UCBPlayer,138,243,381,28,49,UCBPlayer
36587,UCBPlayer,97,242,339,7,56,UCBPlayer
36588,UCBPlayer,130,235,365,24,53,UCBPlayer
36589,UCBPlayer,105,250,355,11,52,UCBPlayer
36590,UCBPlayer,122,227,349,20,57,UCBPlayer
36591,UCBPlayer,109,259,368,15,49,UCBPlayer
36592,UCBPlayer,118,218,336,16,60,UCBPlayer
36593,UCBPlayer,117,267,384,19,45,UCBPlayer
36594,UCBPlayer,110,210,320,12,64,UCBPlayer
36595,UCBPlayer,126,271,397,23,42,UCBPlayer
36596,UCBPlayer,105,210,315,10,65,UCBPlayer
36597,UCBPlayer,130,275,405,25,40,UCBPlayer
36598,UCBPlayer,105,210,315,10,65,UCBPlayer
36599,UCBPlayer,130,275,405,25,40,UCBPlayer
36600,UCBPlayer,106,206,312,10,66,UCBPlayer
36601,UCBPlayer,130,275,405,25,40,UCBPlayer
36602,UCBPlayer,105,210,315,10,65,UCBPlayer
36603,UCBPlayer,131,271,402,25,41,UCBPlayer
36604,UCBPlayer,105,210,315,10,65,UCBPlayer
36605,UCBPlayer,130,275,405,25,40,UCBPlayer
36606,UCBPlayer,105,210,315,10,65,UCBPlayer
36607,UCBPlayer,130,275,405,25,40,UCBPlayer
36608,UCBPlayer,103,203,306,10,68,UCBPlayer
36609,UCBPlayer,128,283,411,25,38,UCBPlayer
36610,UCBPlayer,111,186,297,10,71,UCBPlayer
36611,UCBPlayer,124,299,423,25,34,UCBPlayer
36612,UCBPlayer,115,170,285,10,75,UCBPlayer
36613,UCBPlayer,120,315,435,25,30,UCBPlayer
36614,UCBPlayer,119,154,273,10,79,UCBPlayer
36615,UCBPlayer,112,332,444,25,27,UCBPlayer
36616,UCBPlayer,127,137,264,10,82,UCBPlayer
36617,UCBPlayer,104,349,453,25,24,UCBPlayer
36618,UCBPlayer,126,126,252,7,85,Tie
36619,UCBPlayer,111,351,462,28,22,UCBPlayer
36620,UCBPlayer,116,126,242,3,87,UCBPlayer
36621,UCBPlayer,122,347,469,32,21,UCBPlayer
36622,UCBPlayer,107,132,239,0,87,UCBPlayer
36623,UCBPlayer,132,337,469,35,22,UCBPlayer
36624,UCBPlayer,103,148,251,0,83,UCBPlayer
36625,UCBPlayer,136,321,457,35,26,UCBPlayer
36626,UCBPlayer,99,164,263,0,79,UCBPlayer
36627,UCBPlayer,140,305,445,35,30,UCBPlayer
36628,UCBPlayer,95,180,275,0,75,UCBPlayer
36629,UCBPlayer,144,289,433,35,34,UCBPlayer
36630,UCBPlayer,91,196,287,0,71,UCBPlayer
36631,UCBPlayer,148,273,421,35,38,UCBPlayer
36632,UCBPlayer,87,212,299,0,67,UCBPlayer
36633,UCBPlayer,152,257,409,35,42,UCBPlayer
36634,UCBPlayer,84,224,308,0,64,UCBPlayer
36635,UCBPlayer,146,251,397,32,45,UCBPlayer
36636,UCBPlayer,89,234,323,3,60,UCBPlayer
36637,UCBPlayer,138,243,381,28,49,UCBPlayer
36638,UCBPlayer,97,242,339,7,56,UCBPlayer
36639,UCBPlayer,130,235,365,24,53,UCBPlayer
36640,UCBPlayer,105,250,355,11,52,UCBPlayer
36641,UCBPlayer,122,227,349,20,57,UCBPlayer
36642,UCBPlayer,109,259,368,15,49,UCBPlayer
36643,UCBPlayer,118,218,336,16,60,UCBPlayer
36644,UCBPlayer,117,267,384,19,45,UCBPlayer
36645,UCBPlayer,110,210,320,12,64,UCBPlayer
36646,UCBPlayer,126,271,397,23,42,UCBPlayer
36647,UCBPlayer,105,210,315,10,65,UCBPlayer
36648,UCBPlayer,130,275,405,25,40,UCBPlayer
36649,UCBPlayer,105,210,315,10,65,UCBPlayer
36650,UCBPlayer,130,275,405,25,40,UCBPlayer
36651,UCBPlayer,106,206,312,10,66,UCBPlayer
36652,UCBPlayer,130,275,405,25,40,UCBPlayer
36653,UCBPlayer,105,210,315,10,65,UCBPlayer
36654,UCBPlayer,131,271,402,25,41,UCBPlayer
36655,UCBPlayer,105,210,315,10,65,UCBPlayer
36656,UCBPlayer,130,275,405,25,40,UCBPlayer
36657,UCBPlayer,105,210,315,10,65,UCBPlayer
36658,UCBPlayer,130,275,405,25,40,UCBPlayer
36659,UCBPlayer,103,203,306,10,68,UCBPlayer
36660,UCBPlayer,128,283,411,25,38,UCBPlayer
36661,UCBPlayer,111,186,297,10,71,UCBPlayer
36662,UCBPlayer,124,299,423,25,34,UCBPlayer
36663,UCBPlayer,115,170,285,10,75,UCBPlayer
36664,UCBPlayer,120,315,435,25,30,UCBPlayer
36665,UCBPlayer,119,154,273,10,79,UCBPlayer
36666,UCBPlayer,112,332,444,25,27,UCBPlayer
36667,UCBPlayer,127,137,264,10,82,UCBPlayer
36668,UCBPlayer,104,349,453,25,24,UCBPlayer
36669,UCBPlayer,126,126,252,7,85,Tie
36670,UCBPlayer,111,351,462,28,22,UCBPlayer
36671,UCBPlayer,116,126,242,3,87,UCBPlayer
36672,UCBPlayer,122,347,469,32,21,UCBPlayer
36673,UCBPlayer,107,132,239,0,87,UCBPlayer
36674,UCBPlayer,132,337,469,35,22,UCBPlayer
36675,UCBPlayer,103,148,251,0,83,UCBPlayer
36676,UCBPlayer,136,321,457,35,26,UCBPlayer
36677,UCBPlayer,99,164,263,0,79,UCBPlayer
36678,UCBPlayer,140,305,445,35,30,UCBPlayer
36679,UCBPlayer,95,180,275,0,75,UCBPlayer
36680,UCBPlayer,144,289,433,35,34,UCBPlayer
36681,UCBPlayer,91,196,287,0,71,UCBPlayer
36682,UCBPlayer,148,273,421,35,38,UCBPlayer
36683,UCBPlayer,87,212,299,0,67,UCBPlayer
36684,UCBPlayer,152,257,409,35,42,UCBPlayer
36685,UCBPlayer,84,224,308,0,64,UCBPlayer
36686,UCBPlayer,146,251,397,32,45,UCBPlayer
36687,UCBPlayer,89,234,323,3,60,UCBPlayer
36688,UCBPlayer,138,243,381,28,49,UCBPlayer
36689,UCBPlayer,97,242,339,7,56,UCBPlayer
36690,UCBPlayer,130,235,365,24,53,UCBPlayer
36691,UCBPlayer,105,250,355,11,52,UCBPlayer
36692,UCBPlayer,122,227,349,20,57,UCBPlayer
36693,UCBPlayer,109,259,368,15,49,UCBPlayer
36694,UCBPlayer,118,218,336,16,60,UCBPlayer
36695,UCBPlayer,117,267,384,19,45,UCBPlayer
36696,UCBPlayer,110,210,320,12,64,UCBPlayer
36697,UCBPlayer,126,271,397,23,42,UCBPlayer
36698,UCBPlayer,105,210,315,10,65,UCBPlayer
36699,UCBPlayer,130,275,405,25,40,UCBPlayer
36700,UCBPlayer,105,210,315,10,65,UCBPlayer
36701,UCBPlayer,130,275,405,25,40,UCBPlayer
36702,UCBPlayer,106,206,312,10,66,UCBPlayer
36703,UCBPlayer,130,275,405,25,40,UCBPlayer
36704,UCBPlayer,105,210,315,10,65,UCBPlayer
36705,UCBPlayer,131,271,402,25,41,UCBPlayer
36706,UCBPlayer,105,210,315,10,65,UCBPlayer
36707,UCBPlayer,130,275,405,25,40,UCBPlayer
36708,UCBPlayer,105,210,315,10,65,UCBPlayer
36709,UCBPlayer,130,275,405,25,40,UCBPlayer
36710,UCBPlayer,103,203,306,10,68,UCBPlayer
36711,UCBPlayer,128,283,411,25,38,UCBPlayer
36712,UCBPlayer,111,186,297,10,71,UCBPlayer
36713,UCBPlayer,124,299,423,25,34,UCBPlayer
36714,UCBPlayer,115,170,285,10,75,UCBPlayer
36715,UCBPlayer,120,315,435,25,30,UCBPlayer
36716,UCBPlayer,119,154,273,10,79,UCBPlayer
36717,UCBPlayer,112,332,444,25,27,UCBPlayer
36718,UCBPlayer,127,137,264,10,82,UCBPlayer
36719,UCBPlayer,104,349,453,25,24,UCBPlayer
36720,UCBPlayer,126,126,252,7,85,Tie
36721,UCBPlayer,111,351,462,28,22,UCBPlayer
36722,UCBPlayer,116,126,242,3,87,UCBPlayer
36723,UCBPlayer,122,347,469,32,21,UCBPlayer
36724,UCBPlayer,107,132,239,0,87,UCBPlayer
36725,UCBPlayer,132,337,469,35,22,UCBPlayer
36726,UCBPlayer,103,148,251,0,83,UCBPlayer
36727,UCBPlayer,136,321,457,35,26,UCBPlayer
36728,UCBPlayer,99,164,263,0,79,UCBPlayer
36729,UCBPlayer,140,305,445,35,30,UCBPlayer
36730,UCBPlayer,95,180,275,0,75,UCBPlayer
36731,UCBPlayer,144,289,433,35,34,UCBPlayer
36732,UCBPlayer,91,196,287,0,71,UCBPlayer
36733,UCBPlayer,148,273,421,35,38,UCBPlayer
36734,UCBPlayer,87,212,299,0,67,UCBPlayer
36735,UCBPlayer,152,257,409,35,42,UCBPlayer
36736,UCBPlayer,84,224,308,0,64,UCBPlayer
36737,UCBPlayer,146,251,397,32,45,UCBPlayer
36738,UCBPlayer,89,234,323,3,60,UCBPlayer
36739,UCBPlayer,138,243,381,28,49,UCBPlayer
36740,UCBPlayer,97,242,339,7,56,UCBPlayer
36741,UCBPlayer,130,235,365,24,53,UCBPlayer
36742,UCBPlayer,105,250,355,11,52,UCBPlayer
36743,UCBPlayer,122,227,349,20,57,UCBPlayer
36744,UCBPlayer,109,259,368,15,49,UCBPlayer
36745,UCBPlayer,118,218,336,16,60,UCBPlayer
36746,UCBPlayer,117,267,384,19,45,UCBPlayer
36747,UCBPlayer,110,210,320,12,64,UCBPlayer
36748,UCBPlayer,126,271,397,23,42,UCBPlayer
36749,UCBPlayer,105,210,315,10,65,UCBPlayer
36750,UCBPlayer,130,275,405,25,40,UCBPlayer
36751,UCBPlayer,105,210,315,10,65,UCBPlayer
36752,UCBPlayer,130,275,405,25,40,UCBPlayer
36753,UCBPlayer,106,206,312,10,66,UCBPlayer
36754,UCBPlayer,130,275,405,25,40,UCBPlayer
36755,UCBPlayer,105,210,315,10,65,UCBPlayer
36756,UCBPlayer,131,271,402,25,41,UCBPlayer
36757,UCBPlayer,105,210,315,10,65,UCBPlayer
36758,UCBPlayer,130,275,405,25,40,UCBPlayer
36759,UCBPlayer,105,210,315,10,65,UCBPlayer
36760,UCBPlayer,130,275,405,25,40,UCBPlayer
36761,UCBPlayer,103,203,306,10,68,UCBPlayer
36762,UCBPlayer,128,283,411,25,38,UCBPlayer
36763,UCBPlayer,111,186,297,10,71,UCBPlayer
36764,UCBPlayer,124,299,423,25,34,UCBPlayer
36765,UCBPlayer,115,170,285,10,75,UCBPlayer
36766,UCBPlayer,120,315,435,25,30,UCBPlayer
36767,UCBPlayer,119,154,273,10,79,UCBPlayer
36768,UCBPlayer,112,332,444,25,27,UCBPlayer
36769,UCBPlayer,127,137,264,10,82,UCBPlayer
36770,UCBPlayer,104,349,453,25,24,UCBPlayer
36771,UCBPlayer,126,126,252,7,85,Tie
36772,UCBPlayer,111,351,462,28,22,UCBPlayer
36773,UCBPlayer,116,126,242,3,87,UCBPlayer
36774,UCBPlayer,122,347,469,32,21,UCBPlayer
36775,UCBPlayer,107,132,239,0,87,UCBPlayer
36776,UCBPlayer,132,337,469,35,22,UCBPlayer
36777,UCBPlayer,103,148,251,0,83,UCBPlayer
36778,UCBPlayer,136,321,457,35,26,UCBPlayer
36779,UCBPlayer,99,164,263,0,79,UCBPlayer
36780,UCBPlayer,140,305,445,35,30,UCBPlayer
36781,UCBPlayer,95,180,275,0,75,UCBPlayer
36782,UCBPlayer,144,289,433,35,34,UCBPlayer
36783,UCBPlayer,91,196,287,0,71,UCBPlayer
36784,UCBPlayer,148,273,421,35,38,UCBPlayer
36785,UCBPlayer,87,212,299,0,67,UCBPlayer
36786,UCBPlayer,152,257,409,35,42,UCBPlayer
36787,UCBPlayer,84,224,308,0,64,UCBPlayer
36788,UCBPlayer,146,251,397,32,45,UCBPlayer
36789,UCBPlayer,89,234,323,3,60,UCBPlayer
36790,UCBPlayer,138,243,381,28,49,UCBPlayer
36791,UCBPlayer,97,242,339,7,56,UCBPlayer
36792,UCBPlayer,130,235,365,24,53,UCBPlayer
36793,UCBPlayer,105,250,355,11,52,UCBPlayer
36794,UCBPlayer,122,227,349,20,57,UCBPlayer
36795,UCBPlayer,109,259,368,15,49,UCBPlayer
36796,UCBPlayer,118,218,336,16,60,UCBPlayer
36797,UCBPlayer,117,267,384,19,45,UCBPlayer
36798,UCBPlayer,110,210,320,12,64,UCBPlayer
36799,UCBPlayer,126,271,397,23,42,UCBPlayer
36800,UCBPlayer,105,210,315,10,65,UCBPlayer
36801,UCBPlayer,130,275,405,25,40,UCBPlayer
36802,UCBPlayer,105,210,315,10,65,UCBPlayer
36803,UCBPlayer,130,275,405,25,40,UCBPlayer
36804,UCBPlayer,106,206,312,10,66,UCBPlayer
36805,UCBPlayer,130,275,405,25,40,UCBPlayer
36806,UCBPlayer,105,210,315,10,65,UCBPlayer
36807,UCBPlayer,131,271,402,25,41,UCBPlayer
36808,UCBPlayer,105,210,315,10,65,UCBPlayer
36809,UCBPlayer,130,275,405,25,40,UCBPlayer
36810,UCBPlayer,105,210,315,10,65,UCBPlayer
36811,UCBPlayer,130,275,405,25,40,UCBPlayer
36812,UCBPlayer,103,203,306,10,68,UCBPlayer
36813,UCBPlayer,128,283,411,25,38,UCBPlayer
36814,UCBPlayer,111,186,297,10,71,UCBPlayer
36815,UCBPlayer,124,299,423,25,34,UCBPlayer
36816,UCBPlayer,115,170,285,10,75,UCBPlayer
36817,UCBPlayer,120,315,435,25,30,UCBPlayer
36818,UCBPlayer,119,154,273,10,79,UCBPlayer
36819,UCBPlayer,112,332,444,25,27,UCBPlayer
36820,UCBPlayer,127,137,264,10,82,UCBPlayer
36821,UCBPlayer,104,349,453,25,24,UCBPlayer
36822,UCBPlayer,126,126,252,7,85,Tie
36823,UCBPlayer,111,351,462,28,22,UCBPlayer
36824,UCBPlayer,116,126,242,3,87,UCBPlayer
36825,UCBPlayer,122,347,469,32,21,UCBPlayer
36826,UCBPlayer,107,132,239,0,87,UCBPlayer
36827,UCBPlayer,132,337,469,35,22,UCBPlayer
36828,UCBPlayer,103,148,251,0,83,UCBPlayer
36829,UCBPlayer,136,321,457,35,26,UCBPlayer
36830,UCBPlayer,99,164,263,0,79,UCBPlayer
36831,UCBPlayer,140,305,445,35,30,UCBPlayer
36832,UCBPlayer,95,180,275,0,75,UCBPlayer
36833,UCBPlayer,144,289,433,35,34,UCBPlayer
36834,UCBPlayer,91,196,287,0,71,UCBPlayer
36835,UCBPlayer,148,273,421,35,38,UCBPlayer
36836,UCBPlayer,87,212,299,0,67,UCBPlayer
36837,UCBPlayer,152,257,409,35,42,UCBPlayer
36838,UCBPlayer,84,224,308,0,64,UCBPlayer
36839,UCBPlayer,146,251,397,32,45,UCBPlayer
36840,UCBPlayer,89,234,323,3,60,UCBPlayer
36841,UCBPlayer,138,243,381,28,49,UCBPlayer
36842,UCBPlayer,97,242,339,7,56,UCBPlayer
36843,UCBPlayer,130,235,365,24,53,UCBPlayer
36844,UCBPlayer,105,250,355,11,52,UCBPlayer
36845,UCBPlayer,122,227,349,20,57,UCBPlayer
36846,UCBPlayer,109,259,368,15,49,UCBPlayer
36847,UCBPlayer,118,218,336,16,60,UCBPlayer
36848,UCBPlayer,117,267,384,19,45,UCBPlayer
36849,UCBPlayer,110,210,320,12,64,UCBPlayer
36850,UCBPlayer,126,271,397,23,42,UCBPlayer
36851,UCBPlayer,105,210,315,10,65,UCBPlayer
36852,UCBPlayer,130,275,405,25,40,UCBPlayer
36853,UCBPlayer,105,210,315,10,65,UCBPlayer
36854,UCBPlayer,130,275,405,25,40,UCBPlayer
36855,UCBPlayer,106,206,312,10,66,UCBPlayer
36856,UCBPlayer,130,275,405,25,40,UCBPlayer
36857,UCBPlayer,105,210,315,10,65,UCBPlayer
36858,UCBPlayer,131,271,402,25,41,UCBPlayer
36859,UCBPlayer,105,210,315,10,65,UCBPlayer
36860,UCBPlayer,130,275,405,25,40,UCBPlayer
36861,UCBPlayer,105,210,315,10,65,UCBPlayer
36862,UCBPlayer,130,275,405,25,40,UCBPlayer
36863,UCBPlayer,103,203,306,10,68,UCBPlayer
36864,UCBPlayer,128,283,411,25,38,UCBPlayer
36865,UCBPlayer,111,186,297,10,71,UCBPlayer
36866,UCBPlayer,124,299,423,25,34,UCBPlayer
36867,UCBPlayer,115,170,285,10,75,UCBPlayer
36868,UCBPlayer,120,315,435,25,30,UCBPlayer
36869,UCBPlayer,119,154,273,10,79,UCBPlayer
36870,UCBPlayer,112,332,444,25,27,UCBPlayer
36871,UCBPlayer,127,137,264,10,82,UCBPlayer
36872,UCBPlayer,104,349,453,25,24,UCBPlayer
36873,UCBPlayer,126,126,252,7,85,Tie
36874,UCBPlayer,111,351,462,28,22,UCBPlayer
36875,UCBPlayer,116,126,242,3,87,UCBPlayer
36876,UCBPlayer,122,347,469,32,21,UCBPlayer
36877,UCBPlayer,107,132,239,0,87,UCBPlayer
36878,UCBPlayer,132,337,469,35,22,UCBPlayer
36879,UCBPlayer,103,148,251,0,83,UCBPlayer
36880,UCBPlayer,136,321,457,35,26,UCBPlayer
36881,UCBPlayer,99,164,263,0,79,UCBPlayer
36882,UCBPlayer,140,305,445,35,30,UCBPlayer
36883,UCBPlayer,95,180,275,0,75,UCBPlayer
36884,UCBPlayer,144,289,433,35,34,UCBPlayer
36885,UCBPlayer,91,196,287,0,71,UCBPlayer
36886,UCBPlayer,148,273,421,35,38,UCBPlayer
36887,UCBPlayer,87,212,299,0,67,UCBPlayer
36888,UCBPlayer,152,257,409,35,42,UCBPlayer
36889,UCBPlayer,84,224,308,0,64,UCBPlayer
36890,UCBPlayer,146,251,397,32,45,UCBPlayer
36891,UCBPlayer,89,234,323,3,60,UCBPlayer
36892,UCBPlayer,138,243,381,28,49,UCBPlayer
36893,UCBPlayer,97,242,339,7,56,UCBPlayer
36894,UCBPlayer,130,235,365,24,53,UCBPlayer
36895,UCBPlayer,105,250,355,11,52,UCBPlayer
36896,UCBPlayer,122,227,349,20,57,UCBPlayer
36897,UCBPlayer,109,259,368,15,49,UCBPlayer
36898,UCBPlayer,118,218,336,16,60,UCBPlayer
36899,UCBPlayer,117,267,384,19,45,UCBPlayer
36900,UCBPlayer,110,210,320,12,64,UCBPlayer
36901,UCBPlayer,126,271,397,23,42,UCBPlayer
36902,UCBPlayer,105,210,315,10,65,UCBPlayer
36903,UCBPlayer,130,275,405,25,40,UCBPlayer
36904,UCBPlayer,105,210,315,10,65,UCBPlayer
36905,UCBPlayer,130,275,405,25,40,UCBPlayer
36906,UCBPlayer,106,206,312,10,66,UCBPlayer
36907,UCBPlayer,130,275,405,25,40,UCBPlayer
36908,UCBPlayer,105,210,315,10,65,UCBPlayer
36909,UCBPlayer,131,271,402,25,41,UCBPlayer
36910,UCBPlayer,105,210,315,10,65,UCBPlayer
36911,UCBPlayer,130,275,405,25,40,UCBPlayer
36912,UCBPlayer,105,210,315,10,65,UCBPlayer
36913,UCBPlayer,130,275,405,25,40,UCBPlayer
36914,UCBPlayer,103,203,306,10,68,UCBPlayer
36915,UCBPlayer,128,283,411,25,38,UCBPlayer
36916,UCBPlayer,111,186,297,10,71,UCBPlayer
36917,UCBPlayer,124,299,423,25,34,UCBPlayer
36918,UCBPlayer,115,170,285,10,75,UCBPlayer
36919,UCBPlayer,120,315,435,25,30,UCBPlayer
36920,UCBPlayer,119,154,273,10,79,UCBPlayer
36921,UCBPlayer,112,332,444,25,27,UCBPlayer
36922,UCBPlayer,127,137,264,10,82,UCBPlayer
36923,UCBPlayer,104,349,453,25,24,UCBPlayer
36924,UCBPlayer,126,126,252,7,85,Tie
36925,UCBPlayer,111,351,462,28,22,UCBPlayer
36926,UCBPlayer,116,126,242,3,87,UCBPlayer
36927,UCBPlayer,122,347,469,32,21,UCBPlayer
36928,UCBPlayer,107,132,239,0,87,UCBPlayer
36929,UCBPlayer,132,337,469,35,22,UCBPlayer
36930,UCBPlayer,103,148,251,0,83,UCBPlayer
36931,UCBPlayer,136,321,457,35,26,UCBPlayer
36932,UCBPlayer,99,164,263,0,79,UCBPlayer
36933,UCBPlayer,140,305,445,35,30,UCBPlayer
36934,UCBPlayer,95,180,275,0,75,UCBPlayer
36935,UCBPlayer,144,289,433,35,34,UCBPlayer
36936,UCBPlayer,91,196,287,0,71,UCBPlayer
36937,UCBPlayer,148,273,421,35,38,UCBPlayer
36938,UCBPlayer,87,212,299,0,67,UCBPlayer
36939,UCBPlayer,152,257,409,35,42,UCBPlayer
36940,UCBPlayer,84,224,308,0,64,UCBPlayer
36941,UCBPlayer,146,251,397,32,45,UCBPlayer
36942,UCBPlayer,89,234,323,3,60,UCBPlayer
36943,UCBPlayer,138,243,381,28,49,UCBPlayer
36944,UCBPlayer,97,242,339,7,56,UCBPlayer
36945,UCBPlayer,130,235,365,24,53,UCBPlayer
36946,UCBPlayer,105,250,355,11,52,UCBPlayer
36947,UCBPlayer,122,227,349,20,57,UCBPlayer
36948,UCBPlayer,109,259,368,15,49,UCBPlayer
36949,UCBPlayer,118,218,336,16,60,UCBPlayer
36950,UCBPlayer,117,267,384,19,45,UCBPlayer
36951,UCBPlayer,110,210,320,12,64,UCBPlayer
36952,UCBPlayer,126,271,397,23,42,UCBPlayer
36953,UCBPlayer,105,210,315,10,65,UCBPlayer
36954,UCBPlayer,130,275,405,25,40,UCBPlayer
36955,UCBPlayer,105,210,315,10,65,UCBPlayer
36956,UCBPlayer,130,275,405,25,40,UCBPlayer
36957,UCBPlayer,106,206,312,10,66,UCBPlayer
36958,UCBPlayer,130,275,405,25,40,UCBPlayer
36959,UCBPlayer,105,210,315,10,65,UCBPlayer
36960,UCBPlayer,131,271,402,25,41,UCBPlayer
36961,UCBPlayer,105,210,315,10,65,UCBPlayer
36962,UCBPlayer,130,275,405,25,40,UCBPlayer
36963,UCBPlayer,105,210,315,10,65,UCBPlayer
36964,UCBPlayer,130,275,405,25,40,UCBPlayer
36965,UCBPlayer,103,203,306,10,68,UCBPlayer
36966,UCBPlayer,128,283,411,25,38,UCBPlayer
36967,UCBPlayer,111,186,297,10,71,UCBPlayer
36968,UCBPlayer,124,299,423,25,34,UCBPlayer
36969,UCBPlayer,115,170,285,10,75,UCBPlayer
36970,UCBPlayer,120,315,435,25,30,UCBPlayer
36971,UCBPlayer,119,154,273,10,79,UCBPlayer
36972,UCBPlayer,112,332,444,25,27,UCBPlayer
36973,UCBPlayer,127,137,264,10,82,UCBPlayer
36974,UCBPlayer,104,349,453,25,24,UCBPlayer
36975,UCBPlayer,126,126,252,7,85,Tie
36976,UCBPlayer,111,351,462,28,22,UCBPlayer
36977,UCBPlayer,116,126,242,3,87,UCBPlayer
36978,UCBPlayer,122,347,469,32,21,UCBPlayer
36979,UCBPlayer,107,132,239,0,87,UCBPlayer
36980,UCBPlayer,132,337,469,35,22,UCBPlayer
36981,UCBPlayer,103,148,251,0,83,UCBPlayer
36982,UCBPlayer,136,321,457,35,26,UCBPlayer
36983,UCBPlayer,99,164,263,0,79,UCBPlayer
36984,UCBPlayer,140,305,445,35,30,UCBPlayer
36985,UCBPlayer,95,180,275,0,75,UCBPlayer
36986,UCBPlayer,144,289,433,35,34,UCBPlayer
36987,UCBPlayer,91,196,287,0,71,UCBPlayer
36988,UCBPlayer,148,273,421,35,38,UCBPlayer
36989,UCBPlayer,87,212,299,0,67,UCBPlayer
36990,UCBPlayer,152,257,409,35,42,UCBPlayer
36991,UCBPlayer,84,224,308,0,64,UCBPlayer
36992,UCBPlayer,146,251,397,32,45,UCBPlayer
36993,UCBPlayer,89,234,323,3,60,UCBPlayer
36994,UCBPlayer,138,243,381,28,49,UCBPlayer
36995,UCBPlayer,97,242,339,7,56,UCBPlayer
36996,UCBPlayer,130,235,365,24,53,UCBPlayer
36997,UCBPlayer,105,250,355,11,52,UCBPlayer
36998,UCBPlayer,122,227,349,20,57,UCBPlayer
36999,UCBPlayer,109,259,368,15,49,UCBPlayer
37000,UCBPlayer,118,218,336,16,60,UCBPlayer
37001,UCBPlayer,117,267,384,19,45,UCBPlayer
37002,UCBPlayer,110,210,320,12,64,UCBPlayer
37003,UCBPlayer,126,271,397,23,42,UCBPlayer
37004,UCBPlayer,105,210,315,10,65,UCBPlayer
37005,UCBPlayer,130,275,405,25,40,UCBPlayer
37006,UCBPlayer,105,210,315,10,65,UCBPlayer
37007,UCBPlayer,130,275,405,25,40,UCBPlayer
37008,UCBPlayer,106,206,312,10,66,UCBPlayer
37009,UCBPlayer,130,275,405,25,40,UCBPlayer
37010,UCBPlayer,105,210,315,10,65,UCBPlayer
37011,UCBPlayer,131,271,402,25,41,UCBPlayer
37012,UCBPlayer,105,210,315,10,65,UCBPlayer
37013,UCBPlayer,130,275,405,25,40,UCBPlayer
37014,UCBPlayer,105,210,315,10,65,UCBPlayer
37015,UCBPlayer,130,275,405,25,40,UCBPlayer
37016,UCBPlayer,103,203,306,10,68,UCBPlayer
37017,UCBPlayer,128,283,411,25,38,UCBPlayer
37018,UCBPlayer,111,186,297,10,71,UCBPlayer
37019,UCBPlayer,124,299,423,25,34,UCBPlayer
37020,UCBPlayer,115,170,285,10,75,UCBPlayer
37021,UCBPlayer,120,315,435,25,30,UCBPlayer
37022,UCBPlayer,119,154,273,10,79,UCBPlayer
37023,UCBPlayer,112,332,444,25,27,UCBPlayer
37024,UCBPlayer,127,137,264,10,82,UCBPlayer
37025,UCBPlayer,104,349,453,25,24,UCBPlayer
37026,UCBPlayer,126,126,252,7,85,Tie
37027,UCBPlayer,111,351,462,28,22,UCBPlayer
37028,UCBPlayer,116,126,242,3,87,UCBPlayer
37029,UCBPlayer,122,347,469,32,21,UCBPlayer
37030,UCBPlayer,107,132,239,0,87,UCBPlayer
37031,UCBPlayer,132,337,469,35,22,UCBPlayer
37032,UCBPlayer,103,148,251,0,83,UCBPlayer
37033,UCBPlayer,136,321,457,35,26,UCBPlayer
37034,UCBPlayer,99,164,263,0,79,UCBPlayer
37035,UCBPlayer,140,305,445,35,30,UCBPlayer
37036,UCBPlayer,95,180,275,0,75,UCBPlayer
37037,UCBPlayer,144,289,433,35,34,UCBPlayer
37038,UCBPlayer,91,196,287,0,71,UCBPlayer
37039,UCBPlayer,148,273,421,35,38,UCBPlayer
37040,UCBPlayer,87,212,299,0,67,UCBPlayer
37041,UCBPlayer,152,257,409,35,42,UCBPlayer
37042,UCBPlayer,84,224,308,0,64,UCBPlayer
37043,UCBPlayer,146,251,397,32,45,UCBPlayer
37044,UCBPlayer,89,234,323,3,60,UCBPlayer
37045,UCBPlayer,138,243,381,28,49,UCBPlayer
37046,UCBPlayer,97,242,339,7,56,UCBPlayer
37047,UCBPlayer,130,235,365,24,53,UCBPlayer
37048,UCBPlayer,105,250,355,11,52,UCBPlayer
37049,UCBPlayer,122,227,349,20,57,UCBPlayer
37050,UCBPlayer,109,259,368,15,49,UCBPlayer
37051,UCBPlayer,118,218,336,16,60,UCBPlayer
37052,UCBPlayer,117,267,384,19,45,UCBPlayer
37053,UCBPlayer,110,210,320,12,64,UCBPlayer
37054,UCBPlayer,126,271,397,23,42,UCBPlayer
37055,UCBPlayer,105,210,315,10,65,UCBPlayer
37056,UCBPlayer,130,275,405,25,40,UCBPlayer
37057,UCBPlayer,105,210,315,10,65,UCBPlayer
37058,UCBPlayer,130,275,405,25,40,UCBPlayer
37059,UCBPlayer,106,206,312,10,66,UCBPlayer
37060,UCBPlayer,130,275,405,25,40,UCBPlayer
37061,UCBPlayer,105,210,315,10,65,UCBPlayer
37062,UCBPlayer,131,271,402,25,41,UCBPlayer
37063,UCBPlayer,105,210,315,10,65,UCBPlayer
37064,UCBPlayer,130,275,405,25,40,UCBPlayer
37065,UCBPlayer,105,210,315,10,65,UCBPlayer
37066,UCBPlayer,130,275,405,25,40,UCBPlayer
37067,UCBPlayer,103,203,306,10,68,UCBPlayer
37068,UCBPlayer,128,283,411,25,38,UCBPlayer
37069,UCBPlayer,111,186,297,10,71,UCBPlayer
37070,UCBPlayer,124,299,423,25,34,UCBPlayer
37071,UCBPlayer,115,170,285,10,75,UCBPlayer
37072,UCBPlayer,120,315,435,25,30,UCBPlayer
37073,UCBPlayer,119,154,273,10,79,UCBPlayer
37074,UCBPlayer,112,332,444,25,27,UCBPlayer
37075,UCBPlayer,127,137,264,10,82,UCBPlayer
37076,UCBPlayer,104,349,453,25,24,UCBPlayer
37077,UCBPlayer,126,126,252,7,85,Tie
37078,UCBPlayer,111,351,462,28,22,UCBPlayer
37079,UCBPlayer,116,126,242,3,87,UCBPlayer
37080,UCBPlayer,122,347,469,32,21,UCBPlayer
37081,UCBPlayer,107,132,239,0,87,UCBPlayer
37082,UCBPlayer,132,337,469,35,22,UCBPlayer
37083,UCBPlayer,103,148,251,0,83,UCBPlayer
37084,UCBPlayer,136,321,457,35,26,UCBPlayer
37085,UCBPlayer,99,164,263,0,79,UCBPlayer
37086,UCBPlayer,140,305,445,35,30,UCBPlayer
37087,UCBPlayer,95,180,275,0,75,UCBPlayer
37088,UCBPlayer,144,289,433,35,34,UCBPlayer
37089,UCBPlayer,91,196,287,0,71,UCBPlayer
37090,UCBPlayer,148,273,421,35,38,UCBPlayer
37091,UCBPlayer,87,212,299,0,67,UCBPlayer
37092,UCBPlayer,152,257,409,35,42,UCBPlayer
37093,UCBPlayer,84,224,308,0,64,UCBPlayer
37094,UCBPlayer,146,251,397,32,45,UCBPlayer
37095,UCBPlayer,89,234,323,3,60,UCBPlayer
37096,UCBPlayer,138,243,381,28,49,UCBPlayer
37097,UCBPlayer,97,242,339,7,56,UCBPlayer
37098,UCBPlayer,130,235,365,24,53,UCBPlayer
37099,UCBPlayer,105,250,355,11,52,UCBPlayer
37100,UCBPlayer,122,227,349,20,57,UCBPlayer
37101,UCBPlayer,109,259,368,15,49,UCBPlayer
37102,UCBPlayer,118,218,336,16,60,UCBPlayer
37103,UCBPlayer,117,267,384,19,45,UCBPlayer
37104,UCBPlayer,110,210,320,12,64,UCBPlayer
37105,UCBPlayer,126,271,397,23,42,UCBPlayer
37106,UCBPlayer,105,210,315,10,65,UCBPlayer
37107,UCBPlayer,130,275,405,25,40,UCBPlayer
37108,UCBPlayer,105,210,315,10,65,UCBPlayer
37109,UCBPlayer,130,275,405,25,40,UCBPlayer
37110,UCBPlayer,106,206,312,10,66,UCBPlayer
37111,UCBPlayer,130,275,405,25,40,UCBPlayer
37112,UCBPlayer,105,210,315,10,65,UCBPlayer
37113,UCBPlayer,131,271,402,25,41,UCBPlayer
37114,UCBPlayer,105,210,315,10,65,UCBPlayer
37115,UCBPlayer,130,275,405,25,40,UCBPlayer
37116,UCBPlayer,105,210,315,10,65,UCBPlayer
37117,UCBPlayer,130,275,405,25,40,UCBPlayer
37118,UCBPlayer,103,203,306,10,68,UCBPlayer
37119,UCBPlayer,128,283,411,25,38,UCBPlayer
37120,UCBPlayer,111,186,297,10,71,UCBPlayer
37121,UCBPlayer,124,299,423,25,34,UCBPlayer
37122,UCBPlayer,115,170,285,10,75,UCBPlayer
37123,UCBPlayer,120,315,435,25,30,UCBPlayer
37124,UCBPlayer,119,154,273,10,79,UCBPlayer
37125,UCBPlayer,112,332,444,25,27,UCBPlayer
37126,UCBPlayer,127,137,264,10,82,UCBPlayer
37127,UCBPlayer,104,349,453,25,24,UCBPlayer
37128,UCBPlayer,126,126,252,7,85,Tie
37129,UCBPlayer,111,351,462,28,22,UCBPlayer
37130,UCBPlayer,116,126,242,3,87,UCBPlayer
37131,UCBPlayer,122,347,469,32,21,UCBPlayer
37132,UCBPlayer,107,132,239,0,87,UCBPlayer
37133,UCBPlayer,132,337,469,35,22,UCBPlayer
37134,UCBPlayer,103,148,251,0,83,UCBPlayer
37135,UCBPlayer,136,321,457,35,26,UCBPlayer
37136,UCBPlayer,99,164,263,0,79,UCBPlayer
37137,UCBPlayer,140,305,445,35,30,UCBPlayer
37138,UCBPlayer,95,180,275,0,75,UCBPlayer
37139,UCBPlayer,144,289,433,35,34,UCBPlayer
37140,UCBPlayer,91,196,287,0,71,UCBPlayer
37141,UCBPlayer,148,273,421,35,38,UCBPlayer
37142,UCBPlayer,87,212,299,0,67,UCBPlayer
37143,UCBPlayer,152,257,409,35,42,UCBPlayer
37144,UCBPlayer,84,224,308,0,64,UCBPlayer
37145,UCBPlayer,146,251,397,32,45,UCBPlayer
37146,UCBPlayer,89,234,323,3,60,UCBPlayer
37147,UCBPlayer,138,243,381,28,49,UCBPlayer
37148,UCBPlayer,97,242,339,7,56,UCBPlayer
37149,UCBPlayer,130,235,365,24,53,UCBPlayer
37150,UCBPlayer,105,250,355,11,52,UCBPlayer
37151,UCBPlayer,122,227,349,20,57,UCBPlayer
37152,UCBPlayer,109,259,368,15,49,UCBPlayer
37153,UCBPlayer,118,218,336,16,60,UCBPlayer
37154,UCBPlayer,117,267,384,19,45,UCBPlayer
37155,UCBPlayer,110,210,320,12,64,UCBPlayer
37156,UCBPlayer,126,271,397,23,42,UCBPlayer
37157,UCBPlayer,105,210,315,10,65,UCBPlayer
37158,UCBPlayer,130,275,405,25,40,UCBPlayer
37159,UCBPlayer,105,210,315,10,65,UCBPlayer
37160,UCBPlayer,130,275,405,25,40,UCBPlayer
37161,UCBPlayer,106,206,312,10,66,UCBPlayer
37162,UCBPlayer,130,275,405,25,40,UCBPlayer
37163,UCBPlayer,105,210,315,10,65,UCBPlayer
37164,UCBPlayer,131,271,402,25,41,UCBPlayer
37165,UCBPlayer,105,210,315,10,65,UCBPlayer
37166,UCBPlayer,130,275,405,25,40,UCBPlayer
37167,UCBPlayer,105,210,315,10,65,UCBPlayer
37168,UCBPlayer,130,275,405,25,40,UCBPlayer
37169,UCBPlayer,103,203,306,10,68,UCBPlayer
37170,UCBPlayer,128,283,411,25,38,UCBPlayer
37171,UCBPlayer,111,186,297,10,71,UCBPlayer
37172,UCBPlayer,124,299,423,25,34,UCBPlayer
37173,UCBPlayer,115,170,285,10,75,UCBPlayer
37174,UCBPlayer,120,315,435,25,30,UCBPlayer
37175,UCBPlayer,119,154,273,10,79,UCBPlayer
37176,UCBPlayer,112,332,444,25,27,UCBPlayer
37177,UCBPlayer,127,137,264,10,82,UCBPlayer
37178,UCBPlayer,104,349,453,25,24,UCBPlayer
37179,UCBPlayer,126,126,252,7,85,Tie
37180,UCBPlayer,111,351,462,28,22,UCBPlayer
37181,UCBPlayer,116,126,242,3,87,UCBPlayer
37182,UCBPlayer,122,347,469,32,21,UCBPlayer
37183,UCBPlayer,107,132,239,0,87,UCBPlayer
37184,UCBPlayer,132,337,469,35,22,UCBPlayer
37185,UCBPlayer,103,148,251,0,83,UCBPlayer
37186,UCBPlayer,136,321,457,35,26,UCBPlayer
37187,UCBPlayer,99,164,263,0,79,UCBPlayer
37188,UCBPlayer,140,305,445,35,30,UCBPlayer
37189,UCBPlayer,95,180,275,0,75,UCBPlayer
37190,UCBPlayer,144,289,433,35,34,UCBPlayer
37191,UCBPlayer,91,196,287,0,71,UCBPlayer
37192,UCBPlayer,148,273,421,35,38,UCBPlayer
37193,UCBPlayer,87,212,299,0,67,UCBPlayer
37194,UCBPlayer,152,257,409,35,42,UCBPlayer
37195,UCBPlayer,84,224,308,0,64,UCBPlayer
37196,UCBPlayer,146,251,397,32,45,UCBPlayer
37197,UCBPlayer,89,234,323,3,60,UCBPlayer
37198,UCBPlayer,138,243,381,28,49,UCBPlayer
37199,UCBPlayer,97,242,339,7,56,UCBPlayer
37200,UCBPlayer,130,235,365,24,53,UCBPlayer
37201,UCBPlayer,105,250,355,11,52,UCBPlayer
37202,UCBPlayer,122,227,349,20,57,UCBPlayer
37203,UCBPlayer,109,259,368,15,49,UCBPlayer
37204,UCBPlayer,118,218,336,16,60,UCBPlayer
37205,UCBPlayer,117,267,384,19,45,UCBPlayer
37206,UCBPlayer,110,210,320,12,64,UCBPlayer
37207,UCBPlayer,126,271,397,23,42,UCBPlayer
37208,UCBPlayer,105,210,315,10,65,UCBPlayer
37209,UCBPlayer,130,275,405,25,40,UCBPlayer
37210,UCBPlayer,105,210,315,10,65,UCBPlayer
37211,UCBPlayer,130,275,405,25,40,UCBPlayer
37212,UCBPlayer,106,206,312,10,66,UCBPlayer
37213,UCBPlayer,130,275,405,25,40,UCBPlayer
37214,UCBPlayer,105,210,315,10,65,UCBPlayer
37215,UCBPlayer,131,271,402,25,41,UCBPlayer
37216,UCBPlayer,105,210,315,10,65,UCBPlayer
37217,UCBPlayer,130,275,405,25,40,UCBPlayer
37218,UCBPlayer,105,210,315,10,65,UCBPlayer
37219,UCBPlayer,130,275,405,25,40,UCBPlayer
37220,UCBPlayer,103,203,306,10,68,UCBPlayer
37221,UCBPlayer,128,283,411,25,38,UCBPlayer
37222,UCBPlayer,111,186,297,10,71,UCBPlayer
37223,UCBPlayer,124,299,423,25,34,UCBPlayer
37224,UCBPlayer,115,170,285,10,75,UCBPlayer
37225,UCBPlayer,120,315,435,25,30,UCBPlayer
37226,UCBPlayer,119,154,273,10,79,UCBPlayer
37227,UCBPlayer,112,332,444,25,27,UCBPlayer
37228,UCBPlayer,127,137,264,10,82,UCBPlayer
37229,UCBPlayer,104,349,453,25,24,UCBPlayer
37230,UCBPlayer,126,126,252,7,85,Tie
37231,UCBPlayer,111,351,462,28,22,UCBPlayer
37232,UCBPlayer,116,126,242,3,87,UCBPlayer
37233,UCBPlayer,122,347,469,32,21,UCBPlayer
37234,UCBPlayer,107,132,239,0,87,UCBPlayer
37235,UCBPlayer,132,337,469,35,22,UCBPlayer
37236,UCBPlayer,103,148,251,0,83,UCBPlayer
37237,UCBPlayer,136,321,457,35,26,UCBPlayer
37238,UCBPlayer,99,164,263,0,79,UCBPlayer
37239,UCBPlayer,140,305,445,35,30,UCBPlayer
37240,UCBPlayer,95,180,275,0,75,UCBPlayer
37241,UCBPlayer,144,289,433,35,34,UCBPlayer
37242,UCBPlayer,91,196,287,0,71,UCBPlayer
37243,UCBPlayer,148,273,421,35,38,UCBPlayer
37244,UCBPlayer,87,212,299,0,67,UCBPlayer
37245,UCBPlayer,152,257,409,35,42,UCBPlayer
37246,UCBPlayer,84,224,308,0,64,UCBPlayer
37247,UCBPlayer,146,251,397,32,45,UCBPlayer
37248,UCBPlayer,89,234,323,3,60,UCBPlayer
37249,UCBPlayer,138,243,381,28,49,UCBPlayer
37250,UCBPlayer,97,242,339,7,56,UCBPlayer
37251,UCBPlayer,130,235,365,24,53,UCBPlayer
37252,UCBPlayer,105,250,355,11,52,UCBPlayer
37253,UCBPlayer,122,227,349,20,57,UCBPlayer
37254,UCBPlayer,109,259,368,15,49,UCBPlayer
37255,UCBPlayer,118,218,336,16,60,UCBPlayer
37256,UCBPlayer,117,267,384,19,45,UCBPlayer
37257,UCBPlayer,110,210,320,12,64,UCBPlayer
37258,UCBPlayer,126,271,397,23,42,UCBPlayer
37259,UCBPlayer,105,210,315,10,65,UCBPlayer
37260,UCBPlayer,130,275,405,25,40,UCBPlayer
37261,UCBPlayer,105,210,315,10,65,UCBPlayer
37262,UCBPlayer,130,275,405,25,40,UCBPlayer
37263,UCBPlayer,106,206,312,10,66,UCBPlayer
37264,UCBPlayer,130,275,405,25,40,UCBPlayer
37265,UCBPlayer,105,210,315,10,65,UCBPlayer
37266,UCBPlayer,131,271,402,25,41,UCBPlayer
37267,UCBPlayer,105,210,315,10,65,UCBPlayer
37268,UCBPlayer,130,275,405,25,40,UCBPlayer
37269,UCBPlayer,105,210,315,10,65,UCBPlayer
37270,UCBPlayer,130,275,405,25,40,UCBPlayer
37271,UCBPlayer,103,203,306,10,68,UCBPlayer
37272,UCBPlayer,128,283,411,25,38,UCBPlayer
37273,UCBPlayer,111,186,297,10,71,UCBPlayer
37274,UCBPlayer,124,299,423,25,34,UCBPlayer
37275,UCBPlayer,115,170,285,10,75,UCBPlayer
37276,UCBPlayer,120,315,435,25,30,UCBPlayer
37277,UCBPlayer,119,154,273,10,79,UCBPlayer
37278,UCBPlayer,112,332,444,25,27,UCBPlayer
37279,UCBPlayer,127,137,264,10,82,UCBPlayer
37280,UCBPlayer,104,349,453,25,24,UCBPlayer
37281,UCBPlayer,126,126,252,7,85,Tie
37282,UCBPlayer,111,351,462,28,22,UCBPlayer
37283,UCBPlayer,116,126,242,3,87,UCBPlayer
37284,UCBPlayer,122,347,469,32,21,UCBPlayer
37285,UCBPlayer,107,132,239,0,87,UCBPlayer
37286,UCBPlayer,132,337,469,35,22,UCBPlayer
37287,UCBPlayer,103,148,251,0,83,UCBPlayer
37288,UCBPlayer,136,321,457,35,26,UCBPlayer
37289,UCBPlayer,99,164,263,0,79,UCBPlayer
37290,UCBPlayer,140,305,445,35,30,UCBPlayer
37291,UCBPlayer,95,180,275,0,75,UCBPlayer
37292,UCBPlayer,144,289,433,35,34,UCBPlayer
37293,UCBPlayer,91,196,287,0,71,UCBPlayer
37294,UCBPlayer,148,273,421,35,38,UCBPlayer
37295,UCBPlayer,87,212,299,0,67,UCBPlayer
37296,UCBPlayer,152,257,409,35,42,UCBPlayer
37297,UCBPlayer,84,224,308,0,64,UCBPlayer
37298,UCBPlayer,146,251,397,32,45,UCBPlayer
37299,UCBPlayer,89,234,323,3,60,UCBPlayer
37300,UCBPlayer,138,243,381,28,49,UCBPlayer
37301,UCBPlayer,97,242,339,7,56,UCBPlayer
37302,UCBPlayer,130,235,365,24,53,UCBPlayer
37303,UCBPlayer,105,250,355,11,52,UCBPlayer
37304,UCBPlayer,122,227,349,20,57,UCBPlayer
37305,UCBPlayer,109,259,368,15,49,UCBPlayer
37306,UCBPlayer,118,218,336,16,60,UCBPlayer
37307,UCBPlayer,117,267,384,19,45,UCBPlayer
37308,UCBPlayer,110,210,320,12,64,UCBPlayer
37309,UCBPlayer,126,271,397,23,42,UCBPlayer
37310,UCBPlayer,105,210,315,10,65,UCBPlayer
37311,UCBPlayer,130,275,405,25,40,UCBPlayer
37312,UCBPlayer,105,210,315,10,65,UCBPlayer
37313,UCBPlayer,130,275,405,25,40,UCBPlayer
37314,UCBPlayer,106,206,312,10,66,UCBPlayer
37315,UCBPlayer,130,275,405,25,40,UCBPlayer
37316,UCBPlayer,105,210,315,10,65,UCBPlayer
37317,UCBPlayer,131,271,402,25,41,UCBPlayer
37318,UCBPlayer,105,210,315,10,65,UCBPlayer
37319,UCBPlayer,130,275,405,25,40,UCBPlayer
37320,UCBPlayer,105,210,315,10,65,UCBPlayer
37321,UCBPlayer,130,275,405,25,40,UCBPlayer
37322,UCBPlayer,103,203,306,10,68,UCBPlayer
37323,UCBPlayer,128,283,411,25,38,UCBPlayer
37324,UCBPlayer,111,186,297,10,71,UCBPlayer
37325,UCBPlayer,124,299,423,25,34,UCBPlayer
37326,UCBPlayer,115,170,285,10,75,UCBPlayer
37327,UCBPlayer,120,315,435,25,30,UCBPlayer
37328,UCBPlayer,119,154,273,10,79,UCBPlayer
37329,UCBPlayer,112,332,444,25,27,UCBPlayer
37330,UCBPlayer,127,137,264,10,82,UCBPlayer
37331,UCBPlayer,104,349,453,25,24,UCBPlayer
37332,UCBPlayer,126,126,252,7,85,Tie
37333,UCBPlayer,111,351,462,28,22,UCBPlayer
37334,UCBPlayer,116,126,242,3,87,UCBPlayer
37335,UCBPlayer,122,347,469,32,21,UCBPlayer
37336,UCBPlayer,107,132,239,0,87,UCBPlayer
37337,UCBPlayer,132,337,469,35,22,UCBPlayer
37338,UCBPlayer,103,148,251,0,83,UCBPlayer
37339,UCBPlayer,136,321,457,35,26,UCBPlayer
37340,UCBPlayer,99,164,263,0,79,UCBPlayer
37341,UCBPlayer,140,305,445,35,30,UCBPlayer
37342,UCBPlayer,95,180,275,0,75,UCBPlayer
37343,UCBPlayer,144,289,433,35,34,UCBPlayer
37344,UCBPlayer,91,196,287,0,71,UCBPlayer
37345,UCBPlayer,148,273,421,35,38,UCBPlayer
37346,UCBPlayer,87,212,299,0,67,UCBPlayer
37347,UCBPlayer,152,257,409,35,42,UCBPlayer
37348,UCBPlayer,84,224,308,0,64,UCBPlayer
37349,UCBPlayer,146,251,397,32,45,UCBPlayer
37350,UCBPlayer,89,234,323,3,60,UCBPlayer
37351,UCBPlayer,138,243,381,28,49,UCBPlayer
37352,UCBPlayer,97,242,339,7,56,UCBPlayer
37353,UCBPlayer,130,235,365,24,53,UCBPlayer
37354,UCBPlayer,105,250,355,11,52,UCBPlayer
37355,UCBPlayer,122,227,349,20,57,UCBPlayer
37356,UCBPlayer,109,259,368,15,49,UCBPlayer
37357,UCBPlayer,118,218,336,16,60,UCBPlayer
37358,UCBPlayer,117,267,384,19,45,UCBPlayer
37359,UCBPlayer,110,210,320,12,64,UCBPlayer
37360,UCBPlayer,126,271,397,23,42,UCBPlayer
37361,UCBPlayer,105,210,315,10,65,UCBPlayer
37362,UCBPlayer,130,275,405,25,40,UCBPlayer
37363,UCBPlayer,105,210,315,10,65,UCBPlayer
37364,UCBPlayer,130,275,405,25,40,UCBPlayer
37365,UCBPlayer,106,206,312,10,66,UCBPlayer
37366,UCBPlayer,130,275,405,25,40,UCBPlayer
37367,UCBPlayer,105,210,315,10,65,UCBPlayer
37368,UCBPlayer,131,271,402,25,41,UCBPlayer
37369,UCBPlayer,105,210,315,10,65,UCBPlayer
37370,UCBPlayer,130,275,405,25,40,UCBPlayer
37371,UCBPlayer,105,210,315,10,65,UCBPlayer
37372,UCBPlayer,130,275,405,25,40,UCBPlayer
37373,UCBPlayer,103,203,306,10,68,UCBPlayer
37374,UCBPlayer,128,283,411,25,38,UCBPlayer
37375,UCBPlayer,111,186,297,10,71,UCBPlayer
37376,UCBPlayer,124,299,423,25,34,UCBPlayer
37377,UCBPlayer,115,170,285,10,75,UCBPlayer
37378,UCBPlayer,120,315,435,25,30,UCBPlayer
37379,UCBPlayer,119,154,273,10,79,UCBPlayer
37380,UCBPlayer,112,332,444,25,27,UCBPlayer
37381,UCBPlayer,127,137,264,10,82,UCBPlayer
37382,UCBPlayer,104,349,453,25,24,UCBPlayer
37383,UCBPlayer,126,126,252,7,85,Tie
37384,UCBPlayer,111,351,462,28,22,UCBPlayer
37385,UCBPlayer,116,126,242,3,87,UCBPlayer
37386,UCBPlayer,122,347,469,32,21,UCBPlayer
37387,UCBPlayer,107,132,239,0,87,UCBPlayer
37388,UCBPlayer,132,337,469,35,22,UCBPlayer
37389,UCBPlayer,103,148,251,0,83,UCBPlayer
37390,UCBPlayer,136,321,457,35,26,UCBPlayer
37391,UCBPlayer,99,164,263,0,79,UCBPlayer
37392,UCBPlayer,140,305,445,35,30,UCBPlayer
37393,UCBPlayer,95,180,275,0,75,UCBPlayer
37394,UCBPlayer,144,289,433,35,34,UCBPlayer
37395,UCBPlayer,91,196,287,0,71,UCBPlayer
37396,UCBPlayer,148,273,421,35,38,UCBPlayer
37397,UCBPlayer,87,212,299,0,67,UCBPlayer
37398,UCBPlayer,152,257,409,35,42,UCBPlayer
37399,UCBPlayer,84,224,308,0,64,UCBPlayer
37400,UCBPlayer,146,251,397,32,45,UCBPlayer
37401,UCBPlayer,89,234,323,3,60,UCBPlayer
37402,UCBPlayer,138,243,381,28,49,UCBPlayer
37403,UCBPlayer,97,242,339,7,56,UCBPlayer
37404,UCBPlayer,130,235,365,24,53,UCBPlayer
37405,UCBPlayer,105,250,355,11,52,UCBPlayer
37406,UCBPlayer,122,227,349,20,57,UCBPlayer
37407,UCBPlayer,109,259,368,15,49,UCBPlayer
37408,UCBPlayer,118,218,336,16,60,UCBPlayer
37409,UCBPlayer,117,267,384,19,45,UCBPlayer
37410,UCBPlayer,110,210,320,12,64,UCBPlayer
37411,UCBPlayer,126,271,397,23,42,UCBPlayer
37412,UCBPlayer,105,210,315,10,65,UCBPlayer
37413,UCBPlayer,130,275,405,25,40,UCBPlayer
37414,UCBPlayer,105,210,315,10,65,UCBPlayer
37415,UCBPlayer,130,275,405,25,40,UCBPlayer
37416,UCBPlayer,106,206,312,10,66,UCBPlayer
37417,UCBPlayer,130,275,405,25,40,UCBPlayer
37418,UCBPlayer,105,210,315,10,65,UCBPlayer
37419,UCBPlayer,131,271,402,25,41,UCBPlayer
37420,UCBPlayer,105,210,315,10,65,UCBPlayer
37421,UCBPlayer,130,275,405,25,40,UCBPlayer
37422,UCBPlayer,105,210,315,10,65,UCBPlayer
37423,UCBPlayer,130,275,405,25,40,UCBPlayer
37424,UCBPlayer,103,203,306,10,68,UCBPlayer
37425,UCBPlayer,128,283,411,25,38,UCBPlayer
37426,UCBPlayer,111,186,297,10,71,UCBPlayer
37427,UCBPlayer,124,299,423,25,34,UCBPlayer
37428,UCBPlayer,115,170,285,10,75,UCBPlayer
37429,UCBPlayer,120,315,435,25,30,UCBPlayer
37430,UCBPlayer,119,154,273,10,79,UCBPlayer
37431,UCBPlayer,112,332,444,25,27,UCBPlayer
37432,UCBPlayer,127,137,264,10,82,UCBPlayer
37433,UCBPlayer,104,349,453,25,24,UCBPlayer
37434,UCBPlayer,126,126,252,7,85,Tie
37435,UCBPlayer,111,351,462,28,22,UCBPlayer
37436,UCBPlayer,116,126,242,3,87,UCBPlayer
37437,UCBPlayer,122,347,469,32,21,UCBPlayer
37438,UCBPlayer,107,132,239,0,87,UCBPlayer
37439,UCBPlayer,132,337,469,35,22,UCBPlayer
37440,UCBPlayer,103,148,251,0,83,UCBPlayer
37441,UCBPlayer,136,321,457,35,26,UCBPlayer
37442,UCBPlayer,99,164,263,0,79,UCBPlayer
37443,UCBPlayer,140,305,445,35,30,UCBPlayer
37444,UCBPlayer,95,180,275,0,75,UCBPlayer
37445,UCBPlayer,144,289,433,35,34,UCBPlayer
37446,UCBPlayer,91,196,287,0,71,UCBPlayer
37447,UCBPlayer,148,273,421,35,38,UCBPlayer
37448,UCBPlayer,87,212,299,0,67,UCBPlayer
37449,UCBPlayer,152,257,409,35,42,UCBPlayer
37450,UCBPlayer,84,224,308,0,64,UCBPlayer
37451,UCBPlayer,146,251,397,32,45,UCBPlayer
37452,UCBPlayer,89,234,323,3,60,UCBPlayer
37453,UCBPlayer,138,243,381,28,49,UCBPlayer
37454,UCBPlayer,97,242,339,7,56,UCBPlayer
37455,UCBPlayer,130,235,365,24,53,UCBPlayer
37456,UCBPlayer,105,250,355,11,52,UCBPlayer
37457,UCBPlayer,122,227,349,20,57,UCBPlayer
37458,UCBPlayer,109,259,368,15,49,UCBPlayer
37459,UCBPlayer,118,218,336,16,60,UCBPlayer
37460,UCBPlayer,117,267,384,19,45,UCBPlayer
37461,UCBPlayer,110,210,320,12,64,UCBPlayer
37462,UCBPlayer,126,271,397,23,42,UCBPlayer
37463,UCBPlayer,105,210,315,10,65,UCBPlayer
37464,UCBPlayer,130,275,405,25,40,UCBPlayer
37465,UCBPlayer,105,210,315,10,65,UCBPlayer
37466,UCBPlayer,130,275,405,25,40,UCBPlayer
37467,UCBPlayer,106,206,312,10,66,UCBPlayer
37468,UCBPlayer,130,275,405,25,40,UCBPlayer
37469,UCBPlayer,105,210,315,10,65,UCBPlayer
37470,UCBPlayer,131,271,402,25,41,UCBPlayer
37471,UCBPlayer,105,210,315,10,65,UCBPlayer
37472,UCBPlayer,130,275,405,25,40,UCBPlayer
37473,UCBPlayer,105,210,315,10,65,UCBPlayer
37474,UCBPlayer,130,275,405,25,40,UCBPlayer
37475,UCBPlayer,103,203,306,10,68,UCBPlayer
37476,UCBPlayer,128,283,411,25,38,UCBPlayer
37477,UCBPlayer,111,186,297,10,71,UCBPlayer
37478,UCBPlayer,124,299,423,25,34,UCBPlayer
37479,UCBPlayer,115,170,285,10,75,UCBPlayer
37480,UCBPlayer,120,315,435,25,30,UCBPlayer
37481,UCBPlayer,119,154,273,10,79,UCBPlayer
37482,UCBPlayer,112,332,444,25,27,UCBPlayer
37483,UCBPlayer,127,137,264,10,82,UCBPlayer
37484,UCBPlayer,104,349,453,25,24,UCBPlayer
37485,UCBPlayer,126,126,252,7,85,Tie
37486,UCBPlayer,111,351,462,28,22,UCBPlayer
37487,UCBPlayer,116,126,242,3,87,UCBPlayer
37488,UCBPlayer,122,347,469,32,21,UCBPlayer
37489,UCBPlayer,107,132,239,0,87,UCBPlayer
37490,UCBPlayer,132,337,469,35,22,UCBPlayer
37491,UCBPlayer,103,148,251,0,83,UCBPlayer
37492,UCBPlayer,136,321,457,35,26,UCBPlayer
37493,UCBPlayer,99,164,263,0,79,UCBPlayer
37494,UCBPlayer,140,305,445,35,30,UCBPlayer
37495,UCBPlayer,95,180,275,0,75,UCBPlayer
37496,UCBPlayer,144,289,433,35,34,UCBPlayer
37497,UCBPlayer,91,196,287,0,71,UCBPlayer
37498,UCBPlayer,148,273,421,35,38,UCBPlayer
37499,UCBPlayer,87,212,299,0,67,UCBPlayer
37500,UCBPlayer,152,257,409,35,42,UCBPlayer
37501,UCBPlayer,84,224,308,0,64,UCBPlayer
37502,UCBPlayer,146,251,397,32,45,UCBPlayer
37503,UCBPlayer,89,234,323,3,60,UCBPlayer
37504,UCBPlayer,138,243,381,28,49,UCBPlayer
37505,UCBPlayer,97,242,339,7,56,UCBPlayer
37506,UCBPlayer,130,235,365,24,53,UCBPlayer
37507,UCBPlayer,105,250,355,11,52,UCBPlayer
37508,UCBPlayer,122,227,349,20,57,UCBPlayer
37509,UCBPlayer,109,259,368,15,49,UCBPlayer
37510,UCBPlayer,118,218,336,16,60,UCBPlayer
37511,UCBPlayer,117,267,384,19,45,UCBPlayer
37512,UCBPlayer,110,210,320,12,64,UCBPlayer
37513,UCBPlayer,126,271,397,23,42,UCBPlayer
37514,UCBPlayer,105,210,315,10,65,UCBPlayer
37515,UCBPlayer,130,275,405,25,40,UCBPlayer
37516,UCBPlayer,105,210,315,10,65,UCBPlayer
37517,UCBPlayer,130,275,405,25,40,UCBPlayer
37518,UCBPlayer,106,206,312,10,66,UCBPlayer
37519,UCBPlayer,130,275,405,25,40,UCBPlayer
37520,UCBPlayer,105,210,315,10,65,UCBPlayer
37521,UCBPlayer,131,271,402,25,41,UCBPlayer
37522,UCBPlayer,105,210,315,10,65,UCBPlayer
37523,UCBPlayer,130,275,405,25,40,UCBPlayer
37524,UCBPlayer,105,210,315,10,65,UCBPlayer
37525,UCBPlayer,130,275,405,25,40,UCBPlayer
37526,UCBPlayer,103,203,306,10,68,UCBPlayer
37527,UCBPlayer,128,283,411,25,38,UCBPlayer
37528,UCBPlayer,111,186,297,10,71,UCBPlayer
37529,UCBPlayer,124,299,423,25,34,UCBPlayer
37530,UCBPlayer,115,170,285,10,75,UCBPlayer
37531,UCBPlayer,120,315,435,25,30,UCBPlayer
37532,UCBPlayer,119,154,273,10,79,UCBPlayer
37533,UCBPlayer,112,332,444,25,27,UCBPlayer
37534,UCBPlayer,127,137,264,10,82,UCBPlayer
37535,UCBPlayer,104,349,453,25,24,UCBPlayer
37536,UCBPlayer,126,126,252,7,85,Tie
37537,UCBPlayer,111,351,462,28,22,UCBPlayer
37538,UCBPlayer,116,126,242,3,87,UCBPlayer
37539,UCBPlayer,122,347,469,32,21,UCBPlayer
37540,UCBPlayer,107,132,239,0,87,UCBPlayer
37541,UCBPlayer,132,337,469,35,22,UCBPlayer
37542,UCBPlayer,103,148,251,0,83,UCBPlayer
37543,UCBPlayer,136,321,457,35,26,UCBPlayer
37544,UCBPlayer,99,164,263,0,79,UCBPlayer
37545,UCBPlayer,140,305,445,35,30,UCBPlayer
37546,UCBPlayer,95,180,275,0,75,UCBPlayer
37547,UCBPlayer,144,289,433,35,34,UCBPlayer
37548,UCBPlayer,91,196,287,0,71,UCBPlayer
37549,UCBPlayer,148,273,421,35,38,UCBPlayer
37550,UCBPlayer,87,212,299,0,67,UCBPlayer
37551,UCBPlayer,152,257,409,35,42,UCBPlayer
37552,UCBPlayer,84,224,308,0,64,UCBPlayer
37553,UCBPlayer,146,251,397,32,45,UCBPlayer
37554,UCBPlayer,89,234,323,3,60,UCBPlayer
37555,UCBPlayer,138,243,381,28,49,UCBPlayer
37556,UCBPlayer,97,242,339,7,56,UCBPlayer
37557,UCBPlayer,130,235,365,24,53,UCBPlayer
37558,UCBPlayer,105,250,355,11,52,UCBPlayer
37559,UCBPlayer,122,227,349,20,57,UCBPlayer
37560,UCBPlayer,109,259,368,15,49,UCBPlayer
37561,UCBPlayer,118,218,336,16,60,UCBPlayer
37562,UCBPlayer,117,267,384,19,45,UCBPlayer
37563,UCBPlayer,110,210,320,12,64,UCBPlayer
37564,UCBPlayer,126,271,397,23,42,UCBPlayer
37565,UCBPlayer,105,210,315,10,65,UCBPlayer
37566,UCBPlayer,130,275,405,25,40,UCBPlayer
37567,UCBPlayer,105,210,315,10,65,UCBPlayer
37568,UCBPlayer,130,275,405,25,40,UCBPlayer
37569,UCBPlayer,106,206,312,10,66,UCBPlayer
37570,UCBPlayer,130,275,405,25,40,UCBPlayer
37571,UCBPlayer,105,210,315,10,65,UCBPlayer
37572,UCBPlayer,131,271,402,25,41,UCBPlayer
37573,UCBPlayer,105,210,315,10,65,UCBPlayer
37574,UCBPlayer,130,275,405,25,40,UCBPlayer
37575,UCBPlayer,105,210,315,10,65,UCBPlayer
37576,UCBPlayer,130,275,405,25,40,UCBPlayer
37577,UCBPlayer,103,203,306,10,68,UCBPlayer
37578,UCBPlayer,128,283,411,25,38,UCBPlayer
37579,UCBPlayer,111,186,297,10,71,UCBPlayer
37580,UCBPlayer,124,299,423,25,34,UCBPlayer
37581,UCBPlayer,115,170,285,10,75,UCBPlayer
37582,UCBPlayer,120,315,435,25,30,UCBPlayer
37583,UCBPlayer,119,154,273,10,79,UCBPlayer
37584,UCBPlayer,112,332,444,25,27,UCBPlayer
37585,UCBPlayer,127,137,264,10,82,UCBPlayer
37586,UCBPlayer,104,349,453,25,24,UCBPlayer
37587,UCBPlayer,126,126,252,7,85,Tie
37588,UCBPlayer,111,351,462,28,22,UCBPlayer
37589,UCBPlayer,116,126,242,3,87,UCBPlayer
37590,UCBPlayer,122,347,469,32,21,UCBPlayer
37591,UCBPlayer,107,132,239,0,87,UCBPlayer
37592,UCBPlayer,132,337,469,35,22,UCBPlayer
37593,UCBPlayer,103,148,251,0,83,UCBPlayer
37594,UCBPlayer,136,321,457,35,26,UCBPlayer
37595,UCBPlayer,99,164,263,0,79,UCBPlayer
37596,UCBPlayer,140,305,445,35,30,UCBPlayer
37597,UCBPlayer,95,180,275,0,75,UCBPlayer
37598,UCBPlayer,144,289,433,35,34,UCBPlayer
37599,UCBPlayer,91,196,287,0,71,UCBPlayer
37600,UCBPlayer,148,273,421,35,38,UCBPlayer
37601,UCBPlayer,87,212,299,0,67,UCBPlayer
37602,UCBPlayer,152,257,409,35,42,UCBPlayer
37603,UCBPlayer,84,224,308,0,64,UCBPlayer
37604,UCBPlayer,146,251,397,32,45,UCBPlayer
37605,UCBPlayer,89,234,323,3,60,UCBPlayer
37606,UCBPlayer,138,243,381,28,49,UCBPlayer
37607,UCBPlayer,97,242,339,7,56,UCBPlayer
37608,UCBPlayer,130,235,365,24,53,UCBPlayer
37609,UCBPlayer,105,250,355,11,52,UCBPlayer
37610,UCBPlayer,122,227,349,20,57,UCBPlayer
37611,UCBPlayer,109,259,368,15,49,UCBPlayer
37612,UCBPlayer,118,218,336,16,60,UCBPlayer
37613,UCBPlayer,117,267,384,19,45,UCBPlayer
37614,UCBPlayer,110,210,320,12,64,UCBPlayer
37615,UCBPlayer,126,271,397,23,42,UCBPlayer
37616,UCBPlayer,105,210,315,10,65,UCBPlayer
37617,UCBPlayer,130,275,405,25,40,UCBPlayer
37618,UCBPlayer,105,210,315,10,65,UCBPlayer
37619,UCBPlayer,130,275,405,25,40,UCBPlayer
37620,UCBPlayer,106,206,312,10,66,UCBPlayer
37621,UCBPlayer,130,275,405,25,40,UCBPlayer
37622,UCBPlayer,105,210,315,10,65,UCBPlayer
37623,UCBPlayer,131,271,402,25,41,UCBPlayer
37624,UCBPlayer,105,210,315,10,65,UCBPlayer
37625,UCBPlayer,130,275,405,25,40,UCBPlayer
37626,UCBPlayer,105,210,315,10,65,UCBPlayer
37627,UCBPlayer,130,275,405,25,40,UCBPlayer
37628,UCBPlayer,103,203,306,10,68,UCBPlayer
37629,UCBPlayer,128,283,411,25,38,UCBPlayer
37630,UCBPlayer,111,186,297,10,71,UCBPlayer
37631,UCBPlayer,124,299,423,25,34,UCBPlayer
37632,UCBPlayer,115,170,285,10,75,UCBPlayer
37633,UCBPlayer,120,315,435,25,30,UCBPlayer
37634,UCBPlayer,119,154,273,10,79,UCBPlayer
37635,UCBPlayer,112,332,444,25,27,UCBPlayer
37636,UCBPlayer,127,137,264,10,82,UCBPlayer
37637,UCBPlayer,104,349,453,25,24,UCBPlayer
37638,UCBPlayer,126,126,252,7,85,Tie
37639,UCBPlayer,111,351,462,28,22,UCBPlayer
37640,UCBPlayer,116,126,242,3,87,UCBPlayer
37641,UCBPlayer,122,347,469,32,21,UCBPlayer
37642,UCBPlayer,107,132,239,0,87,UCBPlayer
37643,UCBPlayer,132,337,469,35,22,UCBPlayer
37644,UCBPlayer,103,148,251,0,83,UCBPlayer
37645,UCBPlayer,136,321,457,35,26,UCBPlayer
37646,UCBPlayer,99,164,263,0,79,UCBPlayer
37647,UCBPlayer,140,305,445,35,30,UCBPlayer
37648,UCBPlayer,95,180,275,0,75,UCBPlayer
37649,UCBPlayer,144,289,433,35,34,UCBPlayer
37650,UCBPlayer,91,196,287,0,71,UCBPlayer
37651,UCBPlayer,148,273,421,35,38,UCBPlayer
37652,UCBPlayer,87,212,299,0,67,UCBPlayer
37653,UCBPlayer,152,257,409,35,42,UCBPlayer
37654,UCBPlayer,84,224,308,0,64,UCBPlayer
37655,UCBPlayer,146,251,397,32,45,UCBPlayer
37656,UCBPlayer,89,234,323,3,60,UCBPlayer
37657,UCBPlayer,138,243,381,28,49,UCBPlayer
37658,UCBPlayer,97,242,339,7,56,UCBPlayer
37659,UCBPlayer,130,235,365,24,53,UCBPlayer
37660,UCBPlayer,105,250,355,11,52,UCBPlayer
37661,UCBPlayer,122,227,349,20,57,UCBPlayer
37662,UCBPlayer,109,259,368,15,49,UCBPlayer
37663,UCBPlayer,118,218,336,16,60,UCBPlayer
37664,UCBPlayer,117,267,384,19,45,UCBPlayer
37665,UCBPlayer,110,210,320,12,64,UCBPlayer
37666,UCBPlayer,126,271,397,23,42,UCBPlayer
37667,UCBPlayer,105,210,315,10,65,UCBPlayer
37668,UCBPlayer,130,275,405,25,40,UCBPlayer
37669,UCBPlayer,105,210,315,10,65,UCBPlayer
37670,UCBPlayer,130,275,405,25,40,UCBPlayer
37671,UCBPlayer,106,206,312,10,66,UCBPlayer
37672,UCBPlayer,130,275,405,25,40,UCBPlayer
37673,UCBPlayer,105,210,315,10,65,UCBPlayer
37674,UCBPlayer,131,271,402,25,41,UCBPlayer
37675,UCBPlayer,105,210,315,10,65,UCBPlayer
37676,UCBPlayer,130,275,405,25,40,UCBPlayer
37677,UCBPlayer,105,210,315,10,65,UCBPlayer
37678,UCBPlayer,130,275,405,25,40,UCBPlayer
37679,UCBPlayer,103,203,306,10,68,UCBPlayer
37680,UCBPlayer,128,283,411,25,38,UCBPlayer
37681,UCBPlayer,111,186,297,10,71,UCBPlayer
37682,UCBPlayer,124,299,423,25,34,UCBPlayer
37683,UCBPlayer,115,170,285,10,75,UCBPlayer
37684,UCBPlayer,120,315,435,25,30,UCBPlayer
37685,UCBPlayer,119,154,273,10,79,UCBPlayer
37686,UCBPlayer,112,332,444,25,27,UCBPlayer
37687,UCBPlayer,127,137,264,10,82,UCBPlayer
37688,UCBPlayer,104,349,453,25,24,UCBPlayer
37689,UCBPlayer,126,126,252,7,85,Tie
37690,UCBPlayer,111,351,462,28,22,UCBPlayer
37691,UCBPlayer,116,126,242,3,87,UCBPlayer
37692,UCBPlayer,122,347,469,32,21,UCBPlayer
37693,UCBPlayer,107,132,239,0,87,UCBPlayer
37694,UCBPlayer,132,337,469,35,22,UCBPlayer
37695,UCBPlayer,103,148,251,0,83,UCBPlayer
37696,UCBPlayer,136,321,457,35,26,UCBPlayer
37697,UCBPlayer,99,164,263,0,79,UCBPlayer
37698,UCBPlayer,140,305,445,35,30,UCBPlayer
37699,UCBPlayer,95,180,275,0,75,UCBPlayer
37700,UCBPlayer,144,289,433,35,34,UCBPlayer
37701,UCBPlayer,91,196,287,0,71,UCBPlayer
37702,UCBPlayer,148,273,421,35,38,UCBPlayer
37703,UCBPlayer,87,212,299,0,67,UCBPlayer
37704,UCBPlayer,152,257,409,35,42,UCBPlayer
37705,UCBPlayer,84,224,308,0,64,UCBPlayer
37706,UCBPlayer,146,251,397,32,45,UCBPlayer
37707,UCBPlayer,89,234,323,3,60,UCBPlayer
37708,UCBPlayer,138,243,381,28,49,UCBPlayer
37709,UCBPlayer,97,242,339,7,56,UCBPlayer
37710,UCBPlayer,130,235,365,24,53,UCBPlayer
37711,UCBPlayer,105,250,355,11,52,UCBPlayer
37712,UCBPlayer,122,227,349,20,57,UCBPlayer
37713,UCBPlayer,109,259,368,15,49,UCBPlayer
37714,UCBPlayer,118,218,336,16,60,UCBPlayer
37715,UCBPlayer,117,267,384,19,45,UCBPlayer
37716,UCBPlayer,110,210,320,12,64,UCBPlayer
37717,UCBPlayer,126,271,397,23,42,UCBPlayer
37718,UCBPlayer,105,210,315,10,65,UCBPlayer
37719,UCBPlayer,130,275,405,25,40,UCBPlayer
37720,UCBPlayer,105,210,315,10,65,UCBPlayer
37721,UCBPlayer,130,275,405,25,40,UCBPlayer
37722,UCBPlayer,106,206,312,10,66,UCBPlayer
37723,UCBPlayer,130,275,405,25,40,UCBPlayer
37724,UCBPlayer,105,210,315,10,65,UCBPlayer
37725,UCBPlayer,131,271,402,25,41,UCBPlayer
37726,UCBPlayer,105,210,315,10,65,UCBPlayer
37727,UCBPlayer,130,275,405,25,40,UCBPlayer
37728,UCBPlayer,105,210,315,10,65,UCBPlayer
37729,UCBPlayer,130,275,405,25,40,UCBPlayer
37730,UCBPlayer,103,203,306,10,68,UCBPlayer
37731,UCBPlayer,128,283,411,25,38,UCBPlayer
37732,UCBPlayer,111,186,297,10,71,UCBPlayer
37733,UCBPlayer,124,299,423,25,34,UCBPlayer
37734,UCBPlayer,115,170,285,10,75,UCBPlayer
37735,UCBPlayer,120,315,435,25,30,UCBPlayer
37736,UCBPlayer,119,154,273,10,79,UCBPlayer
37737,UCBPlayer,112,332,444,25,27,UCBPlayer
37738,UCBPlayer,127,137,264,10,82,UCBPlayer
37739,UCBPlayer,104,349,453,25,24,UCBPlayer
37740,UCBPlayer,126,126,252,7,85,Tie
37741,UCBPlayer,111,351,462,28,22,UCBPlayer
37742,UCBPlayer,116,126,242,3,87,UCBPlayer
37743,UCBPlayer,122,347,469,32,21,UCBPlayer
37744,UCBPlayer,107,132,239,0,87,UCBPlayer
37745,UCBPlayer,132,337,469,35,22,UCBPlayer
37746,UCBPlayer,103,148,251,0,83,UCBPlayer
37747,UCBPlayer,136,321,457,35,26,UCBPlayer
37748,UCBPlayer,99,164,263,0,79,UCBPlayer
37749,UCBPlayer,140,305,445,35,30,UCBPlayer
37750,UCBPlayer,95,180,275,0,75,UCBPlayer
37751,UCBPlayer,144,289,433,35,34,UCBPlayer
37752,UCBPlayer,91,196,287,0,71,UCBPlayer
37753,UCBPlayer,148,273,421,35,38,UCBPlayer
37754,UCBPlayer,87,212,299,0,67,UCBPlayer
37755,UCBPlayer,152,257,409,35,42,UCBPlayer
37756,UCBPlayer,84,224,308,0,64,UCBPlayer
37757,UCBPlayer,146,251,397,32,45,UCBPlayer
37758,UCBPlayer,89,234,323,3,60,UCBPlayer
37759,UCBPlayer,138,243,381,28,49,UCBPlayer
37760,UCBPlayer,97,242,339,7,56,UCBPlayer
37761,UCBPlayer,130,235,365,24,53,UCBPlayer
37762,UCBPlayer,105,250,355,11,52,UCBPlayer
37763,UCBPlayer,122,227,349,20,57,UCBPlayer
37764,UCBPlayer,109,259,368,15,49,UCBPlayer
37765,UCBPlayer,118,218,336,16,60,UCBPlayer
37766,UCBPlayer,117,267,384,19,45,UCBPlayer
37767,UCBPlayer,110,210,320,12,64,UCBPlayer
37768,UCBPlayer,126,271,397,23,42,UCBPlayer
37769,UCBPlayer,105,210,315,10,65,UCBPlayer
37770,UCBPlayer,130,275,405,25,40,UCBPlayer
37771,UCBPlayer,105,210,315,10,65,UCBPlayer
37772,UCBPlayer,130,275,405,25,40,UCBPlayer
37773,UCBPlayer,106,206,312,10,66,UCBPlayer
37774,UCBPlayer,130,275,405,25,40,UCBPlayer
37775,UCBPlayer,105,210,315,10,65,UCBPlayer
37776,UCBPlayer,131,271,402,25,41,UCBPlayer
37777,UCBPlayer,105,210,315,10,65,UCBPlayer
37778,UCBPlayer,130,275,405,25,40,UCBPlayer
37779,UCBPlayer,105,210,315,10,65,UCBPlayer
37780,UCBPlayer,130,275,405,25,40,UCBPlayer
37781,UCBPlayer,103,203,306,10,68,UCBPlayer
37782,UCBPlayer,128,283,411,25,38,UCBPlayer
37783,UCBPlayer,111,186,297,10,71,UCBPlayer
37784,UCBPlayer,124,299,423,25,34,UCBPlayer
37785,UCBPlayer,115,170,285,10,75,UCBPlayer
37786,UCBPlayer,120,315,435,25,30,UCBPlayer
37787,UCBPlayer,119,154,273,10,79,UCBPlayer
37788,UCBPlayer,112,332,444,25,27,UCBPlayer
37789,UCBPlayer,127,137,264,10,82,UCBPlayer
37790,UCBPlayer,104,349,453,25,24,UCBPlayer
37791,UCBPlayer,126,126,252,7,85,Tie
37792,UCBPlayer,111,351,462,28,22,UCBPlayer
37793,UCBPlayer,116,126,242,3,87,UCBPlayer
37794,UCBPlayer,122,347,469,32,21,UCBPlayer
37795,UCBPlayer,107,132,239,0,87,UCBPlayer
37796,UCBPlayer,132,337,469,35,22,UCBPlayer
37797,UCBPlayer,103,148,251,0,83,UCBPlayer
37798,UCBPlayer,136,321,457,35,26,UCBPlayer
37799,UCBPlayer,99,164,263,0,79,UCBPlayer
37800,UCBPlayer,140,305,445,35,30,UCBPlayer
37801,UCBPlayer,95,180,275,0,75,UCBPlayer
37802,UCBPlayer,144,289,433,35,34,UCBPlayer
37803,UCBPlayer,91,196,287,0,71,UCBPlayer
37804,UCBPlayer,148,273,421,35,38,UCBPlayer
37805,UCBPlayer,87,212,299,0,67,UCBPlayer
37806,UCBPlayer,152,257,409,35,42,UCBPlayer
37807,UCBPlayer,84,224,308,0,64,UCBPlayer
37808,UCBPlayer,146,251,397,32,45,UCBPlayer
37809,UCBPlayer,89,234,323,3,60,UCBPlayer
37810,UCBPlayer,138,243,381,28,49,UCBPlayer
37811,UCBPlayer,97,242,339,7,56,UCBPlayer
37812,UCBPlayer,130,235,365,24,53,UCBPlayer
37813,UCBPlayer,105,250,355,11,52,UCBPlayer
37814,UCBPlayer,122,227,349,20,57,UCBPlayer
37815,UCBPlayer,109,259,368,15,49,UCBPlayer
37816,UCBPlayer,118,218,336,16,60,UCBPlayer
37817,UCBPlayer,117,267,384,19,45,UCBPlayer
37818,UCBPlayer,110,210,320,12,64,UCBPlayer
37819,UCBPlayer,126,271,397,23,42,UCBPlayer
37820,UCBPlayer,105,210,315,10,65,UCBPlayer
37821,UCBPlayer,130,275,405,25,40,UCBPlayer
37822,UCBPlayer,105,210,315,10,65,UCBPlayer
37823,UCBPlayer,130,275,405,25,40,UCBPlayer
37824,UCBPlayer,106,206,312,10,66,UCBPlayer
37825,UCBPlayer,130,275,405,25,40,UCBPlayer
37826,UCBPlayer,105,210,315,10,65,UCBPlayer
37827,UCBPlayer,131,271,402,25,41,UCBPlayer
37828,UCBPlayer,105,210,315,10,65,UCBPlayer
37829,UCBPlayer,130,275,405,25,40,UCBPlayer
37830,UCBPlayer,105,210,315,10,65,UCBPlayer
37831,UCBPlayer,130,275,405,25,40,UCBPlayer
37832,UCBPlayer,103,203,306,10,68,UCBPlayer
37833,UCBPlayer,128,283,411,25,38,UCBPlayer
37834,UCBPlayer,111,186,297,10,71,UCBPlayer
37835,UCBPlayer,124,299,423,25,34,UCBPlayer
37836,UCBPlayer,115,170,285,10,75,UCBPlayer
37837,UCBPlayer,120,315,435,25,30,UCBPlayer
37838,UCBPlayer,119,154,273,10,79,UCBPlayer
37839,UCBPlayer,112,332,444,25,27,UCBPlayer
37840,UCBPlayer,127,137,264,10,82,UCBPlayer
37841,UCBPlayer,104,349,453,25,24,UCBPlayer
37842,UCBPlayer,126,126,252,7,85,Tie
37843,UCBPlayer,111,351,462,28,22,UCBPlayer
37844,UCBPlayer,116,126,242,3,87,UCBPlayer
37845,UCBPlayer,122,347,469,32,21,UCBPlayer
37846,UCBPlayer,107,132,239,0,87,UCBPlayer
37847,UCBPlayer,132,337,469,35,22,UCBPlayer
37848,UCBPlayer,103,148,251,0,83,UCBPlayer
37849,UCBPlayer,136,321,457,35,26,UCBPlayer
37850,UCBPlayer,99,164,263,0,79,UCBPlayer
37851,UCBPlayer,140,305,445,35,30,UCBPlayer
37852,UCBPlayer,95,180,275,0,75,UCBPlayer
37853,UCBPlayer,144,289,433,35,34,UCBPlayer
37854,UCBPlayer,91,196,287,0,71,UCBPlayer
37855,UCBPlayer,148,273,421,35,38,UCBPlayer
37856,UCBPlayer,87,212,299,0,67,UCBPlayer
37857,UCBPlayer,152,257,409,35,42,UCBPlayer
37858,UCBPlayer,84,224,308,0,64,UCBPlayer
37859,UCBPlayer,146,251,397,32,45,UCBPlayer
37860,UCBPlayer,89,234,323,3,60,UCBPlayer
37861,UCBPlayer,138,243,381,28,49,UCBPlayer
37862,UCBPlayer,97,242,339,7,56,UCBPlayer
37863,UCBPlayer,130,235,365,24,53,UCBPlayer
37864,UCBPlayer,105,250,355,11,52,UCBPlayer
37865,UCBPlayer,122,227,349,20,57,UCBPlayer
37866,UCBPlayer,109,259,368,15,49,UCBPlayer
37867,UCBPlayer,118,218,336,16,60,UCBPlayer
37868,UCBPlayer,117,267,384,19,45,UCBPlayer
37869,UCBPlayer,110,210,320,12,64,UCBPlayer
37870,UCBPlayer,126,271,397,23,42,UCBPlayer
37871,UCBPlayer,105,210,315,10,65,UCBPlayer
37872,UCBPlayer,130,275,405,25,40,UCBPlayer
37873,UCBPlayer,105,210,315,10,65,UCBPlayer
37874,UCBPlayer,130,275,405,25,40,UCBPlayer
37875,UCBPlayer,106,206,312,10,66,UCBPlayer
37876,UCBPlayer,130,275,405,25,40,UCBPlayer
37877,UCBPlayer,105,210,315,10,65,UCBPlayer
37878,UCBPlayer,131,271,402,25,41,UCBPlayer
37879,UCBPlayer,105,210,315,10,65,UCBPlayer
37880,UCBPlayer,130,275,405,25,40,UCBPlayer
37881,UCBPlayer,105,210,315,10,65,UCBPlayer
37882,UCBPlayer,130,275,405,25,40,UCBPlayer
37883,UCBPlayer,103,203,306,10,68,UCBPlayer
37884,UCBPlayer,128,283,411,25,38,UCBPlayer
37885,UCBPlayer,111,186,297,10,71,UCBPlayer
37886,UCBPlayer,124,299,423,25,34,UCBPlayer
37887,UCBPlayer,115,170,285,10,75,UCBPlayer
37888,UCBPlayer,120,315,435,25,30,UCBPlayer
37889,UCBPlayer,119,154,273,10,79,UCBPlayer
37890,UCBPlayer,112,332,444,25,27,UCBPlayer
37891,UCBPlayer,127,137,264,10,82,UCBPlayer
37892,UCBPlayer,104,349,453,25,24,UCBPlayer
37893,UCBPlayer,126,126,252,7,85,Tie
37894,UCBPlayer,111,351,462,28,22,UCBPlayer
37895,UCBPlayer,116,126,242,3,87,UCBPlayer
37896,UCBPlayer,122,347,469,32,21,UCBPlayer
37897,UCBPlayer,107,132,239,0,87,UCBPlayer
37898,UCBPlayer,132,337,469,35,22,UCBPlayer
37899,UCBPlayer,103,148,251,0,83,UCBPlayer
37900,UCBPlayer,136,321,457,35,26,UCBPlayer
37901,UCBPlayer,99,164,263,0,79,UCBPlayer
37902,UCBPlayer,140,305,445,35,30,UCBPlayer
37903,UCBPlayer,95,180,275,0,75,UCBPlayer
37904,UCBPlayer,144,289,433,35,34,UCBPlayer
37905,UCBPlayer,91,196,287,0,71,UCBPlayer
37906,UCBPlayer,148,273,421,35,38,UCBPlayer
37907,UCBPlayer,87,212,299,0,67,UCBPlayer
37908,UCBPlayer,152,257,409,35,42,UCBPlayer
37909,UCBPlayer,84,224,308,0,64,UCBPlayer
37910,UCBPlayer,146,251,397,32,45,UCBPlayer
37911,UCBPlayer,89,234,323,3,60,UCBPlayer
37912,UCBPlayer,138,243,381,28,49,UCBPlayer
37913,UCBPlayer,97,242,339,7,56,UCBPlayer
37914,UCBPlayer,130,235,365,24,53,UCBPlayer
37915,UCBPlayer,105,250,355,11,52,UCBPlayer
37916,UCBPlayer,122,227,349,20,57,UCBPlayer
37917,UCBPlayer,109,259,368,15,49,UCBPlayer
37918,UCBPlayer,118,218,336,16,60,UCBPlayer
37919,UCBPlayer,117,267,384,19,45,UCBPlayer
37920,UCBPlayer,110,210,320,12,64,UCBPlayer
37921,UCBPlayer,126,271,397,23,42,UCBPlayer
37922,UCBPlayer,105,210,315,10,65,UCBPlayer
37923,UCBPlayer,130,275,405,25,40,UCBPlayer
37924,UCBPlayer,105,210,315,10,65,UCBPlayer
37925,UCBPlayer,130,275,405,25,40,UCBPlayer
37926,UCBPlayer,106,206,312,10,66,UCBPlayer
37927,UCBPlayer,130,275,405,25,40,UCBPlayer
37928,UCBPlayer,105,210,315,10,65,UCBPlayer
37929,UCBPlayer,131,271,402,25,41,UCBPlayer
37930,UCBPlayer,105,210,315,10,65,UCBPlayer
37931,UCBPlayer,130,275,405,25,40,UCBPlayer
37932,UCBPlayer,105,210,315,10,65,UCBPlayer
37933,UCBPlayer,130,275,405,25,40,UCBPlayer
37934,UCBPlayer,103,203,306,10,68,UCBPlayer
37935,UCBPlayer,128,283,411,25,38,UCBPlayer
37936,UCBPlayer,111,186,297,10,71,UCBPlayer
37937,UCBPlayer,124,299,423,25,34,UCBPlayer
37938,UCBPlayer,115,170,285,10,75,UCBPlayer
37939,UCBPlayer,120,315,435,25,30,UCBPlayer
37940,UCBPlayer,119,154,273,10,79,UCBPlayer
37941,UCBPlayer,112,332,444,25,27,UCBPlayer
37942,UCBPlayer,127,137,264,10,82,UCBPlayer
37943,UCBPlayer,104,349,453,25,24,UCBPlayer
37944,UCBPlayer,126,126,252,7,85,Tie
37945,UCBPlayer,111,351,462,28,22,UCBPlayer
37946,UCBPlayer,116,126,242,3,87,UCBPlayer
37947,UCBPlayer,122,347,469,32,21,UCBPlayer
37948,UCBPlayer,107,132,239,0,87,UCBPlayer
37949,UCBPlayer,132,337,469,35,22,UCBPlayer
37950,UCBPlayer,103,148,251,0,83,UCBPlayer
37951,UCBPlayer,136,321,457,35,26,UCBPlayer
37952,UCBPlayer,99,164,263,0,79,UCBPlayer
37953,UCBPlayer,140,305,445,35,30,UCBPlayer
37954,UCBPlayer,95,180,275,0,75,UCBPlayer
37955,UCBPlayer,144,289,433,35,34,UCBPlayer
37956,UCBPlayer,91,196,287,0,71,UCBPlayer
37957,UCBPlayer,148,273,421,35,38,UCBPlayer
37958,UCBPlayer,87,212,299,0,67,UCBPlayer
37959,UCBPlayer,152,257,409,35,42,UCBPlayer
37960,UCBPlayer,84,224,308,0,64,UCBPlayer
37961,UCBPlayer,146,251,397,32,45,UCBPlayer
37962,UCBPlayer,89,234,323,3,60,UCBPlayer
37963,UCBPlayer,138,243,381,28,49,UCBPlayer
37964,UCBPlayer,97,242,339,7,56,UCBPlayer
37965,UCBPlayer,130,235,365,24,53,UCBPlayer
37966,UCBPlayer,105,250,355,11,52,UCBPlayer
37967,UCBPlayer,122,227,349,20,57,UCBPlayer
37968,UCBPlayer,109,259,368,15,49,UCBPlayer
37969,UCBPlayer,118,218,336,16,60,UCBPlayer
37970,UCBPlayer,117,267,384,19,45,UCBPlayer
37971,UCBPlayer,110,210,320,12,64,UCBPlayer
37972,UCBPlayer,126,271,397,23,42,UCBPlayer
37973,UCBPlayer,105,210,315,10,65,UCBPlayer
37974,UCBPlayer,130,275,405,25,40,UCBPlayer
37975,UCBPlayer,105,210,315,10,65,UCBPlayer
37976,UCBPlayer,130,275,405,25,40,UCBPlayer
37977,UCBPlayer,106,206,312,10,66,UCBPlayer
37978,UCBPlayer,130,275,405,25,40,UCBPlayer
37979,UCBPlayer,105,210,315,10,65,UCBPlayer
37980,UCBPlayer,131,271,402,25,41,UCBPlayer
37981,UCBPlayer,105,210,315,10,65,UCBPlayer
37982,UCBPlayer,130,275,405,25,40,UCBPlayer
37983,UCBPlayer,105,210,315,10,65,UCBPlayer
37984,UCBPlayer,130,275,405,25,40,UCBPlayer
37985,UCBPlayer,103,203,306,10,68,UCBPlayer
37986,UCBPlayer,128,283,411,25,38,UCBPlayer
37987,UCBPlayer,111,186,297,10,71,UCBPlayer
37988,UCBPlayer,124,299,423,25,34,UCBPlayer
37989,UCBPlayer,115,170,285,10,75,UCBPlayer
37990,UCBPlayer,120,315,435,25,30,UCBPlayer
37991,UCBPlayer,119,154,273,10,79,UCBPlayer
37992,UCBPlayer,112,332,444,25,27,UCBPlayer
37993,UCBPlayer,127,137,264,10,82,UCBPlayer
37994,UCBPlayer,104,349,453,25,24,UCBPlayer
37995,UCBPlayer,126,126,252,7,85,Tie
37996,UCBPlayer,111,351,462,28,22,UCBPlayer
37997,UCBPlayer,116,126,242,3,87,UCBPlayer
37998,UCBPlayer,122,347,469,32,21,UCBPlayer
37999,UCBPlayer,107,132,239,0,87,UCBPlayer
38000,UCBPlayer,132,337,469,35,22,UCBPlayer
38001,UCBPlayer,103,148,251,0,83,UCBPlayer
38002,UCBPlayer,136,321,457,35,26,UCBPlayer
38003,UCBPlayer,99,164,263,0,79,UCBPlayer
38004,UCBPlayer,140,305,445,35,30,UCBPlayer
38005,UCBPlayer,95,180,275,0,75,UCBPlayer
38006,UCBPlayer,144,289,433,35,34,UCBPlayer
38007,UCBPlayer,91,196,287,0,71,UCBPlayer
38008,UCBPlayer,148,273,421,35,38,UCBPlayer
38009,UCBPlayer,87,212,299,0,67,UCBPlayer
38010,UCBPlayer,152,257,409,35,42,UCBPlayer
38011,UCBPlayer,84,224,308,0,64,UCBPlayer
38012,UCBPlayer,146,251,397,32,45,UCBPlayer
38013,UCBPlayer,89,234,323,3,60,UCBPlayer
38014,UCBPlayer,138,243,381,28,49,UCBPlayer
38015,UCBPlayer,97,242,339,7,56,UCBPlayer
38016,UCBPlayer,130,235,365,24,53,UCBPlayer
38017,UCBPlayer,105,250,355,11,52,UCBPlayer
38018,UCBPlayer,122,227,349,20,57,UCBPlayer
38019,UCBPlayer,109,259,368,15,49,UCBPlayer
38020,UCBPlayer,118,218,336,16,60,UCBPlayer
38021,UCBPlayer,117,267,384,19,45,UCBPlayer
38022,UCBPlayer,110,210,320,12,64,UCBPlayer
38023,UCBPlayer,126,271,397,23,42,UCBPlayer
38024,UCBPlayer,105,210,315,10,65,UCBPlayer
38025,UCBPlayer,130,275,405,25,40,UCBPlayer
38026,UCBPlayer,105,210,315,10,65,UCBPlayer
38027,UCBPlayer,130,275,405,25,40,UCBPlayer
38028,UCBPlayer,106,206,312,10,66,UCBPlayer
38029,UCBPlayer,130,275,405,25,40,UCBPlayer
38030,UCBPlayer,105,210,315,10,65,UCBPlayer
38031,UCBPlayer,131,271,402,25,41,UCBPlayer
38032,UCBPlayer,105,210,315,10,65,UCBPlayer
38033,UCBPlayer,130,275,405,25,40,UCBPlayer
38034,UCBPlayer,105,210,315,10,65,UCBPlayer
38035,UCBPlayer,130,275,405,25,40,UCBPlayer
38036,UCBPlayer,103,203,306,10,68,UCBPlayer
38037,UCBPlayer,128,283,411,25,38,UCBPlayer
38038,UCBPlayer,111,186,297,10,71,UCBPlayer
38039,UCBPlayer,124,299,423,25,34,UCBPlayer
38040,UCBPlayer,115,170,285,10,75,UCBPlayer
38041,UCBPlayer,120,315,435,25,30,UCBPlayer
38042,UCBPlayer,119,154,273,10,79,UCBPlayer
38043,UCBPlayer,112,332,444,25,27,UCBPlayer
38044,UCBPlayer,127,137,264,10,82,UCBPlayer
38045,UCBPlayer,104,349,453,25,24,UCBPlayer
38046,UCBPlayer,126,126,252,7,85,Tie
38047,UCBPlayer,111,351,462,28,22,UCBPlayer
38048,UCBPlayer,116,126,242,3,87,UCBPlayer
38049,UCBPlayer,122,347,469,32,21,UCBPlayer
38050,UCBPlayer,107,132,239,0,87,UCBPlayer
38051,UCBPlayer,132,337,469,35,22,UCBPlayer
38052,UCBPlayer,103,148,251,0,83,UCBPlayer
38053,UCBPlayer,136,321,457,35,26,UCBPlayer
38054,UCBPlayer,99,164,263,0,79,UCBPlayer
38055,UCBPlayer,140,305,445,35,30,UCBPlayer
38056,UCBPlayer,95,180,275,0,75,UCBPlayer
38057,UCBPlayer,144,289,433,35,34,UCBPlayer
38058,UCBPlayer,91,196,287,0,71,UCBPlayer
38059,UCBPlayer,148,273,421,35,38,UCBPlayer
38060,UCBPlayer,87,212,299,0,67,UCBPlayer
38061,UCBPlayer,152,257,409,35,42,UCBPlayer
38062,UCBPlayer,84,224,308,0,64,UCBPlayer
38063,UCBPlayer,146,251,397,32,45,UCBPlayer
38064,UCBPlayer,89,234,323,3,60,UCBPlayer
38065,UCBPlayer,138,243,381,28,49,UCBPlayer
38066,UCBPlayer,97,242,339,7,56,UCBPlayer
38067,UCBPlayer,130,235,365,24,53,UCBPlayer
38068,UCBPlayer,105,250,355,11,52,UCBPlayer
38069,UCBPlayer,122,227,349,20,57,UCBPlayer
38070,UCBPlayer,109,259,368,15,49,UCBPlayer
38071,UCBPlayer,118,218,336,16,60,UCBPlayer
38072,UCBPlayer,117,267,384,19,45,UCBPlayer
38073,UCBPlayer,110,210,320,12,64,UCBPlayer
38074,UCBPlayer,126,271,397,23,42,UCBPlayer
38075,UCBPlayer,105,210,315,10,65,UCBPlayer
38076,UCBPlayer,130,275,405,25,40,UCBPlayer
38077,UCBPlayer,105,210,315,10,65,UCBPlayer
38078,UCBPlayer,130,275,405,25,40,UCBPlayer
38079,UCBPlayer,106,206,312,10,66,UCBPlayer
38080,UCBPlayer,130,275,405,25,40,UCBPlayer
38081,UCBPlayer,105,210,315,10,65,UCBPlayer
38082,UCBPlayer,131,271,402,25,41,UCBPlayer
38083,UCBPlayer,105,210,315,10,65,UCBPlayer
38084,UCBPlayer,130,275,405,25,40,UCBPlayer
38085,UCBPlayer,105,210,315,10,65,UCBPlayer
38086,UCBPlayer,130,275,405,25,40,UCBPlayer
38087,UCBPlayer,103,203,306,10,68,UCBPlayer
38088,UCBPlayer,128,283,411,25,38,UCBPlayer
38089,UCBPlayer,111,186,297,10,71,UCBPlayer
38090,UCBPlayer,124,299,423,25,34,UCBPlayer
38091,UCBPlayer,115,170,285,10,75,UCBPlayer
38092,UCBPlayer,120,315,435,25,30,UCBPlayer
38093,UCBPlayer,119,154,273,10,79,UCBPlayer
38094,UCBPlayer,112,332,444,25,27,UCBPlayer
38095,UCBPlayer,127,137,264,10,82,UCBPlayer
38096,UCBPlayer,104,349,453,25,24,UCBPlayer
38097,UCBPlayer,126,126,252,7,85,Tie
38098,UCBPlayer,111,351,462,28,22,UCBPlayer
38099,UCBPlayer,116,126,242,3,87,UCBPlayer
38100,UCBPlayer,122,347,469,32,21,UCBPlayer
38101,UCBPlayer,107,132,239,0,87,UCBPlayer
38102,UCBPlayer,132,337,469,35,22,UCBPlayer
38103,UCBPlayer,103,148,251,0,83,UCBPlayer
38104,UCBPlayer,136,321,457,35,26,UCBPlayer
38105,UCBPlayer,99,164,263,0,79,UCBPlayer
38106,UCBPlayer,140,305,445,35,30,UCBPlayer
38107,UCBPlayer,95,180,275,0,75,UCBPlayer
38108,UCBPlayer,144,289,433,35,34,UCBPlayer
38109,UCBPlayer,91,196,287,0,71,UCBPlayer
38110,UCBPlayer,148,273,421,35,38,UCBPlayer
38111,UCBPlayer,87,212,299,0,67,UCBPlayer
38112,UCBPlayer,152,257,409,35,42,UCBPlayer
38113,UCBPlayer,84,224,308,0,64,UCBPlayer
38114,UCBPlayer,146,251,397,32,45,UCBPlayer
38115,UCBPlayer,89,234,323,3,60,UCBPlayer
38116,UCBPlayer,138,243,381,28,49,UCBPlayer
38117,UCBPlayer,97,242,339,7,56,UCBPlayer
38118,UCBPlayer,130,235,365,24,53,UCBPlayer
38119,UCBPlayer,105,250,355,11,52,UCBPlayer
38120,UCBPlayer,122,227,349,20,57,UCBPlayer
38121,UCBPlayer,109,259,368,15,49,UCBPlayer
38122,UCBPlayer,118,218,336,16,60,UCBPlayer
38123,UCBPlayer,117,267,384,19,45,UCBPlayer
38124,UCBPlayer,110,210,320,12,64,UCBPlayer
38125,UCBPlayer,126,271,397,23,42,UCBPlayer
38126,UCBPlayer,105,210,315,10,65,UCBPlayer
38127,UCBPlayer,130,275,405,25,40,UCBPlayer
38128,UCBPlayer,105,210,315,10,65,UCBPlayer
38129,UCBPlayer,130,275,405,25,40,UCBPlayer
38130,UCBPlayer,106,206,312,10,66,UCBPlayer
38131,UCBPlayer,130,275,405,25,40,UCBPlayer
38132,UCBPlayer,105,210,315,10,65,UCBPlayer
38133,UCBPlayer,131,271,402,25,41,UCBPlayer
38134,UCBPlayer,105,210,315,10,65,UCBPlayer
38135,UCBPlayer,130,275,405,25,40,UCBPlayer
38136,UCBPlayer,105,210,315,10,65,UCBPlayer
38137,UCBPlayer,130,275,405,25,40,UCBPlayer
38138,UCBPlayer,103,203,306,10,68,UCBPlayer
38139,UCBPlayer,128,283,411,25,38,UCBPlayer
38140,UCBPlayer,111,186,297,10,71,UCBPlayer
38141,UCBPlayer,124,299,423,25,34,UCBPlayer
38142,UCBPlayer,115,170,285,10,75,UCBPlayer
38143,UCBPlayer,120,315,435,25,30,UCBPlayer
38144,UCBPlayer,119,154,273,10,79,UCBPlayer
38145,UCBPlayer,112,332,444,25,27,UCBPlayer
38146,UCBPlayer,127,137,264,10,82,UCBPlayer
38147,UCBPlayer,104,349,453,25,24,UCBPlayer
38148,UCBPlayer,126,126,252,7,85,Tie
38149,UCBPlayer,111,351,462,28,22,UCBPlayer
38150,UCBPlayer,116,126,242,3,87,UCBPlayer
38151,UCBPlayer,122,347,469,32,21,UCBPlayer
38152,UCBPlayer,107,132,239,0,87,UCBPlayer
38153,UCBPlayer,132,337,469,35,22,UCBPlayer
38154,UCBPlayer,103,148,251,0,83,UCBPlayer
38155,UCBPlayer,136,321,457,35,26,UCBPlayer
38156,UCBPlayer,99,164,263,0,79,UCBPlayer
38157,UCBPlayer,140,305,445,35,30,UCBPlayer
38158,UCBPlayer,95,180,275,0,75,UCBPlayer
38159,UCBPlayer,144,289,433,35,34,UCBPlayer
38160,UCBPlayer,91,196,287,0,71,UCBPlayer
38161,UCBPlayer,148,273,421,35,38,UCBPlayer
38162,UCBPlayer,87,212,299,0,67,UCBPlayer
38163,UCBPlayer,152,257,409,35,42,UCBPlayer
38164,UCBPlayer,84,224,308,0,64,UCBPlayer
38165,UCBPlayer,146,251,397,32,45,UCBPlayer
38166,UCBPlayer,89,234,323,3,60,UCBPlayer
38167,UCBPlayer,138,243,381,28,49,UCBPlayer
38168,UCBPlayer,97,242,339,7,56,UCBPlayer
38169,UCBPlayer,130,235,365,24,53,UCBPlayer
38170,UCBPlayer,105,250,355,11,52,UCBPlayer
38171,UCBPlayer,122,227,349,20,57,UCBPlayer
38172,UCBPlayer,109,259,368,15,49,UCBPlayer
38173,UCBPlayer,118,218,336,16,60,UCBPlayer
38174,UCBPlayer,117,267,384,19,45,UCBPlayer
38175,UCBPlayer,110,210,320,12,64,UCBPlayer
38176,UCBPlayer,126,271,397,23,42,UCBPlayer
38177,UCBPlayer,105,210,315,10,65,UCBPlayer
38178,UCBPlayer,130,275,405,25,40,UCBPlayer
38179,UCBPlayer,105,210,315,10,65,UCBPlayer
38180,UCBPlayer,130,275,405,25,40,UCBPlayer
38181,UCBPlayer,106,206,312,10,66,UCBPlayer
38182,UCBPlayer,130,275,405,25,40,UCBPlayer
38183,UCBPlayer,105,210,315,10,65,UCBPlayer
38184,UCBPlayer,131,271,402,25,41,UCBPlayer
38185,UCBPlayer,105,210,315,10,65,UCBPlayer
38186,UCBPlayer,130,275,405,25,40,UCBPlayer
38187,UCBPlayer,105,210,315,10,65,UCBPlayer
38188,UCBPlayer,130,275,405,25,40,UCBPlayer
38189,UCBPlayer,103,203,306,10,68,UCBPlayer
38190,UCBPlayer,128,283,411,25,38,UCBPlayer
38191,UCBPlayer,111,186,297,10,71,UCBPlayer
38192,UCBPlayer,124,299,423,25,34,UCBPlayer
38193,UCBPlayer,115,170,285,10,75,UCBPlayer
38194,UCBPlayer,120,315,435,25,30,UCBPlayer
38195,UCBPlayer,119,154,273,10,79,UCBPlayer
38196,UCBPlayer,112,332,444,25,27,UCBPlayer
38197,UCBPlayer,127,137,264,10,82,UCBPlayer
38198,UCBPlayer,104,349,453,25,24,UCBPlayer
38199,UCBPlayer,126,126,252,7,85,Tie
38200,UCBPlayer,111,351,462,28,22,UCBPlayer
38201,UCBPlayer,116,126,242,3,87,UCBPlayer
38202,UCBPlayer,122,347,469,32,21,UCBPlayer
38203,UCBPlayer,107,132,239,0,87,UCBPlayer
38204,UCBPlayer,132,337,469,35,22,UCBPlayer
38205,UCBPlayer,103,148,251,0,83,UCBPlayer
38206,UCBPlayer,136,321,457,35,26,UCBPlayer
38207,UCBPlayer,99,164,263,0,79,UCBPlayer
38208,UCBPlayer,140,305,445,35,30,UCBPlayer
38209,UCBPlayer,95,180,275,0,75,UCBPlayer
38210,UCBPlayer,144,289,433,35,34,UCBPlayer
38211,UCBPlayer,91,196,287,0,71,UCBPlayer
38212,UCBPlayer,148,273,421,35,38,UCBPlayer
38213,UCBPlayer,87,212,299,0,67,UCBPlayer
38214,UCBPlayer,152,257,409,35,42,UCBPlayer
38215,UCBPlayer,84,224,308,0,64,UCBPlayer
38216,UCBPlayer,146,251,397,32,45,UCBPlayer
38217,UCBPlayer,89,234,323,3,60,UCBPlayer
38218,UCBPlayer,138,243,381,28,49,UCBPlayer
38219,UCBPlayer,97,242,339,7,56,UCBPlayer
38220,UCBPlayer,130,235,365,24,53,UCBPlayer
38221,UCBPlayer,105,250,355,11,52,UCBPlayer
38222,UCBPlayer,122,227,349,20,57,UCBPlayer
38223,UCBPlayer,109,259,368,15,49,UCBPlayer
38224,UCBPlayer,118,218,336,16,60,UCBPlayer
38225,UCBPlayer,117,267,384,19,45,UCBPlayer
38226,UCBPlayer,110,210,320,12,64,UCBPlayer
38227,UCBPlayer,126,271,397,23,42,UCBPlayer
38228,UCBPlayer,105,210,315,10,65,UCBPlayer
38229,UCBPlayer,130,275,405,25,40,UCBPlayer
38230,UCBPlayer,105,210,315,10,65,UCBPlayer
38231,UCBPlayer,130,275,405,25,40,UCBPlayer
38232,UCBPlayer,106,206,312,10,66,UCBPlayer
38233,UCBPlayer,130,275,405,25,40,UCBPlayer
38234,UCBPlayer,105,210,315,10,65,UCBPlayer
38235,UCBPlayer,131,271,402,25,41,UCBPlayer
38236,UCBPlayer,105,210,315,10,65,UCBPlayer
38237,UCBPlayer,130,275,405,25,40,UCBPlayer
38238,UCBPlayer,105,210,315,10,65,UCBPlayer
38239,UCBPlayer,130,275,405,25,40,UCBPlayer
38240,UCBPlayer,103,203,306,10,68,UCBPlayer
38241,UCBPlayer,128,283,411,25,38,UCBPlayer
38242,UCBPlayer,111,186,297,10,71,UCBPlayer
38243,UCBPlayer,124,299,423,25,34,UCBPlayer
38244,UCBPlayer,115,170,285,10,75,UCBPlayer
38245,UCBPlayer,120,315,435,25,30,UCBPlayer
38246,UCBPlayer,119,154,273,10,79,UCBPlayer
38247,UCBPlayer,112,332,444,25,27,UCBPlayer
38248,UCBPlayer,127,137,264,10,82,UCBPlayer
38249,UCBPlayer,104,349,453,25,24,UCBPlayer
38250,UCBPlayer,126,126,252,7,85,Tie
38251,UCBPlayer,111,351,462,28,22,UCBPlayer
38252,UCBPlayer,116,126,242,3,87,UCBPlayer
38253,UCBPlayer,122,347,469,32,21,UCBPlayer
38254,UCBPlayer,107,132,239,0,87,UCBPlayer
38255,UCBPlayer,132,337,469,35,22,UCBPlayer
38256,UCBPlayer,103,148,251,0,83,UCBPlayer
38257,UCBPlayer,136,321,457,35,26,UCBPlayer
38258,UCBPlayer,99,164,263,0,79,UCBPlayer
38259,UCBPlayer,140,305,445,35,30,UCBPlayer
38260,UCBPlayer,95,180,275,0,75,UCBPlayer
38261,UCBPlayer,144,289,433,35,34,UCBPlayer
38262,UCBPlayer,91,196,287,0,71,UCBPlayer
38263,UCBPlayer,148,273,421,35,38,UCBPlayer
38264,UCBPlayer,87,212,299,0,67,UCBPlayer
38265,UCBPlayer,152,257,409,35,42,UCBPlayer
38266,UCBPlayer,84,224,308,0,64,UCBPlayer
38267,UCBPlayer,146,251,397,32,45,UCBPlayer
38268,UCBPlayer,89,234,323,3,60,UCBPlayer
38269,UCBPlayer,138,243,381,28,49,UCBPlayer
38270,UCBPlayer,97,242,339,7,56,UCBPlayer
38271,UCBPlayer,130,235,365,24,53,UCBPlayer
38272,UCBPlayer,105,250,355,11,52,UCBPlayer
38273,UCBPlayer,122,227,349,20,57,UCBPlayer
38274,UCBPlayer,109,259,368,15,49,UCBPlayer
38275,UCBPlayer,118,218,336,16,60,UCBPlayer
38276,UCBPlayer,117,267,384,19,45,UCBPlayer
38277,UCBPlayer,110,210,320,12,64,UCBPlayer
38278,UCBPlayer,126,271,397,23,42,UCBPlayer
38279,UCBPlayer,105,210,315,10,65,UCBPlayer
38280,UCBPlayer,130,275,405,25,40,UCBPlayer
38281,UCBPlayer,105,210,315,10,65,UCBPlayer
38282,UCBPlayer,130,275,405,25,40,UCBPlayer
38283,UCBPlayer,106,206,312,10,66,UCBPlayer
38284,UCBPlayer,130,275,405,25,40,UCBPlayer
38285,UCBPlayer,105,210,315,10,65,UCBPlayer
38286,UCBPlayer,131,271,402,25,41,UCBPlayer
38287,UCBPlayer,105,210,315,10,65,UCBPlayer
38288,UCBPlayer,130,275,405,25,40,UCBPlayer
38289,UCBPlayer,105,210,315,10,65,UCBPlayer
38290,UCBPlayer,130,275,405,25,40,UCBPlayer
38291,UCBPlayer,103,203,306,10,68,UCBPlayer
38292,UCBPlayer,128,283,411,25,38,UCBPlayer
38293,UCBPlayer,111,186,297,10,71,UCBPlayer
38294,UCBPlayer,124,299,423,25,34,UCBPlayer
38295,UCBPlayer,115,170,285,10,75,UCBPlayer
38296,UCBPlayer,120,315,435,25,30,UCBPlayer
38297,UCBPlayer,119,154,273,10,79,UCBPlayer
38298,UCBPlayer,112,332,444,25,27,UCBPlayer
38299,UCBPlayer,127,137,264,10,82,UCBPlayer
38300,UCBPlayer,104,349,453,25,24,UCBPlayer
38301,UCBPlayer,126,126,252,7,85,Tie
38302,UCBPlayer,111,351,462,28,22,UCBPlayer
38303,UCBPlayer,116,126,242,3,87,UCBPlayer
38304,UCBPlayer,122,347,469,32,21,UCBPlayer
38305,UCBPlayer,107,132,239,0,87,UCBPlayer
38306,UCBPlayer,132,337,469,35,22,UCBPlayer
38307,UCBPlayer,103,148,251,0,83,UCBPlayer
38308,UCBPlayer,136,321,457,35,26,UCBPlayer
38309,UCBPlayer,99,164,263,0,79,UCBPlayer
38310,UCBPlayer,140,305,445,35,30,UCBPlayer
38311,UCBPlayer,95,180,275,0,75,UCBPlayer
38312,UCBPlayer,144,289,433,35,34,UCBPlayer
38313,UCBPlayer,91,196,287,0,71,UCBPlayer
38314,UCBPlayer,148,273,421,35,38,UCBPlayer
38315,UCBPlayer,87,212,299,0,67,UCBPlayer
38316,UCBPlayer,152,257,409,35,42,UCBPlayer
38317,UCBPlayer,84,224,308,0,64,UCBPlayer
38318,UCBPlayer,146,251,397,32,45,UCBPlayer
38319,UCBPlayer,89,234,323,3,60,UCBPlayer
38320,UCBPlayer,138,243,381,28,49,UCBPlayer
38321,UCBPlayer,97,242,339,7,56,UCBPlayer
38322,UCBPlayer,130,235,365,24,53,UCBPlayer
38323,UCBPlayer,105,250,355,11,52,UCBPlayer
38324,UCBPlayer,122,227,349,20,57,UCBPlayer
38325,UCBPlayer,109,259,368,15,49,UCBPlayer
38326,UCBPlayer,118,218,336,16,60,UCBPlayer
38327,UCBPlayer,117,267,384,19,45,UCBPlayer
38328,UCBPlayer,110,210,320,12,64,UCBPlayer
38329,UCBPlayer,126,271,397,23,42,UCBPlayer
38330,UCBPlayer,105,210,315,10,65,UCBPlayer
38331,UCBPlayer,130,275,405,25,40,UCBPlayer
38332,UCBPlayer,105,210,315,10,65,UCBPlayer
38333,UCBPlayer,130,275,405,25,40,UCBPlayer
38334,UCBPlayer,106,206,312,10,66,UCBPlayer
38335,UCBPlayer,130,275,405,25,40,UCBPlayer
38336,UCBPlayer,105,210,315,10,65,UCBPlayer
38337,UCBPlayer,131,271,402,25,41,UCBPlayer
38338,UCBPlayer,105,210,315,10,65,UCBPlayer
38339,UCBPlayer,130,275,405,25,40,UCBPlayer
38340,UCBPlayer,105,210,315,10,65,UCBPlayer
38341,UCBPlayer,130,275,405,25,40,UCBPlayer
38342,UCBPlayer,103,203,306,10,68,UCBPlayer
38343,UCBPlayer,128,283,411,25,38,UCBPlayer
38344,UCBPlayer,111,186,297,10,71,UCBPlayer
38345,UCBPlayer,124,299,423,25,34,UCBPlayer
38346,UCBPlayer,115,170,285,10,75,UCBPlayer
38347,UCBPlayer,120,315,435,25,30,UCBPlayer
38348,UCBPlayer,119,154,273,10,79,UCBPlayer
38349,UCBPlayer,112,332,444,25,27,UCBPlayer
38350,UCBPlayer,127,137,264,10,82,UCBPlayer
38351,UCBPlayer,104,349,453,25,24,UCBPlayer
38352,UCBPlayer,126,126,252,7,85,Tie
38353,UCBPlayer,111,351,462,28,22,UCBPlayer
38354,UCBPlayer,116,126,242,3,87,UCBPlayer
38355,UCBPlayer,122,347,469,32,21,UCBPlayer
38356,UCBPlayer,107,132,239,0,87,UCBPlayer
38357,UCBPlayer,132,337,469,35,22,UCBPlayer
38358,UCBPlayer,103,148,251,0,83,UCBPlayer
38359,UCBPlayer,136,321,457,35,26,UCBPlayer
38360,UCBPlayer,99,164,263,0,79,UCBPlayer
38361,UCBPlayer,140,305,445,35,30,UCBPlayer
38362,UCBPlayer,95,180,275,0,75,UCBPlayer
38363,UCBPlayer,144,289,433,35,34,UCBPlayer
38364,UCBPlayer,91,196,287,0,71,UCBPlayer
38365,UCBPlayer,148,273,421,35,38,UCBPlayer
38366,UCBPlayer,87,212,299,0,67,UCBPlayer
38367,UCBPlayer,152,257,409,35,42,UCBPlayer
38368,UCBPlayer,84,224,308,0,64,UCBPlayer
38369,UCBPlayer,146,251,397,32,45,UCBPlayer
38370,UCBPlayer,89,234,323,3,60,UCBPlayer
38371,UCBPlayer,138,243,381,28,49,UCBPlayer
38372,UCBPlayer,97,242,339,7,56,UCBPlayer
38373,UCBPlayer,130,235,365,24,53,UCBPlayer
38374,UCBPlayer,105,250,355,11,52,UCBPlayer
38375,UCBPlayer,122,227,349,20,57,UCBPlayer
38376,UCBPlayer,109,259,368,15,49,UCBPlayer
38377,UCBPlayer,118,218,336,16,60,UCBPlayer
38378,UCBPlayer,117,267,384,19,45,UCBPlayer
38379,UCBPlayer,110,210,320,12,64,UCBPlayer
38380,UCBPlayer,126,271,397,23,42,UCBPlayer
38381,UCBPlayer,105,210,315,10,65,UCBPlayer
38382,UCBPlayer,130,275,405,25,40,UCBPlayer
38383,UCBPlayer,105,210,315,10,65,UCBPlayer
38384,UCBPlayer,130,275,405,25,40,UCBPlayer
38385,UCBPlayer,106,206,312,10,66,UCBPlayer
38386,UCBPlayer,130,275,405,25,40,UCBPlayer
38387,UCBPlayer,105,210,315,10,65,UCBPlayer
38388,UCBPlayer,131,271,402,25,41,UCBPlayer
38389,UCBPlayer,105,210,315,10,65,UCBPlayer
38390,UCBPlayer,130,275,405,25,40,UCBPlayer
38391,UCBPlayer,105,210,315,10,65,UCBPlayer
38392,UCBPlayer,130,275,405,25,40,UCBPlayer
38393,UCBPlayer,103,203,306,10,68,UCBPlayer
38394,UCBPlayer,128,283,411,25,38,UCBPlayer
38395,UCBPlayer,111,186,297,10,71,UCBPlayer
38396,UCBPlayer,124,299,423,25,34,UCBPlayer
38397,UCBPlayer,115,170,285,10,75,UCBPlayer
38398,UCBPlayer,120,315,435,25,30,UCBPlayer
38399,UCBPlayer,119,154,273,10,79,UCBPlayer
38400,UCBPlayer,112,332,444,25,27,UCBPlayer
38401,UCBPlayer,127,137,264,10,82,UCBPlayer
38402,UCBPlayer,104,349,453,25,24,UCBPlayer
38403,UCBPlayer,126,126,252,7,85,Tie
38404,UCBPlayer,111,351,462,28,22,UCBPlayer
38405,UCBPlayer,116,126,242,3,87,UCBPlayer
38406,UCBPlayer,122,347,469,32,21,UCBPlayer
38407,UCBPlayer,107,132,239,0,87,UCBPlayer
38408,UCBPlayer,132,337,469,35,22,UCBPlayer
38409,UCBPlayer,103,148,251,0,83,UCBPlayer
38410,UCBPlayer,136,321,457,35,26,UCBPlayer
38411,UCBPlayer,99,164,263,0,79,UCBPlayer
38412,UCBPlayer,140,305,445,35,30,UCBPlayer
38413,UCBPlayer,95,180,275,0,75,UCBPlayer
38414,UCBPlayer,144,289,433,35,34,UCBPlayer
38415,UCBPlayer,91,196,287,0,71,UCBPlayer
38416,UCBPlayer,148,273,421,35,38,UCBPlayer
38417,UCBPlayer,87,212,299,0,67,UCBPlayer
38418,UCBPlayer,152,257,409,35,42,UCBPlayer
38419,UCBPlayer,84,224,308,0,64,UCBPlayer
38420,UCBPlayer,146,251,397,32,45,UCBPlayer
38421,UCBPlayer,89,234,323,3,60,UCBPlayer
38422,UCBPlayer,138,243,381,28,49,UCBPlayer
38423,UCBPlayer,97,242,339,7,56,UCBPlayer
38424,UCBPlayer,130,235,365,24,53,UCBPlayer
38425,UCBPlayer,105,250,355,11,52,UCBPlayer
38426,UCBPlayer,122,227,349,20,57,UCBPlayer
38427,UCBPlayer,109,259,368,15,49,UCBPlayer
38428,UCBPlayer,118,218,336,16,60,UCBPlayer
38429,UCBPlayer,117,267,384,19,45,UCBPlayer
38430,UCBPlayer,110,210,320,12,64,UCBPlayer
38431,UCBPlayer,126,271,397,23,42,UCBPlayer
38432,UCBPlayer,105,210,315,10,65,UCBPlayer
38433,UCBPlayer,130,275,405,25,40,UCBPlayer
38434,UCBPlayer,105,210,315,10,65,UCBPlayer
38435,UCBPlayer,130,275,405,25,40,UCBPlayer
38436,UCBPlayer,106,206,312,10,66,UCBPlayer
38437,UCBPlayer,130,275,405,25,40,UCBPlayer
38438,UCBPlayer,105,210,315,10,65,UCBPlayer
38439,UCBPlayer,131,271,402,25,41,UCBPlayer
38440,UCBPlayer,105,210,315,10,65,UCBPlayer
38441,UCBPlayer,130,275,405,25,40,UCBPlayer
38442,UCBPlayer,105,210,315,10,65,UCBPlayer
38443,UCBPlayer,130,275,405,25,40,UCBPlayer
38444,UCBPlayer,103,203,306,10,68,UCBPlayer
38445,UCBPlayer,128,283,411,25,38,UCBPlayer
38446,UCBPlayer,111,186,297,10,71,UCBPlayer
38447,UCBPlayer,124,299,423,25,34,UCBPlayer
38448,UCBPlayer,115,170,285,10,75,UCBPlayer
38449,UCBPlayer,120,315,435,25,30,UCBPlayer
38450,UCBPlayer,119,154,273,10,79,UCBPlayer
38451,UCBPlayer,112,332,444,25,27,UCBPlayer
38452,UCBPlayer,127,137,264,10,82,UCBPlayer
38453,UCBPlayer,104,349,453,25,24,UCBPlayer
38454,UCBPlayer,126,126,252,7,85,Tie
38455,UCBPlayer,111,351,462,28,22,UCBPlayer
38456,UCBPlayer,116,126,242,3,87,UCBPlayer
38457,UCBPlayer,122,347,469,32,21,UCBPlayer
38458,UCBPlayer,107,132,239,0,87,UCBPlayer
38459,UCBPlayer,132,337,469,35,22,UCBPlayer
38460,UCBPlayer,103,148,251,0,83,UCBPlayer
38461,UCBPlayer,136,321,457,35,26,UCBPlayer
38462,UCBPlayer,99,164,263,0,79,UCBPlayer
38463,UCBPlayer,140,305,445,35,30,UCBPlayer
38464,UCBPlayer,95,180,275,0,75,UCBPlayer
38465,UCBPlayer,144,289,433,35,34,UCBPlayer
38466,UCBPlayer,91,196,287,0,71,UCBPlayer
38467,UCBPlayer,148,273,421,35,38,UCBPlayer
38468,UCBPlayer,87,212,299,0,67,UCBPlayer
38469,UCBPlayer,152,257,409,35,42,UCBPlayer
38470,UCBPlayer,84,224,308,0,64,UCBPlayer
38471,UCBPlayer,146,251,397,32,45,UCBPlayer
38472,UCBPlayer,89,234,323,3,60,UCBPlayer
38473,UCBPlayer,138,243,381,28,49,UCBPlayer
38474,UCBPlayer,97,242,339,7,56,UCBPlayer
38475,UCBPlayer,130,235,365,24,53,UCBPlayer
38476,UCBPlayer,105,250,355,11,52,UCBPlayer
38477,UCBPlayer,122,227,349,20,57,UCBPlayer
38478,UCBPlayer,109,259,368,15,49,UCBPlayer
38479,UCBPlayer,118,218,336,16,60,UCBPlayer
38480,UCBPlayer,117,267,384,19,45,UCBPlayer
38481,UCBPlayer,110,210,320,12,64,UCBPlayer
38482,UCBPlayer,126,271,397,23,42,UCBPlayer
38483,UCBPlayer,105,210,315,10,65,UCBPlayer
38484,UCBPlayer,130,275,405,25,40,UCBPlayer
38485,UCBPlayer,105,210,315,10,65,UCBPlayer
38486,UCBPlayer,130,275,405,25,40,UCBPlayer
38487,UCBPlayer,106,206,312,10,66,UCBPlayer
38488,UCBPlayer,130,275,405,25,40,UCBPlayer
38489,UCBPlayer,105,210,315,10,65,UCBPlayer
38490,UCBPlayer,131,271,402,25,41,UCBPlayer
38491,UCBPlayer,105,210,315,10,65,UCBPlayer
38492,UCBPlayer,130,275,405,25,40,UCBPlayer
38493,UCBPlayer,105,210,315,10,65,UCBPlayer
38494,UCBPlayer,130,275,405,25,40,UCBPlayer
38495,UCBPlayer,103,203,306,10,68,UCBPlayer
38496,UCBPlayer,128,283,411,25,38,UCBPlayer
38497,UCBPlayer,111,186,297,10,71,UCBPlayer
38498,UCBPlayer,124,299,423,25,34,UCBPlayer
38499,UCBPlayer,115,170,285,10,75,UCBPlayer
38500,UCBPlayer,120,315,435,25,30,UCBPlayer
38501,UCBPlayer,119,154,273,10,79,UCBPlayer
38502,UCBPlayer,112,332,444,25,27,UCBPlayer
38503,UCBPlayer,127,137,264,10,82,UCBPlayer
38504,UCBPlayer,104,349,453,25,24,UCBPlayer
38505,UCBPlayer,126,126,252,7,85,Tie
38506,UCBPlayer,111,351,462,28,22,UCBPlayer
38507,UCBPlayer,116,126,242,3,87,UCBPlayer
38508,UCBPlayer,122,347,469,32,21,UCBPlayer
38509,UCBPlayer,107,132,239,0,87,UCBPlayer
38510,UCBPlayer,132,337,469,35,22,UCBPlayer
38511,UCBPlayer,103,148,251,0,83,UCBPlayer
38512,UCBPlayer,136,321,457,35,26,UCBPlayer
38513,UCBPlayer,99,164,263,0,79,UCBPlayer
38514,UCBPlayer,140,305,445,35,30,UCBPlayer
38515,UCBPlayer,95,180,275,0,75,UCBPlayer
38516,UCBPlayer,144,289,433,35,34,UCBPlayer
38517,UCBPlayer,91,196,287,0,71,UCBPlayer
38518,UCBPlayer,148,273,421,35,38,UCBPlayer
38519,UCBPlayer,87,212,299,0,67,UCBPlayer
38520,UCBPlayer,152,257,409,35,42,UCBPlayer
38521,UCBPlayer,84,224,308,0,64,UCBPlayer
38522,UCBPlayer,146,251,397,32,45,UCBPlayer
38523,UCBPlayer,89,234,323,3,60,UCBPlayer
38524,UCBPlayer,138,243,381,28,49,UCBPlayer
38525,UCBPlayer,97,242,339,7,56,UCBPlayer
38526,UCBPlayer,130,235,365,24,53,UCBPlayer
38527,UCBPlayer,105,250,355,11,52,UCBPlayer
38528,UCBPlayer,122,227,349,20,57,UCBPlayer
38529,UCBPlayer,109,259,368,15,49,UCBPlayer
38530,UCBPlayer,118,218,336,16,60,UCBPlayer
38531,UCBPlayer,117,267,384,19,45,UCBPlayer
38532,UCBPlayer,110,210,320,12,64,UCBPlayer
38533,UCBPlayer,126,271,397,23,42,UCBPlayer
38534,UCBPlayer,105,210,315,10,65,UCBPlayer
38535,UCBPlayer,130,275,405,25,40,UCBPlayer
38536,UCBPlayer,105,210,315,10,65,UCBPlayer
38537,UCBPlayer,130,275,405,25,40,UCBPlayer
38538,UCBPlayer,106,206,312,10,66,UCBPlayer
38539,UCBPlayer,130,275,405,25,40,UCBPlayer
38540,UCBPlayer,105,210,315,10,65,UCBPlayer
38541,UCBPlayer,131,271,402,25,41,UCBPlayer
38542,UCBPlayer,105,210,315,10,65,UCBPlayer
38543,UCBPlayer,130,275,405,25,40,UCBPlayer
38544,UCBPlayer,105,210,315,10,65,UCBPlayer
38545,UCBPlayer,130,275,405,25,40,UCBPlayer
38546,UCBPlayer,103,203,306,10,68,UCBPlayer
38547,UCBPlayer,128,283,411,25,38,UCBPlayer
38548,UCBPlayer,111,186,297,10,71,UCBPlayer
38549,UCBPlayer,124,299,423,25,34,UCBPlayer
38550,UCBPlayer,115,170,285,10,75,UCBPlayer
38551,UCBPlayer,120,315,435,25,30,UCBPlayer
38552,UCBPlayer,119,154,273,10,79,UCBPlayer
38553,UCBPlayer,112,332,444,25,27,UCBPlayer
38554,UCBPlayer,127,137,264,10,82,UCBPlayer
38555,UCBPlayer,104,349,453,25,24,UCBPlayer
38556,UCBPlayer,126,126,252,7,85,Tie
38557,UCBPlayer,111,351,462,28,22,UCBPlayer
38558,UCBPlayer,116,126,242,3,87,UCBPlayer
38559,UCBPlayer,122,347,469,32,21,UCBPlayer
38560,UCBPlayer,107,132,239,0,87,UCBPlayer
38561,UCBPlayer,132,337,469,35,22,UCBPlayer
38562,UCBPlayer,103,148,251,0,83,UCBPlayer
38563,UCBPlayer,136,321,457,35,26,UCBPlayer
38564,UCBPlayer,99,164,263,0,79,UCBPlayer
38565,UCBPlayer,140,305,445,35,30,UCBPlayer
38566,UCBPlayer,95,180,275,0,75,UCBPlayer
38567,UCBPlayer,144,289,433,35,34,UCBPlayer
38568,UCBPlayer,91,196,287,0,71,UCBPlayer
38569,UCBPlayer,148,273,421,35,38,UCBPlayer
38570,UCBPlayer,87,212,299,0,67,UCBPlayer
38571,UCBPlayer,152,257,409,35,42,UCBPlayer
38572,UCBPlayer,84,224,308,0,64,UCBPlayer
38573,UCBPlayer,146,251,397,32,45,UCBPlayer
38574,UCBPlayer,89,234,323,3,60,UCBPlayer
38575,UCBPlayer,138,243,381,28,49,UCBPlayer
38576,UCBPlayer,97,242,339,7,56,UCBPlayer
38577,UCBPlayer,130,235,365,24,53,UCBPlayer
38578,UCBPlayer,105,250,355,11,52,UCBPlayer
38579,UCBPlayer,122,227,349,20,57,UCBPlayer
38580,UCBPlayer,109,259,368,15,49,UCBPlayer
38581,UCBPlayer,118,218,336,16,60,UCBPlayer
38582,UCBPlayer,117,267,384,19,45,UCBPlayer
38583,UCBPlayer,110,210,320,12,64,UCBPlayer
38584,UCBPlayer,126,271,397,23,42,UCBPlayer
38585,UCBPlayer,105,210,315,10,65,UCBPlayer
38586,UCBPlayer,130,275,405,25,40,UCBPlayer
38587,UCBPlayer,105,210,315,10,65,UCBPlayer
38588,UCBPlayer,130,275,405,25,40,UCBPlayer
38589,UCBPlayer,106,206,312,10,66,UCBPlayer
38590,UCBPlayer,130,275,405,25,40,UCBPlayer
38591,UCBPlayer,105,210,315,10,65,UCBPlayer
38592,UCBPlayer,131,271,402,25,41,UCBPlayer
38593,UCBPlayer,105,210,315,10,65,UCBPlayer
38594,UCBPlayer,130,275,405,25,40,UCBPlayer
38595,UCBPlayer,105,210,315,10,65,UCBPlayer
38596,UCBPlayer,130,275,405,25,40,UCBPlayer
38597,UCBPlayer,103,203,306,10,68,UCBPlayer
38598,UCBPlayer,128,283,411,25,38,UCBPlayer
38599,UCBPlayer,111,186,297,10,71,UCBPlayer
38600,UCBPlayer,124,299,423,25,34,UCBPlayer
38601,UCBPlayer,115,170,285,10,75,UCBPlayer
38602,UCBPlayer,120,315,435,25,30,UCBPlayer
38603,UCBPlayer,119,154,273,10,79,UCBPlayer
38604,UCBPlayer,112,332,444,25,27,UCBPlayer
38605,UCBPlayer,127,137,264,10,82,UCBPlayer
38606,UCBPlayer,104,349,453,25,24,UCBPlayer
38607,UCBPlayer,126,126,252,7,85,Tie
38608,UCBPlayer,111,351,462,28,22,UCBPlayer
38609,UCBPlayer,116,126,242,3,87,UCBPlayer
38610,UCBPlayer,122,347,469,32,21,UCBPlayer
38611,UCBPlayer,107,132,239,0,87,UCBPlayer
38612,UCBPlayer,132,337,469,35,22,UCBPlayer
38613,UCBPlayer,103,148,251,0,83,UCBPlayer
38614,UCBPlayer,136,321,457,35,26,UCBPlayer
38615,UCBPlayer,99,164,263,0,79,UCBPlayer
38616,UCBPlayer,140,305,445,35,30,UCBPlayer
38617,UCBPlayer,95,180,275,0,75,UCBPlayer
38618,UCBPlayer,144,289,433,35,34,UCBPlayer
38619,UCBPlayer,91,196,287,0,71,UCBPlayer
38620,UCBPlayer,148,273,421,35,38,UCBPlayer
38621,UCBPlayer,87,212,299,0,67,UCBPlayer
38622,UCBPlayer,152,257,409,35,42,UCBPlayer
38623,UCBPlayer,84,224,308,0,64,UCBPlayer
38624,UCBPlayer,146,251,397,32,45,UCBPlayer
38625,UCBPlayer,89,234,323,3,60,UCBPlayer
38626,UCBPlayer,138,243,381,28,49,UCBPlayer
38627,UCBPlayer,97,242,339,7,56,UCBPlayer
38628,UCBPlayer,130,235,365,24,53,UCBPlayer
38629,UCBPlayer,105,250,355,11,52,UCBPlayer
38630,UCBPlayer,122,227,349,20,57,UCBPlayer
38631,UCBPlayer,109,259,368,15,49,UCBPlayer
38632,UCBPlayer,118,218,336,16,60,UCBPlayer
38633,UCBPlayer,117,267,384,19,45,UCBPlayer
38634,UCBPlayer,110,210,320,12,64,UCBPlayer
38635,UCBPlayer,126,271,397,23,42,UCBPlayer
38636,UCBPlayer,105,210,315,10,65,UCBPlayer
38637,UCBPlayer,130,275,405,25,40,UCBPlayer
38638,UCBPlayer,105,210,315,10,65,UCBPlayer
38639,UCBPlayer,130,275,405,25,40,UCBPlayer
38640,UCBPlayer,106,206,312,10,66,UCBPlayer
38641,UCBPlayer,130,275,405,25,40,UCBPlayer
38642,UCBPlayer,105,210,315,10,65,UCBPlayer
38643,UCBPlayer,131,271,402,25,41,UCBPlayer
38644,UCBPlayer,105,210,315,10,65,UCBPlayer
38645,UCBPlayer,130,275,405,25,40,UCBPlayer
38646,UCBPlayer,105,210,315,10,65,UCBPlayer
38647,UCBPlayer,130,275,405,25,40,UCBPlayer
38648,UCBPlayer,103,203,306,10,68,UCBPlayer
38649,UCBPlayer,128,283,411,25,38,UCBPlayer
38650,UCBPlayer,111,186,297,10,71,UCBPlayer
38651,UCBPlayer,124,299,423,25,34,UCBPlayer
38652,UCBPlayer,115,170,285,10,75,UCBPlayer
38653,UCBPlayer,120,315,435,25,30,UCBPlayer
38654,UCBPlayer,119,154,273,10,79,UCBPlayer
38655,UCBPlayer,112,332,444,25,27,UCBPlayer
38656,UCBPlayer,127,137,264,10,82,UCBPlayer
38657,UCBPlayer,104,349,453,25,24,UCBPlayer
38658,UCBPlayer,126,126,252,7,85,Tie
38659,UCBPlayer,111,351,462,28,22,UCBPlayer
38660,UCBPlayer,116,126,242,3,87,UCBPlayer
38661,UCBPlayer,122,347,469,32,21,UCBPlayer
38662,UCBPlayer,107,132,239,0,87,UCBPlayer
38663,UCBPlayer,132,337,469,35,22,UCBPlayer
38664,UCBPlayer,103,148,251,0,83,UCBPlayer
38665,UCBPlayer,136,321,457,35,26,UCBPlayer
38666,UCBPlayer,99,164,263,0,79,UCBPlayer
38667,UCBPlayer,140,305,445,35,30,UCBPlayer
38668,UCBPlayer,95,180,275,0,75,UCBPlayer
38669,UCBPlayer,144,289,433,35,34,UCBPlayer
38670,UCBPlayer,91,196,287,0,71,UCBPlayer
38671,UCBPlayer,148,273,421,35,38,UCBPlayer
38672,UCBPlayer,87,212,299,0,67,UCBPlayer
38673,UCBPlayer,152,257,409,35,42,UCBPlayer
38674,UCBPlayer,84,224,308,0,64,UCBPlayer
38675,UCBPlayer,146,251,397,32,45,UCBPlayer
38676,UCBPlayer,89,234,323,3,60,UCBPlayer
38677,UCBPlayer,138,243,381,28,49,UCBPlayer
38678,UCBPlayer,97,242,339,7,56,UCBPlayer
38679,UCBPlayer,130,235,365,24,53,UCBPlayer
38680,UCBPlayer,105,250,355,11,52,UCBPlayer
38681,UCBPlayer,122,227,349,20,57,UCBPlayer
38682,UCBPlayer,109,259,368,15,49,UCBPlayer
38683,UCBPlayer,118,218,336,16,60,UCBPlayer
38684,UCBPlayer,117,267,384,19,45,UCBPlayer
38685,UCBPlayer,110,210,320,12,64,UCBPlayer
38686,UCBPlayer,126,271,397,23,42,UCBPlayer
38687,UCBPlayer,105,210,315,10,65,UCBPlayer
38688,UCBPlayer,130,275,405,25,40,UCBPlayer
38689,UCBPlayer,105,210,315,10,65,UCBPlayer
38690,UCBPlayer,130,275,405,25,40,UCBPlayer
38691,UCBPlayer,106,206,312,10,66,UCBPlayer
38692,UCBPlayer,130,275,405,25,40,UCBPlayer
38693,UCBPlayer,105,210,315,10,65,UCBPlayer
38694,UCBPlayer,131,271,402,25,41,UCBPlayer
38695,UCBPlayer,105,210,315,10,65,UCBPlayer
38696,UCBPlayer,130,275,405,25,40,UCBPlayer
38697,UCBPlayer,105,210,315,10,65,UCBPlayer
38698,UCBPlayer,130,275,405,25,40,UCBPlayer
38699,UCBPlayer,103,203,306,10,68,UCBPlayer
38700,UCBPlayer,128,283,411,25,38,UCBPlayer
38701,UCBPlayer,111,186,297,10,71,UCBPlayer
38702,UCBPlayer,124,299,423,25,34,UCBPlayer
38703,UCBPlayer,115,170,285,10,75,UCBPlayer
38704,UCBPlayer,120,315,435,25,30,UCBPlayer
38705,UCBPlayer,119,154,273,10,79,UCBPlayer
38706,UCBPlayer,112,332,444,25,27,UCBPlayer
38707,UCBPlayer,127,137,264,10,82,UCBPlayer
38708,UCBPlayer,104,349,453,25,24,UCBPlayer
38709,UCBPlayer,126,126,252,7,85,Tie
38710,UCBPlayer,111,351,462,28,22,UCBPlayer
38711,UCBPlayer,116,126,242,3,87,UCBPlayer
38712,UCBPlayer,122,347,469,32,21,UCBPlayer
38713,UCBPlayer,107,132,239,0,87,UCBPlayer
38714,UCBPlayer,132,337,469,35,22,UCBPlayer
38715,UCBPlayer,103,148,251,0,83,UCBPlayer
38716,UCBPlayer,136,321,457,35,26,UCBPlayer
38717,UCBPlayer,99,164,263,0,79,UCBPlayer
38718,UCBPlayer,140,305,445,35,30,UCBPlayer
38719,UCBPlayer,95,180,275,0,75,UCBPlayer
38720,UCBPlayer,144,289,433,35,34,UCBPlayer
38721,UCBPlayer,91,196,287,0,71,UCBPlayer
38722,UCBPlayer,148,273,421,35,38,UCBPlayer
38723,UCBPlayer,87,212,299,0,67,UCBPlayer
38724,UCBPlayer,152,257,409,35,42,UCBPlayer
38725,UCBPlayer,84,224,308,0,64,UCBPlayer
38726,UCBPlayer,146,251,397,32,45,UCBPlayer
38727,UCBPlayer,89,234,323,3,60,UCBPlayer
38728,UCBPlayer,138,243,381,28,49,UCBPlayer
38729,UCBPlayer,97,242,339,7,56,UCBPlayer
38730,UCBPlayer,130,235,365,24,53,UCBPlayer
38731,UCBPlayer,105,250,355,11,52,UCBPlayer
38732,UCBPlayer,122,227,349,20,57,UCBPlayer
38733,UCBPlayer,109,259,368,15,49,UCBPlayer
38734,UCBPlayer,118,218,336,16,60,UCBPlayer
38735,UCBPlayer,117,267,384,19,45,UCBPlayer
38736,UCBPlayer,110,210,320,12,64,UCBPlayer
38737,UCBPlayer,126,271,397,23,42,UCBPlayer
38738,UCBPlayer,105,210,315,10,65,UCBPlayer
38739,UCBPlayer,130,275,405,25,40,UCBPlayer
38740,UCBPlayer,105,210,315,10,65,UCBPlayer
38741,UCBPlayer,130,275,405,25,40,UCBPlayer
38742,UCBPlayer,106,206,312,10,66,UCBPlayer
38743,UCBPlayer,130,275,405,25,40,UCBPlayer
38744,UCBPlayer,105,210,315,10,65,UCBPlayer
38745,UCBPlayer,131,271,402,25,41,UCBPlayer
38746,UCBPlayer,105,210,315,10,65,UCBPlayer
38747,UCBPlayer,130,275,405,25,40,UCBPlayer
38748,UCBPlayer,105,210,315,10,65,UCBPlayer
38749,UCBPlayer,130,275,405,25,40,UCBPlayer
38750,UCBPlayer,103,203,306,10,68,UCBPlayer
38751,UCBPlayer,128,283,411,25,38,UCBPlayer
38752,UCBPlayer,111,186,297,10,71,UCBPlayer
38753,UCBPlayer,124,299,423,25,34,UCBPlayer
38754,UCBPlayer,115,170,285,10,75,UCBPlayer
38755,UCBPlayer,120,315,435,25,30,UCBPlayer
38756,UCBPlayer,119,154,273,10,79,UCBPlayer
38757,UCBPlayer,112,332,444,25,27,UCBPlayer
38758,UCBPlayer,127,137,264,10,82,UCBPlayer
38759,UCBPlayer,104,349,453,25,24,UCBPlayer
38760,UCBPlayer,126,126,252,7,85,Tie
38761,UCBPlayer,111,351,462,28,22,UCBPlayer
38762,UCBPlayer,116,126,242,3,87,UCBPlayer
38763,UCBPlayer,122,347,469,32,21,UCBPlayer
38764,UCBPlayer,107,132,239,0,87,UCBPlayer
38765,UCBPlayer,132,337,469,35,22,UCBPlayer
38766,UCBPlayer,103,148,251,0,83,UCBPlayer
38767,UCBPlayer,136,321,457,35,26,UCBPlayer
38768,UCBPlayer,99,164,263,0,79,UCBPlayer
38769,UCBPlayer,140,305,445,35,30,UCBPlayer
38770,UCBPlayer,95,180,275,0,75,UCBPlayer
38771,UCBPlayer,144,289,433,35,34,UCBPlayer
38772,UCBPlayer,91,196,287,0,71,UCBPlayer
38773,UCBPlayer,148,273,421,35,38,UCBPlayer
38774,UCBPlayer,87,212,299,0,67,UCBPlayer
38775,UCBPlayer,152,257,409,35,42,UCBPlayer
38776,UCBPlayer,84,224,308,0,64,UCBPlayer
38777,UCBPlayer,146,251,397,32,45,UCBPlayer
38778,UCBPlayer,89,234,323,3,60,UCBPlayer
38779,UCBPlayer,138,243,381,28,49,UCBPlayer
38780,UCBPlayer,97,242,339,7,56,UCBPlayer
38781,UCBPlayer,130,235,365,24,53,UCBPlayer
38782,UCBPlayer,105,250,355,11,52,UCBPlayer
38783,UCBPlayer,122,227,349,20,57,UCBPlayer
38784,UCBPlayer,109,259,368,15,49,UCBPlayer
38785,UCBPlayer,118,218,336,16,60,UCBPlayer
38786,UCBPlayer,117,267,384,19,45,UCBPlayer
38787,UCBPlayer,110,210,320,12,64,UCBPlayer
38788,UCBPlayer,126,271,397,23,42,UCBPlayer
38789,UCBPlayer,105,210,315,10,65,UCBPlayer
38790,UCBPlayer,130,275,405,25,40,UCBPlayer
38791,UCBPlayer,105,210,315,10,65,UCBPlayer
38792,UCBPlayer,130,275,405,25,40,UCBPlayer
38793,UCBPlayer,106,206,312,10,66,UCBPlayer
38794,UCBPlayer,130,275,405,25,40,UCBPlayer
38795,UCBPlayer,105,210,315,10,65,UCBPlayer
38796,UCBPlayer,131,271,402,25,41,UCBPlayer
38797,UCBPlayer,105,210,315,10,65,UCBPlayer
38798,UCBPlayer,130,275,405,25,40,UCBPlayer
38799,UCBPlayer,105,210,315,10,65,UCBPlayer
38800,UCBPlayer,130,275,405,25,40,UCBPlayer
38801,UCBPlayer,103,203,306,10,68,UCBPlayer
38802,UCBPlayer,128,283,411,25,38,UCBPlayer
38803,UCBPlayer,111,186,297,10,71,UCBPlayer
38804,UCBPlayer,124,299,423,25,34,UCBPlayer
38805,UCBPlayer,115,170,285,10,75,UCBPlayer
38806,UCBPlayer,120,315,435,25,30,UCBPlayer
38807,UCBPlayer,119,154,273,10,79,UCBPlayer
38808,UCBPlayer,112,332,444,25,27,UCBPlayer
38809,UCBPlayer,127,137,264,10,82,UCBPlayer
38810,UCBPlayer,104,349,453,25,24,UCBPlayer
38811,UCBPlayer,126,126,252,7,85,Tie
38812,UCBPlayer,111,351,462,28,22,UCBPlayer
38813,UCBPlayer,116,126,242,3,87,UCBPlayer
38814,UCBPlayer,122,347,469,32,21,UCBPlayer
38815,UCBPlayer,107,132,239,0,87,UCBPlayer
38816,UCBPlayer,132,337,469,35,22,UCBPlayer
38817,UCBPlayer,103,148,251,0,83,UCBPlayer
38818,UCBPlayer,136,321,457,35,26,UCBPlayer
38819,UCBPlayer,99,164,263,0,79,UCBPlayer
38820,UCBPlayer,140,305,445,35,30,UCBPlayer
38821,UCBPlayer,95,180,275,0,75,UCBPlayer
38822,UCBPlayer,144,289,433,35,34,UCBPlayer
38823,UCBPlayer,91,196,287,0,71,UCBPlayer
38824,UCBPlayer,148,273,421,35,38,UCBPlayer
38825,UCBPlayer,87,212,299,0,67,UCBPlayer
38826,UCBPlayer,152,257,409,35,42,UCBPlayer
38827,UCBPlayer,84,224,308,0,64,UCBPlayer
38828,UCBPlayer,146,251,397,32,45,UCBPlayer
38829,UCBPlayer,89,234,323,3,60,UCBPlayer
38830,UCBPlayer,138,243,381,28,49,UCBPlayer
38831,UCBPlayer,97,242,339,7,56,UCBPlayer
38832,UCBPlayer,130,235,365,24,53,UCBPlayer
38833,UCBPlayer,105,250,355,11,52,UCBPlayer
38834,UCBPlayer,122,227,349,20,57,UCBPlayer
38835,UCBPlayer,109,259,368,15,49,UCBPlayer
38836,UCBPlayer,118,218,336,16,60,UCBPlayer
38837,UCBPlayer,117,267,384,19,45,UCBPlayer
38838,UCBPlayer,110,210,320,12,64,UCBPlayer
38839,UCBPlayer,126,271,397,23,42,UCBPlayer
38840,UCBPlayer,105,210,315,10,65,UCBPlayer
38841,UCBPlayer,130,275,405,25,40,UCBPlayer
38842,UCBPlayer,105,210,315,10,65,UCBPlayer
38843,UCBPlayer,130,275,405,25,40,UCBPlayer
38844,UCBPlayer,106,206,312,10,66,UCBPlayer
38845,UCBPlayer,130,275,405,25,40,UCBPlayer
38846,UCBPlayer,105,210,315,10,65,UCBPlayer
38847,UCBPlayer,131,271,402,25,41,UCBPlayer
38848,UCBPlayer,105,210,315,10,65,UCBPlayer
38849,UCBPlayer,130,275,405,25,40,UCBPlayer
38850,UCBPlayer,105,210,315,10,65,UCBPlayer
38851,UCBPlayer,130,275,405,25,40,UCBPlayer
38852,UCBPlayer,103,203,306,10,68,UCBPlayer
38853,UCBPlayer,128,283,411,25,38,UCBPlayer
38854,UCBPlayer,111,186,297,10,71,UCBPlayer
38855,UCBPlayer,124,299,423,25,34,UCBPlayer
38856,UCBPlayer,115,170,285,10,75,UCBPlayer
38857,UCBPlayer,120,315,435,25,30,UCBPlayer
38858,UCBPlayer,119,154,273,10,79,UCBPlayer
38859,UCBPlayer,112,332,444,25,27,UCBPlayer
38860,UCBPlayer,127,137,264,10,82,UCBPlayer
38861,UCBPlayer,104,349,453,25,24,UCBPlayer
38862,UCBPlayer,126,126,252,7,85,Tie
38863,UCBPlayer,111,351,462,28,22,UCBPlayer
38864,UCBPlayer,116,126,242,3,87,UCBPlayer
38865,UCBPlayer,122,347,469,32,21,UCBPlayer
38866,UCBPlayer,107,132,239,0,87,UCBPlayer
38867,UCBPlayer,132,337,469,35,22,UCBPlayer
38868,UCBPlayer,103,148,251,0,83,UCBPlayer
38869,UCBPlayer,136,321,457,35,26,UCBPlayer
38870,UCBPlayer,99,164,263,0,79,UCBPlayer
38871,UCBPlayer,140,305,445,35,30,UCBPlayer
38872,UCBPlayer,95,180,275,0,75,UCBPlayer
38873,UCBPlayer,144,289,433,35,34,UCBPlayer
38874,UCBPlayer,91,196,287,0,71,UCBPlayer
38875,UCBPlayer,148,273,421,35,38,UCBPlayer
38876,UCBPlayer,87,212,299,0,67,UCBPlayer
38877,UCBPlayer,152,257,409,35,42,UCBPlayer
38878,UCBPlayer,84,224,308,0,64,UCBPlayer
38879,UCBPlayer,146,251,397,32,45,UCBPlayer
38880,UCBPlayer,89,234,323,3,60,UCBPlayer
38881,UCBPlayer,138,243,381,28,49,UCBPlayer
38882,UCBPlayer,97,242,339,7,56,UCBPlayer
38883,UCBPlayer,130,235,365,24,53,UCBPlayer
38884,UCBPlayer,105,250,355,11,52,UCBPlayer
38885,UCBPlayer,122,227,349,20,57,UCBPlayer
38886,UCBPlayer,109,259,368,15,49,UCBPlayer
38887,UCBPlayer,118,218,336,16,60,UCBPlayer
38888,UCBPlayer,117,267,384,19,45,UCBPlayer
38889,UCBPlayer,110,210,320,12,64,UCBPlayer
38890,UCBPlayer,126,271,397,23,42,UCBPlayer
38891,UCBPlayer,105,210,315,10,65,UCBPlayer
38892,UCBPlayer,130,275,405,25,40,UCBPlayer
38893,UCBPlayer,105,210,315,10,65,UCBPlayer
38894,UCBPlayer,130,275,405,25,40,UCBPlayer
38895,UCBPlayer,106,206,312,10,66,UCBPlayer
38896,UCBPlayer,130,275,405,25,40,UCBPlayer
38897,UCBPlayer,105,210,315,10,65,UCBPlayer
38898,UCBPlayer,131,271,402,25,41,UCBPlayer
38899,UCBPlayer,105,210,315,10,65,UCBPlayer
38900,UCBPlayer,130,275,405,25,40,UCBPlayer
38901,UCBPlayer,105,210,315,10,65,UCBPlayer
38902,UCBPlayer,130,275,405,25,40,UCBPlayer
38903,UCBPlayer,103,203,306,10,68,UCBPlayer
38904,UCBPlayer,128,283,411,25,38,UCBPlayer
38905,UCBPlayer,111,186,297,10,71,UCBPlayer
38906,UCBPlayer,124,299,423,25,34,UCBPlayer
38907,UCBPlayer,115,170,285,10,75,UCBPlayer
38908,UCBPlayer,120,315,435,25,30,UCBPlayer
38909,UCBPlayer,119,154,273,10,79,UCBPlayer
38910,UCBPlayer,112,332,444,25,27,UCBPlayer
38911,UCBPlayer,127,137,264,10,82,UCBPlayer
38912,UCBPlayer,104,349,453,25,24,UCBPlayer
38913,UCBPlayer,126,126,252,7,85,Tie
38914,UCBPlayer,111,351,462,28,22,UCBPlayer
38915,UCBPlayer,116,126,242,3,87,UCBPlayer
38916,UCBPlayer,122,347,469,32,21,UCBPlayer
38917,UCBPlayer,107,132,239,0,87,UCBPlayer
38918,UCBPlayer,132,337,469,35,22,UCBPlayer
38919,UCBPlayer,103,148,251,0,83,UCBPlayer
38920,UCBPlayer,136,321,457,35,26,UCBPlayer
38921,UCBPlayer,99,164,263,0,79,UCBPlayer
38922,UCBPlayer,140,305,445,35,30,UCBPlayer
38923,UCBPlayer,95,180,275,0,75,UCBPlayer
38924,UCBPlayer,144,289,433,35,34,UCBPlayer
38925,UCBPlayer,91,196,287,0,71,UCBPlayer
38926,UCBPlayer,148,273,421,35,38,UCBPlayer
38927,UCBPlayer,87,212,299,0,67,UCBPlayer
38928,UCBPlayer,152,257,409,35,42,UCBPlayer
38929,UCBPlayer,84,224,308,0,64,UCBPlayer
38930,UCBPlayer,146,251,397,32,45,UCBPlayer
38931,UCBPlayer,89,234,323,3,60,UCBPlayer
38932,UCBPlayer,138,243,381,28,49,UCBPlayer
38933,UCBPlayer,97,242,339,7,56,UCBPlayer
38934,UCBPlayer,130,235,365,24,53,UCBPlayer
38935,UCBPlayer,105,250,355,11,52,UCBPlayer
38936,UCBPlayer,122,227,349,20,57,UCBPlayer
38937,UCBPlayer,109,259,368,15,49,UCBPlayer
38938,UCBPlayer,118,218,336,16,60,UCBPlayer
38939,UCBPlayer,117,267,384,19,45,UCBPlayer
38940,UCBPlayer,110,210,320,12,64,UCBPlayer
38941,UCBPlayer,126,271,397,23,42,UCBPlayer
38942,UCBPlayer,105,210,315,10,65,UCBPlayer
38943,UCBPlayer,130,275,405,25,40,UCBPlayer
38944,UCBPlayer,105,210,315,10,65,UCBPlayer
38945,UCBPlayer,130,275,405,25,40,UCBPlayer
38946,UCBPlayer,106,206,312,10,66,UCBPlayer
38947,UCBPlayer,130,275,405,25,40,UCBPlayer
38948,UCBPlayer,105,210,315,10,65,UCBPlayer
38949,UCBPlayer,131,271,402,25,41,UCBPlayer
38950,UCBPlayer,105,210,315,10,65,UCBPlayer
38951,UCBPlayer,130,275,405,25,40,UCBPlayer
38952,UCBPlayer,105,210,315,10,65,UCBPlayer
38953,UCBPlayer,130,275,405,25,40,UCBPlayer
38954,UCBPlayer,103,203,306,10,68,UCBPlayer
38955,UCBPlayer,128,283,411,25,38,UCBPlayer
38956,UCBPlayer,111,186,297,10,71,UCBPlayer
38957,UCBPlayer,124,299,423,25,34,UCBPlayer
38958,UCBPlayer,115,170,285,10,75,UCBPlayer
38959,UCBPlayer,120,315,435,25,30,UCBPlayer
38960,UCBPlayer,119,154,273,10,79,UCBPlayer
38961,UCBPlayer,112,332,444,25,27,UCBPlayer
38962,UCBPlayer,127,137,264,10,82,UCBPlayer
38963,UCBPlayer,104,349,453,25,24,UCBPlayer
38964,UCBPlayer,126,126,252,7,85,Tie
38965,UCBPlayer,111,351,462,28,22,UCBPlayer
38966,UCBPlayer,116,126,242,3,87,UCBPlayer
38967,UCBPlayer,122,347,469,32,21,UCBPlayer
38968,UCBPlayer,107,132,239,0,87,UCBPlayer
38969,UCBPlayer,132,337,469,35,22,UCBPlayer
38970,UCBPlayer,103,148,251,0,83,UCBPlayer
38971,UCBPlayer,136,321,457,35,26,UCBPlayer
38972,UCBPlayer,99,164,263,0,79,UCBPlayer
38973,UCBPlayer,140,305,445,35,30,UCBPlayer
38974,UCBPlayer,95,180,275,0,75,UCBPlayer
38975,UCBPlayer,144,289,433,35,34,UCBPlayer
38976,UCBPlayer,91,196,287,0,71,UCBPlayer
38977,UCBPlayer,148,273,421,35,38,UCBPlayer
38978,UCBPlayer,87,212,299,0,67,UCBPlayer
38979,UCBPlayer,152,257,409,35,42,UCBPlayer
38980,UCBPlayer,84,224,308,0,64,UCBPlayer
38981,UCBPlayer,146,251,397,32,45,UCBPlayer
38982,UCBPlayer,89,234,323,3,60,UCBPlayer
38983,UCBPlayer,138,243,381,28,49,UCBPlayer
38984,UCBPlayer,97,242,339,7,56,UCBPlayer
38985,UCBPlayer,130,235,365,24,53,UCBPlayer
38986,UCBPlayer,105,250,355,11,52,UCBPlayer
38987,UCBPlayer,122,227,349,20,57,UCBPlayer
38988,UCBPlayer,109,259,368,15,49,UCBPlayer
38989,UCBPlayer,118,218,336,16,60,UCBPlayer
38990,UCBPlayer,117,267,384,19,45,UCBPlayer
38991,UCBPlayer,110,210,320,12,64,UCBPlayer
38992,UCBPlayer,126,271,397,23,42,UCBPlayer
38993,UCBPlayer,105,210,315,10,65,UCBPlayer
38994,UCBPlayer,130,275,405,25,40,UCBPlayer
38995,UCBPlayer,105,210,315,10,65,UCBPlayer
38996,UCBPlayer,130,275,405,25,40,UCBPlayer
38997,UCBPlayer,106,206,312,10,66,UCBPlayer
38998,UCBPlayer,130,275,405,25,40,UCBPlayer
38999,UCBPlayer,105,210,315,10,65,UCBPlayer
39000,UCBPlayer,131,271,402,25,41,UCBPlayer
39001,UCBPlayer,105,210,315,10,65,UCBPlayer
39002,UCBPlayer,130,275,405,25,40,UCBPlayer
39003,UCBPlayer,105,210,315,10,65,UCBPlayer
39004,UCBPlayer,130,275,405,25,40,UCBPlayer
39005,UCBPlayer,103,203,306,10,68,UCBPlayer
39006,UCBPlayer,128,283,411,25,38,UCBPlayer
39007,UCBPlayer,111,186,297,10,71,UCBPlayer
39008,UCBPlayer,124,299,423,25,34,UCBPlayer
39009,UCBPlayer,115,170,285,10,75,UCBPlayer
39010,UCBPlayer,120,315,435,25,30,UCBPlayer
39011,UCBPlayer,119,154,273,10,79,UCBPlayer
39012,UCBPlayer,112,332,444,25,27,UCBPlayer
39013,UCBPlayer,127,137,264,10,82,UCBPlayer
39014,UCBPlayer,104,349,453,25,24,UCBPlayer
39015,UCBPlayer,126,126,252,7,85,Tie
39016,UCBPlayer,111,351,462,28,22,UCBPlayer
39017,UCBPlayer,116,126,242,3,87,UCBPlayer
39018,UCBPlayer,122,347,469,32,21,UCBPlayer
39019,UCBPlayer,107,132,239,0,87,UCBPlayer
39020,UCBPlayer,132,337,469,35,22,UCBPlayer
39021,UCBPlayer,103,148,251,0,83,UCBPlayer
39022,UCBPlayer,136,321,457,35,26,UCBPlayer
39023,UCBPlayer,99,164,263,0,79,UCBPlayer
39024,UCBPlayer,140,305,445,35,30,UCBPlayer
39025,UCBPlayer,95,180,275,0,75,UCBPlayer
39026,UCBPlayer,144,289,433,35,34,UCBPlayer
39027,UCBPlayer,91,196,287,0,71,UCBPlayer
39028,UCBPlayer,148,273,421,35,38,UCBPlayer
39029,UCBPlayer,87,212,299,0,67,UCBPlayer
39030,UCBPlayer,152,257,409,35,42,UCBPlayer
39031,UCBPlayer,84,224,308,0,64,UCBPlayer
39032,UCBPlayer,146,251,397,32,45,UCBPlayer
39033,UCBPlayer,89,234,323,3,60,UCBPlayer
39034,UCBPlayer,138,243,381,28,49,UCBPlayer
39035,UCBPlayer,97,242,339,7,56,UCBPlayer
39036,UCBPlayer,130,235,365,24,53,UCBPlayer
39037,UCBPlayer,105,250,355,11,52,UCBPlayer
39038,UCBPlayer,122,227,349,20,57,UCBPlayer
39039,UCBPlayer,109,259,368,15,49,UCBPlayer
39040,UCBPlayer,118,218,336,16,60,UCBPlayer
39041,UCBPlayer,117,267,384,19,45,UCBPlayer
39042,UCBPlayer,110,210,320,12,64,UCBPlayer
39043,UCBPlayer,126,271,397,23,42,UCBPlayer
39044,UCBPlayer,105,210,315,10,65,UCBPlayer
39045,UCBPlayer,130,275,405,25,40,UCBPlayer
39046,UCBPlayer,105,210,315,10,65,UCBPlayer
39047,UCBPlayer,130,275,405,25,40,UCBPlayer
39048,UCBPlayer,106,206,312,10,66,UCBPlayer
39049,UCBPlayer,130,275,405,25,40,UCBPlayer
39050,UCBPlayer,105,210,315,10,65,UCBPlayer
39051,UCBPlayer,131,271,402,25,41,UCBPlayer
39052,UCBPlayer,105,210,315,10,65,UCBPlayer
39053,UCBPlayer,130,275,405,25,40,UCBPlayer
39054,UCBPlayer,105,210,315,10,65,UCBPlayer
39055,UCBPlayer,130,275,405,25,40,UCBPlayer
39056,UCBPlayer,103,203,306,10,68,UCBPlayer
39057,UCBPlayer,128,283,411,25,38,UCBPlayer
39058,UCBPlayer,111,186,297,10,71,UCBPlayer
39059,UCBPlayer,124,299,423,25,34,UCBPlayer
39060,UCBPlayer,115,170,285,10,75,UCBPlayer
39061,UCBPlayer,120,315,435,25,30,UCBPlayer
39062,UCBPlayer,119,154,273,10,79,UCBPlayer
39063,UCBPlayer,112,332,444,25,27,UCBPlayer
39064,UCBPlayer,127,137,264,10,82,UCBPlayer
39065,UCBPlayer,104,349,453,25,24,UCBPlayer
39066,UCBPlayer,126,126,252,7,85,Tie
39067,UCBPlayer,111,351,462,28,22,UCBPlayer
39068,UCBPlayer,116,126,242,3,87,UCBPlayer
39069,UCBPlayer,122,347,469,32,21,UCBPlayer
39070,UCBPlayer,107,132,239,0,87,UCBPlayer
39071,UCBPlayer,132,337,469,35,22,UCBPlayer
39072,UCBPlayer,103,148,251,0,83,UCBPlayer
39073,UCBPlayer,136,321,457,35,26,UCBPlayer
39074,UCBPlayer,99,164,263,0,79,UCBPlayer
39075,UCBPlayer,140,305,445,35,30,UCBPlayer
39076,UCBPlayer,95,180,275,0,75,UCBPlayer
39077,UCBPlayer,144,289,433,35,34,UCBPlayer
39078,UCBPlayer,91,196,287,0,71,UCBPlayer
39079,UCBPlayer,148,273,421,35,38,UCBPlayer
39080,UCBPlayer,87,212,299,0,67,UCBPlayer
39081,UCBPlayer,152,257,409,35,42,UCBPlayer
39082,UCBPlayer,84,224,308,0,64,UCBPlayer
39083,UCBPlayer,146,251,397,32,45,UCBPlayer
39084,UCBPlayer,89,234,323,3,60,UCBPlayer
39085,UCBPlayer,138,243,381,28,49,UCBPlayer
39086,UCBPlayer,97,242,339,7,56,UCBPlayer
39087,UCBPlayer,130,235,365,24,53,UCBPlayer
39088,UCBPlayer,105,250,355,11,52,UCBPlayer
39089,UCBPlayer,122,227,349,20,57,UCBPlayer
39090,UCBPlayer,109,259,368,15,49,UCBPlayer
39091,UCBPlayer,118,218,336,16,60,UCBPlayer
39092,UCBPlayer,117,267,384,19,45,UCBPlayer
39093,UCBPlayer,110,210,320,12,64,UCBPlayer
39094,UCBPlayer,126,271,397,23,42,UCBPlayer
39095,UCBPlayer,105,210,315,10,65,UCBPlayer
39096,UCBPlayer,130,275,405,25,40,UCBPlayer
39097,UCBPlayer,105,210,315,10,65,UCBPlayer
39098,UCBPlayer,130,275,405,25,40,UCBPlayer
39099,UCBPlayer,106,206,312,10,66,UCBPlayer
39100,UCBPlayer,130,275,405,25,40,UCBPlayer
39101,UCBPlayer,105,210,315,10,65,UCBPlayer
39102,UCBPlayer,131,271,402,25,41,UCBPlayer
39103,UCBPlayer,105,210,315,10,65,UCBPlayer
39104,UCBPlayer,130,275,405,25,40,UCBPlayer
39105,UCBPlayer,105,210,315,10,65,UCBPlayer
39106,UCBPlayer,130,275,405,25,40,UCBPlayer
39107,UCBPlayer,103,203,306,10,68,UCBPlayer
39108,UCBPlayer,128,283,411,25,38,UCBPlayer
39109,UCBPlayer,111,186,297,10,71,UCBPlayer
39110,UCBPlayer,124,299,423,25,34,UCBPlayer
39111,UCBPlayer,115,170,285,10,75,UCBPlayer
39112,UCBPlayer,120,315,435,25,30,UCBPlayer
39113,UCBPlayer,119,154,273,10,79,UCBPlayer
39114,UCBPlayer,112,332,444,25,27,UCBPlayer
39115,UCBPlayer,127,137,264,10,82,UCBPlayer
39116,UCBPlayer,104,349,453,25,24,UCBPlayer
39117,UCBPlayer,126,126,252,7,85,Tie
39118,UCBPlayer,111,351,462,28,22,UCBPlayer
39119,UCBPlayer,116,126,242,3,87,UCBPlayer
39120,UCBPlayer,122,347,469,32,21,UCBPlayer
39121,UCBPlayer,107,132,239,0,87,UCBPlayer
39122,UCBPlayer,132,337,469,35,22,UCBPlayer
39123,UCBPlayer,103,148,251,0,83,UCBPlayer
39124,UCBPlayer,136,321,457,35,26,UCBPlayer
39125,UCBPlayer,99,164,263,0,79,UCBPlayer
39126,UCBPlayer,140,305,445,35,30,UCBPlayer
39127,UCBPlayer,95,180,275,0,75,UCBPlayer
39128,UCBPlayer,144,289,433,35,34,UCBPlayer
39129,UCBPlayer,91,196,287,0,71,UCBPlayer
39130,UCBPlayer,148,273,421,35,38,UCBPlayer
39131,UCBPlayer,87,212,299,0,67,UCBPlayer
39132,UCBPlayer,152,257,409,35,42,UCBPlayer
39133,UCBPlayer,84,224,308,0,64,UCBPlayer
39134,UCBPlayer,146,251,397,32,45,UCBPlayer
39135,UCBPlayer,89,234,323,3,60,UCBPlayer
39136,UCBPlayer,138,243,381,28,49,UCBPlayer
39137,UCBPlayer,97,242,339,7,56,UCBPlayer
39138,UCBPlayer,130,235,365,24,53,UCBPlayer
39139,UCBPlayer,105,250,355,11,52,UCBPlayer
39140,UCBPlayer,122,227,349,20,57,UCBPlayer
39141,UCBPlayer,109,259,368,15,49,UCBPlayer
39142,UCBPlayer,118,218,336,16,60,UCBPlayer
39143,UCBPlayer,117,267,384,19,45,UCBPlayer
39144,UCBPlayer,110,210,320,12,64,UCBPlayer
39145,UCBPlayer,126,271,397,23,42,UCBPlayer
39146,UCBPlayer,105,210,315,10,65,UCBPlayer
39147,UCBPlayer,130,275,405,25,40,UCBPlayer
39148,UCBPlayer,105,210,315,10,65,UCBPlayer
39149,UCBPlayer,130,275,405,25,40,UCBPlayer
39150,UCBPlayer,106,206,312,10,66,UCBPlayer
39151,UCBPlayer,130,275,405,25,40,UCBPlayer
39152,UCBPlayer,105,210,315,10,65,UCBPlayer
39153,UCBPlayer,131,271,402,25,41,UCBPlayer
39154,UCBPlayer,105,210,315,10,65,UCBPlayer
39155,UCBPlayer,130,275,405,25,40,UCBPlayer
39156,UCBPlayer,105,210,315,10,65,UCBPlayer
39157,UCBPlayer,130,275,405,25,40,UCBPlayer
39158,UCBPlayer,103,203,306,10,68,UCBPlayer
39159,UCBPlayer,128,283,411,25,38,UCBPlayer
39160,UCBPlayer,111,186,297,10,71,UCBPlayer
39161,UCBPlayer,124,299,423,25,34,UCBPlayer
39162,UCBPlayer,115,170,285,10,75,UCBPlayer
39163,UCBPlayer,120,315,435,25,30,UCBPlayer
39164,UCBPlayer,119,154,273,10,79,UCBPlayer
39165,UCBPlayer,112,332,444,25,27,UCBPlayer
39166,UCBPlayer,127,137,264,10,82,UCBPlayer
39167,UCBPlayer,104,349,453,25,24,UCBPlayer
39168,UCBPlayer,126,126,252,7,85,Tie
39169,UCBPlayer,111,351,462,28,22,UCBPlayer
39170,UCBPlayer,116,126,242,3,87,UCBPlayer
39171,UCBPlayer,122,347,469,32,21,UCBPlayer
39172,UCBPlayer,107,132,239,0,87,UCBPlayer
39173,UCBPlayer,132,337,469,35,22,UCBPlayer
39174,UCBPlayer,103,148,251,0,83,UCBPlayer
39175,UCBPlayer,136,321,457,35,26,UCBPlayer
39176,UCBPlayer,99,164,263,0,79,UCBPlayer
39177,UCBPlayer,140,305,445,35,30,UCBPlayer
39178,UCBPlayer,95,180,275,0,75,UCBPlayer
39179,UCBPlayer,144,289,433,35,34,UCBPlayer
39180,UCBPlayer,91,196,287,0,71,UCBPlayer
39181,UCBPlayer,148,273,421,35,38,UCBPlayer
39182,UCBPlayer,87,212,299,0,67,UCBPlayer
39183,UCBPlayer,152,257,409,35,42,UCBPlayer
39184,UCBPlayer,84,224,308,0,64,UCBPlayer
39185,UCBPlayer,146,251,397,32,45,UCBPlayer
39186,UCBPlayer,89,234,323,3,60,UCBPlayer
39187,UCBPlayer,138,243,381,28,49,UCBPlayer
39188,UCBPlayer,97,242,339,7,56,UCBPlayer
39189,UCBPlayer,130,235,365,24,53,UCBPlayer
39190,UCBPlayer,105,250,355,11,52,UCBPlayer
39191,UCBPlayer,122,227,349,20,57,UCBPlayer
39192,UCBPlayer,109,259,368,15,49,UCBPlayer
39193,UCBPlayer,118,218,336,16,60,UCBPlayer
39194,UCBPlayer,117,267,384,19,45,UCBPlayer
39195,UCBPlayer,110,210,320,12,64,UCBPlayer
39196,UCBPlayer,126,271,397,23,42,UCBPlayer
39197,UCBPlayer,105,210,315,10,65,UCBPlayer
39198,UCBPlayer,130,275,405,25,40,UCBPlayer
39199,UCBPlayer,105,210,315,10,65,UCBPlayer
39200,UCBPlayer,130,275,405,25,40,UCBPlayer
39201,UCBPlayer,106,206,312,10,66,UCBPlayer
39202,UCBPlayer,130,275,405,25,40,UCBPlayer
39203,UCBPlayer,105,210,315,10,65,UCBPlayer
39204,UCBPlayer,131,271,402,25,41,UCBPlayer
39205,UCBPlayer,105,210,315,10,65,UCBPlayer
39206,UCBPlayer,130,275,405,25,40,UCBPlayer
39207,UCBPlayer,105,210,315,10,65,UCBPlayer
39208,UCBPlayer,130,275,405,25,40,UCBPlayer
39209,UCBPlayer,103,203,306,10,68,UCBPlayer
39210,UCBPlayer,128,283,411,25,38,UCBPlayer
39211,UCBPlayer,111,186,297,10,71,UCBPlayer
39212,UCBPlayer,124,299,423,25,34,UCBPlayer
39213,UCBPlayer,115,170,285,10,75,UCBPlayer
39214,UCBPlayer,120,315,435,25,30,UCBPlayer
39215,UCBPlayer,119,154,273,10,79,UCBPlayer
39216,UCBPlayer,112,332,444,25,27,UCBPlayer
39217,UCBPlayer,127,137,264,10,82,UCBPlayer
39218,UCBPlayer,104,349,453,25,24,UCBPlayer
39219,UCBPlayer,126,126,252,7,85,Tie
39220,UCBPlayer,111,351,462,28,22,UCBPlayer
39221,UCBPlayer,116,126,242,3,87,UCBPlayer
39222,UCBPlayer,122,347,469,32,21,UCBPlayer
39223,UCBPlayer,107,132,239,0,87,UCBPlayer
39224,UCBPlayer,132,337,469,35,22,UCBPlayer
39225,UCBPlayer,103,148,251,0,83,UCBPlayer
39226,UCBPlayer,136,321,457,35,26,UCBPlayer
39227,UCBPlayer,99,164,263,0,79,UCBPlayer
39228,UCBPlayer,140,305,445,35,30,UCBPlayer
39229,UCBPlayer,95,180,275,0,75,UCBPlayer
39230,UCBPlayer,144,289,433,35,34,UCBPlayer
39231,UCBPlayer,91,196,287,0,71,UCBPlayer
39232,UCBPlayer,148,273,421,35,38,UCBPlayer
39233,UCBPlayer,87,212,299,0,67,UCBPlayer
39234,UCBPlayer,152,257,409,35,42,UCBPlayer
39235,UCBPlayer,84,224,308,0,64,UCBPlayer
39236,UCBPlayer,146,251,397,32,45,UCBPlayer
39237,UCBPlayer,89,234,323,3,60,UCBPlayer
39238,UCBPlayer,138,243,381,28,49,UCBPlayer
39239,UCBPlayer,97,242,339,7,56,UCBPlayer
39240,UCBPlayer,130,235,365,24,53,UCBPlayer
39241,UCBPlayer,105,250,355,11,52,UCBPlayer
39242,UCBPlayer,122,227,349,20,57,UCBPlayer
39243,UCBPlayer,109,259,368,15,49,UCBPlayer
39244,UCBPlayer,118,218,336,16,60,UCBPlayer
39245,UCBPlayer,117,267,384,19,45,UCBPlayer
39246,UCBPlayer,110,210,320,12,64,UCBPlayer
39247,UCBPlayer,126,271,397,23,42,UCBPlayer
39248,UCBPlayer,105,210,315,10,65,UCBPlayer
39249,UCBPlayer,130,275,405,25,40,UCBPlayer
39250,UCBPlayer,105,210,315,10,65,UCBPlayer
39251,UCBPlayer,130,275,405,25,40,UCBPlayer
39252,UCBPlayer,106,206,312,10,66,UCBPlayer
39253,UCBPlayer,130,275,405,25,40,UCBPlayer
39254,UCBPlayer,105,210,315,10,65,UCBPlayer
39255,UCBPlayer,131,271,402,25,41,UCBPlayer
39256,UCBPlayer,105,210,315,10,65,UCBPlayer
39257,UCBPlayer,130,275,405,25,40,UCBPlayer
39258,UCBPlayer,105,210,315,10,65,UCBPlayer
39259,UCBPlayer,130,275,405,25,40,UCBPlayer
39260,UCBPlayer,103,203,306,10,68,UCBPlayer
39261,UCBPlayer,128,283,411,25,38,UCBPlayer
39262,UCBPlayer,111,186,297,10,71,UCBPlayer
39263,UCBPlayer,124,299,423,25,34,UCBPlayer
39264,UCBPlayer,115,170,285,10,75,UCBPlayer
39265,UCBPlayer,120,315,435,25,30,UCBPlayer
39266,UCBPlayer,119,154,273,10,79,UCBPlayer
39267,UCBPlayer,112,332,444,25,27,UCBPlayer
39268,UCBPlayer,127,137,264,10,82,UCBPlayer
39269,UCBPlayer,104,349,453,25,24,UCBPlayer
39270,UCBPlayer,126,126,252,7,85,Tie
39271,UCBPlayer,111,351,462,28,22,UCBPlayer
39272,UCBPlayer,116,126,242,3,87,UCBPlayer
39273,UCBPlayer,122,347,469,32,21,UCBPlayer
39274,UCBPlayer,107,132,239,0,87,UCBPlayer
39275,UCBPlayer,132,337,469,35,22,UCBPlayer
39276,UCBPlayer,103,148,251,0,83,UCBPlayer
39277,UCBPlayer,136,321,457,35,26,UCBPlayer
39278,UCBPlayer,99,164,263,0,79,UCBPlayer
39279,UCBPlayer,140,305,445,35,30,UCBPlayer
39280,UCBPlayer,95,180,275,0,75,UCBPlayer
39281,UCBPlayer,144,289,433,35,34,UCBPlayer
39282,UCBPlayer,91,196,287,0,71,UCBPlayer
39283,UCBPlayer,148,273,421,35,38,UCBPlayer
39284,UCBPlayer,87,212,299,0,67,UCBPlayer
39285,UCBPlayer,152,257,409,35,42,UCBPlayer
39286,UCBPlayer,84,224,308,0,64,UCBPlayer
39287,UCBPlayer,146,251,397,32,45,UCBPlayer
39288,UCBPlayer,89,234,323,3,60,UCBPlayer
39289,UCBPlayer,138,243,381,28,49,UCBPlayer
39290,UCBPlayer,97,242,339,7,56,UCBPlayer
39291,UCBPlayer,130,235,365,24,53,UCBPlayer
39292,UCBPlayer,105,250,355,11,52,UCBPlayer
39293,UCBPlayer,122,227,349,20,57,UCBPlayer
39294,UCBPlayer,109,259,368,15,49,UCBPlayer
39295,UCBPlayer,118,218,336,16,60,UCBPlayer
39296,UCBPlayer,117,267,384,19,45,UCBPlayer
39297,UCBPlayer,110,210,320,12,64,UCBPlayer
39298,UCBPlayer,126,271,397,23,42,UCBPlayer
39299,UCBPlayer,105,210,315,10,65,UCBPlayer
39300,UCBPlayer,130,275,405,25,40,UCBPlayer
39301,UCBPlayer,105,210,315,10,65,UCBPlayer
39302,UCBPlayer,130,275,405,25,40,UCBPlayer
39303,UCBPlayer,106,206,312,10,66,UCBPlayer
39304,UCBPlayer,130,275,405,25,40,UCBPlayer
39305,UCBPlayer,105,210,315,10,65,UCBPlayer
39306,UCBPlayer,131,271,402,25,41,UCBPlayer
39307,UCBPlayer,105,210,315,10,65,UCBPlayer
39308,UCBPlayer,130,275,405,25,40,UCBPlayer
39309,UCBPlayer,105,210,315,10,65,UCBPlayer
39310,UCBPlayer,130,275,405,25,40,UCBPlayer
39311,UCBPlayer,103,203,306,10,68,UCBPlayer
39312,UCBPlayer,128,283,411,25,38,UCBPlayer
39313,UCBPlayer,111,186,297,10,71,UCBPlayer
39314,UCBPlayer,124,299,423,25,34,UCBPlayer
39315,UCBPlayer,115,170,285,10,75,UCBPlayer
39316,UCBPlayer,120,315,435,25,30,UCBPlayer
39317,UCBPlayer,119,154,273,10,79,UCBPlayer
39318,UCBPlayer,112,332,444,25,27,UCBPlayer
39319,UCBPlayer,127,137,264,10,82,UCBPlayer
39320,UCBPlayer,104,349,453,25,24,UCBPlayer
39321,UCBPlayer,126,126,252,7,85,Tie
39322,UCBPlayer,111,351,462,28,22,UCBPlayer
39323,UCBPlayer,116,126,242,3,87,UCBPlayer
39324,UCBPlayer,122,347,469,32,21,UCBPlayer
39325,UCBPlayer,107,132,239,0,87,UCBPlayer
39326,UCBPlayer,132,337,469,35,22,UCBPlayer
39327,UCBPlayer,103,148,251,0,83,UCBPlayer
39328,UCBPlayer,136,321,457,35,26,UCBPlayer
39329,UCBPlayer,99,164,263,0,79,UCBPlayer
39330,UCBPlayer,140,305,445,35,30,UCBPlayer
39331,UCBPlayer,95,180,275,0,75,UCBPlayer
39332,UCBPlayer,144,289,433,35,34,UCBPlayer
39333,UCBPlayer,91,196,287,0,71,UCBPlayer
39334,UCBPlayer,148,273,421,35,38,UCBPlayer
39335,UCBPlayer,87,212,299,0,67,UCBPlayer
39336,UCBPlayer,152,257,409,35,42,UCBPlayer
39337,UCBPlayer,84,224,308,0,64,UCBPlayer
39338,UCBPlayer,146,251,397,32,45,UCBPlayer
39339,UCBPlayer,89,234,323,3,60,UCBPlayer
39340,UCBPlayer,138,243,381,28,49,UCBPlayer
39341,UCBPlayer,97,242,339,7,56,UCBPlayer
39342,UCBPlayer,130,235,365,24,53,UCBPlayer
39343,UCBPlayer,105,250,355,11,52,UCBPlayer
39344,UCBPlayer,122,227,349,20,57,UCBPlayer
39345,UCBPlayer,109,259,368,15,49,UCBPlayer
39346,UCBPlayer,118,218,336,16,60,UCBPlayer
39347,UCBPlayer,117,267,384,19,45,UCBPlayer
39348,UCBPlayer,110,210,320,12,64,UCBPlayer
39349,UCBPlayer,126,271,397,23,42,UCBPlayer
39350,UCBPlayer,105,210,315,10,65,UCBPlayer
39351,UCBPlayer,130,275,405,25,40,UCBPlayer
39352,UCBPlayer,105,210,315,10,65,UCBPlayer
39353,UCBPlayer,130,275,405,25,40,UCBPlayer
39354,UCBPlayer,106,206,312,10,66,UCBPlayer
39355,UCBPlayer,130,275,405,25,40,UCBPlayer
39356,UCBPlayer,105,210,315,10,65,UCBPlayer
39357,UCBPlayer,131,271,402,25,41,UCBPlayer
39358,UCBPlayer,105,210,315,10,65,UCBPlayer
39359,UCBPlayer,130,275,405,25,40,UCBPlayer
39360,UCBPlayer,105,210,315,10,65,UCBPlayer
39361,UCBPlayer,130,275,405,25,40,UCBPlayer
39362,UCBPlayer,103,203,306,10,68,UCBPlayer
39363,UCBPlayer,128,283,411,25,38,UCBPlayer
39364,UCBPlayer,111,186,297,10,71,UCBPlayer
39365,UCBPlayer,124,299,423,25,34,UCBPlayer
39366,UCBPlayer,115,170,285,10,75,UCBPlayer
39367,UCBPlayer,120,315,435,25,30,UCBPlayer
39368,UCBPlayer,119,154,273,10,79,UCBPlayer
39369,UCBPlayer,112,332,444,25,27,UCBPlayer
39370,UCBPlayer,127,137,264,10,82,UCBPlayer
39371,UCBPlayer,104,349,453,25,24,UCBPlayer
39372,UCBPlayer,126,126,252,7,85,Tie
39373,UCBPlayer,111,351,462,28,22,UCBPlayer
39374,UCBPlayer,116,126,242,3,87,UCBPlayer
39375,UCBPlayer,122,347,469,32,21,UCBPlayer
39376,UCBPlayer,107,132,239,0,87,UCBPlayer
39377,UCBPlayer,132,337,469,35,22,UCBPlayer
39378,UCBPlayer,103,148,251,0,83,UCBPlayer
39379,UCBPlayer,136,321,457,35,26,UCBPlayer
39380,UCBPlayer,99,164,263,0,79,UCBPlayer
39381,UCBPlayer,140,305,445,35,30,UCBPlayer
39382,UCBPlayer,95,180,275,0,75,UCBPlayer
39383,UCBPlayer,144,289,433,35,34,UCBPlayer
39384,UCBPlayer,91,196,287,0,71,UCBPlayer
39385,UCBPlayer,148,273,421,35,38,UCBPlayer
39386,UCBPlayer,87,212,299,0,67,UCBPlayer
39387,UCBPlayer,152,257,409,35,42,UCBPlayer
39388,UCBPlayer,84,224,308,0,64,UCBPlayer
39389,UCBPlayer,146,251,397,32,45,UCBPlayer
39390,UCBPlayer,89,234,323,3,60,UCBPlayer
39391,UCBPlayer,138,243,381,28,49,UCBPlayer
39392,UCBPlayer,97,242,339,7,56,UCBPlayer
39393,UCBPlayer,130,235,365,24,53,UCBPlayer
39394,UCBPlayer,105,250,355,11,52,UCBPlayer
39395,UCBPlayer,122,227,349,20,57,UCBPlayer
39396,UCBPlayer,109,259,368,15,49,UCBPlayer
39397,UCBPlayer,118,218,336,16,60,UCBPlayer
39398,UCBPlayer,117,267,384,19,45,UCBPlayer
39399,UCBPlayer,110,210,320,12,64,UCBPlayer
39400,UCBPlayer,126,271,397,23,42,UCBPlayer
39401,UCBPlayer,105,210,315,10,65,UCBPlayer
39402,UCBPlayer,130,275,405,25,40,UCBPlayer
39403,UCBPlayer,105,210,315,10,65,UCBPlayer
39404,UCBPlayer,130,275,405,25,40,UCBPlayer
39405,UCBPlayer,106,206,312,10,66,UCBPlayer
39406,UCBPlayer,130,275,405,25,40,UCBPlayer
39407,UCBPlayer,105,210,315,10,65,UCBPlayer
39408,UCBPlayer,131,271,402,25,41,UCBPlayer
39409,UCBPlayer,105,210,315,10,65,UCBPlayer
39410,UCBPlayer,130,275,405,25,40,UCBPlayer
39411,UCBPlayer,105,210,315,10,65,UCBPlayer
39412,UCBPlayer,130,275,405,25,40,UCBPlayer
39413,UCBPlayer,103,203,306,10,68,UCBPlayer
39414,UCBPlayer,128,283,411,25,38,UCBPlayer
39415,UCBPlayer,111,186,297,10,71,UCBPlayer
39416,UCBPlayer,124,299,423,25,34,UCBPlayer
39417,UCBPlayer,115,170,285,10,75,UCBPlayer
39418,UCBPlayer,120,315,435,25,30,UCBPlayer
39419,UCBPlayer,119,154,273,10,79,UCBPlayer
39420,UCBPlayer,112,332,444,25,27,UCBPlayer
39421,UCBPlayer,127,137,264,10,82,UCBPlayer
39422,UCBPlayer,104,349,453,25,24,UCBPlayer
39423,UCBPlayer,126,126,252,7,85,Tie
39424,UCBPlayer,111,351,462,28,22,UCBPlayer
39425,UCBPlayer,116,126,242,3,87,UCBPlayer
39426,UCBPlayer,122,347,469,32,21,UCBPlayer
39427,UCBPlayer,107,132,239,0,87,UCBPlayer
39428,UCBPlayer,132,337,469,35,22,UCBPlayer
39429,UCBPlayer,103,148,251,0,83,UCBPlayer
39430,UCBPlayer,136,321,457,35,26,UCBPlayer
39431,UCBPlayer,99,164,263,0,79,UCBPlayer
39432,UCBPlayer,140,305,445,35,30,UCBPlayer
39433,UCBPlayer,95,180,275,0,75,UCBPlayer
39434,UCBPlayer,144,289,433,35,34,UCBPlayer
39435,UCBPlayer,91,196,287,0,71,UCBPlayer
39436,UCBPlayer,148,273,421,35,38,UCBPlayer
39437,UCBPlayer,87,212,299,0,67,UCBPlayer
39438,UCBPlayer,152,257,409,35,42,UCBPlayer
39439,UCBPlayer,84,224,308,0,64,UCBPlayer
39440,UCBPlayer,146,251,397,32,45,UCBPlayer
39441,UCBPlayer,89,234,323,3,60,UCBPlayer
39442,UCBPlayer,138,243,381,28,49,UCBPlayer
39443,UCBPlayer,97,242,339,7,56,UCBPlayer
39444,UCBPlayer,130,235,365,24,53,UCBPlayer
39445,UCBPlayer,105,250,355,11,52,UCBPlayer
39446,UCBPlayer,122,227,349,20,57,UCBPlayer
39447,UCBPlayer,109,259,368,15,49,UCBPlayer
39448,UCBPlayer,118,218,336,16,60,UCBPlayer
39449,UCBPlayer,117,267,384,19,45,UCBPlayer
39450,UCBPlayer,110,210,320,12,64,UCBPlayer
39451,UCBPlayer,126,271,397,23,42,UCBPlayer
39452,UCBPlayer,105,210,315,10,65,UCBPlayer
39453,UCBPlayer,130,275,405,25,40,UCBPlayer
39454,UCBPlayer,105,210,315,10,65,UCBPlayer
39455,UCBPlayer,130,275,405,25,40,UCBPlayer
39456,UCBPlayer,106,206,312,10,66,UCBPlayer
39457,UCBPlayer,130,275,405,25,40,UCBPlayer
39458,UCBPlayer,105,210,315,10,65,UCBPlayer
39459,UCBPlayer,131,271,402,25,41,UCBPlayer
39460,UCBPlayer,105,210,315,10,65,UCBPlayer
39461,UCBPlayer,130,275,405,25,40,UCBPlayer
39462,UCBPlayer,105,210,315,10,65,UCBPlayer
39463,UCBPlayer,130,275,405,25,40,UCBPlayer
39464,UCBPlayer,103,203,306,10,68,UCBPlayer
39465,UCBPlayer,128,283,411,25,38,UCBPlayer
39466,UCBPlayer,111,186,297,10,71,UCBPlayer
39467,UCBPlayer,124,299,423,25,34,UCBPlayer
39468,UCBPlayer,115,170,285,10,75,UCBPlayer
39469,UCBPlayer,120,315,435,25,30,UCBPlayer
39470,UCBPlayer,119,154,273,10,79,UCBPlayer
39471,UCBPlayer,112,332,444,25,27,UCBPlayer
39472,UCBPlayer,127,137,264,10,82,UCBPlayer
39473,UCBPlayer,104,349,453,25,24,UCBPlayer
39474,UCBPlayer,126,126,252,7,85,Tie
39475,UCBPlayer,111,351,462,28,22,UCBPlayer
39476,UCBPlayer,116,126,242,3,87,UCBPlayer
39477,UCBPlayer,122,347,469,32,21,UCBPlayer
39478,UCBPlayer,107,132,239,0,87,UCBPlayer
39479,UCBPlayer,132,337,469,35,22,UCBPlayer
39480,UCBPlayer,103,148,251,0,83,UCBPlayer
39481,UCBPlayer,136,321,457,35,26,UCBPlayer
39482,UCBPlayer,99,164,263,0,79,UCBPlayer
39483,UCBPlayer,140,305,445,35,30,UCBPlayer
39484,UCBPlayer,95,180,275,0,75,UCBPlayer
39485,UCBPlayer,144,289,433,35,34,UCBPlayer
39486,UCBPlayer,91,196,287,0,71,UCBPlayer
39487,UCBPlayer,148,273,421,35,38,UCBPlayer
39488,UCBPlayer,87,212,299,0,67,UCBPlayer
39489,UCBPlayer,152,257,409,35,42,UCBPlayer
39490,UCBPlayer,84,224,308,0,64,UCBPlayer
39491,UCBPlayer,146,251,397,32,45,UCBPlayer
39492,UCBPlayer,89,234,323,3,60,UCBPlayer
39493,UCBPlayer,138,243,381,28,49,UCBPlayer
39494,UCBPlayer,97,242,339,7,56,UCBPlayer
39495,UCBPlayer,130,235,365,24,53,UCBPlayer
39496,UCBPlayer,105,250,355,11,52,UCBPlayer
39497,UCBPlayer,122,227,349,20,57,UCBPlayer
39498,UCBPlayer,109,259,368,15,49,UCBPlayer
39499,UCBPlayer,118,218,336,16,60,UCBPlayer
39500,UCBPlayer,117,267,384,19,45,UCBPlayer
39501,UCBPlayer,110,210,320,12,64,UCBPlayer
39502,UCBPlayer,126,271,397,23,42,UCBPlayer
39503,UCBPlayer,105,210,315,10,65,UCBPlayer
39504,UCBPlayer,130,275,405,25,40,UCBPlayer
39505,UCBPlayer,105,210,315,10,65,UCBPlayer
39506,UCBPlayer,130,275,405,25,40,UCBPlayer
39507,UCBPlayer,106,206,312,10,66,UCBPlayer
39508,UCBPlayer,130,275,405,25,40,UCBPlayer
39509,UCBPlayer,105,210,315,10,65,UCBPlayer
39510,UCBPlayer,131,271,402,25,41,UCBPlayer
39511,UCBPlayer,105,210,315,10,65,UCBPlayer
39512,UCBPlayer,130,275,405,25,40,UCBPlayer
39513,UCBPlayer,105,210,315,10,65,UCBPlayer
39514,UCBPlayer,130,275,405,25,40,UCBPlayer
39515,UCBPlayer,103,203,306,10,68,UCBPlayer
39516,UCBPlayer,128,283,411,25,38,UCBPlayer
39517,UCBPlayer,111,186,297,10,71,UCBPlayer
39518,UCBPlayer,124,299,423,25,34,UCBPlayer
39519,UCBPlayer,115,170,285,10,75,UCBPlayer
39520,UCBPlayer,120,315,435,25,30,UCBPlayer
39521,UCBPlayer,119,154,273,10,79,UCBPlayer
39522,UCBPlayer,112,332,444,25,27,UCBPlayer
39523,UCBPlayer,127,137,264,10,82,UCBPlayer
39524,UCBPlayer,104,349,453,25,24,UCBPlayer
39525,UCBPlayer,126,126,252,7,85,Tie
39526,UCBPlayer,111,351,462,28,22,UCBPlayer
39527,UCBPlayer,116,126,242,3,87,UCBPlayer
39528,UCBPlayer,122,347,469,32,21,UCBPlayer
39529,UCBPlayer,107,132,239,0,87,UCBPlayer
39530,UCBPlayer,132,337,469,35,22,UCBPlayer
39531,UCBPlayer,103,148,251,0,83,UCBPlayer
39532,UCBPlayer,136,321,457,35,26,UCBPlayer
39533,UCBPlayer,99,164,263,0,79,UCBPlayer
39534,UCBPlayer,140,305,445,35,30,UCBPlayer
39535,UCBPlayer,95,180,275,0,75,UCBPlayer
39536,UCBPlayer,144,289,433,35,34,UCBPlayer
39537,UCBPlayer,91,196,287,0,71,UCBPlayer
39538,UCBPlayer,148,273,421,35,38,UCBPlayer
39539,UCBPlayer,87,212,299,0,67,UCBPlayer
39540,UCBPlayer,152,257,409,35,42,UCBPlayer
39541,UCBPlayer,84,224,308,0,64,UCBPlayer
39542,UCBPlayer,146,251,397,32,45,UCBPlayer
39543,UCBPlayer,89,234,323,3,60,UCBPlayer
39544,UCBPlayer,138,243,381,28,49,UCBPlayer
39545,UCBPlayer,97,242,339,7,56,UCBPlayer
39546,UCBPlayer,130,235,365,24,53,UCBPlayer
39547,UCBPlayer,105,250,355,11,52,UCBPlayer
39548,UCBPlayer,122,227,349,20,57,UCBPlayer
39549,UCBPlayer,109,259,368,15,49,UCBPlayer
39550,UCBPlayer,118,218,336,16,60,UCBPlayer
39551,UCBPlayer,117,267,384,19,45,UCBPlayer
39552,UCBPlayer,110,210,320,12,64,UCBPlayer
39553,UCBPlayer,126,271,397,23,42,UCBPlayer
39554,UCBPlayer,105,210,315,10,65,UCBPlayer
39555,UCBPlayer,130,275,405,25,40,UCBPlayer
39556,UCBPlayer,105,210,315,10,65,UCBPlayer
39557,UCBPlayer,130,275,405,25,40,UCBPlayer
39558,UCBPlayer,106,206,312,10,66,UCBPlayer
39559,UCBPlayer,130,275,405,25,40,UCBPlayer
39560,UCBPlayer,105,210,315,10,65,UCBPlayer
39561,UCBPlayer,131,271,402,25,41,UCBPlayer
39562,UCBPlayer,105,210,315,10,65,UCBPlayer
39563,UCBPlayer,130,275,405,25,40,UCBPlayer
39564,UCBPlayer,105,210,315,10,65,UCBPlayer
39565,UCBPlayer,130,275,405,25,40,UCBPlayer
39566,UCBPlayer,103,203,306,10,68,UCBPlayer
39567,UCBPlayer,128,283,411,25,38,UCBPlayer
39568,UCBPlayer,111,186,297,10,71,UCBPlayer
39569,UCBPlayer,124,299,423,25,34,UCBPlayer
39570,UCBPlayer,115,170,285,10,75,UCBPlayer
39571,UCBPlayer,120,315,435,25,30,UCBPlayer
39572,UCBPlayer,119,154,273,10,79,UCBPlayer
39573,UCBPlayer,112,332,444,25,27,UCBPlayer
39574,UCBPlayer,127,137,264,10,82,UCBPlayer
39575,UCBPlayer,104,349,453,25,24,UCBPlayer
39576,UCBPlayer,126,126,252,7,85,Tie
39577,UCBPlayer,111,351,462,28,22,UCBPlayer
39578,UCBPlayer,116,126,242,3,87,UCBPlayer
39579,UCBPlayer,122,347,469,32,21,UCBPlayer
39580,UCBPlayer,107,132,239,0,87,UCBPlayer
39581,UCBPlayer,132,337,469,35,22,UCBPlayer
39582,UCBPlayer,103,148,251,0,83,UCBPlayer
39583,UCBPlayer,136,321,457,35,26,UCBPlayer
39584,UCBPlayer,99,164,263,0,79,UCBPlayer
39585,UCBPlayer,140,305,445,35,30,UCBPlayer
39586,UCBPlayer,95,180,275,0,75,UCBPlayer
39587,UCBPlayer,144,289,433,35,34,UCBPlayer
39588,UCBPlayer,91,196,287,0,71,UCBPlayer
39589,UCBPlayer,148,273,421,35,38,UCBPlayer
39590,UCBPlayer,87,212,299,0,67,UCBPlayer
39591,UCBPlayer,152,257,409,35,42,UCBPlayer
39592,UCBPlayer,84,224,308,0,64,UCBPlayer
39593,UCBPlayer,146,251,397,32,45,UCBPlayer
39594,UCBPlayer,89,234,323,3,60,UCBPlayer
39595,UCBPlayer,138,243,381,28,49,UCBPlayer
39596,UCBPlayer,97,242,339,7,56,UCBPlayer
39597,UCBPlayer,130,235,365,24,53,UCBPlayer
39598,UCBPlayer,105,250,355,11,52,UCBPlayer
39599,UCBPlayer,122,227,349,20,57,UCBPlayer
39600,UCBPlayer,109,259,368,15,49,UCBPlayer
39601,UCBPlayer,118,218,336,16,60,UCBPlayer
39602,UCBPlayer,117,267,384,19,45,UCBPlayer
39603,UCBPlayer,110,210,320,12,64,UCBPlayer
39604,UCBPlayer,126,271,397,23,42,UCBPlayer
39605,UCBPlayer,105,210,315,10,65,UCBPlayer
39606,UCBPlayer,130,275,405,25,40,UCBPlayer
39607,UCBPlayer,105,210,315,10,65,UCBPlayer
39608,UCBPlayer,130,275,405,25,40,UCBPlayer
39609,UCBPlayer,106,206,312,10,66,UCBPlayer
39610,UCBPlayer,130,275,405,25,40,UCBPlayer
39611,UCBPlayer,105,210,315,10,65,UCBPlayer
39612,UCBPlayer,131,271,402,25,41,UCBPlayer
39613,UCBPlayer,105,210,315,10,65,UCBPlayer
39614,UCBPlayer,130,275,405,25,40,UCBPlayer
39615,UCBPlayer,105,210,315,10,65,UCBPlayer
39616,UCBPlayer,130,275,405,25,40,UCBPlayer
39617,UCBPlayer,103,203,306,10,68,UCBPlayer
39618,UCBPlayer,128,283,411,25,38,UCBPlayer
39619,UCBPlayer,111,186,297,10,71,UCBPlayer
39620,UCBPlayer,124,299,423,25,34,UCBPlayer
39621,UCBPlayer,115,170,285,10,75,UCBPlayer
39622,UCBPlayer,120,315,435,25,30,UCBPlayer
39623,UCBPlayer,119,154,273,10,79,UCBPlayer
39624,UCBPlayer,112,332,444,25,27,UCBPlayer
39625,UCBPlayer,127,137,264,10,82,UCBPlayer
39626,UCBPlayer,104,349,453,25,24,UCBPlayer
39627,UCBPlayer,126,126,252,7,85,Tie
39628,UCBPlayer,111,351,462,28,22,UCBPlayer
39629,UCBPlayer,116,126,242,3,87,UCBPlayer
39630,UCBPlayer,122,347,469,32,21,UCBPlayer
39631,UCBPlayer,107,132,239,0,87,UCBPlayer
39632,UCBPlayer,132,337,469,35,22,UCBPlayer
39633,UCBPlayer,103,148,251,0,83,UCBPlayer
39634,UCBPlayer,136,321,457,35,26,UCBPlayer
39635,UCBPlayer,99,164,263,0,79,UCBPlayer
39636,UCBPlayer,140,305,445,35,30,UCBPlayer
39637,UCBPlayer,95,180,275,0,75,UCBPlayer
39638,UCBPlayer,144,289,433,35,34,UCBPlayer
39639,UCBPlayer,91,196,287,0,71,UCBPlayer
39640,UCBPlayer,148,273,421,35,38,UCBPlayer
39641,UCBPlayer,87,212,299,0,67,UCBPlayer
39642,UCBPlayer,152,257,409,35,42,UCBPlayer
39643,UCBPlayer,84,224,308,0,64,UCBPlayer
39644,UCBPlayer,146,251,397,32,45,UCBPlayer
39645,UCBPlayer,89,234,323,3,60,UCBPlayer
39646,UCBPlayer,138,243,381,28,49,UCBPlayer
39647,UCBPlayer,97,242,339,7,56,UCBPlayer
39648,UCBPlayer,130,235,365,24,53,UCBPlayer
39649,UCBPlayer,105,250,355,11,52,UCBPlayer
39650,UCBPlayer,122,227,349,20,57,UCBPlayer
39651,UCBPlayer,109,259,368,15,49,UCBPlayer
39652,UCBPlayer,118,218,336,16,60,UCBPlayer
39653,UCBPlayer,117,267,384,19,45,UCBPlayer
39654,UCBPlayer,110,210,320,12,64,UCBPlayer
39655,UCBPlayer,126,271,397,23,42,UCBPlayer
39656,UCBPlayer,105,210,315,10,65,UCBPlayer
39657,UCBPlayer,130,275,405,25,40,UCBPlayer
39658,UCBPlayer,105,210,315,10,65,UCBPlayer
39659,UCBPlayer,130,275,405,25,40,UCBPlayer
39660,UCBPlayer,106,206,312,10,66,UCBPlayer
39661,UCBPlayer,130,275,405,25,40,UCBPlayer
39662,UCBPlayer,105,210,315,10,65,UCBPlayer
39663,UCBPlayer,131,271,402,25,41,UCBPlayer
39664,UCBPlayer,105,210,315,10,65,UCBPlayer
39665,UCBPlayer,130,275,405,25,40,UCBPlayer
39666,UCBPlayer,105,210,315,10,65,UCBPlayer
39667,UCBPlayer,130,275,405,25,40,UCBPlayer
39668,UCBPlayer,103,203,306,10,68,UCBPlayer
39669,UCBPlayer,128,283,411,25,38,UCBPlayer
39670,UCBPlayer,111,186,297,10,71,UCBPlayer
39671,UCBPlayer,124,299,423,25,34,UCBPlayer
39672,UCBPlayer,115,170,285,10,75,UCBPlayer
39673,UCBPlayer,120,315,435,25,30,UCBPlayer
39674,UCBPlayer,119,154,273,10,79,UCBPlayer
39675,UCBPlayer,112,332,444,25,27,UCBPlayer
39676,UCBPlayer,127,137,264,10,82,UCBPlayer
39677,UCBPlayer,104,349,453,25,24,UCBPlayer
39678,UCBPlayer,126,126,252,7,85,Tie
39679,UCBPlayer,111,351,462,28,22,UCBPlayer
39680,UCBPlayer,116,126,242,3,87,UCBPlayer
39681,UCBPlayer,122,347,469,32,21,UCBPlayer
39682,UCBPlayer,107,132,239,0,87,UCBPlayer
39683,UCBPlayer,132,337,469,35,22,UCBPlayer
39684,UCBPlayer,103,148,251,0,83,UCBPlayer
39685,UCBPlayer,136,321,457,35,26,UCBPlayer
39686,UCBPlayer,99,164,263,0,79,UCBPlayer
39687,UCBPlayer,140,305,445,35,30,UCBPlayer
39688,UCBPlayer,95,180,275,0,75,UCBPlayer
39689,UCBPlayer,144,289,433,35,34,UCBPlayer
39690,UCBPlayer,91,196,287,0,71,UCBPlayer
39691,UCBPlayer,148,273,421,35,38,UCBPlayer
39692,UCBPlayer,87,212,299,0,67,UCBPlayer
39693,UCBPlayer,152,257,409,35,42,UCBPlayer
39694,UCBPlayer,84,224,308,0,64,UCBPlayer
39695,UCBPlayer,146,251,397,32,45,UCBPlayer
39696,UCBPlayer,89,234,323,3,60,UCBPlayer
39697,UCBPlayer,138,243,381,28,49,UCBPlayer
39698,UCBPlayer,97,242,339,7,56,UCBPlayer
39699,UCBPlayer,130,235,365,24,53,UCBPlayer
39700,UCBPlayer,105,250,355,11,52,UCBPlayer
39701,UCBPlayer,122,227,349,20,57,UCBPlayer
39702,UCBPlayer,109,259,368,15,49,UCBPlayer
39703,UCBPlayer,118,218,336,16,60,UCBPlayer
39704,UCBPlayer,117,267,384,19,45,UCBPlayer
39705,UCBPlayer,110,210,320,12,64,UCBPlayer
39706,UCBPlayer,126,271,397,23,42,UCBPlayer
39707,UCBPlayer,105,210,315,10,65,UCBPlayer
39708,UCBPlayer,130,275,405,25,40,UCBPlayer
39709,UCBPlayer,105,210,315,10,65,UCBPlayer
39710,UCBPlayer,130,275,405,25,40,UCBPlayer
39711,UCBPlayer,106,206,312,10,66,UCBPlayer
39712,UCBPlayer,130,275,405,25,40,UCBPlayer
39713,UCBPlayer,105,210,315,10,65,UCBPlayer
39714,UCBPlayer,131,271,402,25,41,UCBPlayer
39715,UCBPlayer,105,210,315,10,65,UCBPlayer
39716,UCBPlayer,130,275,405,25,40,UCBPlayer
39717,UCBPlayer,105,210,315,10,65,UCBPlayer
39718,UCBPlayer,130,275,405,25,40,UCBPlayer
39719,UCBPlayer,103,203,306,10,68,UCBPlayer
39720,UCBPlayer,128,283,411,25,38,UCBPlayer
39721,UCBPlayer,111,186,297,10,71,UCBPlayer
39722,UCBPlayer,124,299,423,25,34,UCBPlayer
39723,UCBPlayer,115,170,285,10,75,UCBPlayer
39724,UCBPlayer,120,315,435,25,30,UCBPlayer
39725,UCBPlayer,119,154,273,10,79,UCBPlayer
39726,UCBPlayer,112,332,444,25,27,UCBPlayer
39727,UCBPlayer,127,137,264,10,82,UCBPlayer
39728,UCBPlayer,104,349,453,25,24,UCBPlayer
39729,UCBPlayer,126,126,252,7,85,Tie
39730,UCBPlayer,111,351,462,28,22,UCBPlayer
39731,UCBPlayer,116,126,242,3,87,UCBPlayer
39732,UCBPlayer,122,347,469,32,21,UCBPlayer
39733,UCBPlayer,107,132,239,0,87,UCBPlayer
39734,UCBPlayer,132,337,469,35,22,UCBPlayer
39735,UCBPlayer,103,148,251,0,83,UCBPlayer
39736,UCBPlayer,136,321,457,35,26,UCBPlayer
39737,UCBPlayer,99,164,263,0,79,UCBPlayer
39738,UCBPlayer,140,305,445,35,30,UCBPlayer
39739,UCBPlayer,95,180,275,0,75,UCBPlayer
39740,UCBPlayer,144,289,433,35,34,UCBPlayer
39741,UCBPlayer,91,196,287,0,71,UCBPlayer
39742,UCBPlayer,148,273,421,35,38,UCBPlayer
39743,UCBPlayer,87,212,299,0,67,UCBPlayer
39744,UCBPlayer,152,257,409,35,42,UCBPlayer
39745,UCBPlayer,84,224,308,0,64,UCBPlayer
39746,UCBPlayer,146,251,397,32,45,UCBPlayer
39747,UCBPlayer,89,234,323,3,60,UCBPlayer
39748,UCBPlayer,138,243,381,28,49,UCBPlayer
39749,UCBPlayer,97,242,339,7,56,UCBPlayer
39750,UCBPlayer,130,235,365,24,53,UCBPlayer
39751,UCBPlayer,105,250,355,11,52,UCBPlayer
39752,UCBPlayer,122,227,349,20,57,UCBPlayer
39753,UCBPlayer,109,259,368,15,49,UCBPlayer
39754,UCBPlayer,118,218,336,16,60,UCBPlayer
39755,UCBPlayer,117,267,384,19,45,UCBPlayer
39756,UCBPlayer,110,210,320,12,64,UCBPlayer
39757,UCBPlayer,126,271,397,23,42,UCBPlayer
39758,UCBPlayer,105,210,315,10,65,UCBPlayer
39759,UCBPlayer,130,275,405,25,40,UCBPlayer
39760,UCBPlayer,105,210,315,10,65,UCBPlayer
39761,UCBPlayer,130,275,405,25,40,UCBPlayer
39762,UCBPlayer,106,206,312,10,66,UCBPlayer
39763,UCBPlayer,130,275,405,25,40,UCBPlayer
39764,UCBPlayer,105,210,315,10,65,UCBPlayer
39765,UCBPlayer,131,271,402,25,41,UCBPlayer
39766,UCBPlayer,105,210,315,10,65,UCBPlayer
39767,UCBPlayer,130,275,405,25,40,UCBPlayer
39768,UCBPlayer,105,210,315,10,65,UCBPlayer
39769,UCBPlayer,130,275,405,25,40,UCBPlayer
39770,UCBPlayer,103,203,306,10,68,UCBPlayer
39771,UCBPlayer,128,283,411,25,38,UCBPlayer
39772,UCBPlayer,111,186,297,10,71,UCBPlayer
39773,UCBPlayer,124,299,423,25,34,UCBPlayer
39774,UCBPlayer,115,170,285,10,75,UCBPlayer
39775,UCBPlayer,120,315,435,25,30,UCBPlayer
39776,UCBPlayer,119,154,273,10,79,UCBPlayer
39777,UCBPlayer,112,332,444,25,27,UCBPlayer
39778,UCBPlayer,127,137,264,10,82,UCBPlayer
39779,UCBPlayer,104,349,453,25,24,UCBPlayer
39780,UCBPlayer,126,126,252,7,85,Tie
39781,UCBPlayer,111,351,462,28,22,UCBPlayer
39782,UCBPlayer,116,126,242,3,87,UCBPlayer
39783,UCBPlayer,122,347,469,32,21,UCBPlayer
39784,UCBPlayer,107,132,239,0,87,UCBPlayer
39785,UCBPlayer,132,337,469,35,22,UCBPlayer
39786,UCBPlayer,103,148,251,0,83,UCBPlayer
39787,UCBPlayer,136,321,457,35,26,UCBPlayer
39788,UCBPlayer,99,164,263,0,79,UCBPlayer
39789,UCBPlayer,140,305,445,35,30,UCBPlayer
39790,UCBPlayer,95,180,275,0,75,UCBPlayer
39791,UCBPlayer,144,289,433,35,34,UCBPlayer
39792,UCBPlayer,91,196,287,0,71,UCBPlayer
39793,UCBPlayer,148,273,421,35,38,UCBPlayer
39794,UCBPlayer,87,212,299,0,67,UCBPlayer
39795,UCBPlayer,152,257,409,35,42,UCBPlayer
39796,UCBPlayer,84,224,308,0,64,UCBPlayer
39797,UCBPlayer,146,251,397,32,45,UCBPlayer
39798,UCBPlayer,89,234,323,3,60,UCBPlayer
39799,UCBPlayer,138,243,381,28,49,UCBPlayer
39800,UCBPlayer,97,242,339,7,56,UCBPlayer
39801,UCBPlayer,130,235,365,24,53,UCBPlayer
39802,UCBPlayer,105,250,355,11,52,UCBPlayer
39803,UCBPlayer,122,227,349,20,57,UCBPlayer
39804,UCBPlayer,109,259,368,15,49,UCBPlayer
39805,UCBPlayer,118,218,336,16,60,UCBPlayer
39806,UCBPlayer,117,267,384,19,45,UCBPlayer
39807,UCBPlayer,110,210,320,12,64,UCBPlayer
39808,UCBPlayer,126,271,397,23,42,UCBPlayer
39809,UCBPlayer,105,210,315,10,65,UCBPlayer
39810,UCBPlayer,130,275,405,25,40,UCBPlayer
39811,UCBPlayer,105,210,315,10,65,UCBPlayer
39812,UCBPlayer,130,275,405,25,40,UCBPlayer
39813,UCBPlayer,106,206,312,10,66,UCBPlayer
39814,UCBPlayer,130,275,405,25,40,UCBPlayer
39815,UCBPlayer,105,210,315,10,65,UCBPlayer
39816,UCBPlayer,131,271,402,25,41,UCBPlayer
39817,UCBPlayer,105,210,315,10,65,UCBPlayer
39818,UCBPlayer,130,275,405,25,40,UCBPlayer
39819,UCBPlayer,105,210,315,10,65,UCBPlayer
39820,UCBPlayer,130,275,405,25,40,UCBPlayer
39821,UCBPlayer,103,203,306,10,68,UCBPlayer
39822,UCBPlayer,128,283,411,25,38,UCBPlayer
39823,UCBPlayer,111,186,297,10,71,UCBPlayer
39824,UCBPlayer,124,299,423,25,34,UCBPlayer
39825,UCBPlayer,115,170,285,10,75,UCBPlayer
39826,UCBPlayer,120,315,435,25,30,UCBPlayer
39827,UCBPlayer,119,154,273,10,79,UCBPlayer
39828,UCBPlayer,112,332,444,25,27,UCBPlayer
39829,UCBPlayer,127,137,264,10,82,UCBPlayer
39830,UCBPlayer,104,349,453,25,24,UCBPlayer
39831,UCBPlayer,126,126,252,7,85,Tie
39832,UCBPlayer,111,351,462,28,22,UCBPlayer
39833,UCBPlayer,116,126,242,3,87,UCBPlayer
39834,UCBPlayer,122,347,469,32,21,UCBPlayer
39835,UCBPlayer,107,132,239,0,87,UCBPlayer
39836,UCBPlayer,132,337,469,35,22,UCBPlayer
39837,UCBPlayer,103,148,251,0,83,UCBPlayer
39838,UCBPlayer,136,321,457,35,26,UCBPlayer
39839,UCBPlayer,99,164,263,0,79,UCBPlayer
39840,UCBPlayer,140,305,445,35,30,UCBPlayer
39841,UCBPlayer,95,180,275,0,75,UCBPlayer
39842,UCBPlayer,144,289,433,35,34,UCBPlayer
39843,UCBPlayer,91,196,287,0,71,UCBPlayer
39844,UCBPlayer,148,273,421,35,38,UCBPlayer
39845,UCBPlayer,87,212,299,0,67,UCBPlayer
39846,UCBPlayer,152,257,409,35,42,UCBPlayer
39847,UCBPlayer,84,224,308,0,64,UCBPlayer
39848,UCBPlayer,146,251,397,32,45,UCBPlayer
39849,UCBPlayer,89,234,323,3,60,UCBPlayer
39850,UCBPlayer,138,243,381,28,49,UCBPlayer
39851,UCBPlayer,97,242,339,7,56,UCBPlayer
39852,UCBPlayer,130,235,365,24,53,UCBPlayer
39853,UCBPlayer,105,250,355,11,52,UCBPlayer
39854,UCBPlayer,122,227,349,20,57,UCBPlayer
39855,UCBPlayer,109,259,368,15,49,UCBPlayer
39856,UCBPlayer,118,218,336,16,60,UCBPlayer
39857,UCBPlayer,117,267,384,19,45,UCBPlayer
39858,UCBPlayer,110,210,320,12,64,UCBPlayer
39859,UCBPlayer,126,271,397,23,42,UCBPlayer
39860,UCBPlayer,105,210,315,10,65,UCBPlayer
39861,UCBPlayer,130,275,405,25,40,UCBPlayer
39862,UCBPlayer,105,210,315,10,65,UCBPlayer
39863,UCBPlayer,130,275,405,25,40,UCBPlayer
39864,UCBPlayer,106,206,312,10,66,UCBPlayer
39865,UCBPlayer,130,275,405,25,40,UCBPlayer
39866,UCBPlayer,105,210,315,10,65,UCBPlayer
39867,UCBPlayer,131,271,402,25,41,UCBPlayer
39868,UCBPlayer,105,210,315,10,65,UCBPlayer
39869,UCBPlayer,130,275,405,25,40,UCBPlayer
39870,UCBPlayer,105,210,315,10,65,UCBPlayer
39871,UCBPlayer,130,275,405,25,40,UCBPlayer
39872,UCBPlayer,103,203,306,10,68,UCBPlayer
39873,UCBPlayer,128,283,411,25,38,UCBPlayer
39874,UCBPlayer,111,186,297,10,71,UCBPlayer
39875,UCBPlayer,124,299,423,25,34,UCBPlayer
39876,UCBPlayer,115,170,285,10,75,UCBPlayer
39877,UCBPlayer,120,315,435,25,30,UCBPlayer
39878,UCBPlayer,119,154,273,10,79,UCBPlayer
39879,UCBPlayer,112,332,444,25,27,UCBPlayer
39880,UCBPlayer,127,137,264,10,82,UCBPlayer
39881,UCBPlayer,104,349,453,25,24,UCBPlayer
39882,UCBPlayer,126,126,252,7,85,Tie
39883,UCBPlayer,111,351,462,28,22,UCBPlayer
39884,UCBPlayer,116,126,242,3,87,UCBPlayer
39885,UCBPlayer,122,347,469,32,21,UCBPlayer
39886,UCBPlayer,107,132,239,0,87,UCBPlayer
39887,UCBPlayer,132,337,469,35,22,UCBPlayer
39888,UCBPlayer,103,148,251,0,83,UCBPlayer
39889,UCBPlayer,136,321,457,35,26,UCBPlayer
39890,UCBPlayer,99,164,263,0,79,UCBPlayer
39891,UCBPlayer,140,305,445,35,30,UCBPlayer
39892,UCBPlayer,95,180,275,0,75,UCBPlayer
39893,UCBPlayer,144,289,433,35,34,UCBPlayer
39894,UCBPlayer,91,196,287,0,71,UCBPlayer
39895,UCBPlayer,148,273,421,35,38,UCBPlayer
39896,UCBPlayer,87,212,299,0,67,UCBPlayer
39897,UCBPlayer,152,257,409,35,42,UCBPlayer
39898,UCBPlayer,84,224,308,0,64,UCBPlayer
39899,UCBPlayer,146,251,397,32,45,UCBPlayer
39900,UCBPlayer,89,234,323,3,60,UCBPlayer
39901,UCBPlayer,138,243,381,28,49,UCBPlayer
39902,UCBPlayer,97,242,339,7,56,UCBPlayer
39903,UCBPlayer,130,235,365,24,53,UCBPlayer
39904,UCBPlayer,105,250,355,11,52,UCBPlayer
39905,UCBPlayer,122,227,349,20,57,UCBPlayer
39906,UCBPlayer,109,259,368,15,49,UCBPlayer
39907,UCBPlayer,118,218,336,16,60,UCBPlayer
39908,UCBPlayer,117,267,384,19,45,UCBPlayer
39909,UCBPlayer,110,210,320,12,64,UCBPlayer
39910,UCBPlayer,126,271,397,23,42,UCBPlayer
39911,UCBPlayer,105,210,315,10,65,UCBPlayer
39912,UCBPlayer,130,275,405,25,40,UCBPlayer
39913,UCBPlayer,105,210,315,10,65,UCBPlayer
39914,UCBPlayer,130,275,405,25,40,UCBPlayer
39915,UCBPlayer,106,206,312,10,66,UCBPlayer
39916,UCBPlayer,130,275,405,25,40,UCBPlayer
39917,UCBPlayer,105,210,315,10,65,UCBPlayer
39918,UCBPlayer,131,271,402,25,41,UCBPlayer
39919,UCBPlayer,105,210,315,10,65,UCBPlayer
39920,UCBPlayer,130,275,405,25,40,UCBPlayer
39921,UCBPlayer,105,210,315,10,65,UCBPlayer
39922,UCBPlayer,130,275,405,25,40,UCBPlayer
39923,UCBPlayer,103,203,306,10,68,UCBPlayer
39924,UCBPlayer,128,283,411,25,38,UCBPlayer
39925,UCBPlayer,111,186,297,10,71,UCBPlayer
39926,UCBPlayer,124,299,423,25,34,UCBPlayer
39927,UCBPlayer,115,170,285,10,75,UCBPlayer
39928,UCBPlayer,120,315,435,25,30,UCBPlayer
39929,UCBPlayer,119,154,273,10,79,UCBPlayer
39930,UCBPlayer,112,332,444,25,27,UCBPlayer
39931,UCBPlayer,127,137,264,10,82,UCBPlayer
39932,UCBPlayer,104,349,453,25,24,UCBPlayer
39933,UCBPlayer,126,126,252,7,85,Tie
39934,UCBPlayer,111,351,462,28,22,UCBPlayer
39935,UCBPlayer,116,126,242,3,87,UCBPlayer
39936,UCBPlayer,122,347,469,32,21,UCBPlayer
39937,UCBPlayer,107,132,239,0,87,UCBPlayer
39938,UCBPlayer,132,337,469,35,22,UCBPlayer
39939,UCBPlayer,103,148,251,0,83,UCBPlayer
39940,UCBPlayer,136,321,457,35,26,UCBPlayer
39941,UCBPlayer,99,164,263,0,79,UCBPlayer
39942,UCBPlayer,140,305,445,35,30,UCBPlayer
39943,UCBPlayer,95,180,275,0,75,UCBPlayer
39944,UCBPlayer,144,289,433,35,34,UCBPlayer
39945,UCBPlayer,91,196,287,0,71,UCBPlayer
39946,UCBPlayer,148,273,421,35,38,UCBPlayer
39947,UCBPlayer,87,212,299,0,67,UCBPlayer
39948,UCBPlayer,152,257,409,35,42,UCBPlayer
39949,UCBPlayer,84,224,308,0,64,UCBPlayer
39950,UCBPlayer,146,251,397,32,45,UCBPlayer
39951,UCBPlayer,89,234,323,3,60,UCBPlayer
39952,UCBPlayer,138,243,381,28,49,UCBPlayer
39953,UCBPlayer,97,242,339,7,56,UCBPlayer
39954,UCBPlayer,130,235,365,24,53,UCBPlayer
39955,UCBPlayer,105,250,355,11,52,UCBPlayer
39956,UCBPlayer,122,227,349,20,57,UCBPlayer
39957,UCBPlayer,109,259,368,15,49,UCBPlayer
39958,UCBPlayer,118,218,336,16,60,UCBPlayer
39959,UCBPlayer,117,267,384,19,45,UCBPlayer
39960,UCBPlayer,110,210,320,12,64,UCBPlayer
39961,UCBPlayer,126,271,397,23,42,UCBPlayer
39962,UCBPlayer,105,210,315,10,65,UCBPlayer
39963,UCBPlayer,130,275,405,25,40,UCBPlayer
39964,UCBPlayer,105,210,315,10,65,UCBPlayer
39965,UCBPlayer,130,275,405,25,40,UCBPlayer
39966,UCBPlayer,106,206,312,10,66,UCBPlayer
39967,UCBPlayer,130,275,405,25,40,UCBPlayer
39968,UCBPlayer,105,210,315,10,65,UCBPlayer
39969,UCBPlayer,131,271,402,25,41,UCBPlayer
39970,UCBPlayer,105,210,315,10,65,UCBPlayer
39971,UCBPlayer,130,275,405,25,40,UCBPlayer
39972,UCBPlayer,105,210,315,10,65,UCBPlayer
39973,UCBPlayer,130,275,405,25,40,UCBPlayer
39974,UCBPlayer,103,203,306,10,68,UCBPlayer
39975,UCBPlayer,128,283,411,25,38,UCBPlayer
39976,UCBPlayer,111,186,297,10,71,UCBPlayer
39977,UCBPlayer,124,299,423,25,34,UCBPlayer
39978,UCBPlayer,115,170,285,10,75,UCBPlayer
39979,UCBPlayer,120,315,435,25,30,UCBPlayer
39980,UCBPlayer,119,154,273,10,79,UCBPlayer
39981,UCBPlayer,112,332,444,25,27,UCBPlayer
39982,UCBPlayer,127,137,264,10,82,UCBPlayer
39983,UCBPlayer,104,349,453,25,24,UCBPlayer
39984,UCBPlayer,126,126,252,7,85,Tie
39985,UCBPlayer,111,351,462,28,22,UCBPlayer
39986,UCBPlayer,116,126,242,3,87,UCBPlayer
39987,UCBPlayer,122,347,469,32,21,UCBPlayer
39988,UCBPlayer,107,132,239,0,87,UCBPlayer
39989,UCBPlayer,132,337,469,35,22,UCBPlayer
39990,UCBPlayer,103,148,251,0,83,UCBPlayer
39991,UCBPlayer,136,321,457,35,26,UCBPlayer
39992,UCBPlayer,99,164,263,0,79,UCBPlayer
39993,UCBPlayer,140,305,445,35,30,UCBPlayer
39994,UCBPlayer,95,180,275,0,75,UCBPlayer
39995,UCBPlayer,144,289,433,35,34,UCBPlayer
39996,UCBPlayer,91,196,287,0,71,UCBPlayer
39997,UCBPlayer,148,273,421,35,38,UCBPlayer
39998,UCBPlayer,87,212,299,0,67,UCBPlayer
39999,UCBPlayer,152,257,409,35,42,UCBPlayer
40000,UCBPlayer,84,224,308,0,64,UCBPlayer
40001,UCBPlayer,146,251,397,32,45,UCBPlayer
40002,UCBPlayer,89,234,323,3,60,UCBPlayer
40003,UCBPlayer,138,243,381,28,49,UCBPlayer
40004,UCBPlayer,97,242,339,7,56,UCBPlayer
40005,UCBPlayer,130,235,365,24,53,UCBPlayer
40006,UCBPlayer,105,250,355,11,52,UCBPlayer
40007,UCBPlayer,122,227,349,20,57,UCBPlayer
40008,UCBPlayer,109,259,368,15,49,UCBPlayer
40009,UCBPlayer,118,218,336,16,60,UCBPlayer
40010,UCBPlayer,117,267,384,19,45,UCBPlayer
40011,UCBPlayer,110,210,320,12,64,UCBPlayer
40012,UCBPlayer,126,271,397,23,42,UCBPlayer
40013,UCBPlayer,105,210,315,10,65,UCBPlayer
40014,UCBPlayer,130,275,405,25,40,UCBPlayer
40015,UCBPlayer,105,210,315,10,65,UCBPlayer
40016,UCBPlayer,130,275,405,25,40,UCBPlayer
40017,UCBPlayer,106,206,312,10,66,UCBPlayer
40018,UCBPlayer,130,275,405,25,40,UCBPlayer
40019,UCBPlayer,105,210,315,10,65,UCBPlayer
40020,UCBPlayer,131,271,402,25,41,UCBPlayer
40021,UCBPlayer,105,210,315,10,65,UCBPlayer
40022,UCBPlayer,130,275,405,25,40,UCBPlayer
40023,UCBPlayer,105,210,315,10,65,UCBPlayer
40024,UCBPlayer,130,275,405,25,40,UCBPlayer
40025,UCBPlayer,103,203,306,10,68,UCBPlayer
40026,UCBPlayer,128,283,411,25,38,UCBPlayer
40027,UCBPlayer,111,186,297,10,71,UCBPlayer
40028,UCBPlayer,124,299,423,25,34,UCBPlayer
40029,UCBPlayer,115,170,285,10,75,UCBPlayer
40030,UCBPlayer,120,315,435,25,30,UCBPlayer
40031,UCBPlayer,119,154,273,10,79,UCBPlayer
40032,UCBPlayer,112,332,444,25,27,UCBPlayer
40033,UCBPlayer,127,137,264,10,82,UCBPlayer
40034,UCBPlayer,104,349,453,25,24,UCBPlayer
40035,UCBPlayer,126,126,252,7,85,Tie
40036,UCBPlayer,111,351,462,28,22,UCBPlayer
40037,UCBPlayer,116,126,242,3,87,UCBPlayer
40038,UCBPlayer,122,347,469,32,21,UCBPlayer
40039,UCBPlayer,107,132,239,0,87,UCBPlayer
40040,UCBPlayer,132,337,469,35,22,UCBPlayer
40041,UCBPlayer,103,148,251,0,83,UCBPlayer
40042,UCBPlayer,136,321,457,35,26,UCBPlayer
40043,UCBPlayer,99,164,263,0,79,UCBPlayer
40044,UCBPlayer,140,305,445,35,30,UCBPlayer
40045,UCBPlayer,95,180,275,0,75,UCBPlayer
40046,UCBPlayer,144,289,433,35,34,UCBPlayer
40047,UCBPlayer,91,196,287,0,71,UCBPlayer
40048,UCBPlayer,148,273,421,35,38,UCBPlayer
40049,UCBPlayer,87,212,299,0,67,UCBPlayer
40050,UCBPlayer,152,257,409,35,42,UCBPlayer
40051,UCBPlayer,84,224,308,0,64,UCBPlayer
40052,UCBPlayer,146,251,397,32,45,UCBPlayer
40053,UCBPlayer,89,234,323,3,60,UCBPlayer
40054,UCBPlayer,138,243,381,28,49,UCBPlayer
40055,UCBPlayer,97,242,339,7,56,UCBPlayer
40056,UCBPlayer,130,235,365,24,53,UCBPlayer
40057,UCBPlayer,105,250,355,11,52,UCBPlayer
40058,UCBPlayer,122,227,349,20,57,UCBPlayer
40059,UCBPlayer,109,259,368,15,49,UCBPlayer
40060,UCBPlayer,118,218,336,16,60,UCBPlayer
40061,UCBPlayer,117,267,384,19,45,UCBPlayer
40062,UCBPlayer,110,210,320,12,64,UCBPlayer
40063,UCBPlayer,126,271,397,23,42,UCBPlayer
40064,UCBPlayer,105,210,315,10,65,UCBPlayer
40065,UCBPlayer,130,275,405,25,40,UCBPlayer
40066,UCBPlayer,105,210,315,10,65,UCBPlayer
40067,UCBPlayer,130,275,405,25,40,UCBPlayer
40068,UCBPlayer,106,206,312,10,66,UCBPlayer
40069,UCBPlayer,130,275,405,25,40,UCBPlayer
40070,UCBPlayer,105,210,315,10,65,UCBPlayer
40071,UCBPlayer,131,271,402,25,41,UCBPlayer
40072,UCBPlayer,105,210,315,10,65,UCBPlayer
40073,UCBPlayer,130,275,405,25,40,UCBPlayer
40074,UCBPlayer,105,210,315,10,65,UCBPlayer
40075,UCBPlayer,130,275,405,25,40,UCBPlayer
40076,UCBPlayer,103,203,306,10,68,UCBPlayer
40077,UCBPlayer,128,283,411,25,38,UCBPlayer
40078,UCBPlayer,111,186,297,10,71,UCBPlayer
40079,UCBPlayer,124,299,423,25,34,UCBPlayer
40080,UCBPlayer,115,170,285,10,75,UCBPlayer
40081,UCBPlayer,120,315,435,25,30,UCBPlayer
40082,UCBPlayer,119,154,273,10,79,UCBPlayer
40083,UCBPlayer,112,332,444,25,27,UCBPlayer
40084,UCBPlayer,127,137,264,10,82,UCBPlayer
40085,UCBPlayer,104,349,453,25,24,UCBPlayer
40086,UCBPlayer,126,126,252,7,85,Tie
40087,UCBPlayer,111,351,462,28,22,UCBPlayer
40088,UCBPlayer,116,126,242,3,87,UCBPlayer
40089,UCBPlayer,122,347,469,32,21,UCBPlayer
40090,UCBPlayer,107,132,239,0,87,UCBPlayer
40091,UCBPlayer,132,337,469,35,22,UCBPlayer
40092,UCBPlayer,103,148,251,0,83,UCBPlayer
40093,UCBPlayer,136,321,457,35,26,UCBPlayer
40094,UCBPlayer,99,164,263,0,79,UCBPlayer
40095,UCBPlayer,140,305,445,35,30,UCBPlayer
40096,UCBPlayer,95,180,275,0,75,UCBPlayer
40097,UCBPlayer,144,289,433,35,34,UCBPlayer
40098,UCBPlayer,91,196,287,0,71,UCBPlayer
40099,UCBPlayer,148,273,421,35,38,UCBPlayer
40100,UCBPlayer,87,212,299,0,67,UCBPlayer
40101,UCBPlayer,152,257,409,35,42,UCBPlayer
40102,UCBPlayer,84,224,308,0,64,UCBPlayer
40103,UCBPlayer,146,251,397,32,45,UCBPlayer
40104,UCBPlayer,89,234,323,3,60,UCBPlayer
40105,UCBPlayer,138,243,381,28,49,UCBPlayer
40106,UCBPlayer,97,242,339,7,56,UCBPlayer
40107,UCBPlayer,130,235,365,24,53,UCBPlayer
40108,UCBPlayer,105,250,355,11,52,UCBPlayer
40109,UCBPlayer,122,227,349,20,57,UCBPlayer
40110,UCBPlayer,109,259,368,15,49,UCBPlayer
40111,UCBPlayer,118,218,336,16,60,UCBPlayer
40112,UCBPlayer,117,267,384,19,45,UCBPlayer
40113,UCBPlayer,110,210,320,12,64,UCBPlayer
40114,UCBPlayer,126,271,397,23,42,UCBPlayer
40115,UCBPlayer,105,210,315,10,65,UCBPlayer
40116,UCBPlayer,130,275,405,25,40,UCBPlayer
40117,UCBPlayer,105,210,315,10,65,UCBPlayer
40118,UCBPlayer,130,275,405,25,40,UCBPlayer
40119,UCBPlayer,106,206,312,10,66,UCBPlayer
40120,UCBPlayer,130,275,405,25,40,UCBPlayer
40121,UCBPlayer,105,210,315,10,65,UCBPlayer
40122,UCBPlayer,131,271,402,25,41,UCBPlayer
40123,UCBPlayer,105,210,315,10,65,UCBPlayer
40124,UCBPlayer,130,275,405,25,40,UCBPlayer
40125,UCBPlayer,105,210,315,10,65,UCBPlayer
40126,UCBPlayer,130,275,405,25,40,UCBPlayer
40127,UCBPlayer,103,203,306,10,68,UCBPlayer
40128,UCBPlayer,128,283,411,25,38,UCBPlayer
40129,UCBPlayer,111,186,297,10,71,UCBPlayer
40130,UCBPlayer,124,299,423,25,34,UCBPlayer
40131,UCBPlayer,115,170,285,10,75,UCBPlayer
40132,UCBPlayer,120,315,435,25,30,UCBPlayer
40133,UCBPlayer,119,154,273,10,79,UCBPlayer
40134,UCBPlayer,112,332,444,25,27,UCBPlayer
40135,UCBPlayer,127,137,264,10,82,UCBPlayer
40136,UCBPlayer,104,349,453,25,24,UCBPlayer
40137,UCBPlayer,126,126,252,7,85,Tie
40138,UCBPlayer,111,351,462,28,22,UCBPlayer
40139,UCBPlayer,116,126,242,3,87,UCBPlayer
40140,UCBPlayer,122,347,469,32,21,UCBPlayer
40141,UCBPlayer,107,132,239,0,87,UCBPlayer
40142,UCBPlayer,132,337,469,35,22,UCBPlayer
40143,UCBPlayer,103,148,251,0,83,UCBPlayer
40144,UCBPlayer,136,321,457,35,26,UCBPlayer
40145,UCBPlayer,99,164,263,0,79,UCBPlayer
40146,UCBPlayer,140,305,445,35,30,UCBPlayer
40147,UCBPlayer,95,180,275,0,75,UCBPlayer
40148,UCBPlayer,144,289,433,35,34,UCBPlayer
40149,UCBPlayer,91,196,287,0,71,UCBPlayer
40150,UCBPlayer,148,273,421,35,38,UCBPlayer
40151,UCBPlayer,87,212,299,0,67,UCBPlayer
40152,UCBPlayer,152,257,409,35,42,UCBPlayer
40153,UCBPlayer,84,224,308,0,64,UCBPlayer
40154,UCBPlayer,146,251,397,32,45,UCBPlayer
40155,UCBPlayer,89,234,323,3,60,UCBPlayer
40156,UCBPlayer,138,243,381,28,49,UCBPlayer
40157,UCBPlayer,97,242,339,7,56,UCBPlayer
40158,UCBPlayer,130,235,365,24,53,UCBPlayer
40159,UCBPlayer,105,250,355,11,52,UCBPlayer
40160,UCBPlayer,122,227,349,20,57,UCBPlayer
40161,UCBPlayer,109,259,368,15,49,UCBPlayer
40162,UCBPlayer,118,218,336,16,60,UCBPlayer
40163,UCBPlayer,117,267,384,19,45,UCBPlayer
40164,UCBPlayer,110,210,320,12,64,UCBPlayer
40165,UCBPlayer,126,271,397,23,42,UCBPlayer
40166,UCBPlayer,105,210,315,10,65,UCBPlayer
40167,UCBPlayer,130,275,405,25,40,UCBPlayer
40168,UCBPlayer,105,210,315,10,65,UCBPlayer
40169,UCBPlayer,130,275,405,25,40,UCBPlayer
40170,UCBPlayer,106,206,312,10,66,UCBPlayer
40171,UCBPlayer,130,275,405,25,40,UCBPlayer
40172,UCBPlayer,105,210,315,10,65,UCBPlayer
40173,UCBPlayer,131,271,402,25,41,UCBPlayer
40174,UCBPlayer,105,210,315,10,65,UCBPlayer
40175,UCBPlayer,130,275,405,25,40,UCBPlayer
40176,UCBPlayer,105,210,315,10,65,UCBPlayer
40177,UCBPlayer,130,275,405,25,40,UCBPlayer
40178,UCBPlayer,103,203,306,10,68,UCBPlayer
40179,UCBPlayer,128,283,411,25,38,UCBPlayer
40180,UCBPlayer,111,186,297,10,71,UCBPlayer
40181,UCBPlayer,124,299,423,25,34,UCBPlayer
40182,UCBPlayer,115,170,285,10,75,UCBPlayer
40183,UCBPlayer,120,315,435,25,30,UCBPlayer
40184,UCBPlayer,119,154,273,10,79,UCBPlayer
40185,UCBPlayer,112,332,444,25,27,UCBPlayer
40186,UCBPlayer,127,137,264,10,82,UCBPlayer
40187,UCBPlayer,104,349,453,25,24,UCBPlayer
40188,UCBPlayer,126,126,252,7,85,Tie
40189,UCBPlayer,111,351,462,28,22,UCBPlayer
40190,UCBPlayer,116,126,242,3,87,UCBPlayer
40191,UCBPlayer,122,347,469,32,21,UCBPlayer
40192,UCBPlayer,107,132,239,0,87,UCBPlayer
40193,UCBPlayer,132,337,469,35,22,UCBPlayer
40194,UCBPlayer,103,148,251,0,83,UCBPlayer
40195,UCBPlayer,136,321,457,35,26,UCBPlayer
40196,UCBPlayer,99,164,263,0,79,UCBPlayer
40197,UCBPlayer,140,305,445,35,30,UCBPlayer
40198,UCBPlayer,95,180,275,0,75,UCBPlayer
40199,UCBPlayer,144,289,433,35,34,UCBPlayer
40200,UCBPlayer,91,196,287,0,71,UCBPlayer
40201,UCBPlayer,148,273,421,35,38,UCBPlayer
40202,UCBPlayer,87,212,299,0,67,UCBPlayer
40203,UCBPlayer,152,257,409,35,42,UCBPlayer
40204,UCBPlayer,84,224,308,0,64,UCBPlayer
40205,UCBPlayer,146,251,397,32,45,UCBPlayer
40206,UCBPlayer,89,234,323,3,60,UCBPlayer
40207,UCBPlayer,138,243,381,28,49,UCBPlayer
40208,UCBPlayer,97,242,339,7,56,UCBPlayer
40209,UCBPlayer,130,235,365,24,53,UCBPlayer
40210,UCBPlayer,105,250,355,11,52,UCBPlayer
40211,UCBPlayer,122,227,349,20,57,UCBPlayer
40212,UCBPlayer,109,259,368,15,49,UCBPlayer
40213,UCBPlayer,118,218,336,16,60,UCBPlayer
40214,UCBPlayer,117,267,384,19,45,UCBPlayer
40215,UCBPlayer,110,210,320,12,64,UCBPlayer
40216,UCBPlayer,126,271,397,23,42,UCBPlayer
40217,UCBPlayer,105,210,315,10,65,UCBPlayer
40218,UCBPlayer,130,275,405,25,40,UCBPlayer
40219,UCBPlayer,105,210,315,10,65,UCBPlayer
40220,UCBPlayer,130,275,405,25,40,UCBPlayer
40221,UCBPlayer,106,206,312,10,66,UCBPlayer
40222,UCBPlayer,130,275,405,25,40,UCBPlayer
40223,UCBPlayer,105,210,315,10,65,UCBPlayer
40224,UCBPlayer,131,271,402,25,41,UCBPlayer
40225,UCBPlayer,105,210,315,10,65,UCBPlayer
40226,UCBPlayer,130,275,405,25,40,UCBPlayer
40227,UCBPlayer,105,210,315,10,65,UCBPlayer
40228,UCBPlayer,130,275,405,25,40,UCBPlayer
40229,UCBPlayer,103,203,306,10,68,UCBPlayer
40230,UCBPlayer,128,283,411,25,38,UCBPlayer
40231,UCBPlayer,111,186,297,10,71,UCBPlayer
40232,UCBPlayer,124,299,423,25,34,UCBPlayer
40233,UCBPlayer,115,170,285,10,75,UCBPlayer
40234,UCBPlayer,120,315,435,25,30,UCBPlayer
40235,UCBPlayer,119,154,273,10,79,UCBPlayer
40236,UCBPlayer,112,332,444,25,27,UCBPlayer
40237,UCBPlayer,127,137,264,10,82,UCBPlayer
40238,UCBPlayer,104,349,453,25,24,UCBPlayer
40239,UCBPlayer,126,126,252,7,85,Tie
40240,UCBPlayer,111,351,462,28,22,UCBPlayer
40241,UCBPlayer,116,126,242,3,87,UCBPlayer
40242,UCBPlayer,122,347,469,32,21,UCBPlayer
40243,UCBPlayer,107,132,239,0,87,UCBPlayer
40244,UCBPlayer,132,337,469,35,22,UCBPlayer
40245,UCBPlayer,103,148,251,0,83,UCBPlayer
40246,UCBPlayer,136,321,457,35,26,UCBPlayer
40247,UCBPlayer,99,164,263,0,79,UCBPlayer
40248,UCBPlayer,140,305,445,35,30,UCBPlayer
40249,UCBPlayer,95,180,275,0,75,UCBPlayer
40250,UCBPlayer,144,289,433,35,34,UCBPlayer
40251,UCBPlayer,91,196,287,0,71,UCBPlayer
40252,UCBPlayer,148,273,421,35,38,UCBPlayer
40253,UCBPlayer,87,212,299,0,67,UCBPlayer
40254,UCBPlayer,152,257,409,35,42,UCBPlayer
40255,UCBPlayer,84,224,308,0,64,UCBPlayer
40256,UCBPlayer,146,251,397,32,45,UCBPlayer
40257,UCBPlayer,89,234,323,3,60,UCBPlayer
40258,UCBPlayer,138,243,381,28,49,UCBPlayer
40259,UCBPlayer,97,242,339,7,56,UCBPlayer
40260,UCBPlayer,130,235,365,24,53,UCBPlayer
40261,UCBPlayer,105,250,355,11,52,UCBPlayer
40262,UCBPlayer,122,227,349,20,57,UCBPlayer
40263,UCBPlayer,109,259,368,15,49,UCBPlayer
40264,UCBPlayer,118,218,336,16,60,UCBPlayer
40265,UCBPlayer,117,267,384,19,45,UCBPlayer
40266,UCBPlayer,110,210,320,12,64,UCBPlayer
40267,UCBPlayer,126,271,397,23,42,UCBPlayer
40268,UCBPlayer,105,210,315,10,65,UCBPlayer
40269,UCBPlayer,130,275,405,25,40,UCBPlayer
40270,UCBPlayer,105,210,315,10,65,UCBPlayer
40271,UCBPlayer,130,275,405,25,40,UCBPlayer
40272,UCBPlayer,106,206,312,10,66,UCBPlayer
40273,UCBPlayer,130,275,405,25,40,UCBPlayer
40274,UCBPlayer,105,210,315,10,65,UCBPlayer
40275,UCBPlayer,131,271,402,25,41,UCBPlayer
40276,UCBPlayer,105,210,315,10,65,UCBPlayer
40277,UCBPlayer,130,275,405,25,40,UCBPlayer
40278,UCBPlayer,105,210,315,10,65,UCBPlayer
40279,UCBPlayer,130,275,405,25,40,UCBPlayer
40280,UCBPlayer,103,203,306,10,68,UCBPlayer
40281,UCBPlayer,128,283,411,25,38,UCBPlayer
40282,UCBPlayer,111,186,297,10,71,UCBPlayer
40283,UCBPlayer,124,299,423,25,34,UCBPlayer
40284,UCBPlayer,115,170,285,10,75,UCBPlayer
40285,UCBPlayer,120,315,435,25,30,UCBPlayer
40286,UCBPlayer,119,154,273,10,79,UCBPlayer
40287,UCBPlayer,112,332,444,25,27,UCBPlayer
40288,UCBPlayer,127,137,264,10,82,UCBPlayer
40289,UCBPlayer,104,349,453,25,24,UCBPlayer
40290,UCBPlayer,126,126,252,7,85,Tie
40291,UCBPlayer,111,351,462,28,22,UCBPlayer
40292,UCBPlayer,116,126,242,3,87,UCBPlayer
40293,UCBPlayer,122,347,469,32,21,UCBPlayer
40294,UCBPlayer,107,132,239,0,87,UCBPlayer
40295,UCBPlayer,132,337,469,35,22,UCBPlayer
40296,UCBPlayer,103,148,251,0,83,UCBPlayer
40297,UCBPlayer,136,321,457,35,26,UCBPlayer
40298,UCBPlayer,99,164,263,0,79,UCBPlayer
40299,UCBPlayer,140,305,445,35,30,UCBPlayer
40300,UCBPlayer,95,180,275,0,75,UCBPlayer
40301,UCBPlayer,144,289,433,35,34,UCBPlayer
40302,UCBPlayer,91,196,287,0,71,UCBPlayer
40303,UCBPlayer,148,273,421,35,38,UCBPlayer
40304,UCBPlayer,87,212,299,0,67,UCBPlayer
40305,UCBPlayer,152,257,409,35,42,UCBPlayer
40306,UCBPlayer,84,224,308,0,64,UCBPlayer
40307,UCBPlayer,146,251,397,32,45,UCBPlayer
40308,UCBPlayer,89,234,323,3,60,UCBPlayer
40309,UCBPlayer,138,243,381,28,49,UCBPlayer
40310,UCBPlayer,97,242,339,7,56,UCBPlayer
40311,UCBPlayer,130,235,365,24,53,UCBPlayer
40312,UCBPlayer,105,250,355,11,52,UCBPlayer
40313,UCBPlayer,122,227,349,20,57,UCBPlayer
40314,UCBPlayer,109,259,368,15,49,UCBPlayer
40315,UCBPlayer,118,218,336,16,60,UCBPlayer
40316,UCBPlayer,117,267,384,19,45,UCBPlayer
40317,UCBPlayer,110,210,320,12,64,UCBPlayer
40318,UCBPlayer,126,271,397,23,42,UCBPlayer
40319,UCBPlayer,105,210,315,10,65,UCBPlayer
40320,UCBPlayer,130,275,405,25,40,UCBPlayer
40321,UCBPlayer,105,210,315,10,65,UCBPlayer
40322,UCBPlayer,130,275,405,25,40,UCBPlayer
40323,UCBPlayer,106,206,312,10,66,UCBPlayer
40324,UCBPlayer,130,275,405,25,40,UCBPlayer
40325,UCBPlayer,105,210,315,10,65,UCBPlayer
40326,UCBPlayer,131,271,402,25,41,UCBPlayer
40327,UCBPlayer,105,210,315,10,65,UCBPlayer
40328,UCBPlayer,130,275,405,25,40,UCBPlayer
40329,UCBPlayer,105,210,315,10,65,UCBPlayer
40330,UCBPlayer,130,275,405,25,40,UCBPlayer
40331,UCBPlayer,103,203,306,10,68,UCBPlayer
40332,UCBPlayer,128,283,411,25,38,UCBPlayer
40333,UCBPlayer,111,186,297,10,71,UCBPlayer
40334,UCBPlayer,124,299,423,25,34,UCBPlayer
40335,UCBPlayer,115,170,285,10,75,UCBPlayer
40336,UCBPlayer,120,315,435,25,30,UCBPlayer
40337,UCBPlayer,119,154,273,10,79,UCBPlayer
40338,UCBPlayer,112,332,444,25,27,UCBPlayer
40339,UCBPlayer,127,137,264,10,82,UCBPlayer
40340,UCBPlayer,104,349,453,25,24,UCBPlayer
40341,UCBPlayer,126,126,252,7,85,Tie
40342,UCBPlayer,111,351,462,28,22,UCBPlayer
40343,UCBPlayer,116,126,242,3,87,UCBPlayer
40344,UCBPlayer,122,347,469,32,21,UCBPlayer
40345,UCBPlayer,107,132,239,0,87,UCBPlayer
40346,UCBPlayer,132,337,469,35,22,UCBPlayer
40347,UCBPlayer,103,148,251,0,83,UCBPlayer
40348,UCBPlayer,136,321,457,35,26,UCBPlayer
40349,UCBPlayer,99,164,263,0,79,UCBPlayer
40350,UCBPlayer,140,305,445,35,30,UCBPlayer
40351,UCBPlayer,95,180,275,0,75,UCBPlayer
40352,UCBPlayer,144,289,433,35,34,UCBPlayer
40353,UCBPlayer,91,196,287,0,71,UCBPlayer
40354,UCBPlayer,148,273,421,35,38,UCBPlayer
40355,UCBPlayer,87,212,299,0,67,UCBPlayer
40356,UCBPlayer,152,257,409,35,42,UCBPlayer
40357,UCBPlayer,84,224,308,0,64,UCBPlayer
40358,UCBPlayer,146,251,397,32,45,UCBPlayer
40359,UCBPlayer,89,234,323,3,60,UCBPlayer
40360,UCBPlayer,138,243,381,28,49,UCBPlayer
40361,UCBPlayer,97,242,339,7,56,UCBPlayer
40362,UCBPlayer,130,235,365,24,53,UCBPlayer
40363,UCBPlayer,105,250,355,11,52,UCBPlayer
40364,UCBPlayer,122,227,349,20,57,UCBPlayer
40365,UCBPlayer,109,259,368,15,49,UCBPlayer
40366,UCBPlayer,118,218,336,16,60,UCBPlayer
40367,UCBPlayer,117,267,384,19,45,UCBPlayer
40368,UCBPlayer,110,210,320,12,64,UCBPlayer
40369,UCBPlayer,126,271,397,23,42,UCBPlayer
40370,UCBPlayer,105,210,315,10,65,UCBPlayer
40371,UCBPlayer,130,275,405,25,40,UCBPlayer
40372,UCBPlayer,105,210,315,10,65,UCBPlayer
40373,UCBPlayer,130,275,405,25,40,UCBPlayer
40374,UCBPlayer,106,206,312,10,66,UCBPlayer
40375,UCBPlayer,130,275,405,25,40,UCBPlayer
40376,UCBPlayer,105,210,315,10,65,UCBPlayer
40377,UCBPlayer,131,271,402,25,41,UCBPlayer
40378,UCBPlayer,105,210,315,10,65,UCBPlayer
40379,UCBPlayer,130,275,405,25,40,UCBPlayer
40380,UCBPlayer,105,210,315,10,65,UCBPlayer
40381,UCBPlayer,130,275,405,25,40,UCBPlayer
40382,UCBPlayer,103,203,306,10,68,UCBPlayer
40383,UCBPlayer,128,283,411,25,38,UCBPlayer
40384,UCBPlayer,111,186,297,10,71,UCBPlayer
40385,UCBPlayer,124,299,423,25,34,UCBPlayer
40386,UCBPlayer,115,170,285,10,75,UCBPlayer
40387,UCBPlayer,120,315,435,25,30,UCBPlayer
40388,UCBPlayer,119,154,273,10,79,UCBPlayer
40389,UCBPlayer,112,332,444,25,27,UCBPlayer
40390,UCBPlayer,127,137,264,10,82,UCBPlayer
40391,UCBPlayer,104,349,453,25,24,UCBPlayer
40392,UCBPlayer,126,126,252,7,85,Tie
40393,UCBPlayer,111,351,462,28,22,UCBPlayer
40394,UCBPlayer,116,126,242,3,87,UCBPlayer
40395,UCBPlayer,122,347,469,32,21,UCBPlayer
40396,UCBPlayer,107,132,239,0,87,UCBPlayer
40397,UCBPlayer,132,337,469,35,22,UCBPlayer
40398,UCBPlayer,103,148,251,0,83,UCBPlayer
40399,UCBPlayer,136,321,457,35,26,UCBPlayer
40400,UCBPlayer,99,164,263,0,79,UCBPlayer
40401,UCBPlayer,140,305,445,35,30,UCBPlayer
40402,UCBPlayer,95,180,275,0,75,UCBPlayer
40403,UCBPlayer,144,289,433,35,34,UCBPlayer
40404,UCBPlayer,91,196,287,0,71,UCBPlayer
40405,UCBPlayer,148,273,421,35,38,UCBPlayer
40406,UCBPlayer,87,212,299,0,67,UCBPlayer
40407,UCBPlayer,152,257,409,35,42,UCBPlayer
40408,UCBPlayer,84,224,308,0,64,UCBPlayer
40409,UCBPlayer,146,251,397,32,45,UCBPlayer
40410,UCBPlayer,89,234,323,3,60,UCBPlayer
40411,UCBPlayer,138,243,381,28,49,UCBPlayer
40412,UCBPlayer,97,242,339,7,56,UCBPlayer
40413,UCBPlayer,130,235,365,24,53,UCBPlayer
40414,UCBPlayer,105,250,355,11,52,UCBPlayer
40415,UCBPlayer,122,227,349,20,57,UCBPlayer
40416,UCBPlayer,109,259,368,15,49,UCBPlayer
40417,UCBPlayer,118,218,336,16,60,UCBPlayer
40418,UCBPlayer,117,267,384,19,45,UCBPlayer
40419,UCBPlayer,110,210,320,12,64,UCBPlayer
40420,UCBPlayer,126,271,397,23,42,UCBPlayer
40421,UCBPlayer,105,210,315,10,65,UCBPlayer
40422,UCBPlayer,130,275,405,25,40,UCBPlayer
40423,UCBPlayer,105,210,315,10,65,UCBPlayer
40424,UCBPlayer,130,275,405,25,40,UCBPlayer
40425,UCBPlayer,106,206,312,10,66,UCBPlayer
40426,UCBPlayer,130,275,405,25,40,UCBPlayer
40427,UCBPlayer,105,210,315,10,65,UCBPlayer
40428,UCBPlayer,131,271,402,25,41,UCBPlayer
40429,UCBPlayer,105,210,315,10,65,UCBPlayer
40430,UCBPlayer,130,275,405,25,40,UCBPlayer
40431,UCBPlayer,105,210,315,10,65,UCBPlayer
40432,UCBPlayer,130,275,405,25,40,UCBPlayer
40433,UCBPlayer,103,203,306,10,68,UCBPlayer
40434,UCBPlayer,128,283,411,25,38,UCBPlayer
40435,UCBPlayer,111,186,297,10,71,UCBPlayer
40436,UCBPlayer,124,299,423,25,34,UCBPlayer
40437,UCBPlayer,115,170,285,10,75,UCBPlayer
40438,UCBPlayer,120,315,435,25,30,UCBPlayer
40439,UCBPlayer,119,154,273,10,79,UCBPlayer
40440,UCBPlayer,112,332,444,25,27,UCBPlayer
40441,UCBPlayer,127,137,264,10,82,UCBPlayer
40442,UCBPlayer,104,349,453,25,24,UCBPlayer
40443,UCBPlayer,126,126,252,7,85,Tie
40444,UCBPlayer,111,351,462,28,22,UCBPlayer
40445,UCBPlayer,116,126,242,3,87,UCBPlayer
40446,UCBPlayer,122,347,469,32,21,UCBPlayer
40447,UCBPlayer,107,132,239,0,87,UCBPlayer
40448,UCBPlayer,132,337,469,35,22,UCBPlayer
40449,UCBPlayer,103,148,251,0,83,UCBPlayer
40450,UCBPlayer,136,321,457,35,26,UCBPlayer
40451,UCBPlayer,99,164,263,0,79,UCBPlayer
40452,UCBPlayer,140,305,445,35,30,UCBPlayer
40453,UCBPlayer,95,180,275,0,75,UCBPlayer
40454,UCBPlayer,144,289,433,35,34,UCBPlayer
40455,UCBPlayer,91,196,287,0,71,UCBPlayer
40456,UCBPlayer,148,273,421,35,38,UCBPlayer
40457,UCBPlayer,87,212,299,0,67,UCBPlayer
40458,UCBPlayer,152,257,409,35,42,UCBPlayer
40459,UCBPlayer,84,224,308,0,64,UCBPlayer
40460,UCBPlayer,146,251,397,32,45,UCBPlayer
40461,UCBPlayer,89,234,323,3,60,UCBPlayer
40462,UCBPlayer,138,243,381,28,49,UCBPlayer
40463,UCBPlayer,97,242,339,7,56,UCBPlayer
40464,UCBPlayer,130,235,365,24,53,UCBPlayer
40465,UCBPlayer,105,250,355,11,52,UCBPlayer
40466,UCBPlayer,122,227,349,20,57,UCBPlayer
40467,UCBPlayer,109,259,368,15,49,UCBPlayer
40468,UCBPlayer,118,218,336,16,60,UCBPlayer
40469,UCBPlayer,117,267,384,19,45,UCBPlayer
40470,UCBPlayer,110,210,320,12,64,UCBPlayer
40471,UCBPlayer,126,271,397,23,42,UCBPlayer
40472,UCBPlayer,105,210,315,10,65,UCBPlayer
40473,UCBPlayer,130,275,405,25,40,UCBPlayer
40474,UCBPlayer,105,210,315,10,65,UCBPlayer
40475,UCBPlayer,130,275,405,25,40,UCBPlayer
40476,UCBPlayer,106,206,312,10,66,UCBPlayer
40477,UCBPlayer,130,275,405,25,40,UCBPlayer
40478,UCBPlayer,105,210,315,10,65,UCBPlayer
40479,UCBPlayer,131,271,402,25,41,UCBPlayer
40480,UCBPlayer,105,210,315,10,65,UCBPlayer
40481,UCBPlayer,130,275,405,25,40,UCBPlayer
40482,UCBPlayer,105,210,315,10,65,UCBPlayer
40483,UCBPlayer,130,275,405,25,40,UCBPlayer
40484,UCBPlayer,103,203,306,10,68,UCBPlayer
40485,UCBPlayer,128,283,411,25,38,UCBPlayer
40486,UCBPlayer,111,186,297,10,71,UCBPlayer
40487,UCBPlayer,124,299,423,25,34,UCBPlayer
40488,UCBPlayer,115,170,285,10,75,UCBPlayer
40489,UCBPlayer,120,315,435,25,30,UCBPlayer
40490,UCBPlayer,119,154,273,10,79,UCBPlayer
40491,UCBPlayer,112,332,444,25,27,UCBPlayer
40492,UCBPlayer,127,137,264,10,82,UCBPlayer
40493,UCBPlayer,104,349,453,25,24,UCBPlayer
40494,UCBPlayer,126,126,252,7,85,Tie
40495,UCBPlayer,111,351,462,28,22,UCBPlayer
40496,UCBPlayer,116,126,242,3,87,UCBPlayer
40497,UCBPlayer,122,347,469,32,21,UCBPlayer
40498,UCBPlayer,107,132,239,0,87,UCBPlayer
40499,UCBPlayer,132,337,469,35,22,UCBPlayer
40500,UCBPlayer,103,148,251,0,83,UCBPlayer
40501,UCBPlayer,136,321,457,35,26,UCBPlayer
40502,UCBPlayer,99,164,263,0,79,UCBPlayer
40503,UCBPlayer,140,305,445,35,30,UCBPlayer
40504,UCBPlayer,95,180,275,0,75,UCBPlayer
40505,UCBPlayer,144,289,433,35,34,UCBPlayer
40506,UCBPlayer,91,196,287,0,71,UCBPlayer
40507,UCBPlayer,148,273,421,35,38,UCBPlayer
40508,UCBPlayer,87,212,299,0,67,UCBPlayer
40509,UCBPlayer,152,257,409,35,42,UCBPlayer
40510,UCBPlayer,84,224,308,0,64,UCBPlayer
40511,UCBPlayer,146,251,397,32,45,UCBPlayer
40512,UCBPlayer,89,234,323,3,60,UCBPlayer
40513,UCBPlayer,138,243,381,28,49,UCBPlayer
40514,UCBPlayer,97,242,339,7,56,UCBPlayer
40515,UCBPlayer,130,235,365,24,53,UCBPlayer
40516,UCBPlayer,105,250,355,11,52,UCBPlayer
40517,UCBPlayer,122,227,349,20,57,UCBPlayer
40518,UCBPlayer,109,259,368,15,49,UCBPlayer
40519,UCBPlayer,118,218,336,16,60,UCBPlayer
40520,UCBPlayer,117,267,384,19,45,UCBPlayer
40521,UCBPlayer,110,210,320,12,64,UCBPlayer
40522,UCBPlayer,126,271,397,23,42,UCBPlayer
40523,UCBPlayer,105,210,315,10,65,UCBPlayer
40524,UCBPlayer,130,275,405,25,40,UCBPlayer
40525,UCBPlayer,105,210,315,10,65,UCBPlayer
40526,UCBPlayer,130,275,405,25,40,UCBPlayer
40527,UCBPlayer,106,206,312,10,66,UCBPlayer
40528,UCBPlayer,130,275,405,25,40,UCBPlayer
40529,UCBPlayer,105,210,315,10,65,UCBPlayer
40530,UCBPlayer,131,271,402,25,41,UCBPlayer
40531,UCBPlayer,105,210,315,10,65,UCBPlayer
40532,UCBPlayer,130,275,405,25,40,UCBPlayer
40533,UCBPlayer,105,210,315,10,65,UCBPlayer
40534,UCBPlayer,130,275,405,25,40,UCBPlayer
40535,UCBPlayer,103,203,306,10,68,UCBPlayer
40536,UCBPlayer,128,283,411,25,38,UCBPlayer
40537,UCBPlayer,111,186,297,10,71,UCBPlayer
40538,UCBPlayer,124,299,423,25,34,UCBPlayer
40539,UCBPlayer,115,170,285,10,75,UCBPlayer
40540,UCBPlayer,120,315,435,25,30,UCBPlayer
40541,UCBPlayer,119,154,273,10,79,UCBPlayer
40542,UCBPlayer,112,332,444,25,27,UCBPlayer
40543,UCBPlayer,127,137,264,10,82,UCBPlayer
40544,UCBPlayer,104,349,453,25,24,UCBPlayer
40545,UCBPlayer,126,126,252,7,85,Tie
40546,UCBPlayer,111,351,462,28,22,UCBPlayer
40547,UCBPlayer,116,126,242,3,87,UCBPlayer
40548,UCBPlayer,122,347,469,32,21,UCBPlayer
40549,UCBPlayer,107,132,239,0,87,UCBPlayer
40550,UCBPlayer,132,337,469,35,22,UCBPlayer
40551,UCBPlayer,103,148,251,0,83,UCBPlayer
40552,UCBPlayer,136,321,457,35,26,UCBPlayer
40553,UCBPlayer,99,164,263,0,79,UCBPlayer
40554,UCBPlayer,140,305,445,35,30,UCBPlayer
40555,UCBPlayer,95,180,275,0,75,UCBPlayer
40556,UCBPlayer,144,289,433,35,34,UCBPlayer
40557,UCBPlayer,91,196,287,0,71,UCBPlayer
40558,UCBPlayer,148,273,421,35,38,UCBPlayer
40559,UCBPlayer,87,212,299,0,67,UCBPlayer
40560,UCBPlayer,152,257,409,35,42,UCBPlayer
40561,UCBPlayer,84,224,308,0,64,UCBPlayer
40562,UCBPlayer,146,251,397,32,45,UCBPlayer
40563,UCBPlayer,89,234,323,3,60,UCBPlayer
40564,UCBPlayer,138,243,381,28,49,UCBPlayer
40565,UCBPlayer,97,242,339,7,56,UCBPlayer
40566,UCBPlayer,130,235,365,24,53,UCBPlayer
40567,UCBPlayer,105,250,355,11,52,UCBPlayer
40568,UCBPlayer,122,227,349,20,57,UCBPlayer
40569,UCBPlayer,109,259,368,15,49,UCBPlayer
40570,UCBPlayer,118,218,336,16,60,UCBPlayer
40571,UCBPlayer,117,267,384,19,45,UCBPlayer
40572,UCBPlayer,110,210,320,12,64,UCBPlayer
40573,UCBPlayer,126,271,397,23,42,UCBPlayer
40574,UCBPlayer,105,210,315,10,65,UCBPlayer
40575,UCBPlayer,130,275,405,25,40,UCBPlayer
40576,UCBPlayer,105,210,315,10,65,UCBPlayer
40577,UCBPlayer,130,275,405,25,40,UCBPlayer
40578,UCBPlayer,106,206,312,10,66,UCBPlayer
40579,UCBPlayer,130,275,405,25,40,UCBPlayer
40580,UCBPlayer,105,210,315,10,65,UCBPlayer
40581,UCBPlayer,131,271,402,25,41,UCBPlayer
40582,UCBPlayer,105,210,315,10,65,UCBPlayer
40583,UCBPlayer,130,275,405,25,40,UCBPlayer
40584,UCBPlayer,105,210,315,10,65,UCBPlayer
40585,UCBPlayer,130,275,405,25,40,UCBPlayer
40586,UCBPlayer,103,203,306,10,68,UCBPlayer
40587,UCBPlayer,128,283,411,25,38,UCBPlayer
40588,UCBPlayer,111,186,297,10,71,UCBPlayer
40589,UCBPlayer,124,299,423,25,34,UCBPlayer
40590,UCBPlayer,115,170,285,10,75,UCBPlayer
40591,UCBPlayer,120,315,435,25,30,UCBPlayer
40592,UCBPlayer,119,154,273,10,79,UCBPlayer
40593,UCBPlayer,112,332,444,25,27,UCBPlayer
40594,UCBPlayer,127,137,264,10,82,UCBPlayer
40595,UCBPlayer,104,349,453,25,24,UCBPlayer
40596,UCBPlayer,126,126,252,7,85,Tie
40597,UCBPlayer,111,351,462,28,22,UCBPlayer
40598,UCBPlayer,116,126,242,3,87,UCBPlayer
40599,UCBPlayer,122,347,469,32,21,UCBPlayer
40600,UCBPlayer,107,132,239,0,87,UCBPlayer
40601,UCBPlayer,132,337,469,35,22,UCBPlayer
40602,UCBPlayer,103,148,251,0,83,UCBPlayer
40603,UCBPlayer,136,321,457,35,26,UCBPlayer
40604,UCBPlayer,99,164,263,0,79,UCBPlayer
40605,UCBPlayer,140,305,445,35,30,UCBPlayer
40606,UCBPlayer,95,180,275,0,75,UCBPlayer
40607,UCBPlayer,144,289,433,35,34,UCBPlayer
40608,UCBPlayer,91,196,287,0,71,UCBPlayer
40609,UCBPlayer,148,273,421,35,38,UCBPlayer
40610,UCBPlayer,87,212,299,0,67,UCBPlayer
40611,UCBPlayer,152,257,409,35,42,UCBPlayer
40612,UCBPlayer,84,224,308,0,64,UCBPlayer
40613,UCBPlayer,146,251,397,32,45,UCBPlayer
40614,UCBPlayer,89,234,323,3,60,UCBPlayer
40615,UCBPlayer,138,243,381,28,49,UCBPlayer
40616,UCBPlayer,97,242,339,7,56,UCBPlayer
40617,UCBPlayer,130,235,365,24,53,UCBPlayer
40618,UCBPlayer,105,250,355,11,52,UCBPlayer
40619,UCBPlayer,122,227,349,20,57,UCBPlayer
40620,UCBPlayer,109,259,368,15,49,UCBPlayer
40621,UCBPlayer,118,218,336,16,60,UCBPlayer
40622,UCBPlayer,117,267,384,19,45,UCBPlayer
40623,UCBPlayer,110,210,320,12,64,UCBPlayer
40624,UCBPlayer,126,271,397,23,42,UCBPlayer
40625,UCBPlayer,105,210,315,10,65,UCBPlayer
40626,UCBPlayer,130,275,405,25,40,UCBPlayer
40627,UCBPlayer,105,210,315,10,65,UCBPlayer
40628,UCBPlayer,130,275,405,25,40,UCBPlayer
40629,UCBPlayer,106,206,312,10,66,UCBPlayer
40630,UCBPlayer,130,275,405,25,40,UCBPlayer
40631,UCBPlayer,105,210,315,10,65,UCBPlayer
40632,UCBPlayer,131,271,402,25,41,UCBPlayer
40633,UCBPlayer,105,210,315,10,65,UCBPlayer
40634,UCBPlayer,130,275,405,25,40,UCBPlayer
40635,UCBPlayer,105,210,315,10,65,UCBPlayer
40636,UCBPlayer,130,275,405,25,40,UCBPlayer
40637,UCBPlayer,103,203,306,10,68,UCBPlayer
40638,UCBPlayer,128,283,411,25,38,UCBPlayer
40639,UCBPlayer,111,186,297,10,71,UCBPlayer
40640,UCBPlayer,124,299,423,25,34,UCBPlayer
40641,UCBPlayer,115,170,285,10,75,UCBPlayer
40642,UCBPlayer,120,315,435,25,30,UCBPlayer
40643,UCBPlayer,119,154,273,10,79,UCBPlayer
40644,UCBPlayer,112,332,444,25,27,UCBPlayer
40645,UCBPlayer,127,137,264,10,82,UCBPlayer
40646,UCBPlayer,104,349,453,25,24,UCBPlayer
40647,UCBPlayer,126,126,252,7,85,Tie
40648,UCBPlayer,111,351,462,28,22,UCBPlayer
40649,UCBPlayer,116,126,242,3,87,UCBPlayer
40650,UCBPlayer,122,347,469,32,21,UCBPlayer
40651,UCBPlayer,107,132,239,0,87,UCBPlayer
40652,UCBPlayer,132,337,469,35,22,UCBPlayer
40653,UCBPlayer,103,148,251,0,83,UCBPlayer
40654,UCBPlayer,136,321,457,35,26,UCBPlayer
40655,UCBPlayer,99,164,263,0,79,UCBPlayer
40656,UCBPlayer,140,305,445,35,30,UCBPlayer
40657,UCBPlayer,95,180,275,0,75,UCBPlayer
40658,UCBPlayer,144,289,433,35,34,UCBPlayer
40659,UCBPlayer,91,196,287,0,71,UCBPlayer
40660,UCBPlayer,148,273,421,35,38,UCBPlayer
40661,UCBPlayer,87,212,299,0,67,UCBPlayer
40662,UCBPlayer,152,257,409,35,42,UCBPlayer
40663,UCBPlayer,84,224,308,0,64,UCBPlayer
40664,UCBPlayer,146,251,397,32,45,UCBPlayer
40665,UCBPlayer,89,234,323,3,60,UCBPlayer
40666,UCBPlayer,138,243,381,28,49,UCBPlayer
40667,UCBPlayer,97,242,339,7,56,UCBPlayer
40668,UCBPlayer,130,235,365,24,53,UCBPlayer
40669,UCBPlayer,105,250,355,11,52,UCBPlayer
40670,UCBPlayer,122,227,349,20,57,UCBPlayer
40671,UCBPlayer,109,259,368,15,49,UCBPlayer
40672,UCBPlayer,118,218,336,16,60,UCBPlayer
40673,UCBPlayer,117,267,384,19,45,UCBPlayer
40674,UCBPlayer,110,210,320,12,64,UCBPlayer
40675,UCBPlayer,126,271,397,23,42,UCBPlayer
40676,UCBPlayer,105,210,315,10,65,UCBPlayer
40677,UCBPlayer,130,275,405,25,40,UCBPlayer
40678,UCBPlayer,105,210,315,10,65,UCBPlayer
40679,UCBPlayer,130,275,405,25,40,UCBPlayer
40680,UCBPlayer,106,206,312,10,66,UCBPlayer
40681,UCBPlayer,130,275,405,25,40,UCBPlayer
40682,UCBPlayer,105,210,315,10,65,UCBPlayer
40683,UCBPlayer,131,271,402,25,41,UCBPlayer
40684,UCBPlayer,105,210,315,10,65,UCBPlayer
40685,UCBPlayer,130,275,405,25,40,UCBPlayer
40686,UCBPlayer,105,210,315,10,65,UCBPlayer
40687,UCBPlayer,130,275,405,25,40,UCBPlayer
40688,UCBPlayer,103,203,306,10,68,UCBPlayer
40689,UCBPlayer,128,283,411,25,38,UCBPlayer
40690,UCBPlayer,111,186,297,10,71,UCBPlayer
40691,UCBPlayer,124,299,423,25,34,UCBPlayer
40692,UCBPlayer,115,170,285,10,75,UCBPlayer
40693,UCBPlayer,120,315,435,25,30,UCBPlayer
40694,UCBPlayer,119,154,273,10,79,UCBPlayer
40695,UCBPlayer,112,332,444,25,27,UCBPlayer
40696,UCBPlayer,127,137,264,10,82,UCBPlayer
40697,UCBPlayer,104,349,453,25,24,UCBPlayer
40698,UCBPlayer,126,126,252,7,85,Tie
40699,UCBPlayer,111,351,462,28,22,UCBPlayer
40700,UCBPlayer,116,126,242,3,87,UCBPlayer
40701,UCBPlayer,122,347,469,32,21,UCBPlayer
40702,UCBPlayer,107,132,239,0,87,UCBPlayer
40703,UCBPlayer,132,337,469,35,22,UCBPlayer
40704,UCBPlayer,103,148,251,0,83,UCBPlayer
40705,UCBPlayer,136,321,457,35,26,UCBPlayer
40706,UCBPlayer,99,164,263,0,79,UCBPlayer
40707,UCBPlayer,140,305,445,35,30,UCBPlayer
40708,UCBPlayer,95,180,275,0,75,UCBPlayer
40709,UCBPlayer,144,289,433,35,34,UCBPlayer
40710,UCBPlayer,91,196,287,0,71,UCBPlayer
40711,UCBPlayer,148,273,421,35,38,UCBPlayer
40712,UCBPlayer,87,212,299,0,67,UCBPlayer
40713,UCBPlayer,152,257,409,35,42,UCBPlayer
40714,UCBPlayer,84,224,308,0,64,UCBPlayer
40715,UCBPlayer,146,251,397,32,45,UCBPlayer
40716,UCBPlayer,89,234,323,3,60,UCBPlayer
40717,UCBPlayer,138,243,381,28,49,UCBPlayer
40718,UCBPlayer,97,242,339,7,56,UCBPlayer
40719,UCBPlayer,130,235,365,24,53,UCBPlayer
40720,UCBPlayer,105,250,355,11,52,UCBPlayer
40721,UCBPlayer,122,227,349,20,57,UCBPlayer
40722,UCBPlayer,109,259,368,15,49,UCBPlayer
40723,UCBPlayer,118,218,336,16,60,UCBPlayer
40724,UCBPlayer,117,267,384,19,45,UCBPlayer
40725,UCBPlayer,110,210,320,12,64,UCBPlayer
40726,UCBPlayer,126,271,397,23,42,UCBPlayer
40727,UCBPlayer,105,210,315,10,65,UCBPlayer
40728,UCBPlayer,130,275,405,25,40,UCBPlayer
40729,UCBPlayer,105,210,315,10,65,UCBPlayer
40730,UCBPlayer,130,275,405,25,40,UCBPlayer
40731,UCBPlayer,106,206,312,10,66,UCBPlayer
40732,UCBPlayer,130,275,405,25,40,UCBPlayer
40733,UCBPlayer,105,210,315,10,65,UCBPlayer
40734,UCBPlayer,131,271,402,25,41,UCBPlayer
40735,UCBPlayer,105,210,315,10,65,UCBPlayer
40736,UCBPlayer,130,275,405,25,40,UCBPlayer
40737,UCBPlayer,105,210,315,10,65,UCBPlayer
40738,UCBPlayer,130,275,405,25,40,UCBPlayer
40739,UCBPlayer,103,203,306,10,68,UCBPlayer
40740,UCBPlayer,128,283,411,25,38,UCBPlayer
40741,UCBPlayer,111,186,297,10,71,UCBPlayer
40742,UCBPlayer,124,299,423,25,34,UCBPlayer
40743,UCBPlayer,115,170,285,10,75,UCBPlayer
40744,UCBPlayer,120,315,435,25,30,UCBPlayer
40745,UCBPlayer,119,154,273,10,79,UCBPlayer
40746,UCBPlayer,112,332,444,25,27,UCBPlayer
40747,UCBPlayer,127,137,264,10,82,UCBPlayer
40748,UCBPlayer,104,349,453,25,24,UCBPlayer
40749,UCBPlayer,126,126,252,7,85,Tie
40750,UCBPlayer,111,351,462,28,22,UCBPlayer
40751,UCBPlayer,116,126,242,3,87,UCBPlayer
40752,UCBPlayer,122,347,469,32,21,UCBPlayer
40753,UCBPlayer,107,132,239,0,87,UCBPlayer
40754,UCBPlayer,132,337,469,35,22,UCBPlayer
40755,UCBPlayer,103,148,251,0,83,UCBPlayer
40756,UCBPlayer,136,321,457,35,26,UCBPlayer
40757,UCBPlayer,99,164,263,0,79,UCBPlayer
40758,UCBPlayer,140,305,445,35,30,UCBPlayer
40759,UCBPlayer,95,180,275,0,75,UCBPlayer
40760,UCBPlayer,144,289,433,35,34,UCBPlayer
40761,UCBPlayer,91,196,287,0,71,UCBPlayer
40762,UCBPlayer,148,273,421,35,38,UCBPlayer
40763,UCBPlayer,87,212,299,0,67,UCBPlayer
40764,UCBPlayer,152,257,409,35,42,UCBPlayer
40765,UCBPlayer,84,224,308,0,64,UCBPlayer
40766,UCBPlayer,146,251,397,32,45,UCBPlayer
40767,UCBPlayer,89,234,323,3,60,UCBPlayer
40768,UCBPlayer,138,243,381,28,49,UCBPlayer
40769,UCBPlayer,97,242,339,7,56,UCBPlayer
40770,UCBPlayer,130,235,365,24,53,UCBPlayer
40771,UCBPlayer,105,250,355,11,52,UCBPlayer
40772,UCBPlayer,122,227,349,20,57,UCBPlayer
40773,UCBPlayer,109,259,368,15,49,UCBPlayer
40774,UCBPlayer,118,218,336,16,60,UCBPlayer
40775,UCBPlayer,117,267,384,19,45,UCBPlayer
40776,UCBPlayer,110,210,320,12,64,UCBPlayer
40777,UCBPlayer,126,271,397,23,42,UCBPlayer
40778,UCBPlayer,105,210,315,10,65,UCBPlayer
40779,UCBPlayer,130,275,405,25,40,UCBPlayer
40780,UCBPlayer,105,210,315,10,65,UCBPlayer
40781,UCBPlayer,130,275,405,25,40,UCBPlayer
40782,UCBPlayer,106,206,312,10,66,UCBPlayer
40783,UCBPlayer,130,275,405,25,40,UCBPlayer
40784,UCBPlayer,105,210,315,10,65,UCBPlayer
40785,UCBPlayer,131,271,402,25,41,UCBPlayer
40786,UCBPlayer,105,210,315,10,65,UCBPlayer
40787,UCBPlayer,130,275,405,25,40,UCBPlayer
40788,UCBPlayer,105,210,315,10,65,UCBPlayer
40789,UCBPlayer,130,275,405,25,40,UCBPlayer
40790,UCBPlayer,103,203,306,10,68,UCBPlayer
40791,UCBPlayer,128,283,411,25,38,UCBPlayer
40792,UCBPlayer,111,186,297,10,71,UCBPlayer
40793,UCBPlayer,124,299,423,25,34,UCBPlayer
40794,UCBPlayer,115,170,285,10,75,UCBPlayer
40795,UCBPlayer,120,315,435,25,30,UCBPlayer
40796,UCBPlayer,119,154,273,10,79,UCBPlayer
40797,UCBPlayer,112,332,444,25,27,UCBPlayer
40798,UCBPlayer,127,137,264,10,82,UCBPlayer
40799,UCBPlayer,104,349,453,25,24,UCBPlayer
40800,UCBPlayer,126,126,252,7,85,Tie
40801,UCBPlayer,111,351,462,28,22,UCBPlayer
40802,UCBPlayer,116,126,242,3,87,UCBPlayer
40803,UCBPlayer,122,347,469,32,21,UCBPlayer
40804,UCBPlayer,107,132,239,0,87,UCBPlayer
40805,UCBPlayer,132,337,469,35,22,UCBPlayer
40806,UCBPlayer,103,148,251,0,83,UCBPlayer
40807,UCBPlayer,136,321,457,35,26,UCBPlayer
40808,UCBPlayer,99,164,263,0,79,UCBPlayer
40809,UCBPlayer,140,305,445,35,30,UCBPlayer
40810,UCBPlayer,95,180,275,0,75,UCBPlayer
40811,UCBPlayer,144,289,433,35,34,UCBPlayer
40812,UCBPlayer,91,196,287,0,71,UCBPlayer
40813,UCBPlayer,148,273,421,35,38,UCBPlayer
40814,UCBPlayer,87,212,299,0,67,UCBPlayer
40815,UCBPlayer,152,257,409,35,42,UCBPlayer
40816,UCBPlayer,84,224,308,0,64,UCBPlayer
40817,UCBPlayer,146,251,397,32,45,UCBPlayer
40818,UCBPlayer,89,234,323,3,60,UCBPlayer
40819,UCBPlayer,138,243,381,28,49,UCBPlayer
40820,UCBPlayer,97,242,339,7,56,UCBPlayer
40821,UCBPlayer,130,235,365,24,53,UCBPlayer
40822,UCBPlayer,105,250,355,11,52,UCBPlayer
40823,UCBPlayer,122,227,349,20,57,UCBPlayer
40824,UCBPlayer,109,259,368,15,49,UCBPlayer
40825,UCBPlayer,118,218,336,16,60,UCBPlayer
40826,UCBPlayer,117,267,384,19,45,UCBPlayer
40827,UCBPlayer,110,210,320,12,64,UCBPlayer
40828,UCBPlayer,126,271,397,23,42,UCBPlayer
40829,UCBPlayer,105,210,315,10,65,UCBPlayer
40830,UCBPlayer,130,275,405,25,40,UCBPlayer
40831,UCBPlayer,105,210,315,10,65,UCBPlayer
40832,UCBPlayer,130,275,405,25,40,UCBPlayer
40833,UCBPlayer,106,206,312,10,66,UCBPlayer
40834,UCBPlayer,130,275,405,25,40,UCBPlayer
40835,UCBPlayer,105,210,315,10,65,UCBPlayer
40836,UCBPlayer,131,271,402,25,41,UCBPlayer
40837,UCBPlayer,105,210,315,10,65,UCBPlayer
40838,UCBPlayer,130,275,405,25,40,UCBPlayer
40839,UCBPlayer,105,210,315,10,65,UCBPlayer
40840,UCBPlayer,130,275,405,25,40,UCBPlayer
40841,UCBPlayer,103,203,306,10,68,UCBPlayer
40842,UCBPlayer,128,283,411,25,38,UCBPlayer
40843,UCBPlayer,111,186,297,10,71,UCBPlayer
40844,UCBPlayer,124,299,423,25,34,UCBPlayer
40845,UCBPlayer,115,170,285,10,75,UCBPlayer
40846,UCBPlayer,120,315,435,25,30,UCBPlayer
40847,UCBPlayer,119,154,273,10,79,UCBPlayer
40848,UCBPlayer,112,332,444,25,27,UCBPlayer
40849,UCBPlayer,127,137,264,10,82,UCBPlayer
40850,UCBPlayer,104,349,453,25,24,UCBPlayer
40851,UCBPlayer,126,126,252,7,85,Tie
40852,UCBPlayer,111,351,462,28,22,UCBPlayer
40853,UCBPlayer,116,126,242,3,87,UCBPlayer
40854,UCBPlayer,122,347,469,32,21,UCBPlayer
40855,UCBPlayer,107,132,239,0,87,UCBPlayer
40856,UCBPlayer,132,337,469,35,22,UCBPlayer
40857,UCBPlayer,103,148,251,0,83,UCBPlayer
40858,UCBPlayer,136,321,457,35,26,UCBPlayer
40859,UCBPlayer,99,164,263,0,79,UCBPlayer
40860,UCBPlayer,140,305,445,35,30,UCBPlayer
40861,UCBPlayer,95,180,275,0,75,UCBPlayer
40862,UCBPlayer,144,289,433,35,34,UCBPlayer
40863,UCBPlayer,91,196,287,0,71,UCBPlayer
40864,UCBPlayer,148,273,421,35,38,UCBPlayer
40865,UCBPlayer,87,212,299,0,67,UCBPlayer
40866,UCBPlayer,152,257,409,35,42,UCBPlayer
40867,UCBPlayer,84,224,308,0,64,UCBPlayer
40868,UCBPlayer,146,251,397,32,45,UCBPlayer
40869,UCBPlayer,89,234,323,3,60,UCBPlayer
40870,UCBPlayer,138,243,381,28,49,UCBPlayer
40871,UCBPlayer,97,242,339,7,56,UCBPlayer
40872,UCBPlayer,130,235,365,24,53,UCBPlayer
40873,UCBPlayer,105,250,355,11,52,UCBPlayer
40874,UCBPlayer,122,227,349,20,57,UCBPlayer
40875,UCBPlayer,109,259,368,15,49,UCBPlayer
40876,UCBPlayer,118,218,336,16,60,UCBPlayer
40877,UCBPlayer,117,267,384,19,45,UCBPlayer
40878,UCBPlayer,110,210,320,12,64,UCBPlayer
40879,UCBPlayer,126,271,397,23,42,UCBPlayer
40880,UCBPlayer,105,210,315,10,65,UCBPlayer
40881,UCBPlayer,130,275,405,25,40,UCBPlayer
40882,UCBPlayer,105,210,315,10,65,UCBPlayer
40883,UCBPlayer,130,275,405,25,40,UCBPlayer
40884,UCBPlayer,106,206,312,10,66,UCBPlayer
40885,UCBPlayer,130,275,405,25,40,UCBPlayer
40886,UCBPlayer,105,210,315,10,65,UCBPlayer
40887,UCBPlayer,131,271,402,25,41,UCBPlayer
40888,UCBPlayer,105,210,315,10,65,UCBPlayer
40889,UCBPlayer,130,275,405,25,40,UCBPlayer
40890,UCBPlayer,105,210,315,10,65,UCBPlayer
40891,UCBPlayer,130,275,405,25,40,UCBPlayer
40892,UCBPlayer,103,203,306,10,68,UCBPlayer
40893,UCBPlayer,128,283,411,25,38,UCBPlayer
40894,UCBPlayer,111,186,297,10,71,UCBPlayer
40895,UCBPlayer,124,299,423,25,34,UCBPlayer
40896,UCBPlayer,115,170,285,10,75,UCBPlayer
40897,UCBPlayer,120,315,435,25,30,UCBPlayer
40898,UCBPlayer,119,154,273,10,79,UCBPlayer
40899,UCBPlayer,112,332,444,25,27,UCBPlayer
40900,UCBPlayer,127,137,264,10,82,UCBPlayer
40901,UCBPlayer,104,349,453,25,24,UCBPlayer
40902,UCBPlayer,126,126,252,7,85,Tie
40903,UCBPlayer,111,351,462,28,22,UCBPlayer
40904,UCBPlayer,116,126,242,3,87,UCBPlayer
40905,UCBPlayer,122,347,469,32,21,UCBPlayer
40906,UCBPlayer,107,132,239,0,87,UCBPlayer
40907,UCBPlayer,132,337,469,35,22,UCBPlayer
40908,UCBPlayer,103,148,251,0,83,UCBPlayer
40909,UCBPlayer,136,321,457,35,26,UCBPlayer
40910,UCBPlayer,99,164,263,0,79,UCBPlayer
40911,UCBPlayer,140,305,445,35,30,UCBPlayer
40912,UCBPlayer,95,180,275,0,75,UCBPlayer
40913,UCBPlayer,144,289,433,35,34,UCBPlayer
40914,UCBPlayer,91,196,287,0,71,UCBPlayer
40915,UCBPlayer,148,273,421,35,38,UCBPlayer
40916,UCBPlayer,87,212,299,0,67,UCBPlayer
40917,UCBPlayer,152,257,409,35,42,UCBPlayer
40918,UCBPlayer,84,224,308,0,64,UCBPlayer
40919,UCBPlayer,146,251,397,32,45,UCBPlayer
40920,UCBPlayer,89,234,323,3,60,UCBPlayer
40921,UCBPlayer,138,243,381,28,49,UCBPlayer
40922,UCBPlayer,97,242,339,7,56,UCBPlayer
40923,UCBPlayer,130,235,365,24,53,UCBPlayer
40924,UCBPlayer,105,250,355,11,52,UCBPlayer
40925,UCBPlayer,122,227,349,20,57,UCBPlayer
40926,UCBPlayer,109,259,368,15,49,UCBPlayer
40927,UCBPlayer,118,218,336,16,60,UCBPlayer
40928,UCBPlayer,117,267,384,19,45,UCBPlayer
40929,UCBPlayer,110,210,320,12,64,UCBPlayer
40930,UCBPlayer,126,271,397,23,42,UCBPlayer
40931,UCBPlayer,105,210,315,10,65,UCBPlayer
40932,UCBPlayer,130,275,405,25,40,UCBPlayer
40933,UCBPlayer,105,210,315,10,65,UCBPlayer
40934,UCBPlayer,130,275,405,25,40,UCBPlayer
40935,UCBPlayer,106,206,312,10,66,UCBPlayer
40936,UCBPlayer,130,275,405,25,40,UCBPlayer
40937,UCBPlayer,105,210,315,10,65,UCBPlayer
40938,UCBPlayer,131,271,402,25,41,UCBPlayer
40939,UCBPlayer,105,210,315,10,65,UCBPlayer
40940,UCBPlayer,130,275,405,25,40,UCBPlayer
40941,UCBPlayer,105,210,315,10,65,UCBPlayer
40942,UCBPlayer,130,275,405,25,40,UCBPlayer
40943,UCBPlayer,103,203,306,10,68,UCBPlayer
40944,UCBPlayer,128,283,411,25,38,UCBPlayer
40945,UCBPlayer,111,186,297,10,71,UCBPlayer
40946,UCBPlayer,124,299,423,25,34,UCBPlayer
40947,UCBPlayer,115,170,285,10,75,UCBPlayer
40948,UCBPlayer,120,315,435,25,30,UCBPlayer
40949,UCBPlayer,119,154,273,10,79,UCBPlayer
40950,UCBPlayer,112,332,444,25,27,UCBPlayer
40951,UCBPlayer,127,137,264,10,82,UCBPlayer
40952,UCBPlayer,104,349,453,25,24,UCBPlayer
40953,UCBPlayer,126,126,252,7,85,Tie
40954,UCBPlayer,111,351,462,28,22,UCBPlayer
40955,UCBPlayer,116,126,242,3,87,UCBPlayer
40956,UCBPlayer,122,347,469,32,21,UCBPlayer
40957,UCBPlayer,107,132,239,0,87,UCBPlayer
40958,UCBPlayer,132,337,469,35,22,UCBPlayer
40959,UCBPlayer,103,148,251,0,83,UCBPlayer
40960,UCBPlayer,136,321,457,35,26,UCBPlayer
40961,UCBPlayer,99,164,263,0,79,UCBPlayer
40962,UCBPlayer,140,305,445,35,30,UCBPlayer
40963,UCBPlayer,95,180,275,0,75,UCBPlayer
40964,UCBPlayer,144,289,433,35,34,UCBPlayer
40965,UCBPlayer,91,196,287,0,71,UCBPlayer
40966,UCBPlayer,148,273,421,35,38,UCBPlayer
40967,UCBPlayer,87,212,299,0,67,UCBPlayer
40968,UCBPlayer,152,257,409,35,42,UCBPlayer
40969,UCBPlayer,84,224,308,0,64,UCBPlayer
40970,UCBPlayer,146,251,397,32,45,UCBPlayer
40971,UCBPlayer,89,234,323,3,60,UCBPlayer
40972,UCBPlayer,138,243,381,28,49,UCBPlayer
40973,UCBPlayer,97,242,339,7,56,UCBPlayer
40974,UCBPlayer,130,235,365,24,53,UCBPlayer
40975,UCBPlayer,105,250,355,11,52,UCBPlayer
40976,UCBPlayer,122,227,349,20,57,UCBPlayer
40977,UCBPlayer,109,259,368,15,49,UCBPlayer
40978,UCBPlayer,118,218,336,16,60,UCBPlayer
40979,UCBPlayer,117,267,384,19,45,UCBPlayer
40980,UCBPlayer,110,210,320,12,64,UCBPlayer
40981,UCBPlayer,126,271,397,23,42,UCBPlayer
40982,UCBPlayer,105,210,315,10,65,UCBPlayer
40983,UCBPlayer,130,275,405,25,40,UCBPlayer
40984,UCBPlayer,105,210,315,10,65,UCBPlayer
40985,UCBPlayer,130,275,405,25,40,UCBPlayer
40986,UCBPlayer,106,206,312,10,66,UCBPlayer
40987,UCBPlayer,130,275,405,25,40,UCBPlayer
40988,UCBPlayer,105,210,315,10,65,UCBPlayer
40989,UCBPlayer,131,271,402,25,41,UCBPlayer
40990,UCBPlayer,105,210,315,10,65,UCBPlayer
40991,UCBPlayer,130,275,405,25,40,UCBPlayer
40992,UCBPlayer,105,210,315,10,65,UCBPlayer
40993,UCBPlayer,130,275,405,25,40,UCBPlayer
40994,UCBPlayer,103,203,306,10,68,UCBPlayer
40995,UCBPlayer,128,283,411,25,38,UCBPlayer
40996,UCBPlayer,111,186,297,10,71,UCBPlayer
40997,UCBPlayer,124,299,423,25,34,UCBPlayer
40998,UCBPlayer,115,170,285,10,75,UCBPlayer
40999,UCBPlayer,120,315,435,25,30,UCBPlayer
41000,UCBPlayer,119,154,273,10,79,UCBPlayer
41001,UCBPlayer,112,332,444,25,27,UCBPlayer
41002,UCBPlayer,127,137,264,10,82,UCBPlayer
41003,UCBPlayer,104,349,453,25,24,UCBPlayer
41004,UCBPlayer,126,126,252,7,85,Tie
41005,UCBPlayer,111,351,462,28,22,UCBPlayer
41006,UCBPlayer,116,126,242,3,87,UCBPlayer
41007,UCBPlayer,122,347,469,32,21,UCBPlayer
41008,UCBPlayer,107,132,239,0,87,UCBPlayer
41009,UCBPlayer,132,337,469,35,22,UCBPlayer
41010,UCBPlayer,103,148,251,0,83,UCBPlayer
41011,UCBPlayer,136,321,457,35,26,UCBPlayer
41012,UCBPlayer,99,164,263,0,79,UCBPlayer
41013,UCBPlayer,140,305,445,35,30,UCBPlayer
41014,UCBPlayer,95,180,275,0,75,UCBPlayer
41015,UCBPlayer,144,289,433,35,34,UCBPlayer
41016,UCBPlayer,91,196,287,0,71,UCBPlayer
41017,UCBPlayer,148,273,421,35,38,UCBPlayer
41018,UCBPlayer,87,212,299,0,67,UCBPlayer
41019,UCBPlayer,152,257,409,35,42,UCBPlayer
41020,UCBPlayer,84,224,308,0,64,UCBPlayer
41021,UCBPlayer,146,251,397,32,45,UCBPlayer
41022,UCBPlayer,89,234,323,3,60,UCBPlayer
41023,UCBPlayer,138,243,381,28,49,UCBPlayer
41024,UCBPlayer,97,242,339,7,56,UCBPlayer
41025,UCBPlayer,130,235,365,24,53,UCBPlayer
41026,UCBPlayer,105,250,355,11,52,UCBPlayer
41027,UCBPlayer,122,227,349,20,57,UCBPlayer
41028,UCBPlayer,109,259,368,15,49,UCBPlayer
41029,UCBPlayer,118,218,336,16,60,UCBPlayer
41030,UCBPlayer,117,267,384,19,45,UCBPlayer
41031,UCBPlayer,110,210,320,12,64,UCBPlayer
41032,UCBPlayer,126,271,397,23,42,UCBPlayer
41033,UCBPlayer,105,210,315,10,65,UCBPlayer
41034,UCBPlayer,130,275,405,25,40,UCBPlayer
41035,UCBPlayer,105,210,315,10,65,UCBPlayer
41036,UCBPlayer,130,275,405,25,40,UCBPlayer
41037,UCBPlayer,106,206,312,10,66,UCBPlayer
41038,UCBPlayer,130,275,405,25,40,UCBPlayer
41039,UCBPlayer,105,210,315,10,65,UCBPlayer
41040,UCBPlayer,131,271,402,25,41,UCBPlayer
41041,UCBPlayer,105,210,315,10,65,UCBPlayer
41042,UCBPlayer,130,275,405,25,40,UCBPlayer
41043,UCBPlayer,105,210,315,10,65,UCBPlayer
41044,UCBPlayer,130,275,405,25,40,UCBPlayer
41045,UCBPlayer,103,203,306,10,68,UCBPlayer
41046,UCBPlayer,128,283,411,25,38,UCBPlayer
41047,UCBPlayer,111,186,297,10,71,UCBPlayer
41048,UCBPlayer,124,299,423,25,34,UCBPlayer
41049,UCBPlayer,115,170,285,10,75,UCBPlayer
41050,UCBPlayer,120,315,435,25,30,UCBPlayer
41051,UCBPlayer,119,154,273,10,79,UCBPlayer
41052,UCBPlayer,112,332,444,25,27,UCBPlayer
41053,UCBPlayer,127,137,264,10,82,UCBPlayer
41054,UCBPlayer,104,349,453,25,24,UCBPlayer
41055,UCBPlayer,126,126,252,7,85,Tie
41056,UCBPlayer,111,351,462,28,22,UCBPlayer
41057,UCBPlayer,116,126,242,3,87,UCBPlayer
41058,UCBPlayer,122,347,469,32,21,UCBPlayer
41059,UCBPlayer,107,132,239,0,87,UCBPlayer
41060,UCBPlayer,132,337,469,35,22,UCBPlayer
41061,UCBPlayer,103,148,251,0,83,UCBPlayer
41062,UCBPlayer,136,321,457,35,26,UCBPlayer
41063,UCBPlayer,99,164,263,0,79,UCBPlayer
41064,UCBPlayer,140,305,445,35,30,UCBPlayer
41065,UCBPlayer,95,180,275,0,75,UCBPlayer
41066,UCBPlayer,144,289,433,35,34,UCBPlayer
41067,UCBPlayer,91,196,287,0,71,UCBPlayer
41068,UCBPlayer,148,273,421,35,38,UCBPlayer
41069,UCBPlayer,87,212,299,0,67,UCBPlayer
41070,UCBPlayer,152,257,409,35,42,UCBPlayer
41071,UCBPlayer,84,224,308,0,64,UCBPlayer
41072,UCBPlayer,146,251,397,32,45,UCBPlayer
41073,UCBPlayer,89,234,323,3,60,UCBPlayer
41074,UCBPlayer,138,243,381,28,49,UCBPlayer
41075,UCBPlayer,97,242,339,7,56,UCBPlayer
41076,UCBPlayer,130,235,365,24,53,UCBPlayer
41077,UCBPlayer,105,250,355,11,52,UCBPlayer
41078,UCBPlayer,122,227,349,20,57,UCBPlayer
41079,UCBPlayer,109,259,368,15,49,UCBPlayer
41080,UCBPlayer,118,218,336,16,60,UCBPlayer
41081,UCBPlayer,117,267,384,19,45,UCBPlayer
41082,UCBPlayer,110,210,320,12,64,UCBPlayer
41083,UCBPlayer,126,271,397,23,42,UCBPlayer
41084,UCBPlayer,105,210,315,10,65,UCBPlayer
41085,UCBPlayer,130,275,405,25,40,UCBPlayer
41086,UCBPlayer,105,210,315,10,65,UCBPlayer
41087,UCBPlayer,130,275,405,25,40,UCBPlayer
41088,UCBPlayer,106,206,312,10,66,UCBPlayer
41089,UCBPlayer,130,275,405,25,40,UCBPlayer
41090,UCBPlayer,105,210,315,10,65,UCBPlayer
41091,UCBPlayer,131,271,402,25,41,UCBPlayer
41092,UCBPlayer,105,210,315,10,65,UCBPlayer
41093,UCBPlayer,130,275,405,25,40,UCBPlayer
41094,UCBPlayer,105,210,315,10,65,UCBPlayer
41095,UCBPlayer,130,275,405,25,40,UCBPlayer
41096,UCBPlayer,103,203,306,10,68,UCBPlayer
41097,UCBPlayer,128,283,411,25,38,UCBPlayer
41098,UCBPlayer,111,186,297,10,71,UCBPlayer
41099,UCBPlayer,124,299,423,25,34,UCBPlayer
41100,UCBPlayer,115,170,285,10,75,UCBPlayer
41101,UCBPlayer,120,315,435,25,30,UCBPlayer
41102,UCBPlayer,119,154,273,10,79,UCBPlayer
41103,UCBPlayer,112,332,444,25,27,UCBPlayer
41104,UCBPlayer,127,137,264,10,82,UCBPlayer
41105,UCBPlayer,104,349,453,25,24,UCBPlayer
41106,UCBPlayer,126,126,252,7,85,Tie
41107,UCBPlayer,111,351,462,28,22,UCBPlayer
41108,UCBPlayer,116,126,242,3,87,UCBPlayer
41109,UCBPlayer,122,347,469,32,21,UCBPlayer
41110,UCBPlayer,107,132,239,0,87,UCBPlayer
41111,UCBPlayer,132,337,469,35,22,UCBPlayer
41112,UCBPlayer,103,148,251,0,83,UCBPlayer
41113,UCBPlayer,136,321,457,35,26,UCBPlayer
41114,UCBPlayer,99,164,263,0,79,UCBPlayer
41115,UCBPlayer,140,305,445,35,30,UCBPlayer
41116,UCBPlayer,95,180,275,0,75,UCBPlayer
41117,UCBPlayer,144,289,433,35,34,UCBPlayer
41118,UCBPlayer,91,196,287,0,71,UCBPlayer
41119,UCBPlayer,148,273,421,35,38,UCBPlayer
41120,UCBPlayer,87,212,299,0,67,UCBPlayer
41121,UCBPlayer,152,257,409,35,42,UCBPlayer
41122,UCBPlayer,84,224,308,0,64,UCBPlayer
41123,UCBPlayer,146,251,397,32,45,UCBPlayer
41124,UCBPlayer,89,234,323,3,60,UCBPlayer
41125,UCBPlayer,138,243,381,28,49,UCBPlayer
41126,UCBPlayer,97,242,339,7,56,UCBPlayer
41127,UCBPlayer,130,235,365,24,53,UCBPlayer
41128,UCBPlayer,105,250,355,11,52,UCBPlayer
41129,UCBPlayer,122,227,349,20,57,UCBPlayer
41130,UCBPlayer,109,259,368,15,49,UCBPlayer
41131,UCBPlayer,118,218,336,16,60,UCBPlayer
41132,UCBPlayer,117,267,384,19,45,UCBPlayer
41133,UCBPlayer,110,210,320,12,64,UCBPlayer
41134,UCBPlayer,126,271,397,23,42,UCBPlayer
41135,UCBPlayer,105,210,315,10,65,UCBPlayer
41136,UCBPlayer,130,275,405,25,40,UCBPlayer
41137,UCBPlayer,105,210,315,10,65,UCBPlayer
41138,UCBPlayer,130,275,405,25,40,UCBPlayer
41139,UCBPlayer,106,206,312,10,66,UCBPlayer
41140,UCBPlayer,130,275,405,25,40,UCBPlayer
41141,UCBPlayer,105,210,315,10,65,UCBPlayer
41142,UCBPlayer,131,271,402,25,41,UCBPlayer
41143,UCBPlayer,105,210,315,10,65,UCBPlayer
41144,UCBPlayer,130,275,405,25,40,UCBPlayer
41145,UCBPlayer,105,210,315,10,65,UCBPlayer
41146,UCBPlayer,130,275,405,25,40,UCBPlayer
41147,UCBPlayer,103,203,306,10,68,UCBPlayer
41148,UCBPlayer,128,283,411,25,38,UCBPlayer
41149,UCBPlayer,111,186,297,10,71,UCBPlayer
41150,UCBPlayer,124,299,423,25,34,UCBPlayer
41151,UCBPlayer,115,170,285,10,75,UCBPlayer
41152,UCBPlayer,120,315,435,25,30,UCBPlayer
41153,UCBPlayer,119,154,273,10,79,UCBPlayer
41154,UCBPlayer,112,332,444,25,27,UCBPlayer
41155,UCBPlayer,127,137,264,10,82,UCBPlayer
41156,UCBPlayer,104,349,453,25,24,UCBPlayer
41157,UCBPlayer,126,126,252,7,85,Tie
41158,UCBPlayer,111,351,462,28,22,UCBPlayer
41159,UCBPlayer,116,126,242,3,87,UCBPlayer
41160,UCBPlayer,122,347,469,32,21,UCBPlayer
41161,UCBPlayer,107,132,239,0,87,UCBPlayer
41162,UCBPlayer,132,337,469,35,22,UCBPlayer
41163,UCBPlayer,103,148,251,0,83,UCBPlayer
41164,UCBPlayer,136,321,457,35,26,UCBPlayer
41165,UCBPlayer,99,164,263,0,79,UCBPlayer
41166,UCBPlayer,140,305,445,35,30,UCBPlayer
41167,UCBPlayer,95,180,275,0,75,UCBPlayer
41168,UCBPlayer,144,289,433,35,34,UCBPlayer
41169,UCBPlayer,91,196,287,0,71,UCBPlayer
41170,UCBPlayer,148,273,421,35,38,UCBPlayer
41171,UCBPlayer,87,212,299,0,67,UCBPlayer
41172,UCBPlayer,152,257,409,35,42,UCBPlayer
41173,UCBPlayer,84,224,308,0,64,UCBPlayer
41174,UCBPlayer,146,251,397,32,45,UCBPlayer
41175,UCBPlayer,89,234,323,3,60,UCBPlayer
41176,UCBPlayer,138,243,381,28,49,UCBPlayer
41177,UCBPlayer,97,242,339,7,56,UCBPlayer
41178,UCBPlayer,130,235,365,24,53,UCBPlayer
41179,UCBPlayer,105,250,355,11,52,UCBPlayer
41180,UCBPlayer,122,227,349,20,57,UCBPlayer
41181,UCBPlayer,109,259,368,15,49,UCBPlayer
41182,UCBPlayer,118,218,336,16,60,UCBPlayer
41183,UCBPlayer,117,267,384,19,45,UCBPlayer
41184,UCBPlayer,110,210,320,12,64,UCBPlayer
41185,UCBPlayer,126,271,397,23,42,UCBPlayer
41186,UCBPlayer,105,210,315,10,65,UCBPlayer
41187,UCBPlayer,130,275,405,25,40,UCBPlayer
41188,UCBPlayer,105,210,315,10,65,UCBPlayer
41189,UCBPlayer,130,275,405,25,40,UCBPlayer
41190,UCBPlayer,106,206,312,10,66,UCBPlayer
41191,UCBPlayer,130,275,405,25,40,UCBPlayer
41192,UCBPlayer,105,210,315,10,65,UCBPlayer
41193,UCBPlayer,131,271,402,25,41,UCBPlayer
41194,UCBPlayer,105,210,315,10,65,UCBPlayer
41195,UCBPlayer,130,275,405,25,40,UCBPlayer
41196,UCBPlayer,105,210,315,10,65,UCBPlayer
41197,UCBPlayer,130,275,405,25,40,UCBPlayer
41198,UCBPlayer,103,203,306,10,68,UCBPlayer
41199,UCBPlayer,128,283,411,25,38,UCBPlayer
41200,UCBPlayer,111,186,297,10,71,UCBPlayer
41201,UCBPlayer,124,299,423,25,34,UCBPlayer
41202,UCBPlayer,115,170,285,10,75,UCBPlayer
41203,UCBPlayer,120,315,435,25,30,UCBPlayer
41204,UCBPlayer,119,154,273,10,79,UCBPlayer
41205,UCBPlayer,112,332,444,25,27,UCBPlayer
41206,UCBPlayer,127,137,264,10,82,UCBPlayer
41207,UCBPlayer,104,349,453,25,24,UCBPlayer
41208,UCBPlayer,126,126,252,7,85,Tie
41209,UCBPlayer,111,351,462,28,22,UCBPlayer
41210,UCBPlayer,116,126,242,3,87,UCBPlayer
41211,UCBPlayer,122,347,469,32,21,UCBPlayer
41212,UCBPlayer,107,132,239,0,87,UCBPlayer
41213,UCBPlayer,132,337,469,35,22,UCBPlayer
41214,UCBPlayer,103,148,251,0,83,UCBPlayer
41215,UCBPlayer,136,321,457,35,26,UCBPlayer
41216,UCBPlayer,99,164,263,0,79,UCBPlayer
41217,UCBPlayer,140,305,445,35,30,UCBPlayer
41218,UCBPlayer,95,180,275,0,75,UCBPlayer
41219,UCBPlayer,144,289,433,35,34,UCBPlayer
41220,UCBPlayer,91,196,287,0,71,UCBPlayer
41221,UCBPlayer,148,273,421,35,38,UCBPlayer
41222,UCBPlayer,87,212,299,0,67,UCBPlayer
41223,UCBPlayer,152,257,409,35,42,UCBPlayer
41224,UCBPlayer,84,224,308,0,64,UCBPlayer
41225,UCBPlayer,146,251,397,32,45,UCBPlayer
41226,UCBPlayer,89,234,323,3,60,UCBPlayer
41227,UCBPlayer,138,243,381,28,49,UCBPlayer
41228,UCBPlayer,97,242,339,7,56,UCBPlayer
41229,UCBPlayer,130,235,365,24,53,UCBPlayer
41230,UCBPlayer,105,250,355,11,52,UCBPlayer
41231,UCBPlayer,122,227,349,20,57,UCBPlayer
41232,UCBPlayer,109,259,368,15,49,UCBPlayer
41233,UCBPlayer,118,218,336,16,60,UCBPlayer
41234,UCBPlayer,117,267,384,19,45,UCBPlayer
41235,UCBPlayer,110,210,320,12,64,UCBPlayer
41236,UCBPlayer,126,271,397,23,42,UCBPlayer
41237,UCBPlayer,105,210,315,10,65,UCBPlayer
41238,UCBPlayer,130,275,405,25,40,UCBPlayer
41239,UCBPlayer,105,210,315,10,65,UCBPlayer
41240,UCBPlayer,130,275,405,25,40,UCBPlayer
41241,UCBPlayer,106,206,312,10,66,UCBPlayer
41242,UCBPlayer,130,275,405,25,40,UCBPlayer
41243,UCBPlayer,105,210,315,10,65,UCBPlayer
41244,UCBPlayer,131,271,402,25,41,UCBPlayer
41245,UCBPlayer,105,210,315,10,65,UCBPlayer
41246,UCBPlayer,130,275,405,25,40,UCBPlayer
41247,UCBPlayer,105,210,315,10,65,UCBPlayer
41248,UCBPlayer,130,275,405,25,40,UCBPlayer
41249,UCBPlayer,103,203,306,10,68,UCBPlayer
41250,UCBPlayer,128,283,411,25,38,UCBPlayer
41251,UCBPlayer,111,186,297,10,71,UCBPlayer
41252,UCBPlayer,124,299,423,25,34,UCBPlayer
41253,UCBPlayer,115,170,285,10,75,UCBPlayer
41254,UCBPlayer,120,315,435,25,30,UCBPlayer
41255,UCBPlayer,119,154,273,10,79,UCBPlayer
41256,UCBPlayer,112,332,444,25,27,UCBPlayer
41257,UCBPlayer,127,137,264,10,82,UCBPlayer
41258,UCBPlayer,104,349,453,25,24,UCBPlayer
41259,UCBPlayer,126,126,252,7,85,Tie
41260,UCBPlayer,111,351,462,28,22,UCBPlayer
41261,UCBPlayer,116,126,242,3,87,UCBPlayer
41262,UCBPlayer,122,347,469,32,21,UCBPlayer
41263,UCBPlayer,107,132,239,0,87,UCBPlayer
41264,UCBPlayer,132,337,469,35,22,UCBPlayer
41265,UCBPlayer,103,148,251,0,83,UCBPlayer
41266,UCBPlayer,136,321,457,35,26,UCBPlayer
41267,UCBPlayer,99,164,263,0,79,UCBPlayer
41268,UCBPlayer,140,305,445,35,30,UCBPlayer
41269,UCBPlayer,95,180,275,0,75,UCBPlayer
41270,UCBPlayer,144,289,433,35,34,UCBPlayer
41271,UCBPlayer,91,196,287,0,71,UCBPlayer
41272,UCBPlayer,148,273,421,35,38,UCBPlayer
41273,UCBPlayer,87,212,299,0,67,UCBPlayer
41274,UCBPlayer,152,257,409,35,42,UCBPlayer
41275,UCBPlayer,84,224,308,0,64,UCBPlayer
41276,UCBPlayer,146,251,397,32,45,UCBPlayer
41277,UCBPlayer,89,234,323,3,60,UCBPlayer
41278,UCBPlayer,138,243,381,28,49,UCBPlayer
41279,UCBPlayer,97,242,339,7,56,UCBPlayer
41280,UCBPlayer,130,235,365,24,53,UCBPlayer
41281,UCBPlayer,105,250,355,11,52,UCBPlayer
41282,UCBPlayer,122,227,349,20,57,UCBPlayer
41283,UCBPlayer,109,259,368,15,49,UCBPlayer
41284,UCBPlayer,118,218,336,16,60,UCBPlayer
41285,UCBPlayer,117,267,384,19,45,UCBPlayer
41286,UCBPlayer,110,210,320,12,64,UCBPlayer
41287,UCBPlayer,126,271,397,23,42,UCBPlayer
41288,UCBPlayer,105,210,315,10,65,UCBPlayer
41289,UCBPlayer,130,275,405,25,40,UCBPlayer
41290,UCBPlayer,105,210,315,10,65,UCBPlayer
41291,UCBPlayer,130,275,405,25,40,UCBPlayer
41292,UCBPlayer,106,206,312,10,66,UCBPlayer
41293,UCBPlayer,130,275,405,25,40,UCBPlayer
41294,UCBPlayer,105,210,315,10,65,UCBPlayer
41295,UCBPlayer,131,271,402,25,41,UCBPlayer
41296,UCBPlayer,105,210,315,10,65,UCBPlayer
41297,UCBPlayer,130,275,405,25,40,UCBPlayer
41298,UCBPlayer,105,210,315,10,65,UCBPlayer
41299,UCBPlayer,130,275,405,25,40,UCBPlayer
41300,UCBPlayer,103,203,306,10,68,UCBPlayer
41301,UCBPlayer,128,283,411,25,38,UCBPlayer
41302,UCBPlayer,111,186,297,10,71,UCBPlayer
41303,UCBPlayer,124,299,423,25,34,UCBPlayer
41304,UCBPlayer,115,170,285,10,75,UCBPlayer
41305,UCBPlayer,120,315,435,25,30,UCBPlayer
41306,UCBPlayer,119,154,273,10,79,UCBPlayer
41307,UCBPlayer,112,332,444,25,27,UCBPlayer
41308,UCBPlayer,127,137,264,10,82,UCBPlayer
41309,UCBPlayer,104,349,453,25,24,UCBPlayer
41310,UCBPlayer,126,126,252,7,85,Tie
41311,UCBPlayer,111,351,462,28,22,UCBPlayer
41312,UCBPlayer,116,126,242,3,87,UCBPlayer
41313,UCBPlayer,122,347,469,32,21,UCBPlayer
41314,UCBPlayer,107,132,239,0,87,UCBPlayer
41315,UCBPlayer,132,337,469,35,22,UCBPlayer
41316,UCBPlayer,103,148,251,0,83,UCBPlayer
41317,UCBPlayer,136,321,457,35,26,UCBPlayer
41318,UCBPlayer,99,164,263,0,79,UCBPlayer
41319,UCBPlayer,140,305,445,35,30,UCBPlayer
41320,UCBPlayer,95,180,275,0,75,UCBPlayer
41321,UCBPlayer,144,289,433,35,34,UCBPlayer
41322,UCBPlayer,91,196,287,0,71,UCBPlayer
41323,UCBPlayer,148,273,421,35,38,UCBPlayer
41324,UCBPlayer,87,212,299,0,67,UCBPlayer
41325,UCBPlayer,152,257,409,35,42,UCBPlayer
41326,UCBPlayer,84,224,308,0,64,UCBPlayer
41327,UCBPlayer,146,251,397,32,45,UCBPlayer
41328,UCBPlayer,89,234,323,3,60,UCBPlayer
41329,UCBPlayer,138,243,381,28,49,UCBPlayer
41330,UCBPlayer,97,242,339,7,56,UCBPlayer
41331,UCBPlayer,130,235,365,24,53,UCBPlayer
41332,UCBPlayer,105,250,355,11,52,UCBPlayer
41333,UCBPlayer,122,227,349,20,57,UCBPlayer
41334,UCBPlayer,109,259,368,15,49,UCBPlayer
41335,UCBPlayer,118,218,336,16,60,UCBPlayer
41336,UCBPlayer,117,267,384,19,45,UCBPlayer
41337,UCBPlayer,110,210,320,12,64,UCBPlayer
41338,UCBPlayer,126,271,397,23,42,UCBPlayer
41339,UCBPlayer,105,210,315,10,65,UCBPlayer
41340,UCBPlayer,130,275,405,25,40,UCBPlayer
41341,UCBPlayer,105,210,315,10,65,UCBPlayer
41342,UCBPlayer,130,275,405,25,40,UCBPlayer
41343,UCBPlayer,106,206,312,10,66,UCBPlayer
41344,UCBPlayer,130,275,405,25,40,UCBPlayer
41345,UCBPlayer,105,210,315,10,65,UCBPlayer
41346,UCBPlayer,131,271,402,25,41,UCBPlayer
41347,UCBPlayer,105,210,315,10,65,UCBPlayer
41348,UCBPlayer,130,275,405,25,40,UCBPlayer
41349,UCBPlayer,105,210,315,10,65,UCBPlayer
41350,UCBPlayer,130,275,405,25,40,UCBPlayer
41351,UCBPlayer,103,203,306,10,68,UCBPlayer
41352,UCBPlayer,128,283,411,25,38,UCBPlayer
41353,UCBPlayer,111,186,297,10,71,UCBPlayer
41354,UCBPlayer,124,299,423,25,34,UCBPlayer
41355,UCBPlayer,115,170,285,10,75,UCBPlayer
41356,UCBPlayer,120,315,435,25,30,UCBPlayer
41357,UCBPlayer,119,154,273,10,79,UCBPlayer
41358,UCBPlayer,112,332,444,25,27,UCBPlayer
41359,UCBPlayer,127,137,264,10,82,UCBPlayer
41360,UCBPlayer,104,349,453,25,24,UCBPlayer
41361,UCBPlayer,126,126,252,7,85,Tie
41362,UCBPlayer,111,351,462,28,22,UCBPlayer
41363,UCBPlayer,116,126,242,3,87,UCBPlayer
41364,UCBPlayer,122,347,469,32,21,UCBPlayer
41365,UCBPlayer,107,132,239,0,87,UCBPlayer
41366,UCBPlayer,132,337,469,35,22,UCBPlayer
41367,UCBPlayer,103,148,251,0,83,UCBPlayer
41368,UCBPlayer,136,321,457,35,26,UCBPlayer
41369,UCBPlayer,99,164,263,0,79,UCBPlayer
41370,UCBPlayer,140,305,445,35,30,UCBPlayer
41371,UCBPlayer,95,180,275,0,75,UCBPlayer
41372,UCBPlayer,144,289,433,35,34,UCBPlayer
41373,UCBPlayer,91,196,287,0,71,UCBPlayer
41374,UCBPlayer,148,273,421,35,38,UCBPlayer
41375,UCBPlayer,87,212,299,0,67,UCBPlayer
41376,UCBPlayer,152,257,409,35,42,UCBPlayer
41377,UCBPlayer,84,224,308,0,64,UCBPlayer
41378,UCBPlayer,146,251,397,32,45,UCBPlayer
41379,UCBPlayer,89,234,323,3,60,UCBPlayer
41380,UCBPlayer,138,243,381,28,49,UCBPlayer
41381,UCBPlayer,97,242,339,7,56,UCBPlayer
41382,UCBPlayer,130,235,365,24,53,UCBPlayer
41383,UCBPlayer,105,250,355,11,52,UCBPlayer
41384,UCBPlayer,122,227,349,20,57,UCBPlayer
41385,UCBPlayer,109,259,368,15,49,UCBPlayer
41386,UCBPlayer,118,218,336,16,60,UCBPlayer
41387,UCBPlayer,117,267,384,19,45,UCBPlayer
41388,UCBPlayer,110,210,320,12,64,UCBPlayer
41389,UCBPlayer,126,271,397,23,42,UCBPlayer
41390,UCBPlayer,105,210,315,10,65,UCBPlayer
41391,UCBPlayer,130,275,405,25,40,UCBPlayer
41392,UCBPlayer,105,210,315,10,65,UCBPlayer
41393,UCBPlayer,130,275,405,25,40,UCBPlayer
41394,UCBPlayer,106,206,312,10,66,UCBPlayer
41395,UCBPlayer,130,275,405,25,40,UCBPlayer
41396,UCBPlayer,105,210,315,10,65,UCBPlayer
41397,UCBPlayer,131,271,402,25,41,UCBPlayer
41398,UCBPlayer,105,210,315,10,65,UCBPlayer
41399,UCBPlayer,130,275,405,25,40,UCBPlayer
41400,UCBPlayer,105,210,315,10,65,UCBPlayer
41401,UCBPlayer,130,275,405,25,40,UCBPlayer
41402,UCBPlayer,103,203,306,10,68,UCBPlayer
41403,UCBPlayer,128,283,411,25,38,UCBPlayer
41404,UCBPlayer,111,186,297,10,71,UCBPlayer
41405,UCBPlayer,124,299,423,25,34,UCBPlayer
41406,UCBPlayer,115,170,285,10,75,UCBPlayer
41407,UCBPlayer,120,315,435,25,30,UCBPlayer
41408,UCBPlayer,119,154,273,10,79,UCBPlayer
41409,UCBPlayer,112,332,444,25,27,UCBPlayer
41410,UCBPlayer,127,137,264,10,82,UCBPlayer
41411,UCBPlayer,104,349,453,25,24,UCBPlayer
41412,UCBPlayer,126,126,252,7,85,Tie
41413,UCBPlayer,111,351,462,28,22,UCBPlayer
41414,UCBPlayer,116,126,242,3,87,UCBPlayer
41415,UCBPlayer,122,347,469,32,21,UCBPlayer
41416,UCBPlayer,107,132,239,0,87,UCBPlayer
41417,UCBPlayer,132,337,469,35,22,UCBPlayer
41418,UCBPlayer,103,148,251,0,83,UCBPlayer
41419,UCBPlayer,136,321,457,35,26,UCBPlayer
41420,UCBPlayer,99,164,263,0,79,UCBPlayer
41421,UCBPlayer,140,305,445,35,30,UCBPlayer
41422,UCBPlayer,95,180,275,0,75,UCBPlayer
41423,UCBPlayer,144,289,433,35,34,UCBPlayer
41424,UCBPlayer,91,196,287,0,71,UCBPlayer
41425,UCBPlayer,148,273,421,35,38,UCBPlayer
41426,UCBPlayer,87,212,299,0,67,UCBPlayer
41427,UCBPlayer,152,257,409,35,42,UCBPlayer
41428,UCBPlayer,84,224,308,0,64,UCBPlayer
41429,UCBPlayer,146,251,397,32,45,UCBPlayer
41430,UCBPlayer,89,234,323,3,60,UCBPlayer
41431,UCBPlayer,138,243,381,28,49,UCBPlayer
41432,UCBPlayer,97,242,339,7,56,UCBPlayer
41433,UCBPlayer,130,235,365,24,53,UCBPlayer
41434,UCBPlayer,105,250,355,11,52,UCBPlayer
41435,UCBPlayer,122,227,349,20,57,UCBPlayer
41436,UCBPlayer,109,259,368,15,49,UCBPlayer
41437,UCBPlayer,118,218,336,16,60,UCBPlayer
41438,UCBPlayer,117,267,384,19,45,UCBPlayer
41439,UCBPlayer,110,210,320,12,64,UCBPlayer
41440,UCBPlayer,126,271,397,23,42,UCBPlayer
41441,UCBPlayer,105,210,315,10,65,UCBPlayer
41442,UCBPlayer,130,275,405,25,40,UCBPlayer
41443,UCBPlayer,105,210,315,10,65,UCBPlayer
41444,UCBPlayer,130,275,405,25,40,UCBPlayer
41445,UCBPlayer,106,206,312,10,66,UCBPlayer
41446,UCBPlayer,130,275,405,25,40,UCBPlayer
41447,UCBPlayer,105,210,315,10,65,UCBPlayer
41448,UCBPlayer,131,271,402,25,41,UCBPlayer
41449,UCBPlayer,105,210,315,10,65,UCBPlayer
41450,UCBPlayer,130,275,405,25,40,UCBPlayer
41451,UCBPlayer,105,210,315,10,65,UCBPlayer
41452,UCBPlayer,130,275,405,25,40,UCBPlayer
41453,UCBPlayer,103,203,306,10,68,UCBPlayer
41454,UCBPlayer,128,283,411,25,38,UCBPlayer
41455,UCBPlayer,111,186,297,10,71,UCBPlayer
41456,UCBPlayer,124,299,423,25,34,UCBPlayer
41457,UCBPlayer,115,170,285,10,75,UCBPlayer
41458,UCBPlayer,120,315,435,25,30,UCBPlayer
41459,UCBPlayer,119,154,273,10,79,UCBPlayer
41460,UCBPlayer,112,332,444,25,27,UCBPlayer
41461,UCBPlayer,127,137,264,10,82,UCBPlayer
41462,UCBPlayer,104,349,453,25,24,UCBPlayer
41463,UCBPlayer,126,126,252,7,85,Tie
41464,UCBPlayer,111,351,462,28,22,UCBPlayer
41465,UCBPlayer,116,126,242,3,87,UCBPlayer
41466,UCBPlayer,122,347,469,32,21,UCBPlayer
41467,UCBPlayer,107,132,239,0,87,UCBPlayer
41468,UCBPlayer,132,337,469,35,22,UCBPlayer
41469,UCBPlayer,103,148,251,0,83,UCBPlayer
41470,UCBPlayer,136,321,457,35,26,UCBPlayer
41471,UCBPlayer,99,164,263,0,79,UCBPlayer
41472,UCBPlayer,140,305,445,35,30,UCBPlayer
41473,UCBPlayer,95,180,275,0,75,UCBPlayer
41474,UCBPlayer,144,289,433,35,34,UCBPlayer
41475,UCBPlayer,91,196,287,0,71,UCBPlayer
41476,UCBPlayer,148,273,421,35,38,UCBPlayer
41477,UCBPlayer,87,212,299,0,67,UCBPlayer
41478,UCBPlayer,152,257,409,35,42,UCBPlayer
41479,UCBPlayer,84,224,308,0,64,UCBPlayer
41480,UCBPlayer,146,251,397,32,45,UCBPlayer
41481,UCBPlayer,89,234,323,3,60,UCBPlayer
41482,UCBPlayer,138,243,381,28,49,UCBPlayer
41483,UCBPlayer,97,242,339,7,56,UCBPlayer
41484,UCBPlayer,130,235,365,24,53,UCBPlayer
41485,UCBPlayer,105,250,355,11,52,UCBPlayer
41486,UCBPlayer,122,227,349,20,57,UCBPlayer
41487,UCBPlayer,109,259,368,15,49,UCBPlayer
41488,UCBPlayer,118,218,336,16,60,UCBPlayer
41489,UCBPlayer,117,267,384,19,45,UCBPlayer
41490,UCBPlayer,110,210,320,12,64,UCBPlayer
41491,UCBPlayer,126,271,397,23,42,UCBPlayer
41492,UCBPlayer,105,210,315,10,65,UCBPlayer
41493,UCBPlayer,130,275,405,25,40,UCBPlayer
41494,UCBPlayer,105,210,315,10,65,UCBPlayer
41495,UCBPlayer,130,275,405,25,40,UCBPlayer
41496,UCBPlayer,106,206,312,10,66,UCBPlayer
41497,UCBPlayer,130,275,405,25,40,UCBPlayer
41498,UCBPlayer,105,210,315,10,65,UCBPlayer
41499,UCBPlayer,131,271,402,25,41,UCBPlayer
41500,UCBPlayer,105,210,315,10,65,UCBPlayer
41501,UCBPlayer,130,275,405,25,40,UCBPlayer
41502,UCBPlayer,105,210,315,10,65,UCBPlayer
41503,UCBPlayer,130,275,405,25,40,UCBPlayer
41504,UCBPlayer,103,203,306,10,68,UCBPlayer
41505,UCBPlayer,128,283,411,25,38,UCBPlayer
41506,UCBPlayer,111,186,297,10,71,UCBPlayer
41507,UCBPlayer,124,299,423,25,34,UCBPlayer
41508,UCBPlayer,115,170,285,10,75,UCBPlayer
41509,UCBPlayer,120,315,435,25,30,UCBPlayer
41510,UCBPlayer,119,154,273,10,79,UCBPlayer
41511,UCBPlayer,112,332,444,25,27,UCBPlayer
41512,UCBPlayer,127,137,264,10,82,UCBPlayer
41513,UCBPlayer,104,349,453,25,24,UCBPlayer
41514,UCBPlayer,126,126,252,7,85,Tie
41515,UCBPlayer,111,351,462,28,22,UCBPlayer
41516,UCBPlayer,116,126,242,3,87,UCBPlayer
41517,UCBPlayer,122,347,469,32,21,UCBPlayer
41518,UCBPlayer,107,132,239,0,87,UCBPlayer
41519,UCBPlayer,132,337,469,35,22,UCBPlayer
41520,UCBPlayer,103,148,251,0,83,UCBPlayer
41521,UCBPlayer,136,321,457,35,26,UCBPlayer
41522,UCBPlayer,99,164,263,0,79,UCBPlayer
41523,UCBPlayer,140,305,445,35,30,UCBPlayer
41524,UCBPlayer,95,180,275,0,75,UCBPlayer
41525,UCBPlayer,144,289,433,35,34,UCBPlayer
41526,UCBPlayer,91,196,287,0,71,UCBPlayer
41527,UCBPlayer,148,273,421,35,38,UCBPlayer
41528,UCBPlayer,87,212,299,0,67,UCBPlayer
41529,UCBPlayer,152,257,409,35,42,UCBPlayer
41530,UCBPlayer,84,224,308,0,64,UCBPlayer
41531,UCBPlayer,146,251,397,32,45,UCBPlayer
41532,UCBPlayer,89,234,323,3,60,UCBPlayer
41533,UCBPlayer,138,243,381,28,49,UCBPlayer
41534,UCBPlayer,97,242,339,7,56,UCBPlayer
41535,UCBPlayer,130,235,365,24,53,UCBPlayer
41536,UCBPlayer,105,250,355,11,52,UCBPlayer
41537,UCBPlayer,122,227,349,20,57,UCBPlayer
41538,UCBPlayer,109,259,368,15,49,UCBPlayer
41539,UCBPlayer,118,218,336,16,60,UCBPlayer
41540,UCBPlayer,117,267,384,19,45,UCBPlayer
41541,UCBPlayer,110,210,320,12,64,UCBPlayer
41542,UCBPlayer,126,271,397,23,42,UCBPlayer
41543,UCBPlayer,105,210,315,10,65,UCBPlayer
41544,UCBPlayer,130,275,405,25,40,UCBPlayer
41545,UCBPlayer,105,210,315,10,65,UCBPlayer
41546,UCBPlayer,130,275,405,25,40,UCBPlayer
41547,UCBPlayer,106,206,312,10,66,UCBPlayer
41548,UCBPlayer,130,275,405,25,40,UCBPlayer
41549,UCBPlayer,105,210,315,10,65,UCBPlayer
41550,UCBPlayer,131,271,402,25,41,UCBPlayer
41551,UCBPlayer,105,210,315,10,65,UCBPlayer
41552,UCBPlayer,130,275,405,25,40,UCBPlayer
41553,UCBPlayer,105,210,315,10,65,UCBPlayer
41554,UCBPlayer,130,275,405,25,40,UCBPlayer
41555,UCBPlayer,103,203,306,10,68,UCBPlayer
41556,UCBPlayer,128,283,411,25,38,UCBPlayer
41557,UCBPlayer,111,186,297,10,71,UCBPlayer
41558,UCBPlayer,124,299,423,25,34,UCBPlayer
41559,UCBPlayer,115,170,285,10,75,UCBPlayer
41560,UCBPlayer,120,315,435,25,30,UCBPlayer
41561,UCBPlayer,119,154,273,10,79,UCBPlayer
41562,UCBPlayer,112,332,444,25,27,UCBPlayer
41563,UCBPlayer,127,137,264,10,82,UCBPlayer
41564,UCBPlayer,104,349,453,25,24,UCBPlayer
41565,UCBPlayer,126,126,252,7,85,Tie
41566,UCBPlayer,111,351,462,28,22,UCBPlayer
41567,UCBPlayer,116,126,242,3,87,UCBPlayer
41568,UCBPlayer,122,347,469,32,21,UCBPlayer
41569,UCBPlayer,107,132,239,0,87,UCBPlayer
41570,UCBPlayer,132,337,469,35,22,UCBPlayer
41571,UCBPlayer,103,148,251,0,83,UCBPlayer
41572,UCBPlayer,136,321,457,35,26,UCBPlayer
41573,UCBPlayer,99,164,263,0,79,UCBPlayer
41574,UCBPlayer,140,305,445,35,30,UCBPlayer
41575,UCBPlayer,95,180,275,0,75,UCBPlayer
41576,UCBPlayer,144,289,433,35,34,UCBPlayer
41577,UCBPlayer,91,196,287,0,71,UCBPlayer
41578,UCBPlayer,148,273,421,35,38,UCBPlayer
41579,UCBPlayer,87,212,299,0,67,UCBPlayer
41580,UCBPlayer,152,257,409,35,42,UCBPlayer
41581,UCBPlayer,84,224,308,0,64,UCBPlayer
41582,UCBPlayer,146,251,397,32,45,UCBPlayer
41583,UCBPlayer,89,234,323,3,60,UCBPlayer
41584,UCBPlayer,138,243,381,28,49,UCBPlayer
41585,UCBPlayer,97,242,339,7,56,UCBPlayer
41586,UCBPlayer,130,235,365,24,53,UCBPlayer
41587,UCBPlayer,105,250,355,11,52,UCBPlayer
41588,UCBPlayer,122,227,349,20,57,UCBPlayer
41589,UCBPlayer,109,259,368,15,49,UCBPlayer
41590,UCBPlayer,118,218,336,16,60,UCBPlayer
41591,UCBPlayer,117,267,384,19,45,UCBPlayer
41592,UCBPlayer,110,210,320,12,64,UCBPlayer
41593,UCBPlayer,126,271,397,23,42,UCBPlayer
41594,UCBPlayer,105,210,315,10,65,UCBPlayer
41595,UCBPlayer,130,275,405,25,40,UCBPlayer
41596,UCBPlayer,105,210,315,10,65,UCBPlayer
41597,UCBPlayer,130,275,405,25,40,UCBPlayer
41598,UCBPlayer,106,206,312,10,66,UCBPlayer
41599,UCBPlayer,130,275,405,25,40,UCBPlayer
41600,UCBPlayer,105,210,315,10,65,UCBPlayer
41601,UCBPlayer,131,271,402,25,41,UCBPlayer
41602,UCBPlayer,105,210,315,10,65,UCBPlayer
41603,UCBPlayer,130,275,405,25,40,UCBPlayer
41604,UCBPlayer,105,210,315,10,65,UCBPlayer
41605,UCBPlayer,130,275,405,25,40,UCBPlayer
41606,UCBPlayer,103,203,306,10,68,UCBPlayer
41607,UCBPlayer,128,283,411,25,38,UCBPlayer
41608,UCBPlayer,111,186,297,10,71,UCBPlayer
41609,UCBPlayer,124,299,423,25,34,UCBPlayer
41610,UCBPlayer,115,170,285,10,75,UCBPlayer
41611,UCBPlayer,120,315,435,25,30,UCBPlayer
41612,UCBPlayer,119,154,273,10,79,UCBPlayer
41613,UCBPlayer,112,332,444,25,27,UCBPlayer
41614,UCBPlayer,127,137,264,10,82,UCBPlayer
41615,UCBPlayer,104,349,453,25,24,UCBPlayer
41616,UCBPlayer,126,126,252,7,85,Tie
41617,UCBPlayer,111,351,462,28,22,UCBPlayer
41618,UCBPlayer,116,126,242,3,87,UCBPlayer
41619,UCBPlayer,122,347,469,32,21,UCBPlayer
41620,UCBPlayer,107,132,239,0,87,UCBPlayer
41621,UCBPlayer,132,337,469,35,22,UCBPlayer
41622,UCBPlayer,103,148,251,0,83,UCBPlayer
41623,UCBPlayer,136,321,457,35,26,UCBPlayer
41624,UCBPlayer,99,164,263,0,79,UCBPlayer
41625,UCBPlayer,140,305,445,35,30,UCBPlayer
41626,UCBPlayer,95,180,275,0,75,UCBPlayer
41627,UCBPlayer,144,289,433,35,34,UCBPlayer
41628,UCBPlayer,91,196,287,0,71,UCBPlayer
41629,UCBPlayer,148,273,421,35,38,UCBPlayer
41630,UCBPlayer,87,212,299,0,67,UCBPlayer
41631,UCBPlayer,152,257,409,35,42,UCBPlayer
41632,UCBPlayer,84,224,308,0,64,UCBPlayer
41633,UCBPlayer,146,251,397,32,45,UCBPlayer
41634,UCBPlayer,89,234,323,3,60,UCBPlayer
41635,UCBPlayer,138,243,381,28,49,UCBPlayer
41636,UCBPlayer,97,242,339,7,56,UCBPlayer
41637,UCBPlayer,130,235,365,24,53,UCBPlayer
41638,UCBPlayer,105,250,355,11,52,UCBPlayer
41639,UCBPlayer,122,227,349,20,57,UCBPlayer
41640,UCBPlayer,109,259,368,15,49,UCBPlayer
41641,UCBPlayer,118,218,336,16,60,UCBPlayer
41642,UCBPlayer,117,267,384,19,45,UCBPlayer
41643,UCBPlayer,110,210,320,12,64,UCBPlayer
41644,UCBPlayer,126,271,397,23,42,UCBPlayer
41645,UCBPlayer,105,210,315,10,65,UCBPlayer
41646,UCBPlayer,130,275,405,25,40,UCBPlayer
41647,UCBPlayer,105,210,315,10,65,UCBPlayer
41648,UCBPlayer,130,275,405,25,40,UCBPlayer
41649,UCBPlayer,106,206,312,10,66,UCBPlayer
41650,UCBPlayer,130,275,405,25,40,UCBPlayer
41651,UCBPlayer,105,210,315,10,65,UCBPlayer
41652,UCBPlayer,131,271,402,25,41,UCBPlayer
41653,UCBPlayer,105,210,315,10,65,UCBPlayer
41654,UCBPlayer,130,275,405,25,40,UCBPlayer
41655,UCBPlayer,105,210,315,10,65,UCBPlayer
41656,UCBPlayer,130,275,405,25,40,UCBPlayer
41657,UCBPlayer,103,203,306,10,68,UCBPlayer
41658,UCBPlayer,128,283,411,25,38,UCBPlayer
41659,UCBPlayer,111,186,297,10,71,UCBPlayer
41660,UCBPlayer,124,299,423,25,34,UCBPlayer
41661,UCBPlayer,115,170,285,10,75,UCBPlayer
41662,UCBPlayer,120,315,435,25,30,UCBPlayer
41663,UCBPlayer,119,154,273,10,79,UCBPlayer
41664,UCBPlayer,112,332,444,25,27,UCBPlayer
41665,UCBPlayer,127,137,264,10,82,UCBPlayer
41666,UCBPlayer,104,349,453,25,24,UCBPlayer
41667,UCBPlayer,126,126,252,7,85,Tie
41668,UCBPlayer,111,351,462,28,22,UCBPlayer
41669,UCBPlayer,116,126,242,3,87,UCBPlayer
41670,UCBPlayer,122,347,469,32,21,UCBPlayer
41671,UCBPlayer,107,132,239,0,87,UCBPlayer
41672,UCBPlayer,132,337,469,35,22,UCBPlayer
41673,UCBPlayer,103,148,251,0,83,UCBPlayer
41674,UCBPlayer,136,321,457,35,26,UCBPlayer
41675,UCBPlayer,99,164,263,0,79,UCBPlayer
41676,UCBPlayer,140,305,445,35,30,UCBPlayer
41677,UCBPlayer,95,180,275,0,75,UCBPlayer
41678,UCBPlayer,144,289,433,35,34,UCBPlayer
41679,UCBPlayer,91,196,287,0,71,UCBPlayer
41680,UCBPlayer,148,273,421,35,38,UCBPlayer
41681,UCBPlayer,87,212,299,0,67,UCBPlayer
41682,UCBPlayer,152,257,409,35,42,UCBPlayer
41683,UCBPlayer,84,224,308,0,64,UCBPlayer
41684,UCBPlayer,146,251,397,32,45,UCBPlayer
41685,UCBPlayer,89,234,323,3,60,UCBPlayer
41686,UCBPlayer,138,243,381,28,49,UCBPlayer
41687,UCBPlayer,97,242,339,7,56,UCBPlayer
41688,UCBPlayer,130,235,365,24,53,UCBPlayer
41689,UCBPlayer,105,250,355,11,52,UCBPlayer
41690,UCBPlayer,122,227,349,20,57,UCBPlayer
41691,UCBPlayer,109,259,368,15,49,UCBPlayer
41692,UCBPlayer,118,218,336,16,60,UCBPlayer
41693,UCBPlayer,117,267,384,19,45,UCBPlayer
41694,UCBPlayer,110,210,320,12,64,UCBPlayer
41695,UCBPlayer,126,271,397,23,42,UCBPlayer
41696,UCBPlayer,105,210,315,10,65,UCBPlayer
41697,UCBPlayer,130,275,405,25,40,UCBPlayer
41698,UCBPlayer,105,210,315,10,65,UCBPlayer
41699,UCBPlayer,130,275,405,25,40,UCBPlayer
41700,UCBPlayer,106,206,312,10,66,UCBPlayer
41701,UCBPlayer,130,275,405,25,40,UCBPlayer
41702,UCBPlayer,105,210,315,10,65,UCBPlayer
41703,UCBPlayer,131,271,402,25,41,UCBPlayer
41704,UCBPlayer,105,210,315,10,65,UCBPlayer
41705,UCBPlayer,130,275,405,25,40,UCBPlayer
41706,UCBPlayer,105,210,315,10,65,UCBPlayer
41707,UCBPlayer,130,275,405,25,40,UCBPlayer
41708,UCBPlayer,103,203,306,10,68,UCBPlayer
41709,UCBPlayer,128,283,411,25,38,UCBPlayer
41710,UCBPlayer,111,186,297,10,71,UCBPlayer
41711,UCBPlayer,124,299,423,25,34,UCBPlayer
41712,UCBPlayer,115,170,285,10,75,UCBPlayer
41713,UCBPlayer,120,315,435,25,30,UCBPlayer
41714,UCBPlayer,119,154,273,10,79,UCBPlayer
41715,UCBPlayer,112,332,444,25,27,UCBPlayer
41716,UCBPlayer,127,137,264,10,82,UCBPlayer
41717,UCBPlayer,104,349,453,25,24,UCBPlayer
41718,UCBPlayer,126,126,252,7,85,Tie
41719,UCBPlayer,111,351,462,28,22,UCBPlayer
41720,UCBPlayer,116,126,242,3,87,UCBPlayer
41721,UCBPlayer,122,347,469,32,21,UCBPlayer
41722,UCBPlayer,107,132,239,0,87,UCBPlayer
41723,UCBPlayer,132,337,469,35,22,UCBPlayer
41724,UCBPlayer,103,148,251,0,83,UCBPlayer
41725,UCBPlayer,136,321,457,35,26,UCBPlayer
41726,UCBPlayer,99,164,263,0,79,UCBPlayer
41727,UCBPlayer,140,305,445,35,30,UCBPlayer
41728,UCBPlayer,95,180,275,0,75,UCBPlayer
41729,UCBPlayer,144,289,433,35,34,UCBPlayer
41730,UCBPlayer,91,196,287,0,71,UCBPlayer
41731,UCBPlayer,148,273,421,35,38,UCBPlayer
41732,UCBPlayer,87,212,299,0,67,UCBPlayer
41733,UCBPlayer,152,257,409,35,42,UCBPlayer
41734,UCBPlayer,84,224,308,0,64,UCBPlayer
41735,UCBPlayer,146,251,397,32,45,UCBPlayer
41736,UCBPlayer,89,234,323,3,60,UCBPlayer
41737,UCBPlayer,138,243,381,28,49,UCBPlayer
41738,UCBPlayer,97,242,339,7,56,UCBPlayer
41739,UCBPlayer,130,235,365,24,53,UCBPlayer
41740,UCBPlayer,105,250,355,11,52,UCBPlayer
41741,UCBPlayer,122,227,349,20,57,UCBPlayer
41742,UCBPlayer,109,259,368,15,49,UCBPlayer
41743,UCBPlayer,118,218,336,16,60,UCBPlayer
41744,UCBPlayer,117,267,384,19,45,UCBPlayer
41745,UCBPlayer,110,210,320,12,64,UCBPlayer
41746,UCBPlayer,126,271,397,23,42,UCBPlayer
41747,UCBPlayer,105,210,315,10,65,UCBPlayer
41748,UCBPlayer,130,275,405,25,40,UCBPlayer
41749,UCBPlayer,105,210,315,10,65,UCBPlayer
41750,UCBPlayer,130,275,405,25,40,UCBPlayer
41751,UCBPlayer,106,206,312,10,66,UCBPlayer
41752,UCBPlayer,130,275,405,25,40,UCBPlayer
41753,UCBPlayer,105,210,315,10,65,UCBPlayer
41754,UCBPlayer,131,271,402,25,41,UCBPlayer
41755,UCBPlayer,105,210,315,10,65,UCBPlayer
41756,UCBPlayer,130,275,405,25,40,UCBPlayer
41757,UCBPlayer,105,210,315,10,65,UCBPlayer
41758,UCBPlayer,130,275,405,25,40,UCBPlayer
41759,UCBPlayer,103,203,306,10,68,UCBPlayer
41760,UCBPlayer,128,283,411,25,38,UCBPlayer
41761,UCBPlayer,111,186,297,10,71,UCBPlayer
41762,UCBPlayer,124,299,423,25,34,UCBPlayer
41763,UCBPlayer,115,170,285,10,75,UCBPlayer
41764,UCBPlayer,120,315,435,25,30,UCBPlayer
41765,UCBPlayer,119,154,273,10,79,UCBPlayer
41766,UCBPlayer,112,332,444,25,27,UCBPlayer
41767,UCBPlayer,127,137,264,10,82,UCBPlayer
41768,UCBPlayer,104,349,453,25,24,UCBPlayer
41769,UCBPlayer,126,126,252,7,85,Tie
41770,UCBPlayer,111,351,462,28,22,UCBPlayer
41771,UCBPlayer,116,126,242,3,87,UCBPlayer
41772,UCBPlayer,122,347,469,32,21,UCBPlayer
41773,UCBPlayer,107,132,239,0,87,UCBPlayer
41774,UCBPlayer,132,337,469,35,22,UCBPlayer
41775,UCBPlayer,103,148,251,0,83,UCBPlayer
41776,UCBPlayer,136,321,457,35,26,UCBPlayer
41777,UCBPlayer,99,164,263,0,79,UCBPlayer
41778,UCBPlayer,140,305,445,35,30,UCBPlayer
41779,UCBPlayer,95,180,275,0,75,UCBPlayer
41780,UCBPlayer,144,289,433,35,34,UCBPlayer
41781,UCBPlayer,91,196,287,0,71,UCBPlayer
41782,UCBPlayer,148,273,421,35,38,UCBPlayer
41783,UCBPlayer,87,212,299,0,67,UCBPlayer
41784,UCBPlayer,152,257,409,35,42,UCBPlayer
41785,UCBPlayer,84,224,308,0,64,UCBPlayer
41786,UCBPlayer,146,251,397,32,45,UCBPlayer
41787,UCBPlayer,89,234,323,3,60,UCBPlayer
41788,UCBPlayer,138,243,381,28,49,UCBPlayer
41789,UCBPlayer,97,242,339,7,56,UCBPlayer
41790,UCBPlayer,130,235,365,24,53,UCBPlayer
41791,UCBPlayer,105,250,355,11,52,UCBPlayer
41792,UCBPlayer,122,227,349,20,57,UCBPlayer
41793,UCBPlayer,109,259,368,15,49,UCBPlayer
41794,UCBPlayer,118,218,336,16,60,UCBPlayer
41795,UCBPlayer,117,267,384,19,45,UCBPlayer
41796,UCBPlayer,110,210,320,12,64,UCBPlayer
41797,UCBPlayer,126,271,397,23,42,UCBPlayer
41798,UCBPlayer,105,210,315,10,65,UCBPlayer
41799,UCBPlayer,130,275,405,25,40,UCBPlayer
41800,UCBPlayer,105,210,315,10,65,UCBPlayer
41801,UCBPlayer,130,275,405,25,40,UCBPlayer
41802,UCBPlayer,106,206,312,10,66,UCBPlayer
41803,UCBPlayer,130,275,405,25,40,UCBPlayer
41804,UCBPlayer,105,210,315,10,65,UCBPlayer
41805,UCBPlayer,131,271,402,25,41,UCBPlayer
41806,UCBPlayer,105,210,315,10,65,UCBPlayer
41807,UCBPlayer,130,275,405,25,40,UCBPlayer
41808,UCBPlayer,105,210,315,10,65,UCBPlayer
41809,UCBPlayer,130,275,405,25,40,UCBPlayer
41810,UCBPlayer,103,203,306,10,68,UCBPlayer
41811,UCBPlayer,128,283,411,25,38,UCBPlayer
41812,UCBPlayer,111,186,297,10,71,UCBPlayer
41813,UCBPlayer,124,299,423,25,34,UCBPlayer
41814,UCBPlayer,115,170,285,10,75,UCBPlayer
41815,UCBPlayer,120,315,435,25,30,UCBPlayer
41816,UCBPlayer,119,154,273,10,79,UCBPlayer
41817,UCBPlayer,112,332,444,25,27,UCBPlayer
41818,UCBPlayer,127,137,264,10,82,UCBPlayer
41819,UCBPlayer,104,349,453,25,24,UCBPlayer
41820,UCBPlayer,126,126,252,7,85,Tie
41821,UCBPlayer,111,351,462,28,22,UCBPlayer
41822,UCBPlayer,116,126,242,3,87,UCBPlayer
41823,UCBPlayer,122,347,469,32,21,UCBPlayer
41824,UCBPlayer,107,132,239,0,87,UCBPlayer
41825,UCBPlayer,132,337,469,35,22,UCBPlayer
41826,UCBPlayer,103,148,251,0,83,UCBPlayer
41827,UCBPlayer,136,321,457,35,26,UCBPlayer
41828,UCBPlayer,99,164,263,0,79,UCBPlayer
41829,UCBPlayer,140,305,445,35,30,UCBPlayer
41830,UCBPlayer,95,180,275,0,75,UCBPlayer
41831,UCBPlayer,144,289,433,35,34,UCBPlayer
41832,UCBPlayer,91,196,287,0,71,UCBPlayer
41833,UCBPlayer,148,273,421,35,38,UCBPlayer
41834,UCBPlayer,87,212,299,0,67,UCBPlayer
41835,UCBPlayer,152,257,409,35,42,UCBPlayer
41836,UCBPlayer,84,224,308,0,64,UCBPlayer
41837,UCBPlayer,146,251,397,32,45,UCBPlayer
41838,UCBPlayer,89,234,323,3,60,UCBPlayer
41839,UCBPlayer,138,243,381,28,49,UCBPlayer
41840,UCBPlayer,97,242,339,7,56,UCBPlayer
41841,UCBPlayer,130,235,365,24,53,UCBPlayer
41842,UCBPlayer,105,250,355,11,52,UCBPlayer
41843,UCBPlayer,122,227,349,20,57,UCBPlayer
41844,UCBPlayer,109,259,368,15,49,UCBPlayer
41845,UCBPlayer,118,218,336,16,60,UCBPlayer
41846,UCBPlayer,117,267,384,19,45,UCBPlayer
41847,UCBPlayer,110,210,320,12,64,UCBPlayer
41848,UCBPlayer,126,271,397,23,42,UCBPlayer
41849,UCBPlayer,105,210,315,10,65,UCBPlayer
41850,UCBPlayer,130,275,405,25,40,UCBPlayer
41851,UCBPlayer,105,210,315,10,65,UCBPlayer
41852,UCBPlayer,130,275,405,25,40,UCBPlayer
41853,UCBPlayer,106,206,312,10,66,UCBPlayer
41854,UCBPlayer,130,275,405,25,40,UCBPlayer
41855,UCBPlayer,105,210,315,10,65,UCBPlayer
41856,UCBPlayer,131,271,402,25,41,UCBPlayer
41857,UCBPlayer,105,210,315,10,65,UCBPlayer
41858,UCBPlayer,130,275,405,25,40,UCBPlayer
41859,UCBPlayer,105,210,315,10,65,UCBPlayer
41860,UCBPlayer,130,275,405,25,40,UCBPlayer
41861,UCBPlayer,103,203,306,10,68,UCBPlayer
41862,UCBPlayer,128,283,411,25,38,UCBPlayer
41863,UCBPlayer,111,186,297,10,71,UCBPlayer
41864,UCBPlayer,124,299,423,25,34,UCBPlayer
41865,UCBPlayer,115,170,285,10,75,UCBPlayer
41866,UCBPlayer,120,315,435,25,30,UCBPlayer
41867,UCBPlayer,119,154,273,10,79,UCBPlayer
41868,UCBPlayer,112,332,444,25,27,UCBPlayer
41869,UCBPlayer,127,137,264,10,82,UCBPlayer
41870,UCBPlayer,104,349,453,25,24,UCBPlayer
41871,UCBPlayer,126,126,252,7,85,Tie
41872,UCBPlayer,111,351,462,28,22,UCBPlayer
41873,UCBPlayer,116,126,242,3,87,UCBPlayer
41874,UCBPlayer,122,347,469,32,21,UCBPlayer
41875,UCBPlayer,107,132,239,0,87,UCBPlayer
41876,UCBPlayer,132,337,469,35,22,UCBPlayer
41877,UCBPlayer,103,148,251,0,83,UCBPlayer
41878,UCBPlayer,136,321,457,35,26,UCBPlayer
41879,UCBPlayer,99,164,263,0,79,UCBPlayer
41880,UCBPlayer,140,305,445,35,30,UCBPlayer
41881,UCBPlayer,95,180,275,0,75,UCBPlayer
41882,UCBPlayer,144,289,433,35,34,UCBPlayer
41883,UCBPlayer,91,196,287,0,71,UCBPlayer
41884,UCBPlayer,148,273,421,35,38,UCBPlayer
41885,UCBPlayer,87,212,299,0,67,UCBPlayer
41886,UCBPlayer,152,257,409,35,42,UCBPlayer
41887,UCBPlayer,84,224,308,0,64,UCBPlayer
41888,UCBPlayer,146,251,397,32,45,UCBPlayer
41889,UCBPlayer,89,234,323,3,60,UCBPlayer
41890,UCBPlayer,138,243,381,28,49,UCBPlayer
41891,UCBPlayer,97,242,339,7,56,UCBPlayer
41892,UCBPlayer,130,235,365,24,53,UCBPlayer
41893,UCBPlayer,105,250,355,11,52,UCBPlayer
41894,UCBPlayer,122,227,349,20,57,UCBPlayer
41895,UCBPlayer,109,259,368,15,49,UCBPlayer
41896,UCBPlayer,118,218,336,16,60,UCBPlayer
41897,UCBPlayer,117,267,384,19,45,UCBPlayer
41898,UCBPlayer,110,210,320,12,64,UCBPlayer
41899,UCBPlayer,126,271,397,23,42,UCBPlayer
41900,UCBPlayer,105,210,315,10,65,UCBPlayer
41901,UCBPlayer,130,275,405,25,40,UCBPlayer
41902,UCBPlayer,105,210,315,10,65,UCBPlayer
41903,UCBPlayer,130,275,405,25,40,UCBPlayer
41904,UCBPlayer,106,206,312,10,66,UCBPlayer
41905,UCBPlayer,130,275,405,25,40,UCBPlayer
41906,UCBPlayer,105,210,315,10,65,UCBPlayer
41907,UCBPlayer,131,271,402,25,41,UCBPlayer
41908,UCBPlayer,105,210,315,10,65,UCBPlayer
41909,UCBPlayer,130,275,405,25,40,UCBPlayer
41910,UCBPlayer,105,210,315,10,65,UCBPlayer
41911,UCBPlayer,130,275,405,25,40,UCBPlayer
41912,UCBPlayer,103,203,306,10,68,UCBPlayer
41913,UCBPlayer,128,283,411,25,38,UCBPlayer
41914,UCBPlayer,111,186,297,10,71,UCBPlayer
41915,UCBPlayer,124,299,423,25,34,UCBPlayer
41916,UCBPlayer,115,170,285,10,75,UCBPlayer
41917,UCBPlayer,120,315,435,25,30,UCBPlayer
41918,UCBPlayer,119,154,273,10,79,UCBPlayer
41919,UCBPlayer,112,332,444,25,27,UCBPlayer
41920,UCBPlayer,127,137,264,10,82,UCBPlayer
41921,UCBPlayer,104,349,453,25,24,UCBPlayer
41922,UCBPlayer,126,126,252,7,85,Tie
41923,UCBPlayer,111,351,462,28,22,UCBPlayer
41924,UCBPlayer,116,126,242,3,87,UCBPlayer
41925,UCBPlayer,122,347,469,32,21,UCBPlayer
41926,UCBPlayer,107,132,239,0,87,UCBPlayer
41927,UCBPlayer,132,337,469,35,22,UCBPlayer
41928,UCBPlayer,103,148,251,0,83,UCBPlayer
41929,UCBPlayer,136,321,457,35,26,UCBPlayer
41930,UCBPlayer,99,164,263,0,79,UCBPlayer
41931,UCBPlayer,140,305,445,35,30,UCBPlayer
41932,UCBPlayer,95,180,275,0,75,UCBPlayer
41933,UCBPlayer,144,289,433,35,34,UCBPlayer
41934,UCBPlayer,91,196,287,0,71,UCBPlayer
41935,UCBPlayer,148,273,421,35,38,UCBPlayer
41936,UCBPlayer,87,212,299,0,67,UCBPlayer
41937,UCBPlayer,152,257,409,35,42,UCBPlayer
41938,UCBPlayer,84,224,308,0,64,UCBPlayer
41939,UCBPlayer,146,251,397,32,45,UCBPlayer
41940,UCBPlayer,89,234,323,3,60,UCBPlayer
41941,UCBPlayer,138,243,381,28,49,UCBPlayer
41942,UCBPlayer,97,242,339,7,56,UCBPlayer
41943,UCBPlayer,130,235,365,24,53,UCBPlayer
41944,UCBPlayer,105,250,355,11,52,UCBPlayer
41945,UCBPlayer,122,227,349,20,57,UCBPlayer
41946,UCBPlayer,109,259,368,15,49,UCBPlayer
41947,UCBPlayer,118,218,336,16,60,UCBPlayer
41948,UCBPlayer,117,267,384,19,45,UCBPlayer
41949,UCBPlayer,110,210,320,12,64,UCBPlayer
41950,UCBPlayer,126,271,397,23,42,UCBPlayer
41951,UCBPlayer,105,210,315,10,65,UCBPlayer
41952,UCBPlayer,130,275,405,25,40,UCBPlayer
41953,UCBPlayer,105,210,315,10,65,UCBPlayer
41954,UCBPlayer,130,275,405,25,40,UCBPlayer
41955,UCBPlayer,106,206,312,10,66,UCBPlayer
41956,UCBPlayer,130,275,405,25,40,UCBPlayer
41957,UCBPlayer,105,210,315,10,65,UCBPlayer
41958,UCBPlayer,131,271,402,25,41,UCBPlayer
41959,UCBPlayer,105,210,315,10,65,UCBPlayer
41960,UCBPlayer,130,275,405,25,40,UCBPlayer
41961,UCBPlayer,105,210,315,10,65,UCBPlayer
41962,UCBPlayer,130,275,405,25,40,UCBPlayer
41963,UCBPlayer,103,203,306,10,68,UCBPlayer
41964,UCBPlayer,128,283,411,25,38,UCBPlayer
41965,UCBPlayer,111,186,297,10,71,UCBPlayer
41966,UCBPlayer,124,299,423,25,34,UCBPlayer
41967,UCBPlayer,115,170,285,10,75,UCBPlayer
41968,UCBPlayer,120,315,435,25,30,UCBPlayer
41969,UCBPlayer,119,154,273,10,79,UCBPlayer
41970,UCBPlayer,112,332,444,25,27,UCBPlayer
41971,UCBPlayer,127,137,264,10,82,UCBPlayer
41972,UCBPlayer,104,349,453,25,24,UCBPlayer
41973,UCBPlayer,126,126,252,7,85,Tie
41974,UCBPlayer,111,351,462,28,22,UCBPlayer
41975,UCBPlayer,116,126,242,3,87,UCBPlayer
41976,UCBPlayer,122,347,469,32,21,UCBPlayer
41977,UCBPlayer,107,132,239,0,87,UCBPlayer
41978,UCBPlayer,132,337,469,35,22,UCBPlayer
41979,UCBPlayer,103,148,251,0,83,UCBPlayer
41980,UCBPlayer,136,321,457,35,26,UCBPlayer
41981,UCBPlayer,99,164,263,0,79,UCBPlayer
41982,UCBPlayer,140,305,445,35,30,UCBPlayer
41983,UCBPlayer,95,180,275,0,75,UCBPlayer
41984,UCBPlayer,144,289,433,35,34,UCBPlayer
41985,UCBPlayer,91,196,287,0,71,UCBPlayer
41986,UCBPlayer,148,273,421,35,38,UCBPlayer
41987,UCBPlayer,87,212,299,0,67,UCBPlayer
41988,UCBPlayer,152,257,409,35,42,UCBPlayer
41989,UCBPlayer,84,224,308,0,64,UCBPlayer
41990,UCBPlayer,146,251,397,32,45,UCBPlayer
41991,UCBPlayer,89,234,323,3,60,UCBPlayer
41992,UCBPlayer,138,243,381,28,49,UCBPlayer
41993,UCBPlayer,97,242,339,7,56,UCBPlayer
41994,UCBPlayer,130,235,365,24,53,UCBPlayer
41995,UCBPlayer,105,250,355,11,52,UCBPlayer
41996,UCBPlayer,122,227,349,20,57,UCBPlayer
41997,UCBPlayer,109,259,368,15,49,UCBPlayer
41998,UCBPlayer,118,218,336,16,60,UCBPlayer
41999,UCBPlayer,117,267,384,19,45,UCBPlayer
42000,UCBPlayer,110,210,320,12,64,UCBPlayer
42001,UCBPlayer,126,271,397,23,42,UCBPlayer
42002,UCBPlayer,105,210,315,10,65,UCBPlayer
42003,UCBPlayer,130,275,405,25,40,UCBPlayer
42004,UCBPlayer,105,210,315,10,65,UCBPlayer
42005,UCBPlayer,130,275,405,25,40,UCBPlayer
42006,UCBPlayer,106,206,312,10,66,UCBPlayer
42007,UCBPlayer,130,275,405,25,40,UCBPlayer
42008,UCBPlayer,105,210,315,10,65,UCBPlayer
42009,UCBPlayer,131,271,402,25,41,UCBPlayer
42010,UCBPlayer,105,210,315,10,65,UCBPlayer
42011,UCBPlayer,130,275,405,25,40,UCBPlayer
42012,UCBPlayer,105,210,315,10,65,UCBPlayer
42013,UCBPlayer,130,275,405,25,40,UCBPlayer
42014,UCBPlayer,103,203,306,10,68,UCBPlayer
42015,UCBPlayer,128,283,411,25,38,UCBPlayer
42016,UCBPlayer,111,186,297,10,71,UCBPlayer
42017,UCBPlayer,124,299,423,25,34,UCBPlayer
42018,UCBPlayer,115,170,285,10,75,UCBPlayer
42019,UCBPlayer,120,315,435,25,30,UCBPlayer
42020,UCBPlayer,119,154,273,10,79,UCBPlayer
42021,UCBPlayer,112,332,444,25,27,UCBPlayer
42022,UCBPlayer,127,137,264,10,82,UCBPlayer
42023,UCBPlayer,104,349,453,25,24,UCBPlayer
42024,UCBPlayer,126,126,252,7,85,Tie
42025,UCBPlayer,111,351,462,28,22,UCBPlayer
42026,UCBPlayer,116,126,242,3,87,UCBPlayer
42027,UCBPlayer,122,347,469,32,21,UCBPlayer
42028,UCBPlayer,107,132,239,0,87,UCBPlayer
42029,UCBPlayer,132,337,469,35,22,UCBPlayer
42030,UCBPlayer,103,148,251,0,83,UCBPlayer
42031,UCBPlayer,136,321,457,35,26,UCBPlayer
42032,UCBPlayer,99,164,263,0,79,UCBPlayer
42033,UCBPlayer,140,305,445,35,30,UCBPlayer
42034,UCBPlayer,95,180,275,0,75,UCBPlayer
42035,UCBPlayer,144,289,433,35,34,UCBPlayer
42036,UCBPlayer,91,196,287,0,71,UCBPlayer
42037,UCBPlayer,148,273,421,35,38,UCBPlayer
42038,UCBPlayer,87,212,299,0,67,UCBPlayer
42039,UCBPlayer,152,257,409,35,42,UCBPlayer
42040,UCBPlayer,84,224,308,0,64,UCBPlayer
42041,UCBPlayer,146,251,397,32,45,UCBPlayer
42042,UCBPlayer,89,234,323,3,60,UCBPlayer
42043,UCBPlayer,138,243,381,28,49,UCBPlayer
42044,UCBPlayer,97,242,339,7,56,UCBPlayer
42045,UCBPlayer,130,235,365,24,53,UCBPlayer
42046,UCBPlayer,105,250,355,11,52,UCBPlayer
42047,UCBPlayer,122,227,349,20,57,UCBPlayer
42048,UCBPlayer,109,259,368,15,49,UCBPlayer
42049,UCBPlayer,118,218,336,16,60,UCBPlayer
42050,UCBPlayer,117,267,384,19,45,UCBPlayer
42051,UCBPlayer,110,210,320,12,64,UCBPlayer
42052,UCBPlayer,126,271,397,23,42,UCBPlayer
42053,UCBPlayer,105,210,315,10,65,UCBPlayer
42054,UCBPlayer,130,275,405,25,40,UCBPlayer
42055,UCBPlayer,105,210,315,10,65,UCBPlayer
42056,UCBPlayer,130,275,405,25,40,UCBPlayer
42057,UCBPlayer,106,206,312,10,66,UCBPlayer
42058,UCBPlayer,130,275,405,25,40,UCBPlayer
42059,UCBPlayer,105,210,315,10,65,UCBPlayer
42060,UCBPlayer,131,271,402,25,41,UCBPlayer
42061,UCBPlayer,105,210,315,10,65,UCBPlayer
42062,UCBPlayer,130,275,405,25,40,UCBPlayer
42063,UCBPlayer,105,210,315,10,65,UCBPlayer
42064,UCBPlayer,130,275,405,25,40,UCBPlayer
42065,UCBPlayer,103,203,306,10,68,UCBPlayer
42066,UCBPlayer,128,283,411,25,38,UCBPlayer
42067,UCBPlayer,111,186,297,10,71,UCBPlayer
42068,UCBPlayer,124,299,423,25,34,UCBPlayer
42069,UCBPlayer,115,170,285,10,75,UCBPlayer
42070,UCBPlayer,120,315,435,25,30,UCBPlayer
42071,UCBPlayer,119,154,273,10,79,UCBPlayer
42072,UCBPlayer,112,332,444,25,27,UCBPlayer
42073,UCBPlayer,127,137,264,10,82,UCBPlayer
42074,UCBPlayer,104,349,453,25,24,UCBPlayer
42075,UCBPlayer,126,126,252,7,85,Tie
42076,UCBPlayer,111,351,462,28,22,UCBPlayer
42077,UCBPlayer,116,126,242,3,87,UCBPlayer
42078,UCBPlayer,122,347,469,32,21,UCBPlayer
42079,UCBPlayer,107,132,239,0,87,UCBPlayer
42080,UCBPlayer,132,337,469,35,22,UCBPlayer
42081,UCBPlayer,103,148,251,0,83,UCBPlayer
42082,UCBPlayer,136,321,457,35,26,UCBPlayer
42083,UCBPlayer,99,164,263,0,79,UCBPlayer
42084,UCBPlayer,140,305,445,35,30,UCBPlayer
42085,UCBPlayer,95,180,275,0,75,UCBPlayer
42086,UCBPlayer,144,289,433,35,34,UCBPlayer
42087,UCBPlayer,91,196,287,0,71,UCBPlayer
42088,UCBPlayer,148,273,421,35,38,UCBPlayer
42089,UCBPlayer,87,212,299,0,67,UCBPlayer
42090,UCBPlayer,152,257,409,35,42,UCBPlayer
42091,UCBPlayer,84,224,308,0,64,UCBPlayer
42092,UCBPlayer,146,251,397,32,45,UCBPlayer
42093,UCBPlayer,89,234,323,3,60,UCBPlayer
42094,UCBPlayer,138,243,381,28,49,UCBPlayer
42095,UCBPlayer,97,242,339,7,56,UCBPlayer
42096,UCBPlayer,130,235,365,24,53,UCBPlayer
42097,UCBPlayer,105,250,355,11,52,UCBPlayer
42098,UCBPlayer,122,227,349,20,57,UCBPlayer
42099,UCBPlayer,109,259,368,15,49,UCBPlayer
42100,UCBPlayer,118,218,336,16,60,UCBPlayer
42101,UCBPlayer,117,267,384,19,45,UCBPlayer
42102,UCBPlayer,110,210,320,12,64,UCBPlayer
42103,UCBPlayer,126,271,397,23,42,UCBPlayer
42104,UCBPlayer,105,210,315,10,65,UCBPlayer
42105,UCBPlayer,130,275,405,25,40,UCBPlayer
42106,UCBPlayer,105,210,315,10,65,UCBPlayer
42107,UCBPlayer,130,275,405,25,40,UCBPlayer
42108,UCBPlayer,106,206,312,10,66,UCBPlayer
42109,UCBPlayer,130,275,405,25,40,UCBPlayer
42110,UCBPlayer,105,210,315,10,65,UCBPlayer
42111,UCBPlayer,131,271,402,25,41,UCBPlayer
42112,UCBPlayer,105,210,315,10,65,UCBPlayer
42113,UCBPlayer,130,275,405,25,40,UCBPlayer
42114,UCBPlayer,105,210,315,10,65,UCBPlayer
42115,UCBPlayer,130,275,405,25,40,UCBPlayer
42116,UCBPlayer,103,203,306,10,68,UCBPlayer
42117,UCBPlayer,128,283,411,25,38,UCBPlayer
42118,UCBPlayer,111,186,297,10,71,UCBPlayer
42119,UCBPlayer,124,299,423,25,34,UCBPlayer
42120,UCBPlayer,115,170,285,10,75,UCBPlayer
42121,UCBPlayer,120,315,435,25,30,UCBPlayer
42122,UCBPlayer,119,154,273,10,79,UCBPlayer
42123,UCBPlayer,112,332,444,25,27,UCBPlayer
42124,UCBPlayer,127,137,264,10,82,UCBPlayer
42125,UCBPlayer,104,349,453,25,24,UCBPlayer
42126,UCBPlayer,126,126,252,7,85,Tie
42127,UCBPlayer,111,351,462,28,22,UCBPlayer
42128,UCBPlayer,116,126,242,3,87,UCBPlayer
42129,UCBPlayer,122,347,469,32,21,UCBPlayer
42130,UCBPlayer,107,132,239,0,87,UCBPlayer
42131,UCBPlayer,132,337,469,35,22,UCBPlayer
42132,UCBPlayer,103,148,251,0,83,UCBPlayer
42133,UCBPlayer,136,321,457,35,26,UCBPlayer
42134,UCBPlayer,99,164,263,0,79,UCBPlayer
42135,UCBPlayer,140,305,445,35,30,UCBPlayer
42136,UCBPlayer,95,180,275,0,75,UCBPlayer
42137,UCBPlayer,144,289,433,35,34,UCBPlayer
42138,UCBPlayer,91,196,287,0,71,UCBPlayer
42139,UCBPlayer,148,273,421,35,38,UCBPlayer
42140,UCBPlayer,87,212,299,0,67,UCBPlayer
42141,UCBPlayer,152,257,409,35,42,UCBPlayer
42142,UCBPlayer,84,224,308,0,64,UCBPlayer
42143,UCBPlayer,146,251,397,32,45,UCBPlayer
42144,UCBPlayer,89,234,323,3,60,UCBPlayer
42145,UCBPlayer,138,243,381,28,49,UCBPlayer
42146,UCBPlayer,97,242,339,7,56,UCBPlayer
42147,UCBPlayer,130,235,365,24,53,UCBPlayer
42148,UCBPlayer,105,250,355,11,52,UCBPlayer
42149,UCBPlayer,122,227,349,20,57,UCBPlayer
42150,UCBPlayer,109,259,368,15,49,UCBPlayer
42151,UCBPlayer,118,218,336,16,60,UCBPlayer
42152,UCBPlayer,117,267,384,19,45,UCBPlayer
42153,UCBPlayer,110,210,320,12,64,UCBPlayer
42154,UCBPlayer,126,271,397,23,42,UCBPlayer
42155,UCBPlayer,105,210,315,10,65,UCBPlayer
42156,UCBPlayer,130,275,405,25,40,UCBPlayer
42157,UCBPlayer,105,210,315,10,65,UCBPlayer
42158,UCBPlayer,130,275,405,25,40,UCBPlayer
42159,UCBPlayer,106,206,312,10,66,UCBPlayer
42160,UCBPlayer,130,275,405,25,40,UCBPlayer
42161,UCBPlayer,105,210,315,10,65,UCBPlayer
42162,UCBPlayer,131,271,402,25,41,UCBPlayer
42163,UCBPlayer,105,210,315,10,65,UCBPlayer
42164,UCBPlayer,130,275,405,25,40,UCBPlayer
42165,UCBPlayer,105,210,315,10,65,UCBPlayer
42166,UCBPlayer,130,275,405,25,40,UCBPlayer
42167,UCBPlayer,103,203,306,10,68,UCBPlayer
42168,UCBPlayer,128,283,411,25,38,UCBPlayer
42169,UCBPlayer,111,186,297,10,71,UCBPlayer
42170,UCBPlayer,124,299,423,25,34,UCBPlayer
42171,UCBPlayer,115,170,285,10,75,UCBPlayer
42172,UCBPlayer,120,315,435,25,30,UCBPlayer
42173,UCBPlayer,119,154,273,10,79,UCBPlayer
42174,UCBPlayer,112,332,444,25,27,UCBPlayer
42175,UCBPlayer,127,137,264,10,82,UCBPlayer
42176,UCBPlayer,104,349,453,25,24,UCBPlayer
42177,UCBPlayer,126,126,252,7,85,Tie
42178,UCBPlayer,111,351,462,28,22,UCBPlayer
42179,UCBPlayer,116,126,242,3,87,UCBPlayer
42180,UCBPlayer,122,347,469,32,21,UCBPlayer
42181,UCBPlayer,107,132,239,0,87,UCBPlayer
42182,UCBPlayer,132,337,469,35,22,UCBPlayer
42183,UCBPlayer,103,148,251,0,83,UCBPlayer
42184,UCBPlayer,136,321,457,35,26,UCBPlayer
42185,UCBPlayer,99,164,263,0,79,UCBPlayer
42186,UCBPlayer,140,305,445,35,30,UCBPlayer
42187,UCBPlayer,95,180,275,0,75,UCBPlayer
42188,UCBPlayer,144,289,433,35,34,UCBPlayer
42189,UCBPlayer,91,196,287,0,71,UCBPlayer
42190,UCBPlayer,148,273,421,35,38,UCBPlayer
42191,UCBPlayer,87,212,299,0,67,UCBPlayer
42192,UCBPlayer,152,257,409,35,42,UCBPlayer
42193,UCBPlayer,84,224,308,0,64,UCBPlayer
42194,UCBPlayer,146,251,397,32,45,UCBPlayer
42195,UCBPlayer,89,234,323,3,60,UCBPlayer
42196,UCBPlayer,138,243,381,28,49,UCBPlayer
42197,UCBPlayer,97,242,339,7,56,UCBPlayer
42198,UCBPlayer,130,235,365,24,53,UCBPlayer
42199,UCBPlayer,105,250,355,11,52,UCBPlayer
42200,UCBPlayer,122,227,349,20,57,UCBPlayer
42201,UCBPlayer,109,259,368,15,49,UCBPlayer
42202,UCBPlayer,118,218,336,16,60,UCBPlayer
42203,UCBPlayer,117,267,384,19,45,UCBPlayer
42204,UCBPlayer,110,210,320,12,64,UCBPlayer
42205,UCBPlayer,126,271,397,23,42,UCBPlayer
42206,UCBPlayer,105,210,315,10,65,UCBPlayer
42207,UCBPlayer,130,275,405,25,40,UCBPlayer
42208,UCBPlayer,105,210,315,10,65,UCBPlayer
42209,UCBPlayer,130,275,405,25,40,UCBPlayer
42210,UCBPlayer,106,206,312,10,66,UCBPlayer
42211,UCBPlayer,130,275,405,25,40,UCBPlayer
42212,UCBPlayer,105,210,315,10,65,UCBPlayer
42213,UCBPlayer,131,271,402,25,41,UCBPlayer
42214,UCBPlayer,105,210,315,10,65,UCBPlayer
42215,UCBPlayer,130,275,405,25,40,UCBPlayer
42216,UCBPlayer,105,210,315,10,65,UCBPlayer
42217,UCBPlayer,130,275,405,25,40,UCBPlayer
42218,UCBPlayer,103,203,306,10,68,UCBPlayer
42219,UCBPlayer,128,283,411,25,38,UCBPlayer
42220,UCBPlayer,111,186,297,10,71,UCBPlayer
42221,UCBPlayer,124,299,423,25,34,UCBPlayer
42222,UCBPlayer,115,170,285,10,75,UCBPlayer
42223,UCBPlayer,120,315,435,25,30,UCBPlayer
42224,UCBPlayer,119,154,273,10,79,UCBPlayer
42225,UCBPlayer,112,332,444,25,27,UCBPlayer
42226,UCBPlayer,127,137,264,10,82,UCBPlayer
42227,UCBPlayer,104,349,453,25,24,UCBPlayer
42228,UCBPlayer,126,126,252,7,85,Tie
42229,UCBPlayer,111,351,462,28,22,UCBPlayer
42230,UCBPlayer,116,126,242,3,87,UCBPlayer
42231,UCBPlayer,122,347,469,32,21,UCBPlayer
42232,UCBPlayer,107,132,239,0,87,UCBPlayer
42233,UCBPlayer,132,337,469,35,22,UCBPlayer
42234,UCBPlayer,103,148,251,0,83,UCBPlayer
42235,UCBPlayer,136,321,457,35,26,UCBPlayer
42236,UCBPlayer,99,164,263,0,79,UCBPlayer
42237,UCBPlayer,140,305,445,35,30,UCBPlayer
42238,UCBPlayer,95,180,275,0,75,UCBPlayer
42239,UCBPlayer,144,289,433,35,34,UCBPlayer
42240,UCBPlayer,91,196,287,0,71,UCBPlayer
42241,UCBPlayer,148,273,421,35,38,UCBPlayer
42242,UCBPlayer,87,212,299,0,67,UCBPlayer
42243,UCBPlayer,152,257,409,35,42,UCBPlayer
42244,UCBPlayer,84,224,308,0,64,UCBPlayer
42245,UCBPlayer,146,251,397,32,45,UCBPlayer
42246,UCBPlayer,89,234,323,3,60,UCBPlayer
42247,UCBPlayer,138,243,381,28,49,UCBPlayer
42248,UCBPlayer,97,242,339,7,56,UCBPlayer
42249,UCBPlayer,130,235,365,24,53,UCBPlayer
42250,UCBPlayer,105,250,355,11,52,UCBPlayer
42251,UCBPlayer,122,227,349,20,57,UCBPlayer
42252,UCBPlayer,109,259,368,15,49,UCBPlayer
42253,UCBPlayer,118,218,336,16,60,UCBPlayer
42254,UCBPlayer,117,267,384,19,45,UCBPlayer
42255,UCBPlayer,110,210,320,12,64,UCBPlayer
42256,UCBPlayer,126,271,397,23,42,UCBPlayer
42257,UCBPlayer,105,210,315,10,65,UCBPlayer
42258,UCBPlayer,130,275,405,25,40,UCBPlayer
42259,UCBPlayer,105,210,315,10,65,UCBPlayer
42260,UCBPlayer,130,275,405,25,40,UCBPlayer
42261,UCBPlayer,106,206,312,10,66,UCBPlayer
42262,UCBPlayer,130,275,405,25,40,UCBPlayer
42263,UCBPlayer,105,210,315,10,65,UCBPlayer
42264,UCBPlayer,131,271,402,25,41,UCBPlayer
42265,UCBPlayer,105,210,315,10,65,UCBPlayer
42266,UCBPlayer,130,275,405,25,40,UCBPlayer
42267,UCBPlayer,105,210,315,10,65,UCBPlayer
42268,UCBPlayer,130,275,405,25,40,UCBPlayer
42269,UCBPlayer,103,203,306,10,68,UCBPlayer
42270,UCBPlayer,128,283,411,25,38,UCBPlayer
42271,UCBPlayer,111,186,297,10,71,UCBPlayer
42272,UCBPlayer,124,299,423,25,34,UCBPlayer
42273,UCBPlayer,115,170,285,10,75,UCBPlayer
42274,UCBPlayer,120,315,435,25,30,UCBPlayer
42275,UCBPlayer,119,154,273,10,79,UCBPlayer
42276,UCBPlayer,112,332,444,25,27,UCBPlayer
42277,UCBPlayer,127,137,264,10,82,UCBPlayer
42278,UCBPlayer,104,349,453,25,24,UCBPlayer
42279,UCBPlayer,126,126,252,7,85,Tie
42280,UCBPlayer,111,351,462,28,22,UCBPlayer
42281,UCBPlayer,116,126,242,3,87,UCBPlayer
42282,UCBPlayer,122,347,469,32,21,UCBPlayer
42283,UCBPlayer,107,132,239,0,87,UCBPlayer
42284,UCBPlayer,132,337,469,35,22,UCBPlayer
42285,UCBPlayer,103,148,251,0,83,UCBPlayer
42286,UCBPlayer,136,321,457,35,26,UCBPlayer
42287,UCBPlayer,99,164,263,0,79,UCBPlayer
42288,UCBPlayer,140,305,445,35,30,UCBPlayer
42289,UCBPlayer,95,180,275,0,75,UCBPlayer
42290,UCBPlayer,144,289,433,35,34,UCBPlayer
42291,UCBPlayer,91,196,287,0,71,UCBPlayer
42292,UCBPlayer,148,273,421,35,38,UCBPlayer
42293,UCBPlayer,87,212,299,0,67,UCBPlayer
42294,UCBPlayer,152,257,409,35,42,UCBPlayer
42295,UCBPlayer,84,224,308,0,64,UCBPlayer
42296,UCBPlayer,146,251,397,32,45,UCBPlayer
42297,UCBPlayer,89,234,323,3,60,UCBPlayer
42298,UCBPlayer,138,243,381,28,49,UCBPlayer
42299,UCBPlayer,97,242,339,7,56,UCBPlayer
42300,UCBPlayer,130,235,365,24,53,UCBPlayer
42301,UCBPlayer,105,250,355,11,52,UCBPlayer
42302,UCBPlayer,122,227,349,20,57,UCBPlayer
42303,UCBPlayer,109,259,368,15,49,UCBPlayer
42304,UCBPlayer,118,218,336,16,60,UCBPlayer
42305,UCBPlayer,117,267,384,19,45,UCBPlayer
42306,UCBPlayer,110,210,320,12,64,UCBPlayer
42307,UCBPlayer,126,271,397,23,42,UCBPlayer
42308,UCBPlayer,105,210,315,10,65,UCBPlayer
42309,UCBPlayer,130,275,405,25,40,UCBPlayer
42310,UCBPlayer,105,210,315,10,65,UCBPlayer
42311,UCBPlayer,130,275,405,25,40,UCBPlayer
42312,UCBPlayer,106,206,312,10,66,UCBPlayer
42313,UCBPlayer,130,275,405,25,40,UCBPlayer
42314,UCBPlayer,105,210,315,10,65,UCBPlayer
42315,UCBPlayer,131,271,402,25,41,UCBPlayer
42316,UCBPlayer,105,210,315,10,65,UCBPlayer
42317,UCBPlayer,130,275,405,25,40,UCBPlayer
42318,UCBPlayer,105,210,315,10,65,UCBPlayer
42319,UCBPlayer,130,275,405,25,40,UCBPlayer
42320,UCBPlayer,103,203,306,10,68,UCBPlayer
42321,UCBPlayer,128,283,411,25,38,UCBPlayer
42322,UCBPlayer,111,186,297,10,71,UCBPlayer
42323,UCBPlayer,124,299,423,25,34,UCBPlayer
42324,UCBPlayer,115,170,285,10,75,UCBPlayer
42325,UCBPlayer,120,315,435,25,30,UCBPlayer
42326,UCBPlayer,119,154,273,10,79,UCBPlayer
42327,UCBPlayer,112,332,444,25,27,UCBPlayer
42328,UCBPlayer,127,137,264,10,82,UCBPlayer
42329,UCBPlayer,104,349,453,25,24,UCBPlayer
42330,UCBPlayer,126,126,252,7,85,Tie
42331,UCBPlayer,111,351,462,28,22,UCBPlayer
42332,UCBPlayer,116,126,242,3,87,UCBPlayer
42333,UCBPlayer,122,347,469,32,21,UCBPlayer
42334,UCBPlayer,107,132,239,0,87,UCBPlayer
42335,UCBPlayer,132,337,469,35,22,UCBPlayer
42336,UCBPlayer,103,148,251,0,83,UCBPlayer
42337,UCBPlayer,136,321,457,35,26,UCBPlayer
42338,UCBPlayer,99,164,263,0,79,UCBPlayer
42339,UCBPlayer,140,305,445,35,30,UCBPlayer
42340,UCBPlayer,95,180,275,0,75,UCBPlayer
42341,UCBPlayer,144,289,433,35,34,UCBPlayer
42342,UCBPlayer,91,196,287,0,71,UCBPlayer
42343,UCBPlayer,148,273,421,35,38,UCBPlayer
42344,UCBPlayer,87,212,299,0,67,UCBPlayer
42345,UCBPlayer,152,257,409,35,42,UCBPlayer
42346,UCBPlayer,84,224,308,0,64,UCBPlayer
42347,UCBPlayer,146,251,397,32,45,UCBPlayer
42348,UCBPlayer,89,234,323,3,60,UCBPlayer
42349,UCBPlayer,138,243,381,28,49,UCBPlayer
42350,UCBPlayer,97,242,339,7,56,UCBPlayer
42351,UCBPlayer,130,235,365,24,53,UCBPlayer
42352,UCBPlayer,105,250,355,11,52,UCBPlayer
42353,UCBPlayer,122,227,349,20,57,UCBPlayer
42354,UCBPlayer,109,259,368,15,49,UCBPlayer
42355,UCBPlayer,118,218,336,16,60,UCBPlayer
42356,UCBPlayer,117,267,384,19,45,UCBPlayer
42357,UCBPlayer,110,210,320,12,64,UCBPlayer
42358,UCBPlayer,126,271,397,23,42,UCBPlayer
42359,UCBPlayer,105,210,315,10,65,UCBPlayer
42360,UCBPlayer,130,275,405,25,40,UCBPlayer
42361,UCBPlayer,105,210,315,10,65,UCBPlayer
42362,UCBPlayer,130,275,405,25,40,UCBPlayer
42363,UCBPlayer,106,206,312,10,66,UCBPlayer
42364,UCBPlayer,130,275,405,25,40,UCBPlayer
42365,UCBPlayer,105,210,315,10,65,UCBPlayer
42366,UCBPlayer,131,271,402,25,41,UCBPlayer
42367,UCBPlayer,105,210,315,10,65,UCBPlayer
42368,UCBPlayer,130,275,405,25,40,UCBPlayer
42369,UCBPlayer,105,210,315,10,65,UCBPlayer
42370,UCBPlayer,130,275,405,25,40,UCBPlayer
42371,UCBPlayer,103,203,306,10,68,UCBPlayer
42372,UCBPlayer,128,283,411,25,38,UCBPlayer
42373,UCBPlayer,111,186,297,10,71,UCBPlayer
42374,UCBPlayer,124,299,423,25,34,UCBPlayer
42375,UCBPlayer,115,170,285,10,75,UCBPlayer
42376,UCBPlayer,120,315,435,25,30,UCBPlayer
42377,UCBPlayer,119,154,273,10,79,UCBPlayer
42378,UCBPlayer,112,332,444,25,27,UCBPlayer
42379,UCBPlayer,127,137,264,10,82,UCBPlayer
42380,UCBPlayer,104,349,453,25,24,UCBPlayer
42381,UCBPlayer,126,126,252,7,85,Tie
42382,UCBPlayer,111,351,462,28,22,UCBPlayer
42383,UCBPlayer,116,126,242,3,87,UCBPlayer
42384,UCBPlayer,122,347,469,32,21,UCBPlayer
42385,UCBPlayer,107,132,239,0,87,UCBPlayer
42386,UCBPlayer,132,337,469,35,22,UCBPlayer
42387,UCBPlayer,103,148,251,0,83,UCBPlayer
42388,UCBPlayer,136,321,457,35,26,UCBPlayer
42389,UCBPlayer,99,164,263,0,79,UCBPlayer
42390,UCBPlayer,140,305,445,35,30,UCBPlayer
42391,UCBPlayer,95,180,275,0,75,UCBPlayer
42392,UCBPlayer,144,289,433,35,34,UCBPlayer
42393,UCBPlayer,91,196,287,0,71,UCBPlayer
42394,UCBPlayer,148,273,421,35,38,UCBPlayer
42395,UCBPlayer,87,212,299,0,67,UCBPlayer
42396,UCBPlayer,152,257,409,35,42,UCBPlayer
42397,UCBPlayer,84,224,308,0,64,UCBPlayer
42398,UCBPlayer,146,251,397,32,45,UCBPlayer
42399,UCBPlayer,89,234,323,3,60,UCBPlayer
42400,UCBPlayer,138,243,381,28,49,UCBPlayer
42401,UCBPlayer,97,242,339,7,56,UCBPlayer
42402,UCBPlayer,130,235,365,24,53,UCBPlayer
42403,UCBPlayer,105,250,355,11,52,UCBPlayer
42404,UCBPlayer,122,227,349,20,57,UCBPlayer
42405,UCBPlayer,109,259,368,15,49,UCBPlayer
42406,UCBPlayer,118,218,336,16,60,UCBPlayer
42407,UCBPlayer,117,267,384,19,45,UCBPlayer
42408,UCBPlayer,110,210,320,12,64,UCBPlayer
42409,UCBPlayer,126,271,397,23,42,UCBPlayer
42410,UCBPlayer,105,210,315,10,65,UCBPlayer
42411,UCBPlayer,130,275,405,25,40,UCBPlayer
42412,UCBPlayer,105,210,315,10,65,UCBPlayer
42413,UCBPlayer,130,275,405,25,40,UCBPlayer
42414,UCBPlayer,106,206,312,10,66,UCBPlayer
42415,UCBPlayer,130,275,405,25,40,UCBPlayer
42416,UCBPlayer,105,210,315,10,65,UCBPlayer
42417,UCBPlayer,131,271,402,25,41,UCBPlayer
42418,UCBPlayer,105,210,315,10,65,UCBPlayer
42419,UCBPlayer,130,275,405,25,40,UCBPlayer
42420,UCBPlayer,105,210,315,10,65,UCBPlayer
42421,UCBPlayer,130,275,405,25,40,UCBPlayer
42422,UCBPlayer,103,203,306,10,68,UCBPlayer
42423,UCBPlayer,128,283,411,25,38,UCBPlayer
42424,UCBPlayer,111,186,297,10,71,UCBPlayer
42425,UCBPlayer,124,299,423,25,34,UCBPlayer
42426,UCBPlayer,115,170,285,10,75,UCBPlayer
42427,UCBPlayer,120,315,435,25,30,UCBPlayer
42428,UCBPlayer,119,154,273,10,79,UCBPlayer
42429,UCBPlayer,112,332,444,25,27,UCBPlayer
42430,UCBPlayer,127,137,264,10,82,UCBPlayer
42431,UCBPlayer,104,349,453,25,24,UCBPlayer
42432,UCBPlayer,126,126,252,7,85,Tie
42433,UCBPlayer,111,351,462,28,22,UCBPlayer
42434,UCBPlayer,116,126,242,3,87,UCBPlayer
42435,UCBPlayer,122,347,469,32,21,UCBPlayer
42436,UCBPlayer,107,132,239,0,87,UCBPlayer
42437,UCBPlayer,132,337,469,35,22,UCBPlayer
42438,UCBPlayer,103,148,251,0,83,UCBPlayer
42439,UCBPlayer,136,321,457,35,26,UCBPlayer
42440,UCBPlayer,99,164,263,0,79,UCBPlayer
42441,UCBPlayer,140,305,445,35,30,UCBPlayer
42442,UCBPlayer,95,180,275,0,75,UCBPlayer
42443,UCBPlayer,144,289,433,35,34,UCBPlayer
42444,UCBPlayer,91,196,287,0,71,UCBPlayer
42445,UCBPlayer,148,273,421,35,38,UCBPlayer
42446,UCBPlayer,87,212,299,0,67,UCBPlayer
42447,UCBPlayer,152,257,409,35,42,UCBPlayer
42448,UCBPlayer,84,224,308,0,64,UCBPlayer
42449,UCBPlayer,146,251,397,32,45,UCBPlayer
42450,UCBPlayer,89,234,323,3,60,UCBPlayer
42451,UCBPlayer,138,243,381,28,49,UCBPlayer
42452,UCBPlayer,97,242,339,7,56,UCBPlayer
42453,UCBPlayer,130,235,365,24,53,UCBPlayer
42454,UCBPlayer,105,250,355,11,52,UCBPlayer
42455,UCBPlayer,122,227,349,20,57,UCBPlayer
42456,UCBPlayer,109,259,368,15,49,UCBPlayer
42457,UCBPlayer,118,218,336,16,60,UCBPlayer
42458,UCBPlayer,117,267,384,19,45,UCBPlayer
42459,UCBPlayer,110,210,320,12,64,UCBPlayer
42460,UCBPlayer,126,271,397,23,42,UCBPlayer
42461,UCBPlayer,105,210,315,10,65,UCBPlayer
42462,UCBPlayer,130,275,405,25,40,UCBPlayer
42463,UCBPlayer,105,210,315,10,65,UCBPlayer
42464,UCBPlayer,130,275,405,25,40,UCBPlayer
42465,UCBPlayer,106,206,312,10,66,UCBPlayer
42466,UCBPlayer,130,275,405,25,40,UCBPlayer
42467,UCBPlayer,105,210,315,10,65,UCBPlayer
42468,UCBPlayer,131,271,402,25,41,UCBPlayer
42469,UCBPlayer,105,210,315,10,65,UCBPlayer
42470,UCBPlayer,130,275,405,25,40,UCBPlayer
42471,UCBPlayer,105,210,315,10,65,UCBPlayer
42472,UCBPlayer,130,275,405,25,40,UCBPlayer
42473,UCBPlayer,103,203,306,10,68,UCBPlayer
42474,UCBPlayer,128,283,411,25,38,UCBPlayer
42475,UCBPlayer,111,186,297,10,71,UCBPlayer
42476,UCBPlayer,124,299,423,25,34,UCBPlayer
42477,UCBPlayer,115,170,285,10,75,UCBPlayer
42478,UCBPlayer,120,315,435,25,30,UCBPlayer
42479,UCBPlayer,119,154,273,10,79,UCBPlayer
42480,UCBPlayer,112,332,444,25,27,UCBPlayer
42481,UCBPlayer,127,137,264,10,82,UCBPlayer
42482,UCBPlayer,104,349,453,25,24,UCBPlayer
42483,UCBPlayer,126,126,252,7,85,Tie
42484,UCBPlayer,111,351,462,28,22,UCBPlayer
42485,UCBPlayer,116,126,242,3,87,UCBPlayer
42486,UCBPlayer,122,347,469,32,21,UCBPlayer
42487,UCBPlayer,107,132,239,0,87,UCBPlayer
42488,UCBPlayer,132,337,469,35,22,UCBPlayer
42489,UCBPlayer,103,148,251,0,83,UCBPlayer
42490,UCBPlayer,136,321,457,35,26,UCBPlayer
42491,UCBPlayer,99,164,263,0,79,UCBPlayer
42492,UCBPlayer,140,305,445,35,30,UCBPlayer
42493,UCBPlayer,95,180,275,0,75,UCBPlayer
42494,UCBPlayer,144,289,433,35,34,UCBPlayer
42495,UCBPlayer,91,196,287,0,71,UCBPlayer
42496,UCBPlayer,148,273,421,35,38,UCBPlayer
42497,UCBPlayer,87,212,299,0,67,UCBPlayer
42498,UCBPlayer,152,257,409,35,42,UCBPlayer
42499,UCBPlayer,84,224,308,0,64,UCBPlayer
42500,UCBPlayer,146,251,397,32,45,UCBPlayer
42501,UCBPlayer,89,234,323,3,60,UCBPlayer
42502,UCBPlayer,138,243,381,28,49,UCBPlayer
42503,UCBPlayer,97,242,339,7,56,UCBPlayer
42504,UCBPlayer,130,235,365,24,53,UCBPlayer
42505,UCBPlayer,105,250,355,11,52,UCBPlayer
42506,UCBPlayer,122,227,349,20,57,UCBPlayer
42507,UCBPlayer,109,259,368,15,49,UCBPlayer
42508,UCBPlayer,118,218,336,16,60,UCBPlayer
42509,UCBPlayer,117,267,384,19,45,UCBPlayer
42510,UCBPlayer,110,210,320,12,64,UCBPlayer
42511,UCBPlayer,126,271,397,23,42,UCBPlayer
42512,UCBPlayer,105,210,315,10,65,UCBPlayer
42513,UCBPlayer,130,275,405,25,40,UCBPlayer
42514,UCBPlayer,105,210,315,10,65,UCBPlayer
42515,UCBPlayer,130,275,405,25,40,UCBPlayer
42516,UCBPlayer,106,206,312,10,66,UCBPlayer
42517,UCBPlayer,130,275,405,25,40,UCBPlayer
42518,UCBPlayer,105,210,315,10,65,UCBPlayer
42519,UCBPlayer,131,271,402,25,41,UCBPlayer
42520,UCBPlayer,105,210,315,10,65,UCBPlayer
42521,UCBPlayer,130,275,405,25,40,UCBPlayer
42522,UCBPlayer,105,210,315,10,65,UCBPlayer
42523,UCBPlayer,130,275,405,25,40,UCBPlayer
42524,UCBPlayer,103,203,306,10,68,UCBPlayer
42525,UCBPlayer,128,283,411,25,38,UCBPlayer
42526,UCBPlayer,111,186,297,10,71,UCBPlayer
42527,UCBPlayer,124,299,423,25,34,UCBPlayer
42528,UCBPlayer,115,170,285,10,75,UCBPlayer
42529,UCBPlayer,120,315,435,25,30,UCBPlayer
42530,UCBPlayer,119,154,273,10,79,UCBPlayer
42531,UCBPlayer,112,332,444,25,27,UCBPlayer
42532,UCBPlayer,127,137,264,10,82,UCBPlayer
42533,UCBPlayer,104,349,453,25,24,UCBPlayer
42534,UCBPlayer,126,126,252,7,85,Tie
42535,UCBPlayer,111,351,462,28,22,UCBPlayer
42536,UCBPlayer,116,126,242,3,87,UCBPlayer
42537,UCBPlayer,122,347,469,32,21,UCBPlayer
42538,UCBPlayer,107,132,239,0,87,UCBPlayer
42539,UCBPlayer,132,337,469,35,22,UCBPlayer
42540,UCBPlayer,103,148,251,0,83,UCBPlayer
42541,UCBPlayer,136,321,457,35,26,UCBPlayer
42542,UCBPlayer,99,164,263,0,79,UCBPlayer
42543,UCBPlayer,140,305,445,35,30,UCBPlayer
42544,UCBPlayer,95,180,275,0,75,UCBPlayer
42545,UCBPlayer,144,289,433,35,34,UCBPlayer
42546,UCBPlayer,91,196,287,0,71,UCBPlayer
42547,UCBPlayer,148,273,421,35,38,UCBPlayer
42548,UCBPlayer,87,212,299,0,67,UCBPlayer
42549,UCBPlayer,152,257,409,35,42,UCBPlayer
42550,UCBPlayer,84,224,308,0,64,UCBPlayer
42551,UCBPlayer,146,251,397,32,45,UCBPlayer
42552,UCBPlayer,89,234,323,3,60,UCBPlayer
42553,UCBPlayer,138,243,381,28,49,UCBPlayer
42554,UCBPlayer,97,242,339,7,56,UCBPlayer
42555,UCBPlayer,130,235,365,24,53,UCBPlayer
42556,UCBPlayer,105,250,355,11,52,UCBPlayer
42557,UCBPlayer,122,227,349,20,57,UCBPlayer
42558,UCBPlayer,109,259,368,15,49,UCBPlayer
42559,UCBPlayer,118,218,336,16,60,UCBPlayer
42560,UCBPlayer,117,267,384,19,45,UCBPlayer
42561,UCBPlayer,110,210,320,12,64,UCBPlayer
42562,UCBPlayer,126,271,397,23,42,UCBPlayer
42563,UCBPlayer,105,210,315,10,65,UCBPlayer
42564,UCBPlayer,130,275,405,25,40,UCBPlayer
42565,UCBPlayer,105,210,315,10,65,UCBPlayer
42566,UCBPlayer,130,275,405,25,40,UCBPlayer
42567,UCBPlayer,106,206,312,10,66,UCBPlayer
42568,UCBPlayer,130,275,405,25,40,UCBPlayer
42569,UCBPlayer,105,210,315,10,65,UCBPlayer
42570,UCBPlayer,131,271,402,25,41,UCBPlayer
42571,UCBPlayer,105,210,315,10,65,UCBPlayer
42572,UCBPlayer,130,275,405,25,40,UCBPlayer
42573,UCBPlayer,105,210,315,10,65,UCBPlayer
42574,UCBPlayer,130,275,405,25,40,UCBPlayer
42575,UCBPlayer,103,203,306,10,68,UCBPlayer
42576,UCBPlayer,128,283,411,25,38,UCBPlayer
42577,UCBPlayer,111,186,297,10,71,UCBPlayer
42578,UCBPlayer,124,299,423,25,34,UCBPlayer
42579,UCBPlayer,115,170,285,10,75,UCBPlayer
42580,UCBPlayer,120,315,435,25,30,UCBPlayer
42581,UCBPlayer,119,154,273,10,79,UCBPlayer
42582,UCBPlayer,112,332,444,25,27,UCBPlayer
42583,UCBPlayer,127,137,264,10,82,UCBPlayer
42584,UCBPlayer,104,349,453,25,24,UCBPlayer
42585,UCBPlayer,126,126,252,7,85,Tie
42586,UCBPlayer,111,351,462,28,22,UCBPlayer
42587,UCBPlayer,116,126,242,3,87,UCBPlayer
42588,UCBPlayer,122,347,469,32,21,UCBPlayer
42589,UCBPlayer,107,132,239,0,87,UCBPlayer
42590,UCBPlayer,132,337,469,35,22,UCBPlayer
42591,UCBPlayer,103,148,251,0,83,UCBPlayer
42592,UCBPlayer,136,321,457,35,26,UCBPlayer
42593,UCBPlayer,99,164,263,0,79,UCBPlayer
42594,UCBPlayer,140,305,445,35,30,UCBPlayer
42595,UCBPlayer,95,180,275,0,75,UCBPlayer
42596,UCBPlayer,144,289,433,35,34,UCBPlayer
42597,UCBPlayer,91,196,287,0,71,UCBPlayer
42598,UCBPlayer,148,273,421,35,38,UCBPlayer
42599,UCBPlayer,87,212,299,0,67,UCBPlayer
42600,UCBPlayer,152,257,409,35,42,UCBPlayer
42601,UCBPlayer,84,224,308,0,64,UCBPlayer
42602,UCBPlayer,146,251,397,32,45,UCBPlayer
42603,UCBPlayer,89,234,323,3,60,UCBPlayer
42604,UCBPlayer,138,243,381,28,49,UCBPlayer
42605,UCBPlayer,97,242,339,7,56,UCBPlayer
42606,UCBPlayer,130,235,365,24,53,UCBPlayer
42607,UCBPlayer,105,250,355,11,52,UCBPlayer
42608,UCBPlayer,122,227,349,20,57,UCBPlayer
42609,UCBPlayer,109,259,368,15,49,UCBPlayer
42610,UCBPlayer,118,218,336,16,60,UCBPlayer
42611,UCBPlayer,117,267,384,19,45,UCBPlayer
42612,UCBPlayer,110,210,320,12,64,UCBPlayer
42613,UCBPlayer,126,271,397,23,42,UCBPlayer
42614,UCBPlayer,105,210,315,10,65,UCBPlayer
42615,UCBPlayer,130,275,405,25,40,UCBPlayer
42616,UCBPlayer,105,210,315,10,65,UCBPlayer
42617,UCBPlayer,130,275,405,25,40,UCBPlayer
42618,UCBPlayer,106,206,312,10,66,UCBPlayer
42619,UCBPlayer,130,275,405,25,40,UCBPlayer
42620,UCBPlayer,105,210,315,10,65,UCBPlayer
42621,UCBPlayer,131,271,402,25,41,UCBPlayer
42622,UCBPlayer,105,210,315,10,65,UCBPlayer
42623,UCBPlayer,130,275,405,25,40,UCBPlayer
42624,UCBPlayer,105,210,315,10,65,UCBPlayer
42625,UCBPlayer,130,275,405,25,40,UCBPlayer
42626,UCBPlayer,103,203,306,10,68,UCBPlayer
42627,UCBPlayer,128,283,411,25,38,UCBPlayer
42628,UCBPlayer,111,186,297,10,71,UCBPlayer
42629,UCBPlayer,124,299,423,25,34,UCBPlayer
42630,UCBPlayer,115,170,285,10,75,UCBPlayer
42631,UCBPlayer,120,315,435,25,30,UCBPlayer
42632,UCBPlayer,119,154,273,10,79,UCBPlayer
42633,UCBPlayer,112,332,444,25,27,UCBPlayer
42634,UCBPlayer,127,137,264,10,82,UCBPlayer
42635,UCBPlayer,104,349,453,25,24,UCBPlayer
42636,UCBPlayer,126,126,252,7,85,Tie
42637,UCBPlayer,111,351,462,28,22,UCBPlayer
42638,UCBPlayer,116,126,242,3,87,UCBPlayer
42639,UCBPlayer,122,347,469,32,21,UCBPlayer
42640,UCBPlayer,107,132,239,0,87,UCBPlayer
42641,UCBPlayer,132,337,469,35,22,UCBPlayer
42642,UCBPlayer,103,148,251,0,83,UCBPlayer
42643,UCBPlayer,136,321,457,35,26,UCBPlayer
42644,UCBPlayer,99,164,263,0,79,UCBPlayer
42645,UCBPlayer,140,305,445,35,30,UCBPlayer
42646,UCBPlayer,95,180,275,0,75,UCBPlayer
42647,UCBPlayer,144,289,433,35,34,UCBPlayer
42648,UCBPlayer,91,196,287,0,71,UCBPlayer
42649,UCBPlayer,148,273,421,35,38,UCBPlayer
42650,UCBPlayer,87,212,299,0,67,UCBPlayer
42651,UCBPlayer,152,257,409,35,42,UCBPlayer
42652,UCBPlayer,84,224,308,0,64,UCBPlayer
42653,UCBPlayer,146,251,397,32,45,UCBPlayer
42654,UCBPlayer,89,234,323,3,60,UCBPlayer
42655,UCBPlayer,138,243,381,28,49,UCBPlayer
42656,UCBPlayer,97,242,339,7,56,UCBPlayer
42657,UCBPlayer,130,235,365,24,53,UCBPlayer
42658,UCBPlayer,105,250,355,11,52,UCBPlayer
42659,UCBPlayer,122,227,349,20,57,UCBPlayer
42660,UCBPlayer,109,259,368,15,49,UCBPlayer
42661,UCBPlayer,118,218,336,16,60,UCBPlayer
42662,UCBPlayer,117,267,384,19,45,UCBPlayer
42663,UCBPlayer,110,210,320,12,64,UCBPlayer
42664,UCBPlayer,126,271,397,23,42,UCBPlayer
42665,UCBPlayer,105,210,315,10,65,UCBPlayer
42666,UCBPlayer,130,275,405,25,40,UCBPlayer
42667,UCBPlayer,105,210,315,10,65,UCBPlayer
42668,UCBPlayer,130,275,405,25,40,UCBPlayer
42669,UCBPlayer,106,206,312,10,66,UCBPlayer
42670,UCBPlayer,130,275,405,25,40,UCBPlayer
42671,UCBPlayer,105,210,315,10,65,UCBPlayer
42672,UCBPlayer,131,271,402,25,41,UCBPlayer
42673,UCBPlayer,105,210,315,10,65,UCBPlayer
42674,UCBPlayer,130,275,405,25,40,UCBPlayer
42675,UCBPlayer,105,210,315,10,65,UCBPlayer
42676,UCBPlayer,130,275,405,25,40,UCBPlayer
42677,UCBPlayer,103,203,306,10,68,UCBPlayer
42678,UCBPlayer,128,283,411,25,38,UCBPlayer
42679,UCBPlayer,111,186,297,10,71,UCBPlayer
42680,UCBPlayer,124,299,423,25,34,UCBPlayer
42681,UCBPlayer,115,170,285,10,75,UCBPlayer
42682,UCBPlayer,120,315,435,25,30,UCBPlayer
42683,UCBPlayer,119,154,273,10,79,UCBPlayer
42684,UCBPlayer,112,332,444,25,27,UCBPlayer
42685,UCBPlayer,127,137,264,10,82,UCBPlayer
42686,UCBPlayer,104,349,453,25,24,UCBPlayer
42687,UCBPlayer,126,126,252,7,85,Tie
42688,UCBPlayer,111,351,462,28,22,UCBPlayer
42689,UCBPlayer,116,126,242,3,87,UCBPlayer
42690,UCBPlayer,122,347,469,32,21,UCBPlayer
42691,UCBPlayer,107,132,239,0,87,UCBPlayer
42692,UCBPlayer,132,337,469,35,22,UCBPlayer
42693,UCBPlayer,103,148,251,0,83,UCBPlayer
42694,UCBPlayer,136,321,457,35,26,UCBPlayer
42695,UCBPlayer,99,164,263,0,79,UCBPlayer
42696,UCBPlayer,140,305,445,35,30,UCBPlayer
42697,UCBPlayer,95,180,275,0,75,UCBPlayer
42698,UCBPlayer,144,289,433,35,34,UCBPlayer
42699,UCBPlayer,91,196,287,0,71,UCBPlayer
42700,UCBPlayer,148,273,421,35,38,UCBPlayer
42701,UCBPlayer,87,212,299,0,67,UCBPlayer
42702,UCBPlayer,152,257,409,35,42,UCBPlayer
42703,UCBPlayer,84,224,308,0,64,UCBPlayer
42704,UCBPlayer,146,251,397,32,45,UCBPlayer
42705,UCBPlayer,89,234,323,3,60,UCBPlayer
42706,UCBPlayer,138,243,381,28,49,UCBPlayer
42707,UCBPlayer,97,242,339,7,56,UCBPlayer
42708,UCBPlayer,130,235,365,24,53,UCBPlayer
42709,UCBPlayer,105,250,355,11,52,UCBPlayer
42710,UCBPlayer,122,227,349,20,57,UCBPlayer
42711,UCBPlayer,109,259,368,15,49,UCBPlayer
42712,UCBPlayer,118,218,336,16,60,UCBPlayer
42713,UCBPlayer,117,267,384,19,45,UCBPlayer
42714,UCBPlayer,110,210,320,12,64,UCBPlayer
42715,UCBPlayer,126,271,397,23,42,UCBPlayer
42716,UCBPlayer,105,210,315,10,65,UCBPlayer
42717,UCBPlayer,130,275,405,25,40,UCBPlayer
42718,UCBPlayer,105,210,315,10,65,UCBPlayer
42719,UCBPlayer,130,275,405,25,40,UCBPlayer
42720,UCBPlayer,106,206,312,10,66,UCBPlayer
42721,UCBPlayer,130,275,405,25,40,UCBPlayer
42722,UCBPlayer,105,210,315,10,65,UCBPlayer
42723,UCBPlayer,131,271,402,25,41,UCBPlayer
42724,UCBPlayer,105,210,315,10,65,UCBPlayer
42725,UCBPlayer,130,275,405,25,40,UCBPlayer
42726,UCBPlayer,105,210,315,10,65,UCBPlayer
42727,UCBPlayer,130,275,405,25,40,UCBPlayer
42728,UCBPlayer,103,203,306,10,68,UCBPlayer
42729,UCBPlayer,128,283,411,25,38,UCBPlayer
42730,UCBPlayer,111,186,297,10,71,UCBPlayer
42731,UCBPlayer,124,299,423,25,34,UCBPlayer
42732,UCBPlayer,115,170,285,10,75,UCBPlayer
42733,UCBPlayer,120,315,435,25,30,UCBPlayer
42734,UCBPlayer,119,154,273,10,79,UCBPlayer
42735,UCBPlayer,112,332,444,25,27,UCBPlayer
42736,UCBPlayer,127,137,264,10,82,UCBPlayer
42737,UCBPlayer,104,349,453,25,24,UCBPlayer
42738,UCBPlayer,126,126,252,7,85,Tie
42739,UCBPlayer,111,351,462,28,22,UCBPlayer
42740,UCBPlayer,116,126,242,3,87,UCBPlayer
42741,UCBPlayer,122,347,469,32,21,UCBPlayer
42742,UCBPlayer,107,132,239,0,87,UCBPlayer
42743,UCBPlayer,132,337,469,35,22,UCBPlayer
42744,UCBPlayer,103,148,251,0,83,UCBPlayer
42745,UCBPlayer,136,321,457,35,26,UCBPlayer
42746,UCBPlayer,99,164,263,0,79,UCBPlayer
42747,UCBPlayer,140,305,445,35,30,UCBPlayer
42748,UCBPlayer,95,180,275,0,75,UCBPlayer
42749,UCBPlayer,144,289,433,35,34,UCBPlayer
42750,UCBPlayer,91,196,287,0,71,UCBPlayer
42751,UCBPlayer,148,273,421,35,38,UCBPlayer
42752,UCBPlayer,87,212,299,0,67,UCBPlayer
42753,UCBPlayer,152,257,409,35,42,UCBPlayer
42754,UCBPlayer,84,224,308,0,64,UCBPlayer
42755,UCBPlayer,146,251,397,32,45,UCBPlayer
42756,UCBPlayer,89,234,323,3,60,UCBPlayer
42757,UCBPlayer,138,243,381,28,49,UCBPlayer
42758,UCBPlayer,97,242,339,7,56,UCBPlayer
42759,UCBPlayer,130,235,365,24,53,UCBPlayer
42760,UCBPlayer,105,250,355,11,52,UCBPlayer
42761,UCBPlayer,122,227,349,20,57,UCBPlayer
42762,UCBPlayer,109,259,368,15,49,UCBPlayer
42763,UCBPlayer,118,218,336,16,60,UCBPlayer
42764,UCBPlayer,117,267,384,19,45,UCBPlayer
42765,UCBPlayer,110,210,320,12,64,UCBPlayer
42766,UCBPlayer,126,271,397,23,42,UCBPlayer
42767,UCBPlayer,105,210,315,10,65,UCBPlayer
42768,UCBPlayer,130,275,405,25,40,UCBPlayer
42769,UCBPlayer,105,210,315,10,65,UCBPlayer
42770,UCBPlayer,130,275,405,25,40,UCBPlayer
42771,UCBPlayer,106,206,312,10,66,UCBPlayer
42772,UCBPlayer,130,275,405,25,40,UCBPlayer
42773,UCBPlayer,105,210,315,10,65,UCBPlayer
42774,UCBPlayer,131,271,402,25,41,UCBPlayer
42775,UCBPlayer,105,210,315,10,65,UCBPlayer
42776,UCBPlayer,130,275,405,25,40,UCBPlayer
42777,UCBPlayer,105,210,315,10,65,UCBPlayer
42778,UCBPlayer,130,275,405,25,40,UCBPlayer
42779,UCBPlayer,103,203,306,10,68,UCBPlayer
42780,UCBPlayer,128,283,411,25,38,UCBPlayer
42781,UCBPlayer,111,186,297,10,71,UCBPlayer
42782,UCBPlayer,124,299,423,25,34,UCBPlayer
42783,UCBPlayer,115,170,285,10,75,UCBPlayer
42784,UCBPlayer,120,315,435,25,30,UCBPlayer
42785,UCBPlayer,119,154,273,10,79,UCBPlayer
42786,UCBPlayer,112,332,444,25,27,UCBPlayer
42787,UCBPlayer,127,137,264,10,82,UCBPlayer
42788,UCBPlayer,104,349,453,25,24,UCBPlayer
42789,UCBPlayer,126,126,252,7,85,Tie
42790,UCBPlayer,111,351,462,28,22,UCBPlayer
42791,UCBPlayer,116,126,242,3,87,UCBPlayer
42792,UCBPlayer,122,347,469,32,21,UCBPlayer
42793,UCBPlayer,107,132,239,0,87,UCBPlayer
42794,UCBPlayer,132,337,469,35,22,UCBPlayer
42795,UCBPlayer,103,148,251,0,83,UCBPlayer
42796,UCBPlayer,136,321,457,35,26,UCBPlayer
42797,UCBPlayer,99,164,263,0,79,UCBPlayer
42798,UCBPlayer,140,305,445,35,30,UCBPlayer
42799,UCBPlayer,95,180,275,0,75,UCBPlayer
42800,UCBPlayer,144,289,433,35,34,UCBPlayer
42801,UCBPlayer,91,196,287,0,71,UCBPlayer
42802,UCBPlayer,148,273,421,35,38,UCBPlayer
42803,UCBPlayer,87,212,299,0,67,UCBPlayer
42804,UCBPlayer,152,257,409,35,42,UCBPlayer
42805,UCBPlayer,84,224,308,0,64,UCBPlayer
42806,UCBPlayer,146,251,397,32,45,UCBPlayer
42807,UCBPlayer,89,234,323,3,60,UCBPlayer
42808,UCBPlayer,138,243,381,28,49,UCBPlayer
42809,UCBPlayer,97,242,339,7,56,UCBPlayer
42810,UCBPlayer,130,235,365,24,53,UCBPlayer
42811,UCBPlayer,105,250,355,11,52,UCBPlayer
42812,UCBPlayer,122,227,349,20,57,UCBPlayer
42813,UCBPlayer,109,259,368,15,49,UCBPlayer
42814,UCBPlayer,118,218,336,16,60,UCBPlayer
42815,UCBPlayer,117,267,384,19,45,UCBPlayer
42816,UCBPlayer,110,210,320,12,64,UCBPlayer
42817,UCBPlayer,126,271,397,23,42,UCBPlayer
42818,UCBPlayer,105,210,315,10,65,UCBPlayer
42819,UCBPlayer,130,275,405,25,40,UCBPlayer
42820,UCBPlayer,105,210,315,10,65,UCBPlayer
42821,UCBPlayer,130,275,405,25,40,UCBPlayer
42822,UCBPlayer,106,206,312,10,66,UCBPlayer
42823,UCBPlayer,130,275,405,25,40,UCBPlayer
42824,UCBPlayer,105,210,315,10,65,UCBPlayer
42825,UCBPlayer,131,271,402,25,41,UCBPlayer
42826,UCBPlayer,105,210,315,10,65,UCBPlayer
42827,UCBPlayer,130,275,405,25,40,UCBPlayer
42828,UCBPlayer,105,210,315,10,65,UCBPlayer
42829,UCBPlayer,130,275,405,25,40,UCBPlayer
42830,UCBPlayer,103,203,306,10,68,UCBPlayer
42831,UCBPlayer,128,283,411,25,38,UCBPlayer
42832,UCBPlayer,111,186,297,10,71,UCBPlayer
42833,UCBPlayer,124,299,423,25,34,UCBPlayer
42834,UCBPlayer,115,170,285,10,75,UCBPlayer
42835,UCBPlayer,120,315,435,25,30,UCBPlayer
42836,UCBPlayer,119,154,273,10,79,UCBPlayer
42837,UCBPlayer,112,332,444,25,27,UCBPlayer
42838,UCBPlayer,127,137,264,10,82,UCBPlayer
42839,UCBPlayer,104,349,453,25,24,UCBPlayer
42840,UCBPlayer,126,126,252,7,85,Tie
42841,UCBPlayer,111,351,462,28,22,UCBPlayer
42842,UCBPlayer,116,126,242,3,87,UCBPlayer
42843,UCBPlayer,122,347,469,32,21,UCBPlayer
42844,UCBPlayer,107,132,239,0,87,UCBPlayer
42845,UCBPlayer,132,337,469,35,22,UCBPlayer
42846,UCBPlayer,103,148,251,0,83,UCBPlayer
42847,UCBPlayer,136,321,457,35,26,UCBPlayer
42848,UCBPlayer,99,164,263,0,79,UCBPlayer
42849,UCBPlayer,140,305,445,35,30,UCBPlayer
42850,UCBPlayer,95,180,275,0,75,UCBPlayer
42851,UCBPlayer,144,289,433,35,34,UCBPlayer
42852,UCBPlayer,91,196,287,0,71,UCBPlayer
42853,UCBPlayer,148,273,421,35,38,UCBPlayer
42854,UCBPlayer,87,212,299,0,67,UCBPlayer
42855,UCBPlayer,152,257,409,35,42,UCBPlayer
42856,UCBPlayer,84,224,308,0,64,UCBPlayer
42857,UCBPlayer,146,251,397,32,45,UCBPlayer
42858,UCBPlayer,89,234,323,3,60,UCBPlayer
42859,UCBPlayer,138,243,381,28,49,UCBPlayer
42860,UCBPlayer,97,242,339,7,56,UCBPlayer
42861,UCBPlayer,130,235,365,24,53,UCBPlayer
42862,UCBPlayer,105,250,355,11,52,UCBPlayer
42863,UCBPlayer,122,227,349,20,57,UCBPlayer
42864,UCBPlayer,109,259,368,15,49,UCBPlayer
42865,UCBPlayer,118,218,336,16,60,UCBPlayer
42866,UCBPlayer,117,267,384,19,45,UCBPlayer
42867,UCBPlayer,110,210,320,12,64,UCBPlayer
42868,UCBPlayer,126,271,397,23,42,UCBPlayer
42869,UCBPlayer,105,210,315,10,65,UCBPlayer
42870,UCBPlayer,130,275,405,25,40,UCBPlayer
42871,UCBPlayer,105,210,315,10,65,UCBPlayer
42872,UCBPlayer,130,275,405,25,40,UCBPlayer
42873,UCBPlayer,106,206,312,10,66,UCBPlayer
42874,UCBPlayer,130,275,405,25,40,UCBPlayer
42875,UCBPlayer,105,210,315,10,65,UCBPlayer
42876,UCBPlayer,131,271,402,25,41,UCBPlayer
42877,UCBPlayer,105,210,315,10,65,UCBPlayer
42878,UCBPlayer,130,275,405,25,40,UCBPlayer
42879,UCBPlayer,105,210,315,10,65,UCBPlayer
42880,UCBPlayer,130,275,405,25,40,UCBPlayer
42881,UCBPlayer,103,203,306,10,68,UCBPlayer
42882,UCBPlayer,128,283,411,25,38,UCBPlayer
42883,UCBPlayer,111,186,297,10,71,UCBPlayer
42884,UCBPlayer,124,299,423,25,34,UCBPlayer
42885,UCBPlayer,115,170,285,10,75,UCBPlayer
42886,UCBPlayer,120,315,435,25,30,UCBPlayer
42887,UCBPlayer,119,154,273,10,79,UCBPlayer
42888,UCBPlayer,112,332,444,25,27,UCBPlayer
42889,UCBPlayer,127,137,264,10,82,UCBPlayer
42890,UCBPlayer,104,349,453,25,24,UCBPlayer
42891,UCBPlayer,126,126,252,7,85,Tie
42892,UCBPlayer,111,351,462,28,22,UCBPlayer
42893,UCBPlayer,116,126,242,3,87,UCBPlayer
42894,UCBPlayer,122,347,469,32,21,UCBPlayer
42895,UCBPlayer,107,132,239,0,87,UCBPlayer
42896,UCBPlayer,132,337,469,35,22,UCBPlayer
42897,UCBPlayer,103,148,251,0,83,UCBPlayer
42898,UCBPlayer,136,321,457,35,26,UCBPlayer
42899,UCBPlayer,99,164,263,0,79,UCBPlayer
42900,UCBPlayer,140,305,445,35,30,UCBPlayer
42901,UCBPlayer,95,180,275,0,75,UCBPlayer
42902,UCBPlayer,144,289,433,35,34,UCBPlayer
42903,UCBPlayer,91,196,287,0,71,UCBPlayer
42904,UCBPlayer,148,273,421,35,38,UCBPlayer
42905,UCBPlayer,87,212,299,0,67,UCBPlayer
42906,UCBPlayer,152,257,409,35,42,UCBPlayer
42907,UCBPlayer,84,224,308,0,64,UCBPlayer
42908,UCBPlayer,146,251,397,32,45,UCBPlayer
42909,UCBPlayer,89,234,323,3,60,UCBPlayer
42910,UCBPlayer,138,243,381,28,49,UCBPlayer
42911,UCBPlayer,97,242,339,7,56,UCBPlayer
42912,UCBPlayer,130,235,365,24,53,UCBPlayer
42913,UCBPlayer,105,250,355,11,52,UCBPlayer
42914,UCBPlayer,122,227,349,20,57,UCBPlayer
42915,UCBPlayer,109,259,368,15,49,UCBPlayer
42916,UCBPlayer,118,218,336,16,60,UCBPlayer
42917,UCBPlayer,117,267,384,19,45,UCBPlayer
42918,UCBPlayer,110,210,320,12,64,UCBPlayer
42919,UCBPlayer,126,271,397,23,42,UCBPlayer
42920,UCBPlayer,105,210,315,10,65,UCBPlayer
42921,UCBPlayer,130,275,405,25,40,UCBPlayer
42922,UCBPlayer,105,210,315,10,65,UCBPlayer
42923,UCBPlayer,130,275,405,25,40,UCBPlayer
42924,UCBPlayer,106,206,312,10,66,UCBPlayer
42925,UCBPlayer,130,275,405,25,40,UCBPlayer
42926,UCBPlayer,105,210,315,10,65,UCBPlayer
42927,UCBPlayer,131,271,402,25,41,UCBPlayer
42928,UCBPlayer,105,210,315,10,65,UCBPlayer
42929,UCBPlayer,130,275,405,25,40,UCBPlayer
42930,UCBPlayer,105,210,315,10,65,UCBPlayer
42931,UCBPlayer,130,275,405,25,40,UCBPlayer
42932,UCBPlayer,103,203,306,10,68,UCBPlayer
42933,UCBPlayer,128,283,411,25,38,UCBPlayer
42934,UCBPlayer,111,186,297,10,71,UCBPlayer
42935,UCBPlayer,124,299,423,25,34,UCBPlayer
42936,UCBPlayer,115,170,285,10,75,UCBPlayer
42937,UCBPlayer,120,315,435,25,30,UCBPlayer
42938,UCBPlayer,119,154,273,10,79,UCBPlayer
42939,UCBPlayer,112,332,444,25,27,UCBPlayer
42940,UCBPlayer,127,137,264,10,82,UCBPlayer
42941,UCBPlayer,104,349,453,25,24,UCBPlayer
42942,UCBPlayer,126,126,252,7,85,Tie
42943,UCBPlayer,111,351,462,28,22,UCBPlayer
42944,UCBPlayer,116,126,242,3,87,UCBPlayer
42945,UCBPlayer,122,347,469,32,21,UCBPlayer
42946,UCBPlayer,107,132,239,0,87,UCBPlayer
42947,UCBPlayer,132,337,469,35,22,UCBPlayer
42948,UCBPlayer,103,148,251,0,83,UCBPlayer
42949,UCBPlayer,136,321,457,35,26,UCBPlayer
42950,UCBPlayer,99,164,263,0,79,UCBPlayer
42951,UCBPlayer,140,305,445,35,30,UCBPlayer
42952,UCBPlayer,95,180,275,0,75,UCBPlayer
42953,UCBPlayer,144,289,433,35,34,UCBPlayer
42954,UCBPlayer,91,196,287,0,71,UCBPlayer
42955,UCBPlayer,148,273,421,35,38,UCBPlayer
42956,UCBPlayer,87,212,299,0,67,UCBPlayer
42957,UCBPlayer,152,257,409,35,42,UCBPlayer
42958,UCBPlayer,84,224,308,0,64,UCBPlayer
42959,UCBPlayer,146,251,397,32,45,UCBPlayer
42960,UCBPlayer,89,234,323,3,60,UCBPlayer
42961,UCBPlayer,138,243,381,28,49,UCBPlayer
42962,UCBPlayer,97,242,339,7,56,UCBPlayer
42963,UCBPlayer,130,235,365,24,53,UCBPlayer
42964,UCBPlayer,105,250,355,11,52,UCBPlayer
42965,UCBPlayer,122,227,349,20,57,UCBPlayer
42966,UCBPlayer,109,259,368,15,49,UCBPlayer
42967,UCBPlayer,118,218,336,16,60,UCBPlayer
42968,UCBPlayer,117,267,384,19,45,UCBPlayer
42969,UCBPlayer,110,210,320,12,64,UCBPlayer
42970,UCBPlayer,126,271,397,23,42,UCBPlayer
42971,UCBPlayer,105,210,315,10,65,UCBPlayer
42972,UCBPlayer,130,275,405,25,40,UCBPlayer
42973,UCBPlayer,105,210,315,10,65,UCBPlayer
42974,UCBPlayer,130,275,405,25,40,UCBPlayer
42975,UCBPlayer,106,206,312,10,66,UCBPlayer
42976,UCBPlayer,130,275,405,25,40,UCBPlayer
42977,UCBPlayer,105,210,315,10,65,UCBPlayer
42978,UCBPlayer,131,271,402,25,41,UCBPlayer
42979,UCBPlayer,105,210,315,10,65,UCBPlayer
42980,UCBPlayer,130,275,405,25,40,UCBPlayer
42981,UCBPlayer,105,210,315,10,65,UCBPlayer
42982,UCBPlayer,130,275,405,25,40,UCBPlayer
42983,UCBPlayer,103,203,306,10,68,UCBPlayer
42984,UCBPlayer,128,283,411,25,38,UCBPlayer
42985,UCBPlayer,111,186,297,10,71,UCBPlayer
42986,UCBPlayer,124,299,423,25,34,UCBPlayer
42987,UCBPlayer,115,170,285,10,75,UCBPlayer
42988,UCBPlayer,120,315,435,25,30,UCBPlayer
42989,UCBPlayer,119,154,273,10,79,UCBPlayer
42990,UCBPlayer,112,332,444,25,27,UCBPlayer
42991,UCBPlayer,127,137,264,10,82,UCBPlayer
42992,UCBPlayer,104,349,453,25,24,UCBPlayer
42993,UCBPlayer,126,126,252,7,85,Tie
42994,UCBPlayer,111,351,462,28,22,UCBPlayer
42995,UCBPlayer,116,126,242,3,87,UCBPlayer
42996,UCBPlayer,122,347,469,32,21,UCBPlayer
42997,UCBPlayer,107,132,239,0,87,UCBPlayer
42998,UCBPlayer,132,337,469,35,22,UCBPlayer
42999,UCBPlayer,103,148,251,0,83,UCBPlayer
43000,UCBPlayer,136,321,457,35,26,UCBPlayer
43001,UCBPlayer,99,164,263,0,79,UCBPlayer
43002,UCBPlayer,140,305,445,35,30,UCBPlayer
43003,UCBPlayer,95,180,275,0,75,UCBPlayer
43004,UCBPlayer,144,289,433,35,34,UCBPlayer
43005,UCBPlayer,91,196,287,0,71,UCBPlayer
43006,UCBPlayer,148,273,421,35,38,UCBPlayer
43007,UCBPlayer,87,212,299,0,67,UCBPlayer
43008,UCBPlayer,152,257,409,35,42,UCBPlayer
43009,UCBPlayer,84,224,308,0,64,UCBPlayer
43010,UCBPlayer,146,251,397,32,45,UCBPlayer
43011,UCBPlayer,89,234,323,3,60,UCBPlayer
43012,UCBPlayer,138,243,381,28,49,UCBPlayer
43013,UCBPlayer,97,242,339,7,56,UCBPlayer
43014,UCBPlayer,130,235,365,24,53,UCBPlayer
43015,UCBPlayer,105,250,355,11,52,UCBPlayer
43016,UCBPlayer,122,227,349,20,57,UCBPlayer
43017,UCBPlayer,109,259,368,15,49,UCBPlayer
43018,UCBPlayer,118,218,336,16,60,UCBPlayer
43019,UCBPlayer,117,267,384,19,45,UCBPlayer
43020,UCBPlayer,110,210,320,12,64,UCBPlayer
43021,UCBPlayer,126,271,397,23,42,UCBPlayer
43022,UCBPlayer,105,210,315,10,65,UCBPlayer
43023,UCBPlayer,130,275,405,25,40,UCBPlayer
43024,UCBPlayer,105,210,315,10,65,UCBPlayer
43025,UCBPlayer,130,275,405,25,40,UCBPlayer
43026,UCBPlayer,106,206,312,10,66,UCBPlayer
43027,UCBPlayer,130,275,405,25,40,UCBPlayer
43028,UCBPlayer,105,210,315,10,65,UCBPlayer
43029,UCBPlayer,131,271,402,25,41,UCBPlayer
43030,UCBPlayer,105,210,315,10,65,UCBPlayer
43031,UCBPlayer,130,275,405,25,40,UCBPlayer
43032,UCBPlayer,105,210,315,10,65,UCBPlayer
43033,UCBPlayer,130,275,405,25,40,UCBPlayer
43034,UCBPlayer,103,203,306,10,68,UCBPlayer
43035,UCBPlayer,128,283,411,25,38,UCBPlayer
43036,UCBPlayer,111,186,297,10,71,UCBPlayer
43037,UCBPlayer,124,299,423,25,34,UCBPlayer
43038,UCBPlayer,115,170,285,10,75,UCBPlayer
43039,UCBPlayer,120,315,435,25,30,UCBPlayer
43040,UCBPlayer,119,154,273,10,79,UCBPlayer
43041,UCBPlayer,112,332,444,25,27,UCBPlayer
43042,UCBPlayer,127,137,264,10,82,UCBPlayer
43043,UCBPlayer,104,349,453,25,24,UCBPlayer
43044,UCBPlayer,126,126,252,7,85,Tie
43045,UCBPlayer,111,351,462,28,22,UCBPlayer
43046,UCBPlayer,116,126,242,3,87,UCBPlayer
43047,UCBPlayer,122,347,469,32,21,UCBPlayer
43048,UCBPlayer,107,132,239,0,87,UCBPlayer
43049,UCBPlayer,132,337,469,35,22,UCBPlayer
43050,UCBPlayer,103,148,251,0,83,UCBPlayer
43051,UCBPlayer,136,321,457,35,26,UCBPlayer
43052,UCBPlayer,99,164,263,0,79,UCBPlayer
43053,UCBPlayer,140,305,445,35,30,UCBPlayer
43054,UCBPlayer,95,180,275,0,75,UCBPlayer
43055,UCBPlayer,144,289,433,35,34,UCBPlayer
43056,UCBPlayer,91,196,287,0,71,UCBPlayer
43057,UCBPlayer,148,273,421,35,38,UCBPlayer
43058,UCBPlayer,87,212,299,0,67,UCBPlayer
43059,UCBPlayer,152,257,409,35,42,UCBPlayer
43060,UCBPlayer,84,224,308,0,64,UCBPlayer
43061,UCBPlayer,146,251,397,32,45,UCBPlayer
43062,UCBPlayer,89,234,323,3,60,UCBPlayer
43063,UCBPlayer,138,243,381,28,49,UCBPlayer
43064,UCBPlayer,97,242,339,7,56,UCBPlayer
43065,UCBPlayer,130,235,365,24,53,UCBPlayer
43066,UCBPlayer,105,250,355,11,52,UCBPlayer
43067,UCBPlayer,122,227,349,20,57,UCBPlayer
43068,UCBPlayer,109,259,368,15,49,UCBPlayer
43069,UCBPlayer,118,218,336,16,60,UCBPlayer
43070,UCBPlayer,117,267,384,19,45,UCBPlayer
43071,UCBPlayer,110,210,320,12,64,UCBPlayer
43072,UCBPlayer,126,271,397,23,42,UCBPlayer
43073,UCBPlayer,105,210,315,10,65,UCBPlayer
43074,UCBPlayer,130,275,405,25,40,UCBPlayer
43075,UCBPlayer,105,210,315,10,65,UCBPlayer
43076,UCBPlayer,130,275,405,25,40,UCBPlayer
43077,UCBPlayer,106,206,312,10,66,UCBPlayer
43078,UCBPlayer,130,275,405,25,40,UCBPlayer
43079,UCBPlayer,105,210,315,10,65,UCBPlayer
43080,UCBPlayer,131,271,402,25,41,UCBPlayer
43081,UCBPlayer,105,210,315,10,65,UCBPlayer
43082,UCBPlayer,130,275,405,25,40,UCBPlayer
43083,UCBPlayer,105,210,315,10,65,UCBPlayer
43084,UCBPlayer,130,275,405,25,40,UCBPlayer
43085,UCBPlayer,103,203,306,10,68,UCBPlayer
43086,UCBPlayer,128,283,411,25,38,UCBPlayer
43087,UCBPlayer,111,186,297,10,71,UCBPlayer
43088,UCBPlayer,124,299,423,25,34,UCBPlayer
43089,UCBPlayer,115,170,285,10,75,UCBPlayer
43090,UCBPlayer,120,315,435,25,30,UCBPlayer
43091,UCBPlayer,119,154,273,10,79,UCBPlayer
43092,UCBPlayer,112,332,444,25,27,UCBPlayer
43093,UCBPlayer,127,137,264,10,82,UCBPlayer
43094,UCBPlayer,104,349,453,25,24,UCBPlayer
43095,UCBPlayer,126,126,252,7,85,Tie
43096,UCBPlayer,111,351,462,28,22,UCBPlayer
43097,UCBPlayer,116,126,242,3,87,UCBPlayer
43098,UCBPlayer,122,347,469,32,21,UCBPlayer
43099,UCBPlayer,107,132,239,0,87,UCBPlayer
43100,UCBPlayer,132,337,469,35,22,UCBPlayer
43101,UCBPlayer,103,148,251,0,83,UCBPlayer
43102,UCBPlayer,136,321,457,35,26,UCBPlayer
43103,UCBPlayer,99,164,263,0,79,UCBPlayer
43104,UCBPlayer,140,305,445,35,30,UCBPlayer
43105,UCBPlayer,95,180,275,0,75,UCBPlayer
43106,UCBPlayer,144,289,433,35,34,UCBPlayer
43107,UCBPlayer,91,196,287,0,71,UCBPlayer
43108,UCBPlayer,148,273,421,35,38,UCBPlayer
43109,UCBPlayer,87,212,299,0,67,UCBPlayer
43110,UCBPlayer,152,257,409,35,42,UCBPlayer
43111,UCBPlayer,84,224,308,0,64,UCBPlayer
43112,UCBPlayer,146,251,397,32,45,UCBPlayer
43113,UCBPlayer,89,234,323,3,60,UCBPlayer
43114,UCBPlayer,138,243,381,28,49,UCBPlayer
43115,UCBPlayer,97,242,339,7,56,UCBPlayer
43116,UCBPlayer,130,235,365,24,53,UCBPlayer
43117,UCBPlayer,105,250,355,11,52,UCBPlayer
43118,UCBPlayer,122,227,349,20,57,UCBPlayer
43119,UCBPlayer,109,259,368,15,49,UCBPlayer
43120,UCBPlayer,118,218,336,16,60,UCBPlayer
43121,UCBPlayer,117,267,384,19,45,UCBPlayer
43122,UCBPlayer,110,210,320,12,64,UCBPlayer
43123,UCBPlayer,126,271,397,23,42,UCBPlayer
43124,UCBPlayer,105,210,315,10,65,UCBPlayer
43125,UCBPlayer,130,275,405,25,40,UCBPlayer
43126,UCBPlayer,105,210,315,10,65,UCBPlayer
43127,UCBPlayer,130,275,405,25,40,UCBPlayer
43128,UCBPlayer,106,206,312,10,66,UCBPlayer
43129,UCBPlayer,130,275,405,25,40,UCBPlayer
43130,UCBPlayer,105,210,315,10,65,UCBPlayer
43131,UCBPlayer,131,271,402,25,41,UCBPlayer
43132,UCBPlayer,105,210,315,10,65,UCBPlayer
43133,UCBPlayer,130,275,405,25,40,UCBPlayer
43134,UCBPlayer,105,210,315,10,65,UCBPlayer
43135,UCBPlayer,130,275,405,25,40,UCBPlayer
43136,UCBPlayer,103,203,306,10,68,UCBPlayer
43137,UCBPlayer,128,283,411,25,38,UCBPlayer
43138,UCBPlayer,111,186,297,10,71,UCBPlayer
43139,UCBPlayer,124,299,423,25,34,UCBPlayer
43140,UCBPlayer,115,170,285,10,75,UCBPlayer
43141,UCBPlayer,120,315,435,25,30,UCBPlayer
43142,UCBPlayer,119,154,273,10,79,UCBPlayer
43143,UCBPlayer,112,332,444,25,27,UCBPlayer
43144,UCBPlayer,127,137,264,10,82,UCBPlayer
43145,UCBPlayer,104,349,453,25,24,UCBPlayer
43146,UCBPlayer,126,126,252,7,85,Tie
43147,UCBPlayer,111,351,462,28,22,UCBPlayer
43148,UCBPlayer,116,126,242,3,87,UCBPlayer
43149,UCBPlayer,122,347,469,32,21,UCBPlayer
43150,UCBPlayer,107,132,239,0,87,UCBPlayer
43151,UCBPlayer,132,337,469,35,22,UCBPlayer
43152,UCBPlayer,103,148,251,0,83,UCBPlayer
43153,UCBPlayer,136,321,457,35,26,UCBPlayer
43154,UCBPlayer,99,164,263,0,79,UCBPlayer
43155,UCBPlayer,140,305,445,35,30,UCBPlayer
43156,UCBPlayer,95,180,275,0,75,UCBPlayer
43157,UCBPlayer,144,289,433,35,34,UCBPlayer
43158,UCBPlayer,91,196,287,0,71,UCBPlayer
43159,UCBPlayer,148,273,421,35,38,UCBPlayer
43160,UCBPlayer,87,212,299,0,67,UCBPlayer
43161,UCBPlayer,152,257,409,35,42,UCBPlayer
43162,UCBPlayer,84,224,308,0,64,UCBPlayer
43163,UCBPlayer,146,251,397,32,45,UCBPlayer
43164,UCBPlayer,89,234,323,3,60,UCBPlayer
43165,UCBPlayer,138,243,381,28,49,UCBPlayer
43166,UCBPlayer,97,242,339,7,56,UCBPlayer
43167,UCBPlayer,130,235,365,24,53,UCBPlayer
43168,UCBPlayer,105,250,355,11,52,UCBPlayer
43169,UCBPlayer,122,227,349,20,57,UCBPlayer
43170,UCBPlayer,109,259,368,15,49,UCBPlayer
43171,UCBPlayer,118,218,336,16,60,UCBPlayer
43172,UCBPlayer,117,267,384,19,45,UCBPlayer
43173,UCBPlayer,110,210,320,12,64,UCBPlayer
43174,UCBPlayer,126,271,397,23,42,UCBPlayer
43175,UCBPlayer,105,210,315,10,65,UCBPlayer
43176,UCBPlayer,130,275,405,25,40,UCBPlayer
43177,UCBPlayer,105,210,315,10,65,UCBPlayer
43178,UCBPlayer,130,275,405,25,40,UCBPlayer
43179,UCBPlayer,106,206,312,10,66,UCBPlayer
43180,UCBPlayer,130,275,405,25,40,UCBPlayer
43181,UCBPlayer,105,210,315,10,65,UCBPlayer
43182,UCBPlayer,131,271,402,25,41,UCBPlayer
43183,UCBPlayer,105,210,315,10,65,UCBPlayer
43184,UCBPlayer,130,275,405,25,40,UCBPlayer
43185,UCBPlayer,105,210,315,10,65,UCBPlayer
43186,UCBPlayer,130,275,405,25,40,UCBPlayer
43187,UCBPlayer,103,203,306,10,68,UCBPlayer
43188,UCBPlayer,128,283,411,25,38,UCBPlayer
43189,UCBPlayer,111,186,297,10,71,UCBPlayer
43190,UCBPlayer,124,299,423,25,34,UCBPlayer
43191,UCBPlayer,115,170,285,10,75,UCBPlayer
43192,UCBPlayer,120,315,435,25,30,UCBPlayer
43193,UCBPlayer,119,154,273,10,79,UCBPlayer
43194,UCBPlayer,112,332,444,25,27,UCBPlayer
43195,UCBPlayer,127,137,264,10,82,UCBPlayer
43196,UCBPlayer,104,349,453,25,24,UCBPlayer
43197,UCBPlayer,126,126,252,7,85,Tie
43198,UCBPlayer,111,351,462,28,22,UCBPlayer
43199,UCBPlayer,116,126,242,3,87,UCBPlayer
43200,UCBPlayer,122,347,469,32,21,UCBPlayer
43201,UCBPlayer,107,132,239,0,87,UCBPlayer
43202,UCBPlayer,132,337,469,35,22,UCBPlayer
43203,UCBPlayer,103,148,251,0,83,UCBPlayer
43204,UCBPlayer,136,321,457,35,26,UCBPlayer
43205,UCBPlayer,99,164,263,0,79,UCBPlayer
43206,UCBPlayer,140,305,445,35,30,UCBPlayer
43207,UCBPlayer,95,180,275,0,75,UCBPlayer
43208,UCBPlayer,144,289,433,35,34,UCBPlayer
43209,UCBPlayer,91,196,287,0,71,UCBPlayer
43210,UCBPlayer,148,273,421,35,38,UCBPlayer
43211,UCBPlayer,87,212,299,0,67,UCBPlayer
43212,UCBPlayer,152,257,409,35,42,UCBPlayer
43213,UCBPlayer,84,224,308,0,64,UCBPlayer
43214,UCBPlayer,146,251,397,32,45,UCBPlayer
43215,UCBPlayer,89,234,323,3,60,UCBPlayer
43216,UCBPlayer,138,243,381,28,49,UCBPlayer
43217,UCBPlayer,97,242,339,7,56,UCBPlayer
43218,UCBPlayer,130,235,365,24,53,UCBPlayer
43219,UCBPlayer,105,250,355,11,52,UCBPlayer
43220,UCBPlayer,122,227,349,20,57,UCBPlayer
43221,UCBPlayer,109,259,368,15,49,UCBPlayer
43222,UCBPlayer,118,218,336,16,60,UCBPlayer
43223,UCBPlayer,117,267,384,19,45,UCBPlayer
43224,UCBPlayer,110,210,320,12,64,UCBPlayer
43225,UCBPlayer,126,271,397,23,42,UCBPlayer
43226,UCBPlayer,105,210,315,10,65,UCBPlayer
43227,UCBPlayer,130,275,405,25,40,UCBPlayer
43228,UCBPlayer,105,210,315,10,65,UCBPlayer
43229,UCBPlayer,130,275,405,25,40,UCBPlayer
43230,UCBPlayer,106,206,312,10,66,UCBPlayer
43231,UCBPlayer,130,275,405,25,40,UCBPlayer
43232,UCBPlayer,105,210,315,10,65,UCBPlayer
43233,UCBPlayer,131,271,402,25,41,UCBPlayer
43234,UCBPlayer,105,210,315,10,65,UCBPlayer
43235,UCBPlayer,130,275,405,25,40,UCBPlayer
43236,UCBPlayer,105,210,315,10,65,UCBPlayer
43237,UCBPlayer,130,275,405,25,40,UCBPlayer
43238,UCBPlayer,103,203,306,10,68,UCBPlayer
43239,UCBPlayer,128,283,411,25,38,UCBPlayer
43240,UCBPlayer,111,186,297,10,71,UCBPlayer
43241,UCBPlayer,124,299,423,25,34,UCBPlayer
43242,UCBPlayer,115,170,285,10,75,UCBPlayer
43243,UCBPlayer,120,315,435,25,30,UCBPlayer
43244,UCBPlayer,119,154,273,10,79,UCBPlayer
43245,UCBPlayer,112,332,444,25,27,UCBPlayer
43246,UCBPlayer,127,137,264,10,82,UCBPlayer
43247,UCBPlayer,104,349,453,25,24,UCBPlayer
43248,UCBPlayer,126,126,252,7,85,Tie
43249,UCBPlayer,111,351,462,28,22,UCBPlayer
43250,UCBPlayer,116,126,242,3,87,UCBPlayer
43251,UCBPlayer,122,347,469,32,21,UCBPlayer
43252,UCBPlayer,107,132,239,0,87,UCBPlayer
43253,UCBPlayer,132,337,469,35,22,UCBPlayer
43254,UCBPlayer,103,148,251,0,83,UCBPlayer
43255,UCBPlayer,136,321,457,35,26,UCBPlayer
43256,UCBPlayer,99,164,263,0,79,UCBPlayer
43257,UCBPlayer,140,305,445,35,30,UCBPlayer
43258,UCBPlayer,95,180,275,0,75,UCBPlayer
43259,UCBPlayer,144,289,433,35,34,UCBPlayer
43260,UCBPlayer,91,196,287,0,71,UCBPlayer
43261,UCBPlayer,148,273,421,35,38,UCBPlayer
43262,UCBPlayer,87,212,299,0,67,UCBPlayer
43263,UCBPlayer,152,257,409,35,42,UCBPlayer
43264,UCBPlayer,84,224,308,0,64,UCBPlayer
43265,UCBPlayer,146,251,397,32,45,UCBPlayer
43266,UCBPlayer,89,234,323,3,60,UCBPlayer
43267,UCBPlayer,138,243,381,28,49,UCBPlayer
43268,UCBPlayer,97,242,339,7,56,UCBPlayer
43269,UCBPlayer,130,235,365,24,53,UCBPlayer
43270,UCBPlayer,105,250,355,11,52,UCBPlayer
43271,UCBPlayer,122,227,349,20,57,UCBPlayer
43272,UCBPlayer,109,259,368,15,49,UCBPlayer
43273,UCBPlayer,118,218,336,16,60,UCBPlayer
43274,UCBPlayer,117,267,384,19,45,UCBPlayer
43275,UCBPlayer,110,210,320,12,64,UCBPlayer
43276,UCBPlayer,126,271,397,23,42,UCBPlayer
43277,UCBPlayer,105,210,315,10,65,UCBPlayer
43278,UCBPlayer,130,275,405,25,40,UCBPlayer
43279,UCBPlayer,105,210,315,10,65,UCBPlayer
43280,UCBPlayer,130,275,405,25,40,UCBPlayer
43281,UCBPlayer,106,206,312,10,66,UCBPlayer
43282,UCBPlayer,130,275,405,25,40,UCBPlayer
43283,UCBPlayer,105,210,315,10,65,UCBPlayer
43284,UCBPlayer,131,271,402,25,41,UCBPlayer
43285,UCBPlayer,105,210,315,10,65,UCBPlayer
43286,UCBPlayer,130,275,405,25,40,UCBPlayer
43287,UCBPlayer,105,210,315,10,65,UCBPlayer
43288,UCBPlayer,130,275,405,25,40,UCBPlayer
43289,UCBPlayer,103,203,306,10,68,UCBPlayer
43290,UCBPlayer,128,283,411,25,38,UCBPlayer
43291,UCBPlayer,111,186,297,10,71,UCBPlayer
43292,UCBPlayer,124,299,423,25,34,UCBPlayer
43293,UCBPlayer,115,170,285,10,75,UCBPlayer
43294,UCBPlayer,120,315,435,25,30,UCBPlayer
43295,UCBPlayer,119,154,273,10,79,UCBPlayer
43296,UCBPlayer,112,332,444,25,27,UCBPlayer
43297,UCBPlayer,127,137,264,10,82,UCBPlayer
43298,UCBPlayer,104,349,453,25,24,UCBPlayer
43299,UCBPlayer,126,126,252,7,85,Tie
43300,UCBPlayer,111,351,462,28,22,UCBPlayer
43301,UCBPlayer,116,126,242,3,87,UCBPlayer
43302,UCBPlayer,122,347,469,32,21,UCBPlayer
43303,UCBPlayer,107,132,239,0,87,UCBPlayer
43304,UCBPlayer,132,337,469,35,22,UCBPlayer
43305,UCBPlayer,103,148,251,0,83,UCBPlayer
43306,UCBPlayer,136,321,457,35,26,UCBPlayer
43307,UCBPlayer,99,164,263,0,79,UCBPlayer
43308,UCBPlayer,140,305,445,35,30,UCBPlayer
43309,UCBPlayer,95,180,275,0,75,UCBPlayer
43310,UCBPlayer,144,289,433,35,34,UCBPlayer
43311,UCBPlayer,91,196,287,0,71,UCBPlayer
43312,UCBPlayer,148,273,421,35,38,UCBPlayer
43313,UCBPlayer,87,212,299,0,67,UCBPlayer
43314,UCBPlayer,152,257,409,35,42,UCBPlayer
43315,UCBPlayer,84,224,308,0,64,UCBPlayer
43316,UCBPlayer,146,251,397,32,45,UCBPlayer
43317,UCBPlayer,89,234,323,3,60,UCBPlayer
43318,UCBPlayer,138,243,381,28,49,UCBPlayer
43319,UCBPlayer,97,242,339,7,56,UCBPlayer
43320,UCBPlayer,130,235,365,24,53,UCBPlayer
43321,UCBPlayer,105,250,355,11,52,UCBPlayer
43322,UCBPlayer,122,227,349,20,57,UCBPlayer
43323,UCBPlayer,109,259,368,15,49,UCBPlayer
43324,UCBPlayer,118,218,336,16,60,UCBPlayer
43325,UCBPlayer,117,267,384,19,45,UCBPlayer
43326,UCBPlayer,110,210,320,12,64,UCBPlayer
43327,UCBPlayer,126,271,397,23,42,UCBPlayer
43328,UCBPlayer,105,210,315,10,65,UCBPlayer
43329,UCBPlayer,130,275,405,25,40,UCBPlayer
43330,UCBPlayer,105,210,315,10,65,UCBPlayer
43331,UCBPlayer,130,275,405,25,40,UCBPlayer
43332,UCBPlayer,106,206,312,10,66,UCBPlayer
43333,UCBPlayer,130,275,405,25,40,UCBPlayer
43334,UCBPlayer,105,210,315,10,65,UCBPlayer
43335,UCBPlayer,131,271,402,25,41,UCBPlayer
43336,UCBPlayer,105,210,315,10,65,UCBPlayer
43337,UCBPlayer,130,275,405,25,40,UCBPlayer
43338,UCBPlayer,105,210,315,10,65,UCBPlayer
43339,UCBPlayer,130,275,405,25,40,UCBPlayer
43340,UCBPlayer,103,203,306,10,68,UCBPlayer
43341,UCBPlayer,128,283,411,25,38,UCBPlayer
43342,UCBPlayer,111,186,297,10,71,UCBPlayer
43343,UCBPlayer,124,299,423,25,34,UCBPlayer
43344,UCBPlayer,115,170,285,10,75,UCBPlayer
43345,UCBPlayer,120,315,435,25,30,UCBPlayer
43346,UCBPlayer,119,154,273,10,79,UCBPlayer
43347,UCBPlayer,112,332,444,25,27,UCBPlayer
43348,UCBPlayer,127,137,264,10,82,UCBPlayer
43349,UCBPlayer,104,349,453,25,24,UCBPlayer
43350,UCBPlayer,126,126,252,7,85,Tie
43351,UCBPlayer,111,351,462,28,22,UCBPlayer
43352,UCBPlayer,116,126,242,3,87,UCBPlayer
43353,UCBPlayer,122,347,469,32,21,UCBPlayer
43354,UCBPlayer,107,132,239,0,87,UCBPlayer
43355,UCBPlayer,132,337,469,35,22,UCBPlayer
43356,UCBPlayer,103,148,251,0,83,UCBPlayer
43357,UCBPlayer,136,321,457,35,26,UCBPlayer
43358,UCBPlayer,99,164,263,0,79,UCBPlayer
43359,UCBPlayer,140,305,445,35,30,UCBPlayer
43360,UCBPlayer,95,180,275,0,75,UCBPlayer
43361,UCBPlayer,144,289,433,35,34,UCBPlayer
43362,UCBPlayer,91,196,287,0,71,UCBPlayer
43363,UCBPlayer,148,273,421,35,38,UCBPlayer
43364,UCBPlayer,87,212,299,0,67,UCBPlayer
43365,UCBPlayer,152,257,409,35,42,UCBPlayer
43366,UCBPlayer,84,224,308,0,64,UCBPlayer
43367,UCBPlayer,146,251,397,32,45,UCBPlayer
43368,UCBPlayer,89,234,323,3,60,UCBPlayer
43369,UCBPlayer,138,243,381,28,49,UCBPlayer
43370,UCBPlayer,97,242,339,7,56,UCBPlayer
43371,UCBPlayer,130,235,365,24,53,UCBPlayer
43372,UCBPlayer,105,250,355,11,52,UCBPlayer
43373,UCBPlayer,122,227,349,20,57,UCBPlayer
43374,UCBPlayer,109,259,368,15,49,UCBPlayer
43375,UCBPlayer,118,218,336,16,60,UCBPlayer
43376,UCBPlayer,117,267,384,19,45,UCBPlayer
43377,UCBPlayer,110,210,320,12,64,UCBPlayer
43378,UCBPlayer,126,271,397,23,42,UCBPlayer
43379,UCBPlayer,105,210,315,10,65,UCBPlayer
43380,UCBPlayer,130,275,405,25,40,UCBPlayer
43381,UCBPlayer,105,210,315,10,65,UCBPlayer
43382,UCBPlayer,130,275,405,25,40,UCBPlayer
43383,UCBPlayer,106,206,312,10,66,UCBPlayer
43384,UCBPlayer,130,275,405,25,40,UCBPlayer
43385,UCBPlayer,105,210,315,10,65,UCBPlayer
43386,UCBPlayer,131,271,402,25,41,UCBPlayer
43387,UCBPlayer,105,210,315,10,65,UCBPlayer
43388,UCBPlayer,130,275,405,25,40,UCBPlayer
43389,UCBPlayer,105,210,315,10,65,UCBPlayer
43390,UCBPlayer,130,275,405,25,40,UCBPlayer
43391,UCBPlayer,103,203,306,10,68,UCBPlayer
43392,UCBPlayer,128,283,411,25,38,UCBPlayer
43393,UCBPlayer,111,186,297,10,71,UCBPlayer
43394,UCBPlayer,124,299,423,25,34,UCBPlayer
43395,UCBPlayer,115,170,285,10,75,UCBPlayer
43396,UCBPlayer,120,315,435,25,30,UCBPlayer
43397,UCBPlayer,119,154,273,10,79,UCBPlayer
43398,UCBPlayer,112,332,444,25,27,UCBPlayer
43399,UCBPlayer,127,137,264,10,82,UCBPlayer
43400,UCBPlayer,104,349,453,25,24,UCBPlayer
43401,UCBPlayer,126,126,252,7,85,Tie
43402,UCBPlayer,111,351,462,28,22,UCBPlayer
43403,UCBPlayer,116,126,242,3,87,UCBPlayer
43404,UCBPlayer,122,347,469,32,21,UCBPlayer
43405,UCBPlayer,107,132,239,0,87,UCBPlayer
43406,UCBPlayer,132,337,469,35,22,UCBPlayer
43407,UCBPlayer,103,148,251,0,83,UCBPlayer
43408,UCBPlayer,136,321,457,35,26,UCBPlayer
43409,UCBPlayer,99,164,263,0,79,UCBPlayer
43410,UCBPlayer,140,305,445,35,30,UCBPlayer
43411,UCBPlayer,95,180,275,0,75,UCBPlayer
43412,UCBPlayer,144,289,433,35,34,UCBPlayer
43413,UCBPlayer,91,196,287,0,71,UCBPlayer
43414,UCBPlayer,148,273,421,35,38,UCBPlayer
43415,UCBPlayer,87,212,299,0,67,UCBPlayer
43416,UCBPlayer,152,257,409,35,42,UCBPlayer
43417,UCBPlayer,84,224,308,0,64,UCBPlayer
43418,UCBPlayer,146,251,397,32,45,UCBPlayer
43419,UCBPlayer,89,234,323,3,60,UCBPlayer
43420,UCBPlayer,138,243,381,28,49,UCBPlayer
43421,UCBPlayer,97,242,339,7,56,UCBPlayer
43422,UCBPlayer,130,235,365,24,53,UCBPlayer
43423,UCBPlayer,105,250,355,11,52,UCBPlayer
43424,UCBPlayer,122,227,349,20,57,UCBPlayer
43425,UCBPlayer,109,259,368,15,49,UCBPlayer
43426,UCBPlayer,118,218,336,16,60,UCBPlayer
43427,UCBPlayer,117,267,384,19,45,UCBPlayer
43428,UCBPlayer,110,210,320,12,64,UCBPlayer
43429,UCBPlayer,126,271,397,23,42,UCBPlayer
43430,UCBPlayer,105,210,315,10,65,UCBPlayer
43431,UCBPlayer,130,275,405,25,40,UCBPlayer
43432,UCBPlayer,105,210,315,10,65,UCBPlayer
43433,UCBPlayer,130,275,405,25,40,UCBPlayer
43434,UCBPlayer,106,206,312,10,66,UCBPlayer
43435,UCBPlayer,130,275,405,25,40,UCBPlayer
43436,UCBPlayer,105,210,315,10,65,UCBPlayer
43437,UCBPlayer,131,271,402,25,41,UCBPlayer
43438,UCBPlayer,105,210,315,10,65,UCBPlayer
43439,UCBPlayer,130,275,405,25,40,UCBPlayer
43440,UCBPlayer,105,210,315,10,65,UCBPlayer
43441,UCBPlayer,130,275,405,25,40,UCBPlayer
43442,UCBPlayer,103,203,306,10,68,UCBPlayer
43443,UCBPlayer,128,283,411,25,38,UCBPlayer
43444,UCBPlayer,111,186,297,10,71,UCBPlayer
43445,UCBPlayer,124,299,423,25,34,UCBPlayer
43446,UCBPlayer,115,170,285,10,75,UCBPlayer
43447,UCBPlayer,120,315,435,25,30,UCBPlayer
43448,UCBPlayer,119,154,273,10,79,UCBPlayer
43449,UCBPlayer,112,332,444,25,27,UCBPlayer
43450,UCBPlayer,127,137,264,10,82,UCBPlayer
43451,UCBPlayer,104,349,453,25,24,UCBPlayer
43452,UCBPlayer,126,126,252,7,85,Tie
43453,UCBPlayer,111,351,462,28,22,UCBPlayer
43454,UCBPlayer,116,126,242,3,87,UCBPlayer
43455,UCBPlayer,122,347,469,32,21,UCBPlayer
43456,UCBPlayer,107,132,239,0,87,UCBPlayer
43457,UCBPlayer,132,337,469,35,22,UCBPlayer
43458,UCBPlayer,103,148,251,0,83,UCBPlayer
43459,UCBPlayer,136,321,457,35,26,UCBPlayer
43460,UCBPlayer,99,164,263,0,79,UCBPlayer
43461,UCBPlayer,140,305,445,35,30,UCBPlayer
43462,UCBPlayer,95,180,275,0,75,UCBPlayer
43463,UCBPlayer,144,289,433,35,34,UCBPlayer
43464,UCBPlayer,91,196,287,0,71,UCBPlayer
43465,UCBPlayer,148,273,421,35,38,UCBPlayer
43466,UCBPlayer,87,212,299,0,67,UCBPlayer
43467,UCBPlayer,152,257,409,35,42,UCBPlayer
43468,UCBPlayer,84,224,308,0,64,UCBPlayer
43469,UCBPlayer,146,251,397,32,45,UCBPlayer
43470,UCBPlayer,89,234,323,3,60,UCBPlayer
43471,UCBPlayer,138,243,381,28,49,UCBPlayer
43472,UCBPlayer,97,242,339,7,56,UCBPlayer
43473,UCBPlayer,130,235,365,24,53,UCBPlayer
43474,UCBPlayer,105,250,355,11,52,UCBPlayer
43475,UCBPlayer,122,227,349,20,57,UCBPlayer
43476,UCBPlayer,109,259,368,15,49,UCBPlayer
43477,UCBPlayer,118,218,336,16,60,UCBPlayer
43478,UCBPlayer,117,267,384,19,45,UCBPlayer
43479,UCBPlayer,110,210,320,12,64,UCBPlayer
43480,UCBPlayer,126,271,397,23,42,UCBPlayer
43481,UCBPlayer,105,210,315,10,65,UCBPlayer
43482,UCBPlayer,130,275,405,25,40,UCBPlayer
43483,UCBPlayer,105,210,315,10,65,UCBPlayer
43484,UCBPlayer,130,275,405,25,40,UCBPlayer
43485,UCBPlayer,106,206,312,10,66,UCBPlayer
43486,UCBPlayer,130,275,405,25,40,UCBPlayer
43487,UCBPlayer,105,210,315,10,65,UCBPlayer
43488,UCBPlayer,131,271,402,25,41,UCBPlayer
43489,UCBPlayer,105,210,315,10,65,UCBPlayer
43490,UCBPlayer,130,275,405,25,40,UCBPlayer
43491,UCBPlayer,105,210,315,10,65,UCBPlayer
43492,UCBPlayer,130,275,405,25,40,UCBPlayer
43493,UCBPlayer,103,203,306,10,68,UCBPlayer
43494,UCBPlayer,128,283,411,25,38,UCBPlayer
43495,UCBPlayer,111,186,297,10,71,UCBPlayer
43496,UCBPlayer,124,299,423,25,34,UCBPlayer
43497,UCBPlayer,115,170,285,10,75,UCBPlayer
43498,UCBPlayer,120,315,435,25,30,UCBPlayer
43499,UCBPlayer,119,154,273,10,79,UCBPlayer
43500,UCBPlayer,112,332,444,25,27,UCBPlayer
43501,UCBPlayer,127,137,264,10,82,UCBPlayer
43502,UCBPlayer,104,349,453,25,24,UCBPlayer
43503,UCBPlayer,126,126,252,7,85,Tie
43504,UCBPlayer,111,351,462,28,22,UCBPlayer
43505,UCBPlayer,116,126,242,3,87,UCBPlayer
43506,UCBPlayer,122,347,469,32,21,UCBPlayer
43507,UCBPlayer,107,132,239,0,87,UCBPlayer
43508,UCBPlayer,132,337,469,35,22,UCBPlayer
43509,UCBPlayer,103,148,251,0,83,UCBPlayer
43510,UCBPlayer,136,321,457,35,26,UCBPlayer
43511,UCBPlayer,99,164,263,0,79,UCBPlayer
43512,UCBPlayer,140,305,445,35,30,UCBPlayer
43513,UCBPlayer,95,180,275,0,75,UCBPlayer
43514,UCBPlayer,144,289,433,35,34,UCBPlayer
43515,UCBPlayer,91,196,287,0,71,UCBPlayer
43516,UCBPlayer,148,273,421,35,38,UCBPlayer
43517,UCBPlayer,87,212,299,0,67,UCBPlayer
43518,UCBPlayer,152,257,409,35,42,UCBPlayer
43519,UCBPlayer,84,224,308,0,64,UCBPlayer
43520,UCBPlayer,146,251,397,32,45,UCBPlayer
43521,UCBPlayer,89,234,323,3,60,UCBPlayer
43522,UCBPlayer,138,243,381,28,49,UCBPlayer
43523,UCBPlayer,97,242,339,7,56,UCBPlayer
43524,UCBPlayer,130,235,365,24,53,UCBPlayer
43525,UCBPlayer,105,250,355,11,52,UCBPlayer
43526,UCBPlayer,122,227,349,20,57,UCBPlayer
43527,UCBPlayer,109,259,368,15,49,UCBPlayer
43528,UCBPlayer,118,218,336,16,60,UCBPlayer
43529,UCBPlayer,117,267,384,19,45,UCBPlayer
43530,UCBPlayer,110,210,320,12,64,UCBPlayer
43531,UCBPlayer,126,271,397,23,42,UCBPlayer
43532,UCBPlayer,105,210,315,10,65,UCBPlayer
43533,UCBPlayer,130,275,405,25,40,UCBPlayer
43534,UCBPlayer,105,210,315,10,65,UCBPlayer
43535,UCBPlayer,130,275,405,25,40,UCBPlayer
43536,UCBPlayer,106,206,312,10,66,UCBPlayer
43537,UCBPlayer,130,275,405,25,40,UCBPlayer
43538,UCBPlayer,105,210,315,10,65,UCBPlayer
43539,UCBPlayer,131,271,402,25,41,UCBPlayer
43540,UCBPlayer,105,210,315,10,65,UCBPlayer
43541,UCBPlayer,130,275,405,25,40,UCBPlayer
43542,UCBPlayer,105,210,315,10,65,UCBPlayer
43543,UCBPlayer,130,275,405,25,40,UCBPlayer
43544,UCBPlayer,103,203,306,10,68,UCBPlayer
43545,UCBPlayer,128,283,411,25,38,UCBPlayer
43546,UCBPlayer,111,186,297,10,71,UCBPlayer
43547,UCBPlayer,124,299,423,25,34,UCBPlayer
43548,UCBPlayer,115,170,285,10,75,UCBPlayer
43549,UCBPlayer,120,315,435,25,30,UCBPlayer
43550,UCBPlayer,119,154,273,10,79,UCBPlayer
43551,UCBPlayer,112,332,444,25,27,UCBPlayer
43552,UCBPlayer,127,137,264,10,82,UCBPlayer
43553,UCBPlayer,104,349,453,25,24,UCBPlayer
43554,UCBPlayer,126,126,252,7,85,Tie
43555,UCBPlayer,111,351,462,28,22,UCBPlayer
43556,UCBPlayer,116,126,242,3,87,UCBPlayer
43557,UCBPlayer,122,347,469,32,21,UCBPlayer
43558,UCBPlayer,107,132,239,0,87,UCBPlayer
43559,UCBPlayer,132,337,469,35,22,UCBPlayer
43560,UCBPlayer,103,148,251,0,83,UCBPlayer
43561,UCBPlayer,136,321,457,35,26,UCBPlayer
43562,UCBPlayer,99,164,263,0,79,UCBPlayer
43563,UCBPlayer,140,305,445,35,30,UCBPlayer
43564,UCBPlayer,95,180,275,0,75,UCBPlayer
43565,UCBPlayer,144,289,433,35,34,UCBPlayer
43566,UCBPlayer,91,196,287,0,71,UCBPlayer
43567,UCBPlayer,148,273,421,35,38,UCBPlayer
43568,UCBPlayer,87,212,299,0,67,UCBPlayer
43569,UCBPlayer,152,257,409,35,42,UCBPlayer
43570,UCBPlayer,84,224,308,0,64,UCBPlayer
43571,UCBPlayer,146,251,397,32,45,UCBPlayer
43572,UCBPlayer,89,234,323,3,60,UCBPlayer
43573,UCBPlayer,138,243,381,28,49,UCBPlayer
43574,UCBPlayer,97,242,339,7,56,UCBPlayer
43575,UCBPlayer,130,235,365,24,53,UCBPlayer
43576,UCBPlayer,105,250,355,11,52,UCBPlayer
43577,UCBPlayer,122,227,349,20,57,UCBPlayer
43578,UCBPlayer,109,259,368,15,49,UCBPlayer
43579,UCBPlayer,118,218,336,16,60,UCBPlayer
43580,UCBPlayer,117,267,384,19,45,UCBPlayer
43581,UCBPlayer,110,210,320,12,64,UCBPlayer
43582,UCBPlayer,126,271,397,23,42,UCBPlayer
43583,UCBPlayer,105,210,315,10,65,UCBPlayer
43584,UCBPlayer,130,275,405,25,40,UCBPlayer
43585,UCBPlayer,105,210,315,10,65,UCBPlayer
43586,UCBPlayer,130,275,405,25,40,UCBPlayer
43587,UCBPlayer,106,206,312,10,66,UCBPlayer
43588,UCBPlayer,130,275,405,25,40,UCBPlayer
43589,UCBPlayer,105,210,315,10,65,UCBPlayer
43590,UCBPlayer,131,271,402,25,41,UCBPlayer
43591,UCBPlayer,105,210,315,10,65,UCBPlayer
43592,UCBPlayer,130,275,405,25,40,UCBPlayer
43593,UCBPlayer,105,210,315,10,65,UCBPlayer
43594,UCBPlayer,130,275,405,25,40,UCBPlayer
43595,UCBPlayer,103,203,306,10,68,UCBPlayer
43596,UCBPlayer,128,283,411,25,38,UCBPlayer
43597,UCBPlayer,111,186,297,10,71,UCBPlayer
43598,UCBPlayer,124,299,423,25,34,UCBPlayer
43599,UCBPlayer,115,170,285,10,75,UCBPlayer
43600,UCBPlayer,120,315,435,25,30,UCBPlayer
43601,UCBPlayer,119,154,273,10,79,UCBPlayer
43602,UCBPlayer,112,332,444,25,27,UCBPlayer
43603,UCBPlayer,127,137,264,10,82,UCBPlayer
43604,UCBPlayer,104,349,453,25,24,UCBPlayer
43605,UCBPlayer,126,126,252,7,85,Tie
43606,UCBPlayer,111,351,462,28,22,UCBPlayer
43607,UCBPlayer,116,126,242,3,87,UCBPlayer
43608,UCBPlayer,122,347,469,32,21,UCBPlayer
43609,UCBPlayer,107,132,239,0,87,UCBPlayer
43610,UCBPlayer,132,337,469,35,22,UCBPlayer
43611,UCBPlayer,103,148,251,0,83,UCBPlayer
43612,UCBPlayer,136,321,457,35,26,UCBPlayer
43613,UCBPlayer,99,164,263,0,79,UCBPlayer
43614,UCBPlayer,140,305,445,35,30,UCBPlayer
43615,UCBPlayer,95,180,275,0,75,UCBPlayer
43616,UCBPlayer,144,289,433,35,34,UCBPlayer
43617,UCBPlayer,91,196,287,0,71,UCBPlayer
43618,UCBPlayer,148,273,421,35,38,UCBPlayer
43619,UCBPlayer,87,212,299,0,67,UCBPlayer
43620,UCBPlayer,152,257,409,35,42,UCBPlayer
43621,UCBPlayer,84,224,308,0,64,UCBPlayer
43622,UCBPlayer,146,251,397,32,45,UCBPlayer
43623,UCBPlayer,89,234,323,3,60,UCBPlayer
43624,UCBPlayer,138,243,381,28,49,UCBPlayer
43625,UCBPlayer,97,242,339,7,56,UCBPlayer
43626,UCBPlayer,130,235,365,24,53,UCBPlayer
43627,UCBPlayer,105,250,355,11,52,UCBPlayer
43628,UCBPlayer,122,227,349,20,57,UCBPlayer
43629,UCBPlayer,109,259,368,15,49,UCBPlayer
43630,UCBPlayer,118,218,336,16,60,UCBPlayer
43631,UCBPlayer,117,267,384,19,45,UCBPlayer
43632,UCBPlayer,110,210,320,12,64,UCBPlayer
43633,UCBPlayer,126,271,397,23,42,UCBPlayer
43634,UCBPlayer,105,210,315,10,65,UCBPlayer
43635,UCBPlayer,130,275,405,25,40,UCBPlayer
43636,UCBPlayer,105,210,315,10,65,UCBPlayer
43637,UCBPlayer,130,275,405,25,40,UCBPlayer
43638,UCBPlayer,106,206,312,10,66,UCBPlayer
43639,UCBPlayer,130,275,405,25,40,UCBPlayer
43640,UCBPlayer,105,210,315,10,65,UCBPlayer
43641,UCBPlayer,131,271,402,25,41,UCBPlayer
43642,UCBPlayer,105,210,315,10,65,UCBPlayer
43643,UCBPlayer,130,275,405,25,40,UCBPlayer
43644,UCBPlayer,105,210,315,10,65,UCBPlayer
43645,UCBPlayer,130,275,405,25,40,UCBPlayer
43646,UCBPlayer,103,203,306,10,68,UCBPlayer
43647,UCBPlayer,128,283,411,25,38,UCBPlayer
43648,UCBPlayer,111,186,297,10,71,UCBPlayer
43649,UCBPlayer,124,299,423,25,34,UCBPlayer
43650,UCBPlayer,115,170,285,10,75,UCBPlayer
43651,UCBPlayer,120,315,435,25,30,UCBPlayer
43652,UCBPlayer,119,154,273,10,79,UCBPlayer
43653,UCBPlayer,112,332,444,25,27,UCBPlayer
43654,UCBPlayer,127,137,264,10,82,UCBPlayer
43655,UCBPlayer,104,349,453,25,24,UCBPlayer
43656,UCBPlayer,126,126,252,7,85,Tie
43657,UCBPlayer,111,351,462,28,22,UCBPlayer
43658,UCBPlayer,116,126,242,3,87,UCBPlayer
43659,UCBPlayer,122,347,469,32,21,UCBPlayer
43660,UCBPlayer,107,132,239,0,87,UCBPlayer
43661,UCBPlayer,132,337,469,35,22,UCBPlayer
43662,UCBPlayer,103,148,251,0,83,UCBPlayer
43663,UCBPlayer,136,321,457,35,26,UCBPlayer
43664,UCBPlayer,99,164,263,0,79,UCBPlayer
43665,UCBPlayer,140,305,445,35,30,UCBPlayer
43666,UCBPlayer,95,180,275,0,75,UCBPlayer
43667,UCBPlayer,144,289,433,35,34,UCBPlayer
43668,UCBPlayer,91,196,287,0,71,UCBPlayer
43669,UCBPlayer,148,273,421,35,38,UCBPlayer
43670,UCBPlayer,87,212,299,0,67,UCBPlayer
43671,UCBPlayer,152,257,409,35,42,UCBPlayer
43672,UCBPlayer,84,224,308,0,64,UCBPlayer
43673,UCBPlayer,146,251,397,32,45,UCBPlayer
43674,UCBPlayer,89,234,323,3,60,UCBPlayer
43675,UCBPlayer,138,243,381,28,49,UCBPlayer
43676,UCBPlayer,97,242,339,7,56,UCBPlayer
43677,UCBPlayer,130,235,365,24,53,UCBPlayer
43678,UCBPlayer,105,250,355,11,52,UCBPlayer
43679,UCBPlayer,122,227,349,20,57,UCBPlayer
43680,UCBPlayer,109,259,368,15,49,UCBPlayer
43681,UCBPlayer,118,218,336,16,60,UCBPlayer
43682,UCBPlayer,117,267,384,19,45,UCBPlayer
43683,UCBPlayer,110,210,320,12,64,UCBPlayer
43684,UCBPlayer,126,271,397,23,42,UCBPlayer
43685,UCBPlayer,105,210,315,10,65,UCBPlayer
43686,UCBPlayer,130,275,405,25,40,UCBPlayer
43687,UCBPlayer,105,210,315,10,65,UCBPlayer
43688,UCBPlayer,130,275,405,25,40,UCBPlayer
43689,UCBPlayer,106,206,312,10,66,UCBPlayer
43690,UCBPlayer,130,275,405,25,40,UCBPlayer
43691,UCBPlayer,105,210,315,10,65,UCBPlayer
43692,UCBPlayer,131,271,402,25,41,UCBPlayer
43693,UCBPlayer,105,210,315,10,65,UCBPlayer
43694,UCBPlayer,130,275,405,25,40,UCBPlayer
43695,UCBPlayer,105,210,315,10,65,UCBPlayer
43696,UCBPlayer,130,275,405,25,40,UCBPlayer
43697,UCBPlayer,103,203,306,10,68,UCBPlayer
43698,UCBPlayer,128,283,411,25,38,UCBPlayer
43699,UCBPlayer,111,186,297,10,71,UCBPlayer
43700,UCBPlayer,124,299,423,25,34,UCBPlayer
43701,UCBPlayer,115,170,285,10,75,UCBPlayer
43702,UCBPlayer,120,315,435,25,30,UCBPlayer
43703,UCBPlayer,119,154,273,10,79,UCBPlayer
43704,UCBPlayer,112,332,444,25,27,UCBPlayer
43705,UCBPlayer,127,137,264,10,82,UCBPlayer
43706,UCBPlayer,104,349,453,25,24,UCBPlayer
43707,UCBPlayer,126,126,252,7,85,Tie
43708,UCBPlayer,111,351,462,28,22,UCBPlayer
43709,UCBPlayer,116,126,242,3,87,UCBPlayer
43710,UCBPlayer,122,347,469,32,21,UCBPlayer
43711,UCBPlayer,107,132,239,0,87,UCBPlayer
43712,UCBPlayer,132,337,469,35,22,UCBPlayer
43713,UCBPlayer,103,148,251,0,83,UCBPlayer
43714,UCBPlayer,136,321,457,35,26,UCBPlayer
43715,UCBPlayer,99,164,263,0,79,UCBPlayer
43716,UCBPlayer,140,305,445,35,30,UCBPlayer
43717,UCBPlayer,95,180,275,0,75,UCBPlayer
43718,UCBPlayer,144,289,433,35,34,UCBPlayer
43719,UCBPlayer,91,196,287,0,71,UCBPlayer
43720,UCBPlayer,148,273,421,35,38,UCBPlayer
43721,UCBPlayer,87,212,299,0,67,UCBPlayer
43722,UCBPlayer,152,257,409,35,42,UCBPlayer
43723,UCBPlayer,84,224,308,0,64,UCBPlayer
43724,UCBPlayer,146,251,397,32,45,UCBPlayer
43725,UCBPlayer,89,234,323,3,60,UCBPlayer
43726,UCBPlayer,138,243,381,28,49,UCBPlayer
43727,UCBPlayer,97,242,339,7,56,UCBPlayer
43728,UCBPlayer,130,235,365,24,53,UCBPlayer
43729,UCBPlayer,105,250,355,11,52,UCBPlayer
43730,UCBPlayer,122,227,349,20,57,UCBPlayer
43731,UCBPlayer,109,259,368,15,49,UCBPlayer
43732,UCBPlayer,118,218,336,16,60,UCBPlayer
43733,UCBPlayer,117,267,384,19,45,UCBPlayer
43734,UCBPlayer,110,210,320,12,64,UCBPlayer
43735,UCBPlayer,126,271,397,23,42,UCBPlayer
43736,UCBPlayer,105,210,315,10,65,UCBPlayer
43737,UCBPlayer,130,275,405,25,40,UCBPlayer
43738,UCBPlayer,105,210,315,10,65,UCBPlayer
43739,UCBPlayer,130,275,405,25,40,UCBPlayer
43740,UCBPlayer,106,206,312,10,66,UCBPlayer
43741,UCBPlayer,130,275,405,25,40,UCBPlayer
43742,UCBPlayer,105,210,315,10,65,UCBPlayer
43743,UCBPlayer,131,271,402,25,41,UCBPlayer
43744,UCBPlayer,105,210,315,10,65,UCBPlayer
43745,UCBPlayer,130,275,405,25,40,UCBPlayer
43746,UCBPlayer,105,210,315,10,65,UCBPlayer
43747,UCBPlayer,130,275,405,25,40,UCBPlayer
43748,UCBPlayer,103,203,306,10,68,UCBPlayer
43749,UCBPlayer,128,283,411,25,38,UCBPlayer
43750,UCBPlayer,111,186,297,10,71,UCBPlayer
43751,UCBPlayer,124,299,423,25,34,UCBPlayer
43752,UCBPlayer,115,170,285,10,75,UCBPlayer
43753,UCBPlayer,120,315,435,25,30,UCBPlayer
43754,UCBPlayer,119,154,273,10,79,UCBPlayer
43755,UCBPlayer,112,332,444,25,27,UCBPlayer
43756,UCBPlayer,127,137,264,10,82,UCBPlayer
43757,UCBPlayer,104,349,453,25,24,UCBPlayer
43758,UCBPlayer,126,126,252,7,85,Tie
43759,UCBPlayer,111,351,462,28,22,UCBPlayer
43760,UCBPlayer,116,126,242,3,87,UCBPlayer
43761,UCBPlayer,122,347,469,32,21,UCBPlayer
43762,UCBPlayer,107,132,239,0,87,UCBPlayer
43763,UCBPlayer,132,337,469,35,22,UCBPlayer
43764,UCBPlayer,103,148,251,0,83,UCBPlayer
43765,UCBPlayer,136,321,457,35,26,UCBPlayer
43766,UCBPlayer,99,164,263,0,79,UCBPlayer
43767,UCBPlayer,140,305,445,35,30,UCBPlayer
43768,UCBPlayer,95,180,275,0,75,UCBPlayer
43769,UCBPlayer,144,289,433,35,34,UCBPlayer
43770,UCBPlayer,91,196,287,0,71,UCBPlayer
43771,UCBPlayer,148,273,421,35,38,UCBPlayer
43772,UCBPlayer,87,212,299,0,67,UCBPlayer
43773,UCBPlayer,152,257,409,35,42,UCBPlayer
43774,UCBPlayer,84,224,308,0,64,UCBPlayer
43775,UCBPlayer,146,251,397,32,45,UCBPlayer
43776,UCBPlayer,89,234,323,3,60,UCBPlayer
43777,UCBPlayer,138,243,381,28,49,UCBPlayer
43778,UCBPlayer,97,242,339,7,56,UCBPlayer
43779,UCBPlayer,130,235,365,24,53,UCBPlayer
43780,UCBPlayer,105,250,355,11,52,UCBPlayer
43781,UCBPlayer,122,227,349,20,57,UCBPlayer
43782,UCBPlayer,109,259,368,15,49,UCBPlayer
43783,UCBPlayer,118,218,336,16,60,UCBPlayer
43784,UCBPlayer,117,267,384,19,45,UCBPlayer
43785,UCBPlayer,110,210,320,12,64,UCBPlayer
43786,UCBPlayer,126,271,397,23,42,UCBPlayer
43787,UCBPlayer,105,210,315,10,65,UCBPlayer
43788,UCBPlayer,130,275,405,25,40,UCBPlayer
43789,UCBPlayer,105,210,315,10,65,UCBPlayer
43790,UCBPlayer,130,275,405,25,40,UCBPlayer
43791,UCBPlayer,106,206,312,10,66,UCBPlayer
43792,UCBPlayer,130,275,405,25,40,UCBPlayer
43793,UCBPlayer,105,210,315,10,65,UCBPlayer
43794,UCBPlayer,131,271,402,25,41,UCBPlayer
43795,UCBPlayer,105,210,315,10,65,UCBPlayer
43796,UCBPlayer,130,275,405,25,40,UCBPlayer
43797,UCBPlayer,105,210,315,10,65,UCBPlayer
43798,UCBPlayer,130,275,405,25,40,UCBPlayer
43799,UCBPlayer,103,203,306,10,68,UCBPlayer
43800,UCBPlayer,128,283,411,25,38,UCBPlayer
43801,UCBPlayer,111,186,297,10,71,UCBPlayer
43802,UCBPlayer,124,299,423,25,34,UCBPlayer
43803,UCBPlayer,115,170,285,10,75,UCBPlayer
43804,UCBPlayer,120,315,435,25,30,UCBPlayer
43805,UCBPlayer,119,154,273,10,79,UCBPlayer
43806,UCBPlayer,112,332,444,25,27,UCBPlayer
43807,UCBPlayer,127,137,264,10,82,UCBPlayer
43808,UCBPlayer,104,349,453,25,24,UCBPlayer
43809,UCBPlayer,126,126,252,7,85,Tie
43810,UCBPlayer,111,351,462,28,22,UCBPlayer
43811,UCBPlayer,116,126,242,3,87,UCBPlayer
43812,UCBPlayer,122,347,469,32,21,UCBPlayer
43813,UCBPlayer,107,132,239,0,87,UCBPlayer
43814,UCBPlayer,132,337,469,35,22,UCBPlayer
43815,UCBPlayer,103,148,251,0,83,UCBPlayer
43816,UCBPlayer,136,321,457,35,26,UCBPlayer
43817,UCBPlayer,99,164,263,0,79,UCBPlayer
43818,UCBPlayer,140,305,445,35,30,UCBPlayer
43819,UCBPlayer,95,180,275,0,75,UCBPlayer
43820,UCBPlayer,144,289,433,35,34,UCBPlayer
43821,UCBPlayer,91,196,287,0,71,UCBPlayer
43822,UCBPlayer,148,273,421,35,38,UCBPlayer
43823,UCBPlayer,87,212,299,0,67,UCBPlayer
43824,UCBPlayer,152,257,409,35,42,UCBPlayer
43825,UCBPlayer,84,224,308,0,64,UCBPlayer
43826,UCBPlayer,146,251,397,32,45,UCBPlayer
43827,UCBPlayer,89,234,323,3,60,UCBPlayer
43828,UCBPlayer,138,243,381,28,49,UCBPlayer
43829,UCBPlayer,97,242,339,7,56,UCBPlayer
43830,UCBPlayer,130,235,365,24,53,UCBPlayer
43831,UCBPlayer,105,250,355,11,52,UCBPlayer
43832,UCBPlayer,122,227,349,20,57,UCBPlayer
43833,UCBPlayer,109,259,368,15,49,UCBPlayer
43834,UCBPlayer,118,218,336,16,60,UCBPlayer
43835,UCBPlayer,117,267,384,19,45,UCBPlayer
43836,UCBPlayer,110,210,320,12,64,UCBPlayer
43837,UCBPlayer,126,271,397,23,42,UCBPlayer
43838,UCBPlayer,105,210,315,10,65,UCBPlayer
43839,UCBPlayer,130,275,405,25,40,UCBPlayer
43840,UCBPlayer,105,210,315,10,65,UCBPlayer
43841,UCBPlayer,130,275,405,25,40,UCBPlayer
43842,UCBPlayer,106,206,312,10,66,UCBPlayer
43843,UCBPlayer,130,275,405,25,40,UCBPlayer
43844,UCBPlayer,105,210,315,10,65,UCBPlayer
43845,UCBPlayer,131,271,402,25,41,UCBPlayer
43846,UCBPlayer,105,210,315,10,65,UCBPlayer
43847,UCBPlayer,130,275,405,25,40,UCBPlayer
43848,UCBPlayer,105,210,315,10,65,UCBPlayer
43849,UCBPlayer,130,275,405,25,40,UCBPlayer
43850,UCBPlayer,103,203,306,10,68,UCBPlayer
43851,UCBPlayer,128,283,411,25,38,UCBPlayer
43852,UCBPlayer,111,186,297,10,71,UCBPlayer
43853,UCBPlayer,124,299,423,25,34,UCBPlayer
43854,UCBPlayer,115,170,285,10,75,UCBPlayer
43855,UCBPlayer,120,315,435,25,30,UCBPlayer
43856,UCBPlayer,119,154,273,10,79,UCBPlayer
43857,UCBPlayer,112,332,444,25,27,UCBPlayer
43858,UCBPlayer,127,137,264,10,82,UCBPlayer
43859,UCBPlayer,104,349,453,25,24,UCBPlayer
43860,UCBPlayer,126,126,252,7,85,Tie
43861,UCBPlayer,111,351,462,28,22,UCBPlayer
43862,UCBPlayer,116,126,242,3,87,UCBPlayer
43863,UCBPlayer,122,347,469,32,21,UCBPlayer
43864,UCBPlayer,107,132,239,0,87,UCBPlayer
43865,UCBPlayer,132,337,469,35,22,UCBPlayer
43866,UCBPlayer,103,148,251,0,83,UCBPlayer
43867,UCBPlayer,136,321,457,35,26,UCBPlayer
43868,UCBPlayer,99,164,263,0,79,UCBPlayer
43869,UCBPlayer,140,305,445,35,30,UCBPlayer
43870,UCBPlayer,95,180,275,0,75,UCBPlayer
43871,UCBPlayer,144,289,433,35,34,UCBPlayer
43872,UCBPlayer,91,196,287,0,71,UCBPlayer
43873,UCBPlayer,148,273,421,35,38,UCBPlayer
43874,UCBPlayer,87,212,299,0,67,UCBPlayer
43875,UCBPlayer,152,257,409,35,42,UCBPlayer
43876,UCBPlayer,84,224,308,0,64,UCBPlayer
43877,UCBPlayer,146,251,397,32,45,UCBPlayer
43878,UCBPlayer,89,234,323,3,60,UCBPlayer
43879,UCBPlayer,138,243,381,28,49,UCBPlayer
43880,UCBPlayer,97,242,339,7,56,UCBPlayer
43881,UCBPlayer,130,235,365,24,53,UCBPlayer
43882,UCBPlayer,105,250,355,11,52,UCBPlayer
43883,UCBPlayer,122,227,349,20,57,UCBPlayer
43884,UCBPlayer,109,259,368,15,49,UCBPlayer
43885,UCBPlayer,118,218,336,16,60,UCBPlayer
43886,UCBPlayer,117,267,384,19,45,UCBPlayer
43887,UCBPlayer,110,210,320,12,64,UCBPlayer
43888,UCBPlayer,126,271,397,23,42,UCBPlayer
43889,UCBPlayer,105,210,315,10,65,UCBPlayer
43890,UCBPlayer,130,275,405,25,40,UCBPlayer
43891,UCBPlayer,105,210,315,10,65,UCBPlayer
43892,UCBPlayer,130,275,405,25,40,UCBPlayer
43893,UCBPlayer,106,206,312,10,66,UCBPlayer
43894,UCBPlayer,130,275,405,25,40,UCBPlayer
43895,UCBPlayer,105,210,315,10,65,UCBPlayer
43896,UCBPlayer,131,271,402,25,41,UCBPlayer
43897,UCBPlayer,105,210,315,10,65,UCBPlayer
43898,UCBPlayer,130,275,405,25,40,UCBPlayer
43899,UCBPlayer,105,210,315,10,65,UCBPlayer
43900,UCBPlayer,130,275,405,25,40,UCBPlayer
43901,UCBPlayer,103,203,306,10,68,UCBPlayer
43902,UCBPlayer,128,283,411,25,38,UCBPlayer
43903,UCBPlayer,111,186,297,10,71,UCBPlayer
43904,UCBPlayer,124,299,423,25,34,UCBPlayer
43905,UCBPlayer,115,170,285,10,75,UCBPlayer
43906,UCBPlayer,120,315,435,25,30,UCBPlayer
43907,UCBPlayer,119,154,273,10,79,UCBPlayer
43908,UCBPlayer,112,332,444,25,27,UCBPlayer
43909,UCBPlayer,127,137,264,10,82,UCBPlayer
43910,UCBPlayer,104,349,453,25,24,UCBPlayer
43911,UCBPlayer,126,126,252,7,85,Tie
43912,UCBPlayer,111,351,462,28,22,UCBPlayer
43913,UCBPlayer,116,126,242,3,87,UCBPlayer
43914,UCBPlayer,122,347,469,32,21,UCBPlayer
43915,UCBPlayer,107,132,239,0,87,UCBPlayer
43916,UCBPlayer,132,337,469,35,22,UCBPlayer
43917,UCBPlayer,103,148,251,0,83,UCBPlayer
43918,UCBPlayer,136,321,457,35,26,UCBPlayer
43919,UCBPlayer,99,164,263,0,79,UCBPlayer
43920,UCBPlayer,140,305,445,35,30,UCBPlayer
43921,UCBPlayer,95,180,275,0,75,UCBPlayer
43922,UCBPlayer,144,289,433,35,34,UCBPlayer
43923,UCBPlayer,91,196,287,0,71,UCBPlayer
43924,UCBPlayer,148,273,421,35,38,UCBPlayer
43925,UCBPlayer,87,212,299,0,67,UCBPlayer
43926,UCBPlayer,152,257,409,35,42,UCBPlayer
43927,UCBPlayer,84,224,308,0,64,UCBPlayer
43928,UCBPlayer,146,251,397,32,45,UCBPlayer
43929,UCBPlayer,89,234,323,3,60,UCBPlayer
43930,UCBPlayer,138,243,381,28,49,UCBPlayer
43931,UCBPlayer,97,242,339,7,56,UCBPlayer
43932,UCBPlayer,130,235,365,24,53,UCBPlayer
43933,UCBPlayer,105,250,355,11,52,UCBPlayer
43934,UCBPlayer,122,227,349,20,57,UCBPlayer
43935,UCBPlayer,109,259,368,15,49,UCBPlayer
43936,UCBPlayer,118,218,336,16,60,UCBPlayer
43937,UCBPlayer,117,267,384,19,45,UCBPlayer
43938,UCBPlayer,110,210,320,12,64,UCBPlayer
43939,UCBPlayer,126,271,397,23,42,UCBPlayer
43940,UCBPlayer,105,210,315,10,65,UCBPlayer
43941,UCBPlayer,130,275,405,25,40,UCBPlayer
43942,UCBPlayer,105,210,315,10,65,UCBPlayer
43943,UCBPlayer,130,275,405,25,40,UCBPlayer
43944,UCBPlayer,106,206,312,10,66,UCBPlayer
43945,UCBPlayer,130,275,405,25,40,UCBPlayer
43946,UCBPlayer,105,210,315,10,65,UCBPlayer
43947,UCBPlayer,131,271,402,25,41,UCBPlayer
43948,UCBPlayer,105,210,315,10,65,UCBPlayer
43949,UCBPlayer,130,275,405,25,40,UCBPlayer
43950,UCBPlayer,105,210,315,10,65,UCBPlayer
43951,UCBPlayer,130,275,405,25,40,UCBPlayer
43952,UCBPlayer,103,203,306,10,68,UCBPlayer
43953,UCBPlayer,128,283,411,25,38,UCBPlayer
43954,UCBPlayer,111,186,297,10,71,UCBPlayer
43955,UCBPlayer,124,299,423,25,34,UCBPlayer
43956,UCBPlayer,115,170,285,10,75,UCBPlayer
43957,UCBPlayer,120,315,435,25,30,UCBPlayer
43958,UCBPlayer,119,154,273,10,79,UCBPlayer
43959,UCBPlayer,112,332,444,25,27,UCBPlayer
43960,UCBPlayer,127,137,264,10,82,UCBPlayer
43961,UCBPlayer,104,349,453,25,24,UCBPlayer
43962,UCBPlayer,126,126,252,7,85,Tie
43963,UCBPlayer,111,351,462,28,22,UCBPlayer
43964,UCBPlayer,116,126,242,3,87,UCBPlayer
43965,UCBPlayer,122,347,469,32,21,UCBPlayer
43966,UCBPlayer,107,132,239,0,87,UCBPlayer
43967,UCBPlayer,132,337,469,35,22,UCBPlayer
43968,UCBPlayer,103,148,251,0,83,UCBPlayer
43969,UCBPlayer,136,321,457,35,26,UCBPlayer
43970,UCBPlayer,99,164,263,0,79,UCBPlayer
43971,UCBPlayer,140,305,445,35,30,UCBPlayer
43972,UCBPlayer,95,180,275,0,75,UCBPlayer
43973,UCBPlayer,144,289,433,35,34,UCBPlayer
43974,UCBPlayer,91,196,287,0,71,UCBPlayer
43975,UCBPlayer,148,273,421,35,38,UCBPlayer
43976,UCBPlayer,87,212,299,0,67,UCBPlayer
43977,UCBPlayer,152,257,409,35,42,UCBPlayer
43978,UCBPlayer,84,224,308,0,64,UCBPlayer
43979,UCBPlayer,146,251,397,32,45,UCBPlayer
43980,UCBPlayer,89,234,323,3,60,UCBPlayer
43981,UCBPlayer,138,243,381,28,49,UCBPlayer
43982,UCBPlayer,97,242,339,7,56,UCBPlayer
43983,UCBPlayer,130,235,365,24,53,UCBPlayer
43984,UCBPlayer,105,250,355,11,52,UCBPlayer
43985,UCBPlayer,122,227,349,20,57,UCBPlayer
43986,UCBPlayer,109,259,368,15,49,UCBPlayer
43987,UCBPlayer,118,218,336,16,60,UCBPlayer
43988,UCBPlayer,117,267,384,19,45,UCBPlayer
43989,UCBPlayer,110,210,320,12,64,UCBPlayer
43990,UCBPlayer,126,271,397,23,42,UCBPlayer
43991,UCBPlayer,105,210,315,10,65,UCBPlayer
43992,UCBPlayer,130,275,405,25,40,UCBPlayer
43993,UCBPlayer,105,210,315,10,65,UCBPlayer
43994,UCBPlayer,130,275,405,25,40,UCBPlayer
43995,UCBPlayer,106,206,312,10,66,UCBPlayer
43996,UCBPlayer,130,275,405,25,40,UCBPlayer
43997,UCBPlayer,105,210,315,10,65,UCBPlayer
43998,UCBPlayer,131,271,402,25,41,UCBPlayer
43999,UCBPlayer,105,210,315,10,65,UCBPlayer
44000,UCBPlayer,130,275,405,25,40,UCBPlayer
44001,UCBPlayer,105,210,315,10,65,UCBPlayer
44002,UCBPlayer,130,275,405,25,40,UCBPlayer
44003,UCBPlayer,103,203,306,10,68,UCBPlayer
44004,UCBPlayer,128,283,411,25,38,UCBPlayer
44005,UCBPlayer,111,186,297,10,71,UCBPlayer
44006,UCBPlayer,124,299,423,25,34,UCBPlayer
44007,UCBPlayer,115,170,285,10,75,UCBPlayer
44008,UCBPlayer,120,315,435,25,30,UCBPlayer
44009,UCBPlayer,119,154,273,10,79,UCBPlayer
44010,UCBPlayer,112,332,444,25,27,UCBPlayer
44011,UCBPlayer,127,137,264,10,82,UCBPlayer
44012,UCBPlayer,104,349,453,25,24,UCBPlayer
44013,UCBPlayer,126,126,252,7,85,Tie
44014,UCBPlayer,111,351,462,28,22,UCBPlayer
44015,UCBPlayer,116,126,242,3,87,UCBPlayer
44016,UCBPlayer,122,347,469,32,21,UCBPlayer
44017,UCBPlayer,107,132,239,0,87,UCBPlayer
44018,UCBPlayer,132,337,469,35,22,UCBPlayer
44019,UCBPlayer,103,148,251,0,83,UCBPlayer
44020,UCBPlayer,136,321,457,35,26,UCBPlayer
44021,UCBPlayer,99,164,263,0,79,UCBPlayer
44022,UCBPlayer,140,305,445,35,30,UCBPlayer
44023,UCBPlayer,95,180,275,0,75,UCBPlayer
44024,UCBPlayer,144,289,433,35,34,UCBPlayer
44025,UCBPlayer,91,196,287,0,71,UCBPlayer
44026,UCBPlayer,148,273,421,35,38,UCBPlayer
44027,UCBPlayer,87,212,299,0,67,UCBPlayer
44028,UCBPlayer,152,257,409,35,42,UCBPlayer
44029,UCBPlayer,84,224,308,0,64,UCBPlayer
44030,UCBPlayer,146,251,397,32,45,UCBPlayer
44031,UCBPlayer,89,234,323,3,60,UCBPlayer
44032,UCBPlayer,138,243,381,28,49,UCBPlayer
44033,UCBPlayer,97,242,339,7,56,UCBPlayer
44034,UCBPlayer,130,235,365,24,53,UCBPlayer
44035,UCBPlayer,105,250,355,11,52,UCBPlayer
44036,UCBPlayer,122,227,349,20,57,UCBPlayer
44037,UCBPlayer,109,259,368,15,49,UCBPlayer
44038,UCBPlayer,118,218,336,16,60,UCBPlayer
44039,UCBPlayer,117,267,384,19,45,UCBPlayer
44040,UCBPlayer,110,210,320,12,64,UCBPlayer
44041,UCBPlayer,126,271,397,23,42,UCBPlayer
44042,UCBPlayer,105,210,315,10,65,UCBPlayer
44043,UCBPlayer,130,275,405,25,40,UCBPlayer
44044,UCBPlayer,105,210,315,10,65,UCBPlayer
44045,UCBPlayer,130,275,405,25,40,UCBPlayer
44046,UCBPlayer,106,206,312,10,66,UCBPlayer
44047,UCBPlayer,130,275,405,25,40,UCBPlayer
44048,UCBPlayer,105,210,315,10,65,UCBPlayer
44049,UCBPlayer,131,271,402,25,41,UCBPlayer
44050,UCBPlayer,105,210,315,10,65,UCBPlayer
44051,UCBPlayer,130,275,405,25,40,UCBPlayer
44052,UCBPlayer,105,210,315,10,65,UCBPlayer
44053,UCBPlayer,130,275,405,25,40,UCBPlayer
44054,UCBPlayer,103,203,306,10,68,UCBPlayer
44055,UCBPlayer,128,283,411,25,38,UCBPlayer
44056,UCBPlayer,111,186,297,10,71,UCBPlayer
44057,UCBPlayer,124,299,423,25,34,UCBPlayer
44058,UCBPlayer,115,170,285,10,75,UCBPlayer
44059,UCBPlayer,120,315,435,25,30,UCBPlayer
44060,UCBPlayer,119,154,273,10,79,UCBPlayer
44061,UCBPlayer,112,332,444,25,27,UCBPlayer
44062,UCBPlayer,127,137,264,10,82,UCBPlayer
44063,UCBPlayer,104,349,453,25,24,UCBPlayer
44064,UCBPlayer,126,126,252,7,85,Tie
44065,UCBPlayer,111,351,462,28,22,UCBPlayer
44066,UCBPlayer,116,126,242,3,87,UCBPlayer
44067,UCBPlayer,122,347,469,32,21,UCBPlayer
44068,UCBPlayer,107,132,239,0,87,UCBPlayer
44069,UCBPlayer,132,337,469,35,22,UCBPlayer
44070,UCBPlayer,103,148,251,0,83,UCBPlayer
44071,UCBPlayer,136,321,457,35,26,UCBPlayer
44072,UCBPlayer,99,164,263,0,79,UCBPlayer
44073,UCBPlayer,140,305,445,35,30,UCBPlayer
44074,UCBPlayer,95,180,275,0,75,UCBPlayer
44075,UCBPlayer,144,289,433,35,34,UCBPlayer
44076,UCBPlayer,91,196,287,0,71,UCBPlayer
44077,UCBPlayer,148,273,421,35,38,UCBPlayer
44078,UCBPlayer,87,212,299,0,67,UCBPlayer
44079,UCBPlayer,152,257,409,35,42,UCBPlayer
44080,UCBPlayer,84,224,308,0,64,UCBPlayer
44081,UCBPlayer,146,251,397,32,45,UCBPlayer
44082,UCBPlayer,89,234,323,3,60,UCBPlayer
44083,UCBPlayer,138,243,381,28,49,UCBPlayer
44084,UCBPlayer,97,242,339,7,56,UCBPlayer
44085,UCBPlayer,130,235,365,24,53,UCBPlayer
44086,UCBPlayer,105,250,355,11,52,UCBPlayer
44087,UCBPlayer,122,227,349,20,57,UCBPlayer
44088,UCBPlayer,109,259,368,15,49,UCBPlayer
44089,UCBPlayer,118,218,336,16,60,UCBPlayer
44090,UCBPlayer,117,267,384,19,45,UCBPlayer
44091,UCBPlayer,110,210,320,12,64,UCBPlayer
44092,UCBPlayer,126,271,397,23,42,UCBPlayer
44093,UCBPlayer,105,210,315,10,65,UCBPlayer
44094,UCBPlayer,130,275,405,25,40,UCBPlayer
44095,UCBPlayer,105,210,315,10,65,UCBPlayer
44096,UCBPlayer,130,275,405,25,40,UCBPlayer
44097,UCBPlayer,106,206,312,10,66,UCBPlayer
44098,UCBPlayer,130,275,405,25,40,UCBPlayer
44099,UCBPlayer,105,210,315,10,65,UCBPlayer
44100,UCBPlayer,131,271,402,25,41,UCBPlayer
44101,UCBPlayer,105,210,315,10,65,UCBPlayer
44102,UCBPlayer,130,275,405,25,40,UCBPlayer
44103,UCBPlayer,105,210,315,10,65,UCBPlayer
44104,UCBPlayer,130,275,405,25,40,UCBPlayer
44105,UCBPlayer,103,203,306,10,68,UCBPlayer
44106,UCBPlayer,128,283,411,25,38,UCBPlayer
44107,UCBPlayer,111,186,297,10,71,UCBPlayer
44108,UCBPlayer,124,299,423,25,34,UCBPlayer
44109,UCBPlayer,115,170,285,10,75,UCBPlayer
44110,UCBPlayer,120,315,435,25,30,UCBPlayer
44111,UCBPlayer,119,154,273,10,79,UCBPlayer
44112,UCBPlayer,112,332,444,25,27,UCBPlayer
44113,UCBPlayer,127,137,264,10,82,UCBPlayer
44114,UCBPlayer,104,349,453,25,24,UCBPlayer
44115,UCBPlayer,126,126,252,7,85,Tie
44116,UCBPlayer,111,351,462,28,22,UCBPlayer
44117,UCBPlayer,116,126,242,3,87,UCBPlayer
44118,UCBPlayer,122,347,469,32,21,UCBPlayer
44119,UCBPlayer,107,132,239,0,87,UCBPlayer
44120,UCBPlayer,132,337,469,35,22,UCBPlayer
44121,UCBPlayer,103,148,251,0,83,UCBPlayer
44122,UCBPlayer,136,321,457,35,26,UCBPlayer
44123,UCBPlayer,99,164,263,0,79,UCBPlayer
44124,UCBPlayer,140,305,445,35,30,UCBPlayer
44125,UCBPlayer,95,180,275,0,75,UCBPlayer
44126,UCBPlayer,144,289,433,35,34,UCBPlayer
44127,UCBPlayer,91,196,287,0,71,UCBPlayer
44128,UCBPlayer,148,273,421,35,38,UCBPlayer
44129,UCBPlayer,87,212,299,0,67,UCBPlayer
44130,UCBPlayer,152,257,409,35,42,UCBPlayer
44131,UCBPlayer,84,224,308,0,64,UCBPlayer
44132,UCBPlayer,146,251,397,32,45,UCBPlayer
44133,UCBPlayer,89,234,323,3,60,UCBPlayer
44134,UCBPlayer,138,243,381,28,49,UCBPlayer
44135,UCBPlayer,97,242,339,7,56,UCBPlayer
44136,UCBPlayer,130,235,365,24,53,UCBPlayer
44137,UCBPlayer,105,250,355,11,52,UCBPlayer
44138,UCBPlayer,122,227,349,20,57,UCBPlayer
44139,UCBPlayer,109,259,368,15,49,UCBPlayer
44140,UCBPlayer,118,218,336,16,60,UCBPlayer
44141,UCBPlayer,117,267,384,19,45,UCBPlayer
44142,UCBPlayer,110,210,320,12,64,UCBPlayer
44143,UCBPlayer,126,271,397,23,42,UCBPlayer
44144,UCBPlayer,105,210,315,10,65,UCBPlayer
44145,UCBPlayer,130,275,405,25,40,UCBPlayer
44146,UCBPlayer,105,210,315,10,65,UCBPlayer
44147,UCBPlayer,130,275,405,25,40,UCBPlayer
44148,UCBPlayer,106,206,312,10,66,UCBPlayer
44149,UCBPlayer,130,275,405,25,40,UCBPlayer
44150,UCBPlayer,105,210,315,10,65,UCBPlayer
44151,UCBPlayer,131,271,402,25,41,UCBPlayer
44152,UCBPlayer,105,210,315,10,65,UCBPlayer
44153,UCBPlayer,130,275,405,25,40,UCBPlayer
44154,UCBPlayer,105,210,315,10,65,UCBPlayer
44155,UCBPlayer,130,275,405,25,40,UCBPlayer
44156,UCBPlayer,103,203,306,10,68,UCBPlayer
44157,UCBPlayer,128,283,411,25,38,UCBPlayer
44158,UCBPlayer,111,186,297,10,71,UCBPlayer
44159,UCBPlayer,124,299,423,25,34,UCBPlayer
44160,UCBPlayer,115,170,285,10,75,UCBPlayer
44161,UCBPlayer,120,315,435,25,30,UCBPlayer
44162,UCBPlayer,119,154,273,10,79,UCBPlayer
44163,UCBPlayer,112,332,444,25,27,UCBPlayer
44164,UCBPlayer,127,137,264,10,82,UCBPlayer
44165,UCBPlayer,104,349,453,25,24,UCBPlayer
44166,UCBPlayer,126,126,252,7,85,Tie
44167,UCBPlayer,111,351,462,28,22,UCBPlayer
44168,UCBPlayer,116,126,242,3,87,UCBPlayer
44169,UCBPlayer,122,347,469,32,21,UCBPlayer
44170,UCBPlayer,107,132,239,0,87,UCBPlayer
44171,UCBPlayer,132,337,469,35,22,UCBPlayer
44172,UCBPlayer,103,148,251,0,83,UCBPlayer
44173,UCBPlayer,136,321,457,35,26,UCBPlayer
44174,UCBPlayer,99,164,263,0,79,UCBPlayer
44175,UCBPlayer,140,305,445,35,30,UCBPlayer
44176,UCBPlayer,95,180,275,0,75,UCBPlayer
44177,UCBPlayer,144,289,433,35,34,UCBPlayer
44178,UCBPlayer,91,196,287,0,71,UCBPlayer
44179,UCBPlayer,148,273,421,35,38,UCBPlayer
44180,UCBPlayer,87,212,299,0,67,UCBPlayer
44181,UCBPlayer,152,257,409,35,42,UCBPlayer
44182,UCBPlayer,84,224,308,0,64,UCBPlayer
44183,UCBPlayer,146,251,397,32,45,UCBPlayer
44184,UCBPlayer,89,234,323,3,60,UCBPlayer
44185,UCBPlayer,138,243,381,28,49,UCBPlayer
44186,UCBPlayer,97,242,339,7,56,UCBPlayer
44187,UCBPlayer,130,235,365,24,53,UCBPlayer
44188,UCBPlayer,105,250,355,11,52,UCBPlayer
44189,UCBPlayer,122,227,349,20,57,UCBPlayer
44190,UCBPlayer,109,259,368,15,49,UCBPlayer
44191,UCBPlayer,118,218,336,16,60,UCBPlayer
44192,UCBPlayer,117,267,384,19,45,UCBPlayer
44193,UCBPlayer,110,210,320,12,64,UCBPlayer
44194,UCBPlayer,126,271,397,23,42,UCBPlayer
44195,UCBPlayer,105,210,315,10,65,UCBPlayer
44196,UCBPlayer,130,275,405,25,40,UCBPlayer
44197,UCBPlayer,105,210,315,10,65,UCBPlayer
44198,UCBPlayer,130,275,405,25,40,UCBPlayer
44199,UCBPlayer,106,206,312,10,66,UCBPlayer
44200,UCBPlayer,130,275,405,25,40,UCBPlayer
44201,UCBPlayer,105,210,315,10,65,UCBPlayer
44202,UCBPlayer,131,271,402,25,41,UCBPlayer
44203,UCBPlayer,105,210,315,10,65,UCBPlayer
44204,UCBPlayer,130,275,405,25,40,UCBPlayer
44205,UCBPlayer,105,210,315,10,65,UCBPlayer
44206,UCBPlayer,130,275,405,25,40,UCBPlayer
44207,UCBPlayer,103,203,306,10,68,UCBPlayer
44208,UCBPlayer,128,283,411,25,38,UCBPlayer
44209,UCBPlayer,111,186,297,10,71,UCBPlayer
44210,UCBPlayer,124,299,423,25,34,UCBPlayer
44211,UCBPlayer,115,170,285,10,75,UCBPlayer
44212,UCBPlayer,120,315,435,25,30,UCBPlayer
44213,UCBPlayer,119,154,273,10,79,UCBPlayer
44214,UCBPlayer,112,332,444,25,27,UCBPlayer
44215,UCBPlayer,127,137,264,10,82,UCBPlayer
44216,UCBPlayer,104,349,453,25,24,UCBPlayer
44217,UCBPlayer,126,126,252,7,85,Tie
44218,UCBPlayer,111,351,462,28,22,UCBPlayer
44219,UCBPlayer,116,126,242,3,87,UCBPlayer
44220,UCBPlayer,122,347,469,32,21,UCBPlayer
44221,UCBPlayer,107,132,239,0,87,UCBPlayer
44222,UCBPlayer,132,337,469,35,22,UCBPlayer
44223,UCBPlayer,103,148,251,0,83,UCBPlayer
44224,UCBPlayer,136,321,457,35,26,UCBPlayer
44225,UCBPlayer,99,164,263,0,79,UCBPlayer
44226,UCBPlayer,140,305,445,35,30,UCBPlayer
44227,UCBPlayer,95,180,275,0,75,UCBPlayer
44228,UCBPlayer,144,289,433,35,34,UCBPlayer
44229,UCBPlayer,91,196,287,0,71,UCBPlayer
44230,UCBPlayer,148,273,421,35,38,UCBPlayer
44231,UCBPlayer,87,212,299,0,67,UCBPlayer
44232,UCBPlayer,152,257,409,35,42,UCBPlayer
44233,UCBPlayer,84,224,308,0,64,UCBPlayer
44234,UCBPlayer,146,251,397,32,45,UCBPlayer
44235,UCBPlayer,89,234,323,3,60,UCBPlayer
44236,UCBPlayer,138,243,381,28,49,UCBPlayer
44237,UCBPlayer,97,242,339,7,56,UCBPlayer
44238,UCBPlayer,130,235,365,24,53,UCBPlayer
44239,UCBPlayer,105,250,355,11,52,UCBPlayer
44240,UCBPlayer,122,227,349,20,57,UCBPlayer
44241,UCBPlayer,109,259,368,15,49,UCBPlayer
44242,UCBPlayer,118,218,336,16,60,UCBPlayer
44243,UCBPlayer,117,267,384,19,45,UCBPlayer
44244,UCBPlayer,110,210,320,12,64,UCBPlayer
44245,UCBPlayer,126,271,397,23,42,UCBPlayer
44246,UCBPlayer,105,210,315,10,65,UCBPlayer
44247,UCBPlayer,130,275,405,25,40,UCBPlayer
44248,UCBPlayer,105,210,315,10,65,UCBPlayer
44249,UCBPlayer,130,275,405,25,40,UCBPlayer
44250,UCBPlayer,106,206,312,10,66,UCBPlayer
44251,UCBPlayer,130,275,405,25,40,UCBPlayer
44252,UCBPlayer,105,210,315,10,65,UCBPlayer
44253,UCBPlayer,131,271,402,25,41,UCBPlayer
44254,UCBPlayer,105,210,315,10,65,UCBPlayer
44255,UCBPlayer,130,275,405,25,40,UCBPlayer
44256,UCBPlayer,105,210,315,10,65,UCBPlayer
44257,UCBPlayer,130,275,405,25,40,UCBPlayer
44258,UCBPlayer,103,203,306,10,68,UCBPlayer
44259,UCBPlayer,128,283,411,25,38,UCBPlayer
44260,UCBPlayer,111,186,297,10,71,UCBPlayer
44261,UCBPlayer,124,299,423,25,34,UCBPlayer
44262,UCBPlayer,115,170,285,10,75,UCBPlayer
44263,UCBPlayer,120,315,435,25,30,UCBPlayer
44264,UCBPlayer,119,154,273,10,79,UCBPlayer
44265,UCBPlayer,112,332,444,25,27,UCBPlayer
44266,UCBPlayer,127,137,264,10,82,UCBPlayer
44267,UCBPlayer,104,349,453,25,24,UCBPlayer
44268,UCBPlayer,126,126,252,7,85,Tie
44269,UCBPlayer,111,351,462,28,22,UCBPlayer
44270,UCBPlayer,116,126,242,3,87,UCBPlayer
44271,UCBPlayer,122,347,469,32,21,UCBPlayer
44272,UCBPlayer,107,132,239,0,87,UCBPlayer
44273,UCBPlayer,132,337,469,35,22,UCBPlayer
44274,UCBPlayer,103,148,251,0,83,UCBPlayer
44275,UCBPlayer,136,321,457,35,26,UCBPlayer
44276,UCBPlayer,99,164,263,0,79,UCBPlayer
44277,UCBPlayer,140,305,445,35,30,UCBPlayer
44278,UCBPlayer,95,180,275,0,75,UCBPlayer
44279,UCBPlayer,144,289,433,35,34,UCBPlayer
44280,UCBPlayer,91,196,287,0,71,UCBPlayer
44281,UCBPlayer,148,273,421,35,38,UCBPlayer
44282,UCBPlayer,87,212,299,0,67,UCBPlayer
44283,UCBPlayer,152,257,409,35,42,UCBPlayer
44284,UCBPlayer,84,224,308,0,64,UCBPlayer
44285,UCBPlayer,146,251,397,32,45,UCBPlayer
44286,UCBPlayer,89,234,323,3,60,UCBPlayer
44287,UCBPlayer,138,243,381,28,49,UCBPlayer
44288,UCBPlayer,97,242,339,7,56,UCBPlayer
44289,UCBPlayer,130,235,365,24,53,UCBPlayer
44290,UCBPlayer,105,250,355,11,52,UCBPlayer
44291,UCBPlayer,122,227,349,20,57,UCBPlayer
44292,UCBPlayer,109,259,368,15,49,UCBPlayer
44293,UCBPlayer,118,218,336,16,60,UCBPlayer
44294,UCBPlayer,117,267,384,19,45,UCBPlayer
44295,UCBPlayer,110,210,320,12,64,UCBPlayer
44296,UCBPlayer,126,271,397,23,42,UCBPlayer
44297,UCBPlayer,105,210,315,10,65,UCBPlayer
44298,UCBPlayer,130,275,405,25,40,UCBPlayer
44299,UCBPlayer,105,210,315,10,65,UCBPlayer
44300,UCBPlayer,130,275,405,25,40,UCBPlayer
44301,UCBPlayer,106,206,312,10,66,UCBPlayer
44302,UCBPlayer,130,275,405,25,40,UCBPlayer
44303,UCBPlayer,105,210,315,10,65,UCBPlayer
44304,UCBPlayer,131,271,402,25,41,UCBPlayer
44305,UCBPlayer,105,210,315,10,65,UCBPlayer
44306,UCBPlayer,130,275,405,25,40,UCBPlayer
44307,UCBPlayer,105,210,315,10,65,UCBPlayer
44308,UCBPlayer,130,275,405,25,40,UCBPlayer
44309,UCBPlayer,103,203,306,10,68,UCBPlayer
44310,UCBPlayer,128,283,411,25,38,UCBPlayer
44311,UCBPlayer,111,186,297,10,71,UCBPlayer
44312,UCBPlayer,124,299,423,25,34,UCBPlayer
44313,UCBPlayer,115,170,285,10,75,UCBPlayer
44314,UCBPlayer,120,315,435,25,30,UCBPlayer
44315,UCBPlayer,119,154,273,10,79,UCBPlayer
44316,UCBPlayer,112,332,444,25,27,UCBPlayer
44317,UCBPlayer,127,137,264,10,82,UCBPlayer
44318,UCBPlayer,104,349,453,25,24,UCBPlayer
44319,UCBPlayer,126,126,252,7,85,Tie
44320,UCBPlayer,111,351,462,28,22,UCBPlayer
44321,UCBPlayer,116,126,242,3,87,UCBPlayer
44322,UCBPlayer,122,347,469,32,21,UCBPlayer
44323,UCBPlayer,107,132,239,0,87,UCBPlayer
44324,UCBPlayer,132,337,469,35,22,UCBPlayer
44325,UCBPlayer,103,148,251,0,83,UCBPlayer
44326,UCBPlayer,136,321,457,35,26,UCBPlayer
44327,UCBPlayer,99,164,263,0,79,UCBPlayer
44328,UCBPlayer,140,305,445,35,30,UCBPlayer
44329,UCBPlayer,95,180,275,0,75,UCBPlayer
44330,UCBPlayer,144,289,433,35,34,UCBPlayer
44331,UCBPlayer,91,196,287,0,71,UCBPlayer
44332,UCBPlayer,148,273,421,35,38,UCBPlayer
44333,UCBPlayer,87,212,299,0,67,UCBPlayer
44334,UCBPlayer,152,257,409,35,42,UCBPlayer
44335,UCBPlayer,84,224,308,0,64,UCBPlayer
44336,UCBPlayer,146,251,397,32,45,UCBPlayer
44337,UCBPlayer,89,234,323,3,60,UCBPlayer
44338,UCBPlayer,138,243,381,28,49,UCBPlayer
44339,UCBPlayer,97,242,339,7,56,UCBPlayer
44340,UCBPlayer,130,235,365,24,53,UCBPlayer
44341,UCBPlayer,105,250,355,11,52,UCBPlayer
44342,UCBPlayer,122,227,349,20,57,UCBPlayer
44343,UCBPlayer,109,259,368,15,49,UCBPlayer
44344,UCBPlayer,118,218,336,16,60,UCBPlayer
44345,UCBPlayer,117,267,384,19,45,UCBPlayer
44346,UCBPlayer,110,210,320,12,64,UCBPlayer
44347,UCBPlayer,126,271,397,23,42,UCBPlayer
44348,UCBPlayer,105,210,315,10,65,UCBPlayer
44349,UCBPlayer,130,275,405,25,40,UCBPlayer
44350,UCBPlayer,105,210,315,10,65,UCBPlayer
44351,UCBPlayer,130,275,405,25,40,UCBPlayer
44352,UCBPlayer,106,206,312,10,66,UCBPlayer
44353,UCBPlayer,130,275,405,25,40,UCBPlayer
44354,UCBPlayer,105,210,315,10,65,UCBPlayer
44355,UCBPlayer,131,271,402,25,41,UCBPlayer
44356,UCBPlayer,105,210,315,10,65,UCBPlayer
44357,UCBPlayer,130,275,405,25,40,UCBPlayer
44358,UCBPlayer,105,210,315,10,65,UCBPlayer
44359,UCBPlayer,130,275,405,25,40,UCBPlayer
44360,UCBPlayer,103,203,306,10,68,UCBPlayer
44361,UCBPlayer,128,283,411,25,38,UCBPlayer
44362,UCBPlayer,111,186,297,10,71,UCBPlayer
44363,UCBPlayer,124,299,423,25,34,UCBPlayer
44364,UCBPlayer,115,170,285,10,75,UCBPlayer
44365,UCBPlayer,120,315,435,25,30,UCBPlayer
44366,UCBPlayer,119,154,273,10,79,UCBPlayer
44367,UCBPlayer,112,332,444,25,27,UCBPlayer
44368,UCBPlayer,127,137,264,10,82,UCBPlayer
44369,UCBPlayer,104,349,453,25,24,UCBPlayer
44370,UCBPlayer,126,126,252,7,85,Tie
44371,UCBPlayer,111,351,462,28,22,UCBPlayer
44372,UCBPlayer,116,126,242,3,87,UCBPlayer
44373,UCBPlayer,122,347,469,32,21,UCBPlayer
44374,UCBPlayer,107,132,239,0,87,UCBPlayer
44375,UCBPlayer,132,337,469,35,22,UCBPlayer
44376,UCBPlayer,103,148,251,0,83,UCBPlayer
44377,UCBPlayer,136,321,457,35,26,UCBPlayer
44378,UCBPlayer,99,164,263,0,79,UCBPlayer
44379,UCBPlayer,140,305,445,35,30,UCBPlayer
44380,UCBPlayer,95,180,275,0,75,UCBPlayer
44381,UCBPlayer,144,289,433,35,34,UCBPlayer
44382,UCBPlayer,91,196,287,0,71,UCBPlayer
44383,UCBPlayer,148,273,421,35,38,UCBPlayer
44384,UCBPlayer,87,212,299,0,67,UCBPlayer
44385,UCBPlayer,152,257,409,35,42,UCBPlayer
44386,UCBPlayer,84,224,308,0,64,UCBPlayer
44387,UCBPlayer,146,251,397,32,45,UCBPlayer
44388,UCBPlayer,89,234,323,3,60,UCBPlayer
44389,UCBPlayer,138,243,381,28,49,UCBPlayer
44390,UCBPlayer,97,242,339,7,56,UCBPlayer
44391,UCBPlayer,130,235,365,24,53,UCBPlayer
44392,UCBPlayer,105,250,355,11,52,UCBPlayer
44393,UCBPlayer,122,227,349,20,57,UCBPlayer
44394,UCBPlayer,109,259,368,15,49,UCBPlayer
44395,UCBPlayer,118,218,336,16,60,UCBPlayer
44396,UCBPlayer,117,267,384,19,45,UCBPlayer
44397,UCBPlayer,110,210,320,12,64,UCBPlayer
44398,UCBPlayer,126,271,397,23,42,UCBPlayer
44399,UCBPlayer,105,210,315,10,65,UCBPlayer
44400,UCBPlayer,130,275,405,25,40,UCBPlayer
44401,UCBPlayer,105,210,315,10,65,UCBPlayer
44402,UCBPlayer,130,275,405,25,40,UCBPlayer
44403,UCBPlayer,106,206,312,10,66,UCBPlayer
44404,UCBPlayer,130,275,405,25,40,UCBPlayer
44405,UCBPlayer,105,210,315,10,65,UCBPlayer
44406,UCBPlayer,131,271,402,25,41,UCBPlayer
44407,UCBPlayer,105,210,315,10,65,UCBPlayer
44408,UCBPlayer,130,275,405,25,40,UCBPlayer
44409,UCBPlayer,105,210,315,10,65,UCBPlayer
44410,UCBPlayer,130,275,405,25,40,UCBPlayer
44411,UCBPlayer,103,203,306,10,68,UCBPlayer
44412,UCBPlayer,128,283,411,25,38,UCBPlayer
44413,UCBPlayer,111,186,297,10,71,UCBPlayer
44414,UCBPlayer,124,299,423,25,34,UCBPlayer
44415,UCBPlayer,115,170,285,10,75,UCBPlayer
44416,UCBPlayer,120,315,435,25,30,UCBPlayer
44417,UCBPlayer,119,154,273,10,79,UCBPlayer
44418,UCBPlayer,112,332,444,25,27,UCBPlayer
44419,UCBPlayer,127,137,264,10,82,UCBPlayer
44420,UCBPlayer,104,349,453,25,24,UCBPlayer
44421,UCBPlayer,126,126,252,7,85,Tie
44422,UCBPlayer,111,351,462,28,22,UCBPlayer
44423,UCBPlayer,116,126,242,3,87,UCBPlayer
44424,UCBPlayer,122,347,469,32,21,UCBPlayer
44425,UCBPlayer,107,132,239,0,87,UCBPlayer
44426,UCBPlayer,132,337,469,35,22,UCBPlayer
44427,UCBPlayer,103,148,251,0,83,UCBPlayer
44428,UCBPlayer,136,321,457,35,26,UCBPlayer
44429,UCBPlayer,99,164,263,0,79,UCBPlayer
44430,UCBPlayer,140,305,445,35,30,UCBPlayer
44431,UCBPlayer,95,180,275,0,75,UCBPlayer
44432,UCBPlayer,144,289,433,35,34,UCBPlayer
44433,UCBPlayer,91,196,287,0,71,UCBPlayer
44434,UCBPlayer,148,273,421,35,38,UCBPlayer
44435,UCBPlayer,87,212,299,0,67,UCBPlayer
44436,UCBPlayer,152,257,409,35,42,UCBPlayer
44437,UCBPlayer,84,224,308,0,64,UCBPlayer
44438,UCBPlayer,146,251,397,32,45,UCBPlayer
44439,UCBPlayer,89,234,323,3,60,UCBPlayer
44440,UCBPlayer,138,243,381,28,49,UCBPlayer
44441,UCBPlayer,97,242,339,7,56,UCBPlayer
44442,UCBPlayer,130,235,365,24,53,UCBPlayer
44443,UCBPlayer,105,250,355,11,52,UCBPlayer
44444,UCBPlayer,122,227,349,20,57,UCBPlayer
44445,UCBPlayer,109,259,368,15,49,UCBPlayer
44446,UCBPlayer,118,218,336,16,60,UCBPlayer
44447,UCBPlayer,117,267,384,19,45,UCBPlayer
44448,UCBPlayer,110,210,320,12,64,UCBPlayer
44449,UCBPlayer,126,271,397,23,42,UCBPlayer
44450,UCBPlayer,105,210,315,10,65,UCBPlayer
44451,UCBPlayer,130,275,405,25,40,UCBPlayer
44452,UCBPlayer,105,210,315,10,65,UCBPlayer
44453,UCBPlayer,130,275,405,25,40,UCBPlayer
44454,UCBPlayer,106,206,312,10,66,UCBPlayer
44455,UCBPlayer,130,275,405,25,40,UCBPlayer
44456,UCBPlayer,105,210,315,10,65,UCBPlayer
44457,UCBPlayer,131,271,402,25,41,UCBPlayer
44458,UCBPlayer,105,210,315,10,65,UCBPlayer
44459,UCBPlayer,130,275,405,25,40,UCBPlayer
44460,UCBPlayer,105,210,315,10,65,UCBPlayer
44461,UCBPlayer,130,275,405,25,40,UCBPlayer
44462,UCBPlayer,103,203,306,10,68,UCBPlayer
44463,UCBPlayer,128,283,411,25,38,UCBPlayer
44464,UCBPlayer,111,186,297,10,71,UCBPlayer
44465,UCBPlayer,124,299,423,25,34,UCBPlayer
44466,UCBPlayer,115,170,285,10,75,UCBPlayer
44467,UCBPlayer,120,315,435,25,30,UCBPlayer
44468,UCBPlayer,119,154,273,10,79,UCBPlayer
44469,UCBPlayer,112,332,444,25,27,UCBPlayer
44470,UCBPlayer,127,137,264,10,82,UCBPlayer
44471,UCBPlayer,104,349,453,25,24,UCBPlayer
44472,UCBPlayer,126,126,252,7,85,Tie
44473,UCBPlayer,111,351,462,28,22,UCBPlayer
44474,UCBPlayer,116,126,242,3,87,UCBPlayer
44475,UCBPlayer,122,347,469,32,21,UCBPlayer
44476,UCBPlayer,107,132,239,0,87,UCBPlayer
44477,UCBPlayer,132,337,469,35,22,UCBPlayer
44478,UCBPlayer,103,148,251,0,83,UCBPlayer
44479,UCBPlayer,136,321,457,35,26,UCBPlayer
44480,UCBPlayer,99,164,263,0,79,UCBPlayer
44481,UCBPlayer,140,305,445,35,30,UCBPlayer
44482,UCBPlayer,95,180,275,0,75,UCBPlayer
44483,UCBPlayer,144,289,433,35,34,UCBPlayer
44484,UCBPlayer,91,196,287,0,71,UCBPlayer
44485,UCBPlayer,148,273,421,35,38,UCBPlayer
44486,UCBPlayer,87,212,299,0,67,UCBPlayer
44487,UCBPlayer,152,257,409,35,42,UCBPlayer
44488,UCBPlayer,84,224,308,0,64,UCBPlayer
44489,UCBPlayer,146,251,397,32,45,UCBPlayer
44490,UCBPlayer,89,234,323,3,60,UCBPlayer
44491,UCBPlayer,138,243,381,28,49,UCBPlayer
44492,UCBPlayer,97,242,339,7,56,UCBPlayer
44493,UCBPlayer,130,235,365,24,53,UCBPlayer
44494,UCBPlayer,105,250,355,11,52,UCBPlayer
44495,UCBPlayer,122,227,349,20,57,UCBPlayer
44496,UCBPlayer,109,259,368,15,49,UCBPlayer
44497,UCBPlayer,118,218,336,16,60,UCBPlayer
44498,UCBPlayer,117,267,384,19,45,UCBPlayer
44499,UCBPlayer,110,210,320,12,64,UCBPlayer
44500,UCBPlayer,126,271,397,23,42,UCBPlayer
44501,UCBPlayer,105,210,315,10,65,UCBPlayer
44502,UCBPlayer,130,275,405,25,40,UCBPlayer
44503,UCBPlayer,105,210,315,10,65,UCBPlayer
44504,UCBPlayer,130,275,405,25,40,UCBPlayer
44505,UCBPlayer,106,206,312,10,66,UCBPlayer
44506,UCBPlayer,130,275,405,25,40,UCBPlayer
44507,UCBPlayer,105,210,315,10,65,UCBPlayer
44508,UCBPlayer,131,271,402,25,41,UCBPlayer
44509,UCBPlayer,105,210,315,10,65,UCBPlayer
44510,UCBPlayer,130,275,405,25,40,UCBPlayer
44511,UCBPlayer,105,210,315,10,65,UCBPlayer
44512,UCBPlayer,130,275,405,25,40,UCBPlayer
44513,UCBPlayer,103,203,306,10,68,UCBPlayer
44514,UCBPlayer,128,283,411,25,38,UCBPlayer
44515,UCBPlayer,111,186,297,10,71,UCBPlayer
44516,UCBPlayer,124,299,423,25,34,UCBPlayer
44517,UCBPlayer,115,170,285,10,75,UCBPlayer
44518,UCBPlayer,120,315,435,25,30,UCBPlayer
44519,UCBPlayer,119,154,273,10,79,UCBPlayer
44520,UCBPlayer,112,332,444,25,27,UCBPlayer
44521,UCBPlayer,127,137,264,10,82,UCBPlayer
44522,UCBPlayer,104,349,453,25,24,UCBPlayer
44523,UCBPlayer,126,126,252,7,85,Tie
44524,UCBPlayer,111,351,462,28,22,UCBPlayer
44525,UCBPlayer,116,126,242,3,87,UCBPlayer
44526,UCBPlayer,122,347,469,32,21,UCBPlayer
44527,UCBPlayer,107,132,239,0,87,UCBPlayer
44528,UCBPlayer,132,337,469,35,22,UCBPlayer
44529,UCBPlayer,103,148,251,0,83,UCBPlayer
44530,UCBPlayer,136,321,457,35,26,UCBPlayer
44531,UCBPlayer,99,164,263,0,79,UCBPlayer
44532,UCBPlayer,140,305,445,35,30,UCBPlayer
44533,UCBPlayer,95,180,275,0,75,UCBPlayer
44534,UCBPlayer,144,289,433,35,34,UCBPlayer
44535,UCBPlayer,91,196,287,0,71,UCBPlayer
44536,UCBPlayer,148,273,421,35,38,UCBPlayer
44537,UCBPlayer,87,212,299,0,67,UCBPlayer
44538,UCBPlayer,152,257,409,35,42,UCBPlayer
44539,UCBPlayer,84,224,308,0,64,UCBPlayer
44540,UCBPlayer,146,251,397,32,45,UCBPlayer
44541,UCBPlayer,89,234,323,3,60,UCBPlayer
44542,UCBPlayer,138,243,381,28,49,UCBPlayer
44543,UCBPlayer,97,242,339,7,56,UCBPlayer
44544,UCBPlayer,130,235,365,24,53,UCBPlayer
44545,UCBPlayer,105,250,355,11,52,UCBPlayer
44546,UCBPlayer,122,227,349,20,57,UCBPlayer
44547,UCBPlayer,109,259,368,15,49,UCBPlayer
44548,UCBPlayer,118,218,336,16,60,UCBPlayer
44549,UCBPlayer,117,267,384,19,45,UCBPlayer
44550,UCBPlayer,110,210,320,12,64,UCBPlayer
44551,UCBPlayer,126,271,397,23,42,UCBPlayer
44552,UCBPlayer,105,210,315,10,65,UCBPlayer
44553,UCBPlayer,130,275,405,25,40,UCBPlayer
44554,UCBPlayer,105,210,315,10,65,UCBPlayer
44555,UCBPlayer,130,275,405,25,40,UCBPlayer
44556,UCBPlayer,106,206,312,10,66,UCBPlayer
44557,UCBPlayer,130,275,405,25,40,UCBPlayer
44558,UCBPlayer,105,210,315,10,65,UCBPlayer
44559,UCBPlayer,131,271,402,25,41,UCBPlayer
44560,UCBPlayer,105,210,315,10,65,UCBPlayer
44561,UCBPlayer,130,275,405,25,40,UCBPlayer
44562,UCBPlayer,105,210,315,10,65,UCBPlayer
44563,UCBPlayer,130,275,405,25,40,UCBPlayer
44564,UCBPlayer,103,203,306,10,68,UCBPlayer
44565,UCBPlayer,128,283,411,25,38,UCBPlayer
44566,UCBPlayer,111,186,297,10,71,UCBPlayer
44567,UCBPlayer,124,299,423,25,34,UCBPlayer
44568,UCBPlayer,115,170,285,10,75,UCBPlayer
44569,UCBPlayer,120,315,435,25,30,UCBPlayer
44570,UCBPlayer,119,154,273,10,79,UCBPlayer
44571,UCBPlayer,112,332,444,25,27,UCBPlayer
44572,UCBPlayer,127,137,264,10,82,UCBPlayer
44573,UCBPlayer,104,349,453,25,24,UCBPlayer
44574,UCBPlayer,126,126,252,7,85,Tie
44575,UCBPlayer,111,351,462,28,22,UCBPlayer
44576,UCBPlayer,116,126,242,3,87,UCBPlayer
44577,UCBPlayer,122,347,469,32,21,UCBPlayer
44578,UCBPlayer,107,132,239,0,87,UCBPlayer
44579,UCBPlayer,132,337,469,35,22,UCBPlayer
44580,UCBPlayer,103,148,251,0,83,UCBPlayer
44581,UCBPlayer,136,321,457,35,26,UCBPlayer
44582,UCBPlayer,99,164,263,0,79,UCBPlayer
44583,UCBPlayer,140,305,445,35,30,UCBPlayer
44584,UCBPlayer,95,180,275,0,75,UCBPlayer
44585,UCBPlayer,144,289,433,35,34,UCBPlayer
44586,UCBPlayer,91,196,287,0,71,UCBPlayer
44587,UCBPlayer,148,273,421,35,38,UCBPlayer
44588,UCBPlayer,87,212,299,0,67,UCBPlayer
44589,UCBPlayer,152,257,409,35,42,UCBPlayer
44590,UCBPlayer,84,224,308,0,64,UCBPlayer
44591,UCBPlayer,146,251,397,32,45,UCBPlayer
44592,UCBPlayer,89,234,323,3,60,UCBPlayer
44593,UCBPlayer,138,243,381,28,49,UCBPlayer
44594,UCBPlayer,97,242,339,7,56,UCBPlayer
44595,UCBPlayer,130,235,365,24,53,UCBPlayer
44596,UCBPlayer,105,250,355,11,52,UCBPlayer
44597,UCBPlayer,122,227,349,20,57,UCBPlayer
44598,UCBPlayer,109,259,368,15,49,UCBPlayer
44599,UCBPlayer,118,218,336,16,60,UCBPlayer
44600,UCBPlayer,117,267,384,19,45,UCBPlayer
44601,UCBPlayer,110,210,320,12,64,UCBPlayer
44602,UCBPlayer,126,271,397,23,42,UCBPlayer
44603,UCBPlayer,105,210,315,10,65,UCBPlayer
44604,UCBPlayer,130,275,405,25,40,UCBPlayer
44605,UCBPlayer,105,210,315,10,65,UCBPlayer
44606,UCBPlayer,130,275,405,25,40,UCBPlayer
44607,UCBPlayer,106,206,312,10,66,UCBPlayer
44608,UCBPlayer,130,275,405,25,40,UCBPlayer
44609,UCBPlayer,105,210,315,10,65,UCBPlayer
44610,UCBPlayer,131,271,402,25,41,UCBPlayer
44611,UCBPlayer,105,210,315,10,65,UCBPlayer
44612,UCBPlayer,130,275,405,25,40,UCBPlayer
44613,UCBPlayer,105,210,315,10,65,UCBPlayer
44614,UCBPlayer,130,275,405,25,40,UCBPlayer
44615,UCBPlayer,103,203,306,10,68,UCBPlayer
44616,UCBPlayer,128,283,411,25,38,UCBPlayer
44617,UCBPlayer,111,186,297,10,71,UCBPlayer
44618,UCBPlayer,124,299,423,25,34,UCBPlayer
44619,UCBPlayer,115,170,285,10,75,UCBPlayer
44620,UCBPlayer,120,315,435,25,30,UCBPlayer
44621,UCBPlayer,119,154,273,10,79,UCBPlayer
44622,UCBPlayer,112,332,444,25,27,UCBPlayer
44623,UCBPlayer,127,137,264,10,82,UCBPlayer
44624,UCBPlayer,104,349,453,25,24,UCBPlayer
44625,UCBPlayer,126,126,252,7,85,Tie
44626,UCBPlayer,111,351,462,28,22,UCBPlayer
44627,UCBPlayer,116,126,242,3,87,UCBPlayer
44628,UCBPlayer,122,347,469,32,21,UCBPlayer
44629,UCBPlayer,107,132,239,0,87,UCBPlayer
44630,UCBPlayer,132,337,469,35,22,UCBPlayer
44631,UCBPlayer,103,148,251,0,83,UCBPlayer
44632,UCBPlayer,136,321,457,35,26,UCBPlayer
44633,UCBPlayer,99,164,263,0,79,UCBPlayer
44634,UCBPlayer,140,305,445,35,30,UCBPlayer
44635,UCBPlayer,95,180,275,0,75,UCBPlayer
44636,UCBPlayer,144,289,433,35,34,UCBPlayer
44637,UCBPlayer,91,196,287,0,71,UCBPlayer
44638,UCBPlayer,148,273,421,35,38,UCBPlayer
44639,UCBPlayer,87,212,299,0,67,UCBPlayer
44640,UCBPlayer,152,257,409,35,42,UCBPlayer
44641,UCBPlayer,84,224,308,0,64,UCBPlayer
44642,UCBPlayer,146,251,397,32,45,UCBPlayer
44643,UCBPlayer,89,234,323,3,60,UCBPlayer
44644,UCBPlayer,138,243,381,28,49,UCBPlayer
44645,UCBPlayer,97,242,339,7,56,UCBPlayer
44646,UCBPlayer,130,235,365,24,53,UCBPlayer
44647,UCBPlayer,105,250,355,11,52,UCBPlayer
44648,UCBPlayer,122,227,349,20,57,UCBPlayer
44649,UCBPlayer,109,259,368,15,49,UCBPlayer
44650,UCBPlayer,118,218,336,16,60,UCBPlayer
44651,UCBPlayer,117,267,384,19,45,UCBPlayer
44652,UCBPlayer,110,210,320,12,64,UCBPlayer
44653,UCBPlayer,126,271,397,23,42,UCBPlayer
44654,UCBPlayer,105,210,315,10,65,UCBPlayer
44655,UCBPlayer,130,275,405,25,40,UCBPlayer
44656,UCBPlayer,105,210,315,10,65,UCBPlayer
44657,UCBPlayer,130,275,405,25,40,UCBPlayer
44658,UCBPlayer,106,206,312,10,66,UCBPlayer
44659,UCBPlayer,130,275,405,25,40,UCBPlayer
44660,UCBPlayer,105,210,315,10,65,UCBPlayer
44661,UCBPlayer,131,271,402,25,41,UCBPlayer
44662,UCBPlayer,105,210,315,10,65,UCBPlayer
44663,UCBPlayer,130,275,405,25,40,UCBPlayer
44664,UCBPlayer,105,210,315,10,65,UCBPlayer
44665,UCBPlayer,130,275,405,25,40,UCBPlayer
44666,UCBPlayer,103,203,306,10,68,UCBPlayer
44667,UCBPlayer,128,283,411,25,38,UCBPlayer
44668,UCBPlayer,111,186,297,10,71,UCBPlayer
44669,UCBPlayer,124,299,423,25,34,UCBPlayer
44670,UCBPlayer,115,170,285,10,75,UCBPlayer
44671,UCBPlayer,120,315,435,25,30,UCBPlayer
44672,UCBPlayer,119,154,273,10,79,UCBPlayer
44673,UCBPlayer,112,332,444,25,27,UCBPlayer
44674,UCBPlayer,127,137,264,10,82,UCBPlayer
44675,UCBPlayer,104,349,453,25,24,UCBPlayer
44676,UCBPlayer,126,126,252,7,85,Tie
44677,UCBPlayer,111,351,462,28,22,UCBPlayer
44678,UCBPlayer,116,126,242,3,87,UCBPlayer
44679,UCBPlayer,122,347,469,32,21,UCBPlayer
44680,UCBPlayer,107,132,239,0,87,UCBPlayer
44681,UCBPlayer,132,337,469,35,22,UCBPlayer
44682,UCBPlayer,103,148,251,0,83,UCBPlayer
44683,UCBPlayer,136,321,457,35,26,UCBPlayer
44684,UCBPlayer,99,164,263,0,79,UCBPlayer
44685,UCBPlayer,140,305,445,35,30,UCBPlayer
44686,UCBPlayer,95,180,275,0,75,UCBPlayer
44687,UCBPlayer,144,289,433,35,34,UCBPlayer
44688,UCBPlayer,91,196,287,0,71,UCBPlayer
44689,UCBPlayer,148,273,421,35,38,UCBPlayer
44690,UCBPlayer,87,212,299,0,67,UCBPlayer
44691,UCBPlayer,152,257,409,35,42,UCBPlayer
44692,UCBPlayer,84,224,308,0,64,UCBPlayer
44693,UCBPlayer,146,251,397,32,45,UCBPlayer
44694,UCBPlayer,89,234,323,3,60,UCBPlayer
44695,UCBPlayer,138,243,381,28,49,UCBPlayer
44696,UCBPlayer,97,242,339,7,56,UCBPlayer
44697,UCBPlayer,130,235,365,24,53,UCBPlayer
44698,UCBPlayer,105,250,355,11,52,UCBPlayer
44699,UCBPlayer,122,227,349,20,57,UCBPlayer
44700,UCBPlayer,109,259,368,15,49,UCBPlayer
44701,UCBPlayer,118,218,336,16,60,UCBPlayer
44702,UCBPlayer,117,267,384,19,45,UCBPlayer
44703,UCBPlayer,110,210,320,12,64,UCBPlayer
44704,UCBPlayer,126,271,397,23,42,UCBPlayer
44705,UCBPlayer,105,210,315,10,65,UCBPlayer
44706,UCBPlayer,130,275,405,25,40,UCBPlayer
44707,UCBPlayer,105,210,315,10,65,UCBPlayer
44708,UCBPlayer,130,275,405,25,40,UCBPlayer
44709,UCBPlayer,106,206,312,10,66,UCBPlayer
44710,UCBPlayer,130,275,405,25,40,UCBPlayer
44711,UCBPlayer,105,210,315,10,65,UCBPlayer
44712,UCBPlayer,131,271,402,25,41,UCBPlayer
44713,UCBPlayer,105,210,315,10,65,UCBPlayer
44714,UCBPlayer,130,275,405,25,40,UCBPlayer
44715,UCBPlayer,105,210,315,10,65,UCBPlayer
44716,UCBPlayer,130,275,405,25,40,UCBPlayer
44717,UCBPlayer,103,203,306,10,68,UCBPlayer
44718,UCBPlayer,128,283,411,25,38,UCBPlayer
44719,UCBPlayer,111,186,297,10,71,UCBPlayer
44720,UCBPlayer,124,299,423,25,34,UCBPlayer
44721,UCBPlayer,115,170,285,10,75,UCBPlayer
44722,UCBPlayer,120,315,435,25,30,UCBPlayer
44723,UCBPlayer,119,154,273,10,79,UCBPlayer
44724,UCBPlayer,112,332,444,25,27,UCBPlayer
44725,UCBPlayer,127,137,264,10,82,UCBPlayer
44726,UCBPlayer,104,349,453,25,24,UCBPlayer
44727,UCBPlayer,126,126,252,7,85,Tie
44728,UCBPlayer,111,351,462,28,22,UCBPlayer
44729,UCBPlayer,116,126,242,3,87,UCBPlayer
44730,UCBPlayer,122,347,469,32,21,UCBPlayer
44731,UCBPlayer,107,132,239,0,87,UCBPlayer
44732,UCBPlayer,132,337,469,35,22,UCBPlayer
44733,UCBPlayer,103,148,251,0,83,UCBPlayer
44734,UCBPlayer,136,321,457,35,26,UCBPlayer
44735,UCBPlayer,99,164,263,0,79,UCBPlayer
44736,UCBPlayer,140,305,445,35,30,UCBPlayer
44737,UCBPlayer,95,180,275,0,75,UCBPlayer
44738,UCBPlayer,144,289,433,35,34,UCBPlayer
44739,UCBPlayer,91,196,287,0,71,UCBPlayer
44740,UCBPlayer,148,273,421,35,38,UCBPlayer
44741,UCBPlayer,87,212,299,0,67,UCBPlayer
44742,UCBPlayer,152,257,409,35,42,UCBPlayer
44743,UCBPlayer,84,224,308,0,64,UCBPlayer
44744,UCBPlayer,146,251,397,32,45,UCBPlayer
44745,UCBPlayer,89,234,323,3,60,UCBPlayer
44746,UCBPlayer,138,243,381,28,49,UCBPlayer
44747,UCBPlayer,97,242,339,7,56,UCBPlayer
44748,UCBPlayer,130,235,365,24,53,UCBPlayer
44749,UCBPlayer,105,250,355,11,52,UCBPlayer
44750,UCBPlayer,122,227,349,20,57,UCBPlayer
44751,UCBPlayer,109,259,368,15,49,UCBPlayer
44752,UCBPlayer,118,218,336,16,60,UCBPlayer
44753,UCBPlayer,117,267,384,19,45,UCBPlayer
44754,UCBPlayer,110,210,320,12,64,UCBPlayer
44755,UCBPlayer,126,271,397,23,42,UCBPlayer
44756,UCBPlayer,105,210,315,10,65,UCBPlayer
44757,UCBPlayer,130,275,405,25,40,UCBPlayer
44758,UCBPlayer,105,210,315,10,65,UCBPlayer
44759,UCBPlayer,130,275,405,25,40,UCBPlayer
44760,UCBPlayer,106,206,312,10,66,UCBPlayer
44761,UCBPlayer,130,275,405,25,40,UCBPlayer
44762,UCBPlayer,105,210,315,10,65,UCBPlayer
44763,UCBPlayer,131,271,402,25,41,UCBPlayer
44764,UCBPlayer,105,210,315,10,65,UCBPlayer
44765,UCBPlayer,130,275,405,25,40,UCBPlayer
44766,UCBPlayer,105,210,315,10,65,UCBPlayer
44767,UCBPlayer,130,275,405,25,40,UCBPlayer
44768,UCBPlayer,103,203,306,10,68,UCBPlayer
44769,UCBPlayer,128,283,411,25,38,UCBPlayer
44770,UCBPlayer,111,186,297,10,71,UCBPlayer
44771,UCBPlayer,124,299,423,25,34,UCBPlayer
44772,UCBPlayer,115,170,285,10,75,UCBPlayer
44773,UCBPlayer,120,315,435,25,30,UCBPlayer
44774,UCBPlayer,119,154,273,10,79,UCBPlayer
44775,UCBPlayer,112,332,444,25,27,UCBPlayer
44776,UCBPlayer,127,137,264,10,82,UCBPlayer
44777,UCBPlayer,104,349,453,25,24,UCBPlayer
44778,UCBPlayer,126,126,252,7,85,Tie
44779,UCBPlayer,111,351,462,28,22,UCBPlayer
44780,UCBPlayer,116,126,242,3,87,UCBPlayer
44781,UCBPlayer,122,347,469,32,21,UCBPlayer
44782,UCBPlayer,107,132,239,0,87,UCBPlayer
44783,UCBPlayer,132,337,469,35,22,UCBPlayer
44784,UCBPlayer,103,148,251,0,83,UCBPlayer
44785,UCBPlayer,136,321,457,35,26,UCBPlayer
44786,UCBPlayer,99,164,263,0,79,UCBPlayer
44787,UCBPlayer,140,305,445,35,30,UCBPlayer
44788,UCBPlayer,95,180,275,0,75,UCBPlayer
44789,UCBPlayer,144,289,433,35,34,UCBPlayer
44790,UCBPlayer,91,196,287,0,71,UCBPlayer
44791,UCBPlayer,148,273,421,35,38,UCBPlayer
44792,UCBPlayer,87,212,299,0,67,UCBPlayer
44793,UCBPlayer,152,257,409,35,42,UCBPlayer
44794,UCBPlayer,84,224,308,0,64,UCBPlayer
44795,UCBPlayer,146,251,397,32,45,UCBPlayer
44796,UCBPlayer,89,234,323,3,60,UCBPlayer
44797,UCBPlayer,138,243,381,28,49,UCBPlayer
44798,UCBPlayer,97,242,339,7,56,UCBPlayer
44799,UCBPlayer,130,235,365,24,53,UCBPlayer
44800,UCBPlayer,105,250,355,11,52,UCBPlayer
44801,UCBPlayer,122,227,349,20,57,UCBPlayer
44802,UCBPlayer,109,259,368,15,49,UCBPlayer
44803,UCBPlayer,118,218,336,16,60,UCBPlayer
44804,UCBPlayer,117,267,384,19,45,UCBPlayer
44805,UCBPlayer,110,210,320,12,64,UCBPlayer
44806,UCBPlayer,126,271,397,23,42,UCBPlayer
44807,UCBPlayer,105,210,315,10,65,UCBPlayer
44808,UCBPlayer,130,275,405,25,40,UCBPlayer
44809,UCBPlayer,105,210,315,10,65,UCBPlayer
44810,UCBPlayer,130,275,405,25,40,UCBPlayer
44811,UCBPlayer,106,206,312,10,66,UCBPlayer
44812,UCBPlayer,130,275,405,25,40,UCBPlayer
44813,UCBPlayer,105,210,315,10,65,UCBPlayer
44814,UCBPlayer,131,271,402,25,41,UCBPlayer
44815,UCBPlayer,105,210,315,10,65,UCBPlayer
44816,UCBPlayer,130,275,405,25,40,UCBPlayer
44817,UCBPlayer,105,210,315,10,65,UCBPlayer
44818,UCBPlayer,130,275,405,25,40,UCBPlayer
44819,UCBPlayer,103,203,306,10,68,UCBPlayer
44820,UCBPlayer,128,283,411,25,38,UCBPlayer
44821,UCBPlayer,111,186,297,10,71,UCBPlayer
44822,UCBPlayer,124,299,423,25,34,UCBPlayer
44823,UCBPlayer,115,170,285,10,75,UCBPlayer
44824,UCBPlayer,120,315,435,25,30,UCBPlayer
44825,UCBPlayer,119,154,273,10,79,UCBPlayer
44826,UCBPlayer,112,332,444,25,27,UCBPlayer
44827,UCBPlayer,127,137,264,10,82,UCBPlayer
44828,UCBPlayer,104,349,453,25,24,UCBPlayer
44829,UCBPlayer,126,126,252,7,85,Tie
44830,UCBPlayer,111,351,462,28,22,UCBPlayer
44831,UCBPlayer,116,126,242,3,87,UCBPlayer
44832,UCBPlayer,122,347,469,32,21,UCBPlayer
44833,UCBPlayer,107,132,239,0,87,UCBPlayer
44834,UCBPlayer,132,337,469,35,22,UCBPlayer
44835,UCBPlayer,103,148,251,0,83,UCBPlayer
44836,UCBPlayer,136,321,457,35,26,UCBPlayer
44837,UCBPlayer,99,164,263,0,79,UCBPlayer
44838,UCBPlayer,140,305,445,35,30,UCBPlayer
44839,UCBPlayer,95,180,275,0,75,UCBPlayer
44840,UCBPlayer,144,289,433,35,34,UCBPlayer
44841,UCBPlayer,91,196,287,0,71,UCBPlayer
44842,UCBPlayer,148,273,421,35,38,UCBPlayer
44843,UCBPlayer,87,212,299,0,67,UCBPlayer
44844,UCBPlayer,152,257,409,35,42,UCBPlayer
44845,UCBPlayer,84,224,308,0,64,UCBPlayer
44846,UCBPlayer,146,251,397,32,45,UCBPlayer
44847,UCBPlayer,89,234,323,3,60,UCBPlayer
44848,UCBPlayer,138,243,381,28,49,UCBPlayer
44849,UCBPlayer,97,242,339,7,56,UCBPlayer
44850,UCBPlayer,130,235,365,24,53,UCBPlayer
44851,UCBPlayer,105,250,355,11,52,UCBPlayer
44852,UCBPlayer,122,227,349,20,57,UCBPlayer
44853,UCBPlayer,109,259,368,15,49,UCBPlayer
44854,UCBPlayer,118,218,336,16,60,UCBPlayer
44855,UCBPlayer,117,267,384,19,45,UCBPlayer
44856,UCBPlayer,110,210,320,12,64,UCBPlayer
44857,UCBPlayer,126,271,397,23,42,UCBPlayer
44858,UCBPlayer,105,210,315,10,65,UCBPlayer
44859,UCBPlayer,130,275,405,25,40,UCBPlayer
44860,UCBPlayer,105,210,315,10,65,UCBPlayer
44861,UCBPlayer,130,275,405,25,40,UCBPlayer
44862,UCBPlayer,106,206,312,10,66,UCBPlayer
44863,UCBPlayer,130,275,405,25,40,UCBPlayer
44864,UCBPlayer,105,210,315,10,65,UCBPlayer
44865,UCBPlayer,131,271,402,25,41,UCBPlayer
44866,UCBPlayer,105,210,315,10,65,UCBPlayer
44867,UCBPlayer,130,275,405,25,40,UCBPlayer
44868,UCBPlayer,105,210,315,10,65,UCBPlayer
44869,UCBPlayer,130,275,405,25,40,UCBPlayer
44870,UCBPlayer,103,203,306,10,68,UCBPlayer
44871,UCBPlayer,128,283,411,25,38,UCBPlayer
44872,UCBPlayer,111,186,297,10,71,UCBPlayer
44873,UCBPlayer,124,299,423,25,34,UCBPlayer
44874,UCBPlayer,115,170,285,10,75,UCBPlayer
44875,UCBPlayer,120,315,435,25,30,UCBPlayer
44876,UCBPlayer,119,154,273,10,79,UCBPlayer
44877,UCBPlayer,112,332,444,25,27,UCBPlayer
44878,UCBPlayer,127,137,264,10,82,UCBPlayer
44879,UCBPlayer,104,349,453,25,24,UCBPlayer
44880,UCBPlayer,126,126,252,7,85,Tie
44881,UCBPlayer,111,351,462,28,22,UCBPlayer
44882,UCBPlayer,116,126,242,3,87,UCBPlayer
44883,UCBPlayer,122,347,469,32,21,UCBPlayer
44884,UCBPlayer,107,132,239,0,87,UCBPlayer
44885,UCBPlayer,132,337,469,35,22,UCBPlayer
44886,UCBPlayer,103,148,251,0,83,UCBPlayer
44887,UCBPlayer,136,321,457,35,26,UCBPlayer
44888,UCBPlayer,99,164,263,0,79,UCBPlayer
44889,UCBPlayer,140,305,445,35,30,UCBPlayer
44890,UCBPlayer,95,180,275,0,75,UCBPlayer
44891,UCBPlayer,144,289,433,35,34,UCBPlayer
44892,UCBPlayer,91,196,287,0,71,UCBPlayer
44893,UCBPlayer,148,273,421,35,38,UCBPlayer
44894,UCBPlayer,87,212,299,0,67,UCBPlayer
44895,UCBPlayer,152,257,409,35,42,UCBPlayer
44896,UCBPlayer,84,224,308,0,64,UCBPlayer
44897,UCBPlayer,146,251,397,32,45,UCBPlayer
44898,UCBPlayer,89,234,323,3,60,UCBPlayer
44899,UCBPlayer,138,243,381,28,49,UCBPlayer
44900,UCBPlayer,97,242,339,7,56,UCBPlayer
44901,UCBPlayer,130,235,365,24,53,UCBPlayer
44902,UCBPlayer,105,250,355,11,52,UCBPlayer
44903,UCBPlayer,122,227,349,20,57,UCBPlayer
44904,UCBPlayer,109,259,368,15,49,UCBPlayer
44905,UCBPlayer,118,218,336,16,60,UCBPlayer
44906,UCBPlayer,117,267,384,19,45,UCBPlayer
44907,UCBPlayer,110,210,320,12,64,UCBPlayer
44908,UCBPlayer,126,271,397,23,42,UCBPlayer
44909,UCBPlayer,105,210,315,10,65,UCBPlayer
44910,UCBPlayer,130,275,405,25,40,UCBPlayer
44911,UCBPlayer,105,210,315,10,65,UCBPlayer
44912,UCBPlayer,130,275,405,25,40,UCBPlayer
44913,UCBPlayer,106,206,312,10,66,UCBPlayer
44914,UCBPlayer,130,275,405,25,40,UCBPlayer
44915,UCBPlayer,105,210,315,10,65,UCBPlayer
44916,UCBPlayer,131,271,402,25,41,UCBPlayer
44917,UCBPlayer,105,210,315,10,65,UCBPlayer
44918,UCBPlayer,130,275,405,25,40,UCBPlayer
44919,UCBPlayer,105,210,315,10,65,UCBPlayer
44920,UCBPlayer,130,275,405,25,40,UCBPlayer
44921,UCBPlayer,103,203,306,10,68,UCBPlayer
44922,UCBPlayer,128,283,411,25,38,UCBPlayer
44923,UCBPlayer,111,186,297,10,71,UCBPlayer
44924,UCBPlayer,124,299,423,25,34,UCBPlayer
44925,UCBPlayer,115,170,285,10,75,UCBPlayer
44926,UCBPlayer,120,315,435,25,30,UCBPlayer
44927,UCBPlayer,119,154,273,10,79,UCBPlayer
44928,UCBPlayer,112,332,444,25,27,UCBPlayer
44929,UCBPlayer,127,137,264,10,82,UCBPlayer
44930,UCBPlayer,104,349,453,25,24,UCBPlayer
44931,UCBPlayer,126,126,252,7,85,Tie
44932,UCBPlayer,111,351,462,28,22,UCBPlayer
44933,UCBPlayer,116,126,242,3,87,UCBPlayer
44934,UCBPlayer,122,347,469,32,21,UCBPlayer
44935,UCBPlayer,107,132,239,0,87,UCBPlayer
44936,UCBPlayer,132,337,469,35,22,UCBPlayer
44937,UCBPlayer,103,148,251,0,83,UCBPlayer
44938,UCBPlayer,136,321,457,35,26,UCBPlayer
44939,UCBPlayer,99,164,263,0,79,UCBPlayer
44940,UCBPlayer,140,305,445,35,30,UCBPlayer
44941,UCBPlayer,95,180,275,0,75,UCBPlayer
44942,UCBPlayer,144,289,433,35,34,UCBPlayer
44943,UCBPlayer,91,196,287,0,71,UCBPlayer
44944,UCBPlayer,148,273,421,35,38,UCBPlayer
44945,UCBPlayer,87,212,299,0,67,UCBPlayer
44946,UCBPlayer,152,257,409,35,42,UCBPlayer
44947,UCBPlayer,84,224,308,0,64,UCBPlayer
44948,UCBPlayer,146,251,397,32,45,UCBPlayer
44949,UCBPlayer,89,234,323,3,60,UCBPlayer
44950,UCBPlayer,138,243,381,28,49,UCBPlayer
44951,UCBPlayer,97,242,339,7,56,UCBPlayer
44952,UCBPlayer,130,235,365,24,53,UCBPlayer
44953,UCBPlayer,105,250,355,11,52,UCBPlayer
44954,UCBPlayer,122,227,349,20,57,UCBPlayer
44955,UCBPlayer,109,259,368,15,49,UCBPlayer
44956,UCBPlayer,118,218,336,16,60,UCBPlayer
44957,UCBPlayer,117,267,384,19,45,UCBPlayer
44958,UCBPlayer,110,210,320,12,64,UCBPlayer
44959,UCBPlayer,126,271,397,23,42,UCBPlayer
44960,UCBPlayer,105,210,315,10,65,UCBPlayer
44961,UCBPlayer,130,275,405,25,40,UCBPlayer
44962,UCBPlayer,105,210,315,10,65,UCBPlayer
44963,UCBPlayer,130,275,405,25,40,UCBPlayer
44964,UCBPlayer,106,206,312,10,66,UCBPlayer
44965,UCBPlayer,130,275,405,25,40,UCBPlayer
44966,UCBPlayer,105,210,315,10,65,UCBPlayer
44967,UCBPlayer,131,271,402,25,41,UCBPlayer
44968,UCBPlayer,105,210,315,10,65,UCBPlayer
44969,UCBPlayer,130,275,405,25,40,UCBPlayer
44970,UCBPlayer,105,210,315,10,65,UCBPlayer
44971,UCBPlayer,130,275,405,25,40,UCBPlayer
44972,UCBPlayer,103,203,306,10,68,UCBPlayer
44973,UCBPlayer,128,283,411,25,38,UCBPlayer
44974,UCBPlayer,111,186,297,10,71,UCBPlayer
44975,UCBPlayer,124,299,423,25,34,UCBPlayer
44976,UCBPlayer,115,170,285,10,75,UCBPlayer
44977,UCBPlayer,120,315,435,25,30,UCBPlayer
44978,UCBPlayer,119,154,273,10,79,UCBPlayer
44979,UCBPlayer,112,332,444,25,27,UCBPlayer
44980,UCBPlayer,127,137,264,10,82,UCBPlayer
44981,UCBPlayer,104,349,453,25,24,UCBPlayer
44982,UCBPlayer,126,126,252,7,85,Tie
44983,UCBPlayer,111,351,462,28,22,UCBPlayer
44984,UCBPlayer,116,126,242,3,87,UCBPlayer
44985,UCBPlayer,122,347,469,32,21,UCBPlayer
44986,UCBPlayer,107,132,239,0,87,UCBPlayer
44987,UCBPlayer,132,337,469,35,22,UCBPlayer
44988,UCBPlayer,103,148,251,0,83,UCBPlayer
44989,UCBPlayer,136,321,457,35,26,UCBPlayer
44990,UCBPlayer,99,164,263,0,79,UCBPlayer
44991,UCBPlayer,140,305,445,35,30,UCBPlayer
44992,UCBPlayer,95,180,275,0,75,UCBPlayer
44993,UCBPlayer,144,289,433,35,34,UCBPlayer
44994,UCBPlayer,91,196,287,0,71,UCBPlayer
44995,UCBPlayer,148,273,421,35,38,UCBPlayer
44996,UCBPlayer,87,212,299,0,67,UCBPlayer
44997,UCBPlayer,152,257,409,35,42,UCBPlayer
44998,UCBPlayer,84,224,308,0,64,UCBPlayer
44999,UCBPlayer,146,251,397,32,45,UCBPlayer
45000,UCBPlayer,89,234,323,3,60,UCBPlayer
45001,UCBPlayer,138,243,381,28,49,UCBPlayer
45002,UCBPlayer,97,242,339,7,56,UCBPlayer
45003,UCBPlayer,130,235,365,24,53,UCBPlayer
45004,UCBPlayer,105,250,355,11,52,UCBPlayer
45005,UCBPlayer,122,227,349,20,57,UCBPlayer
45006,UCBPlayer,109,259,368,15,49,UCBPlayer
45007,UCBPlayer,118,218,336,16,60,UCBPlayer
45008,UCBPlayer,117,267,384,19,45,UCBPlayer
45009,UCBPlayer,110,210,320,12,64,UCBPlayer
45010,UCBPlayer,126,271,397,23,42,UCBPlayer
45011,UCBPlayer,105,210,315,10,65,UCBPlayer
45012,UCBPlayer,130,275,405,25,40,UCBPlayer
45013,UCBPlayer,105,210,315,10,65,UCBPlayer
45014,UCBPlayer,130,275,405,25,40,UCBPlayer
45015,UCBPlayer,106,206,312,10,66,UCBPlayer
45016,UCBPlayer,130,275,405,25,40,UCBPlayer
45017,UCBPlayer,105,210,315,10,65,UCBPlayer
45018,UCBPlayer,131,271,402,25,41,UCBPlayer
45019,UCBPlayer,105,210,315,10,65,UCBPlayer
45020,UCBPlayer,130,275,405,25,40,UCBPlayer
45021,UCBPlayer,105,210,315,10,65,UCBPlayer
45022,UCBPlayer,130,275,405,25,40,UCBPlayer
45023,UCBPlayer,103,203,306,10,68,UCBPlayer
45024,UCBPlayer,128,283,411,25,38,UCBPlayer
45025,UCBPlayer,111,186,297,10,71,UCBPlayer
45026,UCBPlayer,124,299,423,25,34,UCBPlayer
45027,UCBPlayer,115,170,285,10,75,UCBPlayer
45028,UCBPlayer,120,315,435,25,30,UCBPlayer
45029,UCBPlayer,119,154,273,10,79,UCBPlayer
45030,UCBPlayer,112,332,444,25,27,UCBPlayer
45031,UCBPlayer,127,137,264,10,82,UCBPlayer
45032,UCBPlayer,104,349,453,25,24,UCBPlayer
45033,UCBPlayer,126,126,252,7,85,Tie
45034,UCBPlayer,111,351,462,28,22,UCBPlayer
45035,UCBPlayer,116,126,242,3,87,UCBPlayer
45036,UCBPlayer,122,347,469,32,21,UCBPlayer
45037,UCBPlayer,107,132,239,0,87,UCBPlayer
45038,UCBPlayer,132,337,469,35,22,UCBPlayer
45039,UCBPlayer,103,148,251,0,83,UCBPlayer
45040,UCBPlayer,136,321,457,35,26,UCBPlayer
45041,UCBPlayer,99,164,263,0,79,UCBPlayer
45042,UCBPlayer,140,305,445,35,30,UCBPlayer
45043,UCBPlayer,95,180,275,0,75,UCBPlayer
45044,UCBPlayer,144,289,433,35,34,UCBPlayer
45045,UCBPlayer,91,196,287,0,71,UCBPlayer
45046,UCBPlayer,148,273,421,35,38,UCBPlayer
45047,UCBPlayer,87,212,299,0,67,UCBPlayer
45048,UCBPlayer,152,257,409,35,42,UCBPlayer
45049,UCBPlayer,84,224,308,0,64,UCBPlayer
45050,UCBPlayer,146,251,397,32,45,UCBPlayer
45051,UCBPlayer,89,234,323,3,60,UCBPlayer
45052,UCBPlayer,138,243,381,28,49,UCBPlayer
45053,UCBPlayer,97,242,339,7,56,UCBPlayer
45054,UCBPlayer,130,235,365,24,53,UCBPlayer
45055,UCBPlayer,105,250,355,11,52,UCBPlayer
45056,UCBPlayer,122,227,349,20,57,UCBPlayer
45057,UCBPlayer,109,259,368,15,49,UCBPlayer
45058,UCBPlayer,118,218,336,16,60,UCBPlayer
45059,UCBPlayer,117,267,384,19,45,UCBPlayer
45060,UCBPlayer,110,210,320,12,64,UCBPlayer
45061,UCBPlayer,126,271,397,23,42,UCBPlayer
45062,UCBPlayer,105,210,315,10,65,UCBPlayer
45063,UCBPlayer,130,275,405,25,40,UCBPlayer
45064,UCBPlayer,105,210,315,10,65,UCBPlayer
45065,UCBPlayer,130,275,405,25,40,UCBPlayer
45066,UCBPlayer,106,206,312,10,66,UCBPlayer
45067,UCBPlayer,130,275,405,25,40,UCBPlayer
45068,UCBPlayer,105,210,315,10,65,UCBPlayer
45069,UCBPlayer,131,271,402,25,41,UCBPlayer
45070,UCBPlayer,105,210,315,10,65,UCBPlayer
45071,UCBPlayer,130,275,405,25,40,UCBPlayer
45072,UCBPlayer,105,210,315,10,65,UCBPlayer
45073,UCBPlayer,130,275,405,25,40,UCBPlayer
45074,UCBPlayer,103,203,306,10,68,UCBPlayer
45075,UCBPlayer,128,283,411,25,38,UCBPlayer
45076,UCBPlayer,111,186,297,10,71,UCBPlayer
45077,UCBPlayer,124,299,423,25,34,UCBPlayer
45078,UCBPlayer,115,170,285,10,75,UCBPlayer
45079,UCBPlayer,120,315,435,25,30,UCBPlayer
45080,UCBPlayer,119,154,273,10,79,UCBPlayer
45081,UCBPlayer,112,332,444,25,27,UCBPlayer
45082,UCBPlayer,127,137,264,10,82,UCBPlayer
45083,UCBPlayer,104,349,453,25,24,UCBPlayer
45084,UCBPlayer,126,126,252,7,85,Tie
45085,UCBPlayer,111,351,462,28,22,UCBPlayer
45086,UCBPlayer,116,126,242,3,87,UCBPlayer
45087,UCBPlayer,122,347,469,32,21,UCBPlayer
45088,UCBPlayer,107,132,239,0,87,UCBPlayer
45089,UCBPlayer,132,337,469,35,22,UCBPlayer
45090,UCBPlayer,103,148,251,0,83,UCBPlayer
45091,UCBPlayer,136,321,457,35,26,UCBPlayer
45092,UCBPlayer,99,164,263,0,79,UCBPlayer
45093,UCBPlayer,140,305,445,35,30,UCBPlayer
45094,UCBPlayer,95,180,275,0,75,UCBPlayer
45095,UCBPlayer,144,289,433,35,34,UCBPlayer
45096,UCBPlayer,91,196,287,0,71,UCBPlayer
45097,UCBPlayer,148,273,421,35,38,UCBPlayer
45098,UCBPlayer,87,212,299,0,67,UCBPlayer
45099,UCBPlayer,152,257,409,35,42,UCBPlayer
45100,UCBPlayer,84,224,308,0,64,UCBPlayer
45101,UCBPlayer,146,251,397,32,45,UCBPlayer
45102,UCBPlayer,89,234,323,3,60,UCBPlayer
45103,UCBPlayer,138,243,381,28,49,UCBPlayer
45104,UCBPlayer,97,242,339,7,56,UCBPlayer
45105,UCBPlayer,130,235,365,24,53,UCBPlayer
45106,UCBPlayer,105,250,355,11,52,UCBPlayer
45107,UCBPlayer,122,227,349,20,57,UCBPlayer
45108,UCBPlayer,109,259,368,15,49,UCBPlayer
45109,UCBPlayer,118,218,336,16,60,UCBPlayer
45110,UCBPlayer,117,267,384,19,45,UCBPlayer
45111,UCBPlayer,110,210,320,12,64,UCBPlayer
45112,UCBPlayer,126,271,397,23,42,UCBPlayer
45113,UCBPlayer,105,210,315,10,65,UCBPlayer
45114,UCBPlayer,130,275,405,25,40,UCBPlayer
45115,UCBPlayer,105,210,315,10,65,UCBPlayer
45116,UCBPlayer,130,275,405,25,40,UCBPlayer
45117,UCBPlayer,106,206,312,10,66,UCBPlayer
45118,UCBPlayer,130,275,405,25,40,UCBPlayer
45119,UCBPlayer,105,210,315,10,65,UCBPlayer
45120,UCBPlayer,131,271,402,25,41,UCBPlayer
45121,UCBPlayer,105,210,315,10,65,UCBPlayer
45122,UCBPlayer,130,275,405,25,40,UCBPlayer
45123,UCBPlayer,105,210,315,10,65,UCBPlayer
45124,UCBPlayer,130,275,405,25,40,UCBPlayer
45125,UCBPlayer,103,203,306,10,68,UCBPlayer
45126,UCBPlayer,128,283,411,25,38,UCBPlayer
45127,UCBPlayer,111,186,297,10,71,UCBPlayer
45128,UCBPlayer,124,299,423,25,34,UCBPlayer
45129,UCBPlayer,115,170,285,10,75,UCBPlayer
45130,UCBPlayer,120,315,435,25,30,UCBPlayer
45131,UCBPlayer,119,154,273,10,79,UCBPlayer
45132,UCBPlayer,112,332,444,25,27,UCBPlayer
45133,UCBPlayer,127,137,264,10,82,UCBPlayer
45134,UCBPlayer,104,349,453,25,24,UCBPlayer
45135,UCBPlayer,126,126,252,7,85,Tie
45136,UCBPlayer,111,351,462,28,22,UCBPlayer
45137,UCBPlayer,116,126,242,3,87,UCBPlayer
45138,UCBPlayer,122,347,469,32,21,UCBPlayer
45139,UCBPlayer,107,132,239,0,87,UCBPlayer
45140,UCBPlayer,132,337,469,35,22,UCBPlayer
45141,UCBPlayer,103,148,251,0,83,UCBPlayer
45142,UCBPlayer,136,321,457,35,26,UCBPlayer
45143,UCBPlayer,99,164,263,0,79,UCBPlayer
45144,UCBPlayer,140,305,445,35,30,UCBPlayer
45145,UCBPlayer,95,180,275,0,75,UCBPlayer
45146,UCBPlayer,144,289,433,35,34,UCBPlayer
45147,UCBPlayer,91,196,287,0,71,UCBPlayer
45148,UCBPlayer,148,273,421,35,38,UCBPlayer
45149,UCBPlayer,87,212,299,0,67,UCBPlayer
45150,UCBPlayer,152,257,409,35,42,UCBPlayer
45151,UCBPlayer,84,224,308,0,64,UCBPlayer
45152,UCBPlayer,146,251,397,32,45,UCBPlayer
45153,UCBPlayer,89,234,323,3,60,UCBPlayer
45154,UCBPlayer,138,243,381,28,49,UCBPlayer
45155,UCBPlayer,97,242,339,7,56,UCBPlayer
45156,UCBPlayer,130,235,365,24,53,UCBPlayer
45157,UCBPlayer,105,250,355,11,52,UCBPlayer
45158,UCBPlayer,122,227,349,20,57,UCBPlayer
45159,UCBPlayer,109,259,368,15,49,UCBPlayer
45160,UCBPlayer,118,218,336,16,60,UCBPlayer
45161,UCBPlayer,117,267,384,19,45,UCBPlayer
45162,UCBPlayer,110,210,320,12,64,UCBPlayer
45163,UCBPlayer,126,271,397,23,42,UCBPlayer
45164,UCBPlayer,105,210,315,10,65,UCBPlayer
45165,UCBPlayer,130,275,405,25,40,UCBPlayer
45166,UCBPlayer,105,210,315,10,65,UCBPlayer
45167,UCBPlayer,130,275,405,25,40,UCBPlayer
45168,UCBPlayer,106,206,312,10,66,UCBPlayer
45169,UCBPlayer,130,275,405,25,40,UCBPlayer
45170,UCBPlayer,105,210,315,10,65,UCBPlayer
45171,UCBPlayer,131,271,402,25,41,UCBPlayer
45172,UCBPlayer,105,210,315,10,65,UCBPlayer
45173,UCBPlayer,130,275,405,25,40,UCBPlayer
45174,UCBPlayer,105,210,315,10,65,UCBPlayer
45175,UCBPlayer,130,275,405,25,40,UCBPlayer
45176,UCBPlayer,103,203,306,10,68,UCBPlayer
45177,UCBPlayer,128,283,411,25,38,UCBPlayer
45178,UCBPlayer,111,186,297,10,71,UCBPlayer
45179,UCBPlayer,124,299,423,25,34,UCBPlayer
45180,UCBPlayer,115,170,285,10,75,UCBPlayer
45181,UCBPlayer,120,315,435,25,30,UCBPlayer
45182,UCBPlayer,119,154,273,10,79,UCBPlayer
45183,UCBPlayer,112,332,444,25,27,UCBPlayer
45184,UCBPlayer,127,137,264,10,82,UCBPlayer
45185,UCBPlayer,104,349,453,25,24,UCBPlayer
45186,UCBPlayer,126,126,252,7,85,Tie
45187,UCBPlayer,111,351,462,28,22,UCBPlayer
45188,UCBPlayer,116,126,242,3,87,UCBPlayer
45189,UCBPlayer,122,347,469,32,21,UCBPlayer
45190,UCBPlayer,107,132,239,0,87,UCBPlayer
45191,UCBPlayer,132,337,469,35,22,UCBPlayer
45192,UCBPlayer,103,148,251,0,83,UCBPlayer
45193,UCBPlayer,136,321,457,35,26,UCBPlayer
45194,UCBPlayer,99,164,263,0,79,UCBPlayer
45195,UCBPlayer,140,305,445,35,30,UCBPlayer
45196,UCBPlayer,95,180,275,0,75,UCBPlayer
45197,UCBPlayer,144,289,433,35,34,UCBPlayer
45198,UCBPlayer,91,196,287,0,71,UCBPlayer
45199,UCBPlayer,148,273,421,35,38,UCBPlayer
45200,UCBPlayer,87,212,299,0,67,UCBPlayer
45201,UCBPlayer,152,257,409,35,42,UCBPlayer
45202,UCBPlayer,84,224,308,0,64,UCBPlayer
45203,UCBPlayer,146,251,397,32,45,UCBPlayer
45204,UCBPlayer,89,234,323,3,60,UCBPlayer
45205,UCBPlayer,138,243,381,28,49,UCBPlayer
45206,UCBPlayer,97,242,339,7,56,UCBPlayer
45207,UCBPlayer,130,235,365,24,53,UCBPlayer
45208,UCBPlayer,105,250,355,11,52,UCBPlayer
45209,UCBPlayer,122,227,349,20,57,UCBPlayer
45210,UCBPlayer,109,259,368,15,49,UCBPlayer
45211,UCBPlayer,118,218,336,16,60,UCBPlayer
45212,UCBPlayer,117,267,384,19,45,UCBPlayer
45213,UCBPlayer,110,210,320,12,64,UCBPlayer
45214,UCBPlayer,126,271,397,23,42,UCBPlayer
45215,UCBPlayer,105,210,315,10,65,UCBPlayer
45216,UCBPlayer,130,275,405,25,40,UCBPlayer
45217,UCBPlayer,105,210,315,10,65,UCBPlayer
45218,UCBPlayer,130,275,405,25,40,UCBPlayer
45219,UCBPlayer,106,206,312,10,66,UCBPlayer
45220,UCBPlayer,130,275,405,25,40,UCBPlayer
45221,UCBPlayer,105,210,315,10,65,UCBPlayer
45222,UCBPlayer,131,271,402,25,41,UCBPlayer
45223,UCBPlayer,105,210,315,10,65,UCBPlayer
45224,UCBPlayer,130,275,405,25,40,UCBPlayer
45225,UCBPlayer,105,210,315,10,65,UCBPlayer
45226,UCBPlayer,130,275,405,25,40,UCBPlayer
45227,UCBPlayer,103,203,306,10,68,UCBPlayer
45228,UCBPlayer,128,283,411,25,38,UCBPlayer
45229,UCBPlayer,111,186,297,10,71,UCBPlayer
45230,UCBPlayer,124,299,423,25,34,UCBPlayer
45231,UCBPlayer,115,170,285,10,75,UCBPlayer
45232,UCBPlayer,120,315,435,25,30,UCBPlayer
45233,UCBPlayer,119,154,273,10,79,UCBPlayer
45234,UCBPlayer,112,332,444,25,27,UCBPlayer
45235,UCBPlayer,127,137,264,10,82,UCBPlayer
45236,UCBPlayer,104,349,453,25,24,UCBPlayer
45237,UCBPlayer,126,126,252,7,85,Tie
45238,UCBPlayer,111,351,462,28,22,UCBPlayer
45239,UCBPlayer,116,126,242,3,87,UCBPlayer
45240,UCBPlayer,122,347,469,32,21,UCBPlayer
45241,UCBPlayer,107,132,239,0,87,UCBPlayer
45242,UCBPlayer,132,337,469,35,22,UCBPlayer
45243,UCBPlayer,103,148,251,0,83,UCBPlayer
45244,UCBPlayer,136,321,457,35,26,UCBPlayer
45245,UCBPlayer,99,164,263,0,79,UCBPlayer
45246,UCBPlayer,140,305,445,35,30,UCBPlayer
45247,UCBPlayer,95,180,275,0,75,UCBPlayer
45248,UCBPlayer,144,289,433,35,34,UCBPlayer
45249,UCBPlayer,91,196,287,0,71,UCBPlayer
45250,UCBPlayer,148,273,421,35,38,UCBPlayer
45251,UCBPlayer,87,212,299,0,67,UCBPlayer
45252,UCBPlayer,152,257,409,35,42,UCBPlayer
45253,UCBPlayer,84,224,308,0,64,UCBPlayer
45254,UCBPlayer,146,251,397,32,45,UCBPlayer
45255,UCBPlayer,89,234,323,3,60,UCBPlayer
45256,UCBPlayer,138,243,381,28,49,UCBPlayer
45257,UCBPlayer,97,242,339,7,56,UCBPlayer
45258,UCBPlayer,130,235,365,24,53,UCBPlayer
45259,UCBPlayer,105,250,355,11,52,UCBPlayer
45260,UCBPlayer,122,227,349,20,57,UCBPlayer
45261,UCBPlayer,109,259,368,15,49,UCBPlayer
45262,UCBPlayer,118,218,336,16,60,UCBPlayer
45263,UCBPlayer,117,267,384,19,45,UCBPlayer
45264,UCBPlayer,110,210,320,12,64,UCBPlayer
45265,UCBPlayer,126,271,397,23,42,UCBPlayer
45266,UCBPlayer,105,210,315,10,65,UCBPlayer
45267,UCBPlayer,130,275,405,25,40,UCBPlayer
45268,UCBPlayer,105,210,315,10,65,UCBPlayer
45269,UCBPlayer,130,275,405,25,40,UCBPlayer
45270,UCBPlayer,106,206,312,10,66,UCBPlayer
45271,UCBPlayer,130,275,405,25,40,UCBPlayer
45272,UCBPlayer,105,210,315,10,65,UCBPlayer
45273,UCBPlayer,131,271,402,25,41,UCBPlayer
45274,UCBPlayer,105,210,315,10,65,UCBPlayer
45275,UCBPlayer,130,275,405,25,40,UCBPlayer
45276,UCBPlayer,105,210,315,10,65,UCBPlayer
45277,UCBPlayer,130,275,405,25,40,UCBPlayer
45278,UCBPlayer,103,203,306,10,68,UCBPlayer
45279,UCBPlayer,128,283,411,25,38,UCBPlayer
45280,UCBPlayer,111,186,297,10,71,UCBPlayer
45281,UCBPlayer,124,299,423,25,34,UCBPlayer
45282,UCBPlayer,115,170,285,10,75,UCBPlayer
45283,UCBPlayer,120,315,435,25,30,UCBPlayer
45284,UCBPlayer,119,154,273,10,79,UCBPlayer
45285,UCBPlayer,112,332,444,25,27,UCBPlayer
45286,UCBPlayer,127,137,264,10,82,UCBPlayer
45287,UCBPlayer,104,349,453,25,24,UCBPlayer
45288,UCBPlayer,126,126,252,7,85,Tie
45289,UCBPlayer,111,351,462,28,22,UCBPlayer
45290,UCBPlayer,116,126,242,3,87,UCBPlayer
45291,UCBPlayer,122,347,469,32,21,UCBPlayer
45292,UCBPlayer,107,132,239,0,87,UCBPlayer
45293,UCBPlayer,132,337,469,35,22,UCBPlayer
45294,UCBPlayer,103,148,251,0,83,UCBPlayer
45295,UCBPlayer,136,321,457,35,26,UCBPlayer
45296,UCBPlayer,99,164,263,0,79,UCBPlayer
45297,UCBPlayer,140,305,445,35,30,UCBPlayer
45298,UCBPlayer,95,180,275,0,75,UCBPlayer
45299,UCBPlayer,144,289,433,35,34,UCBPlayer
45300,UCBPlayer,91,196,287,0,71,UCBPlayer
45301,UCBPlayer,148,273,421,35,38,UCBPlayer
45302,UCBPlayer,87,212,299,0,67,UCBPlayer
45303,UCBPlayer,152,257,409,35,42,UCBPlayer
45304,UCBPlayer,84,224,308,0,64,UCBPlayer
45305,UCBPlayer,146,251,397,32,45,UCBPlayer
45306,UCBPlayer,89,234,323,3,60,UCBPlayer
45307,UCBPlayer,138,243,381,28,49,UCBPlayer
45308,UCBPlayer,97,242,339,7,56,UCBPlayer
45309,UCBPlayer,130,235,365,24,53,UCBPlayer
45310,UCBPlayer,105,250,355,11,52,UCBPlayer
45311,UCBPlayer,122,227,349,20,57,UCBPlayer
45312,UCBPlayer,109,259,368,15,49,UCBPlayer
45313,UCBPlayer,118,218,336,16,60,UCBPlayer
45314,UCBPlayer,117,267,384,19,45,UCBPlayer
45315,UCBPlayer,110,210,320,12,64,UCBPlayer
45316,UCBPlayer,126,271,397,23,42,UCBPlayer
45317,UCBPlayer,105,210,315,10,65,UCBPlayer
45318,UCBPlayer,130,275,405,25,40,UCBPlayer
45319,UCBPlayer,105,210,315,10,65,UCBPlayer
45320,UCBPlayer,130,275,405,25,40,UCBPlayer
45321,UCBPlayer,106,206,312,10,66,UCBPlayer
45322,UCBPlayer,130,275,405,25,40,UCBPlayer
45323,UCBPlayer,105,210,315,10,65,UCBPlayer
45324,UCBPlayer,131,271,402,25,41,UCBPlayer
45325,UCBPlayer,105,210,315,10,65,UCBPlayer
45326,UCBPlayer,130,275,405,25,40,UCBPlayer
45327,UCBPlayer,105,210,315,10,65,UCBPlayer
45328,UCBPlayer,130,275,405,25,40,UCBPlayer
45329,UCBPlayer,103,203,306,10,68,UCBPlayer
45330,UCBPlayer,128,283,411,25,38,UCBPlayer
45331,UCBPlayer,111,186,297,10,71,UCBPlayer
45332,UCBPlayer,124,299,423,25,34,UCBPlayer
45333,UCBPlayer,115,170,285,10,75,UCBPlayer
45334,UCBPlayer,120,315,435,25,30,UCBPlayer
45335,UCBPlayer,119,154,273,10,79,UCBPlayer
45336,UCBPlayer,112,332,444,25,27,UCBPlayer
45337,UCBPlayer,127,137,264,10,82,UCBPlayer
45338,UCBPlayer,104,349,453,25,24,UCBPlayer
45339,UCBPlayer,126,126,252,7,85,Tie
45340,UCBPlayer,111,351,462,28,22,UCBPlayer
45341,UCBPlayer,116,126,242,3,87,UCBPlayer
45342,UCBPlayer,122,347,469,32,21,UCBPlayer
45343,UCBPlayer,107,132,239,0,87,UCBPlayer
45344,UCBPlayer,132,337,469,35,22,UCBPlayer
45345,UCBPlayer,103,148,251,0,83,UCBPlayer
45346,UCBPlayer,136,321,457,35,26,UCBPlayer
45347,UCBPlayer,99,164,263,0,79,UCBPlayer
45348,UCBPlayer,140,305,445,35,30,UCBPlayer
45349,UCBPlayer,95,180,275,0,75,UCBPlayer
45350,UCBPlayer,144,289,433,35,34,UCBPlayer
45351,UCBPlayer,91,196,287,0,71,UCBPlayer
45352,UCBPlayer,148,273,421,35,38,UCBPlayer
45353,UCBPlayer,87,212,299,0,67,UCBPlayer
45354,UCBPlayer,152,257,409,35,42,UCBPlayer
45355,UCBPlayer,84,224,308,0,64,UCBPlayer
45356,UCBPlayer,146,251,397,32,45,UCBPlayer
45357,UCBPlayer,89,234,323,3,60,UCBPlayer
45358,UCBPlayer,138,243,381,28,49,UCBPlayer
45359,UCBPlayer,97,242,339,7,56,UCBPlayer
45360,UCBPlayer,130,235,365,24,53,UCBPlayer
45361,UCBPlayer,105,250,355,11,52,UCBPlayer
45362,UCBPlayer,122,227,349,20,57,UCBPlayer
45363,UCBPlayer,109,259,368,15,49,UCBPlayer
45364,UCBPlayer,118,218,336,16,60,UCBPlayer
45365,UCBPlayer,117,267,384,19,45,UCBPlayer
45366,UCBPlayer,110,210,320,12,64,UCBPlayer
45367,UCBPlayer,126,271,397,23,42,UCBPlayer
45368,UCBPlayer,105,210,315,10,65,UCBPlayer
45369,UCBPlayer,130,275,405,25,40,UCBPlayer
45370,UCBPlayer,105,210,315,10,65,UCBPlayer
45371,UCBPlayer,130,275,405,25,40,UCBPlayer
45372,UCBPlayer,106,206,312,10,66,UCBPlayer
45373,UCBPlayer,130,275,405,25,40,UCBPlayer
45374,UCBPlayer,105,210,315,10,65,UCBPlayer
45375,UCBPlayer,131,271,402,25,41,UCBPlayer
45376,UCBPlayer,105,210,315,10,65,UCBPlayer
45377,UCBPlayer,130,275,405,25,40,UCBPlayer
45378,UCBPlayer,105,210,315,10,65,UCBPlayer
45379,UCBPlayer,130,275,405,25,40,UCBPlayer
45380,UCBPlayer,103,203,306,10,68,UCBPlayer
45381,UCBPlayer,128,283,411,25,38,UCBPlayer
45382,UCBPlayer,111,186,297,10,71,UCBPlayer
45383,UCBPlayer,124,299,423,25,34,UCBPlayer
45384,UCBPlayer,115,170,285,10,75,UCBPlayer
45385,UCBPlayer,120,315,435,25,30,UCBPlayer
45386,UCBPlayer,119,154,273,10,79,UCBPlayer
45387,UCBPlayer,112,332,444,25,27,UCBPlayer
45388,UCBPlayer,127,137,264,10,82,UCBPlayer
45389,UCBPlayer,104,349,453,25,24,UCBPlayer
45390,UCBPlayer,126,126,252,7,85,Tie
45391,UCBPlayer,111,351,462,28,22,UCBPlayer
45392,UCBPlayer,116,126,242,3,87,UCBPlayer
45393,UCBPlayer,122,347,469,32,21,UCBPlayer
45394,UCBPlayer,107,132,239,0,87,UCBPlayer
45395,UCBPlayer,132,337,469,35,22,UCBPlayer
45396,UCBPlayer,103,148,251,0,83,UCBPlayer
45397,UCBPlayer,136,321,457,35,26,UCBPlayer
45398,UCBPlayer,99,164,263,0,79,UCBPlayer
45399,UCBPlayer,140,305,445,35,30,UCBPlayer
45400,UCBPlayer,95,180,275,0,75,UCBPlayer
45401,UCBPlayer,144,289,433,35,34,UCBPlayer
45402,UCBPlayer,91,196,287,0,71,UCBPlayer
45403,UCBPlayer,148,273,421,35,38,UCBPlayer
45404,UCBPlayer,87,212,299,0,67,UCBPlayer
45405,UCBPlayer,152,257,409,35,42,UCBPlayer
45406,UCBPlayer,84,224,308,0,64,UCBPlayer
45407,UCBPlayer,146,251,397,32,45,UCBPlayer
45408,UCBPlayer,89,234,323,3,60,UCBPlayer
45409,UCBPlayer,138,243,381,28,49,UCBPlayer
45410,UCBPlayer,97,242,339,7,56,UCBPlayer
45411,UCBPlayer,130,235,365,24,53,UCBPlayer
45412,UCBPlayer,105,250,355,11,52,UCBPlayer
45413,UCBPlayer,122,227,349,20,57,UCBPlayer
45414,UCBPlayer,109,259,368,15,49,UCBPlayer
45415,UCBPlayer,118,218,336,16,60,UCBPlayer
45416,UCBPlayer,117,267,384,19,45,UCBPlayer
45417,UCBPlayer,110,210,320,12,64,UCBPlayer
45418,UCBPlayer,126,271,397,23,42,UCBPlayer
45419,UCBPlayer,105,210,315,10,65,UCBPlayer
45420,UCBPlayer,130,275,405,25,40,UCBPlayer
45421,UCBPlayer,105,210,315,10,65,UCBPlayer
45422,UCBPlayer,130,275,405,25,40,UCBPlayer
45423,UCBPlayer,106,206,312,10,66,UCBPlayer
45424,UCBPlayer,130,275,405,25,40,UCBPlayer
45425,UCBPlayer,105,210,315,10,65,UCBPlayer
45426,UCBPlayer,131,271,402,25,41,UCBPlayer
45427,UCBPlayer,105,210,315,10,65,UCBPlayer
45428,UCBPlayer,130,275,405,25,40,UCBPlayer
45429,UCBPlayer,105,210,315,10,65,UCBPlayer
45430,UCBPlayer,130,275,405,25,40,UCBPlayer
45431,UCBPlayer,103,203,306,10,68,UCBPlayer
45432,UCBPlayer,128,283,411,25,38,UCBPlayer
45433,UCBPlayer,111,186,297,10,71,UCBPlayer
45434,UCBPlayer,124,299,423,25,34,UCBPlayer
45435,UCBPlayer,115,170,285,10,75,UCBPlayer
45436,UCBPlayer,120,315,435,25,30,UCBPlayer
45437,UCBPlayer,119,154,273,10,79,UCBPlayer
45438,UCBPlayer,112,332,444,25,27,UCBPlayer
45439,UCBPlayer,127,137,264,10,82,UCBPlayer
45440,UCBPlayer,104,349,453,25,24,UCBPlayer
45441,UCBPlayer,126,126,252,7,85,Tie
45442,UCBPlayer,111,351,462,28,22,UCBPlayer
45443,UCBPlayer,116,126,242,3,87,UCBPlayer
45444,UCBPlayer,122,347,469,32,21,UCBPlayer
45445,UCBPlayer,107,132,239,0,87,UCBPlayer
45446,UCBPlayer,132,337,469,35,22,UCBPlayer
45447,UCBPlayer,103,148,251,0,83,UCBPlayer
45448,UCBPlayer,136,321,457,35,26,UCBPlayer
45449,UCBPlayer,99,164,263,0,79,UCBPlayer
45450,UCBPlayer,140,305,445,35,30,UCBPlayer
45451,UCBPlayer,95,180,275,0,75,UCBPlayer
45452,UCBPlayer,144,289,433,35,34,UCBPlayer
45453,UCBPlayer,91,196,287,0,71,UCBPlayer
45454,UCBPlayer,148,273,421,35,38,UCBPlayer
45455,UCBPlayer,87,212,299,0,67,UCBPlayer
45456,UCBPlayer,152,257,409,35,42,UCBPlayer
45457,UCBPlayer,84,224,308,0,64,UCBPlayer
45458,UCBPlayer,146,251,397,32,45,UCBPlayer
45459,UCBPlayer,89,234,323,3,60,UCBPlayer
45460,UCBPlayer,138,243,381,28,49,UCBPlayer
45461,UCBPlayer,97,242,339,7,56,UCBPlayer
45462,UCBPlayer,130,235,365,24,53,UCBPlayer
45463,UCBPlayer,105,250,355,11,52,UCBPlayer
45464,UCBPlayer,122,227,349,20,57,UCBPlayer
45465,UCBPlayer,109,259,368,15,49,UCBPlayer
45466,UCBPlayer,118,218,336,16,60,UCBPlayer
45467,UCBPlayer,117,267,384,19,45,UCBPlayer
45468,UCBPlayer,110,210,320,12,64,UCBPlayer
45469,UCBPlayer,126,271,397,23,42,UCBPlayer
45470,UCBPlayer,105,210,315,10,65,UCBPlayer
45471,UCBPlayer,130,275,405,25,40,UCBPlayer
45472,UCBPlayer,105,210,315,10,65,UCBPlayer
45473,UCBPlayer,130,275,405,25,40,UCBPlayer
45474,UCBPlayer,106,206,312,10,66,UCBPlayer
45475,UCBPlayer,130,275,405,25,40,UCBPlayer
45476,UCBPlayer,105,210,315,10,65,UCBPlayer
45477,UCBPlayer,131,271,402,25,41,UCBPlayer
45478,UCBPlayer,105,210,315,10,65,UCBPlayer
45479,UCBPlayer,130,275,405,25,40,UCBPlayer
45480,UCBPlayer,105,210,315,10,65,UCBPlayer
45481,UCBPlayer,130,275,405,25,40,UCBPlayer
45482,UCBPlayer,103,203,306,10,68,UCBPlayer
45483,UCBPlayer,128,283,411,25,38,UCBPlayer
45484,UCBPlayer,111,186,297,10,71,UCBPlayer
45485,UCBPlayer,124,299,423,25,34,UCBPlayer
45486,UCBPlayer,115,170,285,10,75,UCBPlayer
45487,UCBPlayer,120,315,435,25,30,UCBPlayer
45488,UCBPlayer,119,154,273,10,79,UCBPlayer
45489,UCBPlayer,112,332,444,25,27,UCBPlayer
45490,UCBPlayer,127,137,264,10,82,UCBPlayer
45491,UCBPlayer,104,349,453,25,24,UCBPlayer
45492,UCBPlayer,126,126,252,7,85,Tie
45493,UCBPlayer,111,351,462,28,22,UCBPlayer
45494,UCBPlayer,116,126,242,3,87,UCBPlayer
45495,UCBPlayer,122,347,469,32,21,UCBPlayer
45496,UCBPlayer,107,132,239,0,87,UCBPlayer
45497,UCBPlayer,132,337,469,35,22,UCBPlayer
45498,UCBPlayer,103,148,251,0,83,UCBPlayer
45499,UCBPlayer,136,321,457,35,26,UCBPlayer
45500,UCBPlayer,99,164,263,0,79,UCBPlayer
45501,UCBPlayer,140,305,445,35,30,UCBPlayer
45502,UCBPlayer,95,180,275,0,75,UCBPlayer
45503,UCBPlayer,144,289,433,35,34,UCBPlayer
45504,UCBPlayer,91,196,287,0,71,UCBPlayer
45505,UCBPlayer,148,273,421,35,38,UCBPlayer
45506,UCBPlayer,87,212,299,0,67,UCBPlayer
45507,UCBPlayer,152,257,409,35,42,UCBPlayer
45508,UCBPlayer,84,224,308,0,64,UCBPlayer
45509,UCBPlayer,146,251,397,32,45,UCBPlayer
45510,UCBPlayer,89,234,323,3,60,UCBPlayer
45511,UCBPlayer,138,243,381,28,49,UCBPlayer
45512,UCBPlayer,97,242,339,7,56,UCBPlayer
45513,UCBPlayer,130,235,365,24,53,UCBPlayer
45514,UCBPlayer,105,250,355,11,52,UCBPlayer
45515,UCBPlayer,122,227,349,20,57,UCBPlayer
45516,UCBPlayer,109,259,368,15,49,UCBPlayer
45517,UCBPlayer,118,218,336,16,60,UCBPlayer
45518,UCBPlayer,117,267,384,19,45,UCBPlayer
45519,UCBPlayer,110,210,320,12,64,UCBPlayer
45520,UCBPlayer,126,271,397,23,42,UCBPlayer
45521,UCBPlayer,105,210,315,10,65,UCBPlayer
45522,UCBPlayer,130,275,405,25,40,UCBPlayer
45523,UCBPlayer,105,210,315,10,65,UCBPlayer
45524,UCBPlayer,130,275,405,25,40,UCBPlayer
45525,UCBPlayer,106,206,312,10,66,UCBPlayer
45526,UCBPlayer,130,275,405,25,40,UCBPlayer
45527,UCBPlayer,105,210,315,10,65,UCBPlayer
45528,UCBPlayer,131,271,402,25,41,UCBPlayer
45529,UCBPlayer,105,210,315,10,65,UCBPlayer
45530,UCBPlayer,130,275,405,25,40,UCBPlayer
45531,UCBPlayer,105,210,315,10,65,UCBPlayer
45532,UCBPlayer,130,275,405,25,40,UCBPlayer
45533,UCBPlayer,103,203,306,10,68,UCBPlayer
45534,UCBPlayer,128,283,411,25,38,UCBPlayer
45535,UCBPlayer,111,186,297,10,71,UCBPlayer
45536,UCBPlayer,124,299,423,25,34,UCBPlayer
45537,UCBPlayer,115,170,285,10,75,UCBPlayer
45538,UCBPlayer,120,315,435,25,30,UCBPlayer
45539,UCBPlayer,119,154,273,10,79,UCBPlayer
45540,UCBPlayer,112,332,444,25,27,UCBPlayer
45541,UCBPlayer,127,137,264,10,82,UCBPlayer
45542,UCBPlayer,104,349,453,25,24,UCBPlayer
45543,UCBPlayer,126,126,252,7,85,Tie
45544,UCBPlayer,111,351,462,28,22,UCBPlayer
45545,UCBPlayer,116,126,242,3,87,UCBPlayer
45546,UCBPlayer,122,347,469,32,21,UCBPlayer
45547,UCBPlayer,107,132,239,0,87,UCBPlayer
45548,UCBPlayer,132,337,469,35,22,UCBPlayer
45549,UCBPlayer,103,148,251,0,83,UCBPlayer
45550,UCBPlayer,136,321,457,35,26,UCBPlayer
45551,UCBPlayer,99,164,263,0,79,UCBPlayer
45552,UCBPlayer,140,305,445,35,30,UCBPlayer
45553,UCBPlayer,95,180,275,0,75,UCBPlayer
45554,UCBPlayer,144,289,433,35,34,UCBPlayer
45555,UCBPlayer,91,196,287,0,71,UCBPlayer
45556,UCBPlayer,148,273,421,35,38,UCBPlayer
45557,UCBPlayer,87,212,299,0,67,UCBPlayer
45558,UCBPlayer,152,257,409,35,42,UCBPlayer
45559,UCBPlayer,84,224,308,0,64,UCBPlayer
45560,UCBPlayer,146,251,397,32,45,UCBPlayer
45561,UCBPlayer,89,234,323,3,60,UCBPlayer
45562,UCBPlayer,138,243,381,28,49,UCBPlayer
45563,UCBPlayer,97,242,339,7,56,UCBPlayer
45564,UCBPlayer,130,235,365,24,53,UCBPlayer
45565,UCBPlayer,105,250,355,11,52,UCBPlayer
45566,UCBPlayer,122,227,349,20,57,UCBPlayer
45567,UCBPlayer,109,259,368,15,49,UCBPlayer
45568,UCBPlayer,118,218,336,16,60,UCBPlayer
45569,UCBPlayer,117,267,384,19,45,UCBPlayer
45570,UCBPlayer,110,210,320,12,64,UCBPlayer
45571,UCBPlayer,126,271,397,23,42,UCBPlayer
45572,UCBPlayer,105,210,315,10,65,UCBPlayer
45573,UCBPlayer,130,275,405,25,40,UCBPlayer
45574,UCBPlayer,105,210,315,10,65,UCBPlayer
45575,UCBPlayer,130,275,405,25,40,UCBPlayer
45576,UCBPlayer,106,206,312,10,66,UCBPlayer
45577,UCBPlayer,130,275,405,25,40,UCBPlayer
45578,UCBPlayer,105,210,315,10,65,UCBPlayer
45579,UCBPlayer,131,271,402,25,41,UCBPlayer
45580,UCBPlayer,105,210,315,10,65,UCBPlayer
45581,UCBPlayer,130,275,405,25,40,UCBPlayer
45582,UCBPlayer,105,210,315,10,65,UCBPlayer
45583,UCBPlayer,130,275,405,25,40,UCBPlayer
45584,UCBPlayer,103,203,306,10,68,UCBPlayer
45585,UCBPlayer,128,283,411,25,38,UCBPlayer
45586,UCBPlayer,111,186,297,10,71,UCBPlayer
45587,UCBPlayer,124,299,423,25,34,UCBPlayer
45588,UCBPlayer,115,170,285,10,75,UCBPlayer
45589,UCBPlayer,120,315,435,25,30,UCBPlayer
45590,UCBPlayer,119,154,273,10,79,UCBPlayer
45591,UCBPlayer,112,332,444,25,27,UCBPlayer
45592,UCBPlayer,127,137,264,10,82,UCBPlayer
45593,UCBPlayer,104,349,453,25,24,UCBPlayer
45594,UCBPlayer,126,126,252,7,85,Tie
45595,UCBPlayer,111,351,462,28,22,UCBPlayer
45596,UCBPlayer,116,126,242,3,87,UCBPlayer
45597,UCBPlayer,122,347,469,32,21,UCBPlayer
45598,UCBPlayer,107,132,239,0,87,UCBPlayer
45599,UCBPlayer,132,337,469,35,22,UCBPlayer
45600,UCBPlayer,103,148,251,0,83,UCBPlayer
45601,UCBPlayer,136,321,457,35,26,UCBPlayer
45602,UCBPlayer,99,164,263,0,79,UCBPlayer
45603,UCBPlayer,140,305,445,35,30,UCBPlayer
45604,UCBPlayer,95,180,275,0,75,UCBPlayer
45605,UCBPlayer,144,289,433,35,34,UCBPlayer
45606,UCBPlayer,91,196,287,0,71,UCBPlayer
45607,UCBPlayer,148,273,421,35,38,UCBPlayer
45608,UCBPlayer,87,212,299,0,67,UCBPlayer
45609,UCBPlayer,152,257,409,35,42,UCBPlayer
45610,UCBPlayer,84,224,308,0,64,UCBPlayer
45611,UCBPlayer,146,251,397,32,45,UCBPlayer
45612,UCBPlayer,89,234,323,3,60,UCBPlayer
45613,UCBPlayer,138,243,381,28,49,UCBPlayer
45614,UCBPlayer,97,242,339,7,56,UCBPlayer
45615,UCBPlayer,130,235,365,24,53,UCBPlayer
45616,UCBPlayer,105,250,355,11,52,UCBPlayer
45617,UCBPlayer,122,227,349,20,57,UCBPlayer
45618,UCBPlayer,109,259,368,15,49,UCBPlayer
45619,UCBPlayer,118,218,336,16,60,UCBPlayer
45620,UCBPlayer,117,267,384,19,45,UCBPlayer
45621,UCBPlayer,110,210,320,12,64,UCBPlayer
45622,UCBPlayer,126,271,397,23,42,UCBPlayer
45623,UCBPlayer,105,210,315,10,65,UCBPlayer
45624,UCBPlayer,130,275,405,25,40,UCBPlayer
45625,UCBPlayer,105,210,315,10,65,UCBPlayer
45626,UCBPlayer,130,275,405,25,40,UCBPlayer
45627,UCBPlayer,106,206,312,10,66,UCBPlayer
45628,UCBPlayer,130,275,405,25,40,UCBPlayer
45629,UCBPlayer,105,210,315,10,65,UCBPlayer
45630,UCBPlayer,131,271,402,25,41,UCBPlayer
45631,UCBPlayer,105,210,315,10,65,UCBPlayer
45632,UCBPlayer,130,275,405,25,40,UCBPlayer
45633,UCBPlayer,105,210,315,10,65,UCBPlayer
45634,UCBPlayer,130,275,405,25,40,UCBPlayer
45635,UCBPlayer,103,203,306,10,68,UCBPlayer
45636,UCBPlayer,128,283,411,25,38,UCBPlayer
45637,UCBPlayer,111,186,297,10,71,UCBPlayer
45638,UCBPlayer,124,299,423,25,34,UCBPlayer
45639,UCBPlayer,115,170,285,10,75,UCBPlayer
45640,UCBPlayer,120,315,435,25,30,UCBPlayer
45641,UCBPlayer,119,154,273,10,79,UCBPlayer
45642,UCBPlayer,112,332,444,25,27,UCBPlayer
45643,UCBPlayer,127,137,264,10,82,UCBPlayer
45644,UCBPlayer,104,349,453,25,24,UCBPlayer
45645,UCBPlayer,126,126,252,7,85,Tie
45646,UCBPlayer,111,351,462,28,22,UCBPlayer
45647,UCBPlayer,116,126,242,3,87,UCBPlayer
45648,UCBPlayer,122,347,469,32,21,UCBPlayer
45649,UCBPlayer,107,132,239,0,87,UCBPlayer
45650,UCBPlayer,132,337,469,35,22,UCBPlayer
45651,UCBPlayer,103,148,251,0,83,UCBPlayer
45652,UCBPlayer,136,321,457,35,26,UCBPlayer
45653,UCBPlayer,99,164,263,0,79,UCBPlayer
45654,UCBPlayer,140,305,445,35,30,UCBPlayer
45655,UCBPlayer,95,180,275,0,75,UCBPlayer
45656,UCBPlayer,144,289,433,35,34,UCBPlayer
45657,UCBPlayer,91,196,287,0,71,UCBPlayer
45658,UCBPlayer,148,273,421,35,38,UCBPlayer
45659,UCBPlayer,87,212,299,0,67,UCBPlayer
45660,UCBPlayer,152,257,409,35,42,UCBPlayer
45661,UCBPlayer,84,224,308,0,64,UCBPlayer
45662,UCBPlayer,146,251,397,32,45,UCBPlayer
45663,UCBPlayer,89,234,323,3,60,UCBPlayer
45664,UCBPlayer,138,243,381,28,49,UCBPlayer
45665,UCBPlayer,97,242,339,7,56,UCBPlayer
45666,UCBPlayer,130,235,365,24,53,UCBPlayer
45667,UCBPlayer,105,250,355,11,52,UCBPlayer
45668,UCBPlayer,122,227,349,20,57,UCBPlayer
45669,UCBPlayer,109,259,368,15,49,UCBPlayer
45670,UCBPlayer,118,218,336,16,60,UCBPlayer
45671,UCBPlayer,117,267,384,19,45,UCBPlayer
45672,UCBPlayer,110,210,320,12,64,UCBPlayer
45673,UCBPlayer,126,271,397,23,42,UCBPlayer
45674,UCBPlayer,105,210,315,10,65,UCBPlayer
45675,UCBPlayer,130,275,405,25,40,UCBPlayer
45676,UCBPlayer,105,210,315,10,65,UCBPlayer
45677,UCBPlayer,130,275,405,25,40,UCBPlayer
45678,UCBPlayer,106,206,312,10,66,UCBPlayer
45679,UCBPlayer,130,275,405,25,40,UCBPlayer
45680,UCBPlayer,105,210,315,10,65,UCBPlayer
45681,UCBPlayer,131,271,402,25,41,UCBPlayer
45682,UCBPlayer,105,210,315,10,65,UCBPlayer
45683,UCBPlayer,130,275,405,25,40,UCBPlayer
45684,UCBPlayer,105,210,315,10,65,UCBPlayer
45685,UCBPlayer,130,275,405,25,40,UCBPlayer
45686,UCBPlayer,103,203,306,10,68,UCBPlayer
45687,UCBPlayer,128,283,411,25,38,UCBPlayer
45688,UCBPlayer,111,186,297,10,71,UCBPlayer
45689,UCBPlayer,124,299,423,25,34,UCBPlayer
45690,UCBPlayer,115,170,285,10,75,UCBPlayer
45691,UCBPlayer,120,315,435,25,30,UCBPlayer
45692,UCBPlayer,119,154,273,10,79,UCBPlayer
45693,UCBPlayer,112,332,444,25,27,UCBPlayer
45694,UCBPlayer,127,137,264,10,82,UCBPlayer
45695,UCBPlayer,104,349,453,25,24,UCBPlayer
45696,UCBPlayer,126,126,252,7,85,Tie
45697,UCBPlayer,111,351,462,28,22,UCBPlayer
45698,UCBPlayer,116,126,242,3,87,UCBPlayer
45699,UCBPlayer,122,347,469,32,21,UCBPlayer
45700,UCBPlayer,107,132,239,0,87,UCBPlayer
45701,UCBPlayer,132,337,469,35,22,UCBPlayer
45702,UCBPlayer,103,148,251,0,83,UCBPlayer
45703,UCBPlayer,136,321,457,35,26,UCBPlayer
45704,UCBPlayer,99,164,263,0,79,UCBPlayer
45705,UCBPlayer,140,305,445,35,30,UCBPlayer
45706,UCBPlayer,95,180,275,0,75,UCBPlayer
45707,UCBPlayer,144,289,433,35,34,UCBPlayer
45708,UCBPlayer,91,196,287,0,71,UCBPlayer
45709,UCBPlayer,148,273,421,35,38,UCBPlayer
45710,UCBPlayer,87,212,299,0,67,UCBPlayer
45711,UCBPlayer,152,257,409,35,42,UCBPlayer
45712,UCBPlayer,84,224,308,0,64,UCBPlayer
45713,UCBPlayer,146,251,397,32,45,UCBPlayer
45714,UCBPlayer,89,234,323,3,60,UCBPlayer
45715,UCBPlayer,138,243,381,28,49,UCBPlayer
45716,UCBPlayer,97,242,339,7,56,UCBPlayer
45717,UCBPlayer,130,235,365,24,53,UCBPlayer
45718,UCBPlayer,105,250,355,11,52,UCBPlayer
45719,UCBPlayer,122,227,349,20,57,UCBPlayer
45720,UCBPlayer,109,259,368,15,49,UCBPlayer
45721,UCBPlayer,118,218,336,16,60,UCBPlayer
45722,UCBPlayer,117,267,384,19,45,UCBPlayer
45723,UCBPlayer,110,210,320,12,64,UCBPlayer
45724,UCBPlayer,126,271,397,23,42,UCBPlayer
45725,UCBPlayer,105,210,315,10,65,UCBPlayer
45726,UCBPlayer,130,275,405,25,40,UCBPlayer
45727,UCBPlayer,105,210,315,10,65,UCBPlayer
45728,UCBPlayer,130,275,405,25,40,UCBPlayer
45729,UCBPlayer,106,206,312,10,66,UCBPlayer
45730,UCBPlayer,130,275,405,25,40,UCBPlayer
45731,UCBPlayer,105,210,315,10,65,UCBPlayer
45732,UCBPlayer,131,271,402,25,41,UCBPlayer
45733,UCBPlayer,105,210,315,10,65,UCBPlayer
45734,UCBPlayer,130,275,405,25,40,UCBPlayer
45735,UCBPlayer,105,210,315,10,65,UCBPlayer
45736,UCBPlayer,130,275,405,25,40,UCBPlayer
45737,UCBPlayer,103,203,306,10,68,UCBPlayer
45738,UCBPlayer,128,283,411,25,38,UCBPlayer
45739,UCBPlayer,111,186,297,10,71,UCBPlayer
45740,UCBPlayer,124,299,423,25,34,UCBPlayer
45741,UCBPlayer,115,170,285,10,75,UCBPlayer
45742,UCBPlayer,120,315,435,25,30,UCBPlayer
45743,UCBPlayer,119,154,273,10,79,UCBPlayer
45744,UCBPlayer,112,332,444,25,27,UCBPlayer
45745,UCBPlayer,127,137,264,10,82,UCBPlayer
45746,UCBPlayer,104,349,453,25,24,UCBPlayer
45747,UCBPlayer,126,126,252,7,85,Tie
45748,UCBPlayer,111,351,462,28,22,UCBPlayer
45749,UCBPlayer,116,126,242,3,87,UCBPlayer
45750,UCBPlayer,122,347,469,32,21,UCBPlayer
45751,UCBPlayer,107,132,239,0,87,UCBPlayer
45752,UCBPlayer,132,337,469,35,22,UCBPlayer
45753,UCBPlayer,103,148,251,0,83,UCBPlayer
45754,UCBPlayer,136,321,457,35,26,UCBPlayer
45755,UCBPlayer,99,164,263,0,79,UCBPlayer
45756,UCBPlayer,140,305,445,35,30,UCBPlayer
45757,UCBPlayer,95,180,275,0,75,UCBPlayer
45758,UCBPlayer,144,289,433,35,34,UCBPlayer
45759,UCBPlayer,91,196,287,0,71,UCBPlayer
45760,UCBPlayer,148,273,421,35,38,UCBPlayer
45761,UCBPlayer,87,212,299,0,67,UCBPlayer
45762,UCBPlayer,152,257,409,35,42,UCBPlayer
45763,UCBPlayer,84,224,308,0,64,UCBPlayer
45764,UCBPlayer,146,251,397,32,45,UCBPlayer
45765,UCBPlayer,89,234,323,3,60,UCBPlayer
45766,UCBPlayer,138,243,381,28,49,UCBPlayer
45767,UCBPlayer,97,242,339,7,56,UCBPlayer
45768,UCBPlayer,130,235,365,24,53,UCBPlayer
45769,UCBPlayer,105,250,355,11,52,UCBPlayer
45770,UCBPlayer,122,227,349,20,57,UCBPlayer
45771,UCBPlayer,109,259,368,15,49,UCBPlayer
45772,UCBPlayer,118,218,336,16,60,UCBPlayer
45773,UCBPlayer,117,267,384,19,45,UCBPlayer
45774,UCBPlayer,110,210,320,12,64,UCBPlayer
45775,UCBPlayer,126,271,397,23,42,UCBPlayer
45776,UCBPlayer,105,210,315,10,65,UCBPlayer
45777,UCBPlayer,130,275,405,25,40,UCBPlayer
45778,UCBPlayer,105,210,315,10,65,UCBPlayer
45779,UCBPlayer,130,275,405,25,40,UCBPlayer
45780,UCBPlayer,106,206,312,10,66,UCBPlayer
45781,UCBPlayer,130,275,405,25,40,UCBPlayer
45782,UCBPlayer,105,210,315,10,65,UCBPlayer
45783,UCBPlayer,131,271,402,25,41,UCBPlayer
45784,UCBPlayer,105,210,315,10,65,UCBPlayer
45785,UCBPlayer,130,275,405,25,40,UCBPlayer
45786,UCBPlayer,105,210,315,10,65,UCBPlayer
45787,UCBPlayer,130,275,405,25,40,UCBPlayer
45788,UCBPlayer,103,203,306,10,68,UCBPlayer
45789,UCBPlayer,128,283,411,25,38,UCBPlayer
45790,UCBPlayer,111,186,297,10,71,UCBPlayer
45791,UCBPlayer,124,299,423,25,34,UCBPlayer
45792,UCBPlayer,115,170,285,10,75,UCBPlayer
45793,UCBPlayer,120,315,435,25,30,UCBPlayer
45794,UCBPlayer,119,154,273,10,79,UCBPlayer
45795,UCBPlayer,112,332,444,25,27,UCBPlayer
45796,UCBPlayer,127,137,264,10,82,UCBPlayer
45797,UCBPlayer,104,349,453,25,24,UCBPlayer
45798,UCBPlayer,126,126,252,7,85,Tie
45799,UCBPlayer,111,351,462,28,22,UCBPlayer
45800,UCBPlayer,116,126,242,3,87,UCBPlayer
45801,UCBPlayer,122,347,469,32,21,UCBPlayer
45802,UCBPlayer,107,132,239,0,87,UCBPlayer
45803,UCBPlayer,132,337,469,35,22,UCBPlayer
45804,UCBPlayer,103,148,251,0,83,UCBPlayer
45805,UCBPlayer,136,321,457,35,26,UCBPlayer
45806,UCBPlayer,99,164,263,0,79,UCBPlayer
45807,UCBPlayer,140,305,445,35,30,UCBPlayer
45808,UCBPlayer,95,180,275,0,75,UCBPlayer
45809,UCBPlayer,144,289,433,35,34,UCBPlayer
45810,UCBPlayer,91,196,287,0,71,UCBPlayer
45811,UCBPlayer,148,273,421,35,38,UCBPlayer
45812,UCBPlayer,87,212,299,0,67,UCBPlayer
45813,UCBPlayer,152,257,409,35,42,UCBPlayer
45814,UCBPlayer,84,224,308,0,64,UCBPlayer
45815,UCBPlayer,146,251,397,32,45,UCBPlayer
45816,UCBPlayer,89,234,323,3,60,UCBPlayer
45817,UCBPlayer,138,243,381,28,49,UCBPlayer
45818,UCBPlayer,97,242,339,7,56,UCBPlayer
45819,UCBPlayer,130,235,365,24,53,UCBPlayer
45820,UCBPlayer,105,250,355,11,52,UCBPlayer
45821,UCBPlayer,122,227,349,20,57,UCBPlayer
45822,UCBPlayer,109,259,368,15,49,UCBPlayer
45823,UCBPlayer,118,218,336,16,60,UCBPlayer
45824,UCBPlayer,117,267,384,19,45,UCBPlayer
45825,UCBPlayer,110,210,320,12,64,UCBPlayer
45826,UCBPlayer,126,271,397,23,42,UCBPlayer
45827,UCBPlayer,105,210,315,10,65,UCBPlayer
45828,UCBPlayer,130,275,405,25,40,UCBPlayer
45829,UCBPlayer,105,210,315,10,65,UCBPlayer
45830,UCBPlayer,130,275,405,25,40,UCBPlayer
45831,UCBPlayer,106,206,312,10,66,UCBPlayer
45832,UCBPlayer,130,275,405,25,40,UCBPlayer
45833,UCBPlayer,105,210,315,10,65,UCBPlayer
45834,UCBPlayer,131,271,402,25,41,UCBPlayer
45835,UCBPlayer,105,210,315,10,65,UCBPlayer
45836,UCBPlayer,130,275,405,25,40,UCBPlayer
45837,UCBPlayer,105,210,315,10,65,UCBPlayer
45838,UCBPlayer,130,275,405,25,40,UCBPlayer
45839,UCBPlayer,103,203,306,10,68,UCBPlayer
45840,UCBPlayer,128,283,411,25,38,UCBPlayer
45841,UCBPlayer,111,186,297,10,71,UCBPlayer
45842,UCBPlayer,124,299,423,25,34,UCBPlayer
45843,UCBPlayer,115,170,285,10,75,UCBPlayer
45844,UCBPlayer,120,315,435,25,30,UCBPlayer
45845,UCBPlayer,119,154,273,10,79,UCBPlayer
45846,UCBPlayer,112,332,444,25,27,UCBPlayer
45847,UCBPlayer,127,137,264,10,82,UCBPlayer
45848,UCBPlayer,104,349,453,25,24,UCBPlayer
45849,UCBPlayer,126,126,252,7,85,Tie
45850,UCBPlayer,111,351,462,28,22,UCBPlayer
45851,UCBPlayer,116,126,242,3,87,UCBPlayer
45852,UCBPlayer,122,347,469,32,21,UCBPlayer
45853,UCBPlayer,107,132,239,0,87,UCBPlayer
45854,UCBPlayer,132,337,469,35,22,UCBPlayer
45855,UCBPlayer,103,148,251,0,83,UCBPlayer
45856,UCBPlayer,136,321,457,35,26,UCBPlayer
45857,UCBPlayer,99,164,263,0,79,UCBPlayer
45858,UCBPlayer,140,305,445,35,30,UCBPlayer
45859,UCBPlayer,95,180,275,0,75,UCBPlayer
45860,UCBPlayer,144,289,433,35,34,UCBPlayer
45861,UCBPlayer,91,196,287,0,71,UCBPlayer
45862,UCBPlayer,148,273,421,35,38,UCBPlayer
45863,UCBPlayer,87,212,299,0,67,UCBPlayer
45864,UCBPlayer,152,257,409,35,42,UCBPlayer
45865,UCBPlayer,84,224,308,0,64,UCBPlayer
45866,UCBPlayer,146,251,397,32,45,UCBPlayer
45867,UCBPlayer,89,234,323,3,60,UCBPlayer
45868,UCBPlayer,138,243,381,28,49,UCBPlayer
45869,UCBPlayer,97,242,339,7,56,UCBPlayer
45870,UCBPlayer,130,235,365,24,53,UCBPlayer
45871,UCBPlayer,105,250,355,11,52,UCBPlayer
45872,UCBPlayer,122,227,349,20,57,UCBPlayer
45873,UCBPlayer,109,259,368,15,49,UCBPlayer
45874,UCBPlayer,118,218,336,16,60,UCBPlayer
45875,UCBPlayer,117,267,384,19,45,UCBPlayer
45876,UCBPlayer,110,210,320,12,64,UCBPlayer
45877,UCBPlayer,126,271,397,23,42,UCBPlayer
45878,UCBPlayer,105,210,315,10,65,UCBPlayer
45879,UCBPlayer,130,275,405,25,40,UCBPlayer
45880,UCBPlayer,105,210,315,10,65,UCBPlayer
45881,UCBPlayer,130,275,405,25,40,UCBPlayer
45882,UCBPlayer,106,206,312,10,66,UCBPlayer
45883,UCBPlayer,130,275,405,25,40,UCBPlayer
45884,UCBPlayer,105,210,315,10,65,UCBPlayer
45885,UCBPlayer,131,271,402,25,41,UCBPlayer
45886,UCBPlayer,105,210,315,10,65,UCBPlayer
45887,UCBPlayer,130,275,405,25,40,UCBPlayer
45888,UCBPlayer,105,210,315,10,65,UCBPlayer
45889,UCBPlayer,130,275,405,25,40,UCBPlayer
45890,UCBPlayer,103,203,306,10,68,UCBPlayer
45891,UCBPlayer,128,283,411,25,38,UCBPlayer
45892,UCBPlayer,111,186,297,10,71,UCBPlayer
45893,UCBPlayer,124,299,423,25,34,UCBPlayer
45894,UCBPlayer,115,170,285,10,75,UCBPlayer
45895,UCBPlayer,120,315,435,25,30,UCBPlayer
45896,UCBPlayer,119,154,273,10,79,UCBPlayer
45897,UCBPlayer,112,332,444,25,27,UCBPlayer
45898,UCBPlayer,127,137,264,10,82,UCBPlayer
45899,UCBPlayer,104,349,453,25,24,UCBPlayer
45900,UCBPlayer,126,126,252,7,85,Tie
45901,UCBPlayer,111,351,462,28,22,UCBPlayer
45902,UCBPlayer,116,126,242,3,87,UCBPlayer
45903,UCBPlayer,122,347,469,32,21,UCBPlayer
45904,UCBPlayer,107,132,239,0,87,UCBPlayer
45905,UCBPlayer,132,337,469,35,22,UCBPlayer
45906,UCBPlayer,103,148,251,0,83,UCBPlayer
45907,UCBPlayer,136,321,457,35,26,UCBPlayer
45908,UCBPlayer,99,164,263,0,79,UCBPlayer
45909,UCBPlayer,140,305,445,35,30,UCBPlayer
45910,UCBPlayer,95,180,275,0,75,UCBPlayer
45911,UCBPlayer,144,289,433,35,34,UCBPlayer
45912,UCBPlayer,91,196,287,0,71,UCBPlayer
45913,UCBPlayer,148,273,421,35,38,UCBPlayer
45914,UCBPlayer,87,212,299,0,67,UCBPlayer
45915,UCBPlayer,152,257,409,35,42,UCBPlayer
45916,UCBPlayer,84,224,308,0,64,UCBPlayer
45917,UCBPlayer,146,251,397,32,45,UCBPlayer
45918,UCBPlayer,89,234,323,3,60,UCBPlayer
45919,UCBPlayer,138,243,381,28,49,UCBPlayer
45920,UCBPlayer,97,242,339,7,56,UCBPlayer
45921,UCBPlayer,130,235,365,24,53,UCBPlayer
45922,UCBPlayer,105,250,355,11,52,UCBPlayer
45923,UCBPlayer,122,227,349,20,57,UCBPlayer
45924,UCBPlayer,109,259,368,15,49,UCBPlayer
45925,UCBPlayer,118,218,336,16,60,UCBPlayer
45926,UCBPlayer,117,267,384,19,45,UCBPlayer
45927,UCBPlayer,110,210,320,12,64,UCBPlayer
45928,UCBPlayer,126,271,397,23,42,UCBPlayer
45929,UCBPlayer,105,210,315,10,65,UCBPlayer
45930,UCBPlayer,130,275,405,25,40,UCBPlayer
45931,UCBPlayer,105,210,315,10,65,UCBPlayer
45932,UCBPlayer,130,275,405,25,40,UCBPlayer
45933,UCBPlayer,106,206,312,10,66,UCBPlayer
45934,UCBPlayer,130,275,405,25,40,UCBPlayer
45935,UCBPlayer,105,210,315,10,65,UCBPlayer
45936,UCBPlayer,131,271,402,25,41,UCBPlayer
45937,UCBPlayer,105,210,315,10,65,UCBPlayer
45938,UCBPlayer,130,275,405,25,40,UCBPlayer
45939,UCBPlayer,105,210,315,10,65,UCBPlayer
45940,UCBPlayer,130,275,405,25,40,UCBPlayer
45941,UCBPlayer,103,203,306,10,68,UCBPlayer
45942,UCBPlayer,128,283,411,25,38,UCBPlayer
45943,UCBPlayer,111,186,297,10,71,UCBPlayer
45944,UCBPlayer,124,299,423,25,34,UCBPlayer
45945,UCBPlayer,115,170,285,10,75,UCBPlayer
45946,UCBPlayer,120,315,435,25,30,UCBPlayer
45947,UCBPlayer,119,154,273,10,79,UCBPlayer
45948,UCBPlayer,112,332,444,25,27,UCBPlayer
45949,UCBPlayer,127,137,264,10,82,UCBPlayer
45950,UCBPlayer,104,349,453,25,24,UCBPlayer
45951,UCBPlayer,126,126,252,7,85,Tie
45952,UCBPlayer,111,351,462,28,22,UCBPlayer
45953,UCBPlayer,116,126,242,3,87,UCBPlayer
45954,UCBPlayer,122,347,469,32,21,UCBPlayer
45955,UCBPlayer,107,132,239,0,87,UCBPlayer
45956,UCBPlayer,132,337,469,35,22,UCBPlayer
45957,UCBPlayer,103,148,251,0,83,UCBPlayer
45958,UCBPlayer,136,321,457,35,26,UCBPlayer
45959,UCBPlayer,99,164,263,0,79,UCBPlayer
45960,UCBPlayer,140,305,445,35,30,UCBPlayer
45961,UCBPlayer,95,180,275,0,75,UCBPlayer
45962,UCBPlayer,144,289,433,35,34,UCBPlayer
45963,UCBPlayer,91,196,287,0,71,UCBPlayer
45964,UCBPlayer,148,273,421,35,38,UCBPlayer
45965,UCBPlayer,87,212,299,0,67,UCBPlayer
45966,UCBPlayer,152,257,409,35,42,UCBPlayer
45967,UCBPlayer,84,224,308,0,64,UCBPlayer
45968,UCBPlayer,146,251,397,32,45,UCBPlayer
45969,UCBPlayer,89,234,323,3,60,UCBPlayer
45970,UCBPlayer,138,243,381,28,49,UCBPlayer
45971,UCBPlayer,97,242,339,7,56,UCBPlayer
45972,UCBPlayer,130,235,365,24,53,UCBPlayer
45973,UCBPlayer,105,250,355,11,52,UCBPlayer
45974,UCBPlayer,122,227,349,20,57,UCBPlayer
45975,UCBPlayer,109,259,368,15,49,UCBPlayer
45976,UCBPlayer,118,218,336,16,60,UCBPlayer
45977,UCBPlayer,117,267,384,19,45,UCBPlayer
45978,UCBPlayer,110,210,320,12,64,UCBPlayer
45979,UCBPlayer,126,271,397,23,42,UCBPlayer
45980,UCBPlayer,105,210,315,10,65,UCBPlayer
45981,UCBPlayer,130,275,405,25,40,UCBPlayer
45982,UCBPlayer,105,210,315,10,65,UCBPlayer
45983,UCBPlayer,130,275,405,25,40,UCBPlayer
45984,UCBPlayer,106,206,312,10,66,UCBPlayer
45985,UCBPlayer,130,275,405,25,40,UCBPlayer
45986,UCBPlayer,105,210,315,10,65,UCBPlayer
45987,UCBPlayer,131,271,402,25,41,UCBPlayer
45988,UCBPlayer,105,210,315,10,65,UCBPlayer
45989,UCBPlayer,130,275,405,25,40,UCBPlayer
45990,UCBPlayer,105,210,315,10,65,UCBPlayer
45991,UCBPlayer,130,275,405,25,40,UCBPlayer
45992,UCBPlayer,103,203,306,10,68,UCBPlayer
45993,UCBPlayer,128,283,411,25,38,UCBPlayer
45994,UCBPlayer,111,186,297,10,71,UCBPlayer
45995,UCBPlayer,124,299,423,25,34,UCBPlayer
45996,UCBPlayer,115,170,285,10,75,UCBPlayer
45997,UCBPlayer,120,315,435,25,30,UCBPlayer
45998,UCBPlayer,119,154,273,10,79,UCBPlayer
45999,UCBPlayer,112,332,444,25,27,UCBPlayer
46000,UCBPlayer,127,137,264,10,82,UCBPlayer
46001,UCBPlayer,104,349,453,25,24,UCBPlayer
46002,UCBPlayer,126,126,252,7,85,Tie
46003,UCBPlayer,111,351,462,28,22,UCBPlayer
46004,UCBPlayer,116,126,242,3,87,UCBPlayer
46005,UCBPlayer,122,347,469,32,21,UCBPlayer
46006,UCBPlayer,107,132,239,0,87,UCBPlayer
46007,UCBPlayer,132,337,469,35,22,UCBPlayer
46008,UCBPlayer,103,148,251,0,83,UCBPlayer
46009,UCBPlayer,136,321,457,35,26,UCBPlayer
46010,UCBPlayer,99,164,263,0,79,UCBPlayer
46011,UCBPlayer,140,305,445,35,30,UCBPlayer
46012,UCBPlayer,95,180,275,0,75,UCBPlayer
46013,UCBPlayer,144,289,433,35,34,UCBPlayer
46014,UCBPlayer,91,196,287,0,71,UCBPlayer
46015,UCBPlayer,148,273,421,35,38,UCBPlayer
46016,UCBPlayer,87,212,299,0,67,UCBPlayer
46017,UCBPlayer,152,257,409,35,42,UCBPlayer
46018,UCBPlayer,84,224,308,0,64,UCBPlayer
46019,UCBPlayer,146,251,397,32,45,UCBPlayer
46020,UCBPlayer,89,234,323,3,60,UCBPlayer
46021,UCBPlayer,138,243,381,28,49,UCBPlayer
46022,UCBPlayer,97,242,339,7,56,UCBPlayer
46023,UCBPlayer,130,235,365,24,53,UCBPlayer
46024,UCBPlayer,105,250,355,11,52,UCBPlayer
46025,UCBPlayer,122,227,349,20,57,UCBPlayer
46026,UCBPlayer,109,259,368,15,49,UCBPlayer
46027,UCBPlayer,118,218,336,16,60,UCBPlayer
46028,UCBPlayer,117,267,384,19,45,UCBPlayer
46029,UCBPlayer,110,210,320,12,64,UCBPlayer
46030,UCBPlayer,126,271,397,23,42,UCBPlayer
46031,UCBPlayer,105,210,315,10,65,UCBPlayer
46032,UCBPlayer,130,275,405,25,40,UCBPlayer
46033,UCBPlayer,105,210,315,10,65,UCBPlayer
46034,UCBPlayer,130,275,405,25,40,UCBPlayer
46035,UCBPlayer,106,206,312,10,66,UCBPlayer
46036,UCBPlayer,130,275,405,25,40,UCBPlayer
46037,UCBPlayer,105,210,315,10,65,UCBPlayer
46038,UCBPlayer,131,271,402,25,41,UCBPlayer
46039,UCBPlayer,105,210,315,10,65,UCBPlayer
46040,UCBPlayer,130,275,405,25,40,UCBPlayer
46041,UCBPlayer,105,210,315,10,65,UCBPlayer
46042,UCBPlayer,130,275,405,25,40,UCBPlayer
46043,UCBPlayer,103,203,306,10,68,UCBPlayer
46044,UCBPlayer,128,283,411,25,38,UCBPlayer
46045,UCBPlayer,111,186,297,10,71,UCBPlayer
46046,UCBPlayer,124,299,423,25,34,UCBPlayer
46047,UCBPlayer,115,170,285,10,75,UCBPlayer
46048,UCBPlayer,120,315,435,25,30,UCBPlayer
46049,UCBPlayer,119,154,273,10,79,UCBPlayer
46050,UCBPlayer,112,332,444,25,27,UCBPlayer
46051,UCBPlayer,127,137,264,10,82,UCBPlayer
46052,UCBPlayer,104,349,453,25,24,UCBPlayer
46053,UCBPlayer,126,126,252,7,85,Tie
46054,UCBPlayer,111,351,462,28,22,UCBPlayer
46055,UCBPlayer,116,126,242,3,87,UCBPlayer
46056,UCBPlayer,122,347,469,32,21,UCBPlayer
46057,UCBPlayer,107,132,239,0,87,UCBPlayer
46058,UCBPlayer,132,337,469,35,22,UCBPlayer
46059,UCBPlayer,103,148,251,0,83,UCBPlayer
46060,UCBPlayer,136,321,457,35,26,UCBPlayer
46061,UCBPlayer,99,164,263,0,79,UCBPlayer
46062,UCBPlayer,140,305,445,35,30,UCBPlayer
46063,UCBPlayer,95,180,275,0,75,UCBPlayer
46064,UCBPlayer,144,289,433,35,34,UCBPlayer
46065,UCBPlayer,91,196,287,0,71,UCBPlayer
46066,UCBPlayer,148,273,421,35,38,UCBPlayer
46067,UCBPlayer,87,212,299,0,67,UCBPlayer
46068,UCBPlayer,152,257,409,35,42,UCBPlayer
46069,UCBPlayer,84,224,308,0,64,UCBPlayer
46070,UCBPlayer,146,251,397,32,45,UCBPlayer
46071,UCBPlayer,89,234,323,3,60,UCBPlayer
46072,UCBPlayer,138,243,381,28,49,UCBPlayer
46073,UCBPlayer,97,242,339,7,56,UCBPlayer
46074,UCBPlayer,130,235,365,24,53,UCBPlayer
46075,UCBPlayer,105,250,355,11,52,UCBPlayer
46076,UCBPlayer,122,227,349,20,57,UCBPlayer
46077,UCBPlayer,109,259,368,15,49,UCBPlayer
46078,UCBPlayer,118,218,336,16,60,UCBPlayer
46079,UCBPlayer,117,267,384,19,45,UCBPlayer
46080,UCBPlayer,110,210,320,12,64,UCBPlayer
46081,UCBPlayer,126,271,397,23,42,UCBPlayer
46082,UCBPlayer,105,210,315,10,65,UCBPlayer
46083,UCBPlayer,130,275,405,25,40,UCBPlayer
46084,UCBPlayer,105,210,315,10,65,UCBPlayer
46085,UCBPlayer,130,275,405,25,40,UCBPlayer
46086,UCBPlayer,106,206,312,10,66,UCBPlayer
46087,UCBPlayer,130,275,405,25,40,UCBPlayer
46088,UCBPlayer,105,210,315,10,65,UCBPlayer
46089,UCBPlayer,131,271,402,25,41,UCBPlayer
46090,UCBPlayer,105,210,315,10,65,UCBPlayer
46091,UCBPlayer,130,275,405,25,40,UCBPlayer
46092,UCBPlayer,105,210,315,10,65,UCBPlayer
46093,UCBPlayer,130,275,405,25,40,UCBPlayer
46094,UCBPlayer,103,203,306,10,68,UCBPlayer
46095,UCBPlayer,128,283,411,25,38,UCBPlayer
46096,UCBPlayer,111,186,297,10,71,UCBPlayer
46097,UCBPlayer,124,299,423,25,34,UCBPlayer
46098,UCBPlayer,115,170,285,10,75,UCBPlayer
46099,UCBPlayer,120,315,435,25,30,UCBPlayer
46100,UCBPlayer,119,154,273,10,79,UCBPlayer
46101,UCBPlayer,112,332,444,25,27,UCBPlayer
46102,UCBPlayer,127,137,264,10,82,UCBPlayer
46103,UCBPlayer,104,349,453,25,24,UCBPlayer
46104,UCBPlayer,126,126,252,7,85,Tie
46105,UCBPlayer,111,351,462,28,22,UCBPlayer
46106,UCBPlayer,116,126,242,3,87,UCBPlayer
46107,UCBPlayer,122,347,469,32,21,UCBPlayer
46108,UCBPlayer,107,132,239,0,87,UCBPlayer
46109,UCBPlayer,132,337,469,35,22,UCBPlayer
46110,UCBPlayer,103,148,251,0,83,UCBPlayer
46111,UCBPlayer,136,321,457,35,26,UCBPlayer
46112,UCBPlayer,99,164,263,0,79,UCBPlayer
46113,UCBPlayer,140,305,445,35,30,UCBPlayer
46114,UCBPlayer,95,180,275,0,75,UCBPlayer
46115,UCBPlayer,144,289,433,35,34,UCBPlayer
46116,UCBPlayer,91,196,287,0,71,UCBPlayer
46117,UCBPlayer,148,273,421,35,38,UCBPlayer
46118,UCBPlayer,87,212,299,0,67,UCBPlayer
46119,UCBPlayer,152,257,409,35,42,UCBPlayer
46120,UCBPlayer,84,224,308,0,64,UCBPlayer
46121,UCBPlayer,146,251,397,32,45,UCBPlayer
46122,UCBPlayer,89,234,323,3,60,UCBPlayer
46123,UCBPlayer,138,243,381,28,49,UCBPlayer
46124,UCBPlayer,97,242,339,7,56,UCBPlayer
46125,UCBPlayer,130,235,365,24,53,UCBPlayer
46126,UCBPlayer,105,250,355,11,52,UCBPlayer
46127,UCBPlayer,122,227,349,20,57,UCBPlayer
46128,UCBPlayer,109,259,368,15,49,UCBPlayer
46129,UCBPlayer,118,218,336,16,60,UCBPlayer
46130,UCBPlayer,117,267,384,19,45,UCBPlayer
46131,UCBPlayer,110,210,320,12,64,UCBPlayer
46132,UCBPlayer,126,271,397,23,42,UCBPlayer
46133,UCBPlayer,105,210,315,10,65,UCBPlayer
46134,UCBPlayer,130,275,405,25,40,UCBPlayer
46135,UCBPlayer,105,210,315,10,65,UCBPlayer
46136,UCBPlayer,130,275,405,25,40,UCBPlayer
46137,UCBPlayer,106,206,312,10,66,UCBPlayer
46138,UCBPlayer,130,275,405,25,40,UCBPlayer
46139,UCBPlayer,105,210,315,10,65,UCBPlayer
46140,UCBPlayer,131,271,402,25,41,UCBPlayer
46141,UCBPlayer,105,210,315,10,65,UCBPlayer
46142,UCBPlayer,130,275,405,25,40,UCBPlayer
46143,UCBPlayer,105,210,315,10,65,UCBPlayer
46144,UCBPlayer,130,275,405,25,40,UCBPlayer
46145,UCBPlayer,103,203,306,10,68,UCBPlayer
46146,UCBPlayer,128,283,411,25,38,UCBPlayer
46147,UCBPlayer,111,186,297,10,71,UCBPlayer
46148,UCBPlayer,124,299,423,25,34,UCBPlayer
46149,UCBPlayer,115,170,285,10,75,UCBPlayer
46150,UCBPlayer,120,315,435,25,30,UCBPlayer
46151,UCBPlayer,119,154,273,10,79,UCBPlayer
46152,UCBPlayer,112,332,444,25,27,UCBPlayer
46153,UCBPlayer,127,137,264,10,82,UCBPlayer
46154,UCBPlayer,104,349,453,25,24,UCBPlayer
46155,UCBPlayer,126,126,252,7,85,Tie
46156,UCBPlayer,111,351,462,28,22,UCBPlayer
46157,UCBPlayer,116,126,242,3,87,UCBPlayer
46158,UCBPlayer,122,347,469,32,21,UCBPlayer
46159,UCBPlayer,107,132,239,0,87,UCBPlayer
46160,UCBPlayer,132,337,469,35,22,UCBPlayer
46161,UCBPlayer,103,148,251,0,83,UCBPlayer
46162,UCBPlayer,136,321,457,35,26,UCBPlayer
46163,UCBPlayer,99,164,263,0,79,UCBPlayer
46164,UCBPlayer,140,305,445,35,30,UCBPlayer
46165,UCBPlayer,95,180,275,0,75,UCBPlayer
46166,UCBPlayer,144,289,433,35,34,UCBPlayer
46167,UCBPlayer,91,196,287,0,71,UCBPlayer
46168,UCBPlayer,148,273,421,35,38,UCBPlayer
46169,UCBPlayer,87,212,299,0,67,UCBPlayer
46170,UCBPlayer,152,257,409,35,42,UCBPlayer
46171,UCBPlayer,84,224,308,0,64,UCBPlayer
46172,UCBPlayer,146,251,397,32,45,UCBPlayer
46173,UCBPlayer,89,234,323,3,60,UCBPlayer
46174,UCBPlayer,138,243,381,28,49,UCBPlayer
46175,UCBPlayer,97,242,339,7,56,UCBPlayer
46176,UCBPlayer,130,235,365,24,53,UCBPlayer
46177,UCBPlayer,105,250,355,11,52,UCBPlayer
46178,UCBPlayer,122,227,349,20,57,UCBPlayer
46179,UCBPlayer,109,259,368,15,49,UCBPlayer
46180,UCBPlayer,118,218,336,16,60,UCBPlayer
46181,UCBPlayer,117,267,384,19,45,UCBPlayer
46182,UCBPlayer,110,210,320,12,64,UCBPlayer
46183,UCBPlayer,126,271,397,23,42,UCBPlayer
46184,UCBPlayer,105,210,315,10,65,UCBPlayer
46185,UCBPlayer,130,275,405,25,40,UCBPlayer
46186,UCBPlayer,105,210,315,10,65,UCBPlayer
46187,UCBPlayer,130,275,405,25,40,UCBPlayer
46188,UCBPlayer,106,206,312,10,66,UCBPlayer
46189,UCBPlayer,130,275,405,25,40,UCBPlayer
46190,UCBPlayer,105,210,315,10,65,UCBPlayer
46191,UCBPlayer,131,271,402,25,41,UCBPlayer
46192,UCBPlayer,105,210,315,10,65,UCBPlayer
46193,UCBPlayer,130,275,405,25,40,UCBPlayer
46194,UCBPlayer,105,210,315,10,65,UCBPlayer
46195,UCBPlayer,130,275,405,25,40,UCBPlayer
46196,UCBPlayer,103,203,306,10,68,UCBPlayer
46197,UCBPlayer,128,283,411,25,38,UCBPlayer
46198,UCBPlayer,111,186,297,10,71,UCBPlayer
46199,UCBPlayer,124,299,423,25,34,UCBPlayer
46200,UCBPlayer,115,170,285,10,75,UCBPlayer
46201,UCBPlayer,120,315,435,25,30,UCBPlayer
46202,UCBPlayer,119,154,273,10,79,UCBPlayer
46203,UCBPlayer,112,332,444,25,27,UCBPlayer
46204,UCBPlayer,127,137,264,10,82,UCBPlayer
46205,UCBPlayer,104,349,453,25,24,UCBPlayer
46206,UCBPlayer,126,126,252,7,85,Tie
46207,UCBPlayer,111,351,462,28,22,UCBPlayer
46208,UCBPlayer,116,126,242,3,87,UCBPlayer
46209,UCBPlayer,122,347,469,32,21,UCBPlayer
46210,UCBPlayer,107,132,239,0,87,UCBPlayer
46211,UCBPlayer,132,337,469,35,22,UCBPlayer
46212,UCBPlayer,103,148,251,0,83,UCBPlayer
46213,UCBPlayer,136,321,457,35,26,UCBPlayer
46214,UCBPlayer,99,164,263,0,79,UCBPlayer
46215,UCBPlayer,140,305,445,35,30,UCBPlayer
46216,UCBPlayer,95,180,275,0,75,UCBPlayer
46217,UCBPlayer,144,289,433,35,34,UCBPlayer
46218,UCBPlayer,91,196,287,0,71,UCBPlayer
46219,UCBPlayer,148,273,421,35,38,UCBPlayer
46220,UCBPlayer,87,212,299,0,67,UCBPlayer
46221,UCBPlayer,152,257,409,35,42,UCBPlayer
46222,UCBPlayer,84,224,308,0,64,UCBPlayer
46223,UCBPlayer,146,251,397,32,45,UCBPlayer
46224,UCBPlayer,89,234,323,3,60,UCBPlayer
46225,UCBPlayer,138,243,381,28,49,UCBPlayer
46226,UCBPlayer,97,242,339,7,56,UCBPlayer
46227,UCBPlayer,130,235,365,24,53,UCBPlayer
46228,UCBPlayer,105,250,355,11,52,UCBPlayer
46229,UCBPlayer,122,227,349,20,57,UCBPlayer
46230,UCBPlayer,109,259,368,15,49,UCBPlayer
46231,UCBPlayer,118,218,336,16,60,UCBPlayer
46232,UCBPlayer,117,267,384,19,45,UCBPlayer
46233,UCBPlayer,110,210,320,12,64,UCBPlayer
46234,UCBPlayer,126,271,397,23,42,UCBPlayer
46235,UCBPlayer,105,210,315,10,65,UCBPlayer
46236,UCBPlayer,130,275,405,25,40,UCBPlayer
46237,UCBPlayer,105,210,315,10,65,UCBPlayer
46238,UCBPlayer,130,275,405,25,40,UCBPlayer
46239,UCBPlayer,106,206,312,10,66,UCBPlayer
46240,UCBPlayer,130,275,405,25,40,UCBPlayer
46241,UCBPlayer,105,210,315,10,65,UCBPlayer
46242,UCBPlayer,131,271,402,25,41,UCBPlayer
46243,UCBPlayer,105,210,315,10,65,UCBPlayer
46244,UCBPlayer,130,275,405,25,40,UCBPlayer
46245,UCBPlayer,105,210,315,10,65,UCBPlayer
46246,UCBPlayer,130,275,405,25,40,UCBPlayer
46247,UCBPlayer,103,203,306,10,68,UCBPlayer
46248,UCBPlayer,128,283,411,25,38,UCBPlayer
46249,UCBPlayer,111,186,297,10,71,UCBPlayer
46250,UCBPlayer,124,299,423,25,34,UCBPlayer
46251,UCBPlayer,115,170,285,10,75,UCBPlayer
46252,UCBPlayer,120,315,435,25,30,UCBPlayer
46253,UCBPlayer,119,154,273,10,79,UCBPlayer
46254,UCBPlayer,112,332,444,25,27,UCBPlayer
46255,UCBPlayer,127,137,264,10,82,UCBPlayer
46256,UCBPlayer,104,349,453,25,24,UCBPlayer
46257,UCBPlayer,126,126,252,7,85,Tie
46258,UCBPlayer,111,351,462,28,22,UCBPlayer
46259,UCBPlayer,116,126,242,3,87,UCBPlayer
46260,UCBPlayer,122,347,469,32,21,UCBPlayer
46261,UCBPlayer,107,132,239,0,87,UCBPlayer
46262,UCBPlayer,132,337,469,35,22,UCBPlayer
46263,UCBPlayer,103,148,251,0,83,UCBPlayer
46264,UCBPlayer,136,321,457,35,26,UCBPlayer
46265,UCBPlayer,99,164,263,0,79,UCBPlayer
46266,UCBPlayer,140,305,445,35,30,UCBPlayer
46267,UCBPlayer,95,180,275,0,75,UCBPlayer
46268,UCBPlayer,144,289,433,35,34,UCBPlayer
46269,UCBPlayer,91,196,287,0,71,UCBPlayer
46270,UCBPlayer,148,273,421,35,38,UCBPlayer
46271,UCBPlayer,87,212,299,0,67,UCBPlayer
46272,UCBPlayer,152,257,409,35,42,UCBPlayer
46273,UCBPlayer,84,224,308,0,64,UCBPlayer
46274,UCBPlayer,146,251,397,32,45,UCBPlayer
46275,UCBPlayer,89,234,323,3,60,UCBPlayer
46276,UCBPlayer,138,243,381,28,49,UCBPlayer
46277,UCBPlayer,97,242,339,7,56,UCBPlayer
46278,UCBPlayer,130,235,365,24,53,UCBPlayer
46279,UCBPlayer,105,250,355,11,52,UCBPlayer
46280,UCBPlayer,122,227,349,20,57,UCBPlayer
46281,UCBPlayer,109,259,368,15,49,UCBPlayer
46282,UCBPlayer,118,218,336,16,60,UCBPlayer
46283,UCBPlayer,117,267,384,19,45,UCBPlayer
46284,UCBPlayer,110,210,320,12,64,UCBPlayer
46285,UCBPlayer,126,271,397,23,42,UCBPlayer
46286,UCBPlayer,105,210,315,10,65,UCBPlayer
46287,UCBPlayer,130,275,405,25,40,UCBPlayer
46288,UCBPlayer,105,210,315,10,65,UCBPlayer
46289,UCBPlayer,130,275,405,25,40,UCBPlayer
46290,UCBPlayer,106,206,312,10,66,UCBPlayer
46291,UCBPlayer,130,275,405,25,40,UCBPlayer
46292,UCBPlayer,105,210,315,10,65,UCBPlayer
46293,UCBPlayer,131,271,402,25,41,UCBPlayer
46294,UCBPlayer,105,210,315,10,65,UCBPlayer
46295,UCBPlayer,130,275,405,25,40,UCBPlayer
46296,UCBPlayer,105,210,315,10,65,UCBPlayer
46297,UCBPlayer,130,275,405,25,40,UCBPlayer
46298,UCBPlayer,103,203,306,10,68,UCBPlayer
46299,UCBPlayer,128,283,411,25,38,UCBPlayer
46300,UCBPlayer,111,186,297,10,71,UCBPlayer
46301,UCBPlayer,124,299,423,25,34,UCBPlayer
46302,UCBPlayer,115,170,285,10,75,UCBPlayer
46303,UCBPlayer,120,315,435,25,30,UCBPlayer
46304,UCBPlayer,119,154,273,10,79,UCBPlayer
46305,UCBPlayer,112,332,444,25,27,UCBPlayer
46306,UCBPlayer,127,137,264,10,82,UCBPlayer
46307,UCBPlayer,104,349,453,25,24,UCBPlayer
46308,UCBPlayer,126,126,252,7,85,Tie
46309,UCBPlayer,111,351,462,28,22,UCBPlayer
46310,UCBPlayer,116,126,242,3,87,UCBPlayer
46311,UCBPlayer,122,347,469,32,21,UCBPlayer
46312,UCBPlayer,107,132,239,0,87,UCBPlayer
46313,UCBPlayer,132,337,469,35,22,UCBPlayer
46314,UCBPlayer,103,148,251,0,83,UCBPlayer
46315,UCBPlayer,136,321,457,35,26,UCBPlayer
46316,UCBPlayer,99,164,263,0,79,UCBPlayer
46317,UCBPlayer,140,305,445,35,30,UCBPlayer
46318,UCBPlayer,95,180,275,0,75,UCBPlayer
46319,UCBPlayer,144,289,433,35,34,UCBPlayer
46320,UCBPlayer,91,196,287,0,71,UCBPlayer
46321,UCBPlayer,148,273,421,35,38,UCBPlayer
46322,UCBPlayer,87,212,299,0,67,UCBPlayer
46323,UCBPlayer,152,257,409,35,42,UCBPlayer
46324,UCBPlayer,84,224,308,0,64,UCBPlayer
46325,UCBPlayer,146,251,397,32,45,UCBPlayer
46326,UCBPlayer,89,234,323,3,60,UCBPlayer
46327,UCBPlayer,138,243,381,28,49,UCBPlayer
46328,UCBPlayer,97,242,339,7,56,UCBPlayer
46329,UCBPlayer,130,235,365,24,53,UCBPlayer
46330,UCBPlayer,105,250,355,11,52,UCBPlayer
46331,UCBPlayer,122,227,349,20,57,UCBPlayer
46332,UCBPlayer,109,259,368,15,49,UCBPlayer
46333,UCBPlayer,118,218,336,16,60,UCBPlayer
46334,UCBPlayer,117,267,384,19,45,UCBPlayer
46335,UCBPlayer,110,210,320,12,64,UCBPlayer
46336,UCBPlayer,126,271,397,23,42,UCBPlayer
46337,UCBPlayer,105,210,315,10,65,UCBPlayer
46338,UCBPlayer,130,275,405,25,40,UCBPlayer
46339,UCBPlayer,105,210,315,10,65,UCBPlayer
46340,UCBPlayer,130,275,405,25,40,UCBPlayer
46341,UCBPlayer,106,206,312,10,66,UCBPlayer
46342,UCBPlayer,130,275,405,25,40,UCBPlayer
46343,UCBPlayer,105,210,315,10,65,UCBPlayer
46344,UCBPlayer,131,271,402,25,41,UCBPlayer
46345,UCBPlayer,105,210,315,10,65,UCBPlayer
46346,UCBPlayer,130,275,405,25,40,UCBPlayer
46347,UCBPlayer,105,210,315,10,65,UCBPlayer
46348,UCBPlayer,130,275,405,25,40,UCBPlayer
46349,UCBPlayer,103,203,306,10,68,UCBPlayer
46350,UCBPlayer,128,283,411,25,38,UCBPlayer
46351,UCBPlayer,111,186,297,10,71,UCBPlayer
46352,UCBPlayer,124,299,423,25,34,UCBPlayer
46353,UCBPlayer,115,170,285,10,75,UCBPlayer
46354,UCBPlayer,120,315,435,25,30,UCBPlayer
46355,UCBPlayer,119,154,273,10,79,UCBPlayer
46356,UCBPlayer,112,332,444,25,27,UCBPlayer
46357,UCBPlayer,127,137,264,10,82,UCBPlayer
46358,UCBPlayer,104,349,453,25,24,UCBPlayer
46359,UCBPlayer,126,126,252,7,85,Tie
46360,UCBPlayer,111,351,462,28,22,UCBPlayer
46361,UCBPlayer,116,126,242,3,87,UCBPlayer
46362,UCBPlayer,122,347,469,32,21,UCBPlayer
46363,UCBPlayer,107,132,239,0,87,UCBPlayer
46364,UCBPlayer,132,337,469,35,22,UCBPlayer
46365,UCBPlayer,103,148,251,0,83,UCBPlayer
46366,UCBPlayer,136,321,457,35,26,UCBPlayer
46367,UCBPlayer,99,164,263,0,79,UCBPlayer
46368,UCBPlayer,140,305,445,35,30,UCBPlayer
46369,UCBPlayer,95,180,275,0,75,UCBPlayer
46370,UCBPlayer,144,289,433,35,34,UCBPlayer
46371,UCBPlayer,91,196,287,0,71,UCBPlayer
46372,UCBPlayer,148,273,421,35,38,UCBPlayer
46373,UCBPlayer,87,212,299,0,67,UCBPlayer
46374,UCBPlayer,152,257,409,35,42,UCBPlayer
46375,UCBPlayer,84,224,308,0,64,UCBPlayer
46376,UCBPlayer,146,251,397,32,45,UCBPlayer
46377,UCBPlayer,89,234,323,3,60,UCBPlayer
46378,UCBPlayer,138,243,381,28,49,UCBPlayer
46379,UCBPlayer,97,242,339,7,56,UCBPlayer
46380,UCBPlayer,130,235,365,24,53,UCBPlayer
46381,UCBPlayer,105,250,355,11,52,UCBPlayer
46382,UCBPlayer,122,227,349,20,57,UCBPlayer
46383,UCBPlayer,109,259,368,15,49,UCBPlayer
46384,UCBPlayer,118,218,336,16,60,UCBPlayer
46385,UCBPlayer,117,267,384,19,45,UCBPlayer
46386,UCBPlayer,110,210,320,12,64,UCBPlayer
46387,UCBPlayer,126,271,397,23,42,UCBPlayer
46388,UCBPlayer,105,210,315,10,65,UCBPlayer
46389,UCBPlayer,130,275,405,25,40,UCBPlayer
46390,UCBPlayer,105,210,315,10,65,UCBPlayer
46391,UCBPlayer,130,275,405,25,40,UCBPlayer
46392,UCBPlayer,106,206,312,10,66,UCBPlayer
46393,UCBPlayer,130,275,405,25,40,UCBPlayer
46394,UCBPlayer,105,210,315,10,65,UCBPlayer
46395,UCBPlayer,131,271,402,25,41,UCBPlayer
46396,UCBPlayer,105,210,315,10,65,UCBPlayer
46397,UCBPlayer,130,275,405,25,40,UCBPlayer
46398,UCBPlayer,105,210,315,10,65,UCBPlayer
46399,UCBPlayer,130,275,405,25,40,UCBPlayer
46400,UCBPlayer,103,203,306,10,68,UCBPlayer
46401,UCBPlayer,128,283,411,25,38,UCBPlayer
46402,UCBPlayer,111,186,297,10,71,UCBPlayer
46403,UCBPlayer,124,299,423,25,34,UCBPlayer
46404,UCBPlayer,115,170,285,10,75,UCBPlayer
46405,UCBPlayer,120,315,435,25,30,UCBPlayer
46406,UCBPlayer,119,154,273,10,79,UCBPlayer
46407,UCBPlayer,112,332,444,25,27,UCBPlayer
46408,UCBPlayer,127,137,264,10,82,UCBPlayer
46409,UCBPlayer,104,349,453,25,24,UCBPlayer
46410,UCBPlayer,126,126,252,7,85,Tie
46411,UCBPlayer,111,351,462,28,22,UCBPlayer
46412,UCBPlayer,116,126,242,3,87,UCBPlayer
46413,UCBPlayer,122,347,469,32,21,UCBPlayer
46414,UCBPlayer,107,132,239,0,87,UCBPlayer
46415,UCBPlayer,132,337,469,35,22,UCBPlayer
46416,UCBPlayer,103,148,251,0,83,UCBPlayer
46417,UCBPlayer,136,321,457,35,26,UCBPlayer
46418,UCBPlayer,99,164,263,0,79,UCBPlayer
46419,UCBPlayer,140,305,445,35,30,UCBPlayer
46420,UCBPlayer,95,180,275,0,75,UCBPlayer
46421,UCBPlayer,144,289,433,35,34,UCBPlayer
46422,UCBPlayer,91,196,287,0,71,UCBPlayer
46423,UCBPlayer,148,273,421,35,38,UCBPlayer
46424,UCBPlayer,87,212,299,0,67,UCBPlayer
46425,UCBPlayer,152,257,409,35,42,UCBPlayer
46426,UCBPlayer,84,224,308,0,64,UCBPlayer
46427,UCBPlayer,146,251,397,32,45,UCBPlayer
46428,UCBPlayer,89,234,323,3,60,UCBPlayer
46429,UCBPlayer,138,243,381,28,49,UCBPlayer
46430,UCBPlayer,97,242,339,7,56,UCBPlayer
46431,UCBPlayer,130,235,365,24,53,UCBPlayer
46432,UCBPlayer,105,250,355,11,52,UCBPlayer
46433,UCBPlayer,122,227,349,20,57,UCBPlayer
46434,UCBPlayer,109,259,368,15,49,UCBPlayer
46435,UCBPlayer,118,218,336,16,60,UCBPlayer
46436,UCBPlayer,117,267,384,19,45,UCBPlayer
46437,UCBPlayer,110,210,320,12,64,UCBPlayer
46438,UCBPlayer,126,271,397,23,42,UCBPlayer
46439,UCBPlayer,105,210,315,10,65,UCBPlayer
46440,UCBPlayer,130,275,405,25,40,UCBPlayer
46441,UCBPlayer,105,210,315,10,65,UCBPlayer
46442,UCBPlayer,130,275,405,25,40,UCBPlayer
46443,UCBPlayer,106,206,312,10,66,UCBPlayer
46444,UCBPlayer,130,275,405,25,40,UCBPlayer
46445,UCBPlayer,105,210,315,10,65,UCBPlayer
46446,UCBPlayer,131,271,402,25,41,UCBPlayer
46447,UCBPlayer,105,210,315,10,65,UCBPlayer
46448,UCBPlayer,130,275,405,25,40,UCBPlayer
46449,UCBPlayer,105,210,315,10,65,UCBPlayer
46450,UCBPlayer,130,275,405,25,40,UCBPlayer
46451,UCBPlayer,103,203,306,10,68,UCBPlayer
46452,UCBPlayer,128,283,411,25,38,UCBPlayer
46453,UCBPlayer,111,186,297,10,71,UCBPlayer
46454,UCBPlayer,124,299,423,25,34,UCBPlayer
46455,UCBPlayer,115,170,285,10,75,UCBPlayer
46456,UCBPlayer,120,315,435,25,30,UCBPlayer
46457,UCBPlayer,119,154,273,10,79,UCBPlayer
46458,UCBPlayer,112,332,444,25,27,UCBPlayer
46459,UCBPlayer,127,137,264,10,82,UCBPlayer
46460,UCBPlayer,104,349,453,25,24,UCBPlayer
46461,UCBPlayer,126,126,252,7,85,Tie
46462,UCBPlayer,111,351,462,28,22,UCBPlayer
46463,UCBPlayer,116,126,242,3,87,UCBPlayer
46464,UCBPlayer,122,347,469,32,21,UCBPlayer
46465,UCBPlayer,107,132,239,0,87,UCBPlayer
46466,UCBPlayer,132,337,469,35,22,UCBPlayer
46467,UCBPlayer,103,148,251,0,83,UCBPlayer
46468,UCBPlayer,136,321,457,35,26,UCBPlayer
46469,UCBPlayer,99,164,263,0,79,UCBPlayer
46470,UCBPlayer,140,305,445,35,30,UCBPlayer
46471,UCBPlayer,95,180,275,0,75,UCBPlayer
46472,UCBPlayer,144,289,433,35,34,UCBPlayer
46473,UCBPlayer,91,196,287,0,71,UCBPlayer
46474,UCBPlayer,148,273,421,35,38,UCBPlayer
46475,UCBPlayer,87,212,299,0,67,UCBPlayer
46476,UCBPlayer,152,257,409,35,42,UCBPlayer
46477,UCBPlayer,84,224,308,0,64,UCBPlayer
46478,UCBPlayer,146,251,397,32,45,UCBPlayer
46479,UCBPlayer,89,234,323,3,60,UCBPlayer
46480,UCBPlayer,138,243,381,28,49,UCBPlayer
46481,UCBPlayer,97,242,339,7,56,UCBPlayer
46482,UCBPlayer,130,235,365,24,53,UCBPlayer
46483,UCBPlayer,105,250,355,11,52,UCBPlayer
46484,UCBPlayer,122,227,349,20,57,UCBPlayer
46485,UCBPlayer,109,259,368,15,49,UCBPlayer
46486,UCBPlayer,118,218,336,16,60,UCBPlayer
46487,UCBPlayer,117,267,384,19,45,UCBPlayer
46488,UCBPlayer,110,210,320,12,64,UCBPlayer
46489,UCBPlayer,126,271,397,23,42,UCBPlayer
46490,UCBPlayer,105,210,315,10,65,UCBPlayer
46491,UCBPlayer,130,275,405,25,40,UCBPlayer
46492,UCBPlayer,105,210,315,10,65,UCBPlayer
46493,UCBPlayer,130,275,405,25,40,UCBPlayer
46494,UCBPlayer,106,206,312,10,66,UCBPlayer
46495,UCBPlayer,130,275,405,25,40,UCBPlayer
46496,UCBPlayer,105,210,315,10,65,UCBPlayer
46497,UCBPlayer,131,271,402,25,41,UCBPlayer
46498,UCBPlayer,105,210,315,10,65,UCBPlayer
46499,UCBPlayer,130,275,405,25,40,UCBPlayer
46500,UCBPlayer,105,210,315,10,65,UCBPlayer
46501,UCBPlayer,130,275,405,25,40,UCBPlayer
46502,UCBPlayer,103,203,306,10,68,UCBPlayer
46503,UCBPlayer,128,283,411,25,38,UCBPlayer
46504,UCBPlayer,111,186,297,10,71,UCBPlayer
46505,UCBPlayer,124,299,423,25,34,UCBPlayer
46506,UCBPlayer,115,170,285,10,75,UCBPlayer
46507,UCBPlayer,120,315,435,25,30,UCBPlayer
46508,UCBPlayer,119,154,273,10,79,UCBPlayer
46509,UCBPlayer,112,332,444,25,27,UCBPlayer
46510,UCBPlayer,127,137,264,10,82,UCBPlayer
46511,UCBPlayer,104,349,453,25,24,UCBPlayer
46512,UCBPlayer,126,126,252,7,85,Tie
46513,UCBPlayer,111,351,462,28,22,UCBPlayer
46514,UCBPlayer,116,126,242,3,87,UCBPlayer
46515,UCBPlayer,122,347,469,32,21,UCBPlayer
46516,UCBPlayer,107,132,239,0,87,UCBPlayer
46517,UCBPlayer,132,337,469,35,22,UCBPlayer
46518,UCBPlayer,103,148,251,0,83,UCBPlayer
46519,UCBPlayer,136,321,457,35,26,UCBPlayer
46520,UCBPlayer,99,164,263,0,79,UCBPlayer
46521,UCBPlayer,140,305,445,35,30,UCBPlayer
46522,UCBPlayer,95,180,275,0,75,UCBPlayer
46523,UCBPlayer,144,289,433,35,34,UCBPlayer
46524,UCBPlayer,91,196,287,0,71,UCBPlayer
46525,UCBPlayer,148,273,421,35,38,UCBPlayer
46526,UCBPlayer,87,212,299,0,67,UCBPlayer
46527,UCBPlayer,152,257,409,35,42,UCBPlayer
46528,UCBPlayer,84,224,308,0,64,UCBPlayer
46529,UCBPlayer,146,251,397,32,45,UCBPlayer
46530,UCBPlayer,89,234,323,3,60,UCBPlayer
46531,UCBPlayer,138,243,381,28,49,UCBPlayer
46532,UCBPlayer,97,242,339,7,56,UCBPlayer
46533,UCBPlayer,130,235,365,24,53,UCBPlayer
46534,UCBPlayer,105,250,355,11,52,UCBPlayer
46535,UCBPlayer,122,227,349,20,57,UCBPlayer
46536,UCBPlayer,109,259,368,15,49,UCBPlayer
46537,UCBPlayer,118,218,336,16,60,UCBPlayer
46538,UCBPlayer,117,267,384,19,45,UCBPlayer
46539,UCBPlayer,110,210,320,12,64,UCBPlayer
46540,UCBPlayer,126,271,397,23,42,UCBPlayer
46541,UCBPlayer,105,210,315,10,65,UCBPlayer
46542,UCBPlayer,130,275,405,25,40,UCBPlayer
46543,UCBPlayer,105,210,315,10,65,UCBPlayer
46544,UCBPlayer,130,275,405,25,40,UCBPlayer
46545,UCBPlayer,106,206,312,10,66,UCBPlayer
46546,UCBPlayer,130,275,405,25,40,UCBPlayer
46547,UCBPlayer,105,210,315,10,65,UCBPlayer
46548,UCBPlayer,131,271,402,25,41,UCBPlayer
46549,UCBPlayer,105,210,315,10,65,UCBPlayer
46550,UCBPlayer,130,275,405,25,40,UCBPlayer
46551,UCBPlayer,105,210,315,10,65,UCBPlayer
46552,UCBPlayer,130,275,405,25,40,UCBPlayer
46553,UCBPlayer,103,203,306,10,68,UCBPlayer
46554,UCBPlayer,128,283,411,25,38,UCBPlayer
46555,UCBPlayer,111,186,297,10,71,UCBPlayer
46556,UCBPlayer,124,299,423,25,34,UCBPlayer
46557,UCBPlayer,115,170,285,10,75,UCBPlayer
46558,UCBPlayer,120,315,435,25,30,UCBPlayer
46559,UCBPlayer,119,154,273,10,79,UCBPlayer
46560,UCBPlayer,112,332,444,25,27,UCBPlayer
46561,UCBPlayer,127,137,264,10,82,UCBPlayer
46562,UCBPlayer,104,349,453,25,24,UCBPlayer
46563,UCBPlayer,126,126,252,7,85,Tie
46564,UCBPlayer,111,351,462,28,22,UCBPlayer
46565,UCBPlayer,116,126,242,3,87,UCBPlayer
46566,UCBPlayer,122,347,469,32,21,UCBPlayer
46567,UCBPlayer,107,132,239,0,87,UCBPlayer
46568,UCBPlayer,132,337,469,35,22,UCBPlayer
46569,UCBPlayer,103,148,251,0,83,UCBPlayer
46570,UCBPlayer,136,321,457,35,26,UCBPlayer
46571,UCBPlayer,99,164,263,0,79,UCBPlayer
46572,UCBPlayer,140,305,445,35,30,UCBPlayer
46573,UCBPlayer,95,180,275,0,75,UCBPlayer
46574,UCBPlayer,144,289,433,35,34,UCBPlayer
46575,UCBPlayer,91,196,287,0,71,UCBPlayer
46576,UCBPlayer,148,273,421,35,38,UCBPlayer
46577,UCBPlayer,87,212,299,0,67,UCBPlayer
46578,UCBPlayer,152,257,409,35,42,UCBPlayer
46579,UCBPlayer,84,224,308,0,64,UCBPlayer
46580,UCBPlayer,146,251,397,32,45,UCBPlayer
46581,UCBPlayer,89,234,323,3,60,UCBPlayer
46582,UCBPlayer,138,243,381,28,49,UCBPlayer
46583,UCBPlayer,97,242,339,7,56,UCBPlayer
46584,UCBPlayer,130,235,365,24,53,UCBPlayer
46585,UCBPlayer,105,250,355,11,52,UCBPlayer
46586,UCBPlayer,122,227,349,20,57,UCBPlayer
46587,UCBPlayer,109,259,368,15,49,UCBPlayer
46588,UCBPlayer,118,218,336,16,60,UCBPlayer
46589,UCBPlayer,117,267,384,19,45,UCBPlayer
46590,UCBPlayer,110,210,320,12,64,UCBPlayer
46591,UCBPlayer,126,271,397,23,42,UCBPlayer
46592,UCBPlayer,105,210,315,10,65,UCBPlayer
46593,UCBPlayer,130,275,405,25,40,UCBPlayer
46594,UCBPlayer,105,210,315,10,65,UCBPlayer
46595,UCBPlayer,130,275,405,25,40,UCBPlayer
46596,UCBPlayer,106,206,312,10,66,UCBPlayer
46597,UCBPlayer,130,275,405,25,40,UCBPlayer
46598,UCBPlayer,105,210,315,10,65,UCBPlayer
46599,UCBPlayer,131,271,402,25,41,UCBPlayer
46600,UCBPlayer,105,210,315,10,65,UCBPlayer
46601,UCBPlayer,130,275,405,25,40,UCBPlayer
46602,UCBPlayer,105,210,315,10,65,UCBPlayer
46603,UCBPlayer,130,275,405,25,40,UCBPlayer
46604,UCBPlayer,103,203,306,10,68,UCBPlayer
46605,UCBPlayer,128,283,411,25,38,UCBPlayer
46606,UCBPlayer,111,186,297,10,71,UCBPlayer
46607,UCBPlayer,124,299,423,25,34,UCBPlayer
46608,UCBPlayer,115,170,285,10,75,UCBPlayer
46609,UCBPlayer,120,315,435,25,30,UCBPlayer
46610,UCBPlayer,119,154,273,10,79,UCBPlayer
46611,UCBPlayer,112,332,444,25,27,UCBPlayer
46612,UCBPlayer,127,137,264,10,82,UCBPlayer
46613,UCBPlayer,104,349,453,25,24,UCBPlayer
46614,UCBPlayer,126,126,252,7,85,Tie
46615,UCBPlayer,111,351,462,28,22,UCBPlayer
46616,UCBPlayer,116,126,242,3,87,UCBPlayer
46617,UCBPlayer,122,347,469,32,21,UCBPlayer
46618,UCBPlayer,107,132,239,0,87,UCBPlayer
46619,UCBPlayer,132,337,469,35,22,UCBPlayer
46620,UCBPlayer,103,148,251,0,83,UCBPlayer
46621,UCBPlayer,136,321,457,35,26,UCBPlayer
46622,UCBPlayer,99,164,263,0,79,UCBPlayer
46623,UCBPlayer,140,305,445,35,30,UCBPlayer
46624,UCBPlayer,95,180,275,0,75,UCBPlayer
46625,UCBPlayer,144,289,433,35,34,UCBPlayer
46626,UCBPlayer,91,196,287,0,71,UCBPlayer
46627,UCBPlayer,148,273,421,35,38,UCBPlayer
46628,UCBPlayer,87,212,299,0,67,UCBPlayer
46629,UCBPlayer,152,257,409,35,42,UCBPlayer
46630,UCBPlayer,84,224,308,0,64,UCBPlayer
46631,UCBPlayer,146,251,397,32,45,UCBPlayer
46632,UCBPlayer,89,234,323,3,60,UCBPlayer
46633,UCBPlayer,138,243,381,28,49,UCBPlayer
46634,UCBPlayer,97,242,339,7,56,UCBPlayer
46635,UCBPlayer,130,235,365,24,53,UCBPlayer
46636,UCBPlayer,105,250,355,11,52,UCBPlayer
46637,UCBPlayer,122,227,349,20,57,UCBPlayer
46638,UCBPlayer,109,259,368,15,49,UCBPlayer
46639,UCBPlayer,118,218,336,16,60,UCBPlayer
46640,UCBPlayer,117,267,384,19,45,UCBPlayer
46641,UCBPlayer,110,210,320,12,64,UCBPlayer
46642,UCBPlayer,126,271,397,23,42,UCBPlayer
46643,UCBPlayer,105,210,315,10,65,UCBPlayer
46644,UCBPlayer,130,275,405,25,40,UCBPlayer
46645,UCBPlayer,105,210,315,10,65,UCBPlayer
46646,UCBPlayer,130,275,405,25,40,UCBPlayer
46647,UCBPlayer,106,206,312,10,66,UCBPlayer
46648,UCBPlayer,130,275,405,25,40,UCBPlayer
46649,UCBPlayer,105,210,315,10,65,UCBPlayer
46650,UCBPlayer,131,271,402,25,41,UCBPlayer
46651,UCBPlayer,105,210,315,10,65,UCBPlayer
46652,UCBPlayer,130,275,405,25,40,UCBPlayer
46653,UCBPlayer,105,210,315,10,65,UCBPlayer
46654,UCBPlayer,130,275,405,25,40,UCBPlayer
46655,UCBPlayer,103,203,306,10,68,UCBPlayer
46656,UCBPlayer,128,283,411,25,38,UCBPlayer
46657,UCBPlayer,111,186,297,10,71,UCBPlayer
46658,UCBPlayer,124,299,423,25,34,UCBPlayer
46659,UCBPlayer,115,170,285,10,75,UCBPlayer
46660,UCBPlayer,120,315,435,25,30,UCBPlayer
46661,UCBPlayer,119,154,273,10,79,UCBPlayer
46662,UCBPlayer,112,332,444,25,27,UCBPlayer
46663,UCBPlayer,127,137,264,10,82,UCBPlayer
46664,UCBPlayer,104,349,453,25,24,UCBPlayer
46665,UCBPlayer,126,126,252,7,85,Tie
46666,UCBPlayer,111,351,462,28,22,UCBPlayer
46667,UCBPlayer,116,126,242,3,87,UCBPlayer
46668,UCBPlayer,122,347,469,32,21,UCBPlayer
46669,UCBPlayer,107,132,239,0,87,UCBPlayer
46670,UCBPlayer,132,337,469,35,22,UCBPlayer
46671,UCBPlayer,103,148,251,0,83,UCBPlayer
46672,UCBPlayer,136,321,457,35,26,UCBPlayer
46673,UCBPlayer,99,164,263,0,79,UCBPlayer
46674,UCBPlayer,140,305,445,35,30,UCBPlayer
46675,UCBPlayer,95,180,275,0,75,UCBPlayer
46676,UCBPlayer,144,289,433,35,34,UCBPlayer
46677,UCBPlayer,91,196,287,0,71,UCBPlayer
46678,UCBPlayer,148,273,421,35,38,UCBPlayer
46679,UCBPlayer,87,212,299,0,67,UCBPlayer
46680,UCBPlayer,152,257,409,35,42,UCBPlayer
46681,UCBPlayer,84,224,308,0,64,UCBPlayer
46682,UCBPlayer,146,251,397,32,45,UCBPlayer
46683,UCBPlayer,89,234,323,3,60,UCBPlayer
46684,UCBPlayer,138,243,381,28,49,UCBPlayer
46685,UCBPlayer,97,242,339,7,56,UCBPlayer
46686,UCBPlayer,130,235,365,24,53,UCBPlayer
46687,UCBPlayer,105,250,355,11,52,UCBPlayer
46688,UCBPlayer,122,227,349,20,57,UCBPlayer
46689,UCBPlayer,109,259,368,15,49,UCBPlayer
46690,UCBPlayer,118,218,336,16,60,UCBPlayer
46691,UCBPlayer,117,267,384,19,45,UCBPlayer
46692,UCBPlayer,110,210,320,12,64,UCBPlayer
46693,UCBPlayer,126,271,397,23,42,UCBPlayer
46694,UCBPlayer,105,210,315,10,65,UCBPlayer
46695,UCBPlayer,130,275,405,25,40,UCBPlayer
46696,UCBPlayer,105,210,315,10,65,UCBPlayer
46697,UCBPlayer,130,275,405,25,40,UCBPlayer
46698,UCBPlayer,106,206,312,10,66,UCBPlayer
46699,UCBPlayer,130,275,405,25,40,UCBPlayer
46700,UCBPlayer,105,210,315,10,65,UCBPlayer
46701,UCBPlayer,131,271,402,25,41,UCBPlayer
46702,UCBPlayer,105,210,315,10,65,UCBPlayer
46703,UCBPlayer,130,275,405,25,40,UCBPlayer
46704,UCBPlayer,105,210,315,10,65,UCBPlayer
46705,UCBPlayer,130,275,405,25,40,UCBPlayer
46706,UCBPlayer,103,203,306,10,68,UCBPlayer
46707,UCBPlayer,128,283,411,25,38,UCBPlayer
46708,UCBPlayer,111,186,297,10,71,UCBPlayer
46709,UCBPlayer,124,299,423,25,34,UCBPlayer
46710,UCBPlayer,115,170,285,10,75,UCBPlayer
46711,UCBPlayer,120,315,435,25,30,UCBPlayer
46712,UCBPlayer,119,154,273,10,79,UCBPlayer
46713,UCBPlayer,112,332,444,25,27,UCBPlayer
46714,UCBPlayer,127,137,264,10,82,UCBPlayer
46715,UCBPlayer,104,349,453,25,24,UCBPlayer
46716,UCBPlayer,126,126,252,7,85,Tie
46717,UCBPlayer,111,351,462,28,22,UCBPlayer
46718,UCBPlayer,116,126,242,3,87,UCBPlayer
46719,UCBPlayer,122,347,469,32,21,UCBPlayer
46720,UCBPlayer,107,132,239,0,87,UCBPlayer
46721,UCBPlayer,132,337,469,35,22,UCBPlayer
46722,UCBPlayer,103,148,251,0,83,UCBPlayer
46723,UCBPlayer,136,321,457,35,26,UCBPlayer
46724,UCBPlayer,99,164,263,0,79,UCBPlayer
46725,UCBPlayer,140,305,445,35,30,UCBPlayer
46726,UCBPlayer,95,180,275,0,75,UCBPlayer
46727,UCBPlayer,144,289,433,35,34,UCBPlayer
46728,UCBPlayer,91,196,287,0,71,UCBPlayer
46729,UCBPlayer,148,273,421,35,38,UCBPlayer
46730,UCBPlayer,87,212,299,0,67,UCBPlayer
46731,UCBPlayer,152,257,409,35,42,UCBPlayer
46732,UCBPlayer,84,224,308,0,64,UCBPlayer
46733,UCBPlayer,146,251,397,32,45,UCBPlayer
46734,UCBPlayer,89,234,323,3,60,UCBPlayer
46735,UCBPlayer,138,243,381,28,49,UCBPlayer
46736,UCBPlayer,97,242,339,7,56,UCBPlayer
46737,UCBPlayer,130,235,365,24,53,UCBPlayer
46738,UCBPlayer,105,250,355,11,52,UCBPlayer
46739,UCBPlayer,122,227,349,20,57,UCBPlayer
46740,UCBPlayer,109,259,368,15,49,UCBPlayer
46741,UCBPlayer,118,218,336,16,60,UCBPlayer
46742,UCBPlayer,117,267,384,19,45,UCBPlayer
46743,UCBPlayer,110,210,320,12,64,UCBPlayer
46744,UCBPlayer,126,271,397,23,42,UCBPlayer
46745,UCBPlayer,105,210,315,10,65,UCBPlayer
46746,UCBPlayer,130,275,405,25,40,UCBPlayer
46747,UCBPlayer,105,210,315,10,65,UCBPlayer
46748,UCBPlayer,130,275,405,25,40,UCBPlayer
46749,UCBPlayer,106,206,312,10,66,UCBPlayer
46750,UCBPlayer,130,275,405,25,40,UCBPlayer
46751,UCBPlayer,105,210,315,10,65,UCBPlayer
46752,UCBPlayer,131,271,402,25,41,UCBPlayer
46753,UCBPlayer,105,210,315,10,65,UCBPlayer
46754,UCBPlayer,130,275,405,25,40,UCBPlayer
46755,UCBPlayer,105,210,315,10,65,UCBPlayer
46756,UCBPlayer,130,275,405,25,40,UCBPlayer
46757,UCBPlayer,103,203,306,10,68,UCBPlayer
46758,UCBPlayer,128,283,411,25,38,UCBPlayer
46759,UCBPlayer,111,186,297,10,71,UCBPlayer
46760,UCBPlayer,124,299,423,25,34,UCBPlayer
46761,UCBPlayer,115,170,285,10,75,UCBPlayer
46762,UCBPlayer,120,315,435,25,30,UCBPlayer
46763,UCBPlayer,119,154,273,10,79,UCBPlayer
46764,UCBPlayer,112,332,444,25,27,UCBPlayer
46765,UCBPlayer,127,137,264,10,82,UCBPlayer
46766,UCBPlayer,104,349,453,25,24,UCBPlayer
46767,UCBPlayer,126,126,252,7,85,Tie
46768,UCBPlayer,111,351,462,28,22,UCBPlayer
46769,UCBPlayer,116,126,242,3,87,UCBPlayer
46770,UCBPlayer,122,347,469,32,21,UCBPlayer
46771,UCBPlayer,107,132,239,0,87,UCBPlayer
46772,UCBPlayer,132,337,469,35,22,UCBPlayer
46773,UCBPlayer,103,148,251,0,83,UCBPlayer
46774,UCBPlayer,136,321,457,35,26,UCBPlayer
46775,UCBPlayer,99,164,263,0,79,UCBPlayer
46776,UCBPlayer,140,305,445,35,30,UCBPlayer
46777,UCBPlayer,95,180,275,0,75,UCBPlayer
46778,UCBPlayer,144,289,433,35,34,UCBPlayer
46779,UCBPlayer,91,196,287,0,71,UCBPlayer
46780,UCBPlayer,148,273,421,35,38,UCBPlayer
46781,UCBPlayer,87,212,299,0,67,UCBPlayer
46782,UCBPlayer,152,257,409,35,42,UCBPlayer
46783,UCBPlayer,84,224,308,0,64,UCBPlayer
46784,UCBPlayer,146,251,397,32,45,UCBPlayer
46785,UCBPlayer,89,234,323,3,60,UCBPlayer
46786,UCBPlayer,138,243,381,28,49,UCBPlayer
46787,UCBPlayer,97,242,339,7,56,UCBPlayer
46788,UCBPlayer,130,235,365,24,53,UCBPlayer
46789,UCBPlayer,105,250,355,11,52,UCBPlayer
46790,UCBPlayer,122,227,349,20,57,UCBPlayer
46791,UCBPlayer,109,259,368,15,49,UCBPlayer
46792,UCBPlayer,118,218,336,16,60,UCBPlayer
46793,UCBPlayer,117,267,384,19,45,UCBPlayer
46794,UCBPlayer,110,210,320,12,64,UCBPlayer
46795,UCBPlayer,126,271,397,23,42,UCBPlayer
46796,UCBPlayer,105,210,315,10,65,UCBPlayer
46797,UCBPlayer,130,275,405,25,40,UCBPlayer
46798,UCBPlayer,105,210,315,10,65,UCBPlayer
46799,UCBPlayer,130,275,405,25,40,UCBPlayer
46800,UCBPlayer,106,206,312,10,66,UCBPlayer
46801,UCBPlayer,130,275,405,25,40,UCBPlayer
46802,UCBPlayer,105,210,315,10,65,UCBPlayer
46803,UCBPlayer,131,271,402,25,41,UCBPlayer
46804,UCBPlayer,105,210,315,10,65,UCBPlayer
46805,UCBPlayer,130,275,405,25,40,UCBPlayer
46806,UCBPlayer,105,210,315,10,65,UCBPlayer
46807,UCBPlayer,130,275,405,25,40,UCBPlayer
46808,UCBPlayer,103,203,306,10,68,UCBPlayer
46809,UCBPlayer,128,283,411,25,38,UCBPlayer
46810,UCBPlayer,111,186,297,10,71,UCBPlayer
46811,UCBPlayer,124,299,423,25,34,UCBPlayer
46812,UCBPlayer,115,170,285,10,75,UCBPlayer
46813,UCBPlayer,120,315,435,25,30,UCBPlayer
46814,UCBPlayer,119,154,273,10,79,UCBPlayer
46815,UCBPlayer,112,332,444,25,27,UCBPlayer
46816,UCBPlayer,127,137,264,10,82,UCBPlayer
46817,UCBPlayer,104,349,453,25,24,UCBPlayer
46818,UCBPlayer,126,126,252,7,85,Tie
46819,UCBPlayer,111,351,462,28,22,UCBPlayer
46820,UCBPlayer,116,126,242,3,87,UCBPlayer
46821,UCBPlayer,122,347,469,32,21,UCBPlayer
46822,UCBPlayer,107,132,239,0,87,UCBPlayer
46823,UCBPlayer,132,337,469,35,22,UCBPlayer
46824,UCBPlayer,103,148,251,0,83,UCBPlayer
46825,UCBPlayer,136,321,457,35,26,UCBPlayer
46826,UCBPlayer,99,164,263,0,79,UCBPlayer
46827,UCBPlayer,140,305,445,35,30,UCBPlayer
46828,UCBPlayer,95,180,275,0,75,UCBPlayer
46829,UCBPlayer,144,289,433,35,34,UCBPlayer
46830,UCBPlayer,91,196,287,0,71,UCBPlayer
46831,UCBPlayer,148,273,421,35,38,UCBPlayer
46832,UCBPlayer,87,212,299,0,67,UCBPlayer
46833,UCBPlayer,152,257,409,35,42,UCBPlayer
46834,UCBPlayer,84,224,308,0,64,UCBPlayer
46835,UCBPlayer,146,251,397,32,45,UCBPlayer
46836,UCBPlayer,89,234,323,3,60,UCBPlayer
46837,UCBPlayer,138,243,381,28,49,UCBPlayer
46838,UCBPlayer,97,242,339,7,56,UCBPlayer
46839,UCBPlayer,130,235,365,24,53,UCBPlayer
46840,UCBPlayer,105,250,355,11,52,UCBPlayer
46841,UCBPlayer,122,227,349,20,57,UCBPlayer
46842,UCBPlayer,109,259,368,15,49,UCBPlayer
46843,UCBPlayer,118,218,336,16,60,UCBPlayer
46844,UCBPlayer,117,267,384,19,45,UCBPlayer
46845,UCBPlayer,110,210,320,12,64,UCBPlayer
46846,UCBPlayer,126,271,397,23,42,UCBPlayer
46847,UCBPlayer,105,210,315,10,65,UCBPlayer
46848,UCBPlayer,130,275,405,25,40,UCBPlayer
46849,UCBPlayer,105,210,315,10,65,UCBPlayer
46850,UCBPlayer,130,275,405,25,40,UCBPlayer
46851,UCBPlayer,106,206,312,10,66,UCBPlayer
46852,UCBPlayer,130,275,405,25,40,UCBPlayer
46853,UCBPlayer,105,210,315,10,65,UCBPlayer
46854,UCBPlayer,131,271,402,25,41,UCBPlayer
46855,UCBPlayer,105,210,315,10,65,UCBPlayer
46856,UCBPlayer,130,275,405,25,40,UCBPlayer
46857,UCBPlayer,105,210,315,10,65,UCBPlayer
46858,UCBPlayer,130,275,405,25,40,UCBPlayer
46859,UCBPlayer,103,203,306,10,68,UCBPlayer
46860,UCBPlayer,128,283,411,25,38,UCBPlayer
46861,UCBPlayer,111,186,297,10,71,UCBPlayer
46862,UCBPlayer,124,299,423,25,34,UCBPlayer
46863,UCBPlayer,115,170,285,10,75,UCBPlayer
46864,UCBPlayer,120,315,435,25,30,UCBPlayer
46865,UCBPlayer,119,154,273,10,79,UCBPlayer
46866,UCBPlayer,112,332,444,25,27,UCBPlayer
46867,UCBPlayer,127,137,264,10,82,UCBPlayer
46868,UCBPlayer,104,349,453,25,24,UCBPlayer
46869,UCBPlayer,126,126,252,7,85,Tie
46870,UCBPlayer,111,351,462,28,22,UCBPlayer
46871,UCBPlayer,116,126,242,3,87,UCBPlayer
46872,UCBPlayer,122,347,469,32,21,UCBPlayer
46873,UCBPlayer,107,132,239,0,87,UCBPlayer
46874,UCBPlayer,132,337,469,35,22,UCBPlayer
46875,UCBPlayer,103,148,251,0,83,UCBPlayer
46876,UCBPlayer,136,321,457,35,26,UCBPlayer
46877,UCBPlayer,99,164,263,0,79,UCBPlayer
46878,UCBPlayer,140,305,445,35,30,UCBPlayer
46879,UCBPlayer,95,180,275,0,75,UCBPlayer
46880,UCBPlayer,144,289,433,35,34,UCBPlayer
46881,UCBPlayer,91,196,287,0,71,UCBPlayer
46882,UCBPlayer,148,273,421,35,38,UCBPlayer
46883,UCBPlayer,87,212,299,0,67,UCBPlayer
46884,UCBPlayer,152,257,409,35,42,UCBPlayer
46885,UCBPlayer,84,224,308,0,64,UCBPlayer
46886,UCBPlayer,146,251,397,32,45,UCBPlayer
46887,UCBPlayer,89,234,323,3,60,UCBPlayer
46888,UCBPlayer,138,243,381,28,49,UCBPlayer
46889,UCBPlayer,97,242,339,7,56,UCBPlayer
46890,UCBPlayer,130,235,365,24,53,UCBPlayer
46891,UCBPlayer,105,250,355,11,52,UCBPlayer
46892,UCBPlayer,122,227,349,20,57,UCBPlayer
46893,UCBPlayer,109,259,368,15,49,UCBPlayer
46894,UCBPlayer,118,218,336,16,60,UCBPlayer
46895,UCBPlayer,117,267,384,19,45,UCBPlayer
46896,UCBPlayer,110,210,320,12,64,UCBPlayer
46897,UCBPlayer,126,271,397,23,42,UCBPlayer
46898,UCBPlayer,105,210,315,10,65,UCBPlayer
46899,UCBPlayer,130,275,405,25,40,UCBPlayer
46900,UCBPlayer,105,210,315,10,65,UCBPlayer
46901,UCBPlayer,130,275,405,25,40,UCBPlayer
46902,UCBPlayer,106,206,312,10,66,UCBPlayer
46903,UCBPlayer,130,275,405,25,40,UCBPlayer
46904,UCBPlayer,105,210,315,10,65,UCBPlayer
46905,UCBPlayer,131,271,402,25,41,UCBPlayer
46906,UCBPlayer,105,210,315,10,65,UCBPlayer
46907,UCBPlayer,130,275,405,25,40,UCBPlayer
46908,UCBPlayer,105,210,315,10,65,UCBPlayer
46909,UCBPlayer,130,275,405,25,40,UCBPlayer
46910,UCBPlayer,103,203,306,10,68,UCBPlayer
46911,UCBPlayer,128,283,411,25,38,UCBPlayer
46912,UCBPlayer,111,186,297,10,71,UCBPlayer
46913,UCBPlayer,124,299,423,25,34,UCBPlayer
46914,UCBPlayer,115,170,285,10,75,UCBPlayer
46915,UCBPlayer,120,315,435,25,30,UCBPlayer
46916,UCBPlayer,119,154,273,10,79,UCBPlayer
46917,UCBPlayer,112,332,444,25,27,UCBPlayer
46918,UCBPlayer,127,137,264,10,82,UCBPlayer
46919,UCBPlayer,104,349,453,25,24,UCBPlayer
46920,UCBPlayer,126,126,252,7,85,Tie
46921,UCBPlayer,111,351,462,28,22,UCBPlayer
46922,UCBPlayer,116,126,242,3,87,UCBPlayer
46923,UCBPlayer,122,347,469,32,21,UCBPlayer
46924,UCBPlayer,107,132,239,0,87,UCBPlayer
46925,UCBPlayer,132,337,469,35,22,UCBPlayer
46926,UCBPlayer,103,148,251,0,83,UCBPlayer
46927,UCBPlayer,136,321,457,35,26,UCBPlayer
46928,UCBPlayer,99,164,263,0,79,UCBPlayer
46929,UCBPlayer,140,305,445,35,30,UCBPlayer
46930,UCBPlayer,95,180,275,0,75,UCBPlayer
46931,UCBPlayer,144,289,433,35,34,UCBPlayer
46932,UCBPlayer,91,196,287,0,71,UCBPlayer
46933,UCBPlayer,148,273,421,35,38,UCBPlayer
46934,UCBPlayer,87,212,299,0,67,UCBPlayer
46935,UCBPlayer,152,257,409,35,42,UCBPlayer
46936,UCBPlayer,84,224,308,0,64,UCBPlayer
46937,UCBPlayer,146,251,397,32,45,UCBPlayer
46938,UCBPlayer,89,234,323,3,60,UCBPlayer
46939,UCBPlayer,138,243,381,28,49,UCBPlayer
46940,UCBPlayer,97,242,339,7,56,UCBPlayer
46941,UCBPlayer,130,235,365,24,53,UCBPlayer
46942,UCBPlayer,105,250,355,11,52,UCBPlayer
46943,UCBPlayer,122,227,349,20,57,UCBPlayer
46944,UCBPlayer,109,259,368,15,49,UCBPlayer
46945,UCBPlayer,118,218,336,16,60,UCBPlayer
46946,UCBPlayer,117,267,384,19,45,UCBPlayer
46947,UCBPlayer,110,210,320,12,64,UCBPlayer
46948,UCBPlayer,126,271,397,23,42,UCBPlayer
46949,UCBPlayer,105,210,315,10,65,UCBPlayer
46950,UCBPlayer,130,275,405,25,40,UCBPlayer
46951,UCBPlayer,105,210,315,10,65,UCBPlayer
46952,UCBPlayer,130,275,405,25,40,UCBPlayer
46953,UCBPlayer,106,206,312,10,66,UCBPlayer
46954,UCBPlayer,130,275,405,25,40,UCBPlayer
46955,UCBPlayer,105,210,315,10,65,UCBPlayer
46956,UCBPlayer,131,271,402,25,41,UCBPlayer
46957,UCBPlayer,105,210,315,10,65,UCBPlayer
46958,UCBPlayer,130,275,405,25,40,UCBPlayer
46959,UCBPlayer,105,210,315,10,65,UCBPlayer
46960,UCBPlayer,130,275,405,25,40,UCBPlayer
46961,UCBPlayer,103,203,306,10,68,UCBPlayer
46962,UCBPlayer,128,283,411,25,38,UCBPlayer
46963,UCBPlayer,111,186,297,10,71,UCBPlayer
46964,UCBPlayer,124,299,423,25,34,UCBPlayer
46965,UCBPlayer,115,170,285,10,75,UCBPlayer
46966,UCBPlayer,120,315,435,25,30,UCBPlayer
46967,UCBPlayer,119,154,273,10,79,UCBPlayer
46968,UCBPlayer,112,332,444,25,27,UCBPlayer
46969,UCBPlayer,127,137,264,10,82,UCBPlayer
46970,UCBPlayer,104,349,453,25,24,UCBPlayer
46971,UCBPlayer,126,126,252,7,85,Tie
46972,UCBPlayer,111,351,462,28,22,UCBPlayer
46973,UCBPlayer,116,126,242,3,87,UCBPlayer
46974,UCBPlayer,122,347,469,32,21,UCBPlayer
46975,UCBPlayer,107,132,239,0,87,UCBPlayer
46976,UCBPlayer,132,337,469,35,22,UCBPlayer
46977,UCBPlayer,103,148,251,0,83,UCBPlayer
46978,UCBPlayer,136,321,457,35,26,UCBPlayer
46979,UCBPlayer,99,164,263,0,79,UCBPlayer
46980,UCBPlayer,140,305,445,35,30,UCBPlayer
46981,UCBPlayer,95,180,275,0,75,UCBPlayer
46982,UCBPlayer,144,289,433,35,34,UCBPlayer
46983,UCBPlayer,91,196,287,0,71,UCBPlayer
46984,UCBPlayer,148,273,421,35,38,UCBPlayer
46985,UCBPlayer,87,212,299,0,67,UCBPlayer
46986,UCBPlayer,152,257,409,35,42,UCBPlayer
46987,UCBPlayer,84,224,308,0,64,UCBPlayer
46988,UCBPlayer,146,251,397,32,45,UCBPlayer
46989,UCBPlayer,89,234,323,3,60,UCBPlayer
46990,UCBPlayer,138,243,381,28,49,UCBPlayer
46991,UCBPlayer,97,242,339,7,56,UCBPlayer
46992,UCBPlayer,130,235,365,24,53,UCBPlayer
46993,UCBPlayer,105,250,355,11,52,UCBPlayer
46994,UCBPlayer,122,227,349,20,57,UCBPlayer
46995,UCBPlayer,109,259,368,15,49,UCBPlayer
46996,UCBPlayer,118,218,336,16,60,UCBPlayer
46997,UCBPlayer,117,267,384,19,45,UCBPlayer
46998,UCBPlayer,110,210,320,12,64,UCBPlayer
46999,UCBPlayer,126,271,397,23,42,UCBPlayer
47000,UCBPlayer,105,210,315,10,65,UCBPlayer
47001,UCBPlayer,130,275,405,25,40,UCBPlayer
47002,UCBPlayer,105,210,315,10,65,UCBPlayer
47003,UCBPlayer,130,275,405,25,40,UCBPlayer
47004,UCBPlayer,106,206,312,10,66,UCBPlayer
47005,UCBPlayer,130,275,405,25,40,UCBPlayer
47006,UCBPlayer,105,210,315,10,65,UCBPlayer
47007,UCBPlayer,131,271,402,25,41,UCBPlayer
47008,UCBPlayer,105,210,315,10,65,UCBPlayer
47009,UCBPlayer,130,275,405,25,40,UCBPlayer
47010,UCBPlayer,105,210,315,10,65,UCBPlayer
47011,UCBPlayer,130,275,405,25,40,UCBPlayer
47012,UCBPlayer,103,203,306,10,68,UCBPlayer
47013,UCBPlayer,128,283,411,25,38,UCBPlayer
47014,UCBPlayer,111,186,297,10,71,UCBPlayer
47015,UCBPlayer,124,299,423,25,34,UCBPlayer
47016,UCBPlayer,115,170,285,10,75,UCBPlayer
47017,UCBPlayer,120,315,435,25,30,UCBPlayer
47018,UCBPlayer,119,154,273,10,79,UCBPlayer
47019,UCBPlayer,112,332,444,25,27,UCBPlayer
47020,UCBPlayer,127,137,264,10,82,UCBPlayer
47021,UCBPlayer,104,349,453,25,24,UCBPlayer
47022,UCBPlayer,126,126,252,7,85,Tie
47023,UCBPlayer,111,351,462,28,22,UCBPlayer
47024,UCBPlayer,116,126,242,3,87,UCBPlayer
47025,UCBPlayer,122,347,469,32,21,UCBPlayer
47026,UCBPlayer,107,132,239,0,87,UCBPlayer
47027,UCBPlayer,132,337,469,35,22,UCBPlayer
47028,UCBPlayer,103,148,251,0,83,UCBPlayer
47029,UCBPlayer,136,321,457,35,26,UCBPlayer
47030,UCBPlayer,99,164,263,0,79,UCBPlayer
47031,UCBPlayer,140,305,445,35,30,UCBPlayer
47032,UCBPlayer,95,180,275,0,75,UCBPlayer
47033,UCBPlayer,144,289,433,35,34,UCBPlayer
47034,UCBPlayer,91,196,287,0,71,UCBPlayer
47035,UCBPlayer,148,273,421,35,38,UCBPlayer
47036,UCBPlayer,87,212,299,0,67,UCBPlayer
47037,UCBPlayer,152,257,409,35,42,UCBPlayer
47038,UCBPlayer,84,224,308,0,64,UCBPlayer
47039,UCBPlayer,146,251,397,32,45,UCBPlayer
47040,UCBPlayer,89,234,323,3,60,UCBPlayer
47041,UCBPlayer,138,243,381,28,49,UCBPlayer
47042,UCBPlayer,97,242,339,7,56,UCBPlayer
47043,UCBPlayer,130,235,365,24,53,UCBPlayer
47044,UCBPlayer,105,250,355,11,52,UCBPlayer
47045,UCBPlayer,122,227,349,20,57,UCBPlayer
47046,UCBPlayer,109,259,368,15,49,UCBPlayer
47047,UCBPlayer,118,218,336,16,60,UCBPlayer
47048,UCBPlayer,117,267,384,19,45,UCBPlayer
47049,UCBPlayer,110,210,320,12,64,UCBPlayer
47050,UCBPlayer,126,271,397,23,42,UCBPlayer
47051,UCBPlayer,105,210,315,10,65,UCBPlayer
47052,UCBPlayer,130,275,405,25,40,UCBPlayer
47053,UCBPlayer,105,210,315,10,65,UCBPlayer
47054,UCBPlayer,130,275,405,25,40,UCBPlayer
47055,UCBPlayer,106,206,312,10,66,UCBPlayer
47056,UCBPlayer,130,275,405,25,40,UCBPlayer
47057,UCBPlayer,105,210,315,10,65,UCBPlayer
47058,UCBPlayer,131,271,402,25,41,UCBPlayer
47059,UCBPlayer,105,210,315,10,65,UCBPlayer
47060,UCBPlayer,130,275,405,25,40,UCBPlayer
47061,UCBPlayer,105,210,315,10,65,UCBPlayer
47062,UCBPlayer,130,275,405,25,40,UCBPlayer
47063,UCBPlayer,103,203,306,10,68,UCBPlayer
47064,UCBPlayer,128,283,411,25,38,UCBPlayer
47065,UCBPlayer,111,186,297,10,71,UCBPlayer
47066,UCBPlayer,124,299,423,25,34,UCBPlayer
47067,UCBPlayer,115,170,285,10,75,UCBPlayer
47068,UCBPlayer,120,315,435,25,30,UCBPlayer
47069,UCBPlayer,119,154,273,10,79,UCBPlayer
47070,UCBPlayer,112,332,444,25,27,UCBPlayer
47071,UCBPlayer,127,137,264,10,82,UCBPlayer
47072,UCBPlayer,104,349,453,25,24,UCBPlayer
47073,UCBPlayer,126,126,252,7,85,Tie
47074,UCBPlayer,111,351,462,28,22,UCBPlayer
47075,UCBPlayer,116,126,242,3,87,UCBPlayer
47076,UCBPlayer,122,347,469,32,21,UCBPlayer
47077,UCBPlayer,107,132,239,0,87,UCBPlayer
47078,UCBPlayer,132,337,469,35,22,UCBPlayer
47079,UCBPlayer,103,148,251,0,83,UCBPlayer
47080,UCBPlayer,136,321,457,35,26,UCBPlayer
47081,UCBPlayer,99,164,263,0,79,UCBPlayer
47082,UCBPlayer,140,305,445,35,30,UCBPlayer
47083,UCBPlayer,95,180,275,0,75,UCBPlayer
47084,UCBPlayer,144,289,433,35,34,UCBPlayer
47085,UCBPlayer,91,196,287,0,71,UCBPlayer
47086,UCBPlayer,148,273,421,35,38,UCBPlayer
47087,UCBPlayer,87,212,299,0,67,UCBPlayer
47088,UCBPlayer,152,257,409,35,42,UCBPlayer
47089,UCBPlayer,84,224,308,0,64,UCBPlayer
47090,UCBPlayer,146,251,397,32,45,UCBPlayer
47091,UCBPlayer,89,234,323,3,60,UCBPlayer
47092,UCBPlayer,138,243,381,28,49,UCBPlayer
47093,UCBPlayer,97,242,339,7,56,UCBPlayer
47094,UCBPlayer,130,235,365,24,53,UCBPlayer
47095,UCBPlayer,105,250,355,11,52,UCBPlayer
47096,UCBPlayer,122,227,349,20,57,UCBPlayer
47097,UCBPlayer,109,259,368,15,49,UCBPlayer
47098,UCBPlayer,118,218,336,16,60,UCBPlayer
47099,UCBPlayer,117,267,384,19,45,UCBPlayer
47100,UCBPlayer,110,210,320,12,64,UCBPlayer
47101,UCBPlayer,126,271,397,23,42,UCBPlayer
47102,UCBPlayer,105,210,315,10,65,UCBPlayer
47103,UCBPlayer,130,275,405,25,40,UCBPlayer
47104,UCBPlayer,105,210,315,10,65,UCBPlayer
47105,UCBPlayer,130,275,405,25,40,UCBPlayer
47106,UCBPlayer,106,206,312,10,66,UCBPlayer
47107,UCBPlayer,130,275,405,25,40,UCBPlayer
47108,UCBPlayer,105,210,315,10,65,UCBPlayer
47109,UCBPlayer,131,271,402,25,41,UCBPlayer
47110,UCBPlayer,105,210,315,10,65,UCBPlayer
47111,UCBPlayer,130,275,405,25,40,UCBPlayer
47112,UCBPlayer,105,210,315,10,65,UCBPlayer
47113,UCBPlayer,130,275,405,25,40,UCBPlayer
47114,UCBPlayer,103,203,306,10,68,UCBPlayer
47115,UCBPlayer,128,283,411,25,38,UCBPlayer
47116,UCBPlayer,111,186,297,10,71,UCBPlayer
47117,UCBPlayer,124,299,423,25,34,UCBPlayer
47118,UCBPlayer,115,170,285,10,75,UCBPlayer
47119,UCBPlayer,120,315,435,25,30,UCBPlayer
47120,UCBPlayer,119,154,273,10,79,UCBPlayer
47121,UCBPlayer,112,332,444,25,27,UCBPlayer
47122,UCBPlayer,127,137,264,10,82,UCBPlayer
47123,UCBPlayer,104,349,453,25,24,UCBPlayer
47124,UCBPlayer,126,126,252,7,85,Tie
47125,UCBPlayer,111,351,462,28,22,UCBPlayer
47126,UCBPlayer,116,126,242,3,87,UCBPlayer
47127,UCBPlayer,122,347,469,32,21,UCBPlayer
47128,UCBPlayer,107,132,239,0,87,UCBPlayer
47129,UCBPlayer,132,337,469,35,22,UCBPlayer
47130,UCBPlayer,103,148,251,0,83,UCBPlayer
47131,UCBPlayer,136,321,457,35,26,UCBPlayer
47132,UCBPlayer,99,164,263,0,79,UCBPlayer
47133,UCBPlayer,140,305,445,35,30,UCBPlayer
47134,UCBPlayer,95,180,275,0,75,UCBPlayer
47135,UCBPlayer,144,289,433,35,34,UCBPlayer
47136,UCBPlayer,91,196,287,0,71,UCBPlayer
47137,UCBPlayer,148,273,421,35,38,UCBPlayer
47138,UCBPlayer,87,212,299,0,67,UCBPlayer
47139,UCBPlayer,152,257,409,35,42,UCBPlayer
47140,UCBPlayer,84,224,308,0,64,UCBPlayer
47141,UCBPlayer,146,251,397,32,45,UCBPlayer
47142,UCBPlayer,89,234,323,3,60,UCBPlayer
47143,UCBPlayer,138,243,381,28,49,UCBPlayer
47144,UCBPlayer,97,242,339,7,56,UCBPlayer
47145,UCBPlayer,130,235,365,24,53,UCBPlayer
47146,UCBPlayer,105,250,355,11,52,UCBPlayer
47147,UCBPlayer,122,227,349,20,57,UCBPlayer
47148,UCBPlayer,109,259,368,15,49,UCBPlayer
47149,UCBPlayer,118,218,336,16,60,UCBPlayer
47150,UCBPlayer,117,267,384,19,45,UCBPlayer
47151,UCBPlayer,110,210,320,12,64,UCBPlayer
47152,UCBPlayer,126,271,397,23,42,UCBPlayer
47153,UCBPlayer,105,210,315,10,65,UCBPlayer
47154,UCBPlayer,130,275,405,25,40,UCBPlayer
47155,UCBPlayer,105,210,315,10,65,UCBPlayer
47156,UCBPlayer,130,275,405,25,40,UCBPlayer
47157,UCBPlayer,106,206,312,10,66,UCBPlayer
47158,UCBPlayer,130,275,405,25,40,UCBPlayer
47159,UCBPlayer,105,210,315,10,65,UCBPlayer
47160,UCBPlayer,131,271,402,25,41,UCBPlayer
47161,UCBPlayer,105,210,315,10,65,UCBPlayer
47162,UCBPlayer,130,275,405,25,40,UCBPlayer
47163,UCBPlayer,105,210,315,10,65,UCBPlayer
47164,UCBPlayer,130,275,405,25,40,UCBPlayer
47165,UCBPlayer,103,203,306,10,68,UCBPlayer
47166,UCBPlayer,128,283,411,25,38,UCBPlayer
47167,UCBPlayer,111,186,297,10,71,UCBPlayer
47168,UCBPlayer,124,299,423,25,34,UCBPlayer
47169,UCBPlayer,115,170,285,10,75,UCBPlayer
47170,UCBPlayer,120,315,435,25,30,UCBPlayer
47171,UCBPlayer,119,154,273,10,79,UCBPlayer
47172,UCBPlayer,112,332,444,25,27,UCBPlayer
47173,UCBPlayer,127,137,264,10,82,UCBPlayer
47174,UCBPlayer,104,349,453,25,24,UCBPlayer
47175,UCBPlayer,126,126,252,7,85,Tie
47176,UCBPlayer,111,351,462,28,22,UCBPlayer
47177,UCBPlayer,116,126,242,3,87,UCBPlayer
47178,UCBPlayer,122,347,469,32,21,UCBPlayer
47179,UCBPlayer,107,132,239,0,87,UCBPlayer
47180,UCBPlayer,132,337,469,35,22,UCBPlayer
47181,UCBPlayer,103,148,251,0,83,UCBPlayer
47182,UCBPlayer,136,321,457,35,26,UCBPlayer
47183,UCBPlayer,99,164,263,0,79,UCBPlayer
47184,UCBPlayer,140,305,445,35,30,UCBPlayer
47185,UCBPlayer,95,180,275,0,75,UCBPlayer
47186,UCBPlayer,144,289,433,35,34,UCBPlayer
47187,UCBPlayer,91,196,287,0,71,UCBPlayer
47188,UCBPlayer,148,273,421,35,38,UCBPlayer
47189,UCBPlayer,87,212,299,0,67,UCBPlayer
47190,UCBPlayer,152,257,409,35,42,UCBPlayer
47191,UCBPlayer,84,224,308,0,64,UCBPlayer
47192,UCBPlayer,146,251,397,32,45,UCBPlayer
47193,UCBPlayer,89,234,323,3,60,UCBPlayer
47194,UCBPlayer,138,243,381,28,49,UCBPlayer
47195,UCBPlayer,97,242,339,7,56,UCBPlayer
47196,UCBPlayer,130,235,365,24,53,UCBPlayer
47197,UCBPlayer,105,250,355,11,52,UCBPlayer
47198,UCBPlayer,122,227,349,20,57,UCBPlayer
47199,UCBPlayer,109,259,368,15,49,UCBPlayer
47200,UCBPlayer,118,218,336,16,60,UCBPlayer
47201,UCBPlayer,117,267,384,19,45,UCBPlayer
47202,UCBPlayer,110,210,320,12,64,UCBPlayer
47203,UCBPlayer,126,271,397,23,42,UCBPlayer
47204,UCBPlayer,105,210,315,10,65,UCBPlayer
47205,UCBPlayer,130,275,405,25,40,UCBPlayer
47206,UCBPlayer,105,210,315,10,65,UCBPlayer
47207,UCBPlayer,130,275,405,25,40,UCBPlayer
47208,UCBPlayer,106,206,312,10,66,UCBPlayer
47209,UCBPlayer,130,275,405,25,40,UCBPlayer
47210,UCBPlayer,105,210,315,10,65,UCBPlayer
47211,UCBPlayer,131,271,402,25,41,UCBPlayer
47212,UCBPlayer,105,210,315,10,65,UCBPlayer
47213,UCBPlayer,130,275,405,25,40,UCBPlayer
47214,UCBPlayer,105,210,315,10,65,UCBPlayer
47215,UCBPlayer,130,275,405,25,40,UCBPlayer
47216,UCBPlayer,103,203,306,10,68,UCBPlayer
47217,UCBPlayer,128,283,411,25,38,UCBPlayer
47218,UCBPlayer,111,186,297,10,71,UCBPlayer
47219,UCBPlayer,124,299,423,25,34,UCBPlayer
47220,UCBPlayer,115,170,285,10,75,UCBPlayer
47221,UCBPlayer,120,315,435,25,30,UCBPlayer
47222,UCBPlayer,119,154,273,10,79,UCBPlayer
47223,UCBPlayer,112,332,444,25,27,UCBPlayer
47224,UCBPlayer,127,137,264,10,82,UCBPlayer
47225,UCBPlayer,104,349,453,25,24,UCBPlayer
47226,UCBPlayer,126,126,252,7,85,Tie
47227,UCBPlayer,111,351,462,28,22,UCBPlayer
47228,UCBPlayer,116,126,242,3,87,UCBPlayer
47229,UCBPlayer,122,347,469,32,21,UCBPlayer
47230,UCBPlayer,107,132,239,0,87,UCBPlayer
47231,UCBPlayer,132,337,469,35,22,UCBPlayer
47232,UCBPlayer,103,148,251,0,83,UCBPlayer
47233,UCBPlayer,136,321,457,35,26,UCBPlayer
47234,UCBPlayer,99,164,263,0,79,UCBPlayer
47235,UCBPlayer,140,305,445,35,30,UCBPlayer
47236,UCBPlayer,95,180,275,0,75,UCBPlayer
47237,UCBPlayer,144,289,433,35,34,UCBPlayer
47238,UCBPlayer,91,196,287,0,71,UCBPlayer
47239,UCBPlayer,148,273,421,35,38,UCBPlayer
47240,UCBPlayer,87,212,299,0,67,UCBPlayer
47241,UCBPlayer,152,257,409,35,42,UCBPlayer
47242,UCBPlayer,84,224,308,0,64,UCBPlayer
47243,UCBPlayer,146,251,397,32,45,UCBPlayer
47244,UCBPlayer,89,234,323,3,60,UCBPlayer
47245,UCBPlayer,138,243,381,28,49,UCBPlayer
47246,UCBPlayer,97,242,339,7,56,UCBPlayer
47247,UCBPlayer,130,235,365,24,53,UCBPlayer
47248,UCBPlayer,105,250,355,11,52,UCBPlayer
47249,UCBPlayer,122,227,349,20,57,UCBPlayer
47250,UCBPlayer,109,259,368,15,49,UCBPlayer
47251,UCBPlayer,118,218,336,16,60,UCBPlayer
47252,UCBPlayer,117,267,384,19,45,UCBPlayer
47253,UCBPlayer,110,210,320,12,64,UCBPlayer
47254,UCBPlayer,126,271,397,23,42,UCBPlayer
47255,UCBPlayer,105,210,315,10,65,UCBPlayer
47256,UCBPlayer,130,275,405,25,40,UCBPlayer
47257,UCBPlayer,105,210,315,10,65,UCBPlayer
47258,UCBPlayer,130,275,405,25,40,UCBPlayer
47259,UCBPlayer,106,206,312,10,66,UCBPlayer
47260,UCBPlayer,130,275,405,25,40,UCBPlayer
47261,UCBPlayer,105,210,315,10,65,UCBPlayer
47262,UCBPlayer,131,271,402,25,41,UCBPlayer
47263,UCBPlayer,105,210,315,10,65,UCBPlayer
47264,UCBPlayer,130,275,405,25,40,UCBPlayer
47265,UCBPlayer,105,210,315,10,65,UCBPlayer
47266,UCBPlayer,130,275,405,25,40,UCBPlayer
47267,UCBPlayer,103,203,306,10,68,UCBPlayer
47268,UCBPlayer,128,283,411,25,38,UCBPlayer
47269,UCBPlayer,111,186,297,10,71,UCBPlayer
47270,UCBPlayer,124,299,423,25,34,UCBPlayer
47271,UCBPlayer,115,170,285,10,75,UCBPlayer
47272,UCBPlayer,120,315,435,25,30,UCBPlayer
47273,UCBPlayer,119,154,273,10,79,UCBPlayer
47274,UCBPlayer,112,332,444,25,27,UCBPlayer
47275,UCBPlayer,127,137,264,10,82,UCBPlayer
47276,UCBPlayer,104,349,453,25,24,UCBPlayer
47277,UCBPlayer,126,126,252,7,85,Tie
47278,UCBPlayer,111,351,462,28,22,UCBPlayer
47279,UCBPlayer,116,126,242,3,87,UCBPlayer
47280,UCBPlayer,122,347,469,32,21,UCBPlayer
47281,UCBPlayer,107,132,239,0,87,UCBPlayer
47282,UCBPlayer,132,337,469,35,22,UCBPlayer
47283,UCBPlayer,103,148,251,0,83,UCBPlayer
47284,UCBPlayer,136,321,457,35,26,UCBPlayer
47285,UCBPlayer,99,164,263,0,79,UCBPlayer
47286,UCBPlayer,140,305,445,35,30,UCBPlayer
47287,UCBPlayer,95,180,275,0,75,UCBPlayer
47288,UCBPlayer,144,289,433,35,34,UCBPlayer
47289,UCBPlayer,91,196,287,0,71,UCBPlayer
47290,UCBPlayer,148,273,421,35,38,UCBPlayer
47291,UCBPlayer,87,212,299,0,67,UCBPlayer
47292,UCBPlayer,152,257,409,35,42,UCBPlayer
47293,UCBPlayer,84,224,308,0,64,UCBPlayer
47294,UCBPlayer,146,251,397,32,45,UCBPlayer
47295,UCBPlayer,89,234,323,3,60,UCBPlayer
47296,UCBPlayer,138,243,381,28,49,UCBPlayer
47297,UCBPlayer,97,242,339,7,56,UCBPlayer
47298,UCBPlayer,130,235,365,24,53,UCBPlayer
47299,UCBPlayer,105,250,355,11,52,UCBPlayer
47300,UCBPlayer,122,227,349,20,57,UCBPlayer
47301,UCBPlayer,109,259,368,15,49,UCBPlayer
47302,UCBPlayer,118,218,336,16,60,UCBPlayer
47303,UCBPlayer,117,267,384,19,45,UCBPlayer
47304,UCBPlayer,110,210,320,12,64,UCBPlayer
47305,UCBPlayer,126,271,397,23,42,UCBPlayer
47306,UCBPlayer,105,210,315,10,65,UCBPlayer
47307,UCBPlayer,130,275,405,25,40,UCBPlayer
47308,UCBPlayer,105,210,315,10,65,UCBPlayer
47309,UCBPlayer,130,275,405,25,40,UCBPlayer
47310,UCBPlayer,106,206,312,10,66,UCBPlayer
47311,UCBPlayer,130,275,405,25,40,UCBPlayer
47312,UCBPlayer,105,210,315,10,65,UCBPlayer
47313,UCBPlayer,131,271,402,25,41,UCBPlayer
47314,UCBPlayer,105,210,315,10,65,UCBPlayer
47315,UCBPlayer,130,275,405,25,40,UCBPlayer
47316,UCBPlayer,105,210,315,10,65,UCBPlayer
47317,UCBPlayer,130,275,405,25,40,UCBPlayer
47318,UCBPlayer,103,203,306,10,68,UCBPlayer
47319,UCBPlayer,128,283,411,25,38,UCBPlayer
47320,UCBPlayer,111,186,297,10,71,UCBPlayer
47321,UCBPlayer,124,299,423,25,34,UCBPlayer
47322,UCBPlayer,115,170,285,10,75,UCBPlayer
47323,UCBPlayer,120,315,435,25,30,UCBPlayer
47324,UCBPlayer,119,154,273,10,79,UCBPlayer
47325,UCBPlayer,112,332,444,25,27,UCBPlayer
47326,UCBPlayer,127,137,264,10,82,UCBPlayer
47327,UCBPlayer,104,349,453,25,24,UCBPlayer
47328,UCBPlayer,126,126,252,7,85,Tie
47329,UCBPlayer,111,351,462,28,22,UCBPlayer
47330,UCBPlayer,116,126,242,3,87,UCBPlayer
47331,UCBPlayer,122,347,469,32,21,UCBPlayer
47332,UCBPlayer,107,132,239,0,87,UCBPlayer
47333,UCBPlayer,132,337,469,35,22,UCBPlayer
47334,UCBPlayer,103,148,251,0,83,UCBPlayer
47335,UCBPlayer,136,321,457,35,26,UCBPlayer
47336,UCBPlayer,99,164,263,0,79,UCBPlayer
47337,UCBPlayer,140,305,445,35,30,UCBPlayer
47338,UCBPlayer,95,180,275,0,75,UCBPlayer
47339,UCBPlayer,144,289,433,35,34,UCBPlayer
47340,UCBPlayer,91,196,287,0,71,UCBPlayer
47341,UCBPlayer,148,273,421,35,38,UCBPlayer
47342,UCBPlayer,87,212,299,0,67,UCBPlayer
47343,UCBPlayer,152,257,409,35,42,UCBPlayer
47344,UCBPlayer,84,224,308,0,64,UCBPlayer
47345,UCBPlayer,146,251,397,32,45,UCBPlayer
47346,UCBPlayer,89,234,323,3,60,UCBPlayer
47347,UCBPlayer,138,243,381,28,49,UCBPlayer
47348,UCBPlayer,97,242,339,7,56,UCBPlayer
47349,UCBPlayer,130,235,365,24,53,UCBPlayer
47350,UCBPlayer,105,250,355,11,52,UCBPlayer
47351,UCBPlayer,122,227,349,20,57,UCBPlayer
47352,UCBPlayer,109,259,368,15,49,UCBPlayer
47353,UCBPlayer,118,218,336,16,60,UCBPlayer
47354,UCBPlayer,117,267,384,19,45,UCBPlayer
47355,UCBPlayer,110,210,320,12,64,UCBPlayer
47356,UCBPlayer,126,271,397,23,42,UCBPlayer
47357,UCBPlayer,105,210,315,10,65,UCBPlayer
47358,UCBPlayer,130,275,405,25,40,UCBPlayer
47359,UCBPlayer,105,210,315,10,65,UCBPlayer
47360,UCBPlayer,130,275,405,25,40,UCBPlayer
47361,UCBPlayer,106,206,312,10,66,UCBPlayer
47362,UCBPlayer,130,275,405,25,40,UCBPlayer
47363,UCBPlayer,105,210,315,10,65,UCBPlayer
47364,UCBPlayer,131,271,402,25,41,UCBPlayer
47365,UCBPlayer,105,210,315,10,65,UCBPlayer
47366,UCBPlayer,130,275,405,25,40,UCBPlayer
47367,UCBPlayer,105,210,315,10,65,UCBPlayer
47368,UCBPlayer,130,275,405,25,40,UCBPlayer
47369,UCBPlayer,103,203,306,10,68,UCBPlayer
47370,UCBPlayer,128,283,411,25,38,UCBPlayer
47371,UCBPlayer,111,186,297,10,71,UCBPlayer
47372,UCBPlayer,124,299,423,25,34,UCBPlayer
47373,UCBPlayer,115,170,285,10,75,UCBPlayer
47374,UCBPlayer,120,315,435,25,30,UCBPlayer
47375,UCBPlayer,119,154,273,10,79,UCBPlayer
47376,UCBPlayer,112,332,444,25,27,UCBPlayer
47377,UCBPlayer,127,137,264,10,82,UCBPlayer
47378,UCBPlayer,104,349,453,25,24,UCBPlayer
47379,UCBPlayer,126,126,252,7,85,Tie
47380,UCBPlayer,111,351,462,28,22,UCBPlayer
47381,UCBPlayer,116,126,242,3,87,UCBPlayer
47382,UCBPlayer,122,347,469,32,21,UCBPlayer
47383,UCBPlayer,107,132,239,0,87,UCBPlayer
47384,UCBPlayer,132,337,469,35,22,UCBPlayer
47385,UCBPlayer,103,148,251,0,83,UCBPlayer
47386,UCBPlayer,136,321,457,35,26,UCBPlayer
47387,UCBPlayer,99,164,263,0,79,UCBPlayer
47388,UCBPlayer,140,305,445,35,30,UCBPlayer
47389,UCBPlayer,95,180,275,0,75,UCBPlayer
47390,UCBPlayer,144,289,433,35,34,UCBPlayer
47391,UCBPlayer,91,196,287,0,71,UCBPlayer
47392,UCBPlayer,148,273,421,35,38,UCBPlayer
47393,UCBPlayer,87,212,299,0,67,UCBPlayer
47394,UCBPlayer,152,257,409,35,42,UCBPlayer
47395,UCBPlayer,84,224,308,0,64,UCBPlayer
47396,UCBPlayer,146,251,397,32,45,UCBPlayer
47397,UCBPlayer,89,234,323,3,60,UCBPlayer
47398,UCBPlayer,138,243,381,28,49,UCBPlayer
47399,UCBPlayer,97,242,339,7,56,UCBPlayer
47400,UCBPlayer,130,235,365,24,53,UCBPlayer
47401,UCBPlayer,105,250,355,11,52,UCBPlayer
47402,UCBPlayer,122,227,349,20,57,UCBPlayer
47403,UCBPlayer,109,259,368,15,49,UCBPlayer
47404,UCBPlayer,118,218,336,16,60,UCBPlayer
47405,UCBPlayer,117,267,384,19,45,UCBPlayer
47406,UCBPlayer,110,210,320,12,64,UCBPlayer
47407,UCBPlayer,126,271,397,23,42,UCBPlayer
47408,UCBPlayer,105,210,315,10,65,UCBPlayer
47409,UCBPlayer,130,275,405,25,40,UCBPlayer
47410,UCBPlayer,105,210,315,10,65,UCBPlayer
47411,UCBPlayer,130,275,405,25,40,UCBPlayer
47412,UCBPlayer,106,206,312,10,66,UCBPlayer
47413,UCBPlayer,130,275,405,25,40,UCBPlayer
47414,UCBPlayer,105,210,315,10,65,UCBPlayer
47415,UCBPlayer,131,271,402,25,41,UCBPlayer
47416,UCBPlayer,105,210,315,10,65,UCBPlayer
47417,UCBPlayer,130,275,405,25,40,UCBPlayer
47418,UCBPlayer,105,210,315,10,65,UCBPlayer
47419,UCBPlayer,130,275,405,25,40,UCBPlayer
47420,UCBPlayer,103,203,306,10,68,UCBPlayer
47421,UCBPlayer,128,283,411,25,38,UCBPlayer
47422,UCBPlayer,111,186,297,10,71,UCBPlayer
47423,UCBPlayer,124,299,423,25,34,UCBPlayer
47424,UCBPlayer,115,170,285,10,75,UCBPlayer
47425,UCBPlayer,120,315,435,25,30,UCBPlayer
47426,UCBPlayer,119,154,273,10,79,UCBPlayer
47427,UCBPlayer,112,332,444,25,27,UCBPlayer
47428,UCBPlayer,127,137,264,10,82,UCBPlayer
47429,UCBPlayer,104,349,453,25,24,UCBPlayer
47430,UCBPlayer,126,126,252,7,85,Tie
47431,UCBPlayer,111,351,462,28,22,UCBPlayer
47432,UCBPlayer,116,126,242,3,87,UCBPlayer
47433,UCBPlayer,122,347,469,32,21,UCBPlayer
47434,UCBPlayer,107,132,239,0,87,UCBPlayer
47435,UCBPlayer,132,337,469,35,22,UCBPlayer
47436,UCBPlayer,103,148,251,0,83,UCBPlayer
47437,UCBPlayer,136,321,457,35,26,UCBPlayer
47438,UCBPlayer,99,164,263,0,79,UCBPlayer
47439,UCBPlayer,140,305,445,35,30,UCBPlayer
47440,UCBPlayer,95,180,275,0,75,UCBPlayer
47441,UCBPlayer,144,289,433,35,34,UCBPlayer
47442,UCBPlayer,91,196,287,0,71,UCBPlayer
47443,UCBPlayer,148,273,421,35,38,UCBPlayer
47444,UCBPlayer,87,212,299,0,67,UCBPlayer
47445,UCBPlayer,152,257,409,35,42,UCBPlayer
47446,UCBPlayer,84,224,308,0,64,UCBPlayer
47447,UCBPlayer,146,251,397,32,45,UCBPlayer
47448,UCBPlayer,89,234,323,3,60,UCBPlayer
47449,UCBPlayer,138,243,381,28,49,UCBPlayer
47450,UCBPlayer,97,242,339,7,56,UCBPlayer
47451,UCBPlayer,130,235,365,24,53,UCBPlayer
47452,UCBPlayer,105,250,355,11,52,UCBPlayer
47453,UCBPlayer,122,227,349,20,57,UCBPlayer
47454,UCBPlayer,109,259,368,15,49,UCBPlayer
47455,UCBPlayer,118,218,336,16,60,UCBPlayer
47456,UCBPlayer,117,267,384,19,45,UCBPlayer
47457,UCBPlayer,110,210,320,12,64,UCBPlayer
47458,UCBPlayer,126,271,397,23,42,UCBPlayer
47459,UCBPlayer,105,210,315,10,65,UCBPlayer
47460,UCBPlayer,130,275,405,25,40,UCBPlayer
47461,UCBPlayer,105,210,315,10,65,UCBPlayer
47462,UCBPlayer,130,275,405,25,40,UCBPlayer
47463,UCBPlayer,106,206,312,10,66,UCBPlayer
47464,UCBPlayer,130,275,405,25,40,UCBPlayer
47465,UCBPlayer,105,210,315,10,65,UCBPlayer
47466,UCBPlayer,131,271,402,25,41,UCBPlayer
47467,UCBPlayer,105,210,315,10,65,UCBPlayer
47468,UCBPlayer,130,275,405,25,40,UCBPlayer
47469,UCBPlayer,105,210,315,10,65,UCBPlayer
47470,UCBPlayer,130,275,405,25,40,UCBPlayer
47471,UCBPlayer,103,203,306,10,68,UCBPlayer
47472,UCBPlayer,128,283,411,25,38,UCBPlayer
47473,UCBPlayer,111,186,297,10,71,UCBPlayer
47474,UCBPlayer,124,299,423,25,34,UCBPlayer
47475,UCBPlayer,115,170,285,10,75,UCBPlayer
47476,UCBPlayer,120,315,435,25,30,UCBPlayer
47477,UCBPlayer,119,154,273,10,79,UCBPlayer
47478,UCBPlayer,112,332,444,25,27,UCBPlayer
47479,UCBPlayer,127,137,264,10,82,UCBPlayer
47480,UCBPlayer,104,349,453,25,24,UCBPlayer
47481,UCBPlayer,126,126,252,7,85,Tie
47482,UCBPlayer,111,351,462,28,22,UCBPlayer
47483,UCBPlayer,116,126,242,3,87,UCBPlayer
47484,UCBPlayer,122,347,469,32,21,UCBPlayer
47485,UCBPlayer,107,132,239,0,87,UCBPlayer
47486,UCBPlayer,132,337,469,35,22,UCBPlayer
47487,UCBPlayer,103,148,251,0,83,UCBPlayer
47488,UCBPlayer,136,321,457,35,26,UCBPlayer
47489,UCBPlayer,99,164,263,0,79,UCBPlayer
47490,UCBPlayer,140,305,445,35,30,UCBPlayer
47491,UCBPlayer,95,180,275,0,75,UCBPlayer
47492,UCBPlayer,144,289,433,35,34,UCBPlayer
47493,UCBPlayer,91,196,287,0,71,UCBPlayer
47494,UCBPlayer,148,273,421,35,38,UCBPlayer
47495,UCBPlayer,87,212,299,0,67,UCBPlayer
47496,UCBPlayer,152,257,409,35,42,UCBPlayer
47497,UCBPlayer,84,224,308,0,64,UCBPlayer
47498,UCBPlayer,146,251,397,32,45,UCBPlayer
47499,UCBPlayer,89,234,323,3,60,UCBPlayer
47500,UCBPlayer,138,243,381,28,49,UCBPlayer
47501,UCBPlayer,97,242,339,7,56,UCBPlayer
47502,UCBPlayer,130,235,365,24,53,UCBPlayer
47503,UCBPlayer,105,250,355,11,52,UCBPlayer
47504,UCBPlayer,122,227,349,20,57,UCBPlayer
47505,UCBPlayer,109,259,368,15,49,UCBPlayer
47506,UCBPlayer,118,218,336,16,60,UCBPlayer
47507,UCBPlayer,117,267,384,19,45,UCBPlayer
47508,UCBPlayer,110,210,320,12,64,UCBPlayer
47509,UCBPlayer,126,271,397,23,42,UCBPlayer
47510,UCBPlayer,105,210,315,10,65,UCBPlayer
47511,UCBPlayer,130,275,405,25,40,UCBPlayer
47512,UCBPlayer,105,210,315,10,65,UCBPlayer
47513,UCBPlayer,130,275,405,25,40,UCBPlayer
47514,UCBPlayer,106,206,312,10,66,UCBPlayer
47515,UCBPlayer,130,275,405,25,40,UCBPlayer
47516,UCBPlayer,105,210,315,10,65,UCBPlayer
47517,UCBPlayer,131,271,402,25,41,UCBPlayer
47518,UCBPlayer,105,210,315,10,65,UCBPlayer
47519,UCBPlayer,130,275,405,25,40,UCBPlayer
47520,UCBPlayer,105,210,315,10,65,UCBPlayer
47521,UCBPlayer,130,275,405,25,40,UCBPlayer
47522,UCBPlayer,103,203,306,10,68,UCBPlayer
47523,UCBPlayer,128,283,411,25,38,UCBPlayer
47524,UCBPlayer,111,186,297,10,71,UCBPlayer
47525,UCBPlayer,124,299,423,25,34,UCBPlayer
47526,UCBPlayer,115,170,285,10,75,UCBPlayer
47527,UCBPlayer,120,315,435,25,30,UCBPlayer
47528,UCBPlayer,119,154,273,10,79,UCBPlayer
47529,UCBPlayer,112,332,444,25,27,UCBPlayer
47530,UCBPlayer,127,137,264,10,82,UCBPlayer
47531,UCBPlayer,104,349,453,25,24,UCBPlayer
47532,UCBPlayer,126,126,252,7,85,Tie
47533,UCBPlayer,111,351,462,28,22,UCBPlayer
47534,UCBPlayer,116,126,242,3,87,UCBPlayer
47535,UCBPlayer,122,347,469,32,21,UCBPlayer
47536,UCBPlayer,107,132,239,0,87,UCBPlayer
47537,UCBPlayer,132,337,469,35,22,UCBPlayer
47538,UCBPlayer,103,148,251,0,83,UCBPlayer
47539,UCBPlayer,136,321,457,35,26,UCBPlayer
47540,UCBPlayer,99,164,263,0,79,UCBPlayer
47541,UCBPlayer,140,305,445,35,30,UCBPlayer
47542,UCBPlayer,95,180,275,0,75,UCBPlayer
47543,UCBPlayer,144,289,433,35,34,UCBPlayer
47544,UCBPlayer,91,196,287,0,71,UCBPlayer
47545,UCBPlayer,148,273,421,35,38,UCBPlayer
47546,UCBPlayer,87,212,299,0,67,UCBPlayer
47547,UCBPlayer,152,257,409,35,42,UCBPlayer
47548,UCBPlayer,84,224,308,0,64,UCBPlayer
47549,UCBPlayer,146,251,397,32,45,UCBPlayer
47550,UCBPlayer,89,234,323,3,60,UCBPlayer
47551,UCBPlayer,138,243,381,28,49,UCBPlayer
47552,UCBPlayer,97,242,339,7,56,UCBPlayer
47553,UCBPlayer,130,235,365,24,53,UCBPlayer
47554,UCBPlayer,105,250,355,11,52,UCBPlayer
47555,UCBPlayer,122,227,349,20,57,UCBPlayer
47556,UCBPlayer,109,259,368,15,49,UCBPlayer
47557,UCBPlayer,118,218,336,16,60,UCBPlayer
47558,UCBPlayer,117,267,384,19,45,UCBPlayer
47559,UCBPlayer,110,210,320,12,64,UCBPlayer
47560,UCBPlayer,126,271,397,23,42,UCBPlayer
47561,UCBPlayer,105,210,315,10,65,UCBPlayer
47562,UCBPlayer,130,275,405,25,40,UCBPlayer
47563,UCBPlayer,105,210,315,10,65,UCBPlayer
47564,UCBPlayer,130,275,405,25,40,UCBPlayer
47565,UCBPlayer,106,206,312,10,66,UCBPlayer
47566,UCBPlayer,130,275,405,25,40,UCBPlayer
47567,UCBPlayer,105,210,315,10,65,UCBPlayer
47568,UCBPlayer,131,271,402,25,41,UCBPlayer
47569,UCBPlayer,105,210,315,10,65,UCBPlayer
47570,UCBPlayer,130,275,405,25,40,UCBPlayer
47571,UCBPlayer,105,210,315,10,65,UCBPlayer
47572,UCBPlayer,130,275,405,25,40,UCBPlayer
47573,UCBPlayer,103,203,306,10,68,UCBPlayer
47574,UCBPlayer,128,283,411,25,38,UCBPlayer
47575,UCBPlayer,111,186,297,10,71,UCBPlayer
47576,UCBPlayer,124,299,423,25,34,UCBPlayer
47577,UCBPlayer,115,170,285,10,75,UCBPlayer
47578,UCBPlayer,120,315,435,25,30,UCBPlayer
47579,UCBPlayer,119,154,273,10,79,UCBPlayer
47580,UCBPlayer,112,332,444,25,27,UCBPlayer
47581,UCBPlayer,127,137,264,10,82,UCBPlayer
47582,UCBPlayer,104,349,453,25,24,UCBPlayer
47583,UCBPlayer,126,126,252,7,85,Tie
47584,UCBPlayer,111,351,462,28,22,UCBPlayer
47585,UCBPlayer,116,126,242,3,87,UCBPlayer
47586,UCBPlayer,122,347,469,32,21,UCBPlayer
47587,UCBPlayer,107,132,239,0,87,UCBPlayer
47588,UCBPlayer,132,337,469,35,22,UCBPlayer
47589,UCBPlayer,103,148,251,0,83,UCBPlayer
47590,UCBPlayer,136,321,457,35,26,UCBPlayer
47591,UCBPlayer,99,164,263,0,79,UCBPlayer
47592,UCBPlayer,140,305,445,35,30,UCBPlayer
47593,UCBPlayer,95,180,275,0,75,UCBPlayer
47594,UCBPlayer,144,289,433,35,34,UCBPlayer
47595,UCBPlayer,91,196,287,0,71,UCBPlayer
47596,UCBPlayer,148,273,421,35,38,UCBPlayer
47597,UCBPlayer,87,212,299,0,67,UCBPlayer
47598,UCBPlayer,152,257,409,35,42,UCBPlayer
47599,UCBPlayer,84,224,308,0,64,UCBPlayer
47600,UCBPlayer,146,251,397,32,45,UCBPlayer
47601,UCBPlayer,89,234,323,3,60,UCBPlayer
47602,UCBPlayer,138,243,381,28,49,UCBPlayer
47603,UCBPlayer,97,242,339,7,56,UCBPlayer
47604,UCBPlayer,130,235,365,24,53,UCBPlayer
47605,UCBPlayer,105,250,355,11,52,UCBPlayer
47606,UCBPlayer,122,227,349,20,57,UCBPlayer
47607,UCBPlayer,109,259,368,15,49,UCBPlayer
47608,UCBPlayer,118,218,336,16,60,UCBPlayer
47609,UCBPlayer,117,267,384,19,45,UCBPlayer
47610,UCBPlayer,110,210,320,12,64,UCBPlayer
47611,UCBPlayer,126,271,397,23,42,UCBPlayer
47612,UCBPlayer,105,210,315,10,65,UCBPlayer
47613,UCBPlayer,130,275,405,25,40,UCBPlayer
47614,UCBPlayer,105,210,315,10,65,UCBPlayer
47615,UCBPlayer,130,275,405,25,40,UCBPlayer
47616,UCBPlayer,106,206,312,10,66,UCBPlayer
47617,UCBPlayer,130,275,405,25,40,UCBPlayer
47618,UCBPlayer,105,210,315,10,65,UCBPlayer
47619,UCBPlayer,131,271,402,25,41,UCBPlayer
47620,UCBPlayer,105,210,315,10,65,UCBPlayer
47621,UCBPlayer,130,275,405,25,40,UCBPlayer
47622,UCBPlayer,105,210,315,10,65,UCBPlayer
47623,UCBPlayer,130,275,405,25,40,UCBPlayer
47624,UCBPlayer,103,203,306,10,68,UCBPlayer
47625,UCBPlayer,128,283,411,25,38,UCBPlayer
47626,UCBPlayer,111,186,297,10,71,UCBPlayer
47627,UCBPlayer,124,299,423,25,34,UCBPlayer
47628,UCBPlayer,115,170,285,10,75,UCBPlayer
47629,UCBPlayer,120,315,435,25,30,UCBPlayer
47630,UCBPlayer,119,154,273,10,79,UCBPlayer
47631,UCBPlayer,112,332,444,25,27,UCBPlayer
47632,UCBPlayer,127,137,264,10,82,UCBPlayer
47633,UCBPlayer,104,349,453,25,24,UCBPlayer
47634,UCBPlayer,126,126,252,7,85,Tie
47635,UCBPlayer,111,351,462,28,22,UCBPlayer
47636,UCBPlayer,116,126,242,3,87,UCBPlayer
47637,UCBPlayer,122,347,469,32,21,UCBPlayer
47638,UCBPlayer,107,132,239,0,87,UCBPlayer
47639,UCBPlayer,132,337,469,35,22,UCBPlayer
47640,UCBPlayer,103,148,251,0,83,UCBPlayer
47641,UCBPlayer,136,321,457,35,26,UCBPlayer
47642,UCBPlayer,99,164,263,0,79,UCBPlayer
47643,UCBPlayer,140,305,445,35,30,UCBPlayer
47644,UCBPlayer,95,180,275,0,75,UCBPlayer
47645,UCBPlayer,144,289,433,35,34,UCBPlayer
47646,UCBPlayer,91,196,287,0,71,UCBPlayer
47647,UCBPlayer,148,273,421,35,38,UCBPlayer
47648,UCBPlayer,87,212,299,0,67,UCBPlayer
47649,UCBPlayer,152,257,409,35,42,UCBPlayer
47650,UCBPlayer,84,224,308,0,64,UCBPlayer
47651,UCBPlayer,146,251,397,32,45,UCBPlayer
47652,UCBPlayer,89,234,323,3,60,UCBPlayer
47653,UCBPlayer,138,243,381,28,49,UCBPlayer
47654,UCBPlayer,97,242,339,7,56,UCBPlayer
47655,UCBPlayer,130,235,365,24,53,UCBPlayer
47656,UCBPlayer,105,250,355,11,52,UCBPlayer
47657,UCBPlayer,122,227,349,20,57,UCBPlayer
47658,UCBPlayer,109,259,368,15,49,UCBPlayer
47659,UCBPlayer,118,218,336,16,60,UCBPlayer
47660,UCBPlayer,117,267,384,19,45,UCBPlayer
47661,UCBPlayer,110,210,320,12,64,UCBPlayer
47662,UCBPlayer,126,271,397,23,42,UCBPlayer
47663,UCBPlayer,105,210,315,10,65,UCBPlayer
47664,UCBPlayer,130,275,405,25,40,UCBPlayer
47665,UCBPlayer,105,210,315,10,65,UCBPlayer
47666,UCBPlayer,130,275,405,25,40,UCBPlayer
47667,UCBPlayer,106,206,312,10,66,UCBPlayer
47668,UCBPlayer,130,275,405,25,40,UCBPlayer
47669,UCBPlayer,105,210,315,10,65,UCBPlayer
47670,UCBPlayer,131,271,402,25,41,UCBPlayer
47671,UCBPlayer,105,210,315,10,65,UCBPlayer
47672,UCBPlayer,130,275,405,25,40,UCBPlayer
47673,UCBPlayer,105,210,315,10,65,UCBPlayer
47674,UCBPlayer,130,275,405,25,40,UCBPlayer
47675,UCBPlayer,103,203,306,10,68,UCBPlayer
47676,UCBPlayer,128,283,411,25,38,UCBPlayer
47677,UCBPlayer,111,186,297,10,71,UCBPlayer
47678,UCBPlayer,124,299,423,25,34,UCBPlayer
47679,UCBPlayer,115,170,285,10,75,UCBPlayer
47680,UCBPlayer,120,315,435,25,30,UCBPlayer
47681,UCBPlayer,119,154,273,10,79,UCBPlayer
47682,UCBPlayer,112,332,444,25,27,UCBPlayer
47683,UCBPlayer,127,137,264,10,82,UCBPlayer
47684,UCBPlayer,104,349,453,25,24,UCBPlayer
47685,UCBPlayer,126,126,252,7,85,Tie
47686,UCBPlayer,111,351,462,28,22,UCBPlayer
47687,UCBPlayer,116,126,242,3,87,UCBPlayer
47688,UCBPlayer,122,347,469,32,21,UCBPlayer
47689,UCBPlayer,107,132,239,0,87,UCBPlayer
47690,UCBPlayer,132,337,469,35,22,UCBPlayer
47691,UCBPlayer,103,148,251,0,83,UCBPlayer
47692,UCBPlayer,136,321,457,35,26,UCBPlayer
47693,UCBPlayer,99,164,263,0,79,UCBPlayer
47694,UCBPlayer,140,305,445,35,30,UCBPlayer
47695,UCBPlayer,95,180,275,0,75,UCBPlayer
47696,UCBPlayer,144,289,433,35,34,UCBPlayer
47697,UCBPlayer,91,196,287,0,71,UCBPlayer
47698,UCBPlayer,148,273,421,35,38,UCBPlayer
47699,UCBPlayer,87,212,299,0,67,UCBPlayer
47700,UCBPlayer,152,257,409,35,42,UCBPlayer
47701,UCBPlayer,84,224,308,0,64,UCBPlayer
47702,UCBPlayer,146,251,397,32,45,UCBPlayer
47703,UCBPlayer,89,234,323,3,60,UCBPlayer
47704,UCBPlayer,138,243,381,28,49,UCBPlayer
47705,UCBPlayer,97,242,339,7,56,UCBPlayer
47706,UCBPlayer,130,235,365,24,53,UCBPlayer
47707,UCBPlayer,105,250,355,11,52,UCBPlayer
47708,UCBPlayer,122,227,349,20,57,UCBPlayer
47709,UCBPlayer,109,259,368,15,49,UCBPlayer
47710,UCBPlayer,118,218,336,16,60,UCBPlayer
47711,UCBPlayer,117,267,384,19,45,UCBPlayer
47712,UCBPlayer,110,210,320,12,64,UCBPlayer
47713,UCBPlayer,126,271,397,23,42,UCBPlayer
47714,UCBPlayer,105,210,315,10,65,UCBPlayer
47715,UCBPlayer,130,275,405,25,40,UCBPlayer
47716,UCBPlayer,105,210,315,10,65,UCBPlayer
47717,UCBPlayer,130,275,405,25,40,UCBPlayer
47718,UCBPlayer,106,206,312,10,66,UCBPlayer
47719,UCBPlayer,130,275,405,25,40,UCBPlayer
47720,UCBPlayer,105,210,315,10,65,UCBPlayer
47721,UCBPlayer,131,271,402,25,41,UCBPlayer
47722,UCBPlayer,105,210,315,10,65,UCBPlayer
47723,UCBPlayer,130,275,405,25,40,UCBPlayer
47724,UCBPlayer,105,210,315,10,65,UCBPlayer
47725,UCBPlayer,130,275,405,25,40,UCBPlayer
47726,UCBPlayer,103,203,306,10,68,UCBPlayer
47727,UCBPlayer,128,283,411,25,38,UCBPlayer
47728,UCBPlayer,111,186,297,10,71,UCBPlayer
47729,UCBPlayer,124,299,423,25,34,UCBPlayer
47730,UCBPlayer,115,170,285,10,75,UCBPlayer
47731,UCBPlayer,120,315,435,25,30,UCBPlayer
47732,UCBPlayer,119,154,273,10,79,UCBPlayer
47733,UCBPlayer,112,332,444,25,27,UCBPlayer
47734,UCBPlayer,127,137,264,10,82,UCBPlayer
47735,UCBPlayer,104,349,453,25,24,UCBPlayer
47736,UCBPlayer,126,126,252,7,85,Tie
47737,UCBPlayer,111,351,462,28,22,UCBPlayer
47738,UCBPlayer,116,126,242,3,87,UCBPlayer
47739,UCBPlayer,122,347,469,32,21,UCBPlayer
47740,UCBPlayer,107,132,239,0,87,UCBPlayer
47741,UCBPlayer,132,337,469,35,22,UCBPlayer
47742,UCBPlayer,103,148,251,0,83,UCBPlayer
47743,UCBPlayer,136,321,457,35,26,UCBPlayer
47744,UCBPlayer,99,164,263,0,79,UCBPlayer
47745,UCBPlayer,140,305,445,35,30,UCBPlayer
47746,UCBPlayer,95,180,275,0,75,UCBPlayer
47747,UCBPlayer,144,289,433,35,34,UCBPlayer
47748,UCBPlayer,91,196,287,0,71,UCBPlayer
47749,UCBPlayer,148,273,421,35,38,UCBPlayer
47750,UCBPlayer,87,212,299,0,67,UCBPlayer
47751,UCBPlayer,152,257,409,35,42,UCBPlayer
47752,UCBPlayer,84,224,308,0,64,UCBPlayer
47753,UCBPlayer,146,251,397,32,45,UCBPlayer
47754,UCBPlayer,89,234,323,3,60,UCBPlayer
47755,UCBPlayer,138,243,381,28,49,UCBPlayer
47756,UCBPlayer,97,242,339,7,56,UCBPlayer
47757,UCBPlayer,130,235,365,24,53,UCBPlayer
47758,UCBPlayer,105,250,355,11,52,UCBPlayer
47759,UCBPlayer,122,227,349,20,57,UCBPlayer
47760,UCBPlayer,109,259,368,15,49,UCBPlayer
47761,UCBPlayer,118,218,336,16,60,UCBPlayer
47762,UCBPlayer,117,267,384,19,45,UCBPlayer
47763,UCBPlayer,110,210,320,12,64,UCBPlayer
47764,UCBPlayer,126,271,397,23,42,UCBPlayer
47765,UCBPlayer,105,210,315,10,65,UCBPlayer
47766,UCBPlayer,130,275,405,25,40,UCBPlayer
47767,UCBPlayer,105,210,315,10,65,UCBPlayer
47768,UCBPlayer,130,275,405,25,40,UCBPlayer
47769,UCBPlayer,106,206,312,10,66,UCBPlayer
47770,UCBPlayer,130,275,405,25,40,UCBPlayer
47771,UCBPlayer,105,210,315,10,65,UCBPlayer
47772,UCBPlayer,131,271,402,25,41,UCBPlayer
47773,UCBPlayer,105,210,315,10,65,UCBPlayer
47774,UCBPlayer,130,275,405,25,40,UCBPlayer
47775,UCBPlayer,105,210,315,10,65,UCBPlayer
47776,UCBPlayer,130,275,405,25,40,UCBPlayer
47777,UCBPlayer,103,203,306,10,68,UCBPlayer
47778,UCBPlayer,128,283,411,25,38,UCBPlayer
47779,UCBPlayer,111,186,297,10,71,UCBPlayer
47780,UCBPlayer,124,299,423,25,34,UCBPlayer
47781,UCBPlayer,115,170,285,10,75,UCBPlayer
47782,UCBPlayer,120,315,435,25,30,UCBPlayer
47783,UCBPlayer,119,154,273,10,79,UCBPlayer
47784,UCBPlayer,112,332,444,25,27,UCBPlayer
47785,UCBPlayer,127,137,264,10,82,UCBPlayer
47786,UCBPlayer,104,349,453,25,24,UCBPlayer
47787,UCBPlayer,126,126,252,7,85,Tie
47788,UCBPlayer,111,351,462,28,22,UCBPlayer
47789,UCBPlayer,116,126,242,3,87,UCBPlayer
47790,UCBPlayer,122,347,469,32,21,UCBPlayer
47791,UCBPlayer,107,132,239,0,87,UCBPlayer
47792,UCBPlayer,132,337,469,35,22,UCBPlayer
47793,UCBPlayer,103,148,251,0,83,UCBPlayer
47794,UCBPlayer,136,321,457,35,26,UCBPlayer
47795,UCBPlayer,99,164,263,0,79,UCBPlayer
47796,UCBPlayer,140,305,445,35,30,UCBPlayer
47797,UCBPlayer,95,180,275,0,75,UCBPlayer
47798,UCBPlayer,144,289,433,35,34,UCBPlayer
47799,UCBPlayer,91,196,287,0,71,UCBPlayer
47800,UCBPlayer,148,273,421,35,38,UCBPlayer
47801,UCBPlayer,87,212,299,0,67,UCBPlayer
47802,UCBPlayer,152,257,409,35,42,UCBPlayer
47803,UCBPlayer,84,224,308,0,64,UCBPlayer
47804,UCBPlayer,146,251,397,32,45,UCBPlayer
47805,UCBPlayer,89,234,323,3,60,UCBPlayer
47806,UCBPlayer,138,243,381,28,49,UCBPlayer
47807,UCBPlayer,97,242,339,7,56,UCBPlayer
47808,UCBPlayer,130,235,365,24,53,UCBPlayer
47809,UCBPlayer,105,250,355,11,52,UCBPlayer
47810,UCBPlayer,122,227,349,20,57,UCBPlayer
47811,UCBPlayer,109,259,368,15,49,UCBPlayer
47812,UCBPlayer,118,218,336,16,60,UCBPlayer
47813,UCBPlayer,117,267,384,19,45,UCBPlayer
47814,UCBPlayer,110,210,320,12,64,UCBPlayer
47815,UCBPlayer,126,271,397,23,42,UCBPlayer
47816,UCBPlayer,105,210,315,10,65,UCBPlayer
47817,UCBPlayer,130,275,405,25,40,UCBPlayer
47818,UCBPlayer,105,210,315,10,65,UCBPlayer
47819,UCBPlayer,130,275,405,25,40,UCBPlayer
47820,UCBPlayer,106,206,312,10,66,UCBPlayer
47821,UCBPlayer,130,275,405,25,40,UCBPlayer
47822,UCBPlayer,105,210,315,10,65,UCBPlayer
47823,UCBPlayer,131,271,402,25,41,UCBPlayer
47824,UCBPlayer,105,210,315,10,65,UCBPlayer
47825,UCBPlayer,130,275,405,25,40,UCBPlayer
47826,UCBPlayer,105,210,315,10,65,UCBPlayer
47827,UCBPlayer,130,275,405,25,40,UCBPlayer
47828,UCBPlayer,103,203,306,10,68,UCBPlayer
47829,UCBPlayer,128,283,411,25,38,UCBPlayer
47830,UCBPlayer,111,186,297,10,71,UCBPlayer
47831,UCBPlayer,124,299,423,25,34,UCBPlayer
0,JointPQPlayer,335,80,415,8,31,Player A
1,JointPQPlayer,387,32,419,0,27,Player A
2,JointPQPlayer,340,110,450,19,23,Player A
3,JointPQPlayer,384,44,428,6,26,Player A
4,JointPQPlayer,377,42,419,3,28,Player A
5,JointPQPlayer,369,39,408,1,31,Player A
6,JointPQPlayer,379,34,413,0,29,Player A
7,JointPQPlayer,335,45,380,0,40,Player A
8,JointPQPlayer,312,82,394,8,38,Player A
9,JointPQPlayer,279,229,508,50,14,Player A
10,JointPQPlayer,340,150,490,26,12,Player A
11,JointPQPlayer,357,42,399,1,34,Player A
12,JointPQPlayer,375,35,410,0,30,Player A
13,JointPQPlayer,367,72,439,8,23,Player A
14,JointPQPlayer,370,40,410,3,31,Player A
15,JointPQPlayer,368,43,411,1,30,Player A
16,JointPQPlayer,274,64,338,0,54,Player A
17,JointPQPlayer,363,38,401,0,33,Player A
18,JointPQPlayer,367,37,404,0,32,Player A
19,JointPQPlayer,383,48,431,6,25,Player A
20,JointPQPlayer,393,33,426,1,25,Player A
21,JointPQPlayer,385,35,420,1,27,Player A
22,JointPQPlayer,369,39,408,1,31,Player A
23,JointPQPlayer,375,40,415,2,29,Player A
24,JointPQPlayer,353,43,396,1,35,Player A
25,JointPQPlayer,387,32,419,0,27,Player A
26,JointPQPlayer,399,29,428,0,24,Player A
27,JointPQPlayer,351,41,392,0,36,Player A
28,JointPQPlayer,369,49,418,2,28,Player A
29,JointPQPlayer,342,62,404,6,34,Player A
30,JointPQPlayer,371,36,407,0,31,Player A
31,JointPQPlayer,350,45,395,0,35,Player A
32,JointPQPlayer,367,37,404,0,32,Player A
33,JointPQPlayer,342,77,419,9,30,Player A
34,JointPQPlayer,312,87,399,10,37,Player A
35,JointPQPlayer,392,42,434,6,24,Player A
36,JointPQPlayer,339,64,403,5,34,Player A
37,JointPQPlayer,378,33,411,1,30,Player A
38,JointPQPlayer,377,37,414,1,29,Player A
39,JointPQPlayer,339,54,393,4,37,Player A
40,JointPQPlayer,361,51,412,5,31,Player A
41,JointPQPlayer,342,67,409,5,32,Player A
42,JointPQPlayer,395,35,430,2,24,Player A
43,JointPQPlayer,375,35,410,0,30,Player A
44,JointPQPlayer,314,54,368,0,44,Player A
45,JointPQPlayer,351,41,392,0,36,Player A
46,JointPQPlayer,351,61,412,5,31,Player A
47,JointPQPlayer,371,51,422,3,27,Player A
48,JointPQPlayer,379,34,413,0,29,Player A
49,JointPQPlayer,344,69,413,6,31,Player A
50,JointPQPlayer,399,29,428,0,24,Player A
51,JointPQPlayer,381,46,427,5,26,Player A
52,JointPQPlayer,389,34,423,1,26,Player A
53,JointPQPlayer,358,63,421,5,28,Player A
54,JointPQPlayer,373,43,416,3,29,Player A
55,JointPQPlayer,317,62,379,2,41,Player A
56,JointPQPlayer,315,65,380,3,41,Player A
57,JointPQPlayer,351,51,402,4,34,Player A
58,JointPQPlayer,389,34,423,1,26,Player A
59,JointPQPlayer,349,49,398,3,35,Player A
60,JointPQPlayer,381,41,422,3,27,Player A
61,JointPQPlayer,381,41,422,3,27,Player A
62,JointPQPlayer,389,34,423,1,26,Player A
63,JointPQPlayer,359,49,408,4,32,Player A
64,JointPQPlayer,397,32,429,1,24,Player A
65,JointPQPlayer,377,47,424,5,27,Player A
66,JointPQPlayer,353,58,411,7,32,Player A
67,JointPQPlayer,376,46,422,6,28,Player A
68,JointPQPlayer,390,45,435,7,24,Player A
69,JointPQPlayer,366,46,412,2,30,Player A
70,JointPQPlayer,349,54,403,5,34,Player A
71,JointPQPlayer,279,69,348,1,51,Player A
72,JointPQPlayer,357,42,399,1,34,Player A
73,JointPQPlayer,384,39,423,4,27,Player A
74,JointPQPlayer,329,64,393,4,37,Player A
75,JointPQPlayer,185,90,275,0,75,Player A
76,JointPQPlayer,340,55,395,3,36,Player A
77,JointPQPlayer,317,62,379,2,41,Player A
78,JointPQPlayer,351,41,392,0,36,Player A
79,JointPQPlayer,359,39,398,0,34,Player A
80,JointPQPlayer,348,78,426,7,27,Player A
81,JointPQPlayer,387,37,424,2,26,Player A
82,JointPQPlayer,391,36,427,2,25,Player A
83,JointPQPlayer,394,34,428,3,25,Player A
84,JointPQPlayer,334,59,393,4,37,Player A
85,JointPQPlayer,381,46,427,5,26,Player A
86,JointPQPlayer,355,40,395,0,35,Player A
87,JointPQPlayer,387,32,419,0,27,Player A
88,JointPQPlayer,350,40,390,1,37,Player A
89,JointPQPlayer,327,57,384,1,39,Player A
90,JointPQPlayer,339,44,383,0,39,Player A
91,JointPQPlayer,390,30,420,1,27,Player A
92,JointPQPlayer,365,55,420,7,29,Player A
93,JointPQPlayer,339,44,383,0,39,Player A
94,JointPQPlayer,373,43,416,3,29,Player A
95,JointPQPlayer,369,39,408,1,31,Player A
96,JointPQPlayer,399,34,433,2,23,Player A
97,JointPQPlayer,399,29,428,0,24,Player A
98,JointPQPlayer,351,51,402,1,33,Player A
99,JointPQPlayer,359,39,398,0,34,Player A
100,JointPQPlayer,405,30,435,1,22,Player A
101,JointPQPlayer,379,39,418,2,28,Player A
102,JointPQPlayer,252,72,324,1,59,Player A
103,JointPQPlayer,373,38,411,1,30,Player A
104,JointPQPlayer,343,43,386,0,38,Player A
105,JointPQPlayer,375,40,415,2,29,Player A
106,JointPQPlayer,413,28,441,1,20,Player A
107,JointPQPlayer,329,69,398,3,35,Player A
108,JointPQPlayer,385,35,420,1,27,Player A
109,JointPQPlayer,391,31,422,0,26,Player A
110,JointPQPlayer,315,50,365,0,45,Player A
111,JointPQPlayer,375,35,410,0,30,Player A
112,JointPQPlayer,303,53,356,0,48,Player A
113,JointPQPlayer,381,36,417,1,28,Player A
114,JointPQPlayer,355,60,415,8,31,Player A
115,JointPQPlayer,351,41,392,0,36,Player A
116,JointPQPlayer,385,35,420,1,27,Player A
117,JointPQPlayer,368,48,416,6,30,Player A
118,JointPQPlayer,290,75,365,3,46,Player A
119,JointPQPlayer,387,37,424,2,26,Player A
120,JointPQPlayer,343,43,386,0,38,Player A
121,JointPQPlayer,377,37,414,1,29,Player A
122,JointPQPlayer,364,64,428,6,26,Player A
123,JointPQPlayer,365,40,405,1,32,Player A
124,JointPQPlayer,335,45,380,0,40,Player A
125,JointPQPlayer,385,35,420,1,27,Player A
126,JointPQPlayer,299,134,433,23,30,Player A
127,JointPQPlayer,310,55,365,0,45,Player A
128,JointPQPlayer,377,42,419,3,28,Player A
129,JointPQPlayer,385,35,420,1,27,Player A
130,JointPQPlayer,355,40,395,0,35,Player A
131,JointPQPlayer,342,47,389,3,38,Player A
132,JointPQPlayer,366,41,407,0,31,Player A
133,JointPQPlayer,374,39,413,3,30,Player A
134,JointPQPlayer,337,62,399,4,35,Player A
135,JointPQPlayer,364,59,423,4,27,Player A
136,JointPQPlayer,322,57,379,2,41,Player A
137,JointPQPlayer,384,39,423,4,27,Player A
138,JointPQPlayer,383,38,421,2,27,Player A
139,JointPQPlayer,365,60,425,3,26,Player A
140,JointPQPlayer,394,29,423,1,26,Player A
141,JointPQPlayer,343,58,401,3,34,Player A
142,JointPQPlayer,206,341,547,65,6,JointPQPlayer
143,JointPQPlayer,387,32,419,0,27,Player A
144,JointPQPlayer,368,33,401,0,33,Player A
145,JointPQPlayer,385,35,420,1,27,Player A
146,JointPQPlayer,391,31,422,0,26,Player A
147,JointPQPlayer,373,43,416,3,29,Player A
148,JointPQPlayer,393,33,426,1,25,Player A
149,JointPQPlayer,277,207,484,35,17,Player A
150,JointPQPlayer,351,51,402,4,34,Player A
151,JointPQPlayer,343,43,386,0,38,Player A
152,JointPQPlayer,379,34,413,0,29,Player A
153,JointPQPlayer,357,52,409,5,32,Player A
154,JointPQPlayer,407,32,439,2,21,Player A
155,JointPQPlayer,347,52,399,4,35,Player A
156,JointPQPlayer,387,32,419,0,27,Player A
157,JointPQPlayer,251,211,462,31,23,Player A
158,JointPQPlayer,371,36,407,0,31,Player A
159,JointPQPlayer,302,57,359,0,47,Player A
160,JointPQPlayer,357,42,399,1,34,Player A
161,JointPQPlayer,278,63,341,0,53,Player A
162,JointPQPlayer,317,52,369,1,44,Player A
163,JointPQPlayer,330,110,440,18,26,Player A
164,JointPQPlayer,418,28,446,3,19,Player A
165,JointPQPlayer,371,46,417,4,29,Player A
166,JointPQPlayer,409,29,438,1,21,Player A
167,JointPQPlayer,357,52,409,5,32,Player A
168,JointPQPlayer,377,37,414,1,29,Player A
169,JointPQPlayer,379,49,428,6,26,Player A
170,JointPQPlayer,371,36,407,0,31,Player A
171,JointPQPlayer,280,90,370,14,48,Player A
172,JointPQPlayer,342,57,399,4,35,Player A
173,JointPQPlayer,363,48,411,1,30,Player A
174,JointPQPlayer,327,47,374,0,42,Player A
175,JointPQPlayer,361,41,402,1,33,Player A
176,JointPQPlayer,369,44,413,3,30,Player A
177,JointPQPlayer,327,47,374,0,42,Player A
178,JointPQPlayer,371,36,407,0,31,Player A
179,JointPQPlayer,413,28,441,1,20,Player A
180,JointPQPlayer,335,55,390,1,37,Player A
181,JointPQPlayer,409,29,438,1,21,Player A
182,JointPQPlayer,377,37,414,1,29,Player A
183,JointPQPlayer,373,38,411,1,30,Player A
184,JointPQPlayer,361,66,427,5,26,Player A
185,JointPQPlayer,371,41,412,2,30,Player A
186,JointPQPlayer,397,67,464,9,15,Player A
187,JointPQPlayer,391,41,432,4,24,Player A
188,JointPQPlayer,219,159,378,19,47,Player A
189,JointPQPlayer,322,52,374,0,42,Player A
190,JointPQPlayer,395,30,425,0,25,Player A
191,JointPQPlayer,334,59,393,4,37,Player A
192,JointPQPlayer,323,123,446,12,22,Player A
193,JointPQPlayer,358,43,401,0,33,Player A
194,JointPQPlayer,386,31,417,1,28,Player A
195,JointPQPlayer,383,33,416,0,28,Player A
196,JointPQPlayer,334,59,393,1,36,Player A
197,JointPQPlayer,359,39,398,0,34,Player A
198,JointPQPlayer,396,41,437,6,23,Player A
199,JointPQPlayer,391,31,422,0,26,Player A
200,JointPQPlayer,351,41,392,0,36,Player A
201,JointPQPlayer,216,191,407,18,37,Player A
202,JointPQPlayer,381,36,417,1,28,Player A
203,JointPQPlayer,377,37,414,1,29,Player A
204,JointPQPlayer,389,39,428,3,25,Player A
205,JointPQPlayer,379,39,418,2,28,Player A
206,JointPQPlayer,405,50,455,9,18,Player A
207,JointPQPlayer,373,38,411,1,30,Player A
208,JointPQPlayer,349,49,398,3,35,Player A
209,JointPQPlayer,395,30,425,0,25,Player A
210,JointPQPlayer,265,235,500,48,16,Player A
211,JointPQPlayer,377,52,429,7,26,Player A
212,JointPQPlayer,319,49,368,0,44,Player A
213,JointPQPlayer,401,31,432,1,23,Player A
214,JointPQPlayer,373,43,416,3,29,Player A
215,JointPQPlayer,360,55,415,5,30,Player A
216,JointPQPlayer,364,44,408,1,31,Player A
217,JointPQPlayer,349,44,393,1,36,Player A
218,JointPQPlayer,274,174,448,35,29,Player A
219,JointPQPlayer,373,38,411,1,30,Player A
220,JointPQPlayer,322,132,454,23,23,Player A
221,JointPQPlayer,338,98,436,20,28,Player A
222,JointPQPlayer,359,39,398,0,34,Player A
223,JointPQPlayer,367,47,414,4,30,Player A
224,JointPQPlayer,336,61,397,5,36,Player A
225,JointPQPlayer,361,41,402,1,33,Player A
226,JointPQPlayer,343,43,386,0,38,Player A
227,JointPQPlayer,414,29,443,3,20,Player A
228,JointPQPlayer,387,37,424,2,26,Player A
229,JointPQPlayer,405,30,435,1,22,Player A
230,JointPQPlayer,333,53,386,3,39,Player A
231,JointPQPlayer,363,43,406,2,32,Player A
232,JointPQPlayer,313,63,376,2,42,Player A
233,JointPQPlayer,347,42,389,0,37,Player A
234,JointPQPlayer,409,29,438,1,21,Player A
235,JointPQPlayer,374,39,413,3,30,Player A
236,JointPQPlayer,371,61,432,7,25,Player A
237,JointPQPlayer,384,39,423,4,27,Player A
238,JointPQPlayer,387,47,434,6,24,Player A
239,JointPQPlayer,294,89,383,9,42,Player A
240,JointPQPlayer,349,84,433,5,24,Player A
241,JointPQPlayer,347,57,404,6,34,Player A
242,JointPQPlayer,374,44,418,2,28,Player A
243,JointPQPlayer,370,35,405,1,32,Player A
244,JointPQPlayer,348,48,396,1,35,Player A
245,JointPQPlayer,397,32,429,1,24,Player A
246,JointPQPlayer,328,53,381,1,40,Player A
247,JointPQPlayer,355,80,435,10,25,Player A
248,JointPQPlayer,355,40,395,0,35,Player A
249,JointPQPlayer,369,39,408,1,31,Player A
250,JointPQPlayer,365,50,415,5,30,Player A
251,JointPQPlayer,381,46,427,5,26,Player A
252,JointPQPlayer,340,65,405,4,33,Player A
253,JointPQPlayer,367,37,404,0,32,Player A
254,JointPQPlayer,359,39,398,0,34,Player A
255,JointPQPlayer,395,45,440,6,22,Player A
256,JointPQPlayer,375,35,410,0,30,Player A
257,JointPQPlayer,377,37,414,1,29,Player A
258,JointPQPlayer,365,45,410,3,31,Player A
259,JointPQPlayer,366,51,417,7,30,Player A
260,JointPQPlayer,245,75,320,0,60,Player A
261,JointPQPlayer,387,32,419,0,27,Player A
262,JointPQPlayer,391,31,422,0,26,Player A
263,JointPQPlayer,370,60,430,5,25,Player A
264,JointPQPlayer,375,45,420,1,27,Player A
265,JointPQPlayer,386,46,432,7,25,Player A
266,JointPQPlayer,307,67,374,3,43,Player A
267,JointPQPlayer,373,68,441,7,22,Player A
268,JointPQPlayer,287,67,354,1,49,Player A
269,JointPQPlayer,290,200,490,41,17,Player A
270,JointPQPlayer,282,187,469,35,22,Player A
271,JointPQPlayer,401,31,432,1,23,Player A
272,JointPQPlayer,385,45,430,5,25,Player A
273,JointPQPlayer,340,50,390,1,37,Player A
274,JointPQPlayer,341,86,427,11,28,Player A
275,JointPQPlayer,315,50,365,0,45,Player A
276,JointPQPlayer,345,55,400,2,34,Player A
277,JointPQPlayer,358,93,451,14,21,Player A
278,JointPQPlayer,350,50,400,2,34,Player A
279,JointPQPlayer,391,31,422,0,26,Player A
280,JointPQPlayer,365,40,405,1,32,Player A
281,JointPQPlayer,344,49,393,1,36,Player A
282,JointPQPlayer,390,35,425,3,26,Player A
283,JointPQPlayer,354,59,413,6,31,Player A
284,JointPQPlayer,331,46,377,0,41,Player A
285,JointPQPlayer,246,241,487,47,20,Player A
286,JointPQPlayer,369,49,418,5,29,Player A
287,JointPQPlayer,397,37,434,3,23,Player A
288,JointPQPlayer,404,29,433,2,23,Player A
289,JointPQPlayer,360,50,410,3,31,Player A
290,JointPQPlayer,379,39,418,2,28,Player A
291,JointPQPlayer,373,43,416,3,29,Player A
292,JointPQPlayer,355,40,395,0,35,Player A
293,JointPQPlayer,357,42,399,1,34,Player A
294,JointPQPlayer,367,37,404,0,32,Player A
295,JointPQPlayer,363,38,401,0,33,Player A
296,JointPQPlayer,330,45,375,1,42,Player A
297,JointPQPlayer,346,46,392,0,36,Player A
298,JointPQPlayer,359,39,398,0,34,Player A
299,JointPQPlayer,355,40,395,0,35,Player A
300,JointPQPlayer,391,31,422,0,26,Player A
301,JointPQPlayer,387,32,419,0,27,Player A
302,JointPQPlayer,403,28,431,0,23,Player A
303,JointPQPlayer,379,39,418,2,28,Player A
304,JointPQPlayer,371,36,407,0,31,Player A
305,JointPQPlayer,355,55,410,6,32,Player A
306,JointPQPlayer,375,35,410,0,30,Player A
307,JointPQPlayer,359,39,398,0,34,Player A
308,JointPQPlayer,340,95,435,13,26,Player A
309,JointPQPlayer,359,39,398,0,34,Player A
310,JointPQPlayer,230,75,305,0,65,Player A
311,JointPQPlayer,365,40,405,1,32,Player A
312,JointPQPlayer,403,38,441,4,21,Player A
313,JointPQPlayer,302,167,469,29,20,Player A
314,JointPQPlayer,366,86,452,12,20,Player A
315,JointPQPlayer,353,48,401,3,34,Player A
316,JointPQPlayer,419,24,443,0,19,Player A
317,JointPQPlayer,383,38,421,2,27,Player A
318,JointPQPlayer,375,35,410,0,30,Player A
319,JointPQPlayer,385,35,420,1,27,Player A
320,JointPQPlayer,345,45,390,1,37,Player A
321,JointPQPlayer,397,32,429,1,24,Player A
322,JointPQPlayer,343,43,386,0,38,Player A
323,JointPQPlayer,311,146,457,23,22,Player A
324,JointPQPlayer,399,34,433,2,23,Player A
325,JointPQPlayer,298,83,381,10,43,Player A
326,JointPQPlayer,301,111,412,14,34,Player A
327,JointPQPlayer,365,55,420,7,29,Player A
328,JointPQPlayer,317,87,404,9,35,Player A
329,JointPQPlayer,296,76,372,4,44,Player A
330,JointPQPlayer,378,48,426,7,27,Player A
331,JointPQPlayer,380,45,425,6,27,Player A
332,JointPQPlayer,377,62,439,8,23,Player A
333,JointPQPlayer,397,32,429,1,24,Player A
334,JointPQPlayer,365,40,405,1,32,Player A
335,JointPQPlayer,333,63,396,7,37,Player A
336,JointPQPlayer,387,42,429,1,24,Player A
337,JointPQPlayer,356,46,402,4,34,Player A
338,JointPQPlayer,355,50,405,1,32,Player A
339,JointPQPlayer,389,34,423,1,26,Player A
340,JointPQPlayer,395,35,430,2,24,Player A
341,JointPQPlayer,367,37,404,0,32,Player A
342,JointPQPlayer,406,26,432,1,23,Player A
343,JointPQPlayer,402,37,439,5,22,Player A
344,JointPQPlayer,336,51,387,1,38,Player A
345,JointPQPlayer,355,40,395,0,35,Player A
346,JointPQPlayer,347,42,389,0,37,Player A
347,JointPQPlayer,358,38,396,1,35,Player A
348,JointPQPlayer,395,35,430,2,24,Player A
349,JointPQPlayer,263,123,386,6,40,Player A
350,JointPQPlayer,365,40,405,1,32,Player A
351,JointPQPlayer,393,33,426,1,25,Player A
352,JointPQPlayer,391,31,422,0,26,Player A
353,JointPQPlayer,315,165,480,37,19,Player A
354,JointPQPlayer,372,42,414,1,29,Player A
355,JointPQPlayer,386,46,432,7,25,Player A
356,JointPQPlayer,340,95,435,13,26,Player A
357,JointPQPlayer,337,47,384,1,39,Player A
358,JointPQPlayer,381,36,417,1,28,Player A
359,JointPQPlayer,344,64,408,4,32,Player A
360,JointPQPlayer,325,50,375,1,42,Player A
361,JointPQPlayer,331,61,392,6,38,Player A
362,JointPQPlayer,345,55,400,2,34,Player A
363,JointPQPlayer,375,35,410,0,30,Player A
364,JointPQPlayer,347,42,389,0,37,Player A
365,JointPQPlayer,326,66,392,6,38,Player A
366,JointPQPlayer,351,41,392,0,36,Player A
367,JointPQPlayer,333,48,381,1,40,Player A
368,JointPQPlayer,274,64,338,0,54,Player A
369,JointPQPlayer,377,37,414,1,29,Player A
370,JointPQPlayer,363,43,406,2,32,Player A
371,JointPQPlayer,250,70,320,0,60,Player A
372,JointPQPlayer,365,45,410,3,31,Player A
373,JointPQPlayer,355,40,395,0,35,Player A
374,JointPQPlayer,359,44,403,2,33,Player A
375,JointPQPlayer,296,61,357,1,48,Player A
376,JointPQPlayer,401,31,432,1,23,Player A
377,JointPQPlayer,393,43,436,5,23,Player A
378,JointPQPlayer,401,31,432,1,23,Player A
379,JointPQPlayer,385,40,425,3,26,Player A
380,JointPQPlayer,333,78,411,7,32,Player A
381,JointPQPlayer,329,49,378,1,41,Player A
382,JointPQPlayer,417,27,444,1,19,Player A
383,JointPQPlayer,381,46,427,2,25,Player A
384,JointPQPlayer,321,51,372,1,43,Player A
385,JointPQPlayer,407,27,434,0,22,Player A
386,JointPQPlayer,359,39,398,0,34,Player A
387,JointPQPlayer,371,46,417,1,28,Player A
388,JointPQPlayer,284,84,368,9,47,Player A
389,JointPQPlayer,356,61,417,4,29,Player A
390,JointPQPlayer,369,64,433,11,26,Player A
391,JointPQPlayer,339,54,393,1,36,Player A
392,JointPQPlayer,362,42,404,0,32,Player A
393,JointPQPlayer,359,44,403,2,33,Player A
394,JointPQPlayer,347,42,389,0,37,Player A
395,JointPQPlayer,363,43,406,2,32,Player A
396,JointPQPlayer,359,44,403,2,33,Player A
397,JointPQPlayer,365,40,405,1,32,Player A
398,JointPQPlayer,384,39,423,1,26,Player A
399,JointPQPlayer,392,27,419,0,27,Player A
400,JointPQPlayer,348,58,406,2,32,Player A
401,JointPQPlayer,296,81,377,3,42,Player A
402,JointPQPlayer,399,29,428,0,24,Player A
403,JointPQPlayer,181,291,472,50,26,JointPQPlayer
404,JointPQPlayer,318,93,411,4,31,Player A
405,JointPQPlayer,335,45,380,0,40,Player A
406,JointPQPlayer,347,42,389,0,37,Player A
407,JointPQPlayer,363,43,406,2,32,Player A
408,JointPQPlayer,230,85,315,1,62,Player A
409,JointPQPlayer,331,61,392,3,37,Player A
410,JointPQPlayer,403,28,431,0,23,Player A
411,JointPQPlayer,360,45,405,1,32,Player A
412,JointPQPlayer,355,45,400,2,34,Player A
413,JointPQPlayer,312,162,474,25,17,Player A
414,JointPQPlayer,355,40,395,0,35,Player A
415,JointPQPlayer,340,95,435,13,26,Player A
416,JointPQPlayer,397,37,434,3,23,Player A
417,JointPQPlayer,343,133,476,27,17,Player A
418,JointPQPlayer,407,27,434,0,22,Player A
419,JointPQPlayer,363,38,401,0,33,Player A
420,JointPQPlayer,384,44,428,6,26,Player A
421,JointPQPlayer,385,45,430,5,25,Player A
422,JointPQPlayer,379,44,423,1,26,Player A
423,JointPQPlayer,359,39,398,0,34,Player A
424,JointPQPlayer,343,43,386,0,38,Player A
425,JointPQPlayer,367,42,409,2,31,Player A
426,JointPQPlayer,318,58,376,2,42,Player A
427,JointPQPlayer,390,50,440,3,21,Player A
428,JointPQPlayer,375,35,410,0,30,Player A
429,JointPQPlayer,338,133,471,28,19,Player A
430,JointPQPlayer,385,35,420,1,27,Player A
431,JointPQPlayer,372,42,414,4,30,Player A
432,JointPQPlayer,358,48,406,2,32,Player A
433,JointPQPlayer,302,57,359,0,47,Player A
434,JointPQPlayer,360,45,405,4,33,Player A
435,JointPQPlayer,343,58,401,3,34,Player A
436,JointPQPlayer,387,37,424,2,26,Player A
437,JointPQPlayer,357,72,429,7,26,Player A
438,JointPQPlayer,365,50,415,2,29,Player A
439,JointPQPlayer,409,29,438,1,21,Player A
440,JointPQPlayer,375,35,410,0,30,Player A
441,JointPQPlayer,377,62,439,11,24,Player A
442,JointPQPlayer,346,46,392,0,36,Player A
443,JointPQPlayer,378,33,411,1,30,Player A
444,JointPQPlayer,330,50,380,0,40,Player A
445,JointPQPlayer,365,40,405,1,32,Player A
446,JointPQPlayer,390,40,430,2,24,Player A
447,JointPQPlayer,364,44,408,1,31,Player A
448,JointPQPlayer,389,34,423,1,26,Player A
449,JointPQPlayer,340,50,390,1,37,Player A
450,JointPQPlayer,382,47,429,1,24,Player A
451,JointPQPlayer,294,59,353,0,49,Player A
452,JointPQPlayer,359,39,398,0,34,Player A
453,JointPQPlayer,381,36,417,1,28,Player A
454,JointPQPlayer,310,70,380,3,41,Player A
455,JointPQPlayer,393,38,431,3,24,Player A
456,JointPQPlayer,389,34,423,1,26,Player A
457,JointPQPlayer,398,38,436,5,23,Player A
458,JointPQPlayer,387,37,424,2,26,Player A
459,JointPQPlayer,331,46,377,0,41,Player A
460,JointPQPlayer,379,34,413,0,29,Player A
461,JointPQPlayer,335,55,390,4,38,Player A
462,JointPQPlayer,387,32,419,0,27,Player A
463,JointPQPlayer,340,50,390,1,37,Player A
464,JointPQPlayer,338,83,421,8,29,Player A
465,JointPQPlayer,375,35,410,0,30,Player A
466,JointPQPlayer,218,78,296,0,68,Player A
467,JointPQPlayer,388,48,436,5,23,Player A
468,JointPQPlayer,387,37,424,2,26,Player A
469,JointPQPlayer,254,69,323,0,59,Player A
470,JointPQPlayer,355,40,395,0,35,Player A
471,JointPQPlayer,385,40,425,3,26,Player A
472,JointPQPlayer,379,39,418,2,28,Player A
473,JointPQPlayer,383,33,416,0,28,Player A
474,JointPQPlayer,369,39,408,1,31,Player A
475,JointPQPlayer,337,57,394,2,36,Player A
476,JointPQPlayer,361,41,402,1,33,Player A
477,JointPQPlayer,387,37,424,2,26,Player A
478,JointPQPlayer,392,37,429,4,25,Player A
479,JointPQPlayer,333,58,391,2,37,Player A
480,JointPQPlayer,363,48,411,4,31,Player A
481,JointPQPlayer,361,51,412,5,31,Player A
482,JointPQPlayer,339,79,418,11,31,Player A
483,JointPQPlayer,330,135,465,25,20,Player A
484,JointPQPlayer,330,120,450,19,23,Player A
485,JointPQPlayer,180,135,315,4,63,Player A
486,JointPQPlayer,298,68,366,4,46,Player A
487,JointPQPlayer,369,44,413,3,30,Player A
488,JointPQPlayer,336,51,387,4,39,Player A
489,JointPQPlayer,362,42,404,0,32,Player A
490,JointPQPlayer,365,65,430,5,25,Player A
491,JointPQPlayer,333,58,391,5,38,Player A
492,JointPQPlayer,262,122,384,13,43,Player A
493,JointPQPlayer,386,41,427,2,25,Player A
494,JointPQPlayer,387,42,429,4,25,Player A
495,JointPQPlayer,376,61,437,9,24,Player A
496,JointPQPlayer,286,211,497,36,13,Player A
497,JointPQPlayer,418,23,441,1,20,Player A
498,JointPQPlayer,345,65,410,9,33,Player A
499,JointPQPlayer,294,79,373,2,43,Player A
500,JointPQPlayer,378,33,411,1,30,Player A
501,JointPQPlayer,340,95,435,13,26,Player A
502,JointPQPlayer,196,201,397,17,40,JointPQPlayer
503,JointPQPlayer,407,32,439,2,21,Player A
504,JointPQPlayer,377,37,414,1,29,Player A
505,JointPQPlayer,369,39,408,1,31,Player A
506,JointPQPlayer,350,45,395,0,35,Player A
507,JointPQPlayer,371,36,407,0,31,Player A
508,JointPQPlayer,383,48,431,6,25,Player A
509,JointPQPlayer,399,29,428,0,24,Player A
510,JointPQPlayer,385,35,420,1,27,Player A
511,JointPQPlayer,355,40,395,0,35,Player A
512,JointPQPlayer,332,57,389,3,38,Player A
513,JointPQPlayer,366,56,422,9,29,Player A
514,JointPQPlayer,366,41,407,0,31,Player A
515,JointPQPlayer,355,40,395,0,35,Player A
516,JointPQPlayer,363,38,401,0,33,Player A
517,JointPQPlayer,344,54,398,3,35,Player A
518,JointPQPlayer,383,33,416,0,28,Player A
519,JointPQPlayer,382,42,424,5,27,Player A
520,JointPQPlayer,269,114,383,12,43,Player A
521,JointPQPlayer,371,41,412,2,30,Player A
522,JointPQPlayer,269,219,488,39,17,Player A
523,JointPQPlayer,326,81,407,3,32,Player A
524,JointPQPlayer,359,49,408,4,32,Player A
525,JointPQPlayer,355,40,395,0,35,Player A
526,JointPQPlayer,371,36,407,0,31,Player A
527,JointPQPlayer,369,59,428,9,27,Player A
528,JointPQPlayer,325,65,390,4,38,Player A
529,JointPQPlayer,377,37,414,1,29,Player A
530,JointPQPlayer,363,43,406,2,32,Player A
531,JointPQPlayer,222,77,299,0,67,Player A
532,JointPQPlayer,373,38,411,1,30,Player A
533,JointPQPlayer,318,53,371,0,43,Player A
534,JointPQPlayer,287,57,344,0,52,Player A
535,JointPQPlayer,361,41,402,1,33,Player A
536,JointPQPlayer,351,41,392,0,36,Player A
537,JointPQPlayer,259,74,333,1,56,Player A
538,JointPQPlayer,347,57,404,6,34,Player A
539,JointPQPlayer,346,46,392,0,36,Player A
540,JointPQPlayer,407,27,434,0,22,Player A
541,JointPQPlayer,378,58,436,5,23,Player A
542,JointPQPlayer,401,31,432,1,23,Player A
543,JointPQPlayer,400,30,430,2,24,Player A
544,JointPQPlayer,343,48,391,2,37,Player A
545,JointPQPlayer,386,41,427,2,25,Player A
546,JointPQPlayer,347,42,389,0,37,Player A
547,JointPQPlayer,377,37,414,1,29,Player A
548,JointPQPlayer,345,45,390,1,37,Player A
549,JointPQPlayer,326,51,377,0,41,Player A
550,JointPQPlayer,382,32,414,1,29,Player A
551,JointPQPlayer,398,38,436,2,22,Player A
552,JointPQPlayer,368,33,401,0,33,Player A
553,JointPQPlayer,337,47,384,1,39,Player A
554,JointPQPlayer,222,77,299,0,67,Player A
555,JointPQPlayer,397,32,429,1,24,Player A
556,JointPQPlayer,359,39,398,0,34,Player A
557,JointPQPlayer,379,34,413,0,29,Player A
558,JointPQPlayer,361,51,412,5,31,Player A
559,JointPQPlayer,379,34,413,0,29,Player A
560,JointPQPlayer,395,30,425,0,25,Player A
561,JointPQPlayer,393,33,426,1,25,Player A
562,JointPQPlayer,309,129,438,22,28,Player A
563,JointPQPlayer,355,50,405,4,33,Player A
564,JointPQPlayer,391,36,427,2,25,Player A
565,JointPQPlayer,347,52,399,4,35,Player A
566,JointPQPlayer,308,163,471,28,19,Player A
567,JointPQPlayer,377,57,434,9,25,Player A
568,JointPQPlayer,373,38,411,1,30,Player A
569,JointPQPlayer,369,39,408,1,31,Player A
570,JointPQPlayer,319,119,438,19,27,Player A
571,JointPQPlayer,359,44,403,2,33,Player A
572,JointPQPlayer,404,34,438,4,22,Player A
573,JointPQPlayer,323,108,431,18,29,Player A
574,JointPQPlayer,367,37,404,0,32,Player A
575,JointPQPlayer,390,40,430,5,25,Player A
576,JointPQPlayer,399,29,428,0,24,Player A
577,JointPQPlayer,346,66,412,8,32,Player A
578,JointPQPlayer,347,42,389,0,37,Player A
579,JointPQPlayer,371,41,412,2,30,Player A
580,JointPQPlayer,355,45,400,2,34,Player A
581,JointPQPlayer,387,47,434,6,24,Player A
582,JointPQPlayer,345,50,395,3,36,Player A
583,JointPQPlayer,343,43,386,0,38,Player A
584,JointPQPlayer,373,43,416,3,29,Player A
585,JointPQPlayer,322,52,374,0,42,Player A
586,JointPQPlayer,363,38,401,0,33,Player A
587,JointPQPlayer,344,69,413,9,32,Player A
588,JointPQPlayer,381,36,417,1,28,Player A
589,JointPQPlayer,310,55,365,0,45,Player A
590,JointPQPlayer,363,43,406,2,32,Player A
591,JointPQPlayer,356,46,402,1,33,Player A
592,JointPQPlayer,361,46,407,3,32,Player A
593,JointPQPlayer,344,64,408,7,33,Player A
594,JointPQPlayer,351,41,392,0,36,Player A
595,JointPQPlayer,344,49,393,1,36,Player A
596,JointPQPlayer,367,42,409,2,31,Player A
597,JointPQPlayer,328,58,386,3,39,Player A
598,JointPQPlayer,363,43,406,2,32,Player A
599,JointPQPlayer,355,60,415,8,31,Player A
600,JointPQPlayer,301,86,387,1,38,Player A
601,JointPQPlayer,287,72,359,3,48,Player A
602,JointPQPlayer,341,101,442,14,24,Player A
603,JointPQPlayer,404,24,428,0,24,Player A
604,JointPQPlayer,381,36,417,1,28,Player A
605,JointPQPlayer,371,51,422,6,28,Player A
606,JointPQPlayer,367,42,409,2,31,Player A
607,JointPQPlayer,345,65,410,9,33,Player A
608,JointPQPlayer,373,38,411,1,30,Player A
609,JointPQPlayer,355,40,395,0,35,Player A
610,JointPQPlayer,339,44,383,0,39,Player A
611,JointPQPlayer,367,37,404,0,32,Player A
612,JointPQPlayer,359,39,398,0,34,Player A
613,JointPQPlayer,391,31,422,0,26,Player A
614,JointPQPlayer,405,35,440,3,21,Player A
615,JointPQPlayer,377,42,419,3,28,Player A
616,JointPQPlayer,305,130,435,22,29,Player A
617,JointPQPlayer,260,95,355,8,51,Player A
618,JointPQPlayer,333,48,381,1,40,Player A
619,JointPQPlayer,348,48,396,1,35,Player A
620,JointPQPlayer,382,52,434,3,23,Player A
621,JointPQPlayer,383,33,416,0,28,Player A
622,JointPQPlayer,306,61,367,2,45,Player A
623,JointPQPlayer,315,75,390,4,38,Player A
624,JointPQPlayer,397,32,429,1,24,Player A
625,JointPQPlayer,391,31,422,0,26,Player A
626,JointPQPlayer,389,34,423,1,26,Player A
627,JointPQPlayer,365,50,415,2,29,Player A
628,JointPQPlayer,263,78,341,3,54,Player A
629,JointPQPlayer,345,60,405,7,34,Player A
630,JointPQPlayer,358,53,411,4,31,Player A
631,JointPQPlayer,391,31,422,0,26,Player A
632,JointPQPlayer,397,37,434,3,23,Player A
633,JointPQPlayer,379,49,428,3,25,Player A
634,JointPQPlayer,350,55,405,4,33,Player A
635,JointPQPlayer,362,62,424,5,27,Player A
636,JointPQPlayer,367,42,409,2,31,Player A
637,JointPQPlayer,363,38,401,0,33,Player A
638,JointPQPlayer,361,56,417,7,30,Player A
639,JointPQPlayer,319,49,368,0,44,Player A
640,JointPQPlayer,367,47,414,1,29,Player A
641,JointPQPlayer,369,44,413,3,30,Player A
642,JointPQPlayer,381,36,417,1,28,Player A
643,JointPQPlayer,332,52,384,1,39,Player A
644,JointPQPlayer,381,36,417,1,28,Player A
645,JointPQPlayer,381,36,417,1,28,Player A
646,JointPQPlayer,379,39,418,2,28,Player A
647,JointPQPlayer,376,36,412,2,30,Player A
648,JointPQPlayer,344,49,393,1,36,Player A
649,JointPQPlayer,361,56,417,7,30,Player A
650,JointPQPlayer,318,118,436,20,28,Player A
651,JointPQPlayer,166,126,292,5,71,Player A
652,JointPQPlayer,359,84,443,12,23,Player A
653,JointPQPlayer,367,42,409,2,31,Player A
654,JointPQPlayer,342,47,389,0,37,Player A
655,JointPQPlayer,379,34,413,0,29,Player A
656,JointPQPlayer,340,55,395,3,36,Player A
657,JointPQPlayer,375,35,410,0,30,Player A
658,JointPQPlayer,351,41,392,0,36,Player A
659,JointPQPlayer,352,102,454,17,21,Player A
660,JointPQPlayer,392,42,434,6,24,Player A
661,JointPQPlayer,353,43,396,1,35,Player A
662,JointPQPlayer,373,38,411,1,30,Player A
663,JointPQPlayer,387,32,419,0,27,Player A
664,JointPQPlayer,367,37,404,0,32,Player A
665,JointPQPlayer,361,56,417,7,30,Player A
666,JointPQPlayer,321,166,487,38,17,Player A
667,JointPQPlayer,347,42,389,0,37,Player A
668,JointPQPlayer,343,43,386,0,38,Player A
669,JointPQPlayer,379,34,413,0,29,Player A
670,JointPQPlayer,369,39,408,1,31,Player A
671,JointPQPlayer,331,51,382,2,40,Player A
672,JointPQPlayer,308,58,366,1,45,Player A
673,JointPQPlayer,299,64,363,1,46,Player A
674,JointPQPlayer,390,40,430,2,24,Player A
675,JointPQPlayer,367,37,404,0,32,Player A
676,JointPQPlayer,387,42,429,4,25,Player A
677,JointPQPlayer,370,70,440,12,24,Player A
678,JointPQPlayer,383,38,421,2,27,Player A
679,JointPQPlayer,358,48,406,2,32,Player A
680,JointPQPlayer,332,67,399,4,35,Player A
681,JointPQPlayer,305,140,445,26,27,Player A
682,JointPQPlayer,291,81,372,7,45,Player A
683,JointPQPlayer,325,125,450,22,24,Player A
684,JointPQPlayer,393,33,426,1,25,Player A
685,JointPQPlayer,318,108,426,16,30,Player A
686,JointPQPlayer,413,28,441,1,20,Player A
687,JointPQPlayer,372,42,414,4,30,Player A
688,JointPQPlayer,368,63,431,9,26,Player A
689,JointPQPlayer,355,45,400,2,34,Player A
690,JointPQPlayer,339,54,393,1,36,Player A
691,JointPQPlayer,384,49,433,5,24,Player A
692,JointPQPlayer,345,55,400,2,34,Player A
693,JointPQPlayer,397,32,429,1,24,Player A
694,JointPQPlayer,394,34,428,3,25,Player A
695,JointPQPlayer,364,44,408,1,31,Player A
696,JointPQPlayer,409,29,438,1,21,Player A
697,JointPQPlayer,393,43,436,5,23,Player A
698,JointPQPlayer,343,73,416,9,31,Player A
699,JointPQPlayer,324,79,403,8,35,Player A
700,JointPQPlayer,380,35,415,2,29,Player A
701,JointPQPlayer,381,36,417,1,28,Player A
702,JointPQPlayer,373,43,416,3,29,Player A
703,JointPQPlayer,336,66,402,7,35,Player A
704,JointPQPlayer,284,94,378,4,42,Player A
705,JointPQPlayer,379,34,413,0,29,Player A
706,JointPQPlayer,342,47,389,0,37,Player A
707,JointPQPlayer,331,126,457,23,22,Player A
708,JointPQPlayer,206,331,537,64,9,JointPQPlayer
709,JointPQPlayer,295,80,375,1,42,Player A
710,JointPQPlayer,357,52,409,5,32,Player A
711,JointPQPlayer,377,42,419,3,28,Player A
712,JointPQPlayer,363,38,401,0,33,Player A
713,JointPQPlayer,377,37,414,1,29,Player A
714,JointPQPlayer,343,43,386,0,38,Player A
715,JointPQPlayer,352,57,409,5,32,Player A
716,JointPQPlayer,389,34,423,1,26,Player A
717,JointPQPlayer,369,44,413,3,30,Player A
718,JointPQPlayer,352,102,454,17,21,Player A
719,JointPQPlayer,351,56,407,6,33,Player A
720,JointPQPlayer,351,46,397,2,35,Player A
721,JointPQPlayer,374,44,418,5,29,Player A
722,JointPQPlayer,397,42,439,5,22,Player A
723,JointPQPlayer,357,42,399,1,34,Player A
724,JointPQPlayer,363,43,406,2,32,Player A
725,JointPQPlayer,383,43,426,4,26,Player A
726,JointPQPlayer,332,67,399,4,35,Player A
727,JointPQPlayer,348,48,396,1,35,Player A
728,JointPQPlayer,365,45,410,3,31,Player A
729,JointPQPlayer,386,41,427,5,26,Player A
730,JointPQPlayer,387,42,429,4,25,Player A
731,JointPQPlayer,379,34,413,0,29,Player A
732,JointPQPlayer,374,49,423,4,27,Player A
733,JointPQPlayer,326,51,377,0,41,Player A
734,JointPQPlayer,335,45,380,0,40,Player A
735,JointPQPlayer,395,30,425,0,25,Player A
736,JointPQPlayer,387,37,424,2,26,Player A
737,JointPQPlayer,373,48,421,2,27,Player A
738,JointPQPlayer,347,42,389,0,37,Player A
739,JointPQPlayer,363,43,406,2,32,Player A
740,JointPQPlayer,363,38,401,0,33,Player A
741,JointPQPlayer,357,72,429,7,26,Player A
742,JointPQPlayer,324,104,428,15,29,Player A
743,JointPQPlayer,344,104,448,20,24,Player A
744,JointPQPlayer,308,118,426,7,27,Player A
745,JointPQPlayer,367,72,439,8,23,Player A
746,JointPQPlayer,366,51,417,7,30,Player A
747,JointPQPlayer,338,88,426,10,28,Player A
748,JointPQPlayer,383,33,416,0,28,Player A
749,JointPQPlayer,399,29,428,0,24,Player A
750,JointPQPlayer,339,44,383,0,39,Player A
751,JointPQPlayer,323,53,376,2,42,Player A
752,JointPQPlayer,345,45,390,1,37,Player A
753,JointPQPlayer,405,35,440,3,21,Player A
754,JointPQPlayer,365,45,410,3,31,Player A
755,JointPQPlayer,299,204,503,39,12,Player A
756,JointPQPlayer,384,29,413,0,29,Player A
757,JointPQPlayer,395,30,425,0,25,Player A
758,JointPQPlayer,385,35,420,1,27,Player A
759,JointPQPlayer,375,35,410,0,30,Player A
760,JointPQPlayer,335,45,380,0,40,Player A
761,JointPQPlayer,359,39,398,0,34,Player A
762,JointPQPlayer,330,50,380,0,40,Player A
763,JointPQPlayer,357,52,409,2,31,Player A
764,JointPQPlayer,371,36,407,0,31,Player A
765,JointPQPlayer,413,28,441,1,20,Player A
766,JointPQPlayer,262,67,329,0,57,Player A
767,JointPQPlayer,299,134,433,23,30,Player A
768,JointPQPlayer,383,38,421,2,27,Player A
769,JointPQPlayer,371,36,407,0,31,Player A
770,JointPQPlayer,399,34,433,2,23,Player A
771,JointPQPlayer,373,38,411,1,30,Player A
772,JointPQPlayer,383,33,416,0,28,Player A
773,JointPQPlayer,365,50,415,5,30,Player A
774,JointPQPlayer,326,56,382,2,40,Player A
775,JointPQPlayer,394,39,433,5,24,Player A
776,JointPQPlayer,352,52,404,3,33,Player A
777,JointPQPlayer,363,38,401,0,33,Player A
778,JointPQPlayer,377,37,414,1,29,Player A
779,JointPQPlayer,342,102,444,16,24,Player A
780,JointPQPlayer,359,39,398,0,34,Player A
781,JointPQPlayer,230,195,425,39,38,Player A
782,JointPQPlayer,357,77,434,9,25,Player A
783,JointPQPlayer,369,39,408,1,31,Player A
784,JointPQPlayer,379,34,413,0,29,Player A
785,JointPQPlayer,389,39,428,3,25,Player A
786,JointPQPlayer,360,45,405,1,32,Player A
787,JointPQPlayer,357,42,399,1,34,Player A
788,JointPQPlayer,383,33,416,0,28,Player A
789,JointPQPlayer,359,119,478,23,15,Player A
790,JointPQPlayer,371,36,407,0,31,Player A
791,JointPQPlayer,352,102,454,14,20,Player A
792,JointPQPlayer,353,43,396,1,35,Player A
793,JointPQPlayer,387,37,424,2,26,Player A
794,JointPQPlayer,404,29,433,2,23,Player A
795,JointPQPlayer,354,44,398,0,34,Player A
796,JointPQPlayer,401,31,432,1,23,Player A
797,JointPQPlayer,343,43,386,0,38,Player A
798,JointPQPlayer,391,36,427,2,25,Player A
799,JointPQPlayer,331,81,412,8,32,Player A
800,JointPQPlayer,351,46,397,2,35,Player A
801,JointPQPlayer,332,72,404,9,35,Player A
802,JointPQPlayer,383,33,416,0,28,Player A
803,JointPQPlayer,343,43,386,0,38,Player A
804,JointPQPlayer,388,33,421,2,27,Player A
805,JointPQPlayer,392,37,429,1,24,Player A
806,JointPQPlayer,361,46,407,3,32,Player A
807,JointPQPlayer,340,85,425,15,30,Player A
808,JointPQPlayer,363,38,401,0,33,Player A
809,JointPQPlayer,375,50,425,3,26,Player A
810,JointPQPlayer,389,34,423,1,26,Player A
811,JointPQPlayer,363,38,401,0,33,Player A
812,JointPQPlayer,335,85,420,10,30,Player A
813,JointPQPlayer,384,44,428,6,26,Player A
814,JointPQPlayer,346,61,407,6,33,Player A
815,JointPQPlayer,363,38,401,0,33,Player A
816,JointPQPlayer,397,37,434,3,23,Player A
817,JointPQPlayer,349,54,403,5,34,Player A
818,JointPQPlayer,391,31,422,0,26,Player A
819,JointPQPlayer,311,156,467,33,22,Player A
820,JointPQPlayer,322,52,374,0,42,Player A
821,JointPQPlayer,375,40,415,2,29,Player A
822,JointPQPlayer,363,68,431,9,26,Player A
823,JointPQPlayer,374,89,463,14,17,Player A
824,JointPQPlayer,389,34,423,1,26,Player A
825,JointPQPlayer,379,34,413,0,29,Player A
826,JointPQPlayer,385,40,425,3,26,Player A
827,JointPQPlayer,363,38,401,0,33,Player A
828,JointPQPlayer,269,84,353,3,50,Player A
829,JointPQPlayer,327,47,374,0,42,Player A
830,JointPQPlayer,381,36,417,1,28,Player A
831,JointPQPlayer,391,31,422,0,26,Player A
832,JointPQPlayer,270,65,335,0,55,Player A
833,JointPQPlayer,367,57,424,8,28,Player A
834,JointPQPlayer,323,133,456,25,23,Player A
835,JointPQPlayer,393,38,431,3,24,Player A
836,JointPQPlayer,414,29,443,3,20,Player A
837,JointPQPlayer,419,29,448,2,18,Player A
838,JointPQPlayer,338,58,396,4,36,Player A
839,JointPQPlayer,376,61,437,6,23,Player A
840,JointPQPlayer,375,35,410,0,30,Player A
841,JointPQPlayer,400,35,435,4,23,Player A
842,JointPQPlayer,363,58,421,8,29,Player A
843,JointPQPlayer,333,68,401,3,34,Player A
844,JointPQPlayer,392,37,429,4,25,Player A
845,JointPQPlayer,371,51,422,6,28,Player A
846,JointPQPlayer,262,107,369,10,47,Player A
847,JointPQPlayer,341,46,387,1,38,Player A
848,JointPQPlayer,391,31,422,0,26,Player A
849,JointPQPlayer,406,26,432,1,23,Player A
850,JointPQPlayer,166,111,277,2,75,Player A
851,JointPQPlayer,365,40,405,1,32,Player A
852,JointPQPlayer,356,51,407,3,32,Player A
853,JointPQPlayer,356,46,402,1,33,Player A
854,JointPQPlayer,295,160,455,24,23,Player A
855,JointPQPlayer,317,62,379,2,41,Player A
856,JointPQPlayer,382,37,419,0,27,Player A
857,JointPQPlayer,370,35,405,1,32,Player A
858,JointPQPlayer,290,70,360,1,47,Player A
859,JointPQPlayer,389,34,423,1,26,Player A
860,JointPQPlayer,407,27,434,0,22,Player A
861,JointPQPlayer,353,53,406,2,32,Player A
862,JointPQPlayer,351,41,392,0,36,Player A
863,JointPQPlayer,391,46,437,6,23,Player A
864,JointPQPlayer,347,42,389,0,37,Player A
865,JointPQPlayer,384,54,438,7,23,Player A
866,JointPQPlayer,338,108,446,18,24,Player A
867,JointPQPlayer,351,41,392,0,36,Player A
868,JointPQPlayer,391,31,422,0,26,Player A
869,JointPQPlayer,332,62,394,5,37,Player A
870,JointPQPlayer,383,33,416,0,28,Player A
871,JointPQPlayer,363,38,401,0,33,Player A
872,JointPQPlayer,353,53,406,5,33,Player A
873,JointPQPlayer,389,34,423,1,26,Player A
874,JointPQPlayer,359,49,408,4,32,Player A
875,JointPQPlayer,349,79,428,9,27,Player A
876,JointPQPlayer,387,37,424,2,26,Player A
877,JointPQPlayer,391,31,422,0,26,Player A
878,JointPQPlayer,387,32,419,0,27,Player A
879,JointPQPlayer,373,38,411,1,30,Player A
880,JointPQPlayer,364,64,428,6,26,Player A
881,JointPQPlayer,371,41,412,2,30,Player A
882,JointPQPlayer,311,51,362,0,46,Player A
883,JointPQPlayer,351,41,392,0,36,Player A
884,JointPQPlayer,375,55,430,8,26,Player A
885,JointPQPlayer,381,41,422,3,27,Player A
886,JointPQPlayer,302,57,359,0,47,Player A
887,JointPQPlayer,311,91,402,10,36,Player A
888,JointPQPlayer,341,56,397,2,35,Player A
889,JointPQPlayer,337,57,394,2,36,Player A
890,JointPQPlayer,334,104,438,16,26,Player A
891,JointPQPlayer,371,36,407,0,31,Player A
892,JointPQPlayer,368,43,411,1,30,Player A
893,JointPQPlayer,389,34,423,1,26,Player A
894,JointPQPlayer,338,53,391,2,37,Player A
895,JointPQPlayer,330,55,385,2,39,Player A
896,JointPQPlayer,351,41,392,0,36,Player A
897,JointPQPlayer,315,105,420,19,33,Player A
898,JointPQPlayer,363,78,441,10,23,Player A
899,JointPQPlayer,351,41,392,0,36,Player A
900,JointPQPlayer,359,44,403,2,33,Player A
901,JointPQPlayer,347,57,404,3,33,Player A
902,JointPQPlayer,371,41,412,2,30,Player A
903,JointPQPlayer,385,40,425,3,26,Player A
904,JointPQPlayer,337,67,404,6,34,Player A
905,JointPQPlayer,374,39,413,0,29,Player A
906,JointPQPlayer,368,43,411,4,31,Player A
907,JointPQPlayer,346,91,437,12,25,Player A
908,JointPQPlayer,373,38,411,1,30,Player A
909,JointPQPlayer,390,40,430,2,24,Player A
910,JointPQPlayer,360,45,405,1,32,Player A
911,JointPQPlayer,338,48,386,0,38,Player A
912,JointPQPlayer,410,35,445,5,20,Player A
913,JointPQPlayer,367,42,409,2,31,Player A
914,JointPQPlayer,402,37,439,5,22,Player A
915,JointPQPlayer,387,37,424,2,26,Player A
916,JointPQPlayer,351,41,392,0,36,Player A
917,JointPQPlayer,324,69,393,7,38,Player A
918,JointPQPlayer,319,49,368,0,44,Player A
919,JointPQPlayer,383,38,421,2,27,Player A
920,JointPQPlayer,341,71,412,11,33,Player A
921,JointPQPlayer,389,34,423,1,26,Player A
922,JointPQPlayer,369,44,413,3,30,Player A
923,JointPQPlayer,342,67,409,8,33,Player A
924,JointPQPlayer,362,62,424,5,27,Player A
925,JointPQPlayer,391,31,422,0,26,Player A
926,JointPQPlayer,333,48,381,1,40,Player A
927,JointPQPlayer,403,28,431,0,23,Player A
928,JointPQPlayer,283,208,491,42,17,Player A
929,JointPQPlayer,296,161,457,29,24,Player A
930,JointPQPlayer,331,46,377,0,41,Player A
931,JointPQPlayer,286,151,437,18,27,Player A
932,JointPQPlayer,353,73,426,7,27,Player A
933,JointPQPlayer,355,50,405,4,33,Player A
934,JointPQPlayer,387,32,419,0,27,Player A
935,JointPQPlayer,361,41,402,1,33,Player A
936,JointPQPlayer,329,79,408,7,33,Player A
937,JointPQPlayer,371,46,417,4,29,Player A
938,JointPQPlayer,344,49,393,1,36,Player A
939,JointPQPlayer,338,98,436,14,26,Player A
940,JointPQPlayer,379,34,413,0,29,Player A
941,JointPQPlayer,379,44,423,4,27,Player A
942,JointPQPlayer,351,61,412,8,32,Player A
943,JointPQPlayer,371,36,407,0,31,Player A
944,JointPQPlayer,379,39,418,2,28,Player A
945,JointPQPlayer,381,36,417,1,28,Player A
946,JointPQPlayer,343,43,386,0,38,Player A
947,JointPQPlayer,385,70,455,9,18,Player A
948,JointPQPlayer,389,44,433,2,23,Player A
949,JointPQPlayer,367,37,404,0,32,Player A
950,JointPQPlayer,350,45,395,3,36,Player A
951,JointPQPlayer,368,53,421,5,28,Player A
952,JointPQPlayer,367,37,404,0,32,Player A
953,JointPQPlayer,271,66,337,2,55,Player A
954,JointPQPlayer,362,42,404,0,32,Player A
955,JointPQPlayer,270,65,335,0,55,Player A
956,JointPQPlayer,335,45,380,0,40,Player A
957,JointPQPlayer,335,45,380,0,40,Player A
958,JointPQPlayer,382,32,414,1,29,Player A
959,JointPQPlayer,337,47,384,1,39,Player A
960,JointPQPlayer,333,118,451,20,23,Player A
961,JointPQPlayer,389,34,423,1,26,Player A
962,JointPQPlayer,191,301,492,46,18,JointPQPlayer
963,JointPQPlayer,349,44,393,1,36,Player A
964,JointPQPlayer,381,36,417,1,28,Player A
965,JointPQPlayer,395,30,425,0,25,Player A
966,JointPQPlayer,319,49,368,0,44,Player A
967,JointPQPlayer,361,41,402,1,33,Player A
968,JointPQPlayer,331,46,377,0,41,Player A
969,JointPQPlayer,375,35,410,0,30,Player A
970,JointPQPlayer,379,34,413,0,29,Player A
971,JointPQPlayer,217,82,299,0,67,Player A
972,JointPQPlayer,359,39,398,0,34,Player A
973,JointPQPlayer,381,46,427,5,26,Player A
974,JointPQPlayer,347,47,394,2,36,Player A
975,JointPQPlayer,375,35,410,0,30,Player A
976,JointPQPlayer,367,37,404,0,32,Player A
977,JointPQPlayer,408,33,441,4,21,Player A
978,JointPQPlayer,340,55,395,3,36,Player A
979,JointPQPlayer,345,55,400,2,34,Player A
980,JointPQPlayer,274,64,338,0,54,Player A
981,JointPQPlayer,381,56,437,9,24,Player A
982,JointPQPlayer,275,70,345,1,52,Player A
983,JointPQPlayer,394,39,433,5,24,Player A
984,JointPQPlayer,338,48,386,0,38,Player A
985,JointPQPlayer,347,42,389,0,37,Player A
986,JointPQPlayer,406,31,437,3,22,Player A
987,JointPQPlayer,366,46,412,2,30,Player A
988,JointPQPlayer,381,36,417,1,28,Player A
989,JointPQPlayer,383,33,416,0,28,Player A
990,JointPQPlayer,370,45,415,5,30,Player A
991,JointPQPlayer,377,37,414,1,29,Player A
992,JointPQPlayer,366,41,407,3,32,Player A
993,JointPQPlayer,292,92,384,10,42,Player A
994,JointPQPlayer,358,43,401,0,33,Player A
995,JointPQPlayer,315,50,365,0,45,Player A
996,JointPQPlayer,350,65,415,5,30,Player A
997,JointPQPlayer,343,43,386,0,38,Player A
998,JointPQPlayer,329,89,418,11,31,Player A
999,JointPQPlayer,381,46,427,2,25,Player A
1000,JointPQPlayer,359,39,398,0,34,Player A
1001,JointPQPlayer,377,42,419,3,28,Player A
1002,JointPQPlayer,384,34,418,2,28,Player A
1003,JointPQPlayer,354,44,398,0,34,Player A
1004,JointPQPlayer,354,44,398,3,35,Player A
1005,JointPQPlayer,346,51,397,2,35,Player A
1006,JointPQPlayer,347,42,389,0,37,Player A
1007,JointPQPlayer,379,39,418,2,28,Player A
1008,JointPQPlayer,373,43,416,3,29,Player A
1009,JointPQPlayer,339,74,413,3,30,Player A
1010,JointPQPlayer,387,32,419,0,27,Player A
1011,JointPQPlayer,392,27,419,0,27,Player A
1012,JointPQPlayer,314,54,368,0,44,Player A
1013,JointPQPlayer,371,36,407,0,31,Player A
1014,JointPQPlayer,397,42,439,5,22,Player A
1015,JointPQPlayer,367,52,419,6,29,Player A
1016,JointPQPlayer,216,211,427,29,34,Player A
1017,JointPQPlayer,393,33,426,1,25,Player A
1018,JointPQPlayer,330,50,380,0,40,Player A
1019,JointPQPlayer,192,232,424,29,35,JointPQPlayer
1020,JointPQPlayer,359,39,398,0,34,Player A
1021,JointPQPlayer,383,33,416,0,28,Player A
1022,JointPQPlayer,391,31,422,0,26,Player A
1023,JointPQPlayer,357,82,439,11,24,Player A
1024,JointPQPlayer,341,81,422,9,29,Player A
1025,JointPQPlayer,351,41,392,0,36,Player A
1026,JointPQPlayer,343,43,386,0,38,Player A
1027,JointPQPlayer,271,61,332,0,56,Player A
1028,JointPQPlayer,363,48,411,4,31,Player A
1029,JointPQPlayer,340,60,400,5,35,Player A
1030,JointPQPlayer,371,36,407,0,31,Player A
1031,JointPQPlayer,353,113,466,20,18,Player A
1032,JointPQPlayer,393,33,426,1,25,Player A
1033,JointPQPlayer,369,39,408,1,31,Player A
1034,JointPQPlayer,383,33,416,0,28,Player A
1035,JointPQPlayer,294,59,353,0,49,Player A
1036,JointPQPlayer,367,42,409,2,31,Player A
1037,JointPQPlayer,373,43,416,3,29,Player A
1038,JointPQPlayer,216,86,302,0,66,Player A
1039,JointPQPlayer,399,29,428,0,24,Player A
1040,JointPQPlayer,349,54,403,5,34,Player A
1041,JointPQPlayer,400,35,435,4,23,Player A
1042,JointPQPlayer,375,45,420,4,28,Player A
1043,JointPQPlayer,319,59,378,1,41,Player A
1044,JointPQPlayer,297,57,354,1,49,Player A
1045,JointPQPlayer,314,54,368,0,44,Player A
1046,JointPQPlayer,397,32,429,1,24,Player A
1047,JointPQPlayer,370,50,420,7,29,Player A
1048,JointPQPlayer,366,46,412,2,30,Player A
1049,JointPQPlayer,306,66,372,4,44,Player A
1050,JointPQPlayer,339,64,403,8,35,Player A
1051,JointPQPlayer,361,71,432,7,25,Player A
1052,JointPQPlayer,403,33,436,2,22,Player A
1053,JointPQPlayer,403,33,436,2,22,Player A
1054,JointPQPlayer,323,58,381,4,41,Player A
1055,JointPQPlayer,375,40,415,2,29,Player A
1056,JointPQPlayer,383,48,431,6,25,Player A
1057,JointPQPlayer,379,39,418,2,28,Player A
1058,JointPQPlayer,366,36,402,1,33,Player A
1059,JointPQPlayer,371,51,422,6,28,Player A
1060,JointPQPlayer,374,44,418,2,28,Player A
1061,JointPQPlayer,375,45,420,4,28,Player A
1062,JointPQPlayer,337,52,389,0,37,Player A
1063,JointPQPlayer,373,38,411,1,30,Player A
1064,JointPQPlayer,331,46,377,0,41,Player A
1065,JointPQPlayer,359,39,398,0,34,Player A
1066,JointPQPlayer,389,34,423,1,26,Player A
1067,JointPQPlayer,303,53,356,0,48,Player A
1068,JointPQPlayer,367,42,409,2,31,Player A
1069,JointPQPlayer,367,37,404,0,32,Player A
1070,JointPQPlayer,343,63,406,8,34,Player A
1071,JointPQPlayer,379,39,418,2,28,Player A
1072,JointPQPlayer,303,53,356,0,48,Player A
1073,JointPQPlayer,347,42,389,0,37,Player A
1074,JointPQPlayer,332,72,404,6,34,Player A
1075,JointPQPlayer,381,46,427,5,26,Player A
1076,JointPQPlayer,393,33,426,1,25,Player A
1077,JointPQPlayer,389,34,423,1,26,Player A
1078,JointPQPlayer,379,39,418,2,28,Player A
1079,JointPQPlayer,382,62,444,10,22,Player A
1080,JointPQPlayer,287,57,344,0,52,Player A
1081,JointPQPlayer,353,43,396,1,35,Player A
1082,JointPQPlayer,262,142,404,21,39,Player A
1083,JointPQPlayer,335,50,385,2,39,Player A
1084,JointPQPlayer,383,33,416,0,28,Player A
1085,JointPQPlayer,383,43,426,4,26,Player A
1086,JointPQPlayer,332,67,399,7,36,Player A
1087,JointPQPlayer,401,31,432,1,23,Player A
1088,JointPQPlayer,391,31,422,0,26,Player A
1089,JointPQPlayer,324,59,383,3,40,Player A
1090,JointPQPlayer,377,37,414,1,29,Player A
1091,JointPQPlayer,381,36,417,1,28,Player A
1092,JointPQPlayer,397,32,429,1,24,Player A
1093,JointPQPlayer,371,36,407,0,31,Player A
1094,JointPQPlayer,369,39,408,1,31,Player A
1095,JointPQPlayer,361,46,407,3,32,Player A
1096,JointPQPlayer,376,46,422,6,28,Player A
1097,JointPQPlayer,362,52,414,4,30,Player A
1098,JointPQPlayer,335,45,380,0,40,Player A
1099,JointPQPlayer,226,76,302,0,66,Player A
1100,JointPQPlayer,381,36,417,1,28,Player A
1101,JointPQPlayer,394,39,433,5,24,Player A
1102,JointPQPlayer,290,95,385,11,42,Player A
1103,JointPQPlayer,347,47,394,2,36,Player A
1104,JointPQPlayer,361,41,402,1,33,Player A
1105,JointPQPlayer,381,46,427,5,26,Player A
1106,JointPQPlayer,328,53,381,1,40,Player A
1107,JointPQPlayer,388,33,421,2,27,Player A
1108,JointPQPlayer,354,64,418,8,30,Player A
1109,JointPQPlayer,389,34,423,1,26,Player A
1110,JointPQPlayer,205,85,290,0,70,Player A
1111,JointPQPlayer,372,37,409,2,31,Player A
1112,JointPQPlayer,345,140,485,30,15,Player A
1113,JointPQPlayer,366,56,422,9,29,Player A
1114,JointPQPlayer,355,65,420,10,30,Player A
1115,JointPQPlayer,357,47,404,3,33,Player A
1116,JointPQPlayer,339,44,383,0,39,Player A
1117,JointPQPlayer,363,43,406,2,32,Player A
1118,JointPQPlayer,289,69,358,2,48,Player A
1119,JointPQPlayer,339,84,423,10,29,Player A
1120,JointPQPlayer,379,34,413,0,29,Player A
1121,JointPQPlayer,290,60,350,0,50,Player A
1122,JointPQPlayer,355,40,395,0,35,Player A
1123,JointPQPlayer,372,52,424,2,26,Player A
1124,JointPQPlayer,320,75,395,6,37,Player A
1125,JointPQPlayer,348,73,421,14,31,Player A
1126,JointPQPlayer,301,86,387,10,41,Player A
1127,JointPQPlayer,311,51,362,0,46,Player A
1128,JointPQPlayer,359,59,418,8,30,Player A
1129,JointPQPlayer,369,49,418,5,29,Player A
1130,JointPQPlayer,369,39,408,1,31,Player A
1131,JointPQPlayer,383,33,416,0,28,Player A
1132,JointPQPlayer,393,38,431,3,24,Player A
1133,JointPQPlayer,345,60,405,4,33,Player A
1134,JointPQPlayer,385,35,420,1,27,Player A
1135,JointPQPlayer,377,37,414,1,29,Player A
1136,JointPQPlayer,296,61,357,1,48,Player A
1137,JointPQPlayer,398,38,436,5,23,Player A
1138,JointPQPlayer,391,46,437,6,23,Player A
1139,JointPQPlayer,304,59,363,1,46,Player A
1140,JointPQPlayer,343,68,411,10,33,Player A
1141,JointPQPlayer,298,58,356,0,48,Player A
1142,JointPQPlayer,351,41,392,0,36,Player A
1143,JointPQPlayer,373,38,411,1,30,Player A
1144,JointPQPlayer,325,55,380,3,41,Player A
1145,JointPQPlayer,306,56,362,0,46,Player A
1146,JointPQPlayer,367,37,404,0,32,Player A
1147,JointPQPlayer,344,64,408,7,33,Player A
1148,JointPQPlayer,381,41,422,3,27,Player A
1149,JointPQPlayer,339,79,418,11,31,Player A
1150,JointPQPlayer,274,64,338,0,54,Player A
1151,JointPQPlayer,341,66,407,3,32,Player A
1152,JointPQPlayer,338,63,401,6,35,Player A
1153,JointPQPlayer,373,38,411,1,30,Player A
1154,JointPQPlayer,381,46,427,2,25,Player A
1155,JointPQPlayer,349,44,393,1,36,Player A
1156,JointPQPlayer,367,37,404,0,32,Player A
1157,JointPQPlayer,343,43,386,0,38,Player A
1158,JointPQPlayer,382,37,419,3,28,Player A
1159,JointPQPlayer,358,53,411,4,31,Player A
1160,JointPQPlayer,355,40,395,0,35,Player A
1161,JointPQPlayer,339,44,383,0,39,Player A
1162,JointPQPlayer,410,25,435,1,22,Player A
1163,JointPQPlayer,379,39,418,2,28,Player A
1164,JointPQPlayer,367,42,409,2,31,Player A
1165,JointPQPlayer,369,49,418,5,29,Player A
1166,JointPQPlayer,363,38,401,0,33,Player A
1167,JointPQPlayer,274,64,338,0,54,Player A
1168,JointPQPlayer,395,30,425,0,25,Player A
1169,JointPQPlayer,365,40,405,1,32,Player A
1170,JointPQPlayer,347,42,389,0,37,Player A
1171,JointPQPlayer,371,46,417,4,29,Player A
1172,JointPQPlayer,339,44,383,0,39,Player A
1173,JointPQPlayer,391,31,422,0,26,Player A
1174,JointPQPlayer,361,56,417,4,29,Player A
1175,JointPQPlayer,298,163,461,27,22,Player A
1176,JointPQPlayer,377,37,414,1,29,Player A
1177,JointPQPlayer,371,36,407,0,31,Player A
1178,JointPQPlayer,369,39,408,1,31,Player A
1179,JointPQPlayer,361,41,402,1,33,Player A
1180,JointPQPlayer,363,38,401,0,33,Player A
1181,JointPQPlayer,367,37,404,0,32,Player A
1182,JointPQPlayer,390,40,430,5,25,Player A
1183,JointPQPlayer,360,45,405,1,32,Player A
1184,JointPQPlayer,355,40,395,0,35,Player A
1185,JointPQPlayer,361,41,402,1,33,Player A
1186,JointPQPlayer,262,67,329,0,57,Player A
1187,JointPQPlayer,351,56,407,3,32,Player A
1188,JointPQPlayer,400,35,435,4,23,Player A
1189,JointPQPlayer,389,44,433,5,24,Player A
1190,JointPQPlayer,310,55,365,0,45,Player A
1191,JointPQPlayer,360,45,405,4,33,Player A
1192,JointPQPlayer,395,35,430,2,24,Player A
1193,JointPQPlayer,367,37,404,0,32,Player A
1194,JointPQPlayer,343,43,386,0,38,Player A
1195,JointPQPlayer,375,35,410,0,30,Player A
1196,JointPQPlayer,353,43,396,1,35,Player A
1197,JointPQPlayer,359,39,398,0,34,Player A
1198,JointPQPlayer,375,40,415,2,29,Player A
1199,JointPQPlayer,299,54,353,0,49,Player A
1200,JointPQPlayer,373,38,411,1,30,Player A
1201,JointPQPlayer,339,44,383,0,39,Player A
1202,JointPQPlayer,350,45,395,0,35,Player A
1203,JointPQPlayer,373,38,411,1,30,Player A
1204,JointPQPlayer,347,47,394,2,36,Player A
1205,JointPQPlayer,356,56,412,5,31,Player A
1206,JointPQPlayer,392,37,429,1,24,Player A
1207,JointPQPlayer,351,56,407,3,32,Player A
1208,JointPQPlayer,328,68,396,4,36,Player A
1209,JointPQPlayer,211,306,517,50,11,JointPQPlayer
1210,JointPQPlayer,365,40,405,1,32,Player A
1211,JointPQPlayer,391,31,422,0,26,Player A
1212,JointPQPlayer,321,51,372,1,43,Player A
1213,JointPQPlayer,379,49,428,6,26,Player A
1214,JointPQPlayer,402,27,429,1,24,Player A
1215,JointPQPlayer,297,72,369,1,44,Player A
1216,JointPQPlayer,361,51,412,2,30,Player A
1217,JointPQPlayer,367,37,404,0,32,Player A
1218,JointPQPlayer,393,33,426,1,25,Player A
1219,JointPQPlayer,371,36,407,0,31,Player A
1220,JointPQPlayer,343,43,386,0,38,Player A
1221,JointPQPlayer,411,26,437,0,21,Player A
1222,JointPQPlayer,387,32,419,0,27,Player A
1223,JointPQPlayer,339,44,383,0,39,Player A
1224,JointPQPlayer,369,44,413,3,30,Player A
1225,JointPQPlayer,383,43,426,4,26,Player A
1226,JointPQPlayer,391,31,422,0,26,Player A
1227,JointPQPlayer,371,36,407,0,31,Player A
1228,JointPQPlayer,331,46,377,0,41,Player A
1229,JointPQPlayer,363,53,416,6,30,Player A
1230,JointPQPlayer,335,45,380,0,40,Player A
1231,JointPQPlayer,362,87,449,12,21,Player A
1232,JointPQPlayer,367,42,409,2,31,Player A
1233,JointPQPlayer,391,31,422,0,26,Player A
1234,JointPQPlayer,399,29,428,0,24,Player A
1235,JointPQPlayer,310,55,365,0,45,Player A
1236,JointPQPlayer,347,42,389,0,37,Player A
1237,JointPQPlayer,369,39,408,1,31,Player A
1238,JointPQPlayer,323,143,466,23,19,Player A
1239,JointPQPlayer,358,58,416,9,31,Player A
1240,JointPQPlayer,355,50,405,4,33,Player A
1241,JointPQPlayer,367,42,409,2,31,Player A
1242,JointPQPlayer,385,45,430,5,25,Player A
1243,JointPQPlayer,365,50,415,2,29,Player A
1244,JointPQPlayer,339,54,393,1,36,Player A
1245,JointPQPlayer,371,46,417,4,29,Player A
1246,JointPQPlayer,303,123,426,16,30,Player A
1247,JointPQPlayer,353,43,396,1,35,Player A
1248,JointPQPlayer,381,36,417,1,28,Player A
1249,JointPQPlayer,356,51,407,3,32,Player A
1250,JointPQPlayer,383,33,416,0,28,Player A
1251,JointPQPlayer,395,30,425,0,25,Player A
1252,JointPQPlayer,367,47,414,1,29,Player A
1253,JointPQPlayer,395,30,425,0,25,Player A
1254,JointPQPlayer,418,28,446,3,19,Player A
1255,JointPQPlayer,334,84,418,14,32,Player A
1256,JointPQPlayer,399,29,428,0,24,Player A
1257,JointPQPlayer,402,27,429,1,24,Player A
1258,JointPQPlayer,353,68,421,8,29,Player A
1259,JointPQPlayer,341,51,392,3,37,Player A
1260,JointPQPlayer,395,35,430,2,24,Player A
1261,JointPQPlayer,361,46,407,3,32,Player A
1262,JointPQPlayer,393,38,431,3,24,Player A
1263,JointPQPlayer,337,47,384,1,39,Player A
1264,JointPQPlayer,342,52,394,2,36,Player A
1265,JointPQPlayer,398,53,451,5,18,Player A
1266,JointPQPlayer,403,28,431,0,23,Player A
1267,JointPQPlayer,323,83,406,5,33,Player A
1268,JointPQPlayer,326,51,377,0,41,Player A
1269,JointPQPlayer,327,82,409,8,33,Player A
1270,JointPQPlayer,387,32,419,0,27,Player A
1271,JointPQPlayer,353,48,401,3,34,Player A
1272,JointPQPlayer,377,47,424,5,27,Player A
1273,JointPQPlayer,363,38,401,0,33,Player A
1274,JointPQPlayer,365,40,405,1,32,Player A
1275,JointPQPlayer,393,38,431,3,24,Player A
1276,JointPQPlayer,365,40,405,1,32,Player A
1277,JointPQPlayer,243,148,391,14,41,Player A
1278,JointPQPlayer,403,28,431,0,23,Player A
1279,JointPQPlayer,361,46,407,3,32,Player A
1280,JointPQPlayer,334,69,403,8,35,Player A
1281,JointPQPlayer,319,89,408,10,34,Player A
1282,JointPQPlayer,327,52,379,2,41,Player A
1283,JointPQPlayer,322,52,374,0,42,Player A
1284,JointPQPlayer,364,44,408,1,31,Player A
1285,JointPQPlayer,363,38,401,0,33,Player A
1286,JointPQPlayer,347,42,389,0,37,Player A
1287,JointPQPlayer,310,95,405,10,35,Player A
1288,JointPQPlayer,345,45,390,1,37,Player A
1289,JointPQPlayer,377,42,419,3,28,Player A
1290,JointPQPlayer,380,40,420,4,28,Player A
1291,JointPQPlayer,345,65,410,3,31,Player A
1292,JointPQPlayer,395,30,425,0,25,Player A
1293,JointPQPlayer,307,52,359,0,47,Player A
1294,JointPQPlayer,377,37,414,1,29,Player A
1295,JointPQPlayer,286,61,347,0,51,Player A
1296,JointPQPlayer,373,43,416,3,29,Player A
1297,JointPQPlayer,370,40,410,3,31,Player A
1298,JointPQPlayer,314,54,368,0,44,Player A
1299,JointPQPlayer,351,41,392,0,36,Player A
1300,JointPQPlayer,379,34,413,0,29,Player A
1301,JointPQPlayer,339,44,383,0,39,Player A
1302,JointPQPlayer,362,67,429,10,27,Player A
1303,JointPQPlayer,360,95,455,12,19,Player A
1304,JointPQPlayer,378,48,426,7,27,Player A
1305,JointPQPlayer,356,56,412,2,30,Player A
1306,JointPQPlayer,352,52,404,3,33,Player A
1307,JointPQPlayer,377,52,429,4,25,Player A
1308,JointPQPlayer,363,38,401,0,33,Player A
1309,JointPQPlayer,381,36,417,1,28,Player A
1310,JointPQPlayer,396,31,427,2,25,Player A
1311,JointPQPlayer,357,52,409,5,32,Player A
1312,JointPQPlayer,353,48,401,3,34,Player A
1313,JointPQPlayer,398,38,436,2,22,Player A
1314,JointPQPlayer,370,35,405,1,32,Player A
1315,JointPQPlayer,338,53,391,2,37,Player A
1316,JointPQPlayer,383,33,416,0,28,Player A
1317,JointPQPlayer,204,224,428,30,34,JointPQPlayer
1318,JointPQPlayer,385,35,420,1,27,Player A
1319,JointPQPlayer,373,38,411,1,30,Player A
1320,JointPQPlayer,240,120,360,7,49,Player A
1321,JointPQPlayer,357,47,404,3,33,Player A
1322,JointPQPlayer,385,40,425,3,26,Player A
1323,JointPQPlayer,369,49,418,2,28,Player A
1324,JointPQPlayer,252,132,384,16,44,Player A
1325,JointPQPlayer,254,69,323,0,59,Player A
1326,JointPQPlayer,363,38,401,0,33,Player A
1327,JointPQPlayer,266,66,332,0,56,Player A
1328,JointPQPlayer,286,61,347,0,51,Player A
1329,JointPQPlayer,405,30,435,1,22,Player A
1330,JointPQPlayer,400,35,435,4,23,Player A
1331,JointPQPlayer,370,40,410,0,30,Player A
1332,JointPQPlayer,391,41,432,4,24,Player A
1333,JointPQPlayer,380,50,430,8,26,Player A
1334,JointPQPlayer,354,49,403,2,33,Player A
1335,JointPQPlayer,347,62,409,8,33,Player A
1336,JointPQPlayer,379,39,418,2,28,Player A
1337,JointPQPlayer,339,44,383,0,39,Player A
1338,JointPQPlayer,238,73,311,0,63,Player A
1339,JointPQPlayer,415,25,440,0,20,Player A
1340,JointPQPlayer,283,203,486,37,17,Player A
1341,JointPQPlayer,352,112,464,18,18,Player A
1342,JointPQPlayer,274,64,338,0,54,Player A
1343,JointPQPlayer,375,40,415,2,29,Player A
1344,JointPQPlayer,350,105,455,18,21,Player A
1345,JointPQPlayer,361,76,437,9,24,Player A
1346,JointPQPlayer,385,35,420,1,27,Player A
1347,JointPQPlayer,367,37,404,0,32,Player A
1348,JointPQPlayer,425,25,450,1,17,Player A
1349,JointPQPlayer,306,56,362,0,46,Player A
1350,JointPQPlayer,363,43,406,2,32,Player A
1351,JointPQPlayer,373,43,416,3,29,Player A
1352,JointPQPlayer,369,39,408,1,31,Player A
1353,JointPQPlayer,369,39,408,1,31,Player A
1354,JointPQPlayer,342,47,389,0,37,Player A
1355,JointPQPlayer,343,53,396,1,35,Player A
1356,JointPQPlayer,353,43,396,1,35,Player A
1357,JointPQPlayer,373,43,416,3,29,Player A
1358,JointPQPlayer,371,81,452,15,21,Player A
1359,JointPQPlayer,329,89,418,11,31,Player A
1360,JointPQPlayer,356,46,402,1,33,Player A
1361,JointPQPlayer,363,43,406,2,32,Player A
1362,JointPQPlayer,379,34,413,0,29,Player A
1363,JointPQPlayer,381,36,417,1,28,Player A
1364,JointPQPlayer,376,36,412,2,30,Player A
1365,JointPQPlayer,375,40,415,2,29,Player A
1366,JointPQPlayer,360,60,420,10,30,Player A
1367,JointPQPlayer,362,47,409,2,31,Player A
1368,JointPQPlayer,324,74,398,9,37,Player A
1369,JointPQPlayer,391,31,422,0,26,Player A
1370,JointPQPlayer,391,31,422,0,26,Player A
1371,JointPQPlayer,321,91,412,11,33,Player A
1372,JointPQPlayer,349,44,393,1,36,Player A
1373,JointPQPlayer,365,40,405,1,32,Player A
1374,JointPQPlayer,339,129,468,25,19,Player A
1375,JointPQPlayer,399,29,428,0,24,Player A
1376,JointPQPlayer,379,34,413,0,29,Player A
1377,JointPQPlayer,407,37,444,4,20,Player A
1378,JointPQPlayer,363,43,406,2,32,Player A
1379,JointPQPlayer,367,37,404,0,32,Player A
1380,JointPQPlayer,359,39,398,0,34,Player A
1381,JointPQPlayer,231,81,312,1,63,Player A
1382,JointPQPlayer,375,40,415,2,29,Player A
1383,JointPQPlayer,169,94,263,0,79,Player A
1384,JointPQPlayer,375,35,410,0,30,Player A
1385,JointPQPlayer,371,36,407,0,31,Player A
1386,JointPQPlayer,361,46,407,3,32,Player A
1387,JointPQPlayer,401,31,432,1,23,Player A
1388,JointPQPlayer,363,43,406,2,32,Player A
1389,JointPQPlayer,363,53,416,6,30,Player A
1390,JointPQPlayer,373,38,411,1,30,Player A
1391,JointPQPlayer,262,67,329,0,57,Player A
1392,JointPQPlayer,339,84,423,10,29,Player A
1393,JointPQPlayer,305,130,435,16,27,Player A
1394,JointPQPlayer,332,72,404,6,34,Player A
1395,JointPQPlayer,290,60,350,0,50,Player A
1396,JointPQPlayer,355,40,395,0,35,Player A
1397,JointPQPlayer,355,50,405,1,32,Player A
1398,JointPQPlayer,319,99,418,11,31,Player A
1399,JointPQPlayer,393,33,426,1,25,Player A
1400,JointPQPlayer,333,48,381,1,40,Player A
1401,JointPQPlayer,354,59,413,6,31,Player A
1402,JointPQPlayer,407,32,439,2,21,Player A
1403,JointPQPlayer,385,40,425,3,26,Player A
1404,JointPQPlayer,319,49,368,0,44,Player A
1405,JointPQPlayer,326,66,392,6,38,Player A
1406,JointPQPlayer,367,72,439,8,23,Player A
1407,JointPQPlayer,335,45,380,0,40,Player A
1408,JointPQPlayer,388,33,421,2,27,Player A
1409,JointPQPlayer,374,39,413,0,29,Player A
1410,JointPQPlayer,365,80,445,11,22,Player A
1411,JointPQPlayer,355,40,395,0,35,Player A
1412,JointPQPlayer,329,64,393,4,37,Player A
1413,JointPQPlayer,285,85,370,8,46,Player A
1414,JointPQPlayer,384,49,433,2,23,Player A
1415,JointPQPlayer,373,48,421,5,28,Player A
1416,JointPQPlayer,311,106,417,7,30,Player A
1417,JointPQPlayer,387,32,419,0,27,Player A
1418,JointPQPlayer,390,30,420,1,27,Player A
1419,JointPQPlayer,365,55,420,7,29,Player A
1420,JointPQPlayer,379,34,413,0,29,Player A
1421,JointPQPlayer,373,53,426,7,27,Player A
1422,JointPQPlayer,250,70,320,0,60,Player A
1423,JointPQPlayer,347,42,389,0,37,Player A
1424,JointPQPlayer,336,56,392,3,37,Player A
1425,JointPQPlayer,392,42,434,6,24,Player A
1426,JointPQPlayer,375,35,410,0,30,Player A
1427,JointPQPlayer,418,33,451,5,18,Player A
1428,JointPQPlayer,383,38,421,2,27,Player A
1429,JointPQPlayer,389,34,423,1,26,Player A
1430,JointPQPlayer,369,39,408,1,31,Player A
1431,JointPQPlayer,279,84,363,4,47,Player A
1432,JointPQPlayer,311,51,362,0,46,Player A
1433,JointPQPlayer,327,47,374,0,42,Player A
1434,JointPQPlayer,371,51,422,6,28,Player A
1435,JointPQPlayer,353,63,416,9,31,Player A
1436,JointPQPlayer,335,125,460,23,21,Player A
1437,JointPQPlayer,265,140,405,19,38,Player A
1438,JointPQPlayer,375,35,410,0,30,Player A
1439,JointPQPlayer,339,44,383,0,39,Player A
1440,JointPQPlayer,377,47,424,5,27,Player A
1441,JointPQPlayer,386,46,432,4,24,Player A
1442,JointPQPlayer,340,105,445,17,24,Player A
1443,JointPQPlayer,375,35,410,0,30,Player A
1444,JointPQPlayer,358,48,406,2,32,Player A
1445,JointPQPlayer,353,73,426,7,27,Player A
1446,JointPQPlayer,379,34,413,0,29,Player A
1447,JointPQPlayer,413,28,441,1,20,Player A
1448,JointPQPlayer,355,75,430,8,26,Player A
1449,JointPQPlayer,378,53,431,3,24,Player A
1450,JointPQPlayer,371,41,412,2,30,Player A
1451,JointPQPlayer,339,49,388,2,38,Player A
1452,JointPQPlayer,311,51,362,0,46,Player A
1453,JointPQPlayer,303,168,471,31,20,Player A
1454,JointPQPlayer,389,34,423,1,26,Player A
1455,JointPQPlayer,389,34,423,1,26,Player A
1456,JointPQPlayer,375,40,415,2,29,Player A
1457,JointPQPlayer,375,35,410,0,30,Player A
1458,JointPQPlayer,375,35,410,0,30,Player A
1459,JointPQPlayer,362,42,404,3,33,Player A
1460,JointPQPlayer,362,47,409,2,31,Player A
1461,JointPQPlayer,363,38,401,0,33,Player A
1462,JointPQPlayer,305,65,370,5,45,Player A
1463,JointPQPlayer,302,107,409,17,36,Player A
1464,JointPQPlayer,364,39,403,2,33,Player A
1465,JointPQPlayer,363,48,411,4,31,Player A
1466,JointPQPlayer,409,34,443,3,20,Player A
1467,JointPQPlayer,332,57,389,3,38,Player A
1468,JointPQPlayer,363,38,401,0,33,Player A
1469,JointPQPlayer,338,43,381,1,40,Player A
1470,JointPQPlayer,318,53,371,0,43,Player A
1471,JointPQPlayer,347,57,404,3,33,Player A
1472,JointPQPlayer,341,71,412,5,31,Player A
1473,JointPQPlayer,403,28,431,0,23,Player A
1474,JointPQPlayer,354,64,418,8,30,Player A
1475,JointPQPlayer,345,45,390,1,37,Player A
1476,JointPQPlayer,377,37,414,1,29,Player A
1477,JointPQPlayer,393,33,426,1,25,Player A
1478,JointPQPlayer,383,38,421,2,27,Player A
1479,JointPQPlayer,383,33,416,0,28,Player A
1480,JointPQPlayer,393,33,426,1,25,Player A
1481,JointPQPlayer,383,38,421,2,27,Player A
1482,JointPQPlayer,371,36,407,0,31,Player A
1483,JointPQPlayer,387,37,424,2,26,Player A
1484,JointPQPlayer,270,65,335,0,55,Player A
1485,JointPQPlayer,355,40,395,0,35,Player A
1486,JointPQPlayer,340,60,400,5,35,Player A
1487,JointPQPlayer,375,45,420,1,27,Player A
1488,JointPQPlayer,349,49,398,3,35,Player A
1489,JointPQPlayer,327,107,434,18,28,Player A
1490,JointPQPlayer,369,39,408,1,31,Player A
1491,JointPQPlayer,296,61,357,1,48,Player A
1492,JointPQPlayer,373,38,411,1,30,Player A
1493,JointPQPlayer,335,50,385,2,39,Player A
1494,JointPQPlayer,376,46,422,6,28,Player A
1495,JointPQPlayer,364,49,413,3,30,Player A
1496,JointPQPlayer,317,92,409,11,34,Player A
1497,JointPQPlayer,308,163,471,34,21,Player A
1498,JointPQPlayer,365,95,460,14,18,Player A
1499,JointPQPlayer,339,44,383,0,39,Player A
1500,JointPQPlayer,337,72,409,5,32,Player A
1501,JointPQPlayer,399,34,433,2,23,Player A
1502,JointPQPlayer,381,36,417,1,28,Player A
1503,JointPQPlayer,303,63,366,1,45,Player A
1504,JointPQPlayer,375,35,410,0,30,Player A
1505,JointPQPlayer,371,36,407,0,31,Player A
1506,JointPQPlayer,359,54,413,6,31,Player A
1507,JointPQPlayer,367,42,409,2,31,Player A
1508,JointPQPlayer,389,34,423,1,26,Player A
1509,JointPQPlayer,331,46,377,0,41,Player A
1510,JointPQPlayer,315,60,375,4,43,Player A
1511,JointPQPlayer,376,41,417,1,28,Player A
1512,JointPQPlayer,365,40,405,1,32,Player A
1513,JointPQPlayer,361,41,402,1,33,Player A
1514,JointPQPlayer,366,41,407,3,32,Player A
1515,JointPQPlayer,354,54,408,4,32,Player A
1516,JointPQPlayer,379,34,413,0,29,Player A
1517,JointPQPlayer,327,47,374,0,42,Player A
1518,JointPQPlayer,340,65,405,4,33,Player A
1519,JointPQPlayer,360,40,400,2,34,Player A
1520,JointPQPlayer,352,62,414,4,30,Player A
1521,JointPQPlayer,349,49,398,0,34,Player A
1522,JointPQPlayer,334,69,403,8,35,Player A
1523,JointPQPlayer,349,44,393,1,36,Player A
1524,JointPQPlayer,383,33,416,0,28,Player A
1525,JointPQPlayer,365,45,410,3,31,Player A
1526,JointPQPlayer,361,41,402,1,33,Player A
1527,JointPQPlayer,399,29,428,0,24,Player A
1528,JointPQPlayer,383,38,421,2,27,Player A
1529,JointPQPlayer,327,47,374,0,42,Player A
1530,JointPQPlayer,335,45,380,0,40,Player A
1531,JointPQPlayer,379,34,413,0,29,Player A
1532,JointPQPlayer,323,58,381,4,41,Player A
1533,JointPQPlayer,367,42,409,2,31,Player A
1534,JointPQPlayer,363,38,401,0,33,Player A
1535,JointPQPlayer,397,32,429,1,24,Player A
1536,JointPQPlayer,312,117,429,19,30,Player A
1537,JointPQPlayer,380,55,435,4,23,Player A
1538,JointPQPlayer,369,39,408,1,31,Player A
1539,JointPQPlayer,371,36,407,0,31,Player A
1540,JointPQPlayer,411,31,442,2,20,Player A
1541,JointPQPlayer,392,37,429,4,25,Player A
1542,JointPQPlayer,346,61,407,6,33,Player A
1543,JointPQPlayer,361,46,407,3,32,Player A
1544,JointPQPlayer,270,65,335,0,55,Player A
1545,JointPQPlayer,274,174,448,29,27,Player A
1546,JointPQPlayer,233,128,361,2,47,Player A
1547,JointPQPlayer,278,63,341,0,53,Player A
1548,JointPQPlayer,329,89,418,14,32,Player A
1549,JointPQPlayer,363,38,401,0,33,Player A
1550,JointPQPlayer,361,51,412,2,30,Player A
1551,JointPQPlayer,379,34,413,0,29,Player A
1552,JointPQPlayer,343,48,391,2,37,Player A
1553,JointPQPlayer,316,61,377,3,42,Player A
1554,JointPQPlayer,357,57,414,7,31,Player A
1555,JointPQPlayer,344,49,393,1,36,Player A
1556,JointPQPlayer,353,43,396,1,35,Player A
1557,JointPQPlayer,321,121,442,23,27,Player A
1558,JointPQPlayer,283,238,521,54,11,Player A
1559,JointPQPlayer,370,40,410,0,30,Player A
1560,JointPQPlayer,341,51,392,3,37,Player A
1561,JointPQPlayer,348,58,406,2,32,Player A
1562,JointPQPlayer,343,53,396,1,35,Player A
1563,JointPQPlayer,381,36,417,1,28,Player A
1564,JointPQPlayer,368,73,441,10,23,Player A
1565,JointPQPlayer,330,50,380,0,40,Player A
1566,JointPQPlayer,345,65,410,9,33,Player A
1567,JointPQPlayer,325,110,435,16,27,Player A
1568,JointPQPlayer,349,44,393,1,36,Player A
1569,JointPQPlayer,339,54,393,1,36,Player A
1570,JointPQPlayer,242,72,314,0,62,Player A
1571,JointPQPlayer,398,28,426,1,25,Player A
1572,JointPQPlayer,403,28,431,0,23,Player A
1573,JointPQPlayer,320,60,380,3,41,Player A
1574,JointPQPlayer,347,42,389,0,37,Player A
1575,JointPQPlayer,379,34,413,0,29,Player A
1576,JointPQPlayer,365,50,415,5,30,Player A
1577,JointPQPlayer,395,30,425,0,25,Player A
1578,JointPQPlayer,355,50,405,4,33,Player A
1579,JointPQPlayer,269,69,338,0,54,Player A
1580,JointPQPlayer,367,37,404,0,32,Player A
1581,JointPQPlayer,365,40,405,1,32,Player A
1582,JointPQPlayer,401,31,432,1,23,Player A
1583,JointPQPlayer,399,29,428,0,24,Player A
1584,JointPQPlayer,222,77,299,0,67,Player A
1585,JointPQPlayer,311,116,427,20,31,Player A
1586,JointPQPlayer,299,54,353,0,49,Player A
1587,JointPQPlayer,287,57,344,0,52,Player A
1588,JointPQPlayer,387,32,419,0,27,Player A
1589,JointPQPlayer,383,33,416,0,28,Player A
1590,JointPQPlayer,383,33,416,0,28,Player A
1591,JointPQPlayer,377,42,419,3,28,Player A
1592,JointPQPlayer,417,27,444,1,19,Player A
1593,JointPQPlayer,377,37,414,1,29,Player A
1594,JointPQPlayer,329,49,378,1,41,Player A
1595,JointPQPlayer,379,39,418,2,28,Player A
1596,JointPQPlayer,385,35,420,1,27,Player A
1597,JointPQPlayer,335,125,460,23,21,Player A
1598,JointPQPlayer,307,57,364,2,46,Player A
1599,JointPQPlayer,184,94,278,0,74,Player A
1600,JointPQPlayer,363,43,406,2,32,Player A
1601,JointPQPlayer,381,36,417,1,28,Player A
1602,JointPQPlayer,336,101,437,15,26,Player A
1603,JointPQPlayer,385,35,420,1,27,Player A
1604,JointPQPlayer,338,68,406,8,34,Player A
1605,JointPQPlayer,371,51,422,3,27,Player A
1606,JointPQPlayer,336,56,392,3,37,Player A
1607,JointPQPlayer,292,102,394,14,40,Player A
1608,JointPQPlayer,393,33,426,1,25,Player A
1609,JointPQPlayer,365,40,405,1,32,Player A
1610,JointPQPlayer,393,33,426,1,25,Player A
1611,JointPQPlayer,379,34,413,0,29,Player A
1612,JointPQPlayer,359,89,448,17,23,Player A
1613,JointPQPlayer,343,78,421,8,29,Player A
1614,JointPQPlayer,325,50,375,1,42,Player A
1615,JointPQPlayer,343,43,386,0,38,Player A
1616,JointPQPlayer,367,37,404,0,32,Player A
1617,JointPQPlayer,375,35,410,0,30,Player A
1618,JointPQPlayer,382,37,419,3,28,Player A
1619,JointPQPlayer,353,48,401,3,34,Player A
1620,JointPQPlayer,344,69,413,9,32,Player A
1621,JointPQPlayer,398,28,426,1,25,Player A
1622,JointPQPlayer,393,33,426,1,25,Player A
1623,JointPQPlayer,366,51,417,1,28,Player A
1624,JointPQPlayer,371,36,407,0,31,Player A
1625,JointPQPlayer,367,62,429,10,27,Player A
1626,JointPQPlayer,377,37,414,1,29,Player A
1627,JointPQPlayer,353,43,396,1,35,Player A
1628,JointPQPlayer,385,35,420,1,27,Player A
1629,JointPQPlayer,373,38,411,1,30,Player A
1630,JointPQPlayer,371,36,407,0,31,Player A
1631,JointPQPlayer,383,33,416,0,28,Player A
1632,JointPQPlayer,377,37,414,1,29,Player A
1633,JointPQPlayer,355,60,415,8,31,Player A
1634,JointPQPlayer,323,83,406,11,35,Player A
1635,JointPQPlayer,371,36,407,0,31,Player A
1636,JointPQPlayer,383,38,421,2,27,Player A
1637,JointPQPlayer,371,46,417,4,29,Player A
1638,JointPQPlayer,343,53,396,4,36,Player A
1639,JointPQPlayer,369,39,408,1,31,Player A
1640,JointPQPlayer,338,98,436,11,25,Player A
1641,JointPQPlayer,331,46,377,0,41,Player A
1642,JointPQPlayer,371,46,417,4,29,Player A
1643,JointPQPlayer,363,48,411,1,30,Player A
1644,JointPQPlayer,295,115,410,18,36,Player A
1645,JointPQPlayer,339,79,418,5,29,Player A
1646,JointPQPlayer,324,59,383,3,40,Player A
1647,JointPQPlayer,389,34,423,1,26,Player A
1648,JointPQPlayer,377,42,419,3,28,Player A
1649,JointPQPlayer,401,31,432,1,23,Player A
1650,JointPQPlayer,343,43,386,0,38,Player A
1651,JointPQPlayer,379,34,413,0,29,Player A
1652,JointPQPlayer,324,134,458,21,21,Player A
1653,JointPQPlayer,329,89,418,11,31,Player A
1654,JointPQPlayer,393,38,431,3,24,Player A
1655,JointPQPlayer,387,37,424,2,26,Player A
1656,JointPQPlayer,383,33,416,0,28,Player A
1657,JointPQPlayer,343,43,386,0,38,Player A
1658,JointPQPlayer,393,33,426,1,25,Player A
1659,JointPQPlayer,380,40,420,4,28,Player A
1660,JointPQPlayer,374,54,428,3,25,Player A
1661,JointPQPlayer,355,40,395,0,35,Player A
1662,JointPQPlayer,385,35,420,1,27,Player A
1663,JointPQPlayer,367,42,409,2,31,Player A
1664,JointPQPlayer,366,46,412,5,31,Player A
1665,JointPQPlayer,323,73,396,7,37,Player A
1666,JointPQPlayer,363,38,401,0,33,Player A
1667,JointPQPlayer,383,33,416,0,28,Player A
1668,JointPQPlayer,343,43,386,0,38,Player A
1669,JointPQPlayer,385,35,420,1,27,Player A
1670,JointPQPlayer,349,44,393,1,36,Player A
1671,JointPQPlayer,379,34,413,0,29,Player A
1672,JointPQPlayer,377,37,414,1,29,Player A
1673,JointPQPlayer,346,56,402,4,34,Player A
1674,JointPQPlayer,413,28,441,1,20,Player A
1675,JointPQPlayer,379,34,413,0,29,Player A
1676,JointPQPlayer,334,59,393,4,37,Player A
1677,JointPQPlayer,371,36,407,0,31,Player A
1678,JointPQPlayer,387,37,424,2,26,Player A
1679,JointPQPlayer,351,41,392,0,36,Player A
1680,JointPQPlayer,381,36,417,1,28,Player A
1681,JointPQPlayer,361,51,412,5,31,Player A
1682,JointPQPlayer,362,92,454,14,20,Player A
1683,JointPQPlayer,256,151,407,15,36,Player A
1684,JointPQPlayer,355,40,395,0,35,Player A
1685,JointPQPlayer,350,55,405,4,33,Player A
1686,JointPQPlayer,353,48,401,3,34,Player A
1687,JointPQPlayer,386,51,437,3,22,Player A
1688,JointPQPlayer,301,146,447,22,25,Player A
1689,JointPQPlayer,290,175,465,31,22,Player A
1690,JointPQPlayer,379,44,423,4,27,Player A
1691,JointPQPlayer,363,43,406,2,32,Player A
1692,JointPQPlayer,394,39,433,5,24,Player A
1693,JointPQPlayer,370,40,410,0,30,Player A
1694,JointPQPlayer,335,45,380,0,40,Player A
1695,JointPQPlayer,373,48,421,5,28,Player A
1696,JointPQPlayer,319,89,408,10,34,Player A
1697,JointPQPlayer,357,42,399,1,34,Player A
1698,JointPQPlayer,345,45,390,1,37,Player A
1699,JointPQPlayer,301,81,382,8,42,Player A
1700,JointPQPlayer,329,99,428,12,28,Player A
1701,JointPQPlayer,373,48,421,5,28,Player A
1702,JointPQPlayer,360,75,435,10,25,Player A
1703,JointPQPlayer,327,47,374,0,42,Player A
1704,JointPQPlayer,319,54,373,2,43,Player A
1705,JointPQPlayer,344,54,398,3,35,Player A
1706,JointPQPlayer,307,77,384,7,41,Player A
1707,JointPQPlayer,367,47,414,1,29,Player A
1708,JointPQPlayer,391,36,427,2,25,Player A
1709,JointPQPlayer,365,40,405,1,32,Player A
1710,JointPQPlayer,378,38,416,3,29,Player A
1711,JointPQPlayer,334,49,383,0,39,Player A
1712,JointPQPlayer,361,46,407,3,32,Player A
1713,JointPQPlayer,365,40,405,1,32,Player A
1714,JointPQPlayer,320,65,385,5,40,Player A
1715,JointPQPlayer,375,40,415,2,29,Player A
1716,JointPQPlayer,357,57,414,7,31,Player A
1717,JointPQPlayer,325,70,395,3,36,Player A
1718,JointPQPlayer,376,36,412,2,30,Player A
1719,JointPQPlayer,334,64,398,3,35,Player A
1720,JointPQPlayer,333,53,386,3,39,Player A
1721,JointPQPlayer,380,45,425,3,26,Player A
1722,JointPQPlayer,349,44,393,1,36,Player A
1723,JointPQPlayer,360,40,400,2,34,Player A
1724,JointPQPlayer,155,255,410,24,38,JointPQPlayer
1725,JointPQPlayer,372,32,404,0,32,Player A
1726,JointPQPlayer,377,37,414,1,29,Player A
1727,JointPQPlayer,341,46,387,1,38,Player A
1728,JointPQPlayer,319,59,378,1,41,Player A
1729,JointPQPlayer,375,40,415,2,29,Player A
1730,JointPQPlayer,317,117,434,12,26,Player A
1731,JointPQPlayer,379,49,428,6,26,Player A
1732,JointPQPlayer,345,80,425,12,29,Player A
1733,JointPQPlayer,363,43,406,2,32,Player A
1734,JointPQPlayer,370,55,425,3,26,Player A
1735,JointPQPlayer,363,43,406,2,32,Player A
1736,JointPQPlayer,343,43,386,0,38,Player A
1737,JointPQPlayer,312,67,379,5,42,Player A
1738,JointPQPlayer,380,45,425,6,27,Player A
1739,JointPQPlayer,362,52,414,4,30,Player A
1740,JointPQPlayer,349,44,393,1,36,Player A
1741,JointPQPlayer,371,36,407,0,31,Player A
1742,JointPQPlayer,336,96,432,13,27,Player A
1743,JointPQPlayer,369,49,418,2,28,Player A
1744,JointPQPlayer,375,55,430,8,26,Player A
1745,JointPQPlayer,403,28,431,0,23,Player A
1746,JointPQPlayer,353,43,396,1,35,Player A
1747,JointPQPlayer,189,89,278,0,74,Player A
1748,JointPQPlayer,371,36,407,0,31,Player A
1749,JointPQPlayer,307,52,359,0,47,Player A
1750,JointPQPlayer,369,39,408,1,31,Player A
1751,JointPQPlayer,363,63,426,4,26,Player A
1752,JointPQPlayer,339,44,383,0,39,Player A
1753,JointPQPlayer,371,36,407,0,31,Player A
1754,JointPQPlayer,385,35,420,1,27,Player A
1755,JointPQPlayer,382,42,424,5,27,Player A
1756,JointPQPlayer,297,102,399,7,36,Player A
1757,JointPQPlayer,319,49,368,0,44,Player A
1758,JointPQPlayer,348,48,396,1,35,Player A
1759,JointPQPlayer,349,44,393,1,36,Player A
1760,JointPQPlayer,338,103,441,16,25,Player A
1761,JointPQPlayer,329,59,388,2,38,Player A
1762,JointPQPlayer,374,44,418,5,29,Player A
1763,JointPQPlayer,340,60,400,5,35,Player A
1764,JointPQPlayer,375,45,420,4,28,Player A
1765,JointPQPlayer,324,59,383,3,40,Player A
1766,JointPQPlayer,396,31,427,2,25,Player A
1767,JointPQPlayer,371,41,412,2,30,Player A
1768,JointPQPlayer,350,70,420,13,31,Player A
1769,JointPQPlayer,309,64,373,2,43,Player A
1770,JointPQPlayer,375,35,410,0,30,Player A
1771,JointPQPlayer,394,29,423,1,26,Player A
1772,JointPQPlayer,385,35,420,1,27,Player A
1773,JointPQPlayer,395,35,430,2,24,Player A
1774,JointPQPlayer,356,46,402,1,33,Player A
1775,JointPQPlayer,385,35,420,1,27,Player A
1776,JointPQPlayer,363,43,406,2,32,Player A
1777,JointPQPlayer,364,44,408,1,31,Player A
1778,JointPQPlayer,359,39,398,0,34,Player A
1779,JointPQPlayer,375,45,420,4,28,Player A
1780,JointPQPlayer,347,42,389,0,37,Player A
1781,JointPQPlayer,359,39,398,0,34,Player A
1782,JointPQPlayer,347,42,389,0,37,Player A
1783,JointPQPlayer,355,40,395,0,35,Player A
1784,JointPQPlayer,343,43,386,0,38,Player A
1785,JointPQPlayer,395,30,425,0,25,Player A
1786,JointPQPlayer,347,42,389,0,37,Player A
1787,JointPQPlayer,342,102,444,13,23,Player A
1788,JointPQPlayer,321,121,442,20,26,Player A
1789,JointPQPlayer,310,55,365,0,45,Player A
1790,JointPQPlayer,242,207,449,27,26,Player A
1791,JointPQPlayer,325,60,385,2,39,Player A
1792,JointPQPlayer,375,50,425,6,27,Player A
1793,JointPQPlayer,306,56,362,0,46,Player A
1794,JointPQPlayer,377,42,419,3,28,Player A
1795,JointPQPlayer,343,43,386,0,38,Player A
1796,JointPQPlayer,385,35,420,1,27,Player A
1797,JointPQPlayer,359,39,398,0,34,Player A
1798,JointPQPlayer,282,62,344,0,52,Player A
1799,JointPQPlayer,342,57,399,4,35,Player A
1800,JointPQPlayer,367,37,404,0,32,Player A
1801,JointPQPlayer,373,48,421,2,27,Player A
1802,JointPQPlayer,312,62,374,3,43,Player A
1803,JointPQPlayer,375,75,450,10,20,Player A
1804,JointPQPlayer,344,99,443,15,24,Player A
1805,JointPQPlayer,331,71,402,7,35,Player A
1806,JointPQPlayer,300,60,360,1,47,Player A
1807,JointPQPlayer,392,37,429,4,25,Player A
1808,JointPQPlayer,199,94,293,0,69,Player A
1809,JointPQPlayer,375,40,415,2,29,Player A
1810,JointPQPlayer,391,31,422,0,26,Player A
1811,JointPQPlayer,327,47,374,0,42,Player A
1812,JointPQPlayer,413,28,441,1,20,Player A
1813,JointPQPlayer,343,43,386,0,38,Player A
1814,JointPQPlayer,403,33,436,2,22,Player A
1815,JointPQPlayer,339,44,383,0,39,Player A
1816,JointPQPlayer,367,42,409,2,31,Player A
1817,JointPQPlayer,397,32,429,1,24,Player A
1818,JointPQPlayer,373,38,411,1,30,Player A
1819,JointPQPlayer,367,37,404,0,32,Player A
1820,JointPQPlayer,343,43,386,0,38,Player A
1821,JointPQPlayer,400,40,440,6,22,Player A
1822,JointPQPlayer,384,39,423,4,27,Player A
1823,JointPQPlayer,400,35,435,1,22,Player A
1824,JointPQPlayer,378,33,411,1,30,Player A
1825,JointPQPlayer,381,46,427,5,26,Player A
1826,JointPQPlayer,403,33,436,2,22,Player A
1827,JointPQPlayer,362,47,409,2,31,Player A
1828,JointPQPlayer,355,50,405,1,32,Player A
1829,JointPQPlayer,205,325,530,63,11,JointPQPlayer
1830,JointPQPlayer,362,52,414,4,30,Player A
1831,JointPQPlayer,376,46,422,6,28,Player A
1832,JointPQPlayer,385,35,420,1,27,Player A
1833,JointPQPlayer,361,41,402,1,33,Player A
1834,JointPQPlayer,395,35,430,2,24,Player A
1835,JointPQPlayer,383,48,431,3,24,Player A
1836,JointPQPlayer,343,53,396,4,36,Player A
1837,JointPQPlayer,351,41,392,0,36,Player A
1838,JointPQPlayer,347,42,389,0,37,Player A
1839,JointPQPlayer,375,40,415,2,29,Player A
1840,JointPQPlayer,380,50,430,8,26,Player A
1841,JointPQPlayer,334,84,418,8,30,Player A
1842,JointPQPlayer,351,41,392,0,36,Player A
1843,JointPQPlayer,305,140,445,26,27,Player A
1844,JointPQPlayer,365,45,410,3,31,Player A
1845,JointPQPlayer,318,58,376,2,42,Player A
1846,JointPQPlayer,359,44,403,2,33,Player A
1847,JointPQPlayer,416,31,447,4,19,Player A
1848,JointPQPlayer,338,68,406,8,34,Player A
1849,JointPQPlayer,411,26,437,0,21,Player A
1850,JointPQPlayer,226,76,302,0,66,Player A
1851,JointPQPlayer,337,57,394,5,37,Player A
1852,JointPQPlayer,319,59,378,1,41,Player A
1853,JointPQPlayer,250,70,320,0,60,Player A
1854,JointPQPlayer,373,38,411,1,30,Player A
1855,JointPQPlayer,371,46,417,1,28,Player A
1856,JointPQPlayer,376,46,422,6,28,Player A
1857,JointPQPlayer,381,41,422,3,27,Player A
1858,JointPQPlayer,302,57,359,0,47,Player A
1859,JointPQPlayer,351,41,392,0,36,Player A
1860,JointPQPlayer,361,46,407,3,32,Player A
1861,JointPQPlayer,390,35,425,3,26,Player A
1862,JointPQPlayer,373,48,421,5,28,Player A
1863,JointPQPlayer,363,38,401,0,33,Player A
1864,JointPQPlayer,400,30,430,2,24,Player A
1865,JointPQPlayer,380,45,425,3,26,Player A
1866,JointPQPlayer,394,34,428,3,25,Player A
1867,JointPQPlayer,365,50,415,5,30,Player A
1868,JointPQPlayer,376,41,417,4,29,Player A
1869,JointPQPlayer,374,69,443,9,22,Player A
1870,JointPQPlayer,380,35,415,2,29,Player A
1871,JointPQPlayer,345,60,405,4,33,Player A
1872,JointPQPlayer,344,69,413,6,31,Player A
1873,JointPQPlayer,357,52,409,2,31,Player A
1874,JointPQPlayer,338,43,381,1,40,Player A
1875,JointPQPlayer,382,47,429,7,26,Player A
1876,JointPQPlayer,391,36,427,2,25,Player A
1877,JointPQPlayer,339,114,453,19,22,Player A
1878,JointPQPlayer,348,58,406,5,33,Player A
1879,JointPQPlayer,393,33,426,1,25,Player A
1880,JointPQPlayer,389,39,428,3,25,Player A
1881,JointPQPlayer,367,37,404,0,32,Player A
1882,JointPQPlayer,383,33,416,0,28,Player A
1883,JointPQPlayer,365,40,405,1,32,Player A
1884,JointPQPlayer,277,82,359,3,48,Player A
1885,JointPQPlayer,242,72,314,0,62,Player A
1886,JointPQPlayer,366,61,427,5,26,Player A
1887,JointPQPlayer,327,142,469,23,18,Player A
1888,JointPQPlayer,383,33,416,0,28,Player A
1889,JointPQPlayer,377,37,414,1,29,Player A
1890,JointPQPlayer,268,128,396,19,41,Player A
1891,JointPQPlayer,351,41,392,0,36,Player A
1892,JointPQPlayer,383,33,416,0,28,Player A
1893,JointPQPlayer,371,36,407,0,31,Player A
1894,JointPQPlayer,363,38,401,0,33,Player A
1895,JointPQPlayer,254,244,498,43,15,Player A
1896,JointPQPlayer,357,72,429,1,24,Player A
1897,JointPQPlayer,363,38,401,0,33,Player A
1898,JointPQPlayer,314,54,368,0,44,Player A
1899,JointPQPlayer,353,43,396,1,35,Player A
1900,JointPQPlayer,372,57,429,7,26,Player A
1901,JointPQPlayer,373,73,446,9,21,Player A
1902,JointPQPlayer,373,38,411,1,30,Player A
1903,JointPQPlayer,403,33,436,2,22,Player A
1904,JointPQPlayer,405,30,435,1,22,Player A
1905,JointPQPlayer,379,34,413,0,29,Player A
1906,JointPQPlayer,283,68,351,1,50,Player A
1907,JointPQPlayer,380,40,420,4,28,Player A
1908,JointPQPlayer,354,54,408,4,32,Player A
1909,JointPQPlayer,382,37,419,3,28,Player A
1910,JointPQPlayer,313,58,371,0,43,Player A
1911,JointPQPlayer,351,41,392,0,36,Player A
1912,JointPQPlayer,311,51,362,0,46,Player A
1913,JointPQPlayer,395,35,430,2,24,Player A
1914,JointPQPlayer,379,39,418,2,28,Player A
1915,JointPQPlayer,405,30,435,1,22,Player A
1916,JointPQPlayer,355,40,395,0,35,Player A
1917,JointPQPlayer,381,46,427,5,26,Player A
1918,JointPQPlayer,362,47,409,2,31,Player A
1919,JointPQPlayer,342,47,389,0,37,Player A
1920,JointPQPlayer,344,84,428,12,28,Player A
1921,JointPQPlayer,378,53,431,6,25,Player A
1922,JointPQPlayer,354,44,398,0,34,Player A
1923,JointPQPlayer,409,29,438,1,21,Player A
1924,JointPQPlayer,349,44,393,1,36,Player A
1925,JointPQPlayer,382,32,414,1,29,Player A
1926,JointPQPlayer,378,38,416,0,28,Player A
1927,JointPQPlayer,410,25,435,1,22,Player A
1928,JointPQPlayer,387,37,424,2,26,Player A
1929,JointPQPlayer,313,78,391,8,39,Player A
1930,JointPQPlayer,348,48,396,1,35,Player A
1931,JointPQPlayer,363,48,411,4,31,Player A
1932,JointPQPlayer,379,34,413,0,29,Player A
1933,JointPQPlayer,364,59,423,10,29,Player A
1934,JointPQPlayer,363,43,406,2,32,Player A
1935,JointPQPlayer,333,58,391,5,38,Player A
1936,JointPQPlayer,319,49,368,0,44,Player A
1937,JointPQPlayer,381,46,427,5,26,Player A
1938,JointPQPlayer,347,87,434,15,27,Player A
1939,JointPQPlayer,371,36,407,0,31,Player A
1940,JointPQPlayer,379,54,433,8,25,Player A
1941,JointPQPlayer,352,92,444,13,23,Player A
1942,JointPQPlayer,389,34,423,1,26,Player A
1943,JointPQPlayer,365,40,405,1,32,Player A
1944,JointPQPlayer,375,40,415,2,29,Player A
1945,JointPQPlayer,361,41,402,1,33,Player A
1946,JointPQPlayer,357,82,439,11,24,Player A
1947,JointPQPlayer,262,67,329,0,57,Player A
1948,JointPQPlayer,359,79,438,10,24,Player A
1949,JointPQPlayer,383,38,421,2,27,Player A
1950,JointPQPlayer,267,92,359,3,48,Player A
1951,JointPQPlayer,387,32,419,0,27,Player A
1952,JointPQPlayer,254,69,323,0,59,Player A
1953,JointPQPlayer,363,43,406,2,32,Player A
1954,JointPQPlayer,405,30,435,1,22,Player A
1955,JointPQPlayer,321,171,492,40,16,Player A
1956,JointPQPlayer,287,162,449,12,21,Player A
1957,JointPQPlayer,415,25,440,0,20,Player A
1958,JointPQPlayer,381,46,427,5,26,Player A
1959,JointPQPlayer,319,64,383,3,40,Player A
1960,JointPQPlayer,379,34,413,0,29,Player A
1961,JointPQPlayer,357,42,399,1,34,Player A
1962,JointPQPlayer,286,66,352,2,50,Player A
1963,JointPQPlayer,363,38,401,0,33,Player A
1964,JointPQPlayer,359,39,398,0,34,Player A
1965,JointPQPlayer,389,34,423,1,26,Player A
1966,JointPQPlayer,282,62,344,0,52,Player A
1967,JointPQPlayer,335,45,380,0,40,Player A
1968,JointPQPlayer,310,60,370,2,44,Player A
1969,JointPQPlayer,377,37,414,1,29,Player A
1970,JointPQPlayer,331,46,377,0,41,Player A
1971,JointPQPlayer,346,46,392,0,36,Player A
1972,JointPQPlayer,243,258,501,55,18,JointPQPlayer
1973,JointPQPlayer,356,46,402,1,33,Player A
1974,JointPQPlayer,335,45,380,0,40,Player A
1975,JointPQPlayer,344,44,388,2,38,Player A
1976,JointPQPlayer,366,46,412,2,30,Player A
1977,JointPQPlayer,386,31,417,1,28,Player A
1978,JointPQPlayer,369,44,413,3,30,Player A
1979,JointPQPlayer,330,55,385,2,39,Player A
1980,JointPQPlayer,375,35,410,0,30,Player A
1981,JointPQPlayer,391,31,422,0,26,Player A
1982,JointPQPlayer,409,29,438,1,21,Player A
1983,JointPQPlayer,343,43,386,0,38,Player A
1984,JointPQPlayer,393,38,431,3,24,Player A
1985,JointPQPlayer,391,31,422,0,26,Player A
1986,JointPQPlayer,367,37,404,0,32,Player A
1987,JointPQPlayer,369,39,408,1,31,Player A
1988,JointPQPlayer,334,59,393,4,37,Player A
1989,JointPQPlayer,179,119,298,5,69,Player A
1990,JointPQPlayer,395,30,425,0,25,Player A
1991,JointPQPlayer,352,52,404,3,33,Player A
1992,JointPQPlayer,363,53,416,6,30,Player A
1993,JointPQPlayer,351,41,392,0,36,Player A
1994,JointPQPlayer,249,244,493,47,18,Player A
1995,JointPQPlayer,180,170,350,3,51,Player A
1996,JointPQPlayer,293,68,361,2,47,Player A
1997,JointPQPlayer,386,41,427,5,26,Player A
1998,JointPQPlayer,287,67,354,1,49,Player A
1999,JointPQPlayer,377,37,414,1,29,Player A
2000,JointPQPlayer,357,57,414,7,31,Player A
2001,JointPQPlayer,322,52,374,0,42,Player A
2002,JointPQPlayer,347,42,389,0,37,Player A
2003,JointPQPlayer,391,31,422,0,26,Player A
2004,JointPQPlayer,373,38,411,1,30,Player A
2005,JointPQPlayer,347,42,389,0,37,Player A
2006,JointPQPlayer,383,33,416,0,28,Player A
2007,JointPQPlayer,354,59,413,9,32,Player A
2008,JointPQPlayer,313,83,396,7,37,Player A
2009,JointPQPlayer,393,33,426,1,25,Player A
2010,JointPQPlayer,367,42,409,2,31,Player A
2011,JointPQPlayer,387,32,419,0,27,Player A
2012,JointPQPlayer,381,36,417,1,28,Player A
2013,JointPQPlayer,321,61,382,2,40,Player A
2014,JointPQPlayer,344,104,448,17,23,Player A
2015,JointPQPlayer,381,36,417,1,28,Player A
2016,JointPQPlayer,319,49,368,0,44,Player A
2017,JointPQPlayer,313,143,456,25,23,Player A
2018,JointPQPlayer,316,56,372,1,43,Player A
2019,JointPQPlayer,238,73,311,0,63,Player A
2020,JointPQPlayer,374,39,413,0,29,Player A
2021,JointPQPlayer,328,58,386,3,39,Player A
2022,JointPQPlayer,404,29,433,2,23,Player A
2023,JointPQPlayer,386,36,422,0,26,Player A
2024,JointPQPlayer,339,54,393,1,36,Player A
2025,JointPQPlayer,380,45,425,6,27,Player A
2026,JointPQPlayer,388,48,436,5,23,Player A
2027,JointPQPlayer,402,27,429,1,24,Player A
2028,JointPQPlayer,366,41,407,0,31,Player A
2029,JointPQPlayer,365,40,405,1,32,Player A
2030,JointPQPlayer,349,44,393,1,36,Player A
2031,JointPQPlayer,343,43,386,0,38,Player A
2032,JointPQPlayer,348,48,396,1,35,Player A
2033,JointPQPlayer,355,40,395,0,35,Player A
2034,JointPQPlayer,361,41,402,1,33,Player A
2035,JointPQPlayer,363,43,406,2,32,Player A
2036,JointPQPlayer,379,34,413,0,29,Player A
2037,JointPQPlayer,357,42,399,1,34,Player A
2038,JointPQPlayer,367,37,404,0,32,Player A
2039,JointPQPlayer,363,38,401,0,33,Player A
2040,JointPQPlayer,359,54,413,6,31,Player A
2041,JointPQPlayer,365,40,405,1,32,Player A
2042,JointPQPlayer,330,90,420,13,31,Player A
2043,JointPQPlayer,389,39,428,3,25,Player A
2044,JointPQPlayer,363,38,401,0,33,Player A
2045,JointPQPlayer,364,44,408,1,31,Player A
2046,JointPQPlayer,343,73,416,6,30,Player A
2047,JointPQPlayer,334,69,403,8,35,Player A
2048,JointPQPlayer,350,50,400,2,34,Player A
2049,JointPQPlayer,372,42,414,1,29,Player A
2050,JointPQPlayer,383,33,416,0,28,Player A
2051,JointPQPlayer,228,173,401,21,40,Player A
2052,JointPQPlayer,326,171,497,30,11,Player A
2053,JointPQPlayer,352,52,404,3,33,Player A
2054,JointPQPlayer,386,41,427,5,26,Player A
2055,JointPQPlayer,330,60,390,4,38,Player A
2056,JointPQPlayer,387,32,419,0,27,Player A
2057,JointPQPlayer,355,45,400,2,34,Player A
2058,JointPQPlayer,305,125,430,17,29,Player A
2059,JointPQPlayer,365,40,405,1,32,Player A
2060,JointPQPlayer,365,40,405,1,32,Player A
2061,JointPQPlayer,367,37,404,0,32,Player A
2062,JointPQPlayer,367,37,404,0,32,Player A
2063,JointPQPlayer,385,35,420,1,27,Player A
2064,JointPQPlayer,387,32,419,0,27,Player A
2065,JointPQPlayer,354,54,408,7,33,Player A
2066,JointPQPlayer,356,51,407,3,32,Player A
2067,JointPQPlayer,327,47,374,0,42,Player A
2068,JointPQPlayer,384,39,423,4,27,Player A
2069,JointPQPlayer,402,37,439,5,22,Player A
2070,JointPQPlayer,346,46,392,0,36,Player A
2071,JointPQPlayer,383,33,416,0,28,Player A
2072,JointPQPlayer,367,47,414,4,30,Player A
2073,JointPQPlayer,362,42,404,0,32,Player A
2074,JointPQPlayer,359,49,408,4,32,Player A
2075,JointPQPlayer,342,47,389,0,37,Player A
2076,JointPQPlayer,343,43,386,0,38,Player A
2077,JointPQPlayer,353,43,396,1,35,Player A
2078,JointPQPlayer,368,38,406,2,32,Player A
2079,JointPQPlayer,273,78,351,1,50,Player A
2080,JointPQPlayer,348,58,406,2,32,Player A
2081,JointPQPlayer,355,40,395,0,35,Player A
2082,JointPQPlayer,376,31,407,0,31,Player A
2083,JointPQPlayer,365,50,415,5,30,Player A
2084,JointPQPlayer,367,37,404,0,32,Player A
2085,JointPQPlayer,351,41,392,0,36,Player A
2086,JointPQPlayer,359,39,398,0,34,Player A
2087,JointPQPlayer,363,38,401,0,33,Player A
2088,JointPQPlayer,359,44,403,2,33,Player A
2089,JointPQPlayer,361,41,402,1,33,Player A
2090,JointPQPlayer,377,47,424,5,27,Player A
2091,JointPQPlayer,361,51,412,5,31,Player A
2092,JointPQPlayer,379,34,413,0,29,Player A
2093,JointPQPlayer,399,29,428,0,24,Player A
2094,JointPQPlayer,377,42,419,3,28,Player A
2095,JointPQPlayer,383,38,421,2,27,Player A
2096,JointPQPlayer,355,40,395,0,35,Player A
2097,JointPQPlayer,395,30,425,0,25,Player A
2098,JointPQPlayer,255,245,500,45,15,Player A
2099,JointPQPlayer,353,83,436,2,22,Player A
2100,JointPQPlayer,282,62,344,0,52,Player A
2101,JointPQPlayer,262,67,329,0,57,Player A
2102,JointPQPlayer,365,40,405,1,32,Player A
2103,JointPQPlayer,340,110,450,19,23,Player A
2104,JointPQPlayer,318,98,416,12,32,Player A
2105,JointPQPlayer,369,39,408,1,31,Player A
2106,JointPQPlayer,330,50,380,0,40,Player A
2107,JointPQPlayer,391,36,427,2,25,Player A
2108,JointPQPlayer,355,80,435,10,25,Player A
2109,JointPQPlayer,393,43,436,5,23,Player A
2110,JointPQPlayer,368,43,411,4,31,Player A
2111,JointPQPlayer,339,149,488,33,15,Player A
2112,JointPQPlayer,389,34,423,1,26,Player A
2113,JointPQPlayer,388,58,446,6,20,Player A
2114,JointPQPlayer,381,46,427,2,25,Player A
2115,JointPQPlayer,355,40,395,0,35,Player A
2116,JointPQPlayer,387,32,419,0,27,Player A
2117,JointPQPlayer,347,42,389,0,37,Player A
2118,JointPQPlayer,341,46,387,1,38,Player A
2119,JointPQPlayer,377,37,414,1,29,Player A
2120,JointPQPlayer,383,38,421,2,27,Player A
2121,JointPQPlayer,363,38,401,0,33,Player A
2122,JointPQPlayer,367,37,404,0,32,Player A
2123,JointPQPlayer,378,38,416,3,29,Player A
2124,JointPQPlayer,323,58,381,1,40,Player A
2125,JointPQPlayer,398,33,431,3,24,Player A
2126,JointPQPlayer,303,68,371,3,44,Player A
2127,JointPQPlayer,378,58,436,8,24,Player A
2128,JointPQPlayer,325,80,405,7,34,Player A
2129,JointPQPlayer,400,30,430,2,24,Player A
2130,JointPQPlayer,393,38,431,3,24,Player A
2131,JointPQPlayer,373,43,416,3,29,Player A
2132,JointPQPlayer,387,42,429,4,25,Player A
2133,JointPQPlayer,368,33,401,0,33,Player A
2134,JointPQPlayer,379,34,413,0,29,Player A
2135,JointPQPlayer,318,53,371,0,43,Player A
2136,JointPQPlayer,387,42,429,4,25,Player A
2137,JointPQPlayer,359,44,403,2,33,Player A
2138,JointPQPlayer,369,39,408,1,31,Player A
2139,JointPQPlayer,381,46,427,5,26,Player A
2140,JointPQPlayer,299,79,378,4,42,Player A
2141,JointPQPlayer,387,32,419,0,27,Player A
2142,JointPQPlayer,395,40,435,4,23,Player A
2143,JointPQPlayer,343,43,386,0,38,Player A
2144,JointPQPlayer,335,45,380,0,40,Player A
2145,JointPQPlayer,327,52,379,2,41,Player A
2146,JointPQPlayer,355,40,395,0,35,Player A
2147,JointPQPlayer,387,32,419,0,27,Player A
2148,JointPQPlayer,363,48,411,4,31,Player A
2149,JointPQPlayer,335,45,380,0,40,Player A
2150,JointPQPlayer,383,48,431,6,25,Player A
2151,JointPQPlayer,372,47,419,6,29,Player A
2152,JointPQPlayer,372,52,424,5,27,Player A
2153,JointPQPlayer,391,31,422,0,26,Player A
2154,JointPQPlayer,370,45,415,5,30,Player A
2155,JointPQPlayer,378,38,416,0,28,Player A
2156,JointPQPlayer,379,34,413,0,29,Player A
2157,JointPQPlayer,355,40,395,0,35,Player A
2158,JointPQPlayer,325,55,380,3,41,Player A
2159,JointPQPlayer,325,140,465,28,21,Player A
2160,JointPQPlayer,293,78,371,3,44,Player A
2161,JointPQPlayer,298,168,466,35,23,Player A
2162,JointPQPlayer,312,102,414,10,32,Player A
2163,JointPQPlayer,373,38,411,1,30,Player A
2164,JointPQPlayer,365,45,410,3,31,Player A
2165,JointPQPlayer,349,44,393,1,36,Player A
2166,JointPQPlayer,371,36,407,0,31,Player A
2167,JointPQPlayer,327,47,374,0,42,Player A
2168,JointPQPlayer,323,48,371,0,43,Player A
2169,JointPQPlayer,312,57,369,1,44,Player A
2170,JointPQPlayer,299,54,353,0,49,Player A
2171,JointPQPlayer,180,185,365,21,52,JointPQPlayer
2172,JointPQPlayer,360,65,425,6,27,Player A
2173,JointPQPlayer,357,52,409,2,31,Player A
2174,JointPQPlayer,380,35,415,2,29,Player A
2175,JointPQPlayer,353,63,416,9,31,Player A
2176,JointPQPlayer,355,40,395,0,35,Player A
2177,JointPQPlayer,369,39,408,1,31,Player A
2178,JointPQPlayer,221,196,417,34,39,Player A
2179,JointPQPlayer,379,34,413,0,29,Player A
2180,JointPQPlayer,367,37,404,0,32,Player A
2181,JointPQPlayer,381,36,417,1,28,Player A
2182,JointPQPlayer,405,30,435,1,22,Player A
2183,JointPQPlayer,359,94,453,16,21,Player A
2184,JointPQPlayer,328,53,381,1,40,Player A
2185,JointPQPlayer,331,56,387,1,38,Player A
2186,JointPQPlayer,363,38,401,0,33,Player A
2187,JointPQPlayer,375,35,410,0,30,Player A
2188,JointPQPlayer,399,29,428,0,24,Player A
2189,JointPQPlayer,403,28,431,0,23,Player A
2190,JointPQPlayer,369,39,408,1,31,Player A
2191,JointPQPlayer,379,39,418,2,28,Player A
2192,JointPQPlayer,379,34,413,0,29,Player A
2193,JointPQPlayer,389,44,433,5,24,Player A
2194,JointPQPlayer,371,46,417,1,28,Player A
2195,JointPQPlayer,355,70,425,9,28,Player A
2196,JointPQPlayer,295,65,360,1,47,Player A
2197,JointPQPlayer,371,36,407,0,31,Player A
2198,JointPQPlayer,380,40,420,4,28,Player A
2199,JointPQPlayer,381,41,422,3,27,Player A
2200,JointPQPlayer,385,40,425,3,26,Player A
2201,JointPQPlayer,369,39,408,1,31,Player A
2202,JointPQPlayer,340,95,435,13,26,Player A
2203,JointPQPlayer,375,35,410,0,30,Player A
2204,JointPQPlayer,269,224,493,41,16,Player A
2205,JointPQPlayer,366,61,427,5,26,Player A
2206,JointPQPlayer,343,43,386,0,38,Player A
2207,JointPQPlayer,375,35,410,0,30,Player A
2208,JointPQPlayer,380,50,430,5,25,Player A
2209,JointPQPlayer,357,72,429,7,26,Player A
2210,JointPQPlayer,369,44,413,3,30,Player A
2211,JointPQPlayer,385,35,420,1,27,Player A
2212,JointPQPlayer,293,68,361,2,47,Player A
2213,JointPQPlayer,367,37,404,0,32,Player A
2214,JointPQPlayer,365,45,410,3,31,Player A
2215,JointPQPlayer,391,31,422,0,26,Player A
2216,JointPQPlayer,339,44,383,0,39,Player A
2217,JointPQPlayer,419,24,443,0,19,Player A
2218,JointPQPlayer,335,125,460,29,23,Player A
2219,JointPQPlayer,313,68,381,1,40,Player A
2220,JointPQPlayer,409,29,438,1,21,Player A
2221,JointPQPlayer,387,32,419,0,27,Player A
2222,JointPQPlayer,291,56,347,0,51,Player A
2223,JointPQPlayer,326,121,447,16,23,Player A
2224,JointPQPlayer,379,34,413,0,29,Player A
2225,JointPQPlayer,365,40,405,1,32,Player A
2226,JointPQPlayer,391,31,422,0,26,Player A
2227,JointPQPlayer,357,42,399,1,34,Player A
2228,JointPQPlayer,393,33,426,1,25,Player A
2229,JointPQPlayer,348,48,396,1,35,Player A
2230,JointPQPlayer,271,86,357,7,50,Player A
2231,JointPQPlayer,362,47,409,2,31,Player A
2232,JointPQPlayer,390,30,420,1,27,Player A
2233,JointPQPlayer,373,43,416,3,29,Player A
2234,JointPQPlayer,320,115,435,13,26,Player A
2235,JointPQPlayer,381,36,417,1,28,Player A
2236,JointPQPlayer,368,53,421,8,29,Player A
2237,JointPQPlayer,374,39,413,0,29,Player A
2238,JointPQPlayer,360,55,415,5,30,Player A
2239,JointPQPlayer,360,55,415,5,30,Player A
2240,JointPQPlayer,367,37,404,0,32,Player A
2241,JointPQPlayer,335,45,380,0,40,Player A
2242,JointPQPlayer,373,48,421,2,27,Player A
2243,JointPQPlayer,381,36,417,1,28,Player A
2244,JointPQPlayer,373,43,416,3,29,Player A
2245,JointPQPlayer,379,34,413,0,29,Player A
2246,JointPQPlayer,315,90,405,10,35,Player A
2247,JointPQPlayer,340,105,445,17,24,Player A
2248,JointPQPlayer,391,36,427,2,25,Player A
2249,JointPQPlayer,371,36,407,0,31,Player A
2250,JointPQPlayer,319,124,443,21,26,Player A
2251,JointPQPlayer,355,50,405,4,33,Player A
2252,JointPQPlayer,359,44,403,2,33,Player A
2253,JointPQPlayer,365,40,405,1,32,Player A
2254,JointPQPlayer,381,36,417,1,28,Player A
2255,JointPQPlayer,331,136,467,27,20,Player A
2256,JointPQPlayer,356,56,412,2,30,Player A
2257,JointPQPlayer,355,40,395,0,35,Player A
2258,JointPQPlayer,398,38,436,5,23,Player A
2259,JointPQPlayer,324,64,388,2,38,Player A
2260,JointPQPlayer,373,48,421,2,27,Player A
2261,JointPQPlayer,190,85,275,0,75,Player A
2262,JointPQPlayer,413,28,441,1,20,Player A
2263,JointPQPlayer,409,34,443,3,20,Player A
2264,JointPQPlayer,356,96,452,15,21,Player A
2265,JointPQPlayer,379,34,413,0,29,Player A
2266,JointPQPlayer,335,45,380,0,40,Player A
2267,JointPQPlayer,353,123,476,24,16,Player A
2268,JointPQPlayer,353,43,396,1,35,Player A
2269,JointPQPlayer,383,33,416,0,28,Player A
2270,JointPQPlayer,375,35,410,0,30,Player A
2271,JointPQPlayer,383,33,416,0,28,Player A
2272,JointPQPlayer,333,83,416,9,31,Player A
2273,JointPQPlayer,352,102,454,20,22,Player A
2274,JointPQPlayer,271,176,447,16,23,Player A
2275,JointPQPlayer,352,47,399,1,34,Player A
2276,JointPQPlayer,390,35,425,3,26,Player A
2277,JointPQPlayer,365,45,410,3,31,Player A
2278,JointPQPlayer,383,38,421,2,27,Player A
2279,JointPQPlayer,323,58,381,1,40,Player A
2280,JointPQPlayer,303,53,356,0,48,Player A
2281,JointPQPlayer,397,32,429,1,24,Player A
2282,JointPQPlayer,314,64,378,4,42,Player A
2283,JointPQPlayer,372,42,414,4,30,Player A
2284,JointPQPlayer,332,137,469,26,19,Player A
2285,JointPQPlayer,326,46,372,1,43,Player A
2286,JointPQPlayer,338,48,386,0,38,Player A
2287,JointPQPlayer,353,48,401,3,34,Player A
2288,JointPQPlayer,326,51,377,0,41,Player A
2289,JointPQPlayer,373,53,426,7,27,Player A
2290,JointPQPlayer,287,192,479,36,19,Player A
2291,JointPQPlayer,349,44,393,1,36,Player A
2292,JointPQPlayer,375,35,410,0,30,Player A
2293,JointPQPlayer,355,40,395,0,35,Player A
2294,JointPQPlayer,357,47,404,3,33,Player A
2295,JointPQPlayer,371,51,422,6,28,Player A
2296,JointPQPlayer,375,40,415,2,29,Player A
2297,JointPQPlayer,240,280,520,50,10,JointPQPlayer
2298,JointPQPlayer,329,89,418,2,28,Player A
2299,JointPQPlayer,358,58,416,9,31,Player A
2300,JointPQPlayer,359,39,398,0,34,Player A
2301,JointPQPlayer,367,42,409,2,31,Player A
2302,JointPQPlayer,401,31,432,1,23,Player A
2303,JointPQPlayer,369,39,408,1,31,Player A
2304,JointPQPlayer,389,39,428,3,25,Player A
2305,JointPQPlayer,405,30,435,1,22,Player A
2306,JointPQPlayer,367,37,404,0,32,Player A
2307,JointPQPlayer,379,34,413,0,29,Player A
2308,JointPQPlayer,190,100,290,3,71,Player A
2309,JointPQPlayer,272,207,479,36,19,Player A
2310,JointPQPlayer,323,103,426,10,28,Player A
2311,JointPQPlayer,302,57,359,0,47,Player A
2312,JointPQPlayer,402,32,434,3,23,Player A
2313,JointPQPlayer,369,44,413,3,30,Player A
2314,JointPQPlayer,363,38,401,0,33,Player A
2315,JointPQPlayer,334,84,418,14,32,Player A
2316,JointPQPlayer,383,48,431,3,24,Player A
2317,JointPQPlayer,320,135,455,21,22,Player A
2318,JointPQPlayer,324,139,463,32,23,Player A
2319,JointPQPlayer,331,91,422,6,28,Player A
2320,JointPQPlayer,359,54,413,6,31,Player A
2321,JointPQPlayer,381,36,417,1,28,Player A
2322,JointPQPlayer,385,35,420,1,27,Player A
2323,JointPQPlayer,370,40,410,3,31,Player A
2324,JointPQPlayer,358,53,411,4,31,Player A
2325,JointPQPlayer,355,40,395,0,35,Player A
2326,JointPQPlayer,369,39,408,1,31,Player A
2327,JointPQPlayer,353,73,426,7,27,Player A
2328,JointPQPlayer,347,82,429,13,28,Player A
2329,JointPQPlayer,233,103,336,1,55,Player A
2330,JointPQPlayer,343,43,386,0,38,Player A
2331,JointPQPlayer,282,62,344,0,52,Player A
2332,JointPQPlayer,367,37,404,0,32,Player A
2333,JointPQPlayer,360,45,405,4,33,Player A
2334,JointPQPlayer,402,32,434,3,23,Player A
2335,JointPQPlayer,297,62,359,0,47,Player A
2336,JointPQPlayer,214,304,518,63,15,JointPQPlayer
2337,JointPQPlayer,340,55,395,0,35,Player A
2338,JointPQPlayer,387,37,424,2,26,Player A
2339,JointPQPlayer,323,48,371,0,43,Player A
2340,JointPQPlayer,393,38,431,3,24,Player A
2341,JointPQPlayer,347,47,394,2,36,Player A
2342,JointPQPlayer,302,77,379,8,43,Player A
2343,JointPQPlayer,384,39,423,1,26,Player A
2344,JointPQPlayer,331,46,377,0,41,Player A
2345,JointPQPlayer,306,56,362,0,46,Player A
2346,JointPQPlayer,370,60,430,11,27,Player A
2347,JointPQPlayer,341,46,387,1,38,Player A
2348,JointPQPlayer,342,47,389,0,37,Player A
2349,JointPQPlayer,355,40,395,0,35,Player A
2350,JointPQPlayer,353,43,396,1,35,Player A
2351,JointPQPlayer,375,35,410,0,30,Player A
2352,JointPQPlayer,402,37,439,5,22,Player A
2353,JointPQPlayer,372,52,424,8,28,Player A
2354,JointPQPlayer,301,61,362,0,46,Player A
2355,JointPQPlayer,359,39,398,0,34,Player A
2356,JointPQPlayer,360,70,430,11,27,Player A
2357,JointPQPlayer,363,63,426,4,26,Player A
2358,JointPQPlayer,363,63,426,4,26,Player A
2359,JointPQPlayer,341,56,397,2,35,Player A
2360,JointPQPlayer,343,128,471,25,18,Player A
2361,JointPQPlayer,359,39,398,0,34,Player A
2362,JointPQPlayer,369,39,408,1,31,Player A
2363,JointPQPlayer,363,38,401,0,33,Player A
2364,JointPQPlayer,365,45,410,3,31,Player A
2365,JointPQPlayer,359,39,398,0,34,Player A
2366,JointPQPlayer,338,98,436,14,26,Player A
2367,JointPQPlayer,306,56,362,0,46,Player A
2368,JointPQPlayer,331,61,392,3,37,Player A
2369,JointPQPlayer,327,47,374,0,42,Player A
2370,JointPQPlayer,351,51,402,1,33,Player A
2371,JointPQPlayer,402,32,434,3,23,Player A
2372,JointPQPlayer,249,149,398,21,41,Player A
2373,JointPQPlayer,250,135,385,8,41,Player A
2374,JointPQPlayer,379,39,418,2,28,Player A
2375,JointPQPlayer,370,40,410,3,31,Player A
2376,JointPQPlayer,343,63,406,8,34,Player A
2377,JointPQPlayer,378,58,436,8,24,Player A
2378,JointPQPlayer,360,85,445,14,23,Player A
2379,JointPQPlayer,358,78,436,8,24,Player A
2380,JointPQPlayer,338,48,386,0,38,Player A
2381,JointPQPlayer,379,34,413,0,29,Player A
2382,JointPQPlayer,363,38,401,0,33,Player A
2383,JointPQPlayer,378,33,411,1,30,Player A
2384,JointPQPlayer,344,59,403,2,33,Player A
2385,JointPQPlayer,395,30,425,0,25,Player A
2386,JointPQPlayer,373,38,411,1,30,Player A
2387,JointPQPlayer,281,76,357,1,48,Player A
2388,JointPQPlayer,400,25,425,0,25,Player A
2389,JointPQPlayer,371,36,407,0,31,Player A
2390,JointPQPlayer,336,61,397,5,36,Player A
2391,JointPQPlayer,363,38,401,0,33,Player A
2392,JointPQPlayer,379,44,423,4,27,Player A
2393,JointPQPlayer,361,76,437,12,25,Player A
2394,JointPQPlayer,290,60,350,0,50,Player A
2395,JointPQPlayer,369,44,413,3,30,Player A
2396,JointPQPlayer,322,117,439,20,27,Player A
2397,JointPQPlayer,357,52,409,5,32,Player A
2398,JointPQPlayer,398,38,436,5,23,Player A
2399,JointPQPlayer,369,44,413,3,30,Player A
2400,JointPQPlayer,363,43,406,2,32,Player A
2401,JointPQPlayer,340,55,395,3,36,Player A
2402,JointPQPlayer,310,55,365,0,45,Player A
2403,JointPQPlayer,387,37,424,2,26,Player A
2404,JointPQPlayer,375,40,415,2,29,Player A
2405,JointPQPlayer,353,43,396,1,35,Player A
2406,JointPQPlayer,371,36,407,0,31,Player A
2407,JointPQPlayer,381,51,432,4,24,Player A
2408,JointPQPlayer,385,40,425,3,26,Player A
2409,JointPQPlayer,263,73,336,1,55,Player A
2410,JointPQPlayer,381,36,417,1,28,Player A
2411,JointPQPlayer,373,38,411,1,30,Player A
2412,JointPQPlayer,320,105,425,15,30,Player A
2413,JointPQPlayer,393,33,426,1,25,Player A
2414,JointPQPlayer,373,43,416,3,29,Player A
2415,JointPQPlayer,395,30,425,0,25,Player A
2416,JointPQPlayer,267,97,364,5,47,Player A
2417,JointPQPlayer,355,40,395,0,35,Player A
2418,JointPQPlayer,373,38,411,1,30,Player A
2419,JointPQPlayer,328,53,381,1,40,Player A
2420,JointPQPlayer,345,45,390,1,37,Player A
2421,JointPQPlayer,385,40,425,3,26,Player A
2422,JointPQPlayer,323,48,371,0,43,Player A
2423,JointPQPlayer,395,30,425,0,25,Player A
2424,JointPQPlayer,382,37,419,3,28,Player A
2425,JointPQPlayer,264,74,338,0,54,Player A
2426,JointPQPlayer,365,40,405,1,32,Player A
2427,JointPQPlayer,375,35,410,0,30,Player A
2428,JointPQPlayer,385,35,420,1,27,Player A
2429,JointPQPlayer,357,47,404,3,33,Player A
2430,JointPQPlayer,338,53,391,2,37,Player A
2431,JointPQPlayer,310,55,365,0,45,Player A
2432,JointPQPlayer,333,58,391,2,37,Player A
2433,JointPQPlayer,375,35,410,0,30,Player A
2434,JointPQPlayer,382,37,419,3,28,Player A
2435,JointPQPlayer,381,46,427,5,26,Player A
2436,JointPQPlayer,394,29,423,1,26,Player A
2437,JointPQPlayer,343,58,401,6,35,Player A
2438,JointPQPlayer,397,32,429,1,24,Player A
2439,JointPQPlayer,375,35,410,0,30,Player A
2440,JointPQPlayer,377,37,414,1,29,Player A
2441,JointPQPlayer,347,42,389,0,37,Player A
2442,JointPQPlayer,315,140,455,27,24,Player A
2443,JointPQPlayer,365,40,405,1,32,Player A
2444,JointPQPlayer,226,286,512,60,16,JointPQPlayer
2445,JointPQPlayer,357,67,424,8,28,Player A
2446,JointPQPlayer,375,35,410,0,30,Player A
2447,JointPQPlayer,274,64,338,0,54,Player A
2448,JointPQPlayer,363,38,401,0,33,Player A
2449,JointPQPlayer,361,41,402,1,33,Player A
2450,JointPQPlayer,357,42,399,1,34,Player A
2451,JointPQPlayer,310,60,370,2,44,Player A
2452,JointPQPlayer,355,45,400,2,34,Player A
2453,JointPQPlayer,395,30,425,0,25,Player A
2454,JointPQPlayer,391,41,432,4,24,Player A
2455,JointPQPlayer,327,57,384,1,39,Player A
2456,JointPQPlayer,389,44,433,5,24,Player A
2457,JointPQPlayer,369,39,408,1,31,Player A
2458,JointPQPlayer,387,32,419,0,27,Player A
2459,JointPQPlayer,395,30,425,0,25,Player A
2460,JointPQPlayer,282,62,344,0,52,Player A
2461,JointPQPlayer,267,132,399,16,39,Player A
2462,JointPQPlayer,365,45,410,3,31,Player A
2463,JointPQPlayer,355,45,400,2,34,Player A
2464,JointPQPlayer,372,62,434,12,26,Player A
2465,JointPQPlayer,365,45,410,3,31,Player A
2466,JointPQPlayer,379,34,413,0,29,Player A
2467,JointPQPlayer,377,37,414,1,29,Player A
2468,JointPQPlayer,282,82,364,2,46,Player A
2469,JointPQPlayer,367,37,404,0,32,Player A
2470,JointPQPlayer,407,27,434,0,22,Player A
2471,JointPQPlayer,223,93,316,5,63,Player A
2472,JointPQPlayer,399,29,428,0,24,Player A
2473,JointPQPlayer,348,58,406,8,34,Player A
2474,JointPQPlayer,352,47,399,1,34,Player A
2475,JointPQPlayer,371,36,407,0,31,Player A
2476,JointPQPlayer,327,47,374,0,42,Player A
2477,JointPQPlayer,351,41,392,0,36,Player A
2478,JointPQPlayer,355,40,395,0,35,Player A
2479,JointPQPlayer,382,37,419,3,28,Player A
2480,JointPQPlayer,387,42,429,4,25,Player A
2481,JointPQPlayer,352,47,399,1,34,Player A
2482,JointPQPlayer,339,44,383,0,39,Player A
2483,JointPQPlayer,379,34,413,0,29,Player A
2484,JointPQPlayer,362,47,409,2,31,Player A
2485,JointPQPlayer,375,35,410,0,30,Player A
2486,JointPQPlayer,370,35,405,1,32,Player A
2487,JointPQPlayer,157,117,274,2,76,Player A
2488,JointPQPlayer,369,39,408,1,31,Player A
2489,JointPQPlayer,393,33,426,1,25,Player A
2490,JointPQPlayer,172,122,294,4,70,Player A
2491,JointPQPlayer,391,31,422,0,26,Player A
2492,JointPQPlayer,375,35,410,0,30,Player A
2493,JointPQPlayer,403,28,431,0,23,Player A
2494,JointPQPlayer,389,34,423,1,26,Player A
2495,JointPQPlayer,355,45,400,2,34,Player A
2496,JointPQPlayer,393,38,431,3,24,Player A
2497,JointPQPlayer,295,65,360,1,47,Player A
2498,JointPQPlayer,181,106,287,3,72,Player A
2499,JointPQPlayer,361,41,402,1,33,Player A
2500,JointPQPlayer,375,45,420,4,28,Player A
2501,JointPQPlayer,383,33,416,0,28,Player A
2502,JointPQPlayer,395,30,425,0,25,Player A
2503,JointPQPlayer,375,35,410,0,30,Player A
2504,JointPQPlayer,299,54,353,0,49,Player A
2505,JointPQPlayer,348,53,401,3,34,Player A
2506,JointPQPlayer,365,45,410,3,31,Player A
2507,JointPQPlayer,347,67,414,10,32,Player A
2508,JointPQPlayer,381,36,417,1,28,Player A
2509,JointPQPlayer,355,55,410,6,32,Player A
2510,JointPQPlayer,402,32,434,3,23,Player A
2511,JointPQPlayer,386,36,422,0,26,Player A
2512,JointPQPlayer,367,37,404,0,32,Player A
2513,JointPQPlayer,297,67,364,5,47,Player A
2514,JointPQPlayer,335,45,380,0,40,Player A
2515,JointPQPlayer,391,31,422,0,26,Player A
2516,JointPQPlayer,177,107,284,3,73,Player A
2517,JointPQPlayer,379,39,418,2,28,Player A
2518,JointPQPlayer,302,57,359,0,47,Player A
2519,JointPQPlayer,330,65,395,3,36,Player A
2520,JointPQPlayer,381,41,422,3,27,Player A
2521,JointPQPlayer,387,32,419,0,27,Player A
2522,JointPQPlayer,363,43,406,2,32,Player A
2523,JointPQPlayer,343,43,386,0,38,Player A
2524,JointPQPlayer,381,56,437,3,22,Player A
2525,JointPQPlayer,365,40,405,1,32,Player A
2526,JointPQPlayer,347,42,389,0,37,Player A
2527,JointPQPlayer,329,114,443,21,26,Player A
2528,JointPQPlayer,328,88,416,3,29,Player A
2529,JointPQPlayer,376,36,412,2,30,Player A
2530,JointPQPlayer,324,69,393,7,38,Player A
2531,JointPQPlayer,407,27,434,0,22,Player A
2532,JointPQPlayer,392,42,434,3,23,Player A
2533,JointPQPlayer,371,36,407,0,31,Player A
2534,JointPQPlayer,333,73,406,5,33,Player A
2535,JointPQPlayer,346,46,392,0,36,Player A
2536,JointPQPlayer,346,61,407,3,32,Player A
2537,JointPQPlayer,339,54,393,1,36,Player A
2538,JointPQPlayer,342,42,384,1,39,Player A
2539,JointPQPlayer,382,47,429,7,26,Player A
2540,JointPQPlayer,285,130,415,11,32,Player A
2541,JointPQPlayer,380,40,420,1,27,Player A
2542,JointPQPlayer,381,36,417,1,28,Player A
2543,JointPQPlayer,381,36,417,1,28,Player A
2544,JointPQPlayer,357,42,399,1,34,Player A
2545,JointPQPlayer,389,34,423,1,26,Player A
2546,JointPQPlayer,387,42,429,1,24,Player A
2547,JointPQPlayer,369,39,408,1,31,Player A
2548,JointPQPlayer,383,33,416,0,28,Player A
2549,JointPQPlayer,363,43,406,2,32,Player A
2550,JointPQPlayer,367,37,404,0,32,Player A
2551,JointPQPlayer,387,32,419,0,27,Player A
2552,JointPQPlayer,415,25,440,0,20,Player A
2553,JointPQPlayer,387,37,424,2,26,Player A
2554,JointPQPlayer,332,62,394,5,37,Player A
2555,JointPQPlayer,361,41,402,1,33,Player A
2556,JointPQPlayer,346,46,392,0,36,Player A
2557,JointPQPlayer,315,95,410,12,34,Player A
2558,JointPQPlayer,377,37,414,1,29,Player A
2559,JointPQPlayer,362,52,414,7,31,Player A
2560,JointPQPlayer,367,52,419,6,29,Player A
2561,JointPQPlayer,346,46,392,0,36,Player A
2562,JointPQPlayer,345,45,390,1,37,Player A
2563,JointPQPlayer,292,62,354,1,49,Player A
2564,JointPQPlayer,373,38,411,1,30,Player A
2565,JointPQPlayer,363,38,401,0,33,Player A
2566,JointPQPlayer,370,45,415,5,30,Player A
2567,JointPQPlayer,356,66,422,9,29,Player A
2568,JointPQPlayer,332,112,444,19,25,Player A
2569,JointPQPlayer,357,42,399,1,34,Player A
2570,JointPQPlayer,308,138,446,21,25,Player A
2571,JointPQPlayer,389,34,423,1,26,Player A
2572,JointPQPlayer,351,41,392,0,36,Player A
2573,JointPQPlayer,355,40,395,0,35,Player A
2574,JointPQPlayer,254,69,323,0,59,Player A
2575,JointPQPlayer,347,42,389,0,37,Player A
2576,JointPQPlayer,398,33,431,3,24,Player A
2577,JointPQPlayer,339,109,448,17,23,Player A
2578,JointPQPlayer,337,47,384,1,39,Player A
2579,JointPQPlayer,389,34,423,1,26,Player A
2580,JointPQPlayer,355,40,395,0,35,Player A
2581,JointPQPlayer,288,93,381,13,44,Player A
2582,JointPQPlayer,405,35,440,3,21,Player A
2583,JointPQPlayer,365,55,420,7,29,Player A
2584,JointPQPlayer,349,54,403,2,33,Player A
2585,JointPQPlayer,349,54,403,2,33,Player A
2586,JointPQPlayer,377,37,414,1,29,Player A
2587,JointPQPlayer,328,63,391,5,38,Player A
2588,JointPQPlayer,399,29,428,0,24,Player A
2589,JointPQPlayer,369,44,413,3,30,Player A
2590,JointPQPlayer,327,62,389,0,37,Player A
2591,JointPQPlayer,391,31,422,0,26,Player A
2592,JointPQPlayer,396,26,422,0,26,Player A
2593,JointPQPlayer,327,47,374,0,42,Player A
2594,JointPQPlayer,327,47,374,0,42,Player A
2595,JointPQPlayer,377,42,419,3,28,Player A
2596,JointPQPlayer,345,55,400,5,35,Player A
2597,JointPQPlayer,384,49,433,8,25,Player A
2598,JointPQPlayer,368,53,421,5,28,Player A
2599,JointPQPlayer,326,106,432,16,28,Player A
2600,JointPQPlayer,354,79,433,8,25,Player A
2601,JointPQPlayer,393,33,426,1,25,Player A
2602,JointPQPlayer,414,34,448,5,19,Player A
2603,JointPQPlayer,355,40,395,0,35,Player A
2604,JointPQPlayer,391,31,422,0,26,Player A
2605,JointPQPlayer,375,35,410,0,30,Player A
2606,JointPQPlayer,393,33,426,1,25,Player A
2607,JointPQPlayer,357,42,399,1,34,Player A
2608,JointPQPlayer,311,156,467,33,22,Player A
2609,JointPQPlayer,355,45,400,2,34,Player A
2610,JointPQPlayer,361,51,412,2,30,Player A
2611,JointPQPlayer,383,33,416,0,28,Player A
2612,JointPQPlayer,383,33,416,0,28,Player A
2613,JointPQPlayer,365,40,405,1,32,Player A
2614,JointPQPlayer,327,47,374,0,42,Player A
2615,JointPQPlayer,321,51,372,1,43,Player A
2616,JointPQPlayer,258,68,326,0,58,Player A
2617,JointPQPlayer,355,40,395,0,35,Player A
2618,JointPQPlayer,347,77,424,8,28,Player A
2619,JointPQPlayer,310,55,365,0,45,Player A
2620,JointPQPlayer,294,59,353,0,49,Player A
2621,JointPQPlayer,387,32,419,0,27,Player A
2622,JointPQPlayer,350,55,405,7,34,Player A
2623,JointPQPlayer,387,37,424,2,26,Player A
2624,JointPQPlayer,373,38,411,1,30,Player A
2625,JointPQPlayer,290,65,355,2,49,Player A
2626,JointPQPlayer,342,47,389,0,37,Player A
2627,JointPQPlayer,389,39,428,3,25,Player A
2628,JointPQPlayer,323,48,371,0,43,Player A
2629,JointPQPlayer,363,48,411,4,31,Player A
2630,JointPQPlayer,363,38,401,0,33,Player A
2631,JointPQPlayer,328,103,431,15,28,Player A
2632,JointPQPlayer,324,104,428,6,26,Player A
2633,JointPQPlayer,381,51,432,4,24,Player A
2634,JointPQPlayer,334,49,383,0,39,Player A
2635,JointPQPlayer,315,50,365,0,45,Player A
2636,JointPQPlayer,387,32,419,0,27,Player A
2637,JointPQPlayer,315,50,365,0,45,Player A
2638,JointPQPlayer,381,36,417,1,28,Player A
2639,JointPQPlayer,332,62,394,5,37,Player A
2640,JointPQPlayer,303,98,401,6,35,Player A
2641,JointPQPlayer,313,108,421,14,31,Player A
2642,JointPQPlayer,359,39,398,0,34,Player A
2643,JointPQPlayer,400,25,425,0,25,Player A
2644,JointPQPlayer,353,43,396,1,35,Player A
2645,JointPQPlayer,372,52,424,8,28,Player A
2646,JointPQPlayer,369,54,423,7,28,Player A
2647,JointPQPlayer,371,36,407,0,31,Player A
2648,JointPQPlayer,377,42,419,3,28,Player A
2649,JointPQPlayer,375,40,415,2,29,Player A
2650,JointPQPlayer,327,52,379,2,41,Player A
2651,JointPQPlayer,373,38,411,1,30,Player A
2652,JointPQPlayer,389,34,423,1,26,Player A
2653,JointPQPlayer,385,35,420,1,27,Player A
2654,JointPQPlayer,399,39,438,4,22,Player A
2655,JointPQPlayer,357,42,399,1,34,Player A
2656,JointPQPlayer,365,55,420,7,29,Player A
2657,JointPQPlayer,371,36,407,0,31,Player A
2658,JointPQPlayer,313,53,366,1,45,Player A
2659,JointPQPlayer,340,60,400,2,34,Player A
2660,JointPQPlayer,328,73,401,6,35,Player A
2661,JointPQPlayer,397,32,429,1,24,Player A
2662,JointPQPlayer,365,80,445,11,22,Player A
2663,JointPQPlayer,355,40,395,0,35,Player A
2664,JointPQPlayer,309,84,393,4,37,Player A
2665,JointPQPlayer,357,47,404,3,33,Player A
2666,JointPQPlayer,311,51,362,0,46,Player A
2667,JointPQPlayer,354,49,403,2,33,Player A
2668,JointPQPlayer,342,97,439,14,25,Player A
2669,JointPQPlayer,393,33,426,1,25,Player A
2670,JointPQPlayer,361,46,407,3,32,Player A
2671,JointPQPlayer,339,44,383,0,39,Player A
2672,JointPQPlayer,343,43,386,0,38,Player A
2673,JointPQPlayer,274,69,343,2,53,Player A
2674,JointPQPlayer,385,40,425,3,26,Player A
2675,JointPQPlayer,262,67,329,0,57,Player A
2676,JointPQPlayer,192,197,389,24,45,JointPQPlayer
2677,JointPQPlayer,363,48,411,4,31,Player A
2678,JointPQPlayer,301,71,372,4,44,Player A
2679,JointPQPlayer,397,32,429,1,24,Player A
2680,JointPQPlayer,173,123,296,6,70,Player A
2681,JointPQPlayer,349,69,418,5,29,Player A
2682,JointPQPlayer,360,40,400,2,34,Player A
2683,JointPQPlayer,364,54,418,5,29,Player A
2684,JointPQPlayer,381,36,417,1,28,Player A
2685,JointPQPlayer,351,41,392,0,36,Player A
2686,JointPQPlayer,303,68,371,3,44,Player A
2687,JointPQPlayer,372,67,439,8,23,Player A
2688,JointPQPlayer,384,44,428,3,25,Player A
2689,JointPQPlayer,378,33,411,1,30,Player A
2690,JointPQPlayer,350,50,400,2,34,Player A
2691,JointPQPlayer,181,116,297,4,69,Player A
2692,JointPQPlayer,402,27,429,1,24,Player A
2693,JointPQPlayer,369,39,408,1,31,Player A
2694,JointPQPlayer,407,27,434,0,22,Player A
2695,JointPQPlayer,355,50,405,1,32,Player A
2696,JointPQPlayer,267,107,374,6,44,Player A
2697,JointPQPlayer,338,48,386,0,38,Player A
2698,JointPQPlayer,391,31,422,0,26,Player A
2699,JointPQPlayer,367,37,404,0,32,Player A
2700,JointPQPlayer,375,35,410,0,30,Player A
2701,JointPQPlayer,243,268,511,50,13,JointPQPlayer
2702,JointPQPlayer,371,36,407,0,31,Player A
2703,JointPQPlayer,377,47,424,5,27,Player A
2704,JointPQPlayer,341,46,387,1,38,Player A
2705,JointPQPlayer,395,30,425,0,25,Player A
2706,JointPQPlayer,381,36,417,1,28,Player A
2707,JointPQPlayer,339,44,383,0,39,Player A
2708,JointPQPlayer,367,42,409,2,31,Player A
2709,JointPQPlayer,383,38,421,2,27,Player A
2710,JointPQPlayer,328,63,391,5,38,Player A
2711,JointPQPlayer,377,37,414,1,29,Player A
2712,JointPQPlayer,406,36,442,5,21,Player A
2713,JointPQPlayer,342,47,389,0,37,Player A
2714,JointPQPlayer,381,36,417,1,28,Player A
2715,JointPQPlayer,336,81,417,7,30,Player A
2716,JointPQPlayer,290,60,350,0,50,Player A
2717,JointPQPlayer,375,40,415,2,29,Player A
2718,JointPQPlayer,329,54,383,3,40,Player A
2719,JointPQPlayer,391,36,427,2,25,Player A
2720,JointPQPlayer,325,125,450,22,24,Player A
2721,JointPQPlayer,286,61,347,0,51,Player A
2722,JointPQPlayer,345,45,390,1,37,Player A
2723,JointPQPlayer,387,37,424,2,26,Player A
2724,JointPQPlayer,375,35,410,0,30,Player A
2725,JointPQPlayer,365,40,405,1,32,Player A
2726,JointPQPlayer,360,95,455,15,20,Player A
2727,JointPQPlayer,313,63,376,2,42,Player A
2728,JointPQPlayer,373,48,421,2,27,Player A
2729,JointPQPlayer,342,47,389,0,37,Player A
2730,JointPQPlayer,359,54,413,3,30,Player A
2731,JointPQPlayer,354,44,398,3,35,Player A
2732,JointPQPlayer,319,119,438,22,28,Player A
2733,JointPQPlayer,361,56,417,4,29,Player A
2734,JointPQPlayer,389,39,428,3,25,Player A
2735,JointPQPlayer,363,38,401,0,33,Player A
2736,JointPQPlayer,389,34,423,1,26,Player A
2737,JointPQPlayer,375,35,410,0,30,Player A
2738,JointPQPlayer,383,33,416,0,28,Player A
2739,JointPQPlayer,339,69,408,7,33,Player A
2740,JointPQPlayer,359,54,413,3,30,Player A
2741,JointPQPlayer,374,34,408,1,31,Player A
2742,JointPQPlayer,370,50,420,4,28,Player A
2743,JointPQPlayer,391,31,422,0,26,Player A
2744,JointPQPlayer,326,51,377,0,41,Player A
2745,JointPQPlayer,372,32,404,0,32,Player A
2746,JointPQPlayer,364,44,408,1,31,Player A
2747,JointPQPlayer,199,324,523,53,10,JointPQPlayer
2748,JointPQPlayer,383,33,416,0,28,Player A
2749,JointPQPlayer,324,59,383,3,40,Player A
2750,JointPQPlayer,353,48,401,3,34,Player A
2751,JointPQPlayer,358,43,401,0,33,Player A
2752,JointPQPlayer,387,32,419,0,27,Player A
2753,JointPQPlayer,234,74,308,0,64,Player A
2754,JointPQPlayer,375,35,410,0,30,Player A
2755,JointPQPlayer,356,46,402,1,33,Player A
2756,JointPQPlayer,246,226,472,38,22,Player A
2757,JointPQPlayer,328,58,386,3,39,Player A
2758,JointPQPlayer,373,38,411,1,30,Player A
2759,JointPQPlayer,357,42,399,1,34,Player A
2760,JointPQPlayer,355,55,410,3,31,Player A
2761,JointPQPlayer,391,31,422,0,26,Player A
2762,JointPQPlayer,270,65,335,0,55,Player A
2763,JointPQPlayer,369,44,413,3,30,Player A
2764,JointPQPlayer,302,57,359,0,47,Player A
2765,JointPQPlayer,355,40,395,0,35,Player A
2766,JointPQPlayer,312,57,369,1,44,Player A
2767,JointPQPlayer,322,132,454,20,22,Player A
2768,JointPQPlayer,351,41,392,0,36,Player A
2769,JointPQPlayer,286,61,347,0,51,Player A
2770,JointPQPlayer,331,46,377,0,41,Player A
2771,JointPQPlayer,398,33,431,3,24,Player A
2772,JointPQPlayer,360,55,415,8,31,Player A
2773,JointPQPlayer,385,45,430,5,25,Player A
2774,JointPQPlayer,296,161,457,32,25,Player A
2775,JointPQPlayer,367,37,404,0,32,Player A
2776,JointPQPlayer,393,33,426,1,25,Player A
2777,JointPQPlayer,401,36,437,3,22,Player A
2778,JointPQPlayer,359,39,398,0,34,Player A
2779,JointPQPlayer,351,46,397,2,35,Player A
2780,JointPQPlayer,412,27,439,2,21,Player A
2781,JointPQPlayer,337,72,409,5,32,Player A
2782,JointPQPlayer,385,40,425,3,26,Player A
2783,JointPQPlayer,386,46,432,7,25,Player A
2784,JointPQPlayer,367,42,409,2,31,Player A
2785,JointPQPlayer,357,47,404,3,33,Player A
2786,JointPQPlayer,300,100,400,11,37,Player A
2787,JointPQPlayer,377,47,424,5,27,Player A
2788,JointPQPlayer,338,53,391,2,37,Player A
2789,JointPQPlayer,347,47,394,2,36,Player A
2790,JointPQPlayer,308,98,406,11,35,Player A
2791,JointPQPlayer,358,68,426,7,27,Player A
2792,JointPQPlayer,278,153,431,21,30,Player A
2793,JointPQPlayer,363,38,401,0,33,Player A
2794,JointPQPlayer,362,37,399,1,34,Player A
2795,JointPQPlayer,371,51,422,6,28,Player A
2796,JointPQPlayer,377,42,419,3,28,Player A
2797,JointPQPlayer,371,36,407,0,31,Player A
2798,JointPQPlayer,345,75,420,4,28,Player A
2799,JointPQPlayer,373,38,411,1,30,Player A
2800,JointPQPlayer,399,29,428,0,24,Player A
2801,JointPQPlayer,371,46,417,4,29,Player A
2802,JointPQPlayer,365,40,405,1,32,Player A
2803,JointPQPlayer,375,40,415,2,29,Player A
2804,JointPQPlayer,412,32,444,4,20,Player A
2805,JointPQPlayer,388,48,436,5,23,Player A
2806,JointPQPlayer,367,37,404,0,32,Player A
2807,JointPQPlayer,359,39,398,0,34,Player A
2808,JointPQPlayer,321,51,372,1,43,Player A
2809,JointPQPlayer,372,62,434,6,24,Player A
2810,JointPQPlayer,319,64,383,3,40,Player A
2811,JointPQPlayer,347,42,389,0,37,Player A
2812,JointPQPlayer,387,37,424,2,26,Player A
2813,JointPQPlayer,401,31,432,1,23,Player A
2814,JointPQPlayer,258,78,336,1,55,Player A
2815,JointPQPlayer,369,39,408,1,31,Player A
2816,JointPQPlayer,371,36,407,0,31,Player A
2817,JointPQPlayer,331,51,382,2,40,Player A
2818,JointPQPlayer,375,35,410,0,30,Player A
2819,JointPQPlayer,363,38,401,0,33,Player A
2820,JointPQPlayer,386,41,427,5,26,Player A
2821,JointPQPlayer,346,61,407,6,33,Player A
2822,JointPQPlayer,328,63,391,5,38,Player A
2823,JointPQPlayer,353,43,396,1,35,Player A
2824,JointPQPlayer,377,42,419,3,28,Player A
2825,JointPQPlayer,265,70,335,0,55,Player A
2826,JointPQPlayer,348,68,416,6,30,Player A
2827,JointPQPlayer,391,31,422,0,26,Player A
2828,JointPQPlayer,357,42,399,1,34,Player A
2829,JointPQPlayer,414,29,443,3,20,Player A
2830,JointPQPlayer,391,41,432,4,24,Player A
2831,JointPQPlayer,354,59,413,3,30,Player A
2832,JointPQPlayer,359,49,408,1,31,Player A
2833,JointPQPlayer,354,44,398,3,35,Player A
2834,JointPQPlayer,296,76,372,7,45,Player A
2835,JointPQPlayer,323,78,401,6,35,Player A
2836,JointPQPlayer,319,49,368,0,44,Player A
2837,JointPQPlayer,280,145,425,24,33,Player A
2838,JointPQPlayer,399,34,433,2,23,Player A
2839,JointPQPlayer,402,27,429,1,24,Player A
2840,JointPQPlayer,268,73,341,3,54,Player A
2841,JointPQPlayer,344,49,393,1,36,Player A
2842,JointPQPlayer,385,35,420,1,27,Player A
2843,JointPQPlayer,381,36,417,1,28,Player A
2844,JointPQPlayer,378,33,411,1,30,Player A
2845,JointPQPlayer,364,49,413,3,30,Player A
2846,JointPQPlayer,313,58,371,0,43,Player A
2847,JointPQPlayer,352,37,389,0,37,Player A
2848,JointPQPlayer,359,39,398,0,34,Player A
2849,JointPQPlayer,387,32,419,0,27,Player A
2850,JointPQPlayer,395,30,425,0,25,Player A
2851,JointPQPlayer,327,47,374,0,42,Player A
2852,JointPQPlayer,349,54,403,2,33,Player A
2853,JointPQPlayer,377,37,414,1,29,Player A
2854,JointPQPlayer,335,45,380,0,40,Player A
2855,JointPQPlayer,352,72,424,11,29,Player A
2856,JointPQPlayer,273,198,471,25,18,Player A
2857,JointPQPlayer,354,49,403,2,33,Player A
2858,JointPQPlayer,387,32,419,0,27,Player A
2859,JointPQPlayer,373,38,411,1,30,Player A
2860,JointPQPlayer,317,52,369,1,44,Player A
2861,JointPQPlayer,373,38,411,1,30,Player A
2862,JointPQPlayer,348,58,406,2,32,Player A
2863,JointPQPlayer,375,40,415,2,29,Player A
2864,JointPQPlayer,337,52,389,3,38,Player A
2865,JointPQPlayer,405,30,435,1,22,Player A
2866,JointPQPlayer,347,42,389,0,37,Player A
2867,JointPQPlayer,387,37,424,2,26,Player A
2868,JointPQPlayer,389,44,433,2,23,Player A
2869,JointPQPlayer,210,80,290,0,70,Player A
2870,JointPQPlayer,374,49,423,7,28,Player A
2871,JointPQPlayer,249,214,463,35,24,Player A
2872,JointPQPlayer,336,91,427,11,28,Player A
2873,JointPQPlayer,363,38,401,0,33,Player A
2874,JointPQPlayer,327,142,469,29,20,Player A
2875,JointPQPlayer,333,63,396,7,37,Player A
2876,JointPQPlayer,362,62,424,8,28,Player A
2877,JointPQPlayer,383,33,416,0,28,Player A
2878,JointPQPlayer,326,111,437,18,27,Player A
2879,JointPQPlayer,365,45,410,3,31,Player A
2880,JointPQPlayer,349,114,463,17,18,Player A
2881,JointPQPlayer,302,57,359,0,47,Player A
2882,JointPQPlayer,376,41,417,4,29,Player A
2883,JointPQPlayer,405,35,440,3,21,Player A
2884,JointPQPlayer,331,121,452,21,23,Player A
2885,JointPQPlayer,385,35,420,1,27,Player A
2886,JointPQPlayer,359,39,398,0,34,Player A
2887,JointPQPlayer,329,89,418,11,31,Player A
2888,JointPQPlayer,335,90,425,15,30,Player A
2889,JointPQPlayer,349,84,433,11,26,Player A
2890,JointPQPlayer,334,49,383,0,39,Player A
2891,JointPQPlayer,379,34,413,0,29,Player A
2892,JointPQPlayer,375,35,410,0,30,Player A
2893,JointPQPlayer,403,38,441,4,21,Player A
2894,JointPQPlayer,383,48,431,3,24,Player A
2895,JointPQPlayer,362,37,399,1,34,Player A
2896,JointPQPlayer,375,45,420,4,28,Player A
2897,JointPQPlayer,364,44,408,1,31,Player A
2898,JointPQPlayer,380,30,410,0,30,Player A
2899,JointPQPlayer,331,46,377,0,41,Player A
2900,JointPQPlayer,388,43,431,6,25,Player A
2901,JointPQPlayer,371,36,407,0,31,Player A
2902,JointPQPlayer,365,45,410,3,31,Player A
2903,JointPQPlayer,351,41,392,0,36,Player A
2904,JointPQPlayer,383,33,416,0,28,Player A
2905,JointPQPlayer,371,36,407,0,31,Player A
2906,JointPQPlayer,339,44,383,0,39,Player A
2907,JointPQPlayer,391,31,422,0,26,Player A
2908,JointPQPlayer,258,68,326,0,58,Player A
2909,JointPQPlayer,306,56,362,0,46,Player A
2910,JointPQPlayer,319,74,393,4,37,Player A
2911,JointPQPlayer,279,59,338,0,54,Player A
2912,JointPQPlayer,387,42,429,4,25,Player A
2913,JointPQPlayer,381,36,417,1,28,Player A
2914,JointPQPlayer,343,43,386,0,38,Player A
2915,JointPQPlayer,377,47,424,5,27,Player A
2916,JointPQPlayer,347,62,409,2,31,Player A
2917,JointPQPlayer,359,54,413,6,31,Player A
2918,JointPQPlayer,359,39,398,0,34,Player A
2919,JointPQPlayer,365,40,405,1,32,Player A
2920,JointPQPlayer,353,43,396,1,35,Player A
2921,JointPQPlayer,388,38,426,4,26,Player A
2922,JointPQPlayer,274,99,373,5,44,Player A
2923,JointPQPlayer,359,39,398,0,34,Player A
2924,JointPQPlayer,371,41,412,2,30,Player A
2925,JointPQPlayer,355,40,395,0,35,Player A
2926,JointPQPlayer,319,64,383,3,40,Player A
2927,JointPQPlayer,344,59,403,2,33,Player A
2928,JointPQPlayer,395,30,425,0,25,Player A
2929,JointPQPlayer,289,149,438,28,30,Player A
2930,JointPQPlayer,343,43,386,0,38,Player A
2931,JointPQPlayer,311,51,362,0,46,Player A
2932,JointPQPlayer,344,54,398,3,35,Player A
2933,JointPQPlayer,388,38,426,4,26,Player A
2934,JointPQPlayer,320,55,375,1,42,Player A
2935,JointPQPlayer,369,54,423,7,28,Player A
2936,JointPQPlayer,390,35,425,0,25,Player A
2937,JointPQPlayer,295,65,360,4,48,Player A
2938,JointPQPlayer,394,34,428,3,25,Player A
2939,JointPQPlayer,332,87,419,9,30,Player A
2940,JointPQPlayer,357,52,409,2,31,Player A
2941,JointPQPlayer,400,30,430,2,24,Player A
2942,JointPQPlayer,361,51,412,5,31,Player A
2943,JointPQPlayer,332,67,399,7,36,Player A
2944,JointPQPlayer,378,38,416,3,29,Player A
2945,JointPQPlayer,388,38,426,1,25,Player A
2946,JointPQPlayer,379,34,413,0,29,Player A
2947,JointPQPlayer,349,44,393,1,36,Player A
2948,JointPQPlayer,339,64,403,5,34,Player A
2949,JointPQPlayer,384,29,413,0,29,Player A
2950,JointPQPlayer,367,37,404,0,32,Player A
2951,JointPQPlayer,373,43,416,3,29,Player A
2952,JointPQPlayer,365,45,410,3,31,Player A
2953,JointPQPlayer,198,318,516,58,14,JointPQPlayer
2954,JointPQPlayer,375,45,420,1,27,Player A
2955,JointPQPlayer,365,40,405,1,32,Player A
2956,JointPQPlayer,397,32,429,1,24,Player A
2957,JointPQPlayer,339,44,383,0,39,Player A
2958,JointPQPlayer,385,35,420,1,27,Player A
2959,JointPQPlayer,324,109,433,17,28,Player A
2960,JointPQPlayer,354,49,403,5,34,Player A
2961,JointPQPlayer,242,177,419,24,35,Player A
2962,JointPQPlayer,373,38,411,1,30,Player A
2963,JointPQPlayer,359,39,398,0,34,Player A
2964,JointPQPlayer,377,42,419,3,28,Player A
2965,JointPQPlayer,367,37,404,0,32,Player A
2966,JointPQPlayer,332,72,404,6,34,Player A
2967,JointPQPlayer,367,37,404,0,32,Player A
2968,JointPQPlayer,326,126,452,18,22,Player A
2969,JointPQPlayer,353,73,426,7,27,Player A
2970,JointPQPlayer,387,32,419,0,27,Player A
2971,JointPQPlayer,381,51,432,7,25,Player A
2972,JointPQPlayer,349,44,393,1,36,Player A
2973,JointPQPlayer,393,33,426,1,25,Player A
2974,JointPQPlayer,411,36,447,4,19,Player A
2975,JointPQPlayer,383,33,416,0,28,Player A
2976,JointPQPlayer,325,85,410,6,32,Player A
2977,JointPQPlayer,263,78,341,6,55,Player A
2978,JointPQPlayer,362,52,414,4,30,Player A
2979,JointPQPlayer,335,60,395,3,36,Player A
2980,JointPQPlayer,402,37,439,5,22,Player A
2981,JointPQPlayer,371,41,412,2,30,Player A
2982,JointPQPlayer,353,43,396,1,35,Player A
2983,JointPQPlayer,387,47,434,3,23,Player A
2984,JointPQPlayer,303,128,431,21,30,Player A
2985,JointPQPlayer,190,295,485,45,20,JointPQPlayer
2986,JointPQPlayer,355,40,395,0,35,Player A
2987,JointPQPlayer,368,63,431,6,25,Player A
2988,JointPQPlayer,303,63,366,1,45,Player A
2989,JointPQPlayer,348,73,421,8,29,Player A
2990,JointPQPlayer,380,40,420,1,27,Player A
2991,JointPQPlayer,381,36,417,1,28,Player A
2992,JointPQPlayer,393,33,426,1,25,Player A
2993,JointPQPlayer,388,33,421,2,27,Player A
2994,JointPQPlayer,377,47,424,5,27,Player A
2995,JointPQPlayer,376,41,417,1,28,Player A
2996,JointPQPlayer,367,37,404,0,32,Player A
2997,JointPQPlayer,387,32,419,0,27,Player A
2998,JointPQPlayer,400,30,430,2,24,Player A
2999,JointPQPlayer,416,31,447,4,19,Player A
3000,JointPQPlayer,361,41,402,1,33,Player A
3001,JointPQPlayer,391,36,427,2,25,Player A
3002,JointPQPlayer,373,38,411,1,30,Player A
3003,JointPQPlayer,363,48,411,4,31,Player A
3004,JointPQPlayer,387,32,419,0,27,Player A
3005,JointPQPlayer,397,37,434,3,23,Player A
3006,JointPQPlayer,302,57,359,0,47,Player A
3007,JointPQPlayer,384,44,428,6,26,Player A
3008,JointPQPlayer,350,50,400,2,34,Player A
3009,JointPQPlayer,367,37,404,0,32,Player A
3010,JointPQPlayer,343,43,386,0,38,Player A
3011,JointPQPlayer,367,52,419,6,29,Player A
3012,JointPQPlayer,347,42,389,0,37,Player A
3013,JointPQPlayer,363,38,401,0,33,Player A
3014,JointPQPlayer,399,34,433,2,23,Player A
3015,JointPQPlayer,354,44,398,0,34,Player A
3016,JointPQPlayer,359,54,413,3,30,Player A
3017,JointPQPlayer,399,29,428,0,24,Player A
3018,JointPQPlayer,369,39,408,1,31,Player A
3019,JointPQPlayer,356,61,417,7,30,Player A
3020,JointPQPlayer,395,35,430,2,24,Player A
3021,JointPQPlayer,355,40,395,0,35,Player A
3022,JointPQPlayer,375,35,410,0,30,Player A
3023,JointPQPlayer,361,111,472,20,16,Player A
3024,JointPQPlayer,379,39,418,2,28,Player A
3025,JointPQPlayer,375,50,425,6,27,Player A
3026,JointPQPlayer,262,67,329,0,57,Player A
3027,JointPQPlayer,353,58,411,7,32,Player A
3028,JointPQPlayer,381,36,417,1,28,Player A
3029,JointPQPlayer,318,53,371,0,43,Player A
3030,JointPQPlayer,359,39,398,0,34,Player A
3031,JointPQPlayer,381,41,422,3,27,Player A
3032,JointPQPlayer,352,67,419,6,29,Player A
3033,JointPQPlayer,366,126,492,28,12,Player A
3034,JointPQPlayer,356,46,402,1,33,Player A
3035,JointPQPlayer,307,127,434,27,31,Player A
3036,JointPQPlayer,359,99,458,15,19,Player A
3037,JointPQPlayer,371,46,417,1,28,Player A
3038,JointPQPlayer,296,56,352,2,50,Player A
3039,JointPQPlayer,384,49,433,8,25,Player A
3040,JointPQPlayer,374,39,413,0,29,Player A
3041,JointPQPlayer,383,48,431,3,24,Player A
3042,JointPQPlayer,346,46,392,0,36,Player A
3043,JointPQPlayer,359,39,398,0,34,Player A
3044,JointPQPlayer,337,47,384,1,39,Player A
3045,JointPQPlayer,358,63,421,8,29,Player A
3046,JointPQPlayer,292,207,499,41,14,Player A
3047,JointPQPlayer,397,32,429,1,24,Player A
3048,JointPQPlayer,377,37,414,1,29,Player A
3049,JointPQPlayer,369,39,408,1,31,Player A
3050,JointPQPlayer,357,57,414,7,31,Player A
3051,JointPQPlayer,245,85,330,1,57,Player A
3052,JointPQPlayer,298,123,421,14,31,Player A
3053,JointPQPlayer,355,40,395,0,35,Player A
3054,JointPQPlayer,377,37,414,1,29,Player A
3055,JointPQPlayer,383,38,421,2,27,Player A
3056,JointPQPlayer,328,98,426,13,29,Player A
3057,JointPQPlayer,383,33,416,0,28,Player A
3058,JointPQPlayer,382,47,429,7,26,Player A
3059,JointPQPlayer,353,43,396,1,35,Player A
3060,JointPQPlayer,298,58,356,0,48,Player A
3061,JointPQPlayer,372,52,424,8,28,Player A
3062,JointPQPlayer,338,48,386,0,38,Player A
3063,JointPQPlayer,375,40,415,2,29,Player A
3064,JointPQPlayer,371,41,412,2,30,Player A
3065,JointPQPlayer,365,50,415,5,30,Player A
3066,JointPQPlayer,221,81,302,0,66,Player A
3067,JointPQPlayer,190,85,275,0,75,Player A
3068,JointPQPlayer,275,70,345,1,52,Player A
3069,JointPQPlayer,341,46,387,1,38,Player A
3070,JointPQPlayer,298,58,356,0,48,Player A
3071,JointPQPlayer,324,109,433,17,28,Player A
3072,JointPQPlayer,331,56,387,4,39,Player A
3073,JointPQPlayer,393,33,426,1,25,Player A
3074,JointPQPlayer,286,61,347,0,51,Player A
3075,JointPQPlayer,395,30,425,0,25,Player A
3076,JointPQPlayer,295,65,360,1,47,Player A
3077,JointPQPlayer,361,51,412,2,30,Player A
3078,JointPQPlayer,325,50,375,1,42,Player A
3079,JointPQPlayer,306,56,362,0,46,Player A
3080,JointPQPlayer,408,33,441,4,21,Player A
3081,JointPQPlayer,346,46,392,0,36,Player A
3082,JointPQPlayer,397,37,434,3,23,Player A
3083,JointPQPlayer,359,39,398,0,34,Player A
3084,JointPQPlayer,373,48,421,5,28,Player A
3085,JointPQPlayer,383,33,416,0,28,Player A
3086,JointPQPlayer,337,47,384,1,39,Player A
3087,JointPQPlayer,372,57,429,4,25,Player A
3088,JointPQPlayer,375,35,410,0,30,Player A
3089,JointPQPlayer,413,33,446,3,19,Player A
3090,JointPQPlayer,391,36,427,2,25,Player A
3091,JointPQPlayer,361,56,417,4,29,Player A
3092,JointPQPlayer,357,57,414,7,31,Player A
3093,JointPQPlayer,350,60,410,9,33,Player A
3094,JointPQPlayer,338,58,396,1,35,Player A
3095,JointPQPlayer,388,33,421,2,27,Player A
3096,JointPQPlayer,366,46,412,2,30,Player A
3097,JointPQPlayer,386,31,417,1,28,Player A
3098,JointPQPlayer,334,74,408,10,34,Player A
3099,JointPQPlayer,371,51,422,3,27,Player A
3100,JointPQPlayer,186,106,292,2,70,Player A
3101,JointPQPlayer,361,41,402,1,33,Player A
3102,JointPQPlayer,321,81,402,7,35,Player A
3103,JointPQPlayer,383,33,416,0,28,Player A
3104,JointPQPlayer,341,56,397,5,36,Player A
3105,JointPQPlayer,385,35,420,1,27,Player A
3106,JointPQPlayer,326,51,377,0,41,Player A
3107,JointPQPlayer,399,29,428,0,24,Player A
3108,JointPQPlayer,353,63,416,9,31,Player A
3109,JointPQPlayer,283,58,341,0,53,Player A
3110,JointPQPlayer,327,47,374,0,42,Player A
3111,JointPQPlayer,367,37,404,0,32,Player A
3112,JointPQPlayer,363,43,406,2,32,Player A
3113,JointPQPlayer,343,58,401,6,35,Player A
3114,JointPQPlayer,351,41,392,0,36,Player A
3115,JointPQPlayer,393,38,431,3,24,Player A
3116,JointPQPlayer,433,23,456,1,15,Player A
3117,JointPQPlayer,363,43,406,2,32,Player A
3118,JointPQPlayer,352,47,399,1,34,Player A
3119,JointPQPlayer,296,66,362,3,47,Player A
3120,JointPQPlayer,368,43,411,1,30,Player A
3121,JointPQPlayer,329,54,383,3,40,Player A
3122,JointPQPlayer,197,97,294,1,69,Player A
3123,JointPQPlayer,390,40,430,5,25,Player A
3124,JointPQPlayer,385,35,420,1,27,Player A
3125,JointPQPlayer,346,61,407,6,33,Player A
3126,JointPQPlayer,331,46,377,0,41,Player A
3127,JointPQPlayer,328,53,381,1,40,Player A
3128,JointPQPlayer,317,162,479,36,19,Player A
3129,JointPQPlayer,341,61,402,7,35,Player A
3130,JointPQPlayer,340,100,440,15,25,Player A
3131,JointPQPlayer,282,62,344,0,52,Player A
3132,JointPQPlayer,342,107,449,18,23,Player A
3133,JointPQPlayer,374,39,413,3,30,Player A
3134,JointPQPlayer,336,66,402,7,35,Player A
3135,JointPQPlayer,355,40,395,0,35,Player A
3136,JointPQPlayer,322,112,434,18,28,Player A
3137,JointPQPlayer,335,45,380,0,40,Player A
3138,JointPQPlayer,393,33,426,1,25,Player A
3139,JointPQPlayer,286,61,347,0,51,Player A
3140,JointPQPlayer,350,65,415,8,31,Player A
3141,JointPQPlayer,366,51,417,1,28,Player A
3142,JointPQPlayer,368,43,411,4,31,Player A
3143,JointPQPlayer,358,43,401,0,33,Player A
3144,JointPQPlayer,367,57,424,8,28,Player A
3145,JointPQPlayer,324,99,423,16,31,Player A
3146,JointPQPlayer,356,46,402,1,33,Player A
3147,JointPQPlayer,374,59,433,8,25,Player A
3148,JointPQPlayer,166,181,347,12,55,JointPQPlayer
3149,JointPQPlayer,331,46,377,0,41,Player A
3150,JointPQPlayer,385,35,420,1,27,Player A
3151,JointPQPlayer,379,34,413,0,29,Player A
3152,JointPQPlayer,375,35,410,0,30,Player A
3153,JointPQPlayer,315,50,365,0,45,Player A
3154,JointPQPlayer,343,48,391,2,37,Player A
3155,JointPQPlayer,365,40,405,1,32,Player A
3156,JointPQPlayer,335,45,380,0,40,Player A
3157,JointPQPlayer,332,107,439,17,26,Player A
3158,JointPQPlayer,242,72,314,0,62,Player A
3159,JointPQPlayer,363,38,401,0,33,Player A
3160,JointPQPlayer,371,46,417,4,29,Player A
3161,JointPQPlayer,335,80,415,8,31,Player A
3162,JointPQPlayer,351,41,392,0,36,Player A
3163,JointPQPlayer,357,42,399,1,34,Player A
3164,JointPQPlayer,362,97,459,16,19,Player A
3165,JointPQPlayer,360,60,420,4,28,Player A
3166,JointPQPlayer,373,38,411,1,30,Player A
3167,JointPQPlayer,300,75,375,7,44,Player A
3168,JointPQPlayer,368,48,416,3,29,Player A
3169,JointPQPlayer,281,61,342,1,53,Player A
3170,JointPQPlayer,362,62,424,8,28,Player A
3171,JointPQPlayer,383,43,426,4,26,Player A
3172,JointPQPlayer,377,42,419,3,28,Player A
3173,JointPQPlayer,390,40,430,5,25,Player A
3174,JointPQPlayer,357,42,399,1,34,Player A
3175,JointPQPlayer,383,43,426,4,26,Player A
3176,JointPQPlayer,355,40,395,0,35,Player A
3177,JointPQPlayer,359,39,398,0,34,Player A
3178,JointPQPlayer,381,36,417,1,28,Player A
3179,JointPQPlayer,379,39,418,2,28,Player A
3180,JointPQPlayer,355,55,410,3,31,Player A
3181,JointPQPlayer,335,60,395,3,36,Player A
3182,JointPQPlayer,380,45,425,6,27,Player A
3183,JointPQPlayer,325,120,445,20,25,Player A
3184,JointPQPlayer,411,26,437,0,21,Player A
3185,JointPQPlayer,359,54,413,3,30,Player A
3186,JointPQPlayer,397,32,429,1,24,Player A
3187,JointPQPlayer,397,32,429,1,24,Player A
3188,JointPQPlayer,318,53,371,0,43,Player A
3189,JointPQPlayer,375,35,410,0,30,Player A
3190,JointPQPlayer,345,45,390,1,37,Player A
3191,JointPQPlayer,360,45,405,4,33,Player A
3192,JointPQPlayer,322,62,384,4,40,Player A
3193,JointPQPlayer,344,49,393,1,36,Player A
3194,JointPQPlayer,361,41,402,1,33,Player A
3195,JointPQPlayer,390,35,425,3,26,Player A
3196,JointPQPlayer,385,35,420,1,27,Player A
3197,JointPQPlayer,389,34,423,1,26,Player A
3198,JointPQPlayer,387,37,424,2,26,Player A
3199,JointPQPlayer,327,57,384,4,40,Player A
3200,JointPQPlayer,380,40,420,4,28,Player A
3201,JointPQPlayer,307,102,409,11,34,Player A
3202,JointPQPlayer,373,38,411,1,30,Player A
3203,JointPQPlayer,390,35,425,0,25,Player A
3204,JointPQPlayer,384,29,413,0,29,Player A
3205,JointPQPlayer,325,135,460,26,22,Player A
3206,JointPQPlayer,353,113,466,20,18,Player A
3207,JointPQPlayer,369,39,408,1,31,Player A
3208,JointPQPlayer,410,35,445,5,20,Player A
3209,JointPQPlayer,357,57,414,7,31,Player A
3210,JointPQPlayer,321,126,447,22,25,Player A
3211,JointPQPlayer,318,53,371,0,43,Player A
3212,JointPQPlayer,345,55,400,2,34,Player A
3213,JointPQPlayer,403,28,431,0,23,Player A
3214,JointPQPlayer,385,35,420,1,27,Player A
3215,JointPQPlayer,379,44,423,4,27,Player A
3216,JointPQPlayer,351,56,407,3,32,Player A
3217,JointPQPlayer,254,264,518,54,12,JointPQPlayer
3218,JointPQPlayer,353,113,466,20,18,Player A
3219,JointPQPlayer,373,43,416,3,29,Player A
3220,JointPQPlayer,391,31,422,0,26,Player A
3221,JointPQPlayer,339,44,383,0,39,Player A
3222,JointPQPlayer,365,45,410,3,31,Player A
3223,JointPQPlayer,324,59,383,3,40,Player A
3224,JointPQPlayer,412,32,444,4,20,Player A
3225,JointPQPlayer,398,38,436,2,22,Player A
3226,JointPQPlayer,315,50,365,0,45,Player A
3227,JointPQPlayer,361,41,402,1,33,Player A
3228,JointPQPlayer,330,55,385,2,39,Player A
3229,JointPQPlayer,317,52,369,1,44,Player A
3230,JointPQPlayer,237,197,434,33,33,Player A
3231,JointPQPlayer,285,205,490,38,16,Player A
3232,JointPQPlayer,391,36,427,2,25,Player A
3233,JointPQPlayer,326,111,437,18,27,Player A
3234,JointPQPlayer,351,51,402,4,34,Player A
3235,JointPQPlayer,315,125,440,15,25,Player A
3236,JointPQPlayer,335,45,380,0,40,Player A
3237,JointPQPlayer,359,54,413,6,31,Player A
3238,JointPQPlayer,324,99,423,13,30,Player A
3239,JointPQPlayer,319,129,448,23,25,Player A
3240,JointPQPlayer,372,57,429,4,25,Player A
3241,JointPQPlayer,311,61,372,1,43,Player A
3242,JointPQPlayer,335,50,385,2,39,Player A
3243,JointPQPlayer,343,43,386,0,38,Player A
3244,JointPQPlayer,350,50,400,2,34,Player A
3245,JointPQPlayer,342,67,409,5,32,Player A
3246,JointPQPlayer,353,48,401,3,34,Player A
3247,JointPQPlayer,356,51,407,3,32,Player A
3248,JointPQPlayer,340,50,390,4,38,Player A
3249,JointPQPlayer,377,52,429,7,26,Player A
3250,JointPQPlayer,377,37,414,1,29,Player A
3251,JointPQPlayer,387,32,419,0,27,Player A
3252,JointPQPlayer,374,34,408,1,31,Player A
3253,JointPQPlayer,384,39,423,1,26,Player A
3254,JointPQPlayer,369,39,408,1,31,Player A
3255,JointPQPlayer,306,56,362,0,46,Player A
3256,JointPQPlayer,231,91,322,2,60,Player A
3257,JointPQPlayer,377,37,414,1,29,Player A
3258,JointPQPlayer,306,61,367,2,45,Player A
3259,JointPQPlayer,383,33,416,0,28,Player A
3260,JointPQPlayer,399,29,428,0,24,Player A
3261,JointPQPlayer,393,33,426,1,25,Player A
3262,JointPQPlayer,197,317,514,50,12,JointPQPlayer
3263,JointPQPlayer,318,93,411,7,32,Player A
3264,JointPQPlayer,367,37,404,0,32,Player A
3265,JointPQPlayer,344,104,448,17,23,Player A
3266,JointPQPlayer,373,38,411,1,30,Player A
3267,JointPQPlayer,385,40,425,3,26,Player A
3268,JointPQPlayer,343,43,386,0,38,Player A
3269,JointPQPlayer,288,68,356,3,49,Player A
3270,JointPQPlayer,325,65,390,4,38,Player A
3271,JointPQPlayer,325,55,380,3,41,Player A
3272,JointPQPlayer,308,58,366,1,45,Player A
3273,JointPQPlayer,370,50,420,7,29,Player A
3274,JointPQPlayer,366,46,412,2,30,Player A
3275,JointPQPlayer,369,39,408,1,31,Player A
3276,JointPQPlayer,370,60,430,5,25,Player A
3277,JointPQPlayer,330,100,430,14,28,Player A
3278,JointPQPlayer,367,37,404,0,32,Player A
3279,JointPQPlayer,371,46,417,1,28,Player A
3280,JointPQPlayer,308,108,416,15,33,Player A
3281,JointPQPlayer,286,61,347,0,51,Player A
3282,JointPQPlayer,397,32,429,1,24,Player A
3283,JointPQPlayer,389,34,423,1,26,Player A
3284,JointPQPlayer,362,62,424,5,27,Player A
3285,JointPQPlayer,357,52,409,2,31,Player A
3286,JointPQPlayer,337,57,394,2,36,Player A
3287,JointPQPlayer,353,43,396,1,35,Player A
3288,JointPQPlayer,357,47,404,3,33,Player A
3289,JointPQPlayer,336,86,422,12,30,Player A
3290,JointPQPlayer,312,127,439,26,29,Player A
3291,JointPQPlayer,332,82,414,10,32,Player A
3292,JointPQPlayer,389,39,428,3,25,Player A
3293,JointPQPlayer,312,67,379,2,41,Player A
3294,JointPQPlayer,321,106,427,17,30,Player A
3295,JointPQPlayer,225,135,360,7,49,Player A
3296,JointPQPlayer,343,43,386,0,38,Player A
3297,JointPQPlayer,403,28,431,0,23,Player A
3298,JointPQPlayer,387,32,419,0,27,Player A
3299,JointPQPlayer,339,44,383,0,39,Player A
3300,JointPQPlayer,382,32,414,1,29,Player A
3301,JointPQPlayer,358,48,406,2,32,Player A
3302,JointPQPlayer,359,54,413,3,30,Player A
3303,JointPQPlayer,391,31,422,0,26,Player A
3304,JointPQPlayer,381,36,417,1,28,Player A
3305,JointPQPlayer,269,79,348,1,51,Player A
3306,JointPQPlayer,392,27,419,0,27,Player A
3307,JointPQPlayer,355,40,395,0,35,Player A
3308,JointPQPlayer,383,33,416,0,28,Player A
3309,JointPQPlayer,359,39,398,0,34,Player A
3310,JointPQPlayer,409,29,438,1,21,Player A
3311,JointPQPlayer,387,37,424,2,26,Player A
3312,JointPQPlayer,355,40,395,0,35,Player A
3313,JointPQPlayer,361,51,412,5,31,Player A
3314,JointPQPlayer,340,65,405,7,34,Player A
3315,JointPQPlayer,366,46,412,2,30,Player A
3316,JointPQPlayer,327,47,374,0,42,Player A
3317,JointPQPlayer,367,52,419,3,28,Player A
3318,JointPQPlayer,377,42,419,3,28,Player A
3319,JointPQPlayer,369,39,408,1,31,Player A
3320,JointPQPlayer,375,35,410,0,30,Player A
3321,JointPQPlayer,385,35,420,1,27,Player A
3322,JointPQPlayer,407,27,434,0,22,Player A
3323,JointPQPlayer,303,53,356,0,48,Player A
3324,JointPQPlayer,357,42,399,1,34,Player A
3325,JointPQPlayer,355,50,405,4,33,Player A
3326,JointPQPlayer,338,63,401,6,35,Player A
3327,JointPQPlayer,363,43,406,2,32,Player A
3328,JointPQPlayer,387,32,419,0,27,Player A
3329,JointPQPlayer,281,61,342,1,53,Player A
3330,JointPQPlayer,369,39,408,1,31,Player A
3331,JointPQPlayer,205,85,290,0,70,Player A
3332,JointPQPlayer,417,27,444,1,19,Player A
3333,JointPQPlayer,393,38,431,3,24,Player A
3334,JointPQPlayer,411,31,442,2,20,Player A
3335,JointPQPlayer,275,100,375,7,44,Player A
3336,JointPQPlayer,332,52,384,1,39,Player A
3337,JointPQPlayer,360,65,425,6,27,Player A
3338,JointPQPlayer,279,69,348,1,51,Player A
3339,JointPQPlayer,339,79,418,8,30,Player A
3340,JointPQPlayer,335,45,380,0,40,Player A
3341,JointPQPlayer,397,32,429,1,24,Player A
3342,JointPQPlayer,379,34,413,0,29,Player A
3343,JointPQPlayer,379,44,423,4,27,Player A
3344,JointPQPlayer,324,104,428,12,28,Player A
3345,JointPQPlayer,327,47,374,0,42,Player A
3346,JointPQPlayer,397,32,429,1,24,Player A
3347,JointPQPlayer,361,46,407,3,32,Player A
3348,JointPQPlayer,278,108,386,12,42,Player A
3349,JointPQPlayer,344,94,438,16,26,Player A
3350,JointPQPlayer,332,62,394,5,37,Player A
3351,JointPQPlayer,350,45,395,3,36,Player A
3352,JointPQPlayer,369,49,418,5,29,Player A
3353,JointPQPlayer,370,50,420,4,28,Player A
3354,JointPQPlayer,393,33,426,1,25,Player A
3355,JointPQPlayer,363,48,411,4,31,Player A
3356,JointPQPlayer,377,37,414,1,29,Player A
3357,JointPQPlayer,384,44,428,6,26,Player A
3358,JointPQPlayer,347,52,399,1,34,Player A
3359,JointPQPlayer,290,60,350,0,50,Player A
3360,JointPQPlayer,375,35,410,0,30,Player A
3361,JointPQPlayer,366,46,412,2,30,Player A
3362,JointPQPlayer,375,35,410,0,30,Player A
3363,JointPQPlayer,355,40,395,0,35,Player A
3364,JointPQPlayer,363,43,406,2,32,Player A
3365,JointPQPlayer,359,54,413,6,31,Player A
3366,JointPQPlayer,325,135,460,26,22,Player A
3367,JointPQPlayer,383,33,416,0,28,Player A
3368,JointPQPlayer,375,40,415,2,29,Player A
3369,JointPQPlayer,363,43,406,2,32,Player A
3370,JointPQPlayer,340,60,400,5,35,Player A
3371,JointPQPlayer,291,66,357,1,48,Player A
3372,JointPQPlayer,312,57,369,1,44,Player A
3373,JointPQPlayer,397,32,429,1,24,Player A
3374,JointPQPlayer,381,36,417,1,28,Player A
3375,JointPQPlayer,358,98,456,16,20,Player A
3376,JointPQPlayer,371,36,407,0,31,Player A
3377,JointPQPlayer,289,189,478,35,19,Player A
3378,JointPQPlayer,371,36,407,0,31,Player A
3379,JointPQPlayer,369,44,413,3,30,Player A
3380,JointPQPlayer,343,43,386,0,38,Player A
3381,JointPQPlayer,343,43,386,0,38,Player A
3382,JointPQPlayer,294,59,353,0,49,Player A
3383,JointPQPlayer,318,53,371,0,43,Player A
3384,JointPQPlayer,365,65,430,8,26,Player A
3385,JointPQPlayer,361,41,402,1,33,Player A
3386,JointPQPlayer,374,39,413,3,30,Player A
3387,JointPQPlayer,330,115,445,17,24,Player A
3388,JointPQPlayer,385,35,420,1,27,Player A
3389,JointPQPlayer,363,38,401,0,33,Player A
3390,JointPQPlayer,361,41,402,1,33,Player A
3391,JointPQPlayer,394,34,428,3,25,Player A
3392,JointPQPlayer,308,133,441,25,28,Player A
3393,JointPQPlayer,373,53,426,4,26,Player A
3394,JointPQPlayer,339,44,383,0,39,Player A
3395,JointPQPlayer,325,50,375,1,42,Player A
3396,JointPQPlayer,347,42,389,0,37,Player A
3397,JointPQPlayer,359,39,398,0,34,Player A
3398,JointPQPlayer,339,44,383,0,39,Player A
3399,JointPQPlayer,344,69,413,6,31,Player A
3400,JointPQPlayer,320,55,375,1,42,Player A
3401,JointPQPlayer,351,41,392,0,36,Player A
3402,JointPQPlayer,387,32,419,0,27,Player A
3403,JointPQPlayer,355,45,400,2,34,Player A
3404,JointPQPlayer,380,45,425,6,27,Player A
3405,JointPQPlayer,336,111,447,16,23,Player A
3406,JointPQPlayer,291,66,357,1,48,Player A
3407,JointPQPlayer,387,47,434,6,24,Player A
3408,JointPQPlayer,395,30,425,0,25,Player A
3409,JointPQPlayer,343,43,386,0,38,Player A
3410,JointPQPlayer,381,36,417,1,28,Player A
3411,JointPQPlayer,347,42,389,0,37,Player A
3412,JointPQPlayer,365,40,405,1,32,Player A
3413,JointPQPlayer,339,49,388,2,38,Player A
3414,JointPQPlayer,354,44,398,0,34,Player A
3415,JointPQPlayer,358,93,451,14,21,Player A
3416,JointPQPlayer,379,44,423,4,27,Player A
3417,JointPQPlayer,349,49,398,3,35,Player A
3418,JointPQPlayer,338,48,386,0,38,Player A
3419,JointPQPlayer,375,40,415,2,29,Player A
3420,JointPQPlayer,343,43,386,0,38,Player A
3421,JointPQPlayer,294,174,468,31,21,Player A
3422,JointPQPlayer,330,60,390,1,37,Player A
3423,JointPQPlayer,379,39,418,2,28,Player A
3424,JointPQPlayer,357,77,434,6,24,Player A
3425,JointPQPlayer,385,35,420,1,27,Player A
3426,JointPQPlayer,363,38,401,0,33,Player A
3427,JointPQPlayer,246,236,482,33,17,Player A
3428,JointPQPlayer,362,57,419,6,29,Player A
3429,JointPQPlayer,399,34,433,2,23,Player A
3430,JointPQPlayer,357,47,404,3,33,Player A
3431,JointPQPlayer,331,46,377,0,41,Player A
3432,JointPQPlayer,373,43,416,3,29,Player A
3433,JointPQPlayer,346,61,407,6,33,Player A
3434,JointPQPlayer,387,32,419,0,27,Player A
3435,JointPQPlayer,359,39,398,0,34,Player A
3436,JointPQPlayer,377,37,414,1,29,Player A
3437,JointPQPlayer,306,56,362,0,46,Player A
3438,JointPQPlayer,341,46,387,1,38,Player A
3439,JointPQPlayer,377,42,419,3,28,Player A
3440,JointPQPlayer,334,104,438,13,25,Player A
3441,JointPQPlayer,407,32,439,2,21,Player A
3442,JointPQPlayer,304,69,373,5,44,Player A
3443,JointPQPlayer,307,52,359,0,47,Player A
3444,JointPQPlayer,371,41,412,2,30,Player A
3445,JointPQPlayer,265,80,345,4,53,Player A
3446,JointPQPlayer,355,45,400,2,34,Player A
3447,JointPQPlayer,295,65,360,1,47,Player A
3448,JointPQPlayer,380,35,415,2,29,Player A
3449,JointPQPlayer,395,40,435,4,23,Player A
3450,JointPQPlayer,375,40,415,2,29,Player A
3451,JointPQPlayer,351,71,422,6,28,Player A
3452,JointPQPlayer,371,36,407,0,31,Player A
3453,JointPQPlayer,363,38,401,0,33,Player A
3454,JointPQPlayer,331,46,377,0,41,Player A
3455,JointPQPlayer,386,31,417,1,28,Player A
3456,JointPQPlayer,324,74,398,9,37,Player A
3457,JointPQPlayer,368,53,421,5,28,Player A
3458,JointPQPlayer,331,61,392,3,37,Player A
3459,JointPQPlayer,383,38,421,2,27,Player A
3460,JointPQPlayer,371,36,407,0,31,Player A
3461,JointPQPlayer,353,53,406,2,32,Player A
3462,JointPQPlayer,324,64,388,5,39,Player A
3463,JointPQPlayer,393,33,426,1,25,Player A
3464,JointPQPlayer,405,35,440,3,21,Player A
3465,JointPQPlayer,339,44,383,0,39,Player A
3466,JointPQPlayer,359,44,403,2,33,Player A
3467,JointPQPlayer,405,30,435,1,22,Player A
3468,JointPQPlayer,319,49,368,0,44,Player A
3469,JointPQPlayer,351,51,402,4,34,Player A
3470,JointPQPlayer,403,28,431,0,23,Player A
3471,JointPQPlayer,387,37,424,2,26,Player A
3472,JointPQPlayer,254,69,323,0,59,Player A
3473,JointPQPlayer,342,62,404,6,34,Player A
3474,JointPQPlayer,340,50,390,1,37,Player A
3475,JointPQPlayer,335,120,455,21,22,Player A
3476,JointPQPlayer,399,34,433,2,23,Player A
3477,JointPQPlayer,256,111,367,11,48,Player A
3478,JointPQPlayer,365,45,410,3,31,Player A
3479,JointPQPlayer,257,72,329,0,57,Player A
3480,JointPQPlayer,356,101,457,17,20,Player A
3481,JointPQPlayer,356,56,412,5,31,Player A
3482,JointPQPlayer,315,50,365,0,45,Player A
3483,JointPQPlayer,347,42,389,0,37,Player A
3484,JointPQPlayer,377,52,429,7,26,Player A
3485,JointPQPlayer,390,40,430,2,24,Player A
3486,JointPQPlayer,351,41,392,0,36,Player A
3487,JointPQPlayer,286,61,347,0,51,Player A
3488,JointPQPlayer,339,44,383,0,39,Player A
3489,JointPQPlayer,413,28,441,1,20,Player A
3490,JointPQPlayer,399,29,428,0,24,Player A
3491,JointPQPlayer,201,91,292,2,70,Player A
3492,JointPQPlayer,385,35,420,1,27,Player A
3493,JointPQPlayer,369,44,413,3,30,Player A
3494,JointPQPlayer,372,97,469,17,16,Player A
3495,JointPQPlayer,410,30,440,3,21,Player A
3496,JointPQPlayer,333,58,391,2,37,Player A
3497,JointPQPlayer,308,58,366,1,45,Player A
3498,JointPQPlayer,335,65,400,2,34,Player A
3499,JointPQPlayer,347,42,389,0,37,Player A
3500,JointPQPlayer,350,45,395,3,36,Player A
3501,JointPQPlayer,336,66,402,7,35,Player A
3502,JointPQPlayer,366,41,407,3,32,Player A
3503,JointPQPlayer,344,49,393,1,36,Player A
3504,JointPQPlayer,403,28,431,0,23,Player A
3505,JointPQPlayer,349,44,393,1,36,Player A
3506,JointPQPlayer,369,39,408,1,31,Player A
3507,JointPQPlayer,379,34,413,0,29,Player A
3508,JointPQPlayer,354,39,393,1,36,Player A
3509,JointPQPlayer,361,46,407,3,32,Player A
3510,JointPQPlayer,377,37,414,1,29,Player A
3511,JointPQPlayer,383,33,416,0,28,Player A
3512,JointPQPlayer,351,41,392,0,36,Player A
3513,JointPQPlayer,393,33,426,1,25,Player A
3514,JointPQPlayer,361,41,402,1,33,Player A
3515,JointPQPlayer,324,64,388,5,39,Player A
3516,JointPQPlayer,359,39,398,0,34,Player A
3517,JointPQPlayer,323,48,371,0,43,Player A
3518,JointPQPlayer,409,34,443,3,20,Player A
3519,JointPQPlayer,399,34,433,2,23,Player A
3520,JointPQPlayer,357,52,409,5,32,Player A
3521,JointPQPlayer,383,33,416,0,28,Player A
3522,JointPQPlayer,351,41,392,0,36,Player A
3523,JointPQPlayer,355,45,400,2,34,Player A
3524,JointPQPlayer,249,74,323,0,59,Player A
3525,JointPQPlayer,391,41,432,4,24,Player A
3526,JointPQPlayer,424,29,453,4,17,Player A
3527,JointPQPlayer,257,72,329,0,57,Player A
3528,JointPQPlayer,383,43,426,4,26,Player A
3529,JointPQPlayer,375,35,410,0,30,Player A
3530,JointPQPlayer,387,47,434,3,23,Player A
3531,JointPQPlayer,367,37,404,0,32,Player A
3532,JointPQPlayer,263,88,351,4,51,Player A
3533,JointPQPlayer,306,56,362,0,46,Player A
3534,JointPQPlayer,403,28,431,0,23,Player A
3535,JointPQPlayer,363,38,401,0,33,Player A
3536,JointPQPlayer,389,34,423,1,26,Player A
3537,JointPQPlayer,392,37,429,4,25,Player A
3538,JointPQPlayer,350,75,425,6,27,Player A
3539,JointPQPlayer,319,49,368,0,44,Player A
3540,JointPQPlayer,306,56,362,0,46,Player A
3541,JointPQPlayer,424,24,448,2,18,Player A
3542,JointPQPlayer,389,39,428,3,25,Player A
3543,JointPQPlayer,389,34,423,1,26,Player A
3544,JointPQPlayer,307,67,374,3,43,Player A
3545,JointPQPlayer,341,81,422,12,30,Player A
3546,JointPQPlayer,388,38,426,1,25,Player A
3547,JointPQPlayer,375,40,415,2,29,Player A
3548,JointPQPlayer,311,76,387,7,40,Player A
3549,JointPQPlayer,336,51,387,1,38,Player A
3550,JointPQPlayer,333,58,391,2,37,Player A
3551,JointPQPlayer,331,66,397,8,37,Player A
3552,JointPQPlayer,364,44,408,1,31,Player A
3553,JointPQPlayer,401,31,432,1,23,Player A
3554,JointPQPlayer,363,38,401,0,33,Player A
3555,JointPQPlayer,389,54,443,9,22,Player A
3556,JointPQPlayer,335,100,435,13,26,Player A
3557,JointPQPlayer,387,32,419,0,27,Player A
3558,JointPQPlayer,362,37,399,1,34,Player A
3559,JointPQPlayer,373,43,416,3,29,Player A
3560,JointPQPlayer,375,40,415,2,29,Player A
3561,JointPQPlayer,329,114,443,15,24,Player A
3562,JointPQPlayer,347,82,429,10,27,Player A
3563,JointPQPlayer,392,42,434,6,24,Player A
3564,JointPQPlayer,390,35,425,0,25,Player A
3565,JointPQPlayer,266,66,332,0,56,Player A
3566,JointPQPlayer,315,50,365,0,45,Player A
3567,JointPQPlayer,367,47,414,4,30,Player A
3568,JointPQPlayer,399,29,428,0,24,Player A
3569,JointPQPlayer,409,29,438,1,21,Player A
3570,JointPQPlayer,193,278,471,49,26,JointPQPlayer
3571,JointPQPlayer,331,81,412,5,31,Player A
3572,JointPQPlayer,322,52,374,0,42,Player A
3573,JointPQPlayer,391,31,422,0,26,Player A
3574,JointPQPlayer,359,39,398,0,34,Player A
3575,JointPQPlayer,365,40,405,1,32,Player A
3576,JointPQPlayer,351,41,392,0,36,Player A
3577,JointPQPlayer,251,91,342,4,54,Player A
3578,JointPQPlayer,337,72,409,5,32,Player A
3579,JointPQPlayer,339,44,383,0,39,Player A
3580,JointPQPlayer,377,47,424,5,27,Player A
3581,JointPQPlayer,347,47,394,2,36,Player A
3582,JointPQPlayer,357,52,409,2,31,Player A
3583,JointPQPlayer,367,42,409,2,31,Player A
3584,JointPQPlayer,387,32,419,0,27,Player A
3585,JointPQPlayer,381,41,422,3,27,Player A
3586,JointPQPlayer,361,41,402,1,33,Player A
3587,JointPQPlayer,391,36,427,2,25,Player A
3588,JointPQPlayer,385,40,425,3,26,Player A
3589,JointPQPlayer,367,37,404,0,32,Player A
3590,JointPQPlayer,286,86,372,4,44,Player A
3591,JointPQPlayer,354,54,408,7,33,Player A
3592,JointPQPlayer,343,78,421,14,31,Player A
3593,JointPQPlayer,353,58,411,4,31,Player A
3594,JointPQPlayer,343,43,386,0,38,Player A
3595,JointPQPlayer,339,44,383,0,39,Player A
3596,JointPQPlayer,367,37,404,0,32,Player A
3597,JointPQPlayer,343,43,386,0,38,Player A
3598,JointPQPlayer,406,31,437,3,22,Player A
3599,JointPQPlayer,387,42,429,4,25,Player A
3600,JointPQPlayer,387,42,429,4,25,Player A
3601,JointPQPlayer,374,39,413,0,29,Player A
3602,JointPQPlayer,354,44,398,3,35,Player A
3603,JointPQPlayer,379,39,418,2,28,Player A
3604,JointPQPlayer,346,51,397,2,35,Player A
3605,JointPQPlayer,388,33,421,2,27,Player A
3606,JointPQPlayer,342,47,389,0,37,Player A
3607,JointPQPlayer,376,36,412,2,30,Player A
3608,JointPQPlayer,338,63,401,3,34,Player A
3609,JointPQPlayer,354,49,403,2,33,Player A
3610,JointPQPlayer,378,33,411,1,30,Player A
3611,JointPQPlayer,359,49,408,4,32,Player A
3612,JointPQPlayer,353,43,396,1,35,Player A
3613,JointPQPlayer,337,57,394,2,36,Player A
3614,JointPQPlayer,213,333,546,67,7,JointPQPlayer
3615,JointPQPlayer,216,186,402,19,39,Player A
3616,JointPQPlayer,375,40,415,2,29,Player A
3617,JointPQPlayer,367,37,404,0,32,Player A
3618,JointPQPlayer,381,41,422,3,27,Player A
3619,JointPQPlayer,347,67,414,7,31,Player A
3620,JointPQPlayer,361,51,412,2,30,Player A
3621,JointPQPlayer,363,58,421,8,29,Player A
3622,JointPQPlayer,373,48,421,5,28,Player A
3623,JointPQPlayer,386,46,432,7,25,Player A
3624,JointPQPlayer,370,45,415,2,29,Player A
3625,JointPQPlayer,343,43,386,0,38,Player A
3626,JointPQPlayer,403,33,436,2,22,Player A
3627,JointPQPlayer,385,35,420,1,27,Player A
3628,JointPQPlayer,197,87,284,0,72,Player A
3629,JointPQPlayer,352,62,414,10,32,Player A
3630,JointPQPlayer,271,111,382,8,42,Player A
3631,JointPQPlayer,381,36,417,1,28,Player A
3632,JointPQPlayer,331,46,377,0,41,Player A
3633,JointPQPlayer,368,48,416,3,29,Player A
3634,JointPQPlayer,351,41,392,0,36,Player A
3635,JointPQPlayer,300,75,375,7,44,Player A
3636,JointPQPlayer,338,103,441,13,24,Player A
3637,JointPQPlayer,318,68,386,3,39,Player A
3638,JointPQPlayer,266,66,332,0,56,Player A
3639,JointPQPlayer,340,70,410,9,33,Player A
3640,JointPQPlayer,395,35,430,2,24,Player A
3641,JointPQPlayer,359,39,398,0,34,Player A
3642,JointPQPlayer,297,162,459,28,23,Player A
3643,JointPQPlayer,377,62,439,8,23,Player A
3644,JointPQPlayer,409,29,438,1,21,Player A
3645,JointPQPlayer,299,54,353,0,49,Player A
3646,JointPQPlayer,310,55,365,0,45,Player A
3647,JointPQPlayer,309,54,363,1,46,Player A
3648,JointPQPlayer,310,60,370,2,44,Player A
3649,JointPQPlayer,371,46,417,4,29,Player A
3650,JointPQPlayer,385,35,420,1,27,Player A
3651,JointPQPlayer,367,37,404,0,32,Player A
3652,JointPQPlayer,367,37,404,0,32,Player A
3653,JointPQPlayer,365,40,405,1,32,Player A
3654,JointPQPlayer,375,35,410,0,30,Player A
3655,JointPQPlayer,321,66,387,7,40,Player A
3656,JointPQPlayer,367,37,404,0,32,Player A
3657,JointPQPlayer,375,40,415,2,29,Player A
3658,JointPQPlayer,362,42,404,0,32,Player A
3659,JointPQPlayer,378,33,411,1,30,Player A
3660,JointPQPlayer,392,42,434,6,24,Player A
3661,JointPQPlayer,337,72,409,8,33,Player A
3662,JointPQPlayer,382,32,414,1,29,Player A
3663,JointPQPlayer,281,96,377,6,43,Player A
3664,JointPQPlayer,351,51,402,1,33,Player A
3665,JointPQPlayer,383,43,426,4,26,Player A
3666,JointPQPlayer,375,35,410,0,30,Player A
3667,JointPQPlayer,367,37,404,0,32,Player A
3668,JointPQPlayer,375,40,415,2,29,Player A
3669,JointPQPlayer,369,49,418,5,29,Player A
3670,JointPQPlayer,321,61,382,2,40,Player A
3671,JointPQPlayer,335,50,385,2,39,Player A
3672,JointPQPlayer,347,42,389,0,37,Player A
3673,JointPQPlayer,325,125,450,22,24,Player A
3674,JointPQPlayer,347,42,389,0,37,Player A
3675,JointPQPlayer,371,36,407,0,31,Player A
3676,JointPQPlayer,414,34,448,5,19,Player A
3677,JointPQPlayer,382,42,424,5,27,Player A
3678,JointPQPlayer,289,64,353,0,49,Player A
3679,JointPQPlayer,381,41,422,3,27,Player A
3680,JointPQPlayer,373,38,411,1,30,Player A
3681,JointPQPlayer,418,28,446,3,19,Player A
3682,JointPQPlayer,369,49,418,5,29,Player A
3683,JointPQPlayer,403,33,436,2,22,Player A
3684,JointPQPlayer,365,45,410,3,31,Player A
3685,JointPQPlayer,387,32,419,0,27,Player A
3686,JointPQPlayer,369,49,418,5,29,Player A
3687,JointPQPlayer,241,76,317,0,61,Player A
3688,JointPQPlayer,286,61,347,0,51,Player A
3689,JointPQPlayer,365,40,405,1,32,Player A
3690,JointPQPlayer,373,53,426,7,27,Player A
3691,JointPQPlayer,349,54,403,5,34,Player A
3692,JointPQPlayer,359,39,398,0,34,Player A
3693,JointPQPlayer,345,45,390,1,37,Player A
3694,JointPQPlayer,299,109,408,16,36,Player A
3695,JointPQPlayer,287,82,369,1,44,Player A
3696,JointPQPlayer,377,42,419,3,28,Player A
3697,JointPQPlayer,396,31,427,2,25,Player A
3698,JointPQPlayer,365,55,420,7,29,Player A
3699,JointPQPlayer,372,67,439,11,24,Player A
3700,JointPQPlayer,337,72,409,8,33,Player A
3701,JointPQPlayer,393,43,436,5,23,Player A
3702,JointPQPlayer,335,100,435,13,26,Player A
3703,JointPQPlayer,314,84,398,0,34,Player A
3704,JointPQPlayer,388,33,421,2,27,Player A
3705,JointPQPlayer,391,46,437,6,23,Player A
3706,JointPQPlayer,345,90,435,13,26,Player A
3707,JointPQPlayer,356,46,402,1,33,Player A
3708,JointPQPlayer,221,316,537,67,10,JointPQPlayer
3709,JointPQPlayer,359,39,398,0,34,Player A
3710,JointPQPlayer,170,235,405,28,41,JointPQPlayer
3711,JointPQPlayer,287,67,354,1,49,Player A
3712,JointPQPlayer,372,42,414,1,29,Player A
3713,JointPQPlayer,386,31,417,1,28,Player A
3714,JointPQPlayer,403,33,436,2,22,Player A
3715,JointPQPlayer,369,39,408,1,31,Player A
3716,JointPQPlayer,361,46,407,3,32,Player A
3717,JointPQPlayer,372,57,429,4,25,Player A
3718,JointPQPlayer,403,33,436,2,22,Player A
3719,JointPQPlayer,367,47,414,4,30,Player A
3720,JointPQPlayer,363,38,401,0,33,Player A
3721,JointPQPlayer,349,44,393,1,36,Player A
3722,JointPQPlayer,375,35,410,0,30,Player A
3723,JointPQPlayer,369,39,408,1,31,Player A
3724,JointPQPlayer,391,31,422,0,26,Player A
3725,JointPQPlayer,409,29,438,1,21,Player A
3726,JointPQPlayer,325,135,460,26,22,Player A
3727,JointPQPlayer,331,121,452,21,23,Player A
3728,JointPQPlayer,379,49,428,6,26,Player A
3729,JointPQPlayer,340,105,445,14,23,Player A
3730,JointPQPlayer,304,89,393,4,37,Player A
3731,JointPQPlayer,353,58,411,7,32,Player A
3732,JointPQPlayer,340,100,440,15,25,Player A
3733,JointPQPlayer,383,33,416,0,28,Player A
3734,JointPQPlayer,379,39,418,2,28,Player A
3735,JointPQPlayer,367,37,404,0,32,Player A
3736,JointPQPlayer,342,57,399,7,36,Player A
3737,JointPQPlayer,394,39,433,2,23,Player A
3738,JointPQPlayer,323,58,381,4,41,Player A
3739,JointPQPlayer,264,124,388,14,42,Player A
3740,JointPQPlayer,288,63,351,4,51,Player A
3741,JointPQPlayer,329,79,408,10,34,Player A
3742,JointPQPlayer,361,41,402,1,33,Player A
3743,JointPQPlayer,366,56,422,3,27,Player A
3744,JointPQPlayer,366,46,412,5,31,Player A
3745,JointPQPlayer,338,53,391,2,37,Player A
3746,JointPQPlayer,379,34,413,0,29,Player A
3747,JointPQPlayer,379,39,418,2,28,Player A
3748,JointPQPlayer,385,35,420,1,27,Player A
3749,JointPQPlayer,351,41,392,0,36,Player A
3750,JointPQPlayer,411,31,442,2,20,Player A
3751,JointPQPlayer,379,34,413,0,29,Player A
3752,JointPQPlayer,271,71,342,4,54,Player A
3753,JointPQPlayer,350,50,400,2,34,Player A
3754,JointPQPlayer,388,33,421,2,27,Player A
3755,JointPQPlayer,352,62,414,4,30,Player A
3756,JointPQPlayer,367,37,404,0,32,Player A
3757,JointPQPlayer,371,46,417,1,28,Player A
3758,JointPQPlayer,386,36,422,3,27,Player A
3759,JointPQPlayer,342,57,399,4,35,Player A
3760,JointPQPlayer,383,48,431,6,25,Player A
3761,JointPQPlayer,368,43,411,4,31,Player A
3762,JointPQPlayer,358,48,406,2,32,Player A
3763,JointPQPlayer,384,49,433,8,25,Player A
3764,JointPQPlayer,359,44,403,2,33,Player A
3765,JointPQPlayer,385,35,420,1,27,Player A
3766,JointPQPlayer,355,60,415,2,29,Player A
3767,JointPQPlayer,355,40,395,0,35,Player A
3768,JointPQPlayer,259,194,453,28,25,Player A
3769,JointPQPlayer,366,51,417,7,30,Player A
3770,JointPQPlayer,367,42,409,2,31,Player A
3771,JointPQPlayer,383,33,416,0,28,Player A
3772,JointPQPlayer,360,45,405,1,32,Player A
3773,JointPQPlayer,397,32,429,1,24,Player A
3774,JointPQPlayer,370,50,420,4,28,Player A
3775,JointPQPlayer,342,67,409,5,32,Player A
3776,JointPQPlayer,375,35,410,0,30,Player A
3777,JointPQPlayer,277,237,514,50,12,Player A
3778,JointPQPlayer,374,49,423,4,27,Player A
3779,JointPQPlayer,315,50,365,0,45,Player A
3780,JointPQPlayer,269,184,453,28,25,Player A
3781,JointPQPlayer,274,64,338,0,54,Player A
3782,JointPQPlayer,361,41,402,1,33,Player A
3783,JointPQPlayer,331,46,377,0,41,Player A
3784,JointPQPlayer,363,48,411,4,31,Player A
3785,JointPQPlayer,391,36,427,2,25,Player A
3786,JointPQPlayer,391,31,422,0,26,Player A
3787,JointPQPlayer,339,44,383,0,39,Player A
3788,JointPQPlayer,331,146,477,25,16,Player A
3789,JointPQPlayer,351,56,407,6,33,Player A
3790,JointPQPlayer,197,117,314,9,65,Player A
3791,JointPQPlayer,320,155,475,29,18,Player A
3792,JointPQPlayer,395,35,430,2,24,Player A
3793,JointPQPlayer,389,34,423,1,26,Player A
3794,JointPQPlayer,385,35,420,1,27,Player A
3795,JointPQPlayer,347,42,389,0,37,Player A
3796,JointPQPlayer,342,142,484,29,15,Player A
3797,JointPQPlayer,359,69,428,0,24,Player A
3798,JointPQPlayer,341,56,397,5,36,Player A
3799,JointPQPlayer,219,89,308,0,64,Player A
3800,JointPQPlayer,389,34,423,1,26,Player A
3801,JointPQPlayer,310,55,365,0,45,Player A
3802,JointPQPlayer,393,33,426,1,25,Player A
3803,JointPQPlayer,418,28,446,3,19,Player A
3804,JointPQPlayer,378,43,421,2,27,Player A
3805,JointPQPlayer,347,42,389,0,37,Player A
3806,JointPQPlayer,363,38,401,0,33,Player A
3807,JointPQPlayer,398,33,431,3,24,Player A
3808,JointPQPlayer,350,55,405,4,33,Player A
3809,JointPQPlayer,395,35,430,2,24,Player A
3810,JointPQPlayer,363,38,401,0,33,Player A
3811,JointPQPlayer,243,83,326,3,59,Player A
3812,JointPQPlayer,373,48,421,5,28,Player A
3813,JointPQPlayer,386,36,422,0,26,Player A
3814,JointPQPlayer,369,39,408,1,31,Player A
3815,JointPQPlayer,382,32,414,1,29,Player A
3816,JointPQPlayer,331,56,387,1,38,Player A
3817,JointPQPlayer,295,75,370,2,44,Player A
3818,JointPQPlayer,359,39,398,0,34,Player A
3819,JointPQPlayer,377,47,424,5,27,Player A
3820,JointPQPlayer,323,133,456,25,23,Player A
3821,JointPQPlayer,153,98,251,0,83,Player A
3822,JointPQPlayer,351,126,477,25,16,Player A
3823,JointPQPlayer,223,288,511,47,12,JointPQPlayer
3824,JointPQPlayer,381,41,422,3,27,Player A
3825,JointPQPlayer,383,43,426,4,26,Player A
3826,JointPQPlayer,377,37,414,1,29,Player A
3827,JointPQPlayer,413,28,441,1,20,Player A
3828,JointPQPlayer,347,42,389,0,37,Player A
3829,JointPQPlayer,343,43,386,0,38,Player A
3830,JointPQPlayer,393,33,426,1,25,Player A
3831,JointPQPlayer,381,41,422,3,27,Player A
3832,JointPQPlayer,361,41,402,1,33,Player A
3833,JointPQPlayer,333,83,416,9,31,Player A
3834,JointPQPlayer,278,63,341,0,53,Player A
3835,JointPQPlayer,389,34,423,1,26,Player A
3836,JointPQPlayer,304,59,363,1,46,Player A
3837,JointPQPlayer,396,36,432,4,24,Player A
3838,JointPQPlayer,331,61,392,3,37,Player A
3839,JointPQPlayer,218,208,426,43,39,Player A
3840,JointPQPlayer,281,206,487,38,17,Player A
3841,JointPQPlayer,375,45,420,4,28,Player A
3842,JointPQPlayer,349,54,403,5,34,Player A
3843,JointPQPlayer,357,42,399,1,34,Player A
3844,JointPQPlayer,373,38,411,1,30,Player A
3845,JointPQPlayer,367,37,404,0,32,Player A
3846,JointPQPlayer,397,32,429,1,24,Player A
3847,JointPQPlayer,354,44,398,0,34,Player A
3848,JointPQPlayer,372,42,414,4,30,Player A
3849,JointPQPlayer,258,108,366,7,47,Player A
3850,JointPQPlayer,307,82,389,9,40,Player A
3851,JointPQPlayer,279,109,388,8,40,Player A
3852,JointPQPlayer,385,35,420,1,27,Player A
3853,JointPQPlayer,340,50,390,1,37,Player A
3854,JointPQPlayer,341,66,407,9,34,Player A
3855,JointPQPlayer,357,42,399,1,34,Player A
3856,JointPQPlayer,347,42,389,0,37,Player A
3857,JointPQPlayer,376,41,417,1,28,Player A
3858,JointPQPlayer,255,65,320,0,60,Player A
3859,JointPQPlayer,358,38,396,1,35,Player A
3860,JointPQPlayer,346,61,407,3,32,Player A
3861,JointPQPlayer,197,87,284,0,72,Player A
3862,JointPQPlayer,382,37,419,3,28,Player A
3863,JointPQPlayer,361,51,412,5,31,Player A
3864,JointPQPlayer,371,51,422,3,27,Player A
3865,JointPQPlayer,372,52,424,5,27,Player A
3866,JointPQPlayer,298,58,356,0,48,Player A
3867,JointPQPlayer,287,57,344,0,52,Player A
3868,JointPQPlayer,210,90,300,1,67,Player A
3869,JointPQPlayer,363,38,401,0,33,Player A
3870,JointPQPlayer,346,66,412,5,31,Player A
3871,JointPQPlayer,363,38,401,0,33,Player A
3872,JointPQPlayer,365,45,410,3,31,Player A
3873,JointPQPlayer,341,46,387,1,38,Player A
3874,JointPQPlayer,371,36,407,0,31,Player A
3875,JointPQPlayer,327,57,384,1,39,Player A
3876,JointPQPlayer,365,40,405,1,32,Player A
3877,JointPQPlayer,390,45,435,7,24,Player A
3878,JointPQPlayer,357,52,409,5,32,Player A
3879,JointPQPlayer,305,60,365,0,45,Player A
3880,JointPQPlayer,391,36,427,2,25,Player A
3881,JointPQPlayer,381,46,427,2,25,Player A
3882,JointPQPlayer,369,39,408,1,31,Player A
3883,JointPQPlayer,377,37,414,1,29,Player A
3884,JointPQPlayer,353,43,396,1,35,Player A
3885,JointPQPlayer,378,48,426,7,27,Player A
3886,JointPQPlayer,374,49,423,4,27,Player A
3887,JointPQPlayer,327,47,374,0,42,Player A
3888,JointPQPlayer,348,78,426,7,27,Player A
3889,JointPQPlayer,335,55,390,1,37,Player A
3890,JointPQPlayer,332,107,439,14,25,Player A
3891,JointPQPlayer,318,93,411,13,34,Player A
3892,JointPQPlayer,397,42,439,5,22,Player A
3893,JointPQPlayer,305,130,435,25,30,Player A
3894,JointPQPlayer,310,55,365,0,45,Player A
3895,JointPQPlayer,344,64,408,4,32,Player A
3896,JointPQPlayer,331,46,377,0,41,Player A
3897,JointPQPlayer,311,51,362,0,46,Player A
3898,JointPQPlayer,374,44,418,2,28,Player A
3899,JointPQPlayer,297,147,444,28,28,Player A
3900,JointPQPlayer,330,80,410,3,31,Player A
3901,JointPQPlayer,385,35,420,1,27,Player A
3902,JointPQPlayer,361,41,402,1,33,Player A
3903,JointPQPlayer,329,64,393,4,37,Player A
3904,JointPQPlayer,350,45,395,0,35,Player A
3905,JointPQPlayer,301,66,367,2,45,Player A
3906,JointPQPlayer,385,45,430,2,24,Player A
3907,JointPQPlayer,343,43,386,0,38,Player A
3908,JointPQPlayer,383,38,421,2,27,Player A
3909,JointPQPlayer,368,43,411,4,31,Player A
3910,JointPQPlayer,318,73,391,2,37,Player A
3911,JointPQPlayer,367,37,404,0,32,Player A
3912,JointPQPlayer,365,40,405,1,32,Player A
3913,JointPQPlayer,391,36,427,2,25,Player A
3914,JointPQPlayer,365,50,415,5,30,Player A
3915,JointPQPlayer,274,199,473,27,18,Player A
3916,JointPQPlayer,378,88,466,14,16,Player A
3917,JointPQPlayer,347,47,394,2,36,Player A
3918,JointPQPlayer,379,34,413,0,29,Player A
3919,JointPQPlayer,371,36,407,0,31,Player A
3920,JointPQPlayer,403,33,436,2,22,Player A
3921,JointPQPlayer,355,40,395,0,35,Player A
3922,JointPQPlayer,193,198,391,23,44,JointPQPlayer
3923,JointPQPlayer,343,43,386,0,38,Player A
3924,JointPQPlayer,357,47,404,3,33,Player A
3925,JointPQPlayer,348,48,396,1,35,Player A
3926,JointPQPlayer,372,47,419,6,29,Player A
3927,JointPQPlayer,329,74,403,8,35,Player A
3928,JointPQPlayer,357,47,404,3,33,Player A
3929,JointPQPlayer,371,36,407,0,31,Player A
3930,JointPQPlayer,347,47,394,2,36,Player A
3931,JointPQPlayer,342,57,399,4,35,Player A
3932,JointPQPlayer,331,46,377,0,41,Player A
3933,JointPQPlayer,393,38,431,3,24,Player A
3934,JointPQPlayer,375,35,410,0,30,Player A
3935,JointPQPlayer,287,57,344,0,52,Player A
3936,JointPQPlayer,375,40,415,2,29,Player A
3937,JointPQPlayer,397,32,429,1,24,Player A
3938,JointPQPlayer,351,41,392,0,36,Player A
3939,JointPQPlayer,351,121,472,23,17,Player A
3940,JointPQPlayer,319,49,368,0,44,Player A
3941,JointPQPlayer,393,38,431,3,24,Player A
3942,JointPQPlayer,338,58,396,4,36,Player A
3943,JointPQPlayer,375,45,420,4,28,Player A
3944,JointPQPlayer,329,49,378,1,41,Player A
3945,JointPQPlayer,359,39,398,0,34,Player A
3946,JointPQPlayer,375,45,420,4,28,Player A
3947,JointPQPlayer,340,70,410,6,32,Player A
3948,JointPQPlayer,335,45,380,0,40,Player A
3949,JointPQPlayer,377,52,429,7,26,Player A
3950,JointPQPlayer,382,47,429,7,26,Player A
3951,JointPQPlayer,352,47,399,1,34,Player A
3952,JointPQPlayer,357,42,399,1,34,Player A
3953,JointPQPlayer,359,49,408,1,31,Player A
3954,JointPQPlayer,337,52,389,3,38,Player A
3955,JointPQPlayer,355,40,395,0,35,Player A
3956,JointPQPlayer,351,41,392,0,36,Player A
3957,JointPQPlayer,393,33,426,1,25,Player A
3958,JointPQPlayer,351,41,392,0,36,Player A
3959,JointPQPlayer,351,41,392,0,36,Player A
3960,JointPQPlayer,349,49,398,3,35,Player A
3961,JointPQPlayer,366,56,422,6,28,Player A
3962,JointPQPlayer,331,46,377,0,41,Player A
3963,JointPQPlayer,380,35,415,2,29,Player A
3964,JointPQPlayer,338,68,406,8,34,Player A
3965,JointPQPlayer,350,40,390,1,37,Player A
3966,JointPQPlayer,373,48,421,5,28,Player A
3967,JointPQPlayer,356,51,407,3,32,Player A
3968,JointPQPlayer,387,32,419,0,27,Player A
3969,JointPQPlayer,364,34,398,0,34,Player A
3970,JointPQPlayer,352,77,429,7,26,Player A
3971,JointPQPlayer,363,38,401,0,33,Player A
3972,JointPQPlayer,353,48,401,3,34,Player A
3973,JointPQPlayer,336,61,397,2,35,Player A
3974,JointPQPlayer,355,115,470,21,17,Player A
3975,JointPQPlayer,381,41,422,3,27,Player A
3976,JointPQPlayer,325,70,395,6,37,Player A
3977,JointPQPlayer,405,35,440,3,21,Player A
3978,JointPQPlayer,389,34,423,1,26,Player A
3979,JointPQPlayer,280,190,470,30,20,Player A
3980,JointPQPlayer,348,93,441,13,24,Player A
3981,JointPQPlayer,412,32,444,4,20,Player A
3982,JointPQPlayer,367,42,409,2,31,Player A
3983,JointPQPlayer,347,57,404,3,33,Player A
3984,JointPQPlayer,393,33,426,1,25,Player A
3985,JointPQPlayer,376,46,422,6,28,Player A
3986,JointPQPlayer,377,37,414,1,29,Player A
3987,JointPQPlayer,259,214,473,33,20,Player A
3988,JointPQPlayer,361,51,412,5,31,Player A
3989,JointPQPlayer,361,76,437,9,24,Player A
3990,JointPQPlayer,365,80,445,11,22,Player A
3991,JointPQPlayer,397,37,434,3,23,Player A
3992,JointPQPlayer,403,28,431,0,23,Player A
3993,JointPQPlayer,302,57,359,0,47,Player A
3994,JointPQPlayer,299,99,398,9,37,Player A
3995,JointPQPlayer,356,51,407,3,32,Player A
3996,JointPQPlayer,313,93,406,11,35,Player A
3997,JointPQPlayer,379,34,413,0,29,Player A
3998,JointPQPlayer,383,33,416,0,28,Player A
3999,JointPQPlayer,306,56,362,0,46,Player A
4000,JointPQPlayer,326,111,437,18,27,Player A
4001,JointPQPlayer,379,39,418,2,28,Player A
4002,JointPQPlayer,385,40,425,3,26,Player A
4003,JointPQPlayer,381,41,422,3,27,Player A
4004,JointPQPlayer,386,36,422,3,27,Player A
4005,JointPQPlayer,336,51,387,1,38,Player A
4006,JointPQPlayer,351,41,392,0,36,Player A
4007,JointPQPlayer,383,33,416,0,28,Player A
4008,JointPQPlayer,378,38,416,3,29,Player A
4009,JointPQPlayer,333,58,391,2,37,Player A
4010,JointPQPlayer,323,48,371,0,43,Player A
4011,JointPQPlayer,216,101,317,3,62,Player A
4012,JointPQPlayer,386,31,417,1,28,Player A
4013,JointPQPlayer,376,51,427,5,26,Player A
4014,JointPQPlayer,366,36,402,1,33,Player A
4015,JointPQPlayer,345,45,390,1,37,Player A
4016,JointPQPlayer,384,49,433,5,24,Player A
4017,JointPQPlayer,235,110,345,1,52,Player A
4018,JointPQPlayer,377,37,414,1,29,Player A
4019,JointPQPlayer,379,54,433,5,24,Player A
4020,JointPQPlayer,379,39,418,2,28,Player A
4021,JointPQPlayer,263,183,446,27,27,Player A
4022,JointPQPlayer,379,39,418,2,28,Player A
4023,JointPQPlayer,371,36,407,0,31,Player A
4024,JointPQPlayer,379,34,413,0,29,Player A
4025,JointPQPlayer,375,45,420,4,28,Player A
4026,JointPQPlayer,379,49,428,6,26,Player A
4027,JointPQPlayer,385,35,420,1,27,Player A
4028,JointPQPlayer,361,56,417,7,30,Player A
4029,JointPQPlayer,326,56,382,2,40,Player A
4030,JointPQPlayer,330,100,430,11,27,Player A
4031,JointPQPlayer,278,218,496,38,14,Player A
4032,JointPQPlayer,342,107,449,18,23,Player A
4033,JointPQPlayer,343,43,386,0,38,Player A
4034,JointPQPlayer,379,34,413,0,29,Player A
4035,JointPQPlayer,369,39,408,1,31,Player A
4036,JointPQPlayer,347,42,389,0,37,Player A
4037,JointPQPlayer,369,49,418,5,29,Player A
4038,JointPQPlayer,347,52,399,4,35,Player A
4039,JointPQPlayer,396,36,432,4,24,Player A
4040,JointPQPlayer,373,48,421,5,28,Player A
4041,JointPQPlayer,371,51,422,3,27,Player A
4042,JointPQPlayer,301,116,417,19,34,Player A
4043,JointPQPlayer,291,171,462,25,21,Player A
4044,JointPQPlayer,367,37,404,0,32,Player A
4045,JointPQPlayer,314,54,368,0,44,Player A
4046,JointPQPlayer,405,35,440,3,21,Player A
4047,JointPQPlayer,391,31,422,0,26,Player A
4048,JointPQPlayer,298,58,356,0,48,Player A
4049,JointPQPlayer,360,45,405,4,33,Player A
4050,JointPQPlayer,335,65,400,8,36,Player A
4051,JointPQPlayer,351,81,432,16,28,Player A
4052,JointPQPlayer,330,80,410,9,33,Player A
4053,JointPQPlayer,361,41,402,1,33,Player A
4054,JointPQPlayer,345,85,430,11,27,Player A
4055,JointPQPlayer,385,35,420,1,27,Player A
4056,JointPQPlayer,405,30,435,1,22,Player A
4057,JointPQPlayer,343,43,386,0,38,Player A
4058,JointPQPlayer,359,39,398,0,34,Player A
4059,JointPQPlayer,329,49,378,1,41,Player A
4060,JointPQPlayer,396,31,427,2,25,Player A
4061,JointPQPlayer,347,77,424,14,30,Player A
4062,JointPQPlayer,303,83,386,3,39,Player A
4063,JointPQPlayer,383,33,416,0,28,Player A
4064,JointPQPlayer,312,57,369,1,44,Player A
4065,JointPQPlayer,394,29,423,1,26,Player A
4066,JointPQPlayer,356,46,402,1,33,Player A
4067,JointPQPlayer,389,44,433,2,23,Player A
4068,JointPQPlayer,370,35,405,1,32,Player A
4069,JointPQPlayer,278,73,351,1,50,Player A
4070,JointPQPlayer,383,33,416,0,28,Player A
4071,JointPQPlayer,360,35,395,0,35,Player A
4072,JointPQPlayer,347,52,399,4,35,Player A
4073,JointPQPlayer,336,56,392,3,37,Player A
4074,JointPQPlayer,198,168,366,13,49,Player A
4075,JointPQPlayer,381,36,417,1,28,Player A
4076,JointPQPlayer,343,48,391,2,37,Player A
4077,JointPQPlayer,347,42,389,0,37,Player A
4078,JointPQPlayer,371,41,412,2,30,Player A
4079,JointPQPlayer,371,36,407,0,31,Player A
4080,JointPQPlayer,370,45,415,2,29,Player A
4081,JointPQPlayer,375,35,410,0,30,Player A
4082,JointPQPlayer,369,49,418,5,29,Player A
4083,JointPQPlayer,291,66,357,1,48,Player A
4084,JointPQPlayer,320,60,380,3,41,Player A
4085,JointPQPlayer,357,42,399,1,34,Player A
4086,JointPQPlayer,357,52,409,5,32,Player A
4087,JointPQPlayer,381,46,427,5,26,Player A
4088,JointPQPlayer,343,78,421,5,28,Player A
4089,JointPQPlayer,393,38,431,3,24,Player A
4090,JointPQPlayer,401,31,432,1,23,Player A
4091,JointPQPlayer,351,41,392,0,36,Player A
4092,JointPQPlayer,282,62,344,0,52,Player A
4093,JointPQPlayer,282,62,344,0,52,Player A
4094,JointPQPlayer,330,95,425,12,29,Player A
4095,JointPQPlayer,275,70,345,4,53,Player A
4096,JointPQPlayer,368,48,416,3,29,Player A
4097,JointPQPlayer,374,44,418,5,29,Player A
4098,JointPQPlayer,364,44,408,1,31,Player A
4099,JointPQPlayer,398,43,441,4,21,Player A
4100,JointPQPlayer,355,40,395,0,35,Player A
4101,JointPQPlayer,371,36,407,0,31,Player A
4102,JointPQPlayer,355,45,400,2,34,Player A
4103,JointPQPlayer,359,39,398,0,34,Player A
4104,JointPQPlayer,307,62,369,1,44,Player A
4105,JointPQPlayer,371,41,412,2,30,Player A
4106,JointPQPlayer,385,40,425,3,26,Player A
4107,JointPQPlayer,373,43,416,3,29,Player A
4108,JointPQPlayer,369,39,408,1,31,Player A
4109,JointPQPlayer,397,37,434,3,23,Player A
4110,JointPQPlayer,385,35,420,1,27,Player A
4111,JointPQPlayer,361,41,402,1,33,Player A
4112,JointPQPlayer,363,48,411,4,31,Player A
4113,JointPQPlayer,370,75,445,14,23,Player A
4114,JointPQPlayer,334,94,428,12,28,Player A
4115,JointPQPlayer,361,41,402,1,33,Player A
4116,JointPQPlayer,343,43,386,0,38,Player A
4117,JointPQPlayer,322,52,374,0,42,Player A
4118,JointPQPlayer,377,47,424,5,27,Player A
4119,JointPQPlayer,367,87,454,14,20,Player A
4120,JointPQPlayer,354,54,408,4,32,Player A
4121,JointPQPlayer,386,36,422,0,26,Player A
4122,JointPQPlayer,344,39,383,0,39,Player A
4123,JointPQPlayer,286,61,347,0,51,Player A
4124,JointPQPlayer,373,48,421,5,28,Player A
4125,JointPQPlayer,304,139,443,21,26,Player A
4126,JointPQPlayer,373,38,411,1,30,Player A
4127,JointPQPlayer,361,46,407,3,32,Player A
4128,JointPQPlayer,401,36,437,3,22,Player A
4129,JointPQPlayer,379,49,428,6,26,Player A
4130,JointPQPlayer,367,37,404,0,32,Player A
4131,JointPQPlayer,397,32,429,1,24,Player A
4132,JointPQPlayer,371,36,407,0,31,Player A
4133,JointPQPlayer,357,62,419,9,30,Player A
4134,JointPQPlayer,367,37,404,0,32,Player A
4135,JointPQPlayer,340,65,405,4,33,Player A
4136,JointPQPlayer,365,50,415,2,29,Player A
4137,JointPQPlayer,367,37,404,0,32,Player A
4138,JointPQPlayer,366,51,417,4,29,Player A
4139,JointPQPlayer,328,133,461,21,20,Player A
4140,JointPQPlayer,285,65,350,3,51,Player A
4141,JointPQPlayer,370,45,415,2,29,Player A
4142,JointPQPlayer,345,85,430,11,27,Player A
4143,JointPQPlayer,375,35,410,0,30,Player A
4144,JointPQPlayer,344,109,453,19,22,Player A
4145,JointPQPlayer,345,45,390,1,37,Player A
4146,JointPQPlayer,375,35,410,0,30,Player A
4147,JointPQPlayer,261,176,437,33,32,Player A
4148,JointPQPlayer,191,251,442,35,31,JointPQPlayer
4149,JointPQPlayer,359,39,398,0,34,Player A
4150,JointPQPlayer,393,33,426,1,25,Player A
4151,JointPQPlayer,343,53,396,1,35,Player A
4152,JointPQPlayer,373,38,411,1,30,Player A
4153,JointPQPlayer,389,39,428,3,25,Player A
4154,JointPQPlayer,389,34,423,1,26,Player A
4155,JointPQPlayer,351,41,392,0,36,Player A
4156,JointPQPlayer,390,35,425,3,26,Player A
4157,JointPQPlayer,338,58,396,4,36,Player A
4158,JointPQPlayer,298,58,356,0,48,Player A
4159,JointPQPlayer,347,42,389,0,37,Player A
4160,JointPQPlayer,343,53,396,1,35,Player A
4161,JointPQPlayer,311,66,377,6,43,Player A
4162,JointPQPlayer,361,41,402,1,33,Player A
4163,JointPQPlayer,369,39,408,1,31,Player A
4164,JointPQPlayer,339,44,383,0,39,Player A
4165,JointPQPlayer,363,38,401,0,33,Player A
4166,JointPQPlayer,395,35,430,2,24,Player A
4167,JointPQPlayer,359,39,398,0,34,Player A
4168,JointPQPlayer,350,45,395,3,36,Player A
4169,JointPQPlayer,364,54,418,5,29,Player A
4170,JointPQPlayer,373,38,411,1,30,Player A
4171,JointPQPlayer,337,57,394,2,36,Player A
4172,JointPQPlayer,227,312,539,69,10,JointPQPlayer
4173,JointPQPlayer,343,78,421,11,30,Player A
4174,JointPQPlayer,371,36,407,0,31,Player A
4175,JointPQPlayer,359,39,398,0,34,Player A
4176,JointPQPlayer,373,38,411,1,30,Player A
4177,JointPQPlayer,339,59,398,6,36,Player A
4178,JointPQPlayer,368,48,416,3,29,Player A
4179,JointPQPlayer,383,33,416,0,28,Player A
4180,JointPQPlayer,339,44,383,0,39,Player A
4181,JointPQPlayer,359,39,398,0,34,Player A
4182,JointPQPlayer,395,30,425,0,25,Player A
4183,JointPQPlayer,369,39,408,1,31,Player A
4184,JointPQPlayer,333,53,386,3,39,Player A
4185,JointPQPlayer,346,61,407,6,33,Player A
4186,JointPQPlayer,401,31,432,1,23,Player A
4187,JointPQPlayer,391,31,422,0,26,Player A
4188,JointPQPlayer,371,51,422,6,28,Player A
4189,JointPQPlayer,337,67,404,3,33,Player A
4190,JointPQPlayer,373,38,411,1,30,Player A
4191,JointPQPlayer,375,35,410,0,30,Player A
4192,JointPQPlayer,371,46,417,4,29,Player A
4193,JointPQPlayer,266,66,332,0,56,Player A
4194,JointPQPlayer,327,82,409,11,34,Player A
4195,JointPQPlayer,391,36,427,2,25,Player A
4196,JointPQPlayer,359,39,398,0,34,Player A
4197,JointPQPlayer,401,31,432,1,23,Player A
4198,JointPQPlayer,369,39,408,1,31,Player A
4199,JointPQPlayer,349,44,393,1,36,Player A
4200,JointPQPlayer,385,50,435,7,24,Player A
4201,JointPQPlayer,340,65,405,7,34,Player A
4202,JointPQPlayer,374,59,433,5,24,Player A
4203,JointPQPlayer,363,38,401,0,33,Player A
4204,JointPQPlayer,379,39,418,2,28,Player A
4205,JointPQPlayer,336,101,437,12,25,Player A
4206,JointPQPlayer,409,29,438,1,21,Player A
4207,JointPQPlayer,402,32,434,3,23,Player A
4208,JointPQPlayer,380,40,420,1,27,Player A
4209,JointPQPlayer,383,38,421,2,27,Player A
4210,JointPQPlayer,351,41,392,0,36,Player A
4211,JointPQPlayer,317,112,429,19,30,Player A
4212,JointPQPlayer,376,51,427,5,26,Player A
4213,JointPQPlayer,351,46,397,2,35,Player A
4214,JointPQPlayer,332,57,389,3,38,Player A
4215,JointPQPlayer,353,53,406,2,32,Player A
4216,JointPQPlayer,339,79,418,11,31,Player A
4217,JointPQPlayer,280,140,420,13,31,Player A
4218,JointPQPlayer,322,77,399,4,35,Player A
4219,JointPQPlayer,354,49,403,5,34,Player A
4220,JointPQPlayer,382,47,429,7,26,Player A
4221,JointPQPlayer,316,56,372,1,43,Player A
4222,JointPQPlayer,415,35,450,4,18,Player A
4223,JointPQPlayer,367,37,404,0,32,Player A
4224,JointPQPlayer,376,31,407,0,31,Player A
4225,JointPQPlayer,377,42,419,3,28,Player A
4226,JointPQPlayer,363,53,416,3,29,Player A
4227,JointPQPlayer,337,67,404,3,33,Player A
4228,JointPQPlayer,351,41,392,0,36,Player A
4229,JointPQPlayer,415,25,440,0,20,Player A
4230,JointPQPlayer,383,33,416,0,28,Player A
4231,JointPQPlayer,379,44,423,4,27,Player A
4232,JointPQPlayer,365,40,405,1,32,Player A
4233,JointPQPlayer,399,29,428,0,24,Player A
4234,JointPQPlayer,297,132,429,22,31,Player A
4235,JointPQPlayer,321,51,372,1,43,Player A
4236,JointPQPlayer,359,44,403,2,33,Player A
4237,JointPQPlayer,365,40,405,1,32,Player A
4238,JointPQPlayer,380,45,425,6,27,Player A
4239,JointPQPlayer,328,53,381,1,40,Player A
4240,JointPQPlayer,383,33,416,0,28,Player A
4241,JointPQPlayer,375,75,450,10,20,Player A
4242,JointPQPlayer,395,40,435,4,23,Player A
4243,JointPQPlayer,385,35,420,1,27,Player A
4244,JointPQPlayer,361,56,417,7,30,Player A
4245,JointPQPlayer,330,50,380,0,40,Player A
4246,JointPQPlayer,291,66,357,1,48,Player A
4247,JointPQPlayer,378,48,426,7,27,Player A
4248,JointPQPlayer,382,42,424,2,26,Player A
4249,JointPQPlayer,353,48,401,3,34,Player A
4250,JointPQPlayer,403,33,436,2,22,Player A
4251,JointPQPlayer,357,42,399,1,34,Player A
4252,JointPQPlayer,316,71,387,7,40,Player A
4253,JointPQPlayer,395,30,425,0,25,Player A
4254,JointPQPlayer,387,37,424,2,26,Player A
4255,JointPQPlayer,379,49,428,6,26,Player A
4256,JointPQPlayer,371,36,407,0,31,Player A
4257,JointPQPlayer,328,113,441,19,26,Player A
4258,JointPQPlayer,351,41,392,0,36,Player A
4259,JointPQPlayer,405,30,435,1,22,Player A
4260,JointPQPlayer,328,63,391,2,37,Player A
4261,JointPQPlayer,377,37,414,1,29,Player A
4262,JointPQPlayer,374,39,413,3,30,Player A
4263,JointPQPlayer,334,59,393,1,36,Player A
4264,JointPQPlayer,363,38,401,0,33,Player A
4265,JointPQPlayer,351,41,392,0,36,Player A
4266,JointPQPlayer,351,46,397,2,35,Player A
4267,JointPQPlayer,326,56,382,2,40,Player A
4268,JointPQPlayer,366,41,407,0,31,Player A
4269,JointPQPlayer,371,41,412,2,30,Player A
4270,JointPQPlayer,337,62,399,7,36,Player A
4271,JointPQPlayer,363,53,416,3,29,Player A
4272,JointPQPlayer,303,73,376,2,42,Player A
4273,JointPQPlayer,387,47,434,6,24,Player A
4274,JointPQPlayer,378,33,411,1,30,Player A
4275,JointPQPlayer,371,36,407,0,31,Player A
4276,JointPQPlayer,403,28,431,0,23,Player A
4277,JointPQPlayer,371,51,422,6,28,Player A
4278,JointPQPlayer,371,36,407,0,31,Player A
4279,JointPQPlayer,367,37,404,0,32,Player A
4280,JointPQPlayer,351,41,392,0,36,Player A
4281,JointPQPlayer,389,34,423,1,26,Player A
4282,JointPQPlayer,387,32,419,0,27,Player A
4283,JointPQPlayer,402,37,439,5,22,Player A
4284,JointPQPlayer,405,35,440,3,21,Player A
4285,JointPQPlayer,355,40,395,0,35,Player A
4286,JointPQPlayer,382,52,434,6,24,Player A
4287,JointPQPlayer,356,66,422,9,29,Player A
4288,JointPQPlayer,365,45,410,3,31,Player A
4289,JointPQPlayer,326,131,457,23,22,Player A
4290,JointPQPlayer,397,32,429,1,24,Player A
4291,JointPQPlayer,365,50,415,5,30,Player A
4292,JointPQPlayer,323,48,371,0,43,Player A
4293,JointPQPlayer,333,73,406,5,33,Player A
4294,JointPQPlayer,403,33,436,2,22,Player A
4295,JointPQPlayer,373,38,411,1,30,Player A
4296,JointPQPlayer,356,56,412,5,31,Player A
4297,JointPQPlayer,330,120,450,22,24,Player A
4298,JointPQPlayer,367,37,404,0,32,Player A
4299,JointPQPlayer,363,53,416,6,30,Player A
4300,JointPQPlayer,278,63,341,0,53,Player A
4301,JointPQPlayer,262,67,329,0,57,Player A
4302,JointPQPlayer,405,40,445,5,20,Player A
4303,JointPQPlayer,363,38,401,0,33,Player A
4304,JointPQPlayer,365,40,405,1,32,Player A
4305,JointPQPlayer,389,34,423,1,26,Player A
4306,JointPQPlayer,380,50,430,5,25,Player A
4307,JointPQPlayer,363,38,401,0,33,Player A
4308,JointPQPlayer,405,30,435,1,22,Player A
4309,JointPQPlayer,359,39,398,0,34,Player A
4310,JointPQPlayer,371,36,407,0,31,Player A
4311,JointPQPlayer,343,43,386,0,38,Player A
4312,JointPQPlayer,343,43,386,0,38,Player A
4313,JointPQPlayer,355,40,395,0,35,Player A
4314,JointPQPlayer,375,35,410,0,30,Player A
4315,JointPQPlayer,357,52,409,5,32,Player A
4316,JointPQPlayer,385,45,430,5,25,Player A
4317,JointPQPlayer,371,41,412,2,30,Player A
4318,JointPQPlayer,320,90,410,9,33,Player A
4319,JointPQPlayer,210,275,485,45,20,JointPQPlayer
4320,JointPQPlayer,360,45,405,1,32,Player A
4321,JointPQPlayer,312,72,384,4,40,Player A
4322,JointPQPlayer,293,168,461,27,22,Player A
4323,JointPQPlayer,402,27,429,1,24,Player A
4324,JointPQPlayer,397,32,429,1,24,Player A
4325,JointPQPlayer,358,48,406,2,32,Player A
4326,JointPQPlayer,406,36,442,5,21,Player A
4327,JointPQPlayer,369,39,408,1,31,Player A
4328,JointPQPlayer,407,32,439,2,21,Player A
4329,JointPQPlayer,349,44,393,1,36,Player A
4330,JointPQPlayer,371,36,407,0,31,Player A
4331,JointPQPlayer,366,56,422,9,29,Player A
4332,JointPQPlayer,332,52,384,1,39,Player A
4333,JointPQPlayer,379,39,418,2,28,Player A
4334,JointPQPlayer,381,36,417,1,28,Player A
4335,JointPQPlayer,409,29,438,1,21,Player A
4336,JointPQPlayer,329,114,443,15,24,Player A
4337,JointPQPlayer,361,41,402,1,33,Player A
4338,JointPQPlayer,306,111,417,19,34,Player A
4339,JointPQPlayer,383,33,416,0,28,Player A
4340,JointPQPlayer,373,38,411,1,30,Player A
4341,JointPQPlayer,368,53,421,8,29,Player A
4342,JointPQPlayer,328,53,381,1,40,Player A
4343,JointPQPlayer,397,37,434,3,23,Player A
4344,JointPQPlayer,351,41,392,0,36,Player A
4345,JointPQPlayer,254,69,323,0,59,Player A
4346,JointPQPlayer,408,33,441,4,21,Player A
4347,JointPQPlayer,328,73,401,3,34,Player A
4348,JointPQPlayer,387,32,419,0,27,Player A
4349,JointPQPlayer,341,71,412,11,33,Player A
4350,JointPQPlayer,359,44,403,2,33,Player A
4351,JointPQPlayer,388,48,436,5,23,Player A
4352,JointPQPlayer,359,39,398,0,34,Player A
4353,JointPQPlayer,365,40,405,1,32,Player A
4354,JointPQPlayer,331,66,397,8,37,Player A
4355,JointPQPlayer,358,48,406,2,32,Player A
4356,JointPQPlayer,306,56,362,0,46,Player A
4357,JointPQPlayer,343,48,391,2,37,Player A
4358,JointPQPlayer,388,38,426,1,25,Player A
4359,JointPQPlayer,405,30,435,1,22,Player A
4360,JointPQPlayer,371,36,407,0,31,Player A
4361,JointPQPlayer,369,44,413,3,30,Player A
4362,JointPQPlayer,331,56,387,1,38,Player A
4363,JointPQPlayer,246,71,317,0,61,Player A
4364,JointPQPlayer,345,50,395,3,36,Player A
4365,JointPQPlayer,399,29,428,0,24,Player A
4366,JointPQPlayer,377,37,414,1,29,Player A
4367,JointPQPlayer,164,99,263,0,79,Player A
4368,JointPQPlayer,367,37,404,0,32,Player A
4369,JointPQPlayer,382,37,419,3,28,Player A
4370,JointPQPlayer,318,63,381,4,41,Player A
4371,JointPQPlayer,343,43,386,0,38,Player A
4372,JointPQPlayer,373,38,411,1,30,Player A
4373,JointPQPlayer,361,41,402,1,33,Player A
4374,JointPQPlayer,299,69,368,3,45,Player A
4375,JointPQPlayer,238,198,436,23,29,Player A
4376,JointPQPlayer,320,65,385,5,40,Player A
4377,JointPQPlayer,359,49,408,4,32,Player A
4378,JointPQPlayer,389,44,433,5,24,Player A
4379,JointPQPlayer,399,29,428,0,24,Player A
4380,JointPQPlayer,359,39,398,0,34,Player A
4381,JointPQPlayer,381,41,422,3,27,Player A
4382,JointPQPlayer,367,42,409,2,31,Player A
4383,JointPQPlayer,387,32,419,0,27,Player A
4384,JointPQPlayer,371,36,407,0,31,Player A
4385,JointPQPlayer,327,47,374,0,42,Player A
4386,JointPQPlayer,351,51,402,1,33,Player A
4387,JointPQPlayer,363,38,401,0,33,Player A
4388,JointPQPlayer,359,54,413,6,31,Player A
4389,JointPQPlayer,371,46,417,4,29,Player A
4390,JointPQPlayer,377,37,414,1,29,Player A
4391,JointPQPlayer,341,86,427,11,28,Player A
4392,JointPQPlayer,375,40,415,2,29,Player A
4393,JointPQPlayer,366,51,417,7,30,Player A
4394,JointPQPlayer,362,47,409,2,31,Player A
4395,JointPQPlayer,339,44,383,0,39,Player A
4396,JointPQPlayer,361,41,402,1,33,Player A
4397,JointPQPlayer,367,37,404,0,32,Player A
4398,JointPQPlayer,361,46,407,3,32,Player A
4399,JointPQPlayer,375,35,410,0,30,Player A
4400,JointPQPlayer,358,53,411,4,31,Player A
4401,JointPQPlayer,379,34,413,0,29,Player A
4402,JointPQPlayer,379,34,413,0,29,Player A
4403,JointPQPlayer,314,54,368,0,44,Player A
4404,JointPQPlayer,397,32,429,1,24,Player A
4405,JointPQPlayer,370,45,415,2,29,Player A
4406,JointPQPlayer,395,30,425,0,25,Player A
4407,JointPQPlayer,385,45,430,5,25,Player A
4408,JointPQPlayer,377,37,414,1,29,Player A
4409,JointPQPlayer,389,34,423,1,26,Player A
4410,JointPQPlayer,376,41,417,4,29,Player A
4411,JointPQPlayer,384,39,423,1,26,Player A
4412,JointPQPlayer,345,55,400,2,34,Player A
4413,JointPQPlayer,380,40,420,4,28,Player A
4414,JointPQPlayer,344,59,403,5,34,Player A
4415,JointPQPlayer,326,51,377,0,41,Player A
4416,JointPQPlayer,349,49,398,3,35,Player A
4417,JointPQPlayer,310,55,365,0,45,Player A
4418,JointPQPlayer,347,42,389,0,37,Player A
4419,JointPQPlayer,361,51,412,2,30,Player A
4420,JointPQPlayer,350,75,425,12,29,Player A
4421,JointPQPlayer,353,58,411,1,30,Player A
4422,JointPQPlayer,351,51,402,1,33,Player A
4423,JointPQPlayer,276,81,357,4,49,Player A
4424,JointPQPlayer,357,52,409,2,31,Player A
4425,JointPQPlayer,358,43,401,3,34,Player A
4426,JointPQPlayer,367,42,409,2,31,Player A
4427,JointPQPlayer,362,47,409,2,31,Player A
4428,JointPQPlayer,212,87,299,0,67,Player A
4429,JointPQPlayer,334,54,388,2,38,Player A
4430,JointPQPlayer,369,39,408,1,31,Player A
4431,JointPQPlayer,381,36,417,1,28,Player A
4432,JointPQPlayer,369,44,413,3,30,Player A
4433,JointPQPlayer,313,78,391,8,39,Player A
4434,JointPQPlayer,387,32,419,0,27,Player A
4435,JointPQPlayer,369,44,413,3,30,Player A
4436,JointPQPlayer,386,41,427,5,26,Player A
4437,JointPQPlayer,360,45,405,1,32,Player A
4438,JointPQPlayer,345,45,390,1,37,Player A
4439,JointPQPlayer,387,32,419,0,27,Player A
4440,JointPQPlayer,375,40,415,2,29,Player A
4441,JointPQPlayer,349,44,393,1,36,Player A
4442,JointPQPlayer,351,56,407,6,33,Player A
4443,JointPQPlayer,349,54,403,2,33,Player A
4444,JointPQPlayer,358,58,416,6,30,Player A
4445,JointPQPlayer,369,49,418,5,29,Player A
4446,JointPQPlayer,306,56,362,0,46,Player A
4447,JointPQPlayer,278,63,341,0,53,Player A
4448,JointPQPlayer,357,42,399,1,34,Player A
4449,JointPQPlayer,359,39,398,0,34,Player A
4450,JointPQPlayer,363,48,411,4,31,Player A
4451,JointPQPlayer,359,44,403,2,33,Player A
4452,JointPQPlayer,355,40,395,0,35,Player A
4453,JointPQPlayer,236,76,312,1,63,Player A
4454,JointPQPlayer,363,73,436,8,24,Player A
4455,JointPQPlayer,378,48,426,7,27,Player A
4456,JointPQPlayer,304,169,473,36,21,Player A
4457,JointPQPlayer,357,52,409,2,31,Player A
4458,JointPQPlayer,346,61,407,3,32,Player A
4459,JointPQPlayer,386,51,437,9,24,Player A
4460,JointPQPlayer,372,42,414,1,29,Player A
4461,JointPQPlayer,387,37,424,2,26,Player A
4462,JointPQPlayer,347,52,399,1,34,Player A
4463,JointPQPlayer,387,37,424,2,26,Player A
4464,JointPQPlayer,313,63,376,2,42,Player A
4465,JointPQPlayer,328,113,441,22,27,Player A
4466,JointPQPlayer,319,184,503,36,11,Player A
4467,JointPQPlayer,323,48,371,0,43,Player A
4468,JointPQPlayer,326,61,387,4,39,Player A
4469,JointPQPlayer,357,42,399,1,34,Player A
4470,JointPQPlayer,395,30,425,0,25,Player A
4471,JointPQPlayer,382,32,414,1,29,Player A
4472,JointPQPlayer,330,65,395,6,37,Player A
4473,JointPQPlayer,328,63,391,2,37,Player A
4474,JointPQPlayer,385,50,435,7,24,Player A
4475,JointPQPlayer,339,84,423,10,29,Player A
4476,JointPQPlayer,392,42,434,6,24,Player A
4477,JointPQPlayer,377,42,419,3,28,Player A
4478,JointPQPlayer,375,45,420,1,27,Player A
4479,JointPQPlayer,355,45,400,2,34,Player A
4480,JointPQPlayer,367,37,404,0,32,Player A
4481,JointPQPlayer,373,38,411,1,30,Player A
4482,JointPQPlayer,373,38,411,1,30,Player A
4483,JointPQPlayer,393,33,426,1,25,Player A
4484,JointPQPlayer,385,35,420,1,27,Player A
4485,JointPQPlayer,391,36,427,2,25,Player A
4486,JointPQPlayer,377,37,414,1,29,Player A
4487,JointPQPlayer,376,46,422,3,27,Player A
4488,JointPQPlayer,359,39,398,0,34,Player A
4489,JointPQPlayer,379,44,423,4,27,Player A
4490,JointPQPlayer,343,43,386,0,38,Player A
4491,JointPQPlayer,287,57,344,0,52,Player A
4492,JointPQPlayer,242,72,314,0,62,Player A
4493,JointPQPlayer,251,206,457,41,28,Player A
4494,JointPQPlayer,334,129,463,20,19,Player A
4495,JointPQPlayer,373,43,416,3,29,Player A
4496,JointPQPlayer,346,66,412,5,31,Player A
4497,JointPQPlayer,343,43,386,0,38,Player A
4498,JointPQPlayer,354,74,428,12,28,Player A
4499,JointPQPlayer,300,95,395,12,39,Player A
4500,JointPQPlayer,387,37,424,2,26,Player A
4501,JointPQPlayer,389,34,423,1,26,Player A
4502,JointPQPlayer,221,81,302,0,66,Player A
4503,JointPQPlayer,212,82,294,1,69,Player A
4504,JointPQPlayer,369,44,413,3,30,Player A
4505,JointPQPlayer,339,44,383,0,39,Player A
4506,JointPQPlayer,367,42,409,2,31,Player A
4507,JointPQPlayer,299,54,353,0,49,Player A
4508,JointPQPlayer,275,80,355,2,49,Player A
4509,JointPQPlayer,318,53,371,0,43,Player A
4510,JointPQPlayer,323,48,371,0,43,Player A
4511,JointPQPlayer,163,108,271,2,77,Player A
4512,JointPQPlayer,323,48,371,0,43,Player A
4513,JointPQPlayer,355,40,395,0,35,Player A
4514,JointPQPlayer,339,44,383,0,39,Player A
4515,JointPQPlayer,334,64,398,6,36,Player A
4516,JointPQPlayer,198,113,311,0,63,Player A
4517,JointPQPlayer,395,30,425,0,25,Player A
4518,JointPQPlayer,377,37,414,1,29,Player A
4519,JointPQPlayer,373,38,411,1,30,Player A
4520,JointPQPlayer,345,90,435,13,26,Player A
4521,JointPQPlayer,375,45,420,4,28,Player A
4522,JointPQPlayer,347,52,399,1,34,Player A
4523,JointPQPlayer,360,65,425,6,27,Player A
4524,JointPQPlayer,365,50,415,2,29,Player A
4525,JointPQPlayer,365,40,405,1,32,Player A
4526,JointPQPlayer,357,52,409,5,32,Player A
4527,JointPQPlayer,286,106,392,3,37,Player A
4528,JointPQPlayer,389,34,423,1,26,Player A
4529,JointPQPlayer,377,37,414,1,29,Player A
4530,JointPQPlayer,391,41,432,4,24,Player A
4531,JointPQPlayer,327,57,384,1,39,Player A
4532,JointPQPlayer,349,119,468,22,18,Player A
4533,JointPQPlayer,369,54,423,7,28,Player A
4534,JointPQPlayer,357,42,399,1,34,Player A
4535,JointPQPlayer,360,55,415,5,30,Player A
4536,JointPQPlayer,375,35,410,0,30,Player A
4537,JointPQPlayer,363,48,411,4,31,Player A
4538,JointPQPlayer,383,33,416,0,28,Player A
4539,JointPQPlayer,177,287,464,36,24,JointPQPlayer
4540,JointPQPlayer,346,96,442,17,25,Player A
4541,JointPQPlayer,377,37,414,1,29,Player A
4542,JointPQPlayer,379,34,413,0,29,Player A
4543,JointPQPlayer,227,87,314,3,63,Player A
4544,JointPQPlayer,356,61,417,4,29,Player A
4545,JointPQPlayer,383,43,426,4,26,Player A
4546,JointPQPlayer,348,48,396,1,35,Player A
4547,JointPQPlayer,357,52,409,5,32,Player A
4548,JointPQPlayer,381,41,422,3,27,Player A
4549,JointPQPlayer,387,42,429,4,25,Player A
4550,JointPQPlayer,351,41,392,0,36,Player A
4551,JointPQPlayer,288,158,446,27,27,Player A
4552,JointPQPlayer,363,58,421,8,29,Player A
4553,JointPQPlayer,353,43,396,1,35,Player A
4554,JointPQPlayer,326,66,392,6,38,Player A
4555,JointPQPlayer,405,35,440,3,21,Player A
4556,JointPQPlayer,327,127,454,23,23,Player A
4557,JointPQPlayer,359,39,398,0,34,Player A
4558,JointPQPlayer,355,40,395,0,35,Player A
4559,JointPQPlayer,397,32,429,1,24,Player A
4560,JointPQPlayer,385,40,425,3,26,Player A
4561,JointPQPlayer,399,29,428,0,24,Player A
4562,JointPQPlayer,391,36,427,2,25,Player A
4563,JointPQPlayer,377,37,414,1,29,Player A
4564,JointPQPlayer,403,33,436,2,22,Player A
4565,JointPQPlayer,323,48,371,0,43,Player A
4566,JointPQPlayer,387,37,424,2,26,Player A
4567,JointPQPlayer,389,34,423,1,26,Player A
4568,JointPQPlayer,324,54,378,1,41,Player A
4569,JointPQPlayer,324,104,428,18,30,Player A
4570,JointPQPlayer,344,94,438,16,26,Player A
4571,JointPQPlayer,375,35,410,0,30,Player A
4572,JointPQPlayer,241,226,467,48,27,Player A
4573,JointPQPlayer,325,55,380,3,41,Player A
4574,JointPQPlayer,304,89,393,10,39,Player A
4575,JointPQPlayer,356,41,397,2,35,Player A
4576,JointPQPlayer,382,42,424,2,26,Player A
4577,JointPQPlayer,317,62,379,2,41,Player A
4578,JointPQPlayer,343,43,386,0,38,Player A
4579,JointPQPlayer,382,32,414,1,29,Player A
4580,JointPQPlayer,259,79,338,3,55,Player A
4581,JointPQPlayer,365,45,410,3,31,Player A
4582,JointPQPlayer,373,43,416,3,29,Player A
4583,JointPQPlayer,363,38,401,0,33,Player A
4584,JointPQPlayer,298,68,366,1,45,Player A
4585,JointPQPlayer,363,38,401,0,33,Player A
4586,JointPQPlayer,387,42,429,4,25,Player A
4587,JointPQPlayer,359,39,398,0,34,Player A
4588,JointPQPlayer,286,81,367,5,46,Player A
4589,JointPQPlayer,373,38,411,1,30,Player A
4590,JointPQPlayer,319,49,368,0,44,Player A
4591,JointPQPlayer,425,25,450,1,17,Player A
4592,JointPQPlayer,369,64,433,11,26,Player A
4593,JointPQPlayer,314,134,448,17,23,Player A
4594,JointPQPlayer,375,55,430,8,26,Player A
4595,JointPQPlayer,336,106,442,17,25,Player A
4596,JointPQPlayer,323,48,371,0,43,Player A
4597,JointPQPlayer,389,39,428,3,25,Player A
4598,JointPQPlayer,399,29,428,0,24,Player A
4599,JointPQPlayer,327,47,374,0,42,Player A
4600,JointPQPlayer,365,40,405,1,32,Player A
4601,JointPQPlayer,361,41,402,1,33,Player A
4602,JointPQPlayer,282,67,349,2,51,Player A
4603,JointPQPlayer,411,31,442,2,20,Player A
4604,JointPQPlayer,367,42,409,2,31,Player A
4605,JointPQPlayer,394,44,438,4,22,Player A
4606,JointPQPlayer,355,50,405,4,33,Player A
4607,JointPQPlayer,359,44,403,2,33,Player A
4608,JointPQPlayer,365,40,405,1,32,Player A
4609,JointPQPlayer,351,41,392,0,36,Player A
4610,JointPQPlayer,395,30,425,0,25,Player A
4611,JointPQPlayer,387,32,419,0,27,Player A
4612,JointPQPlayer,375,35,410,0,30,Player A
4613,JointPQPlayer,365,40,405,1,32,Player A
4614,JointPQPlayer,331,46,377,0,41,Player A
4615,JointPQPlayer,315,135,450,22,24,Player A
4616,JointPQPlayer,354,64,418,8,30,Player A
4617,JointPQPlayer,373,53,426,7,27,Player A
4618,JointPQPlayer,397,32,429,1,24,Player A
4619,JointPQPlayer,361,46,407,3,32,Player A
4620,JointPQPlayer,352,97,449,18,23,Player A
4621,JointPQPlayer,330,75,405,7,34,Player A
4622,JointPQPlayer,350,60,410,3,31,Player A
4623,JointPQPlayer,341,46,387,1,38,Player A
4624,JointPQPlayer,388,33,421,2,27,Player A
4625,JointPQPlayer,385,40,425,3,26,Player A
4626,JointPQPlayer,327,82,409,8,33,Player A
4627,JointPQPlayer,402,27,429,1,24,Player A
4628,JointPQPlayer,385,45,430,5,25,Player A
4629,JointPQPlayer,378,33,411,1,30,Player A
4630,JointPQPlayer,381,36,417,1,28,Player A
4631,JointPQPlayer,346,46,392,0,36,Player A
4632,JointPQPlayer,372,32,404,0,32,Player A
4633,JointPQPlayer,371,36,407,0,31,Player A
4634,JointPQPlayer,403,28,431,0,23,Player A
4635,JointPQPlayer,349,44,393,1,36,Player A
4636,JointPQPlayer,257,72,329,0,57,Player A
4637,JointPQPlayer,365,40,405,1,32,Player A
4638,JointPQPlayer,389,34,423,1,26,Player A
4639,JointPQPlayer,364,59,423,4,27,Player A
4640,JointPQPlayer,224,229,453,31,26,JointPQPlayer
4641,JointPQPlayer,327,47,374,0,42,Player A
4642,JointPQPlayer,365,45,410,3,31,Player A
4643,JointPQPlayer,273,118,391,8,39,Player A
4644,JointPQPlayer,346,106,452,18,22,Player A
4645,JointPQPlayer,353,43,396,1,35,Player A
4646,JointPQPlayer,340,130,470,24,18,Player A
4647,JointPQPlayer,377,37,414,1,29,Player A
4648,JointPQPlayer,415,25,440,0,20,Player A
4649,JointPQPlayer,379,39,418,2,28,Player A
4650,JointPQPlayer,337,87,424,14,30,Player A
4651,JointPQPlayer,405,30,435,1,22,Player A
4652,JointPQPlayer,400,35,435,4,23,Player A
4653,JointPQPlayer,381,41,422,3,27,Player A
4654,JointPQPlayer,334,49,383,0,39,Player A
4655,JointPQPlayer,377,37,414,1,29,Player A
4656,JointPQPlayer,375,50,425,6,27,Player A
4657,JointPQPlayer,341,46,387,1,38,Player A
4658,JointPQPlayer,389,39,428,3,25,Player A
4659,JointPQPlayer,385,50,435,7,24,Player A
4660,JointPQPlayer,364,59,423,7,28,Player A
4661,JointPQPlayer,312,57,369,1,44,Player A
4662,JointPQPlayer,349,44,393,1,36,Player A
4663,JointPQPlayer,363,38,401,0,33,Player A
4664,JointPQPlayer,353,43,396,1,35,Player A
4665,JointPQPlayer,337,112,449,12,21,Player A
4666,JointPQPlayer,270,125,395,18,41,Player A
4667,JointPQPlayer,343,43,386,0,38,Player A
4668,JointPQPlayer,326,66,392,6,38,Player A
4669,JointPQPlayer,379,44,423,4,27,Player A
4670,JointPQPlayer,374,39,413,0,29,Player A
4671,JointPQPlayer,375,40,415,2,29,Player A
4672,JointPQPlayer,413,28,441,1,20,Player A
4673,JointPQPlayer,385,55,440,9,23,Player A
4674,JointPQPlayer,329,59,388,2,38,Player A
4675,JointPQPlayer,377,37,414,1,29,Player A
4676,JointPQPlayer,369,39,408,1,31,Player A
4677,JointPQPlayer,371,36,407,0,31,Player A
4678,JointPQPlayer,356,46,402,1,33,Player A
4679,JointPQPlayer,367,37,404,0,32,Player A
4680,JointPQPlayer,402,27,429,1,24,Player A
4681,JointPQPlayer,333,53,386,0,38,Player A
4682,JointPQPlayer,386,31,417,1,28,Player A
4683,JointPQPlayer,374,39,413,0,29,Player A
4684,JointPQPlayer,363,58,421,8,29,Player A
4685,JointPQPlayer,375,35,410,0,30,Player A
4686,JointPQPlayer,403,33,436,2,22,Player A
4687,JointPQPlayer,343,43,386,0,38,Player A
4688,JointPQPlayer,371,36,407,0,31,Player A
4689,JointPQPlayer,371,36,407,0,31,Player A
4690,JointPQPlayer,319,159,478,35,19,Player A
4691,JointPQPlayer,355,45,400,2,34,Player A
4692,JointPQPlayer,385,40,425,3,26,Player A
4693,JointPQPlayer,353,88,441,10,23,Player A
4694,JointPQPlayer,357,42,399,1,34,Player A
4695,JointPQPlayer,339,44,383,0,39,Player A
4696,JointPQPlayer,363,38,401,0,33,Player A
4697,JointPQPlayer,390,40,430,5,25,Player A
4698,JointPQPlayer,274,104,378,13,45,Player A
4699,JointPQPlayer,346,76,422,9,29,Player A
4700,JointPQPlayer,309,59,368,0,44,Player A
4701,JointPQPlayer,331,126,457,23,22,Player A
4702,JointPQPlayer,347,52,399,1,34,Player A
4703,JointPQPlayer,296,121,417,19,34,Player A
4704,JointPQPlayer,353,43,396,1,35,Player A
4705,JointPQPlayer,352,47,399,1,34,Player A
4706,JointPQPlayer,373,43,416,3,29,Player A
4707,JointPQPlayer,381,41,422,3,27,Player A
4708,JointPQPlayer,343,53,396,4,36,Player A
4709,JointPQPlayer,332,57,389,3,38,Player A
4710,JointPQPlayer,352,92,444,13,23,Player A
4711,JointPQPlayer,374,44,418,5,29,Player A
4712,JointPQPlayer,300,80,380,3,41,Player A
4713,JointPQPlayer,381,36,417,1,28,Player A
4714,JointPQPlayer,352,77,429,7,26,Player A
4715,JointPQPlayer,397,32,429,1,24,Player A
4716,JointPQPlayer,375,35,410,0,30,Player A
4717,JointPQPlayer,363,78,441,10,23,Player A
4718,JointPQPlayer,329,124,453,25,24,Player A
4719,JointPQPlayer,309,119,428,6,26,Player A
4720,JointPQPlayer,343,48,391,2,37,Player A
4721,JointPQPlayer,355,55,410,6,32,Player A
4722,JointPQPlayer,332,72,404,9,35,Player A
4723,JointPQPlayer,335,50,385,2,39,Player A
4724,JointPQPlayer,371,46,417,4,29,Player A
4725,JointPQPlayer,395,30,425,0,25,Player A
4726,JointPQPlayer,359,39,398,0,34,Player A
4727,JointPQPlayer,374,39,413,3,30,Player A
4728,JointPQPlayer,394,39,433,2,23,Player A
4729,JointPQPlayer,350,40,390,1,37,Player A
4730,JointPQPlayer,331,61,392,6,38,Player A
4731,JointPQPlayer,341,76,417,4,29,Player A
4732,JointPQPlayer,340,70,410,6,32,Player A
4733,JointPQPlayer,335,100,435,13,26,Player A
0,revTitforTat,500,0,500,0,0,Player A
1,revTitforTat,483,13,496,2,2,Player A
2,revTitforTat,483,13,496,2,2,Player A
3,revTitforTat,483,13,496,2,2,Player A
4,revTitforTat,483,13,496,2,2,Player A
5,revTitforTat,483,13,496,2,2,Player A
6,revTitforTat,483,13,496,2,2,Player A
7,revTitforTat,483,13,496,2,2,Player A
8,revTitforTat,483,13,496,2,2,Player A
9,revTitforTat,483,13,496,2,2,Player A
10,revTitforTat,483,13,496,2,2,Player A
0,PatternPlayer,299,54,353,0,49,Player A
1,PatternPlayer,299,54,353,0,49,Player A
2,PatternPlayer,299,54,353,0,49,Player A
3,PatternPlayer,299,54,353,0,49,Player A
4,PatternPlayer,299,54,353,0,49,Player A
5,PatternPlayer,299,54,353,0,49,Player A
6,PatternPlayer,299,54,353,0,49,Player A
7,PatternPlayer,299,54,353,0,49,Player A
8,PatternPlayer,299,54,353,0,49,Player A
9,PatternPlayer,299,54,353,0,49,Player A
10,PatternPlayer,299,54,353,0,49,Player A
0,GrudgePlayer,98,123,221,0,93,GrudgePlayer
1,GrudgePlayer,94,124,218,0,94,GrudgePlayer
2,GrudgePlayer,94,124,218,0,94,GrudgePlayer
3,GrudgePlayer,95,120,215,0,95,GrudgePlayer
4,GrudgePlayer,94,124,218,0,94,GrudgePlayer
5,GrudgePlayer,94,124,218,0,94,GrudgePlayer
6,GrudgePlayer,94,124,218,0,94,GrudgePlayer
7,GrudgePlayer,94,124,218,0,94,GrudgePlayer
8,GrudgePlayer,94,124,218,0,94,GrudgePlayer
9,GrudgePlayer,94,124,218,0,94,GrudgePlayer
10,GrudgePlayer,94,124,218,0,94,GrudgePlayer
0,Gullible,496,6,502,2,0,Player A
1,Gullible,496,6,502,2,0,Player A
2,Gullible,496,6,502,2,0,Player A
3,Gullible,496,6,502,2,0,Player A
4,Gullible,496,6,502,2,0,Player A
5,Gullible,498,3,501,1,0,Player A
6,Gullible,496,6,502,2,0,Player A
7,Gullible,496,6,502,2,0,Player A
8,Gullible,496,6,502,2,0,Player A
9,Gullible,496,6,502,2,0,Player A
10,Gullible,496,6,502,2,0,Player A
0,Sly Fox,93,128,221,0,93,Sly Fox
1,Sly Fox,94,124,218,0,94,Sly Fox
2,Sly Fox,94,124,218,0,94,Sly Fox
3,Sly Fox,94,124,218,0,94,Sly Fox
4,Sly Fox,95,120,215,0,95,Sly Fox
5,Sly Fox,94,124,218,0,94,Sly Fox
6,Sly Fox,94,124,218,0,94,Sly Fox
7,Sly Fox,95,120,215,0,95,Sly Fox
8,Sly Fox,94,124,218,0,94,Sly Fox
9,Sly Fox,94,124,218,0,94,Sly Fox
10,Sly Fox,94,124,218,0,94,Sly Fox
11,Sly Fox,94,124,218,0,94,Sly Fox
0,Evan,299,54,353,0,49,Player A
1,Evan,299,54,353,0,49,Player A
2,Evan,299,54,353,0,49,Player A
3,Evan,299,54,353,0,49,Player A
4,Evan,299,54,353,0,49,Player A
5,Evan,299,54,353,0,49,Player A
6,Evan,299,54,353,0,49,Player A
7,Evan,299,54,353,0,49,Player A
8,Evan,299,54,353,0,49,Player A
9,Evan,299,54,353,0,49,Player A
10,Evan,299,54,353,0,49,Player A
0,Randy,299,54,353,0,49,Player A
1,Randy,251,211,462,31,23,Player A
2,Randy,309,64,373,2,43,Player A
3,Randy,299,54,353,0,49,Player A
4,Randy,290,65,355,2,49,Player A
5,Randy,290,75,365,3,46,Player A
6,Randy,287,57,344,0,52,Player A
7,Randy,303,53,356,0,48,Player A
8,Randy,291,76,367,5,46,Player A
9,Randy,306,61,367,2,45,Player A
10,Randy,291,56,347,0,51,Player A
11,Randy,283,68,351,1,50,Player A
12,Randy,305,55,360,1,47,Player A
13,Randy,278,63,341,0,53,Player A
14,Randy,281,71,352,2,50,Player A
15,Randy,257,82,339,4,55,Player A
16,Randy,269,89,358,5,49,Player A
17,Randy,256,71,327,1,58,Player A
18,Randy,311,61,372,4,44,Player A
19,Randy,304,59,363,1,46,Player A
20,Randy,267,62,329,0,57,Player A
21,Randy,307,52,359,0,47,Player A
22,Randy,305,60,365,3,46,Player A
23,Randy,306,61,367,2,45,Player A
24,Randy,273,73,346,2,52,Player A
25,Randy,302,62,364,2,46,Player A
26,Randy,299,69,368,3,45,Player A
27,Randy,307,52,359,0,47,Player A
28,Randy,268,73,341,3,54,Player A
29,Randy,327,47,374,0,42,Player A
30,Randy,351,46,397,2,35,Player A
31,Randy,313,63,376,5,43,Player A
32,Randy,282,72,354,1,49,Player A
33,Randy,267,67,334,2,56,Player A
34,Randy,316,71,387,4,39,Player A
35,Randy,316,46,362,0,46,Player A
36,Randy,289,104,393,10,39,Player A
37,Randy,275,80,355,5,50,Player A
38,Randy,295,55,350,0,50,Player A
39,Randy,295,70,365,3,46,Player A
40,Randy,277,102,379,11,44,Player A
41,Randy,315,50,365,0,45,Player A
42,Randy,291,56,347,0,51,Player A
43,Randy,312,57,369,1,44,Player A
44,Randy,303,53,356,0,48,Player A
45,Randy,281,106,387,7,40,Player A
46,Randy,311,51,362,0,46,Player A
47,Randy,265,80,345,4,53,Player A
48,Randy,295,55,350,0,50,Player A
49,Randy,252,102,354,10,52,Player A
50,Randy,264,104,368,9,47,Player A
51,Randy,343,43,386,0,38,Player A
52,Randy,303,53,356,0,48,Player A
53,Randy,323,48,371,0,43,Player A
54,Randy,319,49,368,0,44,Player A
55,Randy,236,106,342,7,55,Player A
56,Randy,300,60,360,1,47,Player A
57,Randy,251,66,317,0,61,Player A
58,Randy,286,61,347,0,51,Player A
59,Randy,309,54,363,1,46,Player A
60,Randy,295,75,370,5,45,Player A
61,Randy,287,77,364,5,47,Player A
62,Randy,299,54,353,0,49,Player A
63,Randy,303,73,376,5,43,Player A
64,Randy,315,50,365,0,45,Player A
65,Randy,291,61,352,2,50,Player A
66,Randy,295,75,370,5,45,Player A
67,Randy,307,52,359,0,47,Player A
68,Randy,314,64,378,4,42,Player A
69,Randy,277,72,349,2,51,Player A
70,Randy,271,76,347,3,52,Player A
71,Randy,295,90,385,11,42,Player A
72,Randy,312,57,369,1,44,Player A
73,Randy,300,65,365,3,46,Player A
74,Randy,347,47,394,2,36,Player A
75,Randy,270,65,335,0,55,Player A
76,Randy,321,51,372,1,43,Player A
77,Randy,287,102,389,12,41,Player A
78,Randy,276,86,362,6,48,Player A
79,Randy,302,87,389,9,40,Player A
80,Randy,270,145,415,20,35,Player A
81,Randy,307,52,359,0,47,Player A
82,Randy,286,61,347,3,52,Player A
83,Randy,298,73,371,3,44,Player A
84,Randy,286,56,342,1,53,Player A
85,Randy,272,92,364,8,48,Player A
86,Randy,290,65,355,2,49,Player A
87,Randy,335,45,380,0,40,Player A
88,Randy,299,54,353,0,49,Player A
89,Randy,335,45,380,0,40,Player A
90,Randy,316,56,372,1,43,Player A
91,Randy,307,52,359,0,47,Player A
92,Randy,246,106,352,5,51,Player A
93,Randy,246,126,372,13,47,Player A
94,Randy,308,58,366,1,45,Player A
95,Randy,320,70,390,7,39,Player A
96,Randy,303,73,376,5,43,Player A
97,Randy,271,61,332,0,56,Player A
98,Randy,315,50,365,0,45,Player A
99,Randy,291,56,347,0,51,Player A
100,Randy,316,56,372,1,43,Player A
101,Randy,279,59,338,0,54,Player A
102,Randy,306,61,367,2,45,Player A
103,Randy,299,54,353,0,49,Player A
104,Randy,287,57,344,0,52,Player A
105,Randy,310,65,375,4,43,Player A
106,Randy,295,55,350,0,50,Player A
107,Randy,283,58,341,0,53,Player A
108,Randy,303,53,356,0,48,Player A
109,Randy,295,55,350,0,50,Player A
110,Randy,307,52,359,0,47,Player A
111,Randy,323,48,371,0,43,Player A
112,Randy,319,49,368,0,44,Player A
113,Randy,255,65,320,0,60,Player A
114,Randy,303,53,356,0,48,Player A
115,Randy,247,67,314,0,62,Player A
116,Randy,311,51,362,0,46,Player A
117,Randy,311,51,362,0,46,Player A
118,Randy,260,70,330,1,57,Player A
119,Randy,315,50,365,0,45,Player A
120,Randy,283,58,341,0,53,Player A
121,Randy,343,43,386,0,38,Player A
122,Randy,268,73,341,3,54,Player A
123,Randy,291,56,347,0,51,Player A
124,Randy,284,64,348,1,51,Player A
125,Randy,305,70,375,4,43,Player A
126,Randy,291,56,347,0,51,Player A
127,Randy,295,55,350,0,50,Player A
128,Randy,241,111,352,8,52,Player A
129,Randy,315,60,375,1,42,Player A
130,Randy,265,80,345,4,53,Player A
131,Randy,330,70,400,8,36,Player A
132,Randy,294,69,363,1,46,Player A
133,Randy,298,63,361,2,47,Player A
134,Randy,297,57,354,1,49,Player A
135,Randy,285,70,355,2,49,Player A
136,Randy,335,45,380,0,40,Player A
137,Randy,324,44,368,0,44,Player A
138,Randy,339,44,383,0,39,Player A
139,Randy,276,76,352,2,50,Player A
140,Randy,291,56,347,0,51,Player A
141,Randy,307,52,359,0,47,Player A
142,Randy,291,56,347,0,51,Player A
143,Randy,299,54,353,0,49,Player A
144,Randy,295,55,350,0,50,Player A
145,Randy,311,51,362,0,46,Player A
146,Randy,287,57,344,0,52,Player A
147,Randy,287,72,359,3,48,Player A
148,Randy,246,71,317,0,61,Player A
149,Randy,282,62,344,0,52,Player A
150,Randy,252,72,324,1,59,Player A
151,Randy,296,61,357,1,48,Player A
152,Randy,294,84,378,4,42,Player A
153,Randy,300,75,375,7,44,Player A
154,Randy,300,60,360,1,47,Player A
155,Randy,310,65,375,4,43,Player A
156,Randy,303,88,391,8,39,Player A
157,Randy,311,51,362,0,46,Player A
158,Randy,319,49,368,0,44,Player A
159,Randy,297,67,364,2,46,Player A
160,Randy,289,69,358,2,48,Player A
161,Randy,291,56,347,0,51,Player A
162,Randy,264,124,388,17,43,Player A
163,Randy,307,52,359,0,47,Player A
164,Randy,297,57,354,1,49,Player A
165,Randy,294,74,368,6,46,Player A
166,Randy,303,53,356,0,48,Player A
167,Randy,283,58,341,0,53,Player A
168,Randy,252,92,344,6,54,Player A
169,Randy,315,50,365,0,45,Player A
170,Randy,286,76,362,6,48,Player A
171,Randy,339,44,383,0,39,Player A
172,Randy,286,81,367,5,46,Player A
173,Randy,303,53,356,0,48,Player A
174,Randy,285,60,345,1,52,Player A
175,Randy,307,77,384,7,41,Player A
176,Randy,256,86,342,4,54,Player A
177,Randy,302,62,364,2,46,Player A
178,Randy,262,67,329,0,57,Player A
179,Randy,321,51,372,1,43,Player A
180,Randy,279,69,348,1,51,Player A
181,Randy,283,58,341,0,53,Player A
182,Randy,286,81,367,5,46,Player A
183,Randy,288,68,356,0,48,Player A
184,Randy,307,52,359,0,47,Player A
185,Randy,305,55,360,1,47,Player A
186,Randy,288,68,356,3,49,Player A
187,Randy,311,51,362,0,46,Player A
188,Randy,280,55,335,0,55,Player A
189,Randy,277,77,354,4,50,Player A
190,Randy,339,44,383,0,39,Player A
191,Randy,298,68,366,4,46,Player A
192,Randy,318,58,376,2,42,Player A
193,Randy,268,68,336,1,55,Player A
194,Randy,363,43,406,2,32,Player A
195,Randy,300,65,365,3,46,Player A
196,Randy,296,61,357,1,48,Player A
197,Randy,311,51,362,0,46,Player A
198,Randy,304,59,363,1,46,Player A
199,Randy,271,61,332,0,56,Player A
200,Randy,325,50,375,1,42,Player A
201,Randy,280,75,355,2,49,Player A
202,Randy,319,49,368,0,44,Player A
203,Randy,275,60,335,0,55,Player A
204,Randy,275,60,335,0,55,Player A
205,Randy,303,53,356,0,48,Player A
206,Randy,284,119,403,14,37,Player A
207,Randy,251,176,427,20,31,Player A
208,Randy,283,58,341,0,53,Player A
209,Randy,280,85,365,6,47,Player A
210,Randy,232,107,339,7,56,Player A
211,Randy,307,52,359,0,47,Player A
212,Randy,271,76,347,3,52,Player A
213,Randy,238,88,326,3,59,Player A
214,Randy,321,51,372,1,43,Player A
215,Randy,316,61,377,3,42,Player A
216,Randy,252,92,344,6,54,Player A
217,Randy,331,61,392,3,37,Player A
218,Randy,296,66,362,3,47,Player A
219,Randy,297,92,389,9,40,Player A
220,Randy,311,51,362,0,46,Player A
221,Randy,264,114,378,13,45,Player A
222,Randy,313,53,366,1,45,Player A
223,Randy,296,61,357,1,48,Player A
224,Randy,276,66,342,1,53,Player A
225,Randy,331,46,377,0,41,Player A
226,Randy,246,91,337,5,56,Player A
227,Randy,322,67,389,6,39,Player A
228,Randy,270,65,335,0,55,Player A
229,Randy,311,51,362,0,46,Player A
230,Randy,293,58,351,1,50,Player A
231,Randy,286,66,352,2,50,Player A
232,Randy,294,89,383,9,42,Player A
233,Randy,270,115,385,8,41,Player A
234,Randy,303,53,356,0,48,Player A
235,Randy,313,58,371,3,44,Player A
236,Randy,244,84,328,2,58,Player A
237,Randy,278,63,341,0,53,Player A
238,Randy,298,53,351,1,50,Player A
239,Randy,296,61,357,1,48,Player A
240,Randy,303,53,356,0,48,Player A
241,Randy,311,51,362,0,46,Player A
242,Randy,296,61,357,1,48,Player A
243,Randy,315,50,365,0,45,Player A
244,Randy,314,64,378,4,42,Player A
245,Randy,257,82,339,4,55,Player A
246,Randy,292,117,409,14,35,Player A
247,Randy,310,60,370,2,44,Player A
248,Randy,283,58,341,0,53,Player A
249,Randy,325,50,375,1,42,Player A
250,Randy,268,68,336,1,55,Player A
251,Randy,292,62,354,1,49,Player A
252,Randy,299,54,353,0,49,Player A
253,Randy,319,49,368,0,44,Player A
254,Randy,323,48,371,0,43,Player A
255,Randy,292,67,359,3,48,Player A
256,Randy,278,63,341,0,53,Player A
257,Randy,298,68,366,4,46,Player A
258,Randy,311,51,362,0,46,Player A
259,Randy,303,53,356,0,48,Player A
260,Randy,317,52,369,1,44,Player A
261,Randy,279,69,348,1,51,Player A
262,Randy,283,58,341,0,53,Player A
263,Randy,299,54,353,0,49,Player A
264,Randy,289,79,368,3,45,Player A
265,Randy,287,57,344,0,52,Player A
266,Randy,305,55,360,1,47,Player A
267,Randy,272,77,349,2,51,Player A
268,Randy,259,64,323,0,59,Player A
269,Randy,270,90,360,7,49,Player A
270,Randy,307,52,359,0,47,Player A
271,Randy,303,53,356,0,48,Player A
272,Randy,251,76,327,1,58,Player A
273,Randy,280,80,360,7,49,Player A
274,Randy,238,173,411,28,39,Player A
275,Randy,242,172,414,19,35,Player A
276,Randy,295,70,365,3,46,Player A
277,Randy,287,57,344,0,52,Player A
278,Randy,339,44,383,0,39,Player A
279,Randy,306,66,372,4,44,Player A
280,Randy,294,59,353,0,49,Player A
281,Randy,297,62,359,3,48,Player A
282,Randy,271,76,347,3,52,Player A
283,Randy,307,57,364,2,46,Player A
284,Randy,272,92,364,5,47,Player A
285,Randy,292,87,379,5,42,Player A
286,Randy,304,59,363,4,47,Player A
287,Randy,299,69,368,3,45,Player A
288,Randy,288,73,361,2,47,Player A
289,Randy,338,43,381,1,40,Player A
290,Randy,298,58,356,0,48,Player A
291,Randy,283,93,376,11,45,Player A
292,Randy,271,71,342,1,53,Player A
293,Randy,280,70,350,3,51,Player A
294,Randy,295,55,350,0,50,Player A
295,Randy,295,55,350,0,50,Player A
296,Randy,283,58,341,0,53,Player A
297,Randy,310,60,370,2,44,Player A
298,Randy,323,48,371,0,43,Player A
299,Randy,266,66,332,0,56,Player A
300,Randy,331,46,377,0,41,Player A
301,Randy,257,87,344,3,53,Player A
302,Randy,283,58,341,0,53,Player A
303,Randy,256,71,327,1,58,Player A
304,Randy,323,48,371,0,43,Player A
305,Randy,274,69,343,2,53,Player A
306,Randy,276,66,342,1,53,Player A
307,Randy,323,48,371,0,43,Player A
308,Randy,311,51,362,0,46,Player A
309,Randy,298,63,361,2,47,Player A
310,Randy,291,56,347,0,51,Player A
311,Randy,288,63,351,1,50,Player A
312,Randy,285,75,360,4,48,Player A
313,Randy,228,153,381,13,44,Player A
314,Randy,292,62,354,1,49,Player A
315,Randy,311,51,362,0,46,Player A
316,Randy,292,67,359,3,48,Player A
317,Randy,311,56,367,2,45,Player A
318,Randy,262,67,329,0,57,Player A
319,Randy,288,63,351,1,50,Player A
320,Randy,325,50,375,1,42,Player A
321,Randy,244,114,358,11,51,Player A
322,Randy,306,76,382,5,41,Player A
323,Randy,291,56,347,0,51,Player A
324,Randy,283,58,341,0,53,Player A
325,Randy,328,58,386,3,39,Player A
326,Randy,258,103,361,11,50,Player A
327,Randy,294,64,358,2,48,Player A
328,Randy,287,57,344,0,52,Player A
329,Randy,317,57,374,3,43,Player A
330,Randy,312,57,369,1,44,Player A
331,Randy,295,55,350,0,50,Player A
332,Randy,291,56,347,0,51,Player A
333,Randy,300,65,365,3,46,Player A
334,Randy,315,50,365,0,45,Player A
335,Randy,307,62,369,4,45,Player A
336,Randy,277,72,349,2,51,Player A
337,Randy,278,63,341,0,53,Player A
338,Randy,315,50,365,0,45,Player A
339,Randy,309,54,363,1,46,Player A
340,Randy,308,58,366,1,45,Player A
341,Randy,284,54,338,0,54,Player A
342,Randy,296,76,372,4,44,Player A
343,Randy,291,56,347,0,51,Player A
344,Randy,279,59,338,0,54,Player A
345,Randy,286,66,352,2,50,Player A
346,Randy,304,59,363,1,46,Player A
347,Randy,244,129,373,14,47,Player A
348,Randy,277,87,364,5,47,Player A
349,Randy,279,59,338,0,54,Player A
350,Randy,277,72,349,2,51,Player A
351,Randy,337,47,384,1,39,Player A
352,Randy,292,62,354,1,49,Player A
353,Randy,307,52,359,0,47,Player A
354,Randy,311,76,387,7,40,Player A
355,Randy,326,61,387,4,39,Player A
356,Randy,327,47,374,0,42,Player A
357,Randy,291,56,347,0,51,Player A
358,Randy,310,55,365,0,45,Player A
359,Randy,294,64,358,2,48,Player A
360,Randy,264,84,348,4,52,Player A
361,Randy,307,52,359,0,47,Player A
362,Randy,279,99,378,10,44,Player A
363,Randy,296,76,372,4,44,Player A
364,Randy,325,50,375,1,42,Player A
365,Randy,290,60,350,0,50,Player A
366,Randy,299,64,363,1,46,Player A
367,Randy,284,64,348,1,51,Player A
368,Randy,321,56,377,3,42,Player A
369,Randy,247,127,374,9,45,Player A
370,Randy,281,71,352,2,50,Player A
371,Randy,302,77,379,5,42,Player A
372,Randy,301,56,357,1,48,Player A
373,Randy,304,59,363,1,46,Player A
374,Randy,302,57,359,0,47,Player A
375,Randy,242,97,339,7,56,Player A
376,Randy,284,69,353,3,50,Player A
377,Randy,309,69,378,4,42,Player A
378,Randy,286,71,357,4,49,Player A
379,Randy,298,58,356,0,48,Player A
380,Randy,287,62,349,2,51,Player A
381,Randy,251,76,327,1,58,Player A
382,Randy,295,55,350,0,50,Player A
383,Randy,303,53,356,0,48,Player A
384,Randy,311,51,362,0,46,Player A
385,Randy,313,53,366,1,45,Player A
386,Randy,300,70,370,5,45,Player A
387,Randy,315,50,365,0,45,Player A
388,Randy,299,54,353,0,49,Player A
389,Randy,293,58,351,1,50,Player A
390,Randy,302,57,359,0,47,Player A
391,Randy,306,51,357,1,48,Player A
392,Randy,282,62,344,0,52,Player A
393,Randy,311,51,362,0,46,Player A
394,Randy,302,77,379,5,42,Player A
395,Randy,288,63,351,1,50,Player A
396,Randy,287,72,359,3,48,Player A
397,Randy,351,41,392,0,36,Player A
398,Randy,299,54,353,0,49,Player A
399,Randy,349,44,393,1,36,Player A
400,Randy,335,45,380,0,40,Player A
401,Randy,330,65,395,6,37,Player A
402,Randy,271,61,332,0,56,Player A
403,Randy,293,73,366,4,46,Player A
404,Randy,267,62,329,0,57,Player A
405,Randy,275,60,335,0,55,Player A
406,Randy,260,110,370,11,47,Player A
407,Randy,291,56,347,0,51,Player A
408,Randy,295,55,350,0,50,Player A
409,Randy,268,68,336,1,55,Player A
410,Randy,280,70,350,3,51,Player A
411,Randy,331,46,377,0,41,Player A
412,Randy,295,55,350,0,50,Player A
413,Randy,279,59,338,0,54,Player A
414,Randy,270,85,355,5,50,Player A
415,Randy,323,48,371,0,43,Player A
416,Randy,303,53,356,0,48,Player A
417,Randy,312,57,369,1,44,Player A
418,Randy,275,60,335,0,55,Player A
419,Randy,309,59,368,3,45,Player A
420,Randy,288,93,381,10,43,Player A
421,Randy,351,41,392,0,36,Player A
422,Randy,287,57,344,0,52,Player A
423,Randy,317,52,369,1,44,Player A
424,Randy,296,61,357,1,48,Player A
425,Randy,325,50,375,1,42,Player A
426,Randy,280,65,345,1,52,Player A
427,Randy,294,64,358,2,48,Player A
428,Randy,275,115,390,13,41,Player A
429,Randy,273,73,346,2,52,Player A
430,Randy,319,49,368,0,44,Player A
431,Randy,283,58,341,0,53,Player A
432,Randy,307,52,359,0,47,Player A
433,Randy,283,58,341,0,53,Player A
434,Randy,279,74,353,3,50,Player A
435,Randy,292,62,354,1,49,Player A
436,Randy,285,75,360,4,48,Player A
437,Randy,292,62,354,1,49,Player A
438,Randy,295,55,350,0,50,Player A
439,Randy,244,84,328,2,58,Player A
440,Randy,283,58,341,0,53,Player A
441,Randy,311,51,362,0,46,Player A
442,Randy,294,54,348,1,51,Player A
443,Randy,294,64,358,2,48,Player A
444,Randy,312,57,369,1,44,Player A
445,Randy,263,78,341,3,54,Player A
446,Randy,320,55,375,1,42,Player A
447,Randy,307,52,359,0,47,Player A
448,Randy,274,69,343,2,53,Player A
449,Randy,311,51,362,0,46,Player A
450,Randy,280,65,345,1,52,Player A
451,Randy,263,63,326,0,58,Player A
452,Randy,292,62,354,1,49,Player A
453,Randy,267,62,329,0,57,Player A
454,Randy,258,93,351,7,52,Player A
455,Randy,248,73,321,1,60,Player A
456,Randy,339,44,383,0,39,Player A
457,Randy,307,52,359,0,47,Player A
458,Randy,282,92,374,9,45,Player A
459,Randy,291,56,347,0,51,Player A
460,Randy,275,60,335,0,55,Player A
461,Randy,281,71,352,2,50,Player A
462,Randy,287,57,344,0,52,Player A
463,Randy,313,53,366,1,45,Player A
464,Randy,296,61,357,1,48,Player A
465,Randy,303,53,356,0,48,Player A
466,Randy,311,51,362,0,46,Player A
467,Randy,307,92,399,10,37,Player A
468,Randy,300,60,360,1,47,Player A
469,Randy,299,54,353,0,49,Player A
470,Randy,295,55,350,0,50,Player A
471,Randy,307,52,359,0,47,Player A
472,Randy,304,84,388,8,40,Player A
473,Randy,286,66,352,2,50,Player A
474,Randy,265,80,345,4,53,Player A
475,Randy,261,156,417,22,35,Player A
476,Randy,237,157,394,17,41,Player A
477,Randy,303,53,356,0,48,Player A
478,Randy,283,58,341,0,53,Player A
479,Randy,280,65,345,1,52,Player A
480,Randy,287,77,364,5,47,Player A
481,Randy,299,54,353,0,49,Player A
482,Randy,303,53,356,0,48,Player A
483,Randy,337,47,384,1,39,Player A
484,Randy,241,91,332,3,57,Player A
485,Randy,291,56,347,0,51,Player A
486,Randy,260,70,330,1,57,Player A
487,Randy,347,42,389,0,37,Player A
488,Randy,275,60,335,0,55,Player A
489,Randy,307,52,359,0,47,Player A
490,Randy,296,61,357,1,48,Player A
491,Randy,311,51,362,0,46,Player A
492,Randy,287,57,344,0,52,Player A
493,Randy,318,48,366,1,45,Player A
494,Randy,276,116,392,9,39,Player A
495,Randy,304,69,373,5,44,Player A
496,Randy,318,53,371,0,43,Player A
497,Randy,273,83,356,3,49,Player A
498,Randy,241,101,342,7,55,Player A
499,Randy,303,53,356,0,48,Player A
500,Randy,304,94,398,9,37,Player A
501,Randy,287,57,344,0,52,Player A
502,Randy,319,49,368,0,44,Player A
503,Randy,303,53,356,0,48,Player A
504,Randy,307,52,359,0,47,Player A
505,Randy,307,52,359,0,47,Player A
506,Randy,315,50,365,0,45,Player A
507,Randy,299,54,353,0,49,Player A
508,Randy,306,61,367,2,45,Player A
509,Randy,310,65,375,4,43,Player A
510,Randy,315,50,365,0,45,Player A
511,Randy,296,66,362,3,47,Player A
512,Randy,252,152,404,18,38,Player A
513,Randy,311,91,402,10,36,Player A
514,Randy,276,96,372,7,45,Player A
515,Randy,319,49,368,0,44,Player A
516,Randy,296,61,357,1,48,Player A
517,Randy,307,52,359,0,47,Player A
518,Randy,271,61,332,0,56,Player A
519,Randy,327,47,374,0,42,Player A
520,Randy,274,74,348,4,52,Player A
521,Randy,311,51,362,0,46,Player A
522,Randy,275,60,335,0,55,Player A
523,Randy,287,57,344,0,52,Player A
524,Randy,298,68,366,4,46,Player A
525,Randy,307,52,359,0,47,Player A
526,Randy,291,56,347,0,51,Player A
527,Randy,284,64,348,1,51,Player A
528,Randy,227,152,379,14,45,Player A
529,Randy,263,108,371,9,46,Player A
530,Randy,299,54,353,0,49,Player A
531,Randy,329,54,383,3,40,Player A
532,Randy,290,60,350,0,50,Player A
533,Randy,265,85,350,9,53,Player A
534,Randy,298,68,366,1,45,Player A
535,Randy,286,66,352,2,50,Player A
536,Randy,254,84,338,3,55,Player A
537,Randy,299,54,353,0,49,Player A
538,Randy,315,65,380,3,41,Player A
539,Randy,299,54,353,0,49,Player A
540,Randy,295,55,350,0,50,Player A
541,Randy,260,70,330,1,57,Player A
542,Randy,335,45,380,0,40,Player A
543,Randy,301,56,357,1,48,Player A
544,Randy,306,56,362,0,46,Player A
545,Randy,304,49,353,0,49,Player A
546,Randy,328,63,391,5,38,Player A
547,Randy,261,76,337,2,55,Player A
548,Randy,254,94,348,7,53,Player A
549,Randy,269,74,343,2,53,Player A
550,Randy,295,55,350,0,50,Player A
551,Randy,299,54,353,0,49,Player A
552,Randy,302,62,364,2,46,Player A
553,Randy,291,56,347,0,51,Player A
554,Randy,322,57,379,2,41,Player A
555,Randy,319,49,368,0,44,Player A
556,Randy,310,60,370,2,44,Player A
557,Randy,303,53,356,0,48,Player A
558,Randy,295,55,350,0,50,Player A
559,Randy,247,67,314,0,62,Player A
560,Randy,302,57,359,0,47,Player A
561,Randy,291,56,347,0,51,Player A
562,Randy,275,60,335,0,55,Player A
563,Randy,308,58,366,1,45,Player A
564,Randy,274,84,358,5,49,Player A
565,Randy,303,53,356,0,48,Player A
566,Randy,303,53,356,0,48,Player A
567,Randy,276,66,342,1,53,Player A
568,Randy,215,160,375,16,47,Player A
569,Randy,261,121,382,11,43,Player A
570,Randy,311,51,362,0,46,Player A
571,Randy,300,60,360,1,47,Player A
572,Randy,303,53,356,0,48,Player A
573,Randy,296,61,357,1,48,Player A
574,Randy,271,76,347,3,52,Player A
575,Randy,299,54,353,0,49,Player A
576,Randy,273,93,366,7,47,Player A
577,Randy,295,55,350,0,50,Player A
578,Randy,282,62,344,0,52,Player A
579,Randy,299,54,353,0,49,Player A
580,Randy,271,61,332,0,56,Player A
581,Randy,325,50,375,1,42,Player A
582,Randy,286,71,357,4,49,Player A
583,Randy,311,51,362,0,46,Player A
584,Randy,293,58,351,1,50,Player A
585,Randy,314,54,368,0,44,Player A
586,Randy,283,93,376,11,45,Player A
587,Randy,254,84,338,3,55,Player A
588,Randy,312,57,369,1,44,Player A
589,Randy,260,80,340,2,54,Player A
590,Randy,283,58,341,0,53,Player A
591,Randy,311,51,362,0,46,Player A
592,Randy,260,75,335,3,56,Player A
593,Randy,279,74,353,3,50,Player A
594,Randy,309,54,363,1,46,Player A
595,Randy,310,60,370,2,44,Player A
596,Randy,292,62,354,1,49,Player A
597,Randy,318,58,376,2,42,Player A
598,Randy,307,52,359,0,47,Player A
599,Randy,311,51,362,0,46,Player A
600,Randy,303,88,391,8,39,Player A
601,Randy,311,51,362,0,46,Player A
602,Randy,291,56,347,0,51,Player A
603,Randy,303,53,356,0,48,Player A
604,Randy,307,67,374,3,43,Player A
605,Randy,319,49,368,0,44,Player A
606,Randy,299,54,353,0,49,Player A
607,Randy,305,70,375,4,43,Player A
608,Randy,291,56,347,0,51,Player A
609,Randy,277,82,359,6,49,Player A
610,Randy,303,53,356,0,48,Player A
611,Randy,327,47,374,0,42,Player A
612,Randy,303,53,356,0,48,Player A
613,Randy,279,59,338,0,54,Player A
614,Randy,283,68,351,1,50,Player A
615,Randy,291,56,347,0,51,Player A
616,Randy,315,50,365,0,45,Player A
617,Randy,282,62,344,0,52,Player A
618,Randy,300,60,360,1,47,Player A
619,Randy,339,44,383,0,39,Player A
620,Randy,310,90,400,11,37,Player A
621,Randy,325,55,380,3,41,Player A
622,Randy,291,86,377,6,43,Player A
623,Randy,329,49,378,1,41,Player A
624,Randy,290,75,365,3,46,Player A
625,Randy,279,59,338,0,54,Player A
626,Randy,308,58,366,1,45,Player A
627,Randy,319,49,368,0,44,Player A
628,Randy,313,58,371,3,44,Player A
629,Randy,287,97,384,7,41,Player A
630,Randy,271,61,332,0,56,Player A
631,Randy,339,44,383,0,39,Player A
632,Randy,304,59,363,1,46,Player A
633,Randy,321,51,372,1,43,Player A
634,Randy,273,73,346,2,52,Player A
635,Randy,259,64,323,0,59,Player A
636,Randy,311,51,362,0,46,Player A
637,Randy,303,68,371,6,45,Player A
638,Randy,292,77,369,4,45,Player A
639,Randy,346,51,397,2,35,Player A
640,Randy,323,48,371,0,43,Player A
641,Randy,290,70,360,4,48,Player A
642,Randy,294,64,358,2,48,Player A
643,Randy,312,57,369,1,44,Player A
644,Randy,286,66,352,2,50,Player A
645,Randy,304,69,373,5,44,Player A
646,Randy,260,75,335,0,55,Player A
647,Randy,312,47,359,0,47,Player A
648,Randy,316,71,387,7,40,Player A
649,Randy,308,58,366,1,45,Player A
650,Randy,272,67,339,1,54,Player A
651,Randy,303,53,356,0,48,Player A
652,Randy,311,51,362,0,46,Player A
653,Randy,339,44,383,0,39,Player A
654,Randy,315,50,365,0,45,Player A
655,Randy,283,58,341,0,53,Player A
656,Randy,303,53,356,0,48,Player A
657,Randy,259,79,338,3,55,Player A
658,Randy,295,55,350,0,50,Player A
659,Randy,334,59,393,4,37,Player A
660,Randy,302,62,364,2,46,Player A
661,Randy,311,51,362,0,46,Player A
662,Randy,280,65,345,1,52,Player A
663,Randy,319,49,368,0,44,Player A
664,Randy,288,68,356,3,49,Player A
665,Randy,286,66,352,2,50,Player A
666,Randy,311,51,362,0,46,Player A
667,Randy,277,127,404,18,38,Player A
668,Randy,268,68,336,1,55,Player A
669,Randy,337,47,384,1,39,Player A
670,Randy,282,62,344,0,52,Player A
671,Randy,299,54,353,0,49,Player A
672,Randy,301,66,367,2,45,Player A
673,Randy,315,50,365,0,45,Player A
674,Randy,279,59,338,0,54,Player A
675,Randy,292,62,354,1,49,Player A
676,Randy,319,49,368,0,44,Player A
677,Randy,330,55,385,2,39,Player A
678,Randy,291,56,347,0,51,Player A
679,Randy,267,62,329,0,57,Player A
680,Randy,305,65,370,2,44,Player A
681,Randy,291,66,357,4,49,Player A
682,Randy,271,71,342,1,53,Player A
683,Randy,283,58,341,0,53,Player A
684,Randy,288,78,366,4,46,Player A
685,Randy,318,53,371,0,43,Player A
686,Randy,285,60,345,1,52,Player A
687,Randy,290,60,350,0,50,Player A
688,Randy,329,49,378,1,41,Player A
689,Randy,280,65,345,1,52,Player A
690,Randy,298,58,356,0,48,Player A
691,Randy,314,59,373,5,44,Player A
692,Randy,261,81,342,1,53,Player A
693,Randy,291,56,347,0,51,Player A
694,Randy,299,54,353,0,49,Player A
695,Randy,287,57,344,0,52,Player A
696,Randy,327,47,374,0,42,Player A
697,Randy,286,56,342,1,53,Player A
698,Randy,324,64,388,5,39,Player A
699,Randy,287,57,344,0,52,Player A
700,Randy,275,60,335,0,55,Player A
701,Randy,265,80,345,4,53,Player A
702,Randy,287,57,344,0,52,Player A
703,Randy,295,55,350,0,50,Player A
704,Randy,288,63,351,1,50,Player A
705,Randy,283,58,341,0,53,Player A
706,Randy,259,129,388,14,42,Player A
707,Randy,323,48,371,0,43,Player A
708,Randy,299,54,353,0,49,Player A
709,Randy,285,95,380,9,43,Player A
710,Randy,287,57,344,0,52,Player A
711,Randy,295,55,350,0,50,Player A
712,Randy,299,54,353,0,49,Player A
713,Randy,271,76,347,3,52,Player A
714,Randy,284,64,348,1,51,Player A
715,Randy,275,60,335,0,55,Player A
716,Randy,302,82,384,7,41,Player A
717,Randy,249,84,333,4,57,Player A
718,Randy,287,57,344,0,52,Player A
719,Randy,277,82,359,6,49,Player A
720,Randy,293,103,396,13,39,Player A
721,Randy,339,44,383,0,39,Player A
722,Randy,296,61,357,1,48,Player A
723,Randy,271,61,332,0,56,Player A
724,Randy,323,53,376,2,42,Player A
725,Randy,288,68,356,3,49,Player A
726,Randy,303,53,356,0,48,Player A
727,Randy,284,79,363,4,47,Player A
728,Randy,287,57,344,0,52,Player A
729,Randy,295,55,350,0,50,Player A
730,Randy,299,54,353,0,49,Player A
731,Randy,271,61,332,0,56,Player A
732,Randy,275,60,335,0,55,Player A
733,Randy,284,64,348,1,51,Player A
734,Randy,275,60,335,0,55,Player A
735,Randy,307,52,359,0,47,Player A
736,Randy,323,48,371,0,43,Player A
737,Randy,305,55,360,1,47,Player A
738,Randy,276,66,342,1,53,Player A
739,Randy,254,104,358,8,50,Player A
740,Randy,271,66,337,2,55,Player A
741,Randy,310,65,375,4,43,Player A
742,Randy,265,75,340,2,54,Player A
743,Randy,263,78,341,3,54,Player A
744,Randy,319,49,368,0,44,Player A
745,Randy,311,51,362,0,46,Player A
746,Randy,260,90,350,6,52,Player A
747,Randy,329,54,383,3,40,Player A
748,Randy,275,80,355,2,49,Player A
749,Randy,296,51,347,0,51,Player A
750,Randy,266,66,332,0,56,Player A
751,Randy,287,77,364,5,47,Player A
752,Randy,270,85,355,5,50,Player A
753,Randy,268,68,336,1,55,Player A
754,Randy,295,55,350,0,50,Player A
755,Randy,276,66,342,1,53,Player A
756,Randy,303,53,356,0,48,Player A
757,Randy,273,83,356,6,50,Player A
758,Randy,296,61,357,1,48,Player A
759,Randy,295,55,350,0,50,Player A
760,Randy,245,95,340,5,55,Player A
761,Randy,279,59,338,0,54,Player A
762,Randy,259,74,333,1,56,Player A
763,Randy,284,64,348,1,51,Player A
764,Randy,338,63,401,6,35,Player A
765,Randy,287,57,344,0,52,Player A
766,Randy,343,48,391,2,37,Player A
767,Randy,287,57,344,0,52,Player A
768,Randy,253,78,331,2,57,Player A
769,Randy,318,63,381,4,41,Player A
770,Randy,311,51,362,0,46,Player A
771,Randy,295,55,350,0,50,Player A
772,Randy,339,44,383,0,39,Player A
773,Randy,283,58,341,0,53,Player A
774,Randy,279,59,338,0,54,Player A
775,Randy,275,60,335,0,55,Player A
776,Randy,278,63,341,0,53,Player A
777,Randy,295,55,350,0,50,Player A
778,Randy,320,55,375,1,42,Player A
779,Randy,310,60,370,2,44,Player A
780,Randy,262,67,329,0,57,Player A
781,Randy,305,55,360,1,47,Player A
782,Randy,273,78,351,4,51,Player A
783,Randy,308,58,366,1,45,Player A
784,Randy,279,59,338,0,54,Player A
785,Randy,287,57,344,0,52,Player A
786,Randy,331,46,377,0,41,Player A
787,Randy,287,57,344,0,52,Player A
788,Randy,269,99,368,9,47,Player A
789,Randy,342,67,409,5,32,Player A
790,Randy,295,55,350,0,50,Player A
791,Randy,302,62,364,2,46,Player A
792,Randy,299,54,353,0,49,Player A
793,Randy,307,52,359,0,47,Player A
794,Randy,270,70,340,2,54,Player A
795,Randy,297,77,374,6,44,Player A
796,Randy,284,94,378,10,44,Player A
797,Randy,271,76,347,3,52,Player A
798,Randy,251,106,357,7,50,Player A
799,Randy,314,49,363,1,46,Player A
800,Randy,306,61,367,2,45,Player A
801,Randy,287,67,354,1,49,Player A
802,Randy,304,59,363,1,46,Player A
803,Randy,303,53,356,0,48,Player A
804,Randy,315,50,365,0,45,Player A
805,Randy,283,58,341,0,53,Player A
806,Randy,276,66,342,1,53,Player A
807,Randy,257,77,334,2,56,Player A
808,Randy,295,55,350,0,50,Player A
809,Randy,306,71,377,6,43,Player A
810,Randy,335,45,380,0,40,Player A
811,Randy,249,99,348,7,53,Player A
812,Randy,329,49,378,1,41,Player A
813,Randy,333,48,381,1,40,Player A
814,Randy,312,57,369,1,44,Player A
815,Randy,287,87,374,9,45,Player A
816,Randy,260,80,340,2,54,Player A
817,Randy,291,56,347,0,51,Player A
818,Randy,295,90,385,8,41,Player A
819,Randy,331,46,377,0,41,Player A
820,Randy,315,50,365,0,45,Player A
821,Randy,277,117,394,14,40,Player A
822,Randy,312,57,369,1,44,Player A
823,Randy,292,92,384,7,41,Player A
824,Randy,270,90,360,7,49,Player A
825,Randy,335,45,380,0,40,Player A
826,Randy,295,55,350,0,50,Player A
827,Randy,317,52,369,1,44,Player A
828,Randy,246,151,397,14,39,Player A
829,Randy,283,78,361,5,48,Player A
830,Randy,299,54,353,0,49,Player A
831,Randy,307,52,359,0,47,Player A
832,Randy,319,49,368,0,44,Player A
833,Randy,267,62,329,0,57,Player A
834,Randy,278,98,376,8,44,Player A
835,Randy,281,91,372,7,45,Player A
836,Randy,286,66,352,2,50,Player A
837,Randy,235,105,340,5,55,Player A
838,Randy,303,53,356,0,48,Player A
839,Randy,291,56,347,0,51,Player A
840,Randy,315,55,370,2,44,Player A
841,Randy,269,79,348,4,52,Player A
842,Randy,309,54,363,1,46,Player A
843,Randy,278,88,366,7,47,Player A
844,Randy,282,82,364,5,47,Player A
845,Randy,304,59,363,1,46,Player A
846,Randy,291,71,362,3,47,Player A
847,Randy,277,62,339,1,54,Player A
848,Randy,276,66,342,1,53,Player A
849,Randy,302,52,354,1,49,Player A
850,Randy,301,61,362,0,46,Player A
851,Randy,300,50,350,0,50,Player A
852,Randy,299,54,353,0,49,Player A
853,Randy,347,42,389,0,37,Player A
854,Randy,335,45,380,0,40,Player A
855,Randy,338,58,396,4,36,Player A
856,Randy,253,143,396,16,40,Player A
857,Randy,273,113,386,12,42,Player A
858,Randy,307,52,359,0,47,Player A
859,Randy,323,48,371,0,43,Player A
860,Randy,287,57,344,0,52,Player A
861,Randy,312,62,374,3,43,Player A
862,Randy,283,58,341,0,53,Player A
863,Randy,291,56,347,0,51,Player A
864,Randy,271,61,332,0,56,Player A
865,Randy,299,54,353,0,49,Player A
866,Randy,279,74,353,3,50,Player A
867,Randy,252,112,364,8,48,Player A
868,Randy,287,57,344,0,52,Player A
869,Randy,310,65,375,4,43,Player A
870,Randy,272,67,339,1,54,Player A
871,Randy,271,61,332,0,56,Player A
872,Randy,264,104,368,6,46,Player A
873,Randy,295,55,350,0,50,Player A
874,Randy,303,68,371,3,44,Player A
875,Randy,307,52,359,0,47,Player A
876,Randy,305,55,360,1,47,Player A
877,Randy,297,67,364,2,46,Player A
878,Randy,322,57,379,2,41,Player A
879,Randy,283,58,341,0,53,Player A
880,Randy,289,69,358,5,49,Player A
881,Randy,306,56,362,0,46,Player A
882,Randy,256,106,362,9,49,Player A
883,Randy,335,45,380,0,40,Player A
884,Randy,290,65,355,2,49,Player A
885,Randy,288,63,351,1,50,Player A
886,Randy,292,77,369,4,45,Player A
887,Randy,279,99,378,10,44,Player A
888,Randy,251,101,352,8,52,Player A
889,Randy,311,51,362,0,46,Player A
890,Randy,359,39,398,0,34,Player A
891,Randy,309,54,363,1,46,Player A
892,Randy,290,65,355,2,49,Player A
893,Randy,247,112,359,9,50,Player A
894,Randy,281,61,342,1,53,Player A
895,Randy,314,59,373,2,43,Player A
896,Randy,315,50,365,0,45,Player A
897,Randy,314,69,383,6,41,Player A
898,Randy,266,121,387,13,42,Player A
899,Randy,285,80,365,6,47,Player A
900,Randy,266,81,347,3,52,Player A
901,Randy,294,59,353,0,49,Player A
902,Randy,292,52,344,0,52,Player A
903,Randy,275,60,335,0,55,Player A
904,Randy,292,62,354,1,49,Player A
905,Randy,315,50,365,0,45,Player A
906,Randy,310,65,375,4,43,Player A
907,Randy,327,47,374,0,42,Player A
908,Randy,291,56,347,0,51,Player A
909,Randy,279,59,338,0,54,Player A
910,Randy,249,139,388,17,43,Player A
911,Randy,359,39,398,0,34,Player A
912,Randy,319,49,368,0,44,Player A
913,Randy,291,56,347,0,51,Player A
914,Randy,273,98,371,12,47,Player A
915,Randy,285,70,355,2,49,Player A
916,Randy,267,62,329,0,57,Player A
917,Randy,303,53,356,0,48,Player A
918,Randy,299,54,353,0,49,Player A
919,Randy,314,54,368,0,44,Player A
920,Randy,267,102,369,7,46,Player A
921,Randy,311,51,362,0,46,Player A
922,Randy,270,65,335,0,55,Player A
923,Randy,290,65,355,2,49,Player A
924,Randy,282,67,349,2,51,Player A
925,Randy,285,75,360,4,48,Player A
926,Randy,282,67,349,2,51,Player A
927,Randy,327,52,379,2,41,Player A
928,Randy,314,54,368,0,44,Player A
929,Randy,275,185,460,29,23,Player A
930,Randy,259,104,363,4,47,Player A
931,Randy,303,63,366,4,46,Player A
932,Randy,264,89,353,6,51,Player A
933,Randy,307,52,359,0,47,Player A
934,Randy,331,46,377,0,41,Player A
935,Randy,337,47,384,1,39,Player A
936,Randy,278,78,356,3,49,Player A
937,Randy,309,54,363,1,46,Player A
938,Randy,305,70,375,4,43,Player A
939,Randy,294,64,358,2,48,Player A
940,Randy,298,83,381,7,42,Player A
941,Randy,313,53,366,1,45,Player A
942,Randy,278,68,346,2,52,Player A
943,Randy,286,91,377,6,43,Player A
944,Randy,275,60,335,0,55,Player A
945,Randy,319,49,368,0,44,Player A
946,Randy,313,53,366,1,45,Player A
947,Randy,294,59,353,0,49,Player A
948,Randy,268,68,336,1,55,Player A
949,Randy,279,64,343,2,53,Player A
950,Randy,293,58,351,1,50,Player A
951,Randy,299,64,363,1,46,Player A
952,Randy,298,58,356,0,48,Player A
953,Randy,324,44,368,0,44,Player A
954,Randy,303,53,356,0,48,Player A
955,Randy,295,90,385,8,41,Player A
956,Randy,307,52,359,0,47,Player A
957,Randy,315,50,365,0,45,Player A
958,Randy,306,66,372,4,44,Player A
959,Randy,274,69,343,2,53,Player A
960,Randy,318,53,371,0,43,Player A
961,Randy,282,67,349,2,51,Player A
962,Randy,264,99,363,10,49,Player A
963,Randy,279,79,358,5,49,Player A
964,Randy,307,52,359,0,47,Player A
965,Randy,323,48,371,0,43,Player A
966,Randy,291,56,347,0,51,Player A
967,Randy,299,54,353,0,49,Player A
968,Randy,291,56,347,0,51,Player A
969,Randy,254,69,323,0,59,Player A
970,Randy,321,51,372,1,43,Player A
971,Randy,297,67,364,2,46,Player A
972,Randy,277,72,349,2,51,Player A
973,Randy,293,78,371,6,45,Player A
974,Randy,280,65,345,1,52,Player A
975,Randy,306,61,367,2,45,Player A
976,Randy,249,69,318,1,61,Player A
977,Randy,292,62,354,1,49,Player A
978,Randy,277,87,364,8,48,Player A
979,Randy,298,68,366,4,46,Player A
980,Randy,289,159,448,26,26,Player A
981,Randy,305,75,380,6,42,Player A
982,Randy,308,73,381,4,41,Player A
983,Randy,296,66,362,3,47,Player A
984,Randy,367,37,404,0,32,Player A
985,Randy,317,52,369,1,44,Player A
986,Randy,258,113,371,12,47,Player A
987,Randy,309,54,363,1,46,Player A
988,Randy,246,91,337,5,56,Player A
989,Randy,288,63,351,1,50,Player A
990,Randy,309,54,363,1,46,Player A
991,Randy,233,133,366,10,48,Player A
992,Randy,293,73,366,4,46,Player A
993,Randy,270,65,335,0,55,Player A
994,Randy,309,54,363,1,46,Player A
995,Randy,286,61,347,0,51,Player A
996,Randy,260,100,360,7,49,Player A
997,Randy,279,84,363,4,47,Player A
998,Randy,286,66,352,2,50,Player A
999,Randy,318,58,376,2,42,Player A
1000,Randy,303,53,356,0,48,Player A
1001,Randy,335,45,380,0,40,Player A
1002,Randy,319,49,368,0,44,Player A
1003,Randy,291,56,347,0,51,Player A
1004,Randy,292,52,344,0,52,Player A
1005,Randy,286,66,352,2,50,Player A
1006,Randy,279,59,338,0,54,Player A
1007,Randy,287,57,344,0,52,Player A
1008,Randy,311,51,362,0,46,Player A
1009,Randy,267,62,329,0,57,Player A
1010,Randy,303,53,356,0,48,Player A
1011,Randy,295,55,350,0,50,Player A
1012,Randy,195,310,505,53,16,Randy
1013,Randy,308,93,401,6,35,Player A
1014,Randy,312,102,414,13,33,Player A
1015,Randy,286,66,352,2,50,Player A
1016,Randy,287,57,344,0,52,Player A
1017,Randy,307,52,359,0,47,Player A
1018,Randy,299,54,353,0,49,Player A
1019,Randy,298,63,361,2,47,Player A
1020,Randy,283,58,341,0,53,Player A
1021,Randy,299,54,353,0,49,Player A
1022,Randy,312,62,374,3,43,Player A
1023,Randy,267,62,329,0,57,Player A
1024,Randy,363,38,401,0,33,Player A
1025,Randy,319,49,368,0,44,Player A
1026,Randy,294,64,358,2,48,Player A
1027,Randy,321,51,372,1,43,Player A
1028,Randy,264,119,383,12,43,Player A
1029,Randy,294,94,388,8,40,Player A
1030,Randy,291,56,347,0,51,Player A
1031,Randy,300,65,365,3,46,Player A
1032,Randy,264,129,393,13,40,Player A
1033,Randy,300,75,375,7,44,Player A
1034,Randy,282,62,344,0,52,Player A
1035,Randy,325,50,375,1,42,Player A
1036,Randy,286,61,347,0,51,Player A
1037,Randy,299,54,353,0,49,Player A
1038,Randy,319,89,408,10,34,Player A
1039,Randy,295,55,350,0,50,Player A
1040,Randy,307,52,359,0,47,Player A
1041,Randy,311,51,362,0,46,Player A
1042,Randy,307,52,359,0,47,Player A
1043,Randy,280,105,385,8,41,Player A
1044,Randy,315,50,365,0,45,Player A
1045,Randy,300,65,365,6,47,Player A
1046,Randy,278,88,366,7,47,Player A
1047,Randy,260,95,355,5,50,Player A
1048,Randy,317,62,379,2,41,Player A
1049,Randy,319,49,368,0,44,Player A
1050,Randy,327,47,374,0,42,Player A
1051,Randy,301,56,357,1,48,Player A
1052,Randy,334,49,383,0,39,Player A
1053,Randy,307,52,359,0,47,Player A
1054,Randy,301,56,357,1,48,Player A
1055,Randy,293,68,361,2,47,Player A
1056,Randy,323,48,371,0,43,Player A
1057,Randy,304,59,363,1,46,Player A
1058,Randy,303,53,356,0,48,Player A
1059,Randy,276,66,342,1,53,Player A
1060,Randy,319,49,368,0,44,Player A
1061,Randy,282,62,344,0,52,Player A
1062,Randy,315,50,365,0,45,Player A
1063,Randy,273,78,351,4,51,Player A
1064,Randy,274,69,343,2,53,Player A
1065,Randy,311,51,362,0,46,Player A
1066,Randy,287,57,344,0,52,Player A
1067,Randy,331,46,377,0,41,Player A
1068,Randy,275,60,335,0,55,Player A
1069,Randy,279,59,338,0,54,Player A
1070,Randy,327,47,374,0,42,Player A
1071,Randy,249,124,373,14,47,Player A
1072,Randy,291,56,347,0,51,Player A
1073,Randy,230,105,335,6,57,Player A
1074,Randy,302,62,364,2,46,Player A
1075,Randy,311,51,362,0,46,Player A
1076,Randy,264,69,333,1,56,Player A
1077,Randy,303,53,356,0,48,Player A
1078,Randy,301,56,357,1,48,Player A
1079,Randy,283,73,356,3,49,Player A
1080,Randy,299,54,353,0,49,Player A
1081,Randy,291,56,347,0,51,Player A
1082,Randy,327,47,374,0,42,Player A
1083,Randy,304,59,363,1,46,Player A
1084,Randy,299,54,353,0,49,Player A
1085,Randy,306,61,367,2,45,Player A
1086,Randy,262,82,344,3,53,Player A
1087,Randy,287,57,344,0,52,Player A
1088,Randy,291,56,347,0,51,Player A
1089,Randy,299,54,353,0,49,Player A
1090,Randy,329,49,378,1,41,Player A
1091,Randy,310,55,365,0,45,Player A
1092,Randy,299,54,353,0,49,Player A
1093,Randy,284,64,348,1,51,Player A
1094,Randy,287,77,364,5,47,Player A
1095,Randy,274,64,338,0,54,Player A
1096,Randy,307,52,359,0,47,Player A
1097,Randy,313,53,366,1,45,Player A
1098,Randy,276,96,372,7,45,Player A
1099,Randy,313,53,366,1,45,Player A
1100,Randy,294,59,353,0,49,Player A
1101,Randy,277,72,349,2,51,Player A
1102,Randy,263,63,326,0,58,Player A
1103,Randy,306,56,362,3,47,Player A
1104,Randy,278,73,351,1,50,Player A
1105,Randy,331,51,382,2,40,Player A
1106,Randy,318,58,376,2,42,Player A
1107,Randy,279,74,353,3,50,Player A
1108,Randy,289,69,358,2,48,Player A
1109,Randy,283,58,341,0,53,Player A
1110,Randy,303,53,356,0,48,Player A
1111,Randy,223,118,341,6,55,Player A
1112,Randy,283,88,371,6,45,Player A
1113,Randy,275,60,335,0,55,Player A
1114,Randy,295,55,350,0,50,Player A
1115,Randy,308,68,376,5,43,Player A
1116,Randy,303,53,356,0,48,Player A
1117,Randy,315,50,365,0,45,Player A
1118,Randy,294,64,358,2,48,Player A
1119,Randy,303,53,356,0,48,Player A
1120,Randy,302,62,364,2,46,Player A
1121,Randy,304,64,368,3,45,Player A
1122,Randy,295,55,350,0,50,Player A
1123,Randy,295,55,350,0,50,Player A
1124,Randy,291,86,377,9,44,Player A
1125,Randy,304,59,363,1,46,Player A
1126,Randy,307,52,359,0,47,Player A
1127,Randy,291,56,347,0,51,Player A
1128,Randy,304,59,363,1,46,Player A
1129,Randy,292,67,359,3,48,Player A
1130,Randy,308,58,366,1,45,Player A
1131,Randy,279,59,338,0,54,Player A
1132,Randy,281,96,377,9,44,Player A
1133,Randy,299,54,353,0,49,Player A
1134,Randy,306,66,372,4,44,Player A
1135,Randy,294,59,353,0,49,Player A
1136,Randy,296,61,357,1,48,Player A
1137,Randy,284,74,358,5,49,Player A
1138,Randy,300,60,360,1,47,Player A
1139,Randy,323,48,371,0,43,Player A
1140,Randy,295,55,350,0,50,Player A
1141,Randy,311,51,362,0,46,Player A
1142,Randy,312,62,374,3,43,Player A
1143,Randy,262,97,359,9,50,Player A
1144,Randy,298,68,366,4,46,Player A
1145,Randy,297,77,374,6,44,Player A
1146,Randy,224,124,348,10,54,Player A
1147,Randy,318,58,376,2,42,Player A
1148,Randy,278,63,341,0,53,Player A
1149,Randy,295,55,350,0,50,Player A
1150,Randy,311,51,362,0,46,Player A
1151,Randy,317,52,369,1,44,Player A
1152,Randy,292,62,354,1,49,Player A
1153,Randy,291,56,347,0,51,Player A
1154,Randy,287,57,344,0,52,Player A
1155,Randy,323,48,371,0,43,Player A
1156,Randy,282,57,339,1,54,Player A
1157,Randy,256,86,342,4,54,Player A
1158,Randy,300,65,365,3,46,Player A
1159,Randy,279,59,338,0,54,Player A
1160,Randy,296,66,362,3,47,Player A
1161,Randy,307,72,379,5,42,Player A
1162,Randy,315,50,365,0,45,Player A
1163,Randy,256,71,327,1,58,Player A
1164,Randy,316,66,382,5,41,Player A
1165,Randy,299,54,353,0,49,Player A
1166,Randy,283,58,341,0,53,Player A
1167,Randy,279,69,348,1,51,Player A
1168,Randy,300,75,375,4,43,Player A
1169,Randy,281,71,352,2,50,Player A
1170,Randy,279,59,338,0,54,Player A
1171,Randy,279,59,338,0,54,Player A
1172,Randy,345,45,390,1,37,Player A
1173,Randy,250,80,330,1,57,Player A
1174,Randy,295,55,350,0,50,Player A
1175,Randy,296,71,367,5,46,Player A
1176,Randy,279,74,353,3,50,Player A
1177,Randy,287,57,344,0,52,Player A
1178,Randy,307,52,359,0,47,Player A
1179,Randy,307,52,359,0,47,Player A
1180,Randy,283,58,341,0,53,Player A
1181,Randy,327,47,374,0,42,Player A
1182,Randy,313,53,366,1,45,Player A
1183,Randy,312,72,384,4,40,Player A
1184,Randy,339,49,388,2,38,Player A
1185,Randy,270,65,335,0,55,Player A
1186,Randy,277,92,369,4,45,Player A
1187,Randy,295,55,350,0,50,Player A
1188,Randy,263,78,341,3,54,Player A
1189,Randy,279,59,338,0,54,Player A
1190,Randy,300,60,360,1,47,Player A
1191,Randy,265,80,345,4,53,Player A
1192,Randy,264,139,403,23,40,Player A
1193,Randy,300,110,410,12,34,Player A
1194,Randy,280,65,345,1,52,Player A
1195,Randy,283,58,341,0,53,Player A
1196,Randy,299,54,353,0,49,Player A
1197,Randy,254,69,323,0,59,Player A
1198,Randy,303,53,356,0,48,Player A
1199,Randy,311,51,362,0,46,Player A
1200,Randy,319,49,368,0,44,Player A
1201,Randy,309,54,363,1,46,Player A
1202,Randy,302,57,359,0,47,Player A
1203,Randy,339,44,383,0,39,Player A
1204,Randy,307,52,359,0,47,Player A
1205,Randy,283,58,341,0,53,Player A
1206,Randy,298,53,351,1,50,Player A
1207,Randy,266,86,352,5,51,Player A
1208,Randy,282,62,344,0,52,Player A
1209,Randy,264,69,333,1,56,Player A
1210,Randy,304,64,368,3,45,Player A
1211,Randy,285,75,360,4,48,Player A
1212,Randy,303,53,356,0,48,Player A
1213,Randy,299,54,353,0,49,Player A
1214,Randy,307,52,359,0,47,Player A
1215,Randy,281,96,377,9,44,Player A
1216,Randy,302,62,364,2,46,Player A
1217,Randy,299,54,353,0,49,Player A
1218,Randy,287,57,344,0,52,Player A
1219,Randy,327,52,379,2,41,Player A
1220,Randy,272,67,339,1,54,Player A
1221,Randy,279,59,338,0,54,Player A
1222,Randy,260,85,345,4,53,Player A
1223,Randy,283,58,341,0,53,Player A
1224,Randy,295,55,350,0,50,Player A
1225,Randy,266,101,367,8,47,Player A
1226,Randy,308,73,381,4,41,Player A
1227,Randy,316,61,377,3,42,Player A
1228,Randy,282,62,344,0,52,Player A
1229,Randy,279,59,338,0,54,Player A
1230,Randy,287,67,354,1,49,Player A
1231,Randy,294,64,358,2,48,Player A
1232,Randy,267,62,329,0,57,Player A
1233,Randy,304,69,373,5,44,Player A
1234,Randy,265,90,355,8,51,Player A
1235,Randy,263,123,386,15,43,Player A
1236,Randy,251,66,317,0,61,Player A
1237,Randy,287,72,359,3,48,Player A
1238,Randy,307,52,359,0,47,Player A
1239,Randy,254,74,328,2,58,Player A
1240,Randy,299,54,353,0,49,Player A
1241,Randy,279,59,338,0,54,Player A
1242,Randy,248,103,351,7,52,Player A
1243,Randy,295,55,350,0,50,Player A
1244,Randy,299,54,353,0,49,Player A
1245,Randy,287,57,344,0,52,Player A
1246,Randy,323,48,371,0,43,Player A
1247,Randy,309,54,363,1,46,Player A
1248,Randy,293,68,361,2,47,Player A
1249,Randy,275,65,340,2,54,Player A
1250,Randy,286,76,362,3,47,Player A
1251,Randy,286,66,352,2,50,Player A
1252,Randy,323,58,381,4,41,Player A
1253,Randy,328,53,381,1,40,Player A
1254,Randy,296,71,367,5,46,Player A
1255,Randy,261,156,417,16,33,Player A
1256,Randy,303,73,376,2,42,Player A
1257,Randy,295,65,360,1,47,Player A
1258,Randy,298,53,351,1,50,Player A
1259,Randy,290,60,350,0,50,Player A
1260,Randy,323,48,371,0,43,Player A
1261,Randy,307,52,359,0,47,Player A
1262,Randy,282,62,344,0,52,Player A
1263,Randy,295,55,350,0,50,Player A
1264,Randy,323,48,371,0,43,Player A
1265,Randy,280,65,345,1,52,Player A
1266,Randy,339,44,383,0,39,Player A
1267,Randy,323,48,371,0,43,Player A
1268,Randy,292,82,374,6,44,Player A
1269,Randy,276,66,342,1,53,Player A
1270,Randy,303,53,356,0,48,Player A
1271,Randy,307,52,359,0,47,Player A
1272,Randy,311,51,362,0,46,Player A
1273,Randy,287,57,344,0,52,Player A
1274,Randy,323,48,371,0,43,Player A
1275,Randy,315,50,365,0,45,Player A
1276,Randy,319,49,368,0,44,Player A
1277,Randy,302,57,359,0,47,Player A
1278,Randy,278,108,386,9,41,Player A
1279,Randy,255,160,415,23,36,Player A
1280,Randy,287,57,344,0,52,Player A
1281,Randy,282,62,344,0,52,Player A
1282,Randy,262,72,334,2,56,Player A
1283,Randy,315,50,365,0,45,Player A
1284,Randy,295,55,350,0,50,Player A
1285,Randy,287,57,344,0,52,Player A
1286,Randy,315,50,365,0,45,Player A
1287,Randy,302,57,359,0,47,Player A
1288,Randy,321,51,372,1,43,Player A
1289,Randy,296,61,357,1,48,Player A
1290,Randy,277,102,379,11,44,Player A
1291,Randy,304,69,373,2,43,Player A
1292,Randy,295,65,360,4,48,Player A
1293,Randy,285,75,360,4,48,Player A
1294,Randy,358,43,401,0,33,Player A
1295,Randy,287,62,349,2,51,Player A
1296,Randy,308,58,366,1,45,Player A
1297,Randy,275,60,335,0,55,Player A
1298,Randy,290,70,360,4,48,Player A
1299,Randy,262,72,334,2,56,Player A
1300,Randy,282,82,364,5,47,Player A
1301,Randy,302,72,374,3,43,Player A
1302,Randy,311,51,362,0,46,Player A
1303,Randy,327,47,374,0,42,Player A
1304,Randy,288,63,351,1,50,Player A
1305,Randy,317,52,369,1,44,Player A
1306,Randy,313,58,371,3,44,Player A
1307,Randy,281,91,372,7,45,Player A
1308,Randy,281,71,352,2,50,Player A
1309,Randy,299,54,353,0,49,Player A
1310,Randy,300,50,350,0,50,Player A
1311,Randy,318,58,376,2,42,Player A
1312,Randy,311,51,362,0,46,Player A
1313,Randy,295,55,350,0,50,Player A
1314,Randy,263,63,326,0,58,Player A
1315,Randy,310,55,365,0,45,Player A
1316,Randy,292,72,364,5,47,Player A
1317,Randy,287,57,344,0,52,Player A
1318,Randy,303,53,356,0,48,Player A
1319,Randy,288,68,356,3,49,Player A
1320,Randy,286,66,352,2,50,Player A
1321,Randy,264,69,333,1,56,Player A
1322,Randy,307,52,359,0,47,Player A
1323,Randy,272,147,419,18,33,Player A
1324,Randy,304,59,363,1,46,Player A
1325,Randy,299,54,353,0,49,Player A
1326,Randy,291,56,347,0,51,Player A
1327,Randy,311,51,362,0,46,Player A
1328,Randy,282,67,349,2,51,Player A
1329,Randy,302,62,364,2,46,Player A
1330,Randy,307,52,359,0,47,Player A
1331,Randy,310,60,370,2,44,Player A
1332,Randy,320,60,380,3,41,Player A
1333,Randy,302,62,364,2,46,Player A
1334,Randy,288,78,366,4,46,Player A
1335,Randy,276,91,367,8,47,Player A
1336,Randy,316,66,382,5,41,Player A
1337,Randy,266,106,372,7,45,Player A
1338,Randy,295,55,350,0,50,Player A
1339,Randy,279,59,338,0,54,Player A
1340,Randy,274,64,338,0,54,Player A
1341,Randy,248,108,356,9,51,Player A
1342,Randy,264,94,358,8,50,Player A
1343,Randy,315,55,370,2,44,Player A
1344,Randy,306,56,362,0,46,Player A
1345,Randy,319,49,368,0,44,Player A
1346,Randy,309,54,363,1,46,Player A
1347,Randy,302,62,364,2,46,Player A
1348,Randy,268,68,336,1,55,Player A
1349,Randy,303,53,356,0,48,Player A
1350,Randy,315,50,365,0,45,Player A
1351,Randy,280,100,380,9,43,Player A
1352,Randy,262,92,354,1,49,Player A
1353,Randy,299,59,358,2,48,Player A
1354,Randy,277,72,349,2,51,Player A
1355,Randy,311,51,362,0,46,Player A
1356,Randy,292,67,359,3,48,Player A
1357,Randy,314,54,368,0,44,Player A
1358,Randy,312,57,369,4,45,Player A
1359,Randy,254,159,413,12,33,Player A
1360,Randy,321,51,372,1,43,Player A
1361,Randy,326,56,382,2,40,Player A
1362,Randy,283,58,341,0,53,Player A
1363,Randy,294,64,358,2,48,Player A
1364,Randy,307,52,359,0,47,Player A
1365,Randy,274,94,368,6,46,Player A
1366,Randy,306,61,367,2,45,Player A
1367,Randy,355,40,395,0,35,Player A
1368,Randy,302,62,364,2,46,Player A
1369,Randy,323,48,371,0,43,Player A
1370,Randy,290,65,355,2,49,Player A
1371,Randy,278,68,346,2,52,Player A
1372,Randy,275,60,335,0,55,Player A
1373,Randy,278,63,341,0,53,Player A
1374,Randy,288,68,356,3,49,Player A
1375,Randy,277,77,354,4,50,Player A
1376,Randy,329,49,378,1,41,Player A
1377,Randy,283,73,356,3,49,Player A
1378,Randy,295,55,350,0,50,Player A
1379,Randy,307,52,359,0,47,Player A
1380,Randy,311,61,372,4,44,Player A
1381,Randy,294,84,378,4,42,Player A
1382,Randy,287,57,344,0,52,Player A
1383,Randy,302,67,369,4,45,Player A
1384,Randy,299,54,353,0,49,Player A
1385,Randy,279,59,338,0,54,Player A
1386,Randy,254,69,323,0,59,Player A
1387,Randy,274,64,338,0,54,Player A
1388,Randy,218,168,386,18,44,Player A
1389,Randy,279,59,338,0,54,Player A
1390,Randy,293,68,361,2,47,Player A
1391,Randy,311,51,362,0,46,Player A
1392,Randy,283,68,351,1,50,Player A
1393,Randy,299,54,353,0,49,Player A
1394,Randy,311,51,362,0,46,Player A
1395,Randy,287,57,344,0,52,Player A
1396,Randy,295,55,350,0,50,Player A
1397,Randy,307,62,369,4,45,Player A
1398,Randy,318,63,381,4,41,Player A
1399,Randy,250,100,350,6,52,Player A
1400,Randy,291,56,347,0,51,Player A
1401,Randy,295,55,350,0,50,Player A
1402,Randy,286,76,362,6,48,Player A
1403,Randy,312,57,369,1,44,Player A
1404,Randy,291,56,347,0,51,Player A
1405,Randy,311,51,362,0,46,Player A
1406,Randy,291,56,347,0,51,Player A
1407,Randy,299,54,353,0,49,Player A
1408,Randy,281,61,342,1,53,Player A
1409,Randy,279,74,353,3,50,Player A
1410,Randy,301,56,357,1,48,Player A
1411,Randy,295,60,355,2,49,Player A
1412,Randy,286,61,347,0,51,Player A
1413,Randy,254,69,323,0,59,Player A
1414,Randy,293,83,376,5,43,Player A
1415,Randy,319,49,368,0,44,Player A
1416,Randy,273,78,351,4,51,Player A
1417,Randy,299,54,353,0,49,Player A
1418,Randy,295,55,350,0,50,Player A
1419,Randy,278,63,341,0,53,Player A
1420,Randy,311,51,362,0,46,Player A
1421,Randy,281,126,407,12,35,Player A
1422,Randy,262,67,329,0,57,Player A
1423,Randy,307,52,359,0,47,Player A
1424,Randy,295,55,350,0,50,Player A
1425,Randy,291,56,347,0,51,Player A
1426,Randy,268,68,336,1,55,Player A
1427,Randy,283,68,351,1,50,Player A
1428,Randy,325,50,375,1,42,Player A
1429,Randy,302,57,359,0,47,Player A
1430,Randy,323,48,371,0,43,Player A
1431,Randy,323,48,371,0,43,Player A
1432,Randy,275,60,335,0,55,Player A
1433,Randy,295,55,350,0,50,Player A
1434,Randy,271,91,362,6,48,Player A
1435,Randy,291,56,347,0,51,Player A
1436,Randy,274,89,363,4,47,Player A
1437,Randy,299,54,353,0,49,Player A
1438,Randy,343,43,386,0,38,Player A
1439,Randy,268,78,346,5,53,Player A
1440,Randy,322,52,374,0,42,Player A
1441,Randy,270,80,350,6,52,Player A
1442,Randy,296,61,357,1,48,Player A
1443,Randy,276,66,342,1,53,Player A
1444,Randy,287,57,344,0,52,Player A
1445,Randy,261,76,337,2,55,Player A
1446,Randy,331,46,377,0,41,Player A
1447,Randy,287,57,344,0,52,Player A
1448,Randy,299,54,353,0,49,Player A
1449,Randy,315,50,365,0,45,Player A
1450,Randy,307,52,359,0,47,Player A
1451,Randy,307,52,359,0,47,Player A
1452,Randy,299,54,353,0,49,Player A
1453,Randy,311,51,362,0,46,Player A
1454,Randy,306,61,367,2,45,Player A
1455,Randy,299,54,353,0,49,Player A
1456,Randy,277,82,359,6,49,Player A
1457,Randy,339,44,383,0,39,Player A
1458,Randy,307,52,359,0,47,Player A
1459,Randy,273,73,346,5,53,Player A
1460,Randy,288,73,361,2,47,Player A
1461,Randy,331,46,377,0,41,Player A
1462,Randy,294,54,348,1,51,Player A
1463,Randy,274,64,338,0,54,Player A
1464,Randy,266,66,332,0,56,Player A
1465,Randy,283,58,341,0,53,Player A
1466,Randy,284,64,348,1,51,Player A
1467,Randy,282,67,349,2,51,Player A
1468,Randy,256,141,397,14,39,Player A
1469,Randy,298,63,361,2,47,Player A
1470,Randy,343,43,386,0,38,Player A
1471,Randy,315,65,380,3,41,Player A
1472,Randy,295,55,350,0,50,Player A
1473,Randy,276,66,342,1,53,Player A
1474,Randy,258,68,326,0,58,Player A
1475,Randy,281,76,357,4,49,Player A
1476,Randy,303,53,356,0,48,Player A
1477,Randy,328,63,391,2,37,Player A
1478,Randy,249,99,348,7,53,Player A
1479,Randy,318,63,381,4,41,Player A
1480,Randy,294,69,363,4,47,Player A
1481,Randy,228,183,411,22,37,Player A
1482,Randy,294,64,358,2,48,Player A
1483,Randy,298,68,366,4,46,Player A
1484,Randy,293,68,361,2,47,Player A
1485,Randy,295,55,350,0,50,Player A
1486,Randy,303,53,356,0,48,Player A
1487,Randy,287,57,344,0,52,Player A
1488,Randy,311,51,362,0,46,Player A
1489,Randy,296,61,357,1,48,Player A
1490,Randy,286,66,352,2,50,Player A
1491,Randy,292,82,374,6,44,Player A
1492,Randy,323,48,371,0,43,Player A
1493,Randy,285,70,355,2,49,Player A
1494,Randy,315,50,365,0,45,Player A
1495,Randy,303,53,356,0,48,Player A
1496,Randy,329,49,378,1,41,Player A
1497,Randy,267,77,344,3,53,Player A
1498,Randy,295,55,350,0,50,Player A
1499,Randy,303,53,356,0,48,Player A
1500,Randy,275,60,335,0,55,Player A
1501,Randy,262,67,329,0,57,Player A
1502,Randy,287,57,344,0,52,Player A
1503,Randy,279,59,338,0,54,Player A
1504,Randy,311,51,362,0,46,Player A
1505,Randy,260,70,330,1,57,Player A
1506,Randy,311,51,362,0,46,Player A
1507,Randy,319,49,368,0,44,Player A
1508,Randy,291,56,347,0,51,Player A
1509,Randy,295,55,350,0,50,Player A
1510,Randy,262,72,334,2,56,Player A
1511,Randy,298,63,361,2,47,Player A
1512,Randy,307,57,364,2,46,Player A
1513,Randy,286,71,357,1,48,Player A
1514,Randy,292,52,344,0,52,Player A
1515,Randy,335,45,380,0,40,Player A
1516,Randy,339,44,383,0,39,Player A
1517,Randy,287,57,344,0,52,Player A
1518,Randy,283,58,341,0,53,Player A
1519,Randy,285,100,385,11,42,Player A
1520,Randy,279,59,338,0,54,Player A
1521,Randy,292,82,374,6,44,Player A
1522,Randy,275,60,335,0,55,Player A
1523,Randy,299,54,353,0,49,Player A
1524,Randy,343,43,386,0,38,Player A
1525,Randy,316,61,377,3,42,Player A
1526,Randy,241,81,322,2,60,Player A
1527,Randy,295,55,350,0,50,Player A
1528,Randy,295,65,360,1,47,Player A
1529,Randy,267,62,329,0,57,Player A
1530,Randy,283,58,341,0,53,Player A
1531,Randy,300,60,360,1,47,Player A
1532,Randy,307,52,359,0,47,Player A
1533,Randy,335,45,380,0,40,Player A
1534,Randy,303,53,356,0,48,Player A
1535,Randy,283,58,341,0,53,Player A
1536,Randy,283,98,381,10,43,Player A
1537,Randy,295,55,350,0,50,Player A
1538,Randy,314,64,378,4,42,Player A
1539,Randy,291,56,347,0,51,Player A
1540,Randy,301,86,387,7,40,Player A
1541,Randy,311,51,362,0,46,Player A
1542,Randy,297,57,354,1,49,Player A
1543,Randy,298,68,366,4,46,Player A
1544,Randy,300,65,365,3,46,Player A
1545,Randy,287,57,344,0,52,Player A
1546,Randy,272,67,339,1,54,Player A
1547,Randy,283,68,351,4,51,Player A
1548,Randy,296,61,357,1,48,Player A
1549,Randy,296,61,357,1,48,Player A
1550,Randy,311,51,362,0,46,Player A
1551,Randy,317,52,369,1,44,Player A
1552,Randy,267,92,359,6,49,Player A
1553,Randy,266,76,342,1,53,Player A
1554,Randy,333,48,381,1,40,Player A
1555,Randy,306,56,362,0,46,Player A
1556,Randy,337,47,384,1,39,Player A
1557,Randy,302,62,364,2,46,Player A
1558,Randy,293,78,371,3,44,Player A
1559,Randy,291,56,347,0,51,Player A
1560,Randy,258,83,341,3,54,Player A
1561,Randy,317,57,374,3,43,Player A
1562,Randy,265,70,335,0,55,Player A
1563,Randy,323,48,371,0,43,Player A
1564,Randy,294,54,348,1,51,Player A
1565,Randy,296,61,357,1,48,Player A
1566,Randy,275,60,335,0,55,Player A
1567,Randy,299,54,353,0,49,Player A
1568,Randy,285,80,365,6,47,Player A
1569,Randy,291,81,372,7,45,Player A
1570,Randy,281,76,357,4,49,Player A
1571,Randy,315,50,365,0,45,Player A
1572,Randy,288,63,351,1,50,Player A
1573,Randy,249,79,328,2,58,Player A
1574,Randy,316,66,382,5,41,Player A
1575,Randy,310,55,365,0,45,Player A
1576,Randy,283,58,341,0,53,Player A
1577,Randy,319,49,368,0,44,Player A
1578,Randy,282,92,374,9,45,Player A
1579,Randy,291,56,347,0,51,Player A
1580,Randy,289,69,358,2,48,Player A
1581,Randy,319,49,368,0,44,Player A
1582,Randy,258,153,411,19,36,Player A
1583,Randy,262,67,329,0,57,Player A
1584,Randy,275,85,360,7,49,Player A
1585,Randy,290,60,350,0,50,Player A
1586,Randy,327,47,374,0,42,Player A
1587,Randy,294,59,353,0,49,Player A
1588,Randy,315,50,365,0,45,Player A
1589,Randy,328,63,391,5,38,Player A
1590,Randy,272,87,359,6,49,Player A
1591,Randy,287,57,344,0,52,Player A
1592,Randy,301,56,357,1,48,Player A
1593,Randy,291,86,377,9,44,Player A
1594,Randy,328,53,381,1,40,Player A
1595,Randy,297,62,359,3,48,Player A
1596,Randy,326,51,377,0,41,Player A
1597,Randy,315,50,365,0,45,Player A
1598,Randy,287,57,344,0,52,Player A
1599,Randy,303,53,356,0,48,Player A
1600,Randy,301,56,357,1,48,Player A
1601,Randy,290,60,350,0,50,Player A
1602,Randy,319,49,368,0,44,Player A
1603,Randy,295,70,365,3,46,Player A
1604,Randy,336,51,387,4,39,Player A
1605,Randy,289,69,358,2,48,Player A
1606,Randy,307,52,359,0,47,Player A
1607,Randy,286,66,352,2,50,Player A
1608,Randy,258,113,371,15,48,Player A
1609,Randy,297,112,409,11,34,Player A
1610,Randy,322,52,374,3,43,Player A
1611,Randy,312,62,374,3,43,Player A
1612,Randy,301,61,362,0,46,Player A
1613,Randy,271,61,332,0,56,Player A
1614,Randy,295,55,350,0,50,Player A
1615,Randy,290,55,345,1,52,Player A
1616,Randy,343,43,386,0,38,Player A
1617,Randy,304,69,373,5,44,Player A
1618,Randy,268,68,336,1,55,Player A
1619,Randy,316,76,392,6,38,Player A
1620,Randy,299,54,353,0,49,Player A
1621,Randy,291,56,347,0,51,Player A
1622,Randy,315,50,365,0,45,Player A
1623,Randy,302,62,364,2,46,Player A
1624,Randy,264,109,373,11,46,Player A
1625,Randy,307,52,359,0,47,Player A
1626,Randy,288,73,361,2,47,Player A
1627,Randy,283,58,341,0,53,Player A
1628,Randy,295,55,350,0,50,Player A
1629,Randy,271,61,332,0,56,Player A
1630,Randy,295,55,350,0,50,Player A
1631,Randy,319,49,368,0,44,Player A
1632,Randy,287,67,354,1,49,Player A
1633,Randy,315,50,365,0,45,Player A
1634,Randy,315,50,365,0,45,Player A
1635,Randy,283,83,366,7,47,Player A
1636,Randy,343,43,386,0,38,Player A
1637,Randy,333,48,381,1,40,Player A
1638,Randy,314,59,373,2,43,Player A
1639,Randy,299,54,353,0,49,Player A
1640,Randy,322,67,389,6,39,Player A
1641,Randy,292,62,354,1,49,Player A
1642,Randy,294,59,353,0,49,Player A
1643,Randy,295,55,350,0,50,Player A
1644,Randy,282,67,349,2,51,Player A
1645,Randy,310,65,375,4,43,Player A
1646,Randy,270,65,335,0,55,Player A
1647,Randy,343,43,386,0,38,Player A
1648,Randy,289,74,363,4,47,Player A
1649,Randy,279,59,338,0,54,Player A
1650,Randy,284,79,363,4,47,Player A
1651,Randy,291,56,347,0,51,Player A
1652,Randy,319,54,373,2,43,Player A
1653,Randy,294,64,358,2,48,Player A
1654,Randy,329,54,383,3,40,Player A
1655,Randy,282,62,344,0,52,Player A
1656,Randy,319,49,368,0,44,Player A
1657,Randy,294,64,358,2,48,Player A
1658,Randy,339,49,388,2,38,Player A
1659,Randy,290,95,385,8,41,Player A
1660,Randy,311,86,397,5,36,Player A
1661,Randy,301,76,377,3,42,Player A
1662,Randy,295,55,350,0,50,Player A
1663,Randy,283,58,341,0,53,Player A
1664,Randy,291,56,347,0,51,Player A
1665,Randy,292,57,349,2,51,Player A
1666,Randy,321,56,377,0,41,Player A
1667,Randy,308,48,356,0,48,Player A
1668,Randy,259,79,338,3,55,Player A
1669,Randy,308,63,371,3,44,Player A
1670,Randy,276,66,342,1,53,Player A
1671,Randy,274,64,338,0,54,Player A
1672,Randy,314,64,378,4,42,Player A
1673,Randy,286,66,352,2,50,Player A
1674,Randy,291,56,347,0,51,Player A
1675,Randy,288,78,366,7,47,Player A
1676,Randy,276,66,342,1,53,Player A
1677,Randy,312,62,374,3,43,Player A
1678,Randy,316,61,377,3,42,Player A
1679,Randy,310,70,380,3,41,Player A
1680,Randy,291,56,347,0,51,Player A
1681,Randy,257,132,389,15,42,Player A
1682,Randy,292,82,374,3,43,Player A
1683,Randy,282,67,349,2,51,Player A
1684,Randy,331,46,377,0,41,Player A
1685,Randy,280,70,350,3,51,Player A
1686,Randy,292,62,354,1,49,Player A
1687,Randy,283,68,351,1,50,Player A
1688,Randy,316,66,382,5,41,Player A
1689,Randy,275,75,350,3,51,Player A
1690,Randy,302,62,364,2,46,Player A
1691,Randy,299,54,353,0,49,Player A
1692,Randy,286,66,352,2,50,Player A
1693,Randy,293,58,351,1,50,Player A
1694,Randy,274,64,338,0,54,Player A
1695,Randy,279,59,338,0,54,Player A
1696,Randy,315,50,365,0,45,Player A
1697,Randy,276,101,377,12,45,Player A
1698,Randy,270,85,355,5,50,Player A
1699,Randy,293,63,356,3,49,Player A
1700,Randy,278,68,346,2,52,Player A
1701,Randy,226,141,367,11,48,Player A
1702,Randy,323,48,371,0,43,Player A
1703,Randy,287,67,354,1,49,Player A
1704,Randy,315,50,365,0,45,Player A
1705,Randy,273,63,336,1,55,Player A
1706,Randy,296,71,367,5,46,Player A
1707,Randy,295,75,370,5,45,Player A
1708,Randy,286,61,347,0,51,Player A
1709,Randy,331,46,377,0,41,Player A
1710,Randy,307,57,364,2,46,Player A
1711,Randy,298,58,356,0,48,Player A
1712,Randy,273,63,336,1,55,Player A
1713,Randy,286,61,347,0,51,Player A
1714,Randy,334,49,383,3,40,Player A
1715,Randy,316,66,382,2,40,Player A
1716,Randy,287,57,344,0,52,Player A
1717,Randy,290,55,345,1,52,Player A
1718,Randy,296,61,357,1,48,Player A
1719,Randy,307,52,359,0,47,Player A
1720,Randy,315,50,365,0,45,Player A
1721,Randy,323,48,371,0,43,Player A
1722,Randy,299,54,353,0,49,Player A
1723,Randy,279,59,338,0,54,Player A
1724,Randy,266,66,332,0,56,Player A
1725,Randy,308,63,371,3,44,Player A
1726,Randy,284,64,348,1,51,Player A
1727,Randy,268,93,361,5,48,Player A
1728,Randy,302,62,364,2,46,Player A
1729,Randy,303,53,356,0,48,Player A
1730,Randy,295,55,350,0,50,Player A
1731,Randy,295,55,350,0,50,Player A
1732,Randy,289,74,363,4,47,Player A
1733,Randy,263,78,341,3,54,Player A
1734,Randy,287,77,364,5,47,Player A
1735,Randy,280,70,350,3,51,Player A
1736,Randy,302,62,364,2,46,Player A
1737,Randy,254,134,388,14,42,Player A
1738,Randy,287,57,344,0,52,Player A
1739,Randy,275,60,335,0,55,Player A
1740,Randy,283,68,351,1,50,Player A
1741,Randy,299,54,353,0,49,Player A
1742,Randy,290,65,355,2,49,Player A
1743,Randy,275,95,370,8,46,Player A
1744,Randy,229,184,413,18,35,Player A
1745,Randy,242,177,419,18,33,Player A
1746,Randy,299,54,353,0,49,Player A
1747,Randy,280,95,375,7,44,Player A
1748,Randy,304,59,363,1,46,Player A
1749,Randy,274,74,348,4,52,Player A
1750,Randy,280,75,355,2,49,Player A
1751,Randy,292,62,354,1,49,Player A
1752,Randy,267,77,344,3,53,Player A
1753,Randy,286,96,382,8,42,Player A
1754,Randy,311,51,362,0,46,Player A
1755,Randy,266,131,397,17,40,Player A
1756,Randy,274,64,338,0,54,Player A
1757,Randy,274,64,338,0,54,Player A
1758,Randy,292,67,359,3,48,Player A
1759,Randy,300,60,360,1,47,Player A
1760,Randy,275,60,335,0,55,Player A
1761,Randy,255,105,360,7,49,Player A
1762,Randy,279,59,338,0,54,Player A
1763,Randy,349,44,393,1,36,Player A
1764,Randy,265,75,340,2,54,Player A
1765,Randy,266,66,332,0,56,Player A
1766,Randy,319,49,368,0,44,Player A
1767,Randy,294,54,348,1,51,Player A
1768,Randy,326,51,377,0,41,Player A
1769,Randy,336,41,377,0,41,Player A
1770,Randy,311,51,362,0,46,Player A
1771,Randy,279,59,338,0,54,Player A
1772,Randy,278,68,346,2,52,Player A
1773,Randy,308,58,366,1,45,Player A
1774,Randy,279,59,338,0,54,Player A
1775,Randy,291,56,347,0,51,Player A
1776,Randy,283,58,341,0,53,Player A
1777,Randy,299,54,353,0,49,Player A
1778,Randy,308,63,371,3,44,Player A
1779,Randy,316,56,372,1,43,Player A
1780,Randy,272,122,394,14,40,Player A
1781,Randy,288,68,356,3,49,Player A
1782,Randy,291,56,347,0,51,Player A
1783,Randy,271,61,332,0,56,Player A
1784,Randy,266,66,332,0,56,Player A
1785,Randy,311,51,362,0,46,Player A
1786,Randy,272,117,389,15,42,Player A
1787,Randy,266,86,352,5,51,Player A
1788,Randy,298,68,366,4,46,Player A
1789,Randy,244,89,333,4,57,Player A
1790,Randy,282,67,349,2,51,Player A
1791,Randy,279,59,338,0,54,Player A
1792,Randy,318,58,376,2,42,Player A
1793,Randy,283,78,361,5,48,Player A
1794,Randy,290,60,350,0,50,Player A
1795,Randy,297,57,354,1,49,Player A
1796,Randy,281,71,352,2,50,Player A
1797,Randy,268,68,336,1,55,Player A
1798,Randy,282,67,349,2,51,Player A
1799,Randy,280,70,350,3,51,Player A
1800,Randy,307,52,359,0,47,Player A
1801,Randy,320,60,380,3,41,Player A
1802,Randy,323,48,371,0,43,Player A
1803,Randy,281,81,362,9,49,Player A
1804,Randy,356,46,402,1,33,Player A
1805,Randy,279,59,338,0,54,Player A
1806,Randy,282,62,344,0,52,Player A
1807,Randy,282,107,389,9,40,Player A
1808,Randy,286,71,357,4,49,Player A
1809,Randy,304,59,363,1,46,Player A
1810,Randy,311,51,362,0,46,Player A
1811,Randy,255,75,330,1,57,Player A
1812,Randy,303,53,356,0,48,Player A
1813,Randy,262,67,329,0,57,Player A
1814,Randy,335,45,380,0,40,Player A
1815,Randy,307,52,359,0,47,Player A
1816,Randy,323,48,371,0,43,Player A
1817,Randy,307,57,364,2,46,Player A
1818,Randy,265,75,340,2,54,Player A
1819,Randy,286,61,347,0,51,Player A
1820,Randy,304,49,353,0,49,Player A
1821,Randy,349,44,393,1,36,Player A
1822,Randy,283,88,371,9,46,Player A
1823,Randy,283,58,341,0,53,Player A
1824,Randy,250,90,340,5,55,Player A
1825,Randy,323,48,371,0,43,Player A
1826,Randy,296,61,357,1,48,Player A
1827,Randy,280,85,365,6,47,Player A
1828,Randy,299,74,373,5,44,Player A
1829,Randy,323,48,371,0,43,Player A
1830,Randy,283,58,341,0,53,Player A
1831,Randy,311,51,362,0,46,Player A
1832,Randy,311,51,362,0,46,Player A
1833,Randy,295,55,350,0,50,Player A
1834,Randy,323,48,371,0,43,Player A
1835,Randy,270,85,355,5,50,Player A
1836,Randy,316,71,387,7,40,Player A
1837,Randy,302,67,369,4,45,Player A
1838,Randy,322,52,374,0,42,Player A
1839,Randy,279,59,338,0,54,Player A
1840,Randy,284,64,348,1,51,Player A
1841,Randy,296,61,357,1,48,Player A
1842,Randy,282,72,354,4,50,Player A
1843,Randy,322,52,374,0,42,Player A
1844,Randy,310,65,375,4,43,Player A
1845,Randy,303,53,356,0,48,Player A
1846,Randy,315,50,365,0,45,Player A
1847,Randy,254,99,353,9,52,Player A
1848,Randy,307,72,379,8,43,Player A
1849,Randy,290,75,365,3,46,Player A
1850,Randy,311,51,362,0,46,Player A
1851,Randy,246,86,332,3,57,Player A
1852,Randy,291,56,347,0,51,Player A
1853,Randy,317,52,369,1,44,Player A
1854,Randy,286,66,352,2,50,Player A
1855,Randy,303,53,356,0,48,Player A
1856,Randy,278,63,341,0,53,Player A
1857,Randy,289,69,358,2,48,Player A
1858,Randy,311,51,362,0,46,Player A
1859,Randy,301,56,357,1,48,Player A
1860,Randy,303,68,371,3,44,Player A
1861,Randy,242,117,359,12,51,Player A
1862,Randy,311,51,362,0,46,Player A
1863,Randy,298,88,386,12,42,Player A
1864,Randy,285,80,365,3,46,Player A
1865,Randy,267,62,329,0,57,Player A
1866,Randy,295,55,350,0,50,Player A
1867,Randy,326,46,372,1,43,Player A
1868,Randy,277,67,344,0,52,Player A
1869,Randy,304,54,358,2,48,Player A
1870,Randy,301,61,362,0,46,Player A
1871,Randy,312,47,359,0,47,Player A
1872,Randy,271,61,332,0,56,Player A
1873,Randy,294,79,373,5,44,Player A
1874,Randy,296,66,362,3,47,Player A
1875,Randy,270,65,335,0,55,Player A
1876,Randy,299,54,353,0,49,Player A
1877,Randy,256,81,337,2,55,Player A
1878,Randy,267,77,344,3,53,Player A
1879,Randy,308,63,371,3,44,Player A
1880,Randy,303,53,356,0,48,Player A
1881,Randy,331,46,377,0,41,Player A
1882,Randy,265,85,350,3,51,Player A
1883,Randy,268,78,346,2,52,Player A
1884,Randy,304,79,383,6,41,Player A
1885,Randy,272,87,359,6,49,Player A
1886,Randy,323,48,371,0,43,Player A
1887,Randy,279,59,338,0,54,Player A
1888,Randy,294,64,358,2,48,Player A
1889,Randy,316,56,372,1,43,Player A
1890,Randy,314,59,373,2,43,Player A
1891,Randy,279,59,338,0,54,Player A
1892,Randy,291,56,347,0,51,Player A
1893,Randy,303,53,356,0,48,Player A
1894,Randy,296,61,357,1,48,Player A
1895,Randy,279,59,338,0,54,Player A
1896,Randy,307,52,359,0,47,Player A
1897,Randy,283,98,381,10,43,Player A
1898,Randy,319,54,373,2,43,Player A
1899,Randy,307,122,429,19,30,Player A
1900,Randy,271,61,332,0,56,Player A
1901,Randy,290,75,365,6,47,Player A
1902,Randy,290,75,365,3,46,Player A
1903,Randy,314,64,378,4,42,Player A
1904,Randy,335,45,380,0,40,Player A
1905,Randy,277,62,339,1,54,Player A
1906,Randy,280,65,345,1,52,Player A
1907,Randy,315,50,365,0,45,Player A
1908,Randy,325,50,375,1,42,Player A
1909,Randy,285,70,355,2,49,Player A
1910,Randy,287,92,379,8,43,Player A
1911,Randy,325,50,375,1,42,Player A
1912,Randy,220,90,310,2,64,Player A
1913,Randy,311,51,362,0,46,Player A
1914,Randy,295,55,350,0,50,Player A
1915,Randy,293,63,356,3,49,Player A
1916,Randy,312,57,369,1,44,Player A
1917,Randy,276,81,357,4,49,Player A
1918,Randy,324,64,388,2,38,Player A
1919,Randy,271,61,332,0,56,Player A
1920,Randy,303,53,356,0,48,Player A
1921,Randy,330,45,375,1,42,Player A
1922,Randy,277,77,354,4,50,Player A
1923,Randy,269,64,333,1,56,Player A
1924,Randy,303,58,361,2,47,Player A
1925,Randy,316,71,387,7,40,Player A
1926,Randy,278,98,376,8,44,Player A
1927,Randy,266,66,332,0,56,Player A
1928,Randy,238,108,346,8,54,Player A
1929,Randy,279,59,338,0,54,Player A
1930,Randy,290,60,350,0,50,Player A
1931,Randy,283,58,341,0,53,Player A
1932,Randy,311,51,362,0,46,Player A
1933,Randy,315,50,365,0,45,Player A
1934,Randy,287,57,344,0,52,Player A
1935,Randy,303,53,356,0,48,Player A
1936,Randy,287,57,344,0,52,Player A
1937,Randy,248,118,366,10,48,Player A
1938,Randy,294,59,353,0,49,Player A
1939,Randy,279,59,338,0,54,Player A
1940,Randy,273,83,356,6,50,Player A
1941,Randy,298,63,361,2,47,Player A
1942,Randy,287,57,344,0,52,Player A
1943,Randy,297,72,369,4,45,Player A
1944,Randy,315,50,365,0,45,Player A
1945,Randy,309,54,363,1,46,Player A
1946,Randy,283,88,371,6,45,Player A
1947,Randy,311,51,362,0,46,Player A
1948,Randy,310,60,370,2,44,Player A
1949,Randy,296,66,362,3,47,Player A
1950,Randy,292,62,354,1,49,Player A
1951,Randy,303,53,356,0,48,Player A
1952,Randy,299,54,353,0,49,Player A
1953,Randy,271,61,332,0,56,Player A
1954,Randy,327,47,374,0,42,Player A
1955,Randy,279,59,338,0,54,Player A
1956,Randy,291,56,347,0,51,Player A
1957,Randy,291,56,347,0,51,Player A
1958,Randy,295,65,360,1,47,Player A
1959,Randy,323,48,371,0,43,Player A
1960,Randy,305,55,360,1,47,Player A
1961,Randy,318,53,371,0,43,Player A
1962,Randy,287,57,344,0,52,Player A
1963,Randy,303,53,356,0,48,Player A
1964,Randy,317,62,379,2,41,Player A
1965,Randy,304,69,373,2,43,Player A
1966,Randy,271,61,332,0,56,Player A
1967,Randy,335,45,380,0,40,Player A
1968,Randy,287,57,344,0,52,Player A
1969,Randy,288,63,351,1,50,Player A
1970,Randy,309,54,363,1,46,Player A
1971,Randy,272,67,339,1,54,Player A
1972,Randy,252,72,324,1,59,Player A
1973,Randy,257,112,369,13,48,Player A
1974,Randy,331,46,377,0,41,Player A
1975,Randy,279,74,353,3,50,Player A
1976,Randy,303,53,356,0,48,Player A
1977,Randy,288,63,351,1,50,Player A
1978,Randy,277,72,349,2,51,Player A
1979,Randy,288,63,351,1,50,Player A
1980,Randy,291,56,347,0,51,Player A
1981,Randy,312,57,369,1,44,Player A
1982,Randy,323,48,371,0,43,Player A
1983,Randy,301,76,377,6,43,Player A
1984,Randy,297,77,374,3,43,Player A
1985,Randy,279,59,338,0,54,Player A
1986,Randy,291,56,347,0,51,Player A
1987,Randy,299,54,353,0,49,Player A
1988,Randy,307,52,359,0,47,Player A
1989,Randy,303,53,356,0,48,Player A
1990,Randy,282,77,359,3,48,Player A
1991,Randy,291,56,347,0,51,Player A
1992,Randy,273,113,386,15,43,Player A
1993,Randy,296,61,357,1,48,Player A
1994,Randy,269,74,343,2,53,Player A
1995,Randy,335,45,380,0,40,Player A
1996,Randy,266,66,332,0,56,Player A
1997,Randy,299,54,353,0,49,Player A
1998,Randy,308,58,366,1,45,Player A
1999,Randy,244,74,318,1,61,Player A
2000,Randy,266,86,352,5,51,Player A
2001,Randy,287,82,369,4,45,Player A
2002,Randy,299,54,353,0,49,Player A
2003,Randy,303,53,356,0,48,Player A
2004,Randy,287,57,344,0,52,Player A
2005,Randy,313,53,366,1,45,Player A
2006,Randy,297,72,369,4,45,Player A
2007,Randy,294,69,363,4,47,Player A
2008,Randy,319,49,368,0,44,Player A
2009,Randy,283,58,341,0,53,Player A
2010,Randy,307,52,359,0,47,Player A
2011,Randy,295,55,350,0,50,Player A
2012,Randy,319,49,368,0,44,Player A
2013,Randy,283,63,346,2,52,Player A
2014,Randy,332,57,389,3,38,Player A
2015,Randy,286,61,347,0,51,Player A
2016,Randy,289,59,348,1,51,Player A
2017,Randy,290,60,350,0,50,Player A
2018,Randy,287,57,344,0,52,Player A
2019,Randy,291,56,347,0,51,Player A
2020,Randy,314,49,363,1,46,Player A
2021,Randy,323,58,381,1,40,Player A
2022,Randy,267,67,334,2,56,Player A
2023,Randy,291,66,357,1,48,Player A
2024,Randy,308,48,356,0,48,Player A
2025,Randy,315,50,365,0,45,Player A
2026,Randy,259,79,338,3,55,Player A
2027,Randy,319,49,368,0,44,Player A
2028,Randy,351,41,392,0,36,Player A
2029,Randy,339,44,383,0,39,Player A
2030,Randy,283,58,341,0,53,Player A
2031,Randy,262,82,344,3,53,Player A
2032,Randy,335,45,380,0,40,Player A
2033,Randy,269,74,343,2,53,Player A
2034,Randy,279,59,338,0,54,Player A
2035,Randy,303,78,381,7,42,Player A
2036,Randy,304,59,363,1,46,Player A
2037,Randy,303,53,356,0,48,Player A
2038,Randy,271,61,332,0,56,Player A
2039,Randy,270,85,355,5,50,Player A
2040,Randy,315,50,365,0,45,Player A
2041,Randy,256,71,327,1,58,Player A
2042,Randy,315,50,365,0,45,Player A
2043,Randy,323,48,371,0,43,Player A
2044,Randy,259,64,323,0,59,Player A
2045,Randy,300,60,360,1,47,Player A
2046,Randy,311,51,362,0,46,Player A
2047,Randy,312,67,379,5,42,Player A
2048,Randy,213,178,391,17,42,Player A
2049,Randy,304,64,368,3,45,Player A
2050,Randy,303,53,356,0,48,Player A
2051,Randy,285,80,365,6,47,Player A
2052,Randy,319,49,368,0,44,Player A
2053,Randy,269,74,343,2,53,Player A
2054,Randy,311,56,367,2,45,Player A
2055,Randy,301,71,372,4,44,Player A
2056,Randy,276,86,362,6,48,Player A
2057,Randy,265,75,340,2,54,Player A
2058,Randy,291,56,347,0,51,Player A
2059,Randy,264,69,333,1,56,Player A
2060,Randy,313,53,366,1,45,Player A
2061,Randy,298,58,356,0,48,Player A
2062,Randy,275,60,335,0,55,Player A
2063,Randy,299,54,353,0,49,Player A
2064,Randy,270,65,335,0,55,Player A
2065,Randy,304,84,388,8,40,Player A
2066,Randy,280,80,360,4,48,Player A
2067,Randy,315,50,365,0,45,Player A
2068,Randy,270,90,360,7,49,Player A
2069,Randy,260,135,395,15,40,Player A
2070,Randy,303,58,361,2,47,Player A
2071,Randy,284,89,373,8,45,Player A
2072,Randy,302,67,369,4,45,Player A
2073,Randy,278,83,361,5,48,Player A
2074,Randy,292,67,359,3,48,Player A
2075,Randy,312,47,359,0,47,Player A
2076,Randy,327,47,374,0,42,Player A
2077,Randy,307,52,359,0,47,Player A
2078,Randy,320,60,380,3,41,Player A
2079,Randy,299,54,353,0,49,Player A
2080,Randy,295,55,350,0,50,Player A
2081,Randy,278,68,346,2,52,Player A
2082,Randy,311,51,362,0,46,Player A
2083,Randy,299,54,353,0,49,Player A
2084,Randy,315,50,365,0,45,Player A
2085,Randy,294,64,358,2,48,Player A
2086,Randy,277,97,374,6,44,Player A
2087,Randy,339,44,383,0,39,Player A
2088,Randy,260,70,330,1,57,Player A
2089,Randy,315,50,365,0,45,Player A
2090,Randy,255,85,340,5,55,Player A
2091,Randy,319,49,368,0,44,Player A
2092,Randy,311,51,362,0,46,Player A
2093,Randy,258,68,326,0,58,Player A
2094,Randy,326,61,387,4,39,Player A
2095,Randy,261,101,362,6,48,Player A
2096,Randy,290,65,355,2,49,Player A
2097,Randy,308,73,381,4,41,Player A
2098,Randy,282,67,349,2,51,Player A
2099,Randy,264,74,338,3,55,Player A
2100,Randy,281,96,377,9,44,Player A
2101,Randy,303,53,356,0,48,Player A
2102,Randy,299,69,368,3,45,Player A
2103,Randy,287,107,394,11,39,Player A
2104,Randy,322,57,379,2,41,Player A
2105,Randy,287,57,344,0,52,Player A
2106,Randy,307,67,374,6,44,Player A
2107,Randy,293,63,356,0,48,Player A
2108,Randy,307,52,359,0,47,Player A
2109,Randy,289,59,348,1,51,Player A
2110,Randy,253,78,331,2,57,Player A
2111,Randy,315,50,365,0,45,Player A
2112,Randy,287,62,349,2,51,Player A
2113,Randy,256,96,352,8,52,Player A
2114,Randy,335,50,385,2,39,Player A
2115,Randy,266,71,337,2,55,Player A
2116,Randy,294,59,353,0,49,Player A
2117,Randy,268,68,336,1,55,Player A
2118,Randy,318,63,381,4,41,Player A
2119,Randy,348,48,396,1,35,Player A
2120,Randy,299,54,353,0,49,Player A
2121,Randy,270,65,335,0,55,Player A
2122,Randy,309,54,363,1,46,Player A
2123,Randy,306,61,367,2,45,Player A
2124,Randy,311,51,362,0,46,Player A
2125,Randy,258,68,326,0,58,Player A
2126,Randy,308,48,356,0,48,Player A
2127,Randy,299,54,353,0,49,Player A
2128,Randy,323,48,371,0,43,Player A
2129,Randy,305,95,400,11,37,Player A
2130,Randy,299,54,353,0,49,Player A
2131,Randy,302,67,369,4,45,Player A
2132,Randy,288,63,351,1,50,Player A
2133,Randy,248,73,321,1,60,Player A
2134,Randy,326,56,382,2,40,Player A
2135,Randy,285,80,365,6,47,Player A
2136,Randy,295,55,350,0,50,Player A
2137,Randy,322,107,429,16,29,Player A
2138,Randy,306,66,372,4,44,Player A
2139,Randy,290,75,365,3,46,Player A
2140,Randy,263,63,326,0,58,Player A
2141,Randy,292,62,354,1,49,Player A
2142,Randy,292,67,359,3,48,Player A
2143,Randy,234,129,363,10,49,Player A
2144,Randy,275,60,335,0,55,Player A
2145,Randy,262,67,329,0,57,Player A
2146,Randy,298,63,361,2,47,Player A
2147,Randy,290,75,365,3,46,Player A
2148,Randy,280,75,355,5,50,Player A
2149,Randy,309,79,388,5,39,Player A
2150,Randy,265,100,365,9,48,Player A
2151,Randy,299,54,353,0,49,Player A
2152,Randy,307,52,359,0,47,Player A
2153,Randy,254,89,343,5,54,Player A
2154,Randy,303,53,356,0,48,Player A
2155,Randy,283,58,341,0,53,Player A
2156,Randy,308,58,366,1,45,Player A
2157,Randy,331,46,377,0,41,Player A
2158,Randy,299,54,353,0,49,Player A
2159,Randy,304,104,408,13,35,Player A
2160,Randy,279,59,338,0,54,Player A
2161,Randy,275,60,335,0,55,Player A
2162,Randy,274,84,358,2,48,Player A
2163,Randy,311,56,367,2,45,Player A
2164,Randy,300,60,360,1,47,Player A
2165,Randy,297,57,354,1,49,Player A
2166,Randy,289,79,368,3,45,Player A
2167,Randy,296,81,377,6,43,Player A
2168,Randy,285,60,345,1,52,Player A
2169,Randy,342,47,389,0,37,Player A
2170,Randy,301,56,357,1,48,Player A
2171,Randy,296,61,357,1,48,Player A
2172,Randy,283,58,341,0,53,Player A
2173,Randy,283,58,341,0,53,Player A
2174,Randy,270,65,335,0,55,Player A
2175,Randy,299,54,353,0,49,Player A
2176,Randy,303,53,356,0,48,Player A
2177,Randy,288,53,341,0,53,Player A
2178,Randy,323,48,371,0,43,Player A
2179,Randy,291,56,347,0,51,Player A
2180,Randy,319,49,368,0,44,Player A
2181,Randy,311,51,362,0,46,Player A
2182,Randy,311,51,362,0,46,Player A
2183,Randy,300,65,365,3,46,Player A
2184,Randy,288,68,356,3,49,Player A
2185,Randy,306,61,367,2,45,Player A
2186,Randy,298,63,361,2,47,Player A
2187,Randy,291,56,347,0,51,Player A
2188,Randy,296,61,357,1,48,Player A
2189,Randy,287,57,344,0,52,Player A
2190,Randy,287,57,344,0,52,Player A
2191,Randy,275,70,345,1,52,Player A
2192,Randy,307,52,359,0,47,Player A
2193,Randy,311,51,362,0,46,Player A
2194,Randy,302,62,364,2,46,Player A
2195,Randy,319,49,368,0,44,Player A
2196,Randy,236,76,312,1,63,Player A
2197,Randy,291,56,347,0,51,Player A
2198,Randy,261,86,347,3,52,Player A
2199,Randy,315,50,365,0,45,Player A
2200,Randy,271,61,332,0,56,Player A
2201,Randy,290,60,350,0,50,Player A
2202,Randy,291,56,347,0,51,Player A
2203,Randy,283,58,341,0,53,Player A
2204,Randy,276,76,352,5,51,Player A
2205,Randy,264,84,348,4,52,Player A
2206,Randy,335,45,380,0,40,Player A
2207,Randy,306,66,372,4,44,Player A
2208,Randy,315,50,365,0,45,Player A
2209,Randy,327,47,374,0,42,Player A
2210,Randy,294,114,408,13,35,Player A
2211,Randy,265,80,345,4,53,Player A
2212,Randy,309,54,363,1,46,Player A
2213,Randy,323,58,381,1,40,Player A
2214,Randy,267,67,334,2,56,Player A
2215,Randy,278,63,341,0,53,Player A
2216,Randy,282,62,344,0,52,Player A
2217,Randy,307,52,359,0,47,Player A
2218,Randy,307,52,359,0,47,Player A
2219,Randy,266,66,332,0,56,Player A
2220,Randy,299,54,353,0,49,Player A
2221,Randy,295,60,355,2,49,Player A
2222,Randy,319,64,383,6,41,Player A
2223,Randy,309,74,383,6,41,Player A
2224,Randy,281,66,347,0,51,Player A
2225,Randy,275,60,335,0,55,Player A
2226,Randy,327,47,374,0,42,Player A
2227,Randy,350,40,390,1,37,Player A
2228,Randy,303,68,371,3,44,Player A
2229,Randy,307,52,359,0,47,Player A
2230,Randy,291,81,372,7,45,Player A
2231,Randy,258,68,326,0,58,Player A
2232,Randy,290,85,375,4,43,Player A
2233,Randy,292,62,354,1,49,Player A
2234,Randy,332,57,389,3,38,Player A
2235,Randy,311,51,362,0,46,Player A
2236,Randy,286,66,352,2,50,Player A
2237,Randy,314,64,378,4,42,Player A
2238,Randy,303,53,356,0,48,Player A
2239,Randy,275,60,335,0,55,Player A
2240,Randy,299,69,368,3,45,Player A
2241,Randy,287,57,344,0,52,Player A
2242,Randy,295,55,350,0,50,Player A
2243,Randy,305,55,360,1,47,Player A
2244,Randy,294,59,353,0,49,Player A
2245,Randy,303,53,356,0,48,Player A
2246,Randy,286,61,347,0,51,Player A
2247,Randy,312,57,369,1,44,Player A
2248,Randy,314,59,373,2,43,Player A
2249,Randy,290,65,355,2,49,Player A
2250,Randy,258,83,341,3,54,Player A
2251,Randy,310,65,375,4,43,Player A
2252,Randy,343,43,386,0,38,Player A
2253,Randy,290,70,360,4,48,Player A
2254,Randy,318,53,371,0,43,Player A
2255,Randy,301,56,357,1,48,Player A
2256,Randy,280,70,350,3,51,Player A
2257,Randy,304,59,363,1,46,Player A
2258,Randy,275,60,335,0,55,Player A
2259,Randy,325,60,385,2,39,Player A
2260,Randy,276,86,362,6,48,Player A
2261,Randy,244,154,398,15,39,Player A
2262,Randy,280,120,400,11,37,Player A
2263,Randy,307,62,369,1,44,Player A
2264,Randy,296,61,357,1,48,Player A
2265,Randy,301,56,357,1,48,Player A
2266,Randy,289,69,358,2,48,Player A
2267,Randy,319,74,393,4,37,Player A
2268,Randy,319,54,373,2,43,Player A
2269,Randy,288,63,351,1,50,Player A
2270,Randy,303,53,356,0,48,Player A
2271,Randy,313,53,366,1,45,Player A
2272,Randy,293,68,361,2,47,Player A
2273,Randy,311,56,367,2,45,Player A
2274,Randy,324,54,378,1,41,Player A
2275,Randy,325,50,375,1,42,Player A
2276,Randy,282,62,344,0,52,Player A
2277,Randy,243,78,321,1,60,Player A
2278,Randy,286,56,342,1,53,Player A
2279,Randy,266,131,397,17,40,Player A
2280,Randy,267,82,349,5,52,Player A
2281,Randy,284,64,348,1,51,Player A
2282,Randy,284,64,348,1,51,Player A
2283,Randy,312,57,369,1,44,Player A
2284,Randy,340,55,395,3,36,Player A
2285,Randy,305,65,370,2,44,Player A
2286,Randy,267,72,339,1,54,Player A
2287,Randy,311,51,362,0,46,Player A
2288,Randy,299,64,363,1,46,Player A
2289,Randy,271,136,407,15,36,Player A
2290,Randy,286,66,352,2,50,Player A
2291,Randy,303,53,356,0,48,Player A
2292,Randy,287,57,344,0,52,Player A
2293,Randy,267,62,329,0,57,Player A
2294,Randy,295,55,350,0,50,Player A
2295,Randy,304,64,368,3,45,Player A
2296,Randy,275,60,335,0,55,Player A
2297,Randy,292,62,354,1,49,Player A
2298,Randy,295,55,350,0,50,Player A
2299,Randy,327,47,374,0,42,Player A
2300,Randy,299,54,353,0,49,Player A
2301,Randy,302,62,364,2,46,Player A
2302,Randy,311,51,362,0,46,Player A
2303,Randy,319,49,368,0,44,Player A
2304,Randy,251,91,342,7,55,Player A
2305,Randy,274,84,358,5,49,Player A
2306,Randy,278,63,341,0,53,Player A
2307,Randy,311,51,362,0,46,Player A
2308,Randy,267,62,329,0,57,Player A
2309,Randy,313,53,366,1,45,Player A
2310,Randy,272,82,354,4,50,Player A
2311,Randy,268,83,351,4,51,Player A
2312,Randy,299,54,353,0,49,Player A
2313,Randy,307,57,364,2,46,Player A
2314,Randy,308,63,371,3,44,Player A
2315,Randy,299,84,383,9,42,Player A
2316,Randy,264,74,338,3,55,Player A
2317,Randy,285,60,345,1,52,Player A
2318,Randy,255,130,385,14,43,Player A
2319,Randy,262,102,364,8,48,Player A
2320,Randy,307,52,359,0,47,Player A
2321,Randy,293,58,351,1,50,Player A
2322,Randy,277,82,359,6,49,Player A
2323,Randy,335,55,390,4,38,Player A
2324,Randy,285,65,350,0,50,Player A
2325,Randy,299,54,353,0,49,Player A
2326,Randy,304,59,363,4,47,Player A
2327,Randy,303,73,376,5,43,Player A
2328,Randy,276,86,362,6,48,Player A
2329,Randy,314,49,363,1,46,Player A
2330,Randy,279,69,348,1,51,Player A
2331,Randy,270,90,360,7,49,Player A
2332,Randy,299,89,388,8,40,Player A
2333,Randy,316,56,372,1,43,Player A
2334,Randy,314,59,373,2,43,Player A
2335,Randy,318,63,381,4,41,Player A
2336,Randy,275,60,335,0,55,Player A
2337,Randy,316,56,372,1,43,Player A
2338,Randy,318,58,376,2,42,Player A
2339,Randy,311,51,362,0,46,Player A
2340,Randy,298,63,361,2,47,Player A
2341,Randy,291,56,347,0,51,Player A
2342,Randy,295,55,350,0,50,Player A
2343,Randy,295,55,350,0,50,Player A
2344,Randy,337,62,399,7,36,Player A
2345,Randy,274,94,368,6,46,Player A
2346,Randy,304,64,368,3,45,Player A
2347,Randy,251,66,317,0,61,Player A
2348,Randy,307,52,359,0,47,Player A
2349,Randy,279,59,338,0,54,Player A
2350,Randy,241,76,317,0,61,Player A
2351,Randy,268,68,336,1,55,Player A
2352,Randy,298,63,361,2,47,Player A
2353,Randy,291,56,347,0,51,Player A
2354,Randy,244,209,453,34,27,Player A
2355,Randy,275,70,345,1,52,Player A
2356,Randy,283,58,341,0,53,Player A
2357,Randy,272,92,364,8,48,Player A
2358,Randy,314,74,388,8,40,Player A
2359,Randy,323,48,371,0,43,Player A
2360,Randy,283,58,341,0,53,Player A
2361,Randy,321,56,377,3,42,Player A
2362,Randy,266,66,332,0,56,Player A
2363,Randy,274,64,338,0,54,Player A
2364,Randy,265,95,360,10,50,Player A
2365,Randy,300,75,375,7,44,Player A
2366,Randy,316,66,382,5,41,Player A
2367,Randy,259,64,323,0,59,Player A
2368,Randy,286,66,352,2,50,Player A
2369,Randy,270,80,350,3,51,Player A
2370,Randy,315,55,370,2,44,Player A
2371,Randy,346,46,392,0,36,Player A
2372,Randy,271,66,337,2,55,Player A
2373,Randy,262,102,364,8,48,Player A
2374,Randy,276,71,347,3,52,Player A
2375,Randy,297,57,354,1,49,Player A
2376,Randy,298,78,376,5,43,Player A
2377,Randy,321,56,377,3,42,Player A
2378,Randy,251,101,352,8,52,Player A
2379,Randy,290,60,350,0,50,Player A
2380,Randy,270,65,335,0,55,Player A
2381,Randy,304,49,353,0,49,Player A
2382,Randy,275,60,335,0,55,Player A
2383,Randy,297,77,374,6,44,Player A
2384,Randy,311,51,362,0,46,Player A
2385,Randy,287,57,344,0,52,Player A
2386,Randy,312,67,379,5,42,Player A
2387,Randy,284,69,353,3,50,Player A
2388,Randy,302,62,364,2,46,Player A
2389,Randy,289,74,363,4,47,Player A
2390,Randy,287,67,354,1,49,Player A
2391,Randy,276,141,417,13,32,Player A
2392,Randy,259,74,333,1,56,Player A
2393,Randy,323,48,371,0,43,Player A
2394,Randy,274,64,338,0,54,Player A
2395,Randy,263,63,326,0,58,Player A
2396,Randy,279,59,338,0,54,Player A
2397,Randy,279,159,438,22,28,Player A
2398,Randy,267,62,329,0,57,Player A
2399,Randy,318,58,376,2,42,Player A
2400,Randy,297,77,374,3,43,Player A
2401,Randy,276,66,342,1,53,Player A
2402,Randy,295,55,350,0,50,Player A
2403,Randy,265,95,360,7,49,Player A
2404,Randy,311,76,387,4,39,Player A
2405,Randy,303,73,376,8,44,Player A
2406,Randy,268,88,356,6,50,Player A
2407,Randy,272,72,344,3,53,Player A
2408,Randy,332,57,389,3,38,Player A
2409,Randy,307,52,359,0,47,Player A
2410,Randy,271,61,332,0,56,Player A
2411,Randy,303,53,356,0,48,Player A
2412,Randy,299,69,368,3,45,Player A
2413,Randy,274,69,343,2,53,Player A
2414,Randy,256,81,337,2,55,Player A
2415,Randy,255,150,405,22,39,Player A
2416,Randy,271,96,367,8,47,Player A
2417,Randy,275,60,335,0,55,Player A
2418,Randy,295,55,350,0,50,Player A
2419,Randy,306,66,372,4,44,Player A
2420,Randy,276,66,342,1,53,Player A
2421,Randy,285,75,360,4,48,Player A
2422,Randy,262,87,349,5,52,Player A
2423,Randy,295,55,350,0,50,Player A
2424,Randy,264,89,353,3,50,Player A
2425,Randy,288,63,351,1,50,Player A
2426,Randy,339,54,393,4,37,Player A
2427,Randy,287,67,354,1,49,Player A
2428,Randy,287,57,344,0,52,Player A
2429,Randy,290,65,355,2,49,Player A
2430,Randy,236,286,522,49,9,Randy
2431,Randy,314,49,363,1,46,Player A
2432,Randy,292,92,384,10,42,Player A
2433,Randy,324,54,378,1,41,Player A
2434,Randy,279,59,338,0,54,Player A
2435,Randy,287,57,344,0,52,Player A
2436,Randy,311,51,362,0,46,Player A
2437,Randy,279,74,353,3,50,Player A
2438,Randy,312,67,379,5,42,Player A
2439,Randy,279,74,353,3,50,Player A
2440,Randy,263,73,336,1,55,Player A
2441,Randy,258,68,326,0,58,Player A
2442,Randy,298,63,361,2,47,Player A
2443,Randy,272,67,339,1,54,Player A
2444,Randy,270,70,340,2,54,Player A
2445,Randy,291,56,347,0,51,Player A
2446,Randy,271,61,332,0,56,Player A
2447,Randy,271,61,332,0,56,Player A
2448,Randy,256,121,377,9,44,Player A
2449,Randy,304,79,383,6,41,Player A
2450,Randy,309,64,373,2,43,Player A
2451,Randy,296,71,367,5,46,Player A
2452,Randy,273,73,346,2,52,Player A
2453,Randy,319,49,368,0,44,Player A
2454,Randy,273,93,366,7,47,Player A
2455,Randy,325,50,375,1,42,Player A
2456,Randy,287,67,354,1,49,Player A
2457,Randy,252,82,334,5,57,Player A
2458,Randy,316,56,372,1,43,Player A
2459,Randy,323,48,371,0,43,Player A
2460,Randy,272,67,339,1,54,Player A
2461,Randy,311,51,362,0,46,Player A
2462,Randy,296,66,362,3,47,Player A
2463,Randy,339,44,383,0,39,Player A
2464,Randy,295,55,350,0,50,Player A
2465,Randy,299,54,353,0,49,Player A
2466,Randy,272,87,359,6,49,Player A
2467,Randy,325,50,375,1,42,Player A
2468,Randy,301,76,377,6,43,Player A
2469,Randy,283,63,346,2,52,Player A
2470,Randy,260,130,390,13,41,Player A
2471,Randy,309,59,368,0,44,Player A
2472,Randy,287,57,344,0,52,Player A
2473,Randy,307,52,359,0,47,Player A
2474,Randy,315,55,370,2,44,Player A
2475,Randy,267,72,339,1,54,Player A
2476,Randy,291,76,367,5,46,Player A
2477,Randy,274,159,433,17,28,Player A
2478,Randy,256,121,377,6,43,Player A
2479,Randy,291,56,347,0,51,Player A
2480,Randy,279,59,338,0,54,Player A
2481,Randy,249,69,318,1,61,Player A
2482,Randy,276,66,342,1,53,Player A
2483,Randy,278,93,371,6,45,Player A
2484,Randy,292,62,354,1,49,Player A
2485,Randy,315,50,365,0,45,Player A
2486,Randy,312,57,369,1,44,Player A
2487,Randy,308,73,381,7,42,Player A
2488,Randy,274,69,343,2,53,Player A
2489,Randy,296,66,362,3,47,Player A
2490,Randy,303,53,356,0,48,Player A
2491,Randy,303,53,356,0,48,Player A
2492,Randy,264,84,348,4,52,Player A
2493,Randy,311,51,362,0,46,Player A
2494,Randy,323,48,371,0,43,Player A
2495,Randy,298,73,371,6,45,Player A
2496,Randy,267,72,339,1,54,Player A
2497,Randy,299,54,353,0,49,Player A
2498,Randy,283,58,341,0,53,Player A
2499,Randy,315,50,365,0,45,Player A
2500,Randy,265,75,340,2,54,Player A
2501,Randy,276,66,342,1,53,Player A
2502,Randy,302,62,364,2,46,Player A
2503,Randy,276,76,352,2,50,Player A
2504,Randy,311,51,362,0,46,Player A
2505,Randy,295,55,350,0,50,Player A
2506,Randy,307,52,359,0,47,Player A
2507,Randy,295,55,350,0,50,Player A
2508,Randy,290,65,355,2,49,Player A
2509,Randy,347,42,389,0,37,Player A
2510,Randy,285,105,390,10,40,Player A
2511,Randy,293,58,351,1,50,Player A
2512,Randy,290,60,350,0,50,Player A
2513,Randy,276,106,382,8,42,Player A
2514,Randy,303,53,356,0,48,Player A
2515,Randy,325,55,380,3,41,Player A
2516,Randy,290,60,350,0,50,Player A
2517,Randy,307,52,359,0,47,Player A
2518,Randy,296,66,362,3,47,Player A
2519,Randy,323,48,371,0,43,Player A
2520,Randy,283,58,341,0,53,Player A
2521,Randy,262,122,384,16,44,Player A
2522,Randy,242,87,329,3,58,Player A
2523,Randy,272,77,349,5,52,Player A
2524,Randy,287,72,359,3,48,Player A
2525,Randy,295,85,380,6,42,Player A
2526,Randy,299,54,353,0,49,Player A
2527,Randy,325,50,375,1,42,Player A
2528,Randy,322,57,379,2,41,Player A
2529,Randy,315,50,365,0,45,Player A
2530,Randy,319,49,368,0,44,Player A
2531,Randy,267,67,334,2,56,Player A
2532,Randy,314,59,373,2,43,Player A
2533,Randy,318,48,366,1,45,Player A
2534,Randy,291,71,362,3,47,Player A
2535,Randy,257,87,344,6,54,Player A
2536,Randy,284,64,348,1,51,Player A
2537,Randy,327,47,374,0,42,Player A
2538,Randy,304,59,363,1,46,Player A
2539,Randy,315,50,365,0,45,Player A
2540,Randy,286,66,352,2,50,Player A
2541,Randy,323,48,371,0,43,Player A
2542,Randy,231,146,377,15,46,Player A
2543,Randy,290,65,355,2,49,Player A
2544,Randy,275,60,335,0,55,Player A
2545,Randy,251,81,332,3,57,Player A
2546,Randy,268,68,336,1,55,Player A
2547,Randy,343,43,386,0,38,Player A
2548,Randy,295,55,350,0,50,Player A
2549,Randy,291,96,387,10,41,Player A
2550,Randy,254,69,323,0,59,Player A
2551,Randy,298,63,361,2,47,Player A
2552,Randy,311,51,362,0,46,Player A
2553,Randy,327,47,374,0,42,Player A
2554,Randy,283,58,341,0,53,Player A
2555,Randy,300,65,365,3,46,Player A
2556,Randy,299,54,353,0,49,Player A
2557,Randy,284,64,348,1,51,Player A
2558,Randy,311,51,362,0,46,Player A
2559,Randy,296,81,377,6,43,Player A
2560,Randy,263,83,346,2,52,Player A
2561,Randy,296,71,367,5,46,Player A
2562,Randy,284,64,348,1,51,Player A
2563,Randy,306,71,377,3,42,Player A
2564,Randy,291,56,347,0,51,Player A
2565,Randy,307,52,359,0,47,Player A
2566,Randy,279,79,358,2,48,Player A
2567,Randy,303,53,356,0,48,Player A
2568,Randy,285,100,385,8,41,Player A
2569,Randy,281,71,352,2,50,Player A
2570,Randy,275,60,335,0,55,Player A
2571,Randy,282,67,349,2,51,Player A
2572,Randy,286,66,352,2,50,Player A
2573,Randy,270,80,350,3,51,Player A
2574,Randy,307,52,359,0,47,Player A
2575,Randy,323,53,376,2,42,Player A
2576,Randy,288,63,351,1,50,Player A
2577,Randy,293,63,356,0,48,Player A
2578,Randy,290,70,360,4,48,Player A
2579,Randy,303,53,356,0,48,Player A
2580,Randy,279,59,338,0,54,Player A
2581,Randy,335,45,380,0,40,Player A
2582,Randy,299,59,358,2,48,Player A
2583,Randy,285,80,365,6,47,Player A
2584,Randy,295,55,350,0,50,Player A
2585,Randy,308,48,356,0,48,Player A
2586,Randy,268,68,336,1,55,Player A
2587,Randy,275,60,335,0,55,Player A
2588,Randy,298,63,361,2,47,Player A
2589,Randy,256,76,332,3,57,Player A
2590,Randy,262,67,329,0,57,Player A
2591,Randy,289,59,348,1,51,Player A
2592,Randy,279,59,338,0,54,Player A
2593,Randy,284,64,348,1,51,Player A
2594,Randy,291,56,347,0,51,Player A
2595,Randy,324,54,378,1,41,Player A
2596,Randy,319,49,368,0,44,Player A
2597,Randy,292,62,354,1,49,Player A
2598,Randy,315,50,365,0,45,Player A
2599,Randy,279,59,338,0,54,Player A
2600,Randy,284,69,353,3,50,Player A
2601,Randy,311,51,362,0,46,Player A
2602,Randy,250,105,355,8,51,Player A
2603,Randy,273,73,346,2,52,Player A
2604,Randy,283,88,371,9,46,Player A
2605,Randy,294,59,353,0,49,Player A
2606,Randy,321,51,372,1,43,Player A
2607,Randy,290,80,370,8,46,Player A
2608,Randy,287,57,344,0,52,Player A
2609,Randy,267,62,329,0,57,Player A
2610,Randy,258,68,326,0,58,Player A
2611,Randy,247,97,344,6,54,Player A
2612,Randy,308,58,366,1,45,Player A
2613,Randy,303,53,356,0,48,Player A
2614,Randy,299,54,353,0,49,Player A
2615,Randy,318,63,381,4,41,Player A
2616,Randy,245,80,325,2,59,Player A
2617,Randy,311,51,362,0,46,Player A
2618,Randy,291,56,347,0,51,Player A
2619,Randy,256,91,347,6,53,Player A
2620,Randy,299,54,353,0,49,Player A
2621,Randy,307,62,369,1,44,Player A
2622,Randy,251,66,317,0,61,Player A
2623,Randy,307,52,359,0,47,Player A
2624,Randy,261,66,327,1,58,Player A
2625,Randy,313,63,376,2,42,Player A
2626,Randy,278,83,361,5,48,Player A
2627,Randy,327,47,374,0,42,Player A
2628,Randy,311,51,362,0,46,Player A
2629,Randy,343,43,386,0,38,Player A
2630,Randy,285,60,345,1,52,Player A
2631,Randy,261,76,337,2,55,Player A
2632,Randy,292,62,354,1,49,Player A
2633,Randy,252,82,334,5,57,Player A
2634,Randy,275,95,370,8,46,Player A
2635,Randy,318,48,366,1,45,Player A
2636,Randy,289,89,378,7,43,Player A
2637,Randy,299,54,353,0,49,Player A
2638,Randy,291,56,347,0,51,Player A
2639,Randy,270,65,335,0,55,Player A
2640,Randy,303,53,356,0,48,Player A
2641,Randy,303,53,356,0,48,Player A
2642,Randy,311,51,362,0,46,Player A
2643,Randy,244,164,408,19,37,Player A
2644,Randy,320,60,380,3,41,Player A
2645,Randy,295,55,350,0,50,Player A
2646,Randy,301,101,402,10,36,Player A
2647,Randy,302,62,364,2,46,Player A
2648,Randy,296,61,357,1,48,Player A
2649,Randy,295,55,350,0,50,Player A
2650,Randy,303,53,356,0,48,Player A
2651,Randy,277,77,354,4,50,Player A
2652,Randy,299,54,353,0,49,Player A
2653,Randy,293,78,371,6,45,Player A
2654,Randy,255,155,410,21,37,Player A
2655,Randy,307,77,384,4,40,Player A
2656,Randy,335,45,380,0,40,Player A
2657,Randy,259,109,368,12,48,Player A
2658,Randy,299,69,368,3,45,Player A
2659,Randy,323,48,371,0,43,Player A
2660,Randy,291,56,347,0,51,Player A
2661,Randy,272,67,339,1,54,Player A
2662,Randy,307,52,359,0,47,Player A
2663,Randy,252,72,324,1,59,Player A
2664,Randy,327,47,374,0,42,Player A
2665,Randy,296,71,367,5,46,Player A
2666,Randy,243,83,326,3,59,Player A
2667,Randy,327,47,374,0,42,Player A
2668,Randy,295,55,350,0,50,Player A
2669,Randy,300,60,360,1,47,Player A
2670,Randy,284,64,348,1,51,Player A
2671,Randy,279,59,338,0,54,Player A
2672,Randy,307,52,359,0,47,Player A
2673,Randy,323,48,371,0,43,Player A
2674,Randy,323,53,376,2,42,Player A
2675,Randy,306,56,362,0,46,Player A
2676,Randy,306,66,372,4,44,Player A
2677,Randy,304,84,388,11,41,Player A
2678,Randy,346,46,392,0,36,Player A
2679,Randy,279,59,338,0,54,Player A
2680,Randy,317,52,369,1,44,Player A
2681,Randy,306,81,387,10,41,Player A
2682,Randy,253,143,396,16,40,Player A
2683,Randy,264,69,333,1,56,Player A
2684,Randy,266,66,332,0,56,Player A
2685,Randy,303,53,356,0,48,Player A
2686,Randy,290,55,345,1,52,Player A
2687,Randy,302,67,369,4,45,Player A
2688,Randy,248,103,351,7,52,Player A
2689,Randy,294,64,358,2,48,Player A
2690,Randy,295,80,375,7,44,Player A
2691,Randy,312,57,369,1,44,Player A
2692,Randy,283,58,341,0,53,Player A
2693,Randy,331,46,377,0,41,Player A
2694,Randy,262,67,329,0,57,Player A
2695,Randy,283,73,356,3,49,Player A
2696,Randy,286,66,352,2,50,Player A
2697,Randy,284,64,348,1,51,Player A
2698,Randy,316,56,372,1,43,Player A
2699,Randy,295,100,395,9,38,Player A
2700,Randy,311,51,362,0,46,Player A
2701,Randy,294,74,368,6,46,Player A
2702,Randy,303,63,366,1,45,Player A
2703,Randy,303,53,356,0,48,Player A
2704,Randy,284,64,348,1,51,Player A
2705,Randy,312,62,374,3,43,Player A
2706,Randy,291,76,367,5,46,Player A
2707,Randy,275,60,335,0,55,Player A
2708,Randy,290,65,355,2,49,Player A
2709,Randy,299,54,353,0,49,Player A
2710,Randy,291,56,347,0,51,Player A
2711,Randy,280,95,375,10,45,Player A
2712,Randy,314,59,373,2,43,Player A
2713,Randy,327,47,374,0,42,Player A
2714,Randy,255,65,320,0,60,Player A
2715,Randy,291,71,362,3,47,Player A
2716,Randy,317,52,369,1,44,Player A
2717,Randy,282,62,344,0,52,Player A
2718,Randy,323,48,371,0,43,Player A
2719,Randy,287,57,344,0,52,Player A
2720,Randy,307,52,359,0,47,Player A
2721,Randy,254,94,348,4,52,Player A
2722,Randy,303,53,356,0,48,Player A
2723,Randy,280,65,345,1,52,Player A
2724,Randy,327,47,374,0,42,Player A
2725,Randy,311,51,362,0,46,Player A
2726,Randy,286,66,352,2,50,Player A
2727,Randy,299,54,353,0,49,Player A
2728,Randy,270,85,355,5,50,Player A
2729,Randy,266,81,347,3,52,Player A
2730,Randy,287,57,344,0,52,Player A
2731,Randy,237,82,319,2,61,Player A
2732,Randy,324,54,378,1,41,Player A
2733,Randy,275,60,335,0,55,Player A
2734,Randy,270,70,340,2,54,Player A
2735,Randy,268,98,366,10,48,Player A
2736,Randy,263,138,401,15,38,Player A
2737,Randy,332,52,384,1,39,Player A
2738,Randy,330,55,385,2,39,Player A
2739,Randy,355,40,395,0,35,Player A
2740,Randy,316,56,372,1,43,Player A
2741,Randy,331,46,377,0,41,Player A
2742,Randy,271,76,347,3,52,Player A
2743,Randy,310,60,370,2,44,Player A
2744,Randy,299,54,353,0,49,Player A
2745,Randy,306,61,367,2,45,Player A
2746,Randy,246,131,377,12,45,Player A
2747,Randy,287,57,344,0,52,Player A
2748,Randy,323,48,371,0,43,Player A
2749,Randy,295,55,350,0,50,Player A
2750,Randy,278,93,371,6,45,Player A
2751,Randy,281,71,352,2,50,Player A
2752,Randy,291,56,347,0,51,Player A
2753,Randy,267,77,344,3,53,Player A
2754,Randy,306,91,397,8,37,Player A
2755,Randy,315,50,365,0,45,Player A
2756,Randy,303,53,356,0,48,Player A
2757,Randy,286,71,357,4,49,Player A
2758,Randy,306,66,372,4,44,Player A
2759,Randy,322,72,394,8,38,Player A
2760,Randy,304,59,363,1,46,Player A
2761,Randy,298,68,366,4,46,Player A
2762,Randy,318,58,376,2,42,Player A
2763,Randy,307,52,359,0,47,Player A
2764,Randy,307,62,369,4,45,Player A
2765,Randy,318,53,371,0,43,Player A
2766,Randy,331,46,377,0,41,Player A
2767,Randy,285,60,345,1,52,Player A
2768,Randy,294,79,373,8,45,Player A
2769,Randy,306,56,362,0,46,Player A
2770,Randy,259,64,323,0,59,Player A
2771,Randy,310,65,375,4,43,Player A
2772,Randy,283,68,351,1,50,Player A
2773,Randy,299,54,353,0,49,Player A
2774,Randy,299,69,368,3,45,Player A
2775,Randy,323,48,371,0,43,Player A
2776,Randy,283,58,341,0,53,Player A
2777,Randy,257,102,359,6,49,Player A
2778,Randy,309,54,363,1,46,Player A
2779,Randy,332,57,389,3,38,Player A
2780,Randy,285,60,345,1,52,Player A
2781,Randy,286,61,347,0,51,Player A
2782,Randy,281,66,347,3,52,Player A
2783,Randy,265,80,345,4,53,Player A
2784,Randy,260,75,335,3,56,Player A
2785,Randy,296,101,397,11,38,Player A
2786,Randy,295,55,350,0,50,Player A
2787,Randy,307,52,359,0,47,Player A
2788,Randy,298,53,351,1,50,Player A
2789,Randy,285,110,395,12,39,Player A
2790,Randy,228,158,386,18,44,Player A
2791,Randy,294,79,373,5,44,Player A
2792,Randy,307,52,359,0,47,Player A
2793,Randy,327,47,374,0,42,Player A
2794,Randy,272,92,364,8,48,Player A
2795,Randy,319,49,368,0,44,Player A
2796,Randy,299,54,353,0,49,Player A
2797,Randy,299,54,353,0,49,Player A
2798,Randy,303,53,356,0,48,Player A
2799,Randy,306,61,367,2,45,Player A
2800,Randy,280,65,345,1,52,Player A
2801,Randy,315,50,365,0,45,Player A
2802,Randy,261,76,337,2,55,Player A
2803,Randy,284,69,353,3,50,Player A
2804,Randy,302,72,374,6,44,Player A
2805,Randy,283,58,341,0,53,Player A
2806,Randy,300,60,360,1,47,Player A
2807,Randy,278,63,341,0,53,Player A
2808,Randy,298,63,361,2,47,Player A
2809,Randy,279,59,338,0,54,Player A
2810,Randy,339,44,383,0,39,Player A
2811,Randy,265,75,340,2,54,Player A
2812,Randy,289,74,363,4,47,Player A
2813,Randy,320,60,380,3,41,Player A
2814,Randy,324,59,383,3,40,Player A
2815,Randy,250,70,320,0,60,Player A
2816,Randy,287,57,344,0,52,Player A
2817,Randy,281,121,402,13,37,Player A
2818,Randy,226,151,377,18,47,Player A
2819,Randy,319,49,368,0,44,Player A
2820,Randy,336,51,387,1,38,Player A
2821,Randy,259,129,388,20,44,Player A
2822,Randy,307,52,359,0,47,Player A
2823,Randy,281,66,347,3,52,Player A
2824,Randy,262,102,364,5,47,Player A
2825,Randy,307,52,359,0,47,Player A
2826,Randy,246,136,382,14,44,Player A
2827,Randy,298,68,366,4,46,Player A
2828,Randy,297,57,354,1,49,Player A
2829,Randy,292,62,354,1,49,Player A
2830,Randy,285,80,365,6,47,Player A
2831,Randy,302,57,359,0,47,Player A
2832,Randy,281,61,342,1,53,Player A
2833,Randy,284,79,363,4,47,Player A
2834,Randy,337,57,394,5,37,Player A
2835,Randy,263,83,346,2,52,Player A
2836,Randy,319,49,368,0,44,Player A
2837,Randy,318,48,366,1,45,Player A
2838,Randy,280,85,365,6,47,Player A
2839,Randy,282,62,344,0,52,Player A
2840,Randy,300,50,350,0,50,Player A
2841,Randy,312,57,369,1,44,Player A
2842,Randy,253,78,331,2,57,Player A
2843,Randy,304,59,363,1,46,Player A
2844,Randy,279,74,353,3,50,Player A
2845,Randy,264,69,333,1,56,Player A
2846,Randy,283,58,341,0,53,Player A
2847,Randy,252,117,369,10,47,Player A
2848,Randy,314,69,383,6,41,Player A
2849,Randy,299,54,353,0,49,Player A
2850,Randy,331,46,377,0,41,Player A
2851,Randy,267,62,329,0,57,Player A
2852,Randy,315,50,365,0,45,Player A
2853,Randy,351,41,392,0,36,Player A
2854,Randy,275,60,335,0,55,Player A
2855,Randy,288,118,406,14,36,Player A
2856,Randy,311,51,362,0,46,Player A
2857,Randy,307,52,359,0,47,Player A
2858,Randy,315,50,365,0,45,Player A
2859,Randy,292,62,354,1,49,Player A
2860,Randy,268,68,336,1,55,Player A
2861,Randy,256,121,377,12,45,Player A
2862,Randy,295,55,350,0,50,Player A
2863,Randy,303,53,356,0,48,Player A
2864,Randy,303,53,356,0,48,Player A
2865,Randy,299,54,353,0,49,Player A
2866,Randy,306,66,372,4,44,Player A
2867,Randy,282,72,354,4,50,Player A
2868,Randy,320,55,375,1,42,Player A
2869,Randy,302,62,364,2,46,Player A
2870,Randy,306,61,367,2,45,Player A
2871,Randy,275,60,335,0,55,Player A
2872,Randy,315,50,365,0,45,Player A
2873,Randy,291,56,347,0,51,Player A
2874,Randy,286,66,352,2,50,Player A
2875,Randy,275,60,335,0,55,Player A
2876,Randy,319,49,368,0,44,Player A
2877,Randy,274,69,343,2,53,Player A
2878,Randy,253,98,351,7,52,Player A
2879,Randy,323,48,371,0,43,Player A
2880,Randy,279,59,338,0,54,Player A
2881,Randy,246,71,317,0,61,Player A
2882,Randy,270,65,335,0,55,Player A
2883,Randy,285,60,345,1,52,Player A
2884,Randy,290,60,350,0,50,Player A
2885,Randy,317,52,369,1,44,Player A
2886,Randy,343,43,386,0,38,Player A
2887,Randy,295,55,350,0,50,Player A
2888,Randy,297,57,354,1,49,Player A
2889,Randy,288,63,351,1,50,Player A
2890,Randy,296,61,357,1,48,Player A
2891,Randy,288,53,341,0,53,Player A
2892,Randy,280,65,345,1,52,Player A
2893,Randy,254,69,323,0,59,Player A
2894,Randy,307,52,359,0,47,Player A
2895,Randy,279,59,338,0,54,Player A
2896,Randy,309,69,378,4,42,Player A
2897,Randy,207,232,439,29,30,Randy
2898,Randy,296,61,357,1,48,Player A
2899,Randy,319,49,368,0,44,Player A
2900,Randy,315,50,365,0,45,Player A
2901,Randy,291,56,347,0,51,Player A
2902,Randy,270,130,400,14,38,Player A
2903,Randy,291,56,347,0,51,Player A
2904,Randy,283,58,341,0,53,Player A
2905,Randy,242,72,314,0,62,Player A
2906,Randy,265,100,365,6,47,Player A
2907,Randy,311,51,362,0,46,Player A
2908,Randy,317,52,369,1,44,Player A
2909,Randy,312,62,374,3,43,Player A
2910,Randy,275,60,335,0,55,Player A
2911,Randy,287,57,344,0,52,Player A
2912,Randy,307,52,359,0,47,Player A
2913,Randy,315,50,365,0,45,Player A
2914,Randy,345,55,400,5,35,Player A
2915,Randy,312,57,369,1,44,Player A
2916,Randy,263,63,326,0,58,Player A
2917,Randy,292,62,354,1,49,Player A
2918,Randy,323,48,371,0,43,Player A
2919,Randy,287,57,344,0,52,Player A
2920,Randy,310,60,370,2,44,Player A
2921,Randy,321,51,372,1,43,Player A
2922,Randy,311,51,362,0,46,Player A
2923,Randy,296,61,357,1,48,Player A
2924,Randy,282,67,349,2,51,Player A
2925,Randy,299,54,353,0,49,Player A
2926,Randy,301,56,357,1,48,Player A
2927,Randy,287,82,369,7,46,Player A
2928,Randy,319,49,368,0,44,Player A
2929,Randy,283,58,341,0,53,Player A
2930,Randy,307,52,359,0,47,Player A
2931,Randy,288,63,351,1,50,Player A
2932,Randy,313,58,371,3,44,Player A
2933,Randy,324,54,378,1,41,Player A
2934,Randy,296,61,357,1,48,Player A
2935,Randy,320,55,375,1,42,Player A
2936,Randy,299,54,353,0,49,Player A
2937,Randy,299,54,353,0,49,Player A
2938,Randy,295,55,350,0,50,Player A
2939,Randy,335,45,380,0,40,Player A
2940,Randy,299,54,353,0,49,Player A
2941,Randy,283,58,341,0,53,Player A
2942,Randy,304,49,353,0,49,Player A
2943,Randy,300,60,360,1,47,Player A
2944,Randy,335,45,380,0,40,Player A
2945,Randy,298,68,366,4,46,Player A
2946,Randy,287,57,344,0,52,Player A
2947,Randy,275,60,335,0,55,Player A
2948,Randy,311,66,377,3,42,Player A
2949,Randy,307,62,369,1,44,Player A
2950,Randy,315,50,365,0,45,Player A
2951,Randy,302,62,364,2,46,Player A
2952,Randy,279,59,338,0,54,Player A
2953,Randy,284,64,348,1,51,Player A
2954,Randy,319,49,368,0,44,Player A
2955,Randy,295,80,375,7,44,Player A
2956,Randy,271,61,332,0,56,Player A
2957,Randy,295,55,350,0,50,Player A
2958,Randy,287,57,344,0,52,Player A
2959,Randy,271,166,437,21,28,Player A
2960,Randy,295,55,350,0,50,Player A
2961,Randy,291,56,347,0,51,Player A
2962,Randy,296,61,357,1,48,Player A
2963,Randy,296,66,362,3,47,Player A
2964,Randy,279,59,338,0,54,Player A
2965,Randy,258,68,326,0,58,Player A
2966,Randy,271,91,362,9,49,Player A
2967,Randy,300,65,365,3,46,Player A
2968,Randy,287,67,354,1,49,Player A
2969,Randy,288,63,351,1,50,Player A
2970,Randy,299,54,353,0,49,Player A
2971,Randy,307,52,359,0,47,Player A
2972,Randy,273,73,346,2,52,Player A
2973,Randy,325,50,375,1,42,Player A
2974,Randy,310,60,370,2,44,Player A
2975,Randy,274,69,343,2,53,Player A
2976,Randy,311,51,362,0,46,Player A
2977,Randy,285,60,345,1,52,Player A
2978,Randy,320,55,375,1,42,Player A
2979,Randy,299,54,353,0,49,Player A
2980,Randy,309,54,363,1,46,Player A
2981,Randy,284,74,358,5,49,Player A
2982,Randy,273,68,341,0,53,Player A
2983,Randy,311,51,362,0,46,Player A
2984,Randy,293,68,361,5,48,Player A
2985,Randy,302,62,364,2,46,Player A
2986,Randy,287,72,359,3,48,Player A
2987,Randy,324,54,378,4,42,Player A
2988,Randy,302,77,379,5,42,Player A
2989,Randy,278,58,336,1,55,Player A
2990,Randy,262,82,344,3,53,Player A
2991,Randy,297,57,354,1,49,Player A
2992,Randy,298,68,366,4,46,Player A
2993,Randy,296,76,372,4,44,Player A
2994,Randy,287,57,344,0,52,Player A
2995,Randy,279,59,338,0,54,Player A
2996,Randy,311,51,362,0,46,Player A
2997,Randy,287,57,344,0,52,Player A
2998,Randy,294,69,363,4,47,Player A
2999,Randy,283,58,341,0,53,Player A
3000,Randy,269,79,348,4,52,Player A
3001,Randy,262,67,329,0,57,Player A
3002,Randy,281,76,357,4,49,Player A
3003,Randy,299,54,353,0,49,Player A
3004,Randy,283,58,341,0,53,Player A
3005,Randy,287,57,344,0,52,Player A
3006,Randy,280,65,345,1,52,Player A
3007,Randy,291,56,347,0,51,Player A
3008,Randy,320,65,385,5,40,Player A
3009,Randy,286,76,362,3,47,Player A
3010,Randy,311,51,362,0,46,Player A
3011,Randy,287,57,344,0,52,Player A
3012,Randy,256,71,327,1,58,Player A
3013,Randy,304,74,378,7,43,Player A
3014,Randy,262,72,334,2,56,Player A
3015,Randy,291,121,412,14,34,Player A
3016,Randy,317,52,369,1,44,Player A
3017,Randy,275,85,360,4,48,Player A
3018,Randy,303,73,376,5,43,Player A
3019,Randy,294,64,358,2,48,Player A
3020,Randy,300,70,370,5,45,Player A
3021,Randy,283,58,341,0,53,Player A
3022,Randy,276,66,342,1,53,Player A
3023,Randy,299,59,358,2,48,Player A
3024,Randy,284,64,348,1,51,Player A
3025,Randy,308,83,391,8,39,Player A
3026,Randy,299,69,368,3,45,Player A
3027,Randy,319,59,378,4,42,Player A
3028,Randy,309,74,383,6,41,Player A
3029,Randy,299,54,353,0,49,Player A
3030,Randy,285,60,345,1,52,Player A
3031,Randy,326,51,377,0,41,Player A
3032,Randy,327,47,374,0,42,Player A
3033,Randy,267,62,329,0,57,Player A
3034,Randy,289,64,353,3,50,Player A
3035,Randy,297,62,359,0,47,Player A
3036,Randy,323,48,371,0,43,Player A
3037,Randy,283,58,341,0,53,Player A
3038,Randy,268,68,336,1,55,Player A
3039,Randy,315,50,365,0,45,Player A
3040,Randy,262,67,329,0,57,Player A
3041,Randy,291,56,347,0,51,Player A
3042,Randy,292,57,349,2,51,Player A
3043,Randy,321,71,392,6,38,Player A
3044,Randy,296,51,347,0,51,Player A
3045,Randy,323,48,371,0,43,Player A
3046,Randy,299,74,373,5,44,Player A
3047,Randy,298,78,376,5,43,Player A
3048,Randy,331,46,377,0,41,Player A
3049,Randy,298,63,361,2,47,Player A
3050,Randy,258,68,326,0,58,Player A
3051,Randy,283,58,341,0,53,Player A
3052,Randy,287,57,344,0,52,Player A
3053,Randy,263,63,326,0,58,Player A
3054,Randy,320,80,400,11,37,Player A
3055,Randy,316,56,372,1,43,Player A
3056,Randy,259,104,363,10,49,Player A
3057,Randy,291,56,347,0,51,Player A
3058,Randy,299,54,353,0,49,Player A
3059,Randy,303,53,356,0,48,Player A
3060,Randy,295,55,350,0,50,Player A
3061,Randy,292,62,354,1,49,Player A
3062,Randy,300,70,370,5,45,Player A
3063,Randy,300,80,380,6,42,Player A
3064,Randy,287,57,344,0,52,Player A
3065,Randy,286,106,392,12,40,Player A
3066,Randy,285,70,355,2,49,Player A
3067,Randy,317,52,369,1,44,Player A
3068,Randy,333,48,381,1,40,Player A
3069,Randy,268,83,351,4,51,Player A
3070,Randy,298,113,411,16,35,Player A
3071,Randy,311,51,362,0,46,Player A
3072,Randy,271,61,332,0,56,Player A
3073,Randy,270,70,340,2,54,Player A
3074,Randy,295,55,350,0,50,Player A
3075,Randy,311,51,362,0,46,Player A
3076,Randy,307,52,359,0,47,Player A
3077,Randy,292,67,359,3,48,Player A
3078,Randy,286,61,347,0,51,Player A
3079,Randy,294,64,358,2,48,Player A
3080,Randy,268,88,356,6,50,Player A
3081,Randy,291,56,347,0,51,Player A
3082,Randy,323,48,371,0,43,Player A
3083,Randy,293,58,351,1,50,Player A
3084,Randy,277,82,359,6,49,Player A
3085,Randy,245,85,330,4,58,Player A
3086,Randy,285,75,360,4,48,Player A
3087,Randy,322,57,379,2,41,Player A
3088,Randy,320,60,380,3,41,Player A
3089,Randy,311,51,362,0,46,Player A
3090,Randy,273,63,336,1,55,Player A
3091,Randy,282,62,344,0,52,Player A
3092,Randy,287,57,344,0,52,Player A
3093,Randy,258,128,386,12,42,Player A
3094,Randy,295,55,350,0,50,Player A
3095,Randy,320,45,365,0,45,Player A
3096,Randy,351,41,392,0,36,Player A
3097,Randy,295,55,350,0,50,Player A
3098,Randy,335,45,380,0,40,Player A
3099,Randy,272,67,339,1,54,Player A
3100,Randy,244,164,408,19,37,Player A
3101,Randy,303,53,356,0,48,Player A
3102,Randy,266,131,397,14,39,Player A
3103,Randy,278,78,356,3,49,Player A
3104,Randy,282,67,349,2,51,Player A
3105,Randy,238,133,371,12,47,Player A
3106,Randy,284,79,363,4,47,Player A
3107,Randy,267,62,329,0,57,Player A
3108,Randy,312,57,369,1,44,Player A
3109,Randy,299,54,353,0,49,Player A
3110,Randy,311,51,362,0,46,Player A
3111,Randy,307,52,359,0,47,Player A
3112,Randy,357,42,399,1,34,Player A
3113,Randy,268,93,361,8,49,Player A
3114,Randy,303,53,356,0,48,Player A
3115,Randy,311,51,362,0,46,Player A
3116,Randy,308,58,366,1,45,Player A
3117,Randy,333,48,381,1,40,Player A
3118,Randy,253,178,431,24,31,Player A
3119,Randy,315,65,380,3,41,Player A
3120,Randy,291,56,347,0,51,Player A
3121,Randy,260,180,440,30,30,Player A
3122,Randy,225,205,430,23,31,Player A
3123,Randy,306,61,367,2,45,Player A
3124,Randy,293,78,371,6,45,Player A
3125,Randy,270,110,380,12,44,Player A
3126,Randy,299,54,353,0,49,Player A
3127,Randy,305,55,360,1,47,Player A
3128,Randy,267,82,349,5,52,Player A
3129,Randy,280,65,345,1,52,Player A
3130,Randy,311,51,362,0,46,Player A
3131,Randy,325,50,375,1,42,Player A
3132,Randy,290,60,350,0,50,Player A
3133,Randy,311,51,362,0,46,Player A
3134,Randy,291,56,347,0,51,Player A
3135,Randy,282,67,349,2,51,Player A
3136,Randy,300,60,360,1,47,Player A
3137,Randy,277,102,379,8,43,Player A
3138,Randy,295,55,350,0,50,Player A
3139,Randy,309,54,363,1,46,Player A
3140,Randy,292,62,354,1,49,Player A
3141,Randy,327,52,379,2,41,Player A
3142,Randy,330,55,385,2,39,Player A
3143,Randy,359,39,398,0,34,Player A
3144,Randy,289,59,348,1,51,Player A
3145,Randy,296,61,357,1,48,Player A
3146,Randy,284,54,338,0,54,Player A
3147,Randy,268,68,336,1,55,Player A
3148,Randy,286,76,362,3,47,Player A
3149,Randy,327,47,374,0,42,Player A
3150,Randy,264,94,358,8,50,Player A
3151,Randy,270,65,335,0,55,Player A
3152,Randy,271,61,332,0,56,Player A
3153,Randy,254,69,323,0,59,Player A
3154,Randy,300,75,375,4,43,Player A
3155,Randy,287,57,344,0,52,Player A
3156,Randy,314,59,373,2,43,Player A
3157,Randy,311,51,362,0,46,Player A
3158,Randy,284,69,353,3,50,Player A
3159,Randy,277,92,369,7,46,Player A
3160,Randy,302,57,359,0,47,Player A
3161,Randy,300,60,360,1,47,Player A
3162,Randy,287,57,344,0,52,Player A
3163,Randy,296,61,357,1,48,Player A
3164,Randy,259,64,323,0,59,Player A
3165,Randy,277,72,349,2,51,Player A
3166,Randy,303,53,356,0,48,Player A
3167,Randy,285,70,355,2,49,Player A
3168,Randy,291,56,347,0,51,Player A
3169,Randy,254,69,323,0,59,Player A
3170,Randy,275,60,335,0,55,Player A
3171,Randy,319,49,368,0,44,Player A
3172,Randy,283,58,341,0,53,Player A
3173,Randy,275,80,355,5,50,Player A
3174,Randy,339,44,383,0,39,Player A
3175,Randy,307,52,359,0,47,Player A
3176,Randy,269,79,348,4,52,Player A
3177,Randy,287,57,344,0,52,Player A
3178,Randy,276,66,342,1,53,Player A
3179,Randy,287,77,364,5,47,Player A
3180,Randy,304,74,378,7,43,Player A
3181,Randy,284,64,348,1,51,Player A
3182,Randy,284,64,348,1,51,Player A
3183,Randy,314,64,378,4,42,Player A
3184,Randy,273,83,356,6,50,Player A
3185,Randy,295,55,350,0,50,Player A
3186,Randy,310,85,395,6,37,Player A
3187,Randy,275,75,350,6,52,Player A
3188,Randy,250,100,350,6,52,Player A
3189,Randy,283,93,376,8,44,Player A
3190,Randy,258,78,336,1,55,Player A
3191,Randy,292,72,364,2,46,Player A
3192,Randy,295,55,350,0,50,Player A
3193,Randy,345,55,400,5,35,Player A
3194,Randy,290,105,395,6,37,Player A
3195,Randy,285,70,355,2,49,Player A
3196,Randy,257,72,329,0,57,Player A
3197,Randy,292,52,344,0,52,Player A
3198,Randy,295,85,380,9,43,Player A
3199,Randy,248,73,321,1,60,Player A
3200,Randy,244,179,423,22,33,Player A
3201,Randy,291,71,362,3,47,Player A
3202,Randy,319,49,368,0,44,Player A
3203,Randy,255,75,330,1,57,Player A
3204,Randy,296,66,362,3,47,Player A
3205,Randy,267,62,329,0,57,Player A
3206,Randy,284,64,348,1,51,Player A
3207,Randy,299,54,353,0,49,Player A
3208,Randy,253,83,336,4,56,Player A
3209,Randy,239,79,318,1,61,Player A
3210,Randy,279,59,338,0,54,Player A
3211,Randy,295,55,350,0,50,Player A
3212,Randy,303,53,356,0,48,Player A
3213,Randy,271,61,332,0,56,Player A
3214,Randy,273,73,346,2,52,Player A
3215,Randy,291,56,347,0,51,Player A
3216,Randy,302,62,364,2,46,Player A
3217,Randy,304,64,368,3,45,Player A
3218,Randy,250,100,350,6,52,Player A
3219,Randy,261,96,357,7,50,Player A
3220,Randy,290,65,355,2,49,Player A
3221,Randy,260,80,340,5,55,Player A
3222,Randy,300,60,360,1,47,Player A
3223,Randy,263,63,326,0,58,Player A
3224,Randy,295,55,350,0,50,Player A
3225,Randy,275,60,335,0,55,Player A
3226,Randy,309,54,363,1,46,Player A
3227,Randy,278,63,341,0,53,Player A
3228,Randy,284,69,353,3,50,Player A
3229,Randy,276,66,342,1,53,Player A
3230,Randy,303,53,356,0,48,Player A
3231,Randy,287,57,344,0,52,Player A
3232,Randy,299,54,353,0,49,Player A
3233,Randy,293,58,351,1,50,Player A
3234,Randy,290,60,350,0,50,Player A
3235,Randy,273,73,346,2,52,Player A
3236,Randy,311,51,362,0,46,Player A
3237,Randy,279,59,338,0,54,Player A
3238,Randy,357,42,399,1,34,Player A
3239,Randy,298,58,356,0,48,Player A
3240,Randy,313,53,366,1,45,Player A
3241,Randy,308,58,366,1,45,Player A
3242,Randy,335,45,380,0,40,Player A
3243,Randy,291,56,347,0,51,Player A
3244,Randy,299,54,353,0,49,Player A
3245,Randy,323,48,371,0,43,Player A
3246,Randy,287,57,344,0,52,Player A
3247,Randy,307,52,359,0,47,Player A
3248,Randy,308,48,356,0,48,Player A
3249,Randy,275,60,335,0,55,Player A
3250,Randy,287,57,344,0,52,Player A
3251,Randy,315,50,365,0,45,Player A
3252,Randy,268,68,336,1,55,Player A
3253,Randy,287,57,344,0,52,Player A
3254,Randy,317,52,369,1,44,Player A
3255,Randy,322,57,379,2,41,Player A
3256,Randy,303,53,356,0,48,Player A
3257,Randy,282,72,354,4,50,Player A
3258,Randy,306,66,372,4,44,Player A
3259,Randy,315,50,365,0,45,Player A
3260,Randy,306,81,387,7,40,Player A
3261,Randy,315,50,365,0,45,Player A
3262,Randy,319,49,368,0,44,Player A
3263,Randy,217,222,439,29,30,Randy
3264,Randy,295,55,350,0,50,Player A
3265,Randy,283,58,341,0,53,Player A
3266,Randy,291,56,347,0,51,Player A
3267,Randy,307,52,359,0,47,Player A
3268,Randy,319,49,368,0,44,Player A
3269,Randy,323,48,371,0,43,Player A
3270,Randy,307,52,359,0,47,Player A
3271,Randy,289,59,348,1,51,Player A
3272,Randy,287,72,359,3,48,Player A
3273,Randy,292,77,369,7,46,Player A
3274,Randy,300,70,370,2,44,Player A
3275,Randy,299,54,353,0,49,Player A
3276,Randy,267,62,329,0,57,Player A
3277,Randy,335,45,380,0,40,Player A
3278,Randy,263,83,346,5,53,Player A
3279,Randy,283,58,341,0,53,Player A
3280,Randy,266,66,332,0,56,Player A
3281,Randy,309,54,363,1,46,Player A
3282,Randy,276,66,342,1,53,Player A
3283,Randy,299,79,378,7,43,Player A
3284,Randy,308,58,366,1,45,Player A
3285,Randy,307,52,359,0,47,Player A
3286,Randy,311,51,362,0,46,Player A
3287,Randy,279,59,338,0,54,Player A
3288,Randy,337,47,384,1,39,Player A
3289,Randy,243,98,341,6,55,Player A
3290,Randy,270,65,335,0,55,Player A
3291,Randy,287,57,344,0,52,Player A
3292,Randy,329,54,383,3,40,Player A
3293,Randy,296,61,357,1,48,Player A
3294,Randy,318,53,371,0,43,Player A
3295,Randy,283,63,346,2,52,Player A
3296,Randy,282,97,379,11,44,Player A
3297,Randy,310,60,370,2,44,Player A
3298,Randy,283,58,341,0,53,Player A
3299,Randy,300,50,350,0,50,Player A
3300,Randy,291,56,347,0,51,Player A
3301,Randy,279,69,348,1,51,Player A
3302,Randy,249,79,328,2,58,Player A
3303,Randy,250,155,405,22,39,Player A
3304,Randy,323,48,371,0,43,Player A
3305,Randy,295,55,350,0,50,Player A
3306,Randy,323,48,371,0,43,Player A
3307,Randy,327,47,374,0,42,Player A
3308,Randy,284,64,348,1,51,Player A
3309,Randy,281,76,357,4,49,Player A
3310,Randy,286,66,352,2,50,Player A
3311,Randy,258,88,346,5,53,Player A
3312,Randy,256,106,362,6,48,Player A
3313,Randy,316,61,377,3,42,Player A
3314,Randy,303,53,356,0,48,Player A
3315,Randy,217,222,439,32,31,Randy
3316,Randy,275,60,335,0,55,Player A
3317,Randy,287,57,344,0,52,Player A
3318,Randy,298,78,376,5,43,Player A
3319,Randy,275,60,335,0,55,Player A
3320,Randy,295,80,375,4,43,Player A
3321,Randy,315,50,365,0,45,Player A
3322,Randy,303,53,356,0,48,Player A
3323,Randy,291,56,347,0,51,Player A
3324,Randy,287,57,344,0,52,Player A
3325,Randy,298,68,366,4,46,Player A
3326,Randy,291,56,347,0,51,Player A
3327,Randy,286,81,367,8,47,Player A
3328,Randy,269,84,353,3,50,Player A
3329,Randy,300,70,370,5,45,Player A
3330,Randy,292,62,354,1,49,Player A
3331,Randy,306,61,367,2,45,Player A
3332,Randy,258,88,346,5,53,Player A
3333,Randy,262,67,329,0,57,Player A
3334,Randy,311,51,362,0,46,Player A
3335,Randy,290,65,355,2,49,Player A
3336,Randy,315,50,365,0,45,Player A
3337,Randy,283,58,341,0,53,Player A
3338,Randy,287,57,344,0,52,Player A
3339,Randy,277,77,354,4,50,Player A
3340,Randy,301,56,357,1,48,Player A
3341,Randy,304,64,368,3,45,Player A
3342,Randy,285,75,360,4,48,Player A
3343,Randy,285,80,365,6,47,Player A
3344,Randy,298,63,361,2,47,Player A
3345,Randy,310,60,370,2,44,Player A
3346,Randy,317,72,389,9,40,Player A
3347,Randy,278,88,366,7,47,Player A
3348,Randy,299,64,363,1,46,Player A
3349,Randy,335,45,380,0,40,Player A
3350,Randy,320,45,365,0,45,Player A
3351,Randy,278,68,346,2,52,Player A
3352,Randy,299,79,378,4,42,Player A
3353,Randy,277,77,354,4,50,Player A
3354,Randy,319,49,368,0,44,Player A
3355,Randy,247,82,329,3,58,Player A
3356,Randy,295,55,350,0,50,Player A
3357,Randy,303,53,356,0,48,Player A
3358,Randy,284,69,353,3,50,Player A
3359,Randy,307,52,359,0,47,Player A
3360,Randy,303,53,356,0,48,Player A
3361,Randy,283,58,341,0,53,Player A
3362,Randy,287,57,344,0,52,Player A
3363,Randy,304,64,368,3,45,Player A
3364,Randy,295,55,350,0,50,Player A
3365,Randy,270,130,400,17,39,Player A
3366,Randy,308,83,391,8,39,Player A
3367,Randy,283,58,341,0,53,Player A
3368,Randy,288,63,351,1,50,Player A
3369,Randy,327,47,374,0,42,Player A
3370,Randy,307,52,359,0,47,Player A
3371,Randy,331,46,377,0,41,Player A
3372,Randy,307,52,359,0,47,Player A
3373,Randy,287,57,344,0,52,Player A
3374,Randy,263,93,356,6,50,Player A
3375,Randy,283,58,341,0,53,Player A
3376,Randy,275,60,335,0,55,Player A
3377,Randy,246,116,362,12,50,Player A
3378,Randy,271,61,332,0,56,Player A
3379,Randy,271,61,332,0,56,Player A
3380,Randy,315,50,365,0,45,Player A
3381,Randy,304,59,363,1,46,Player A
3382,Randy,287,57,344,0,52,Player A
3383,Randy,324,54,378,1,41,Player A
3384,Randy,294,64,358,2,48,Player A
3385,Randy,271,61,332,0,56,Player A
3386,Randy,309,54,363,1,46,Player A
3387,Randy,302,57,359,0,47,Player A
3388,Randy,288,68,356,3,49,Player A
3389,Randy,282,62,344,0,52,Player A
3390,Randy,283,78,361,5,48,Player A
3391,Randy,260,70,330,1,57,Player A
3392,Randy,255,85,340,5,55,Player A
3393,Randy,278,68,346,2,52,Player A
3394,Randy,262,107,369,10,47,Player A
3395,Randy,277,97,374,6,44,Player A
3396,Randy,307,52,359,0,47,Player A
3397,Randy,302,57,359,3,48,Player A
3398,Randy,252,92,344,6,54,Player A
3399,Randy,301,66,367,2,45,Player A
3400,Randy,330,45,375,1,42,Player A
3401,Randy,266,111,377,15,46,Player A
3402,Randy,291,56,347,0,51,Player A
3403,Randy,307,52,359,0,47,Player A
3404,Randy,289,99,388,11,41,Player A
3405,Randy,323,48,371,0,43,Player A
3406,Randy,326,61,387,4,39,Player A
3407,Randy,283,58,341,0,53,Player A
3408,Randy,332,52,384,1,39,Player A
3409,Randy,261,76,337,2,55,Player A
3410,Randy,255,80,335,3,56,Player A
3411,Randy,331,46,377,0,41,Player A
3412,Randy,235,80,315,1,62,Player A
3413,Randy,292,62,354,1,49,Player A
3414,Randy,307,52,359,0,47,Player A
3415,Randy,303,53,356,0,48,Player A
3416,Randy,288,63,351,1,50,Player A
3417,Randy,286,96,382,8,42,Player A
3418,Randy,299,54,353,0,49,Player A
3419,Randy,253,103,356,6,50,Player A
3420,Randy,267,62,329,0,57,Player A
3421,Randy,331,46,377,0,41,Player A
3422,Randy,281,71,352,2,50,Player A
3423,Randy,283,58,341,0,53,Player A
3424,Randy,315,55,370,2,44,Player A
3425,Randy,275,75,350,3,51,Player A
3426,Randy,311,56,367,2,45,Player A
3427,Randy,277,72,349,2,51,Player A
3428,Randy,291,56,347,0,51,Player A
3429,Randy,319,49,368,0,44,Player A
3430,Randy,279,59,338,0,54,Player A
3431,Randy,327,47,374,0,42,Player A
3432,Randy,307,52,359,0,47,Player A
3433,Randy,307,52,359,0,47,Player A
3434,Randy,299,54,353,0,49,Player A
3435,Randy,303,53,356,0,48,Player A
3436,Randy,262,112,374,15,47,Player A
3437,Randy,294,64,358,2,48,Player A
3438,Randy,330,50,380,0,40,Player A
3439,Randy,311,51,362,0,46,Player A
3440,Randy,281,66,347,3,52,Player A
3441,Randy,302,57,359,0,47,Player A
3442,Randy,283,58,341,0,53,Player A
3443,Randy,301,56,357,1,48,Player A
3444,Randy,310,55,365,0,45,Player A
3445,Randy,303,53,356,0,48,Player A
3446,Randy,339,44,383,0,39,Player A
3447,Randy,319,64,383,3,40,Player A
3448,Randy,329,49,378,1,41,Player A
3449,Randy,314,54,368,0,44,Player A
3450,Randy,258,73,331,2,57,Player A
3451,Randy,310,60,370,2,44,Player A
3452,Randy,372,32,404,0,32,Player A
3453,Randy,261,76,337,2,55,Player A
3454,Randy,339,44,383,0,39,Player A
3455,Randy,282,97,379,8,43,Player A
3456,Randy,291,76,367,5,46,Player A
3457,Randy,288,78,366,4,46,Player A
3458,Randy,274,129,403,14,37,Player A
3459,Randy,266,96,362,6,48,Player A
3460,Randy,249,79,328,2,58,Player A
3461,Randy,292,62,354,1,49,Player A
3462,Randy,351,41,392,0,36,Player A
3463,Randy,259,104,363,10,49,Player A
3464,Randy,285,75,360,4,48,Player A
3465,Randy,295,55,350,0,50,Player A
3466,Randy,323,48,371,0,43,Player A
3467,Randy,283,78,361,5,48,Player A
3468,Randy,271,61,332,0,56,Player A
3469,Randy,323,48,371,0,43,Player A
3470,Randy,264,89,353,6,51,Player A
3471,Randy,307,52,359,0,47,Player A
3472,Randy,274,69,343,2,53,Player A
3473,Randy,287,57,344,0,52,Player A
3474,Randy,277,77,354,4,50,Player A
3475,Randy,275,90,365,6,47,Player A
3476,Randy,283,58,341,0,53,Player A
3477,Randy,288,63,351,1,50,Player A
3478,Randy,287,57,344,0,52,Player A
3479,Randy,341,46,387,1,38,Player A
3480,Randy,247,102,349,8,53,Player A
3481,Randy,319,49,368,0,44,Player A
3482,Randy,316,61,377,3,42,Player A
3483,Randy,266,66,332,0,56,Player A
3484,Randy,296,61,357,1,48,Player A
3485,Randy,299,54,353,0,49,Player A
3486,Randy,277,77,354,4,50,Player A
3487,Randy,301,56,357,1,48,Player A
3488,Randy,270,65,335,0,55,Player A
3489,Randy,323,48,371,0,43,Player A
3490,Randy,301,56,357,1,48,Player A
3491,Randy,287,77,364,5,47,Player A
3492,Randy,311,51,362,0,46,Player A
3493,Randy,247,107,354,10,52,Player A
3494,Randy,283,58,341,0,53,Player A
3495,Randy,282,72,354,4,50,Player A
3496,Randy,264,164,428,18,30,Player A
3497,Randy,307,57,364,2,46,Player A
3498,Randy,326,51,377,0,41,Player A
3499,Randy,320,55,375,1,42,Player A
3500,Randy,309,54,363,1,46,Player A
3501,Randy,269,74,343,2,53,Player A
3502,Randy,283,58,341,0,53,Player A
3503,Randy,284,54,338,0,54,Player A
3504,Randy,315,50,365,0,45,Player A
3505,Randy,299,54,353,0,49,Player A
3506,Randy,292,62,354,1,49,Player A
3507,Randy,268,68,336,1,55,Player A
3508,Randy,306,61,367,2,45,Player A
3509,Randy,266,116,382,14,44,Player A
3510,Randy,276,71,347,3,52,Player A
3511,Randy,339,49,388,2,38,Player A
3512,Randy,308,58,366,1,45,Player A
3513,Randy,287,57,344,0,52,Player A
3514,Randy,279,59,338,0,54,Player A
3515,Randy,286,91,377,6,43,Player A
3516,Randy,237,147,384,16,44,Player A
3517,Randy,275,70,345,1,52,Player A
3518,Randy,297,72,369,4,45,Player A
3519,Randy,285,75,360,4,48,Player A
3520,Randy,287,57,344,0,52,Player A
3521,Randy,295,80,375,7,44,Player A
3522,Randy,315,50,365,0,45,Player A
3523,Randy,299,54,353,0,49,Player A
3524,Randy,310,75,385,8,41,Player A
3525,Randy,258,98,356,6,50,Player A
3526,Randy,292,62,354,1,49,Player A
3527,Randy,272,67,339,1,54,Player A
3528,Randy,273,93,366,10,48,Player A
3529,Randy,292,62,354,1,49,Player A
3530,Randy,300,60,360,1,47,Player A
3531,Randy,296,61,357,1,48,Player A
3532,Randy,313,53,366,1,45,Player A
3533,Randy,275,95,370,8,46,Player A
3534,Randy,311,56,367,2,45,Player A
3535,Randy,305,70,375,4,43,Player A
3536,Randy,272,67,339,1,54,Player A
3537,Randy,284,64,348,1,51,Player A
3538,Randy,307,52,359,0,47,Player A
3539,Randy,303,53,356,0,48,Player A
3540,Randy,266,71,337,2,55,Player A
3541,Randy,282,62,344,0,52,Player A
3542,Randy,252,77,329,3,58,Player A
3543,Randy,290,60,350,0,50,Player A
3544,Randy,295,70,365,3,46,Player A
3545,Randy,279,59,338,0,54,Player A
3546,Randy,283,73,356,3,49,Player A
3547,Randy,275,60,335,0,55,Player A
3548,Randy,279,59,338,0,54,Player A
3549,Randy,285,75,360,4,48,Player A
3550,Randy,284,79,363,4,47,Player A
3551,Randy,343,48,391,2,37,Player A
3552,Randy,294,74,368,6,46,Player A
3553,Randy,249,154,403,14,37,Player A
3554,Randy,302,77,379,5,42,Player A
3555,Randy,278,83,361,5,48,Player A
3556,Randy,299,54,353,0,49,Player A
3557,Randy,283,58,341,0,53,Player A
3558,Randy,311,51,362,0,46,Player A
3559,Randy,299,54,353,0,49,Player A
3560,Randy,299,54,353,0,49,Player A
3561,Randy,304,69,373,5,44,Player A
3562,Randy,290,65,355,2,49,Player A
3563,Randy,290,65,355,2,49,Player A
3564,Randy,312,57,369,1,44,Player A
3565,Randy,327,47,374,0,42,Player A
3566,Randy,262,72,334,2,56,Player A
3567,Randy,319,49,368,0,44,Player A
3568,Randy,327,47,374,0,42,Player A
3569,Randy,292,67,359,3,48,Player A
3570,Randy,280,65,345,1,52,Player A
3571,Randy,276,81,357,4,49,Player A
3572,Randy,279,59,338,0,54,Player A
3573,Randy,291,56,347,0,51,Player A
3574,Randy,303,53,356,0,48,Player A
3575,Randy,303,53,356,0,48,Player A
3576,Randy,299,54,353,0,49,Player A
3577,Randy,331,46,377,0,41,Player A
3578,Randy,285,95,380,6,42,Player A
3579,Randy,275,85,360,4,48,Player A
3580,Randy,307,52,359,0,47,Player A
3581,Randy,305,55,360,1,47,Player A
3582,Randy,265,80,345,4,53,Player A
3583,Randy,310,55,365,0,45,Player A
3584,Randy,279,69,348,1,51,Player A
3585,Randy,291,56,347,0,51,Player A
3586,Randy,311,51,362,0,46,Player A
3587,Randy,277,92,369,10,47,Player A
3588,Randy,303,53,356,0,48,Player A
3589,Randy,292,72,364,5,47,Player A
3590,Randy,294,59,353,0,49,Player A
3591,Randy,274,69,343,2,53,Player A
3592,Randy,280,65,345,1,52,Player A
3593,Randy,323,48,371,0,43,Player A
3594,Randy,316,56,372,1,43,Player A
3595,Randy,301,56,357,1,48,Player A
3596,Randy,260,70,330,1,57,Player A
3597,Randy,282,62,344,0,52,Player A
3598,Randy,278,78,356,6,50,Player A
3599,Randy,302,67,369,4,45,Player A
3600,Randy,288,93,381,10,43,Player A
3601,Randy,264,69,333,1,56,Player A
3602,Randy,297,57,354,1,49,Player A
3603,Randy,334,49,383,0,39,Player A
3604,Randy,295,55,350,0,50,Player A
3605,Randy,340,40,380,0,40,Player A
3606,Randy,283,58,341,0,53,Player A
3607,Randy,303,53,356,0,48,Player A
3608,Randy,299,54,353,0,49,Player A
3609,Randy,266,66,332,0,56,Player A
3610,Randy,251,131,382,14,44,Player A
3611,Randy,275,60,335,0,55,Player A
3612,Randy,294,64,358,2,48,Player A
3613,Randy,319,49,368,0,44,Player A
3614,Randy,311,51,362,0,46,Player A
3615,Randy,303,53,356,0,48,Player A
3616,Randy,315,50,365,0,45,Player A
3617,Randy,257,97,354,7,51,Player A
3618,Randy,315,50,365,0,45,Player A
3619,Randy,291,56,347,0,51,Player A
3620,Randy,265,65,330,1,57,Player A
3621,Randy,286,61,347,0,51,Player A
3622,Randy,272,67,339,1,54,Player A
3623,Randy,290,70,360,4,48,Player A
3624,Randy,290,60,350,0,50,Player A
3625,Randy,285,70,355,2,49,Player A
3626,Randy,323,48,371,0,43,Player A
3627,Randy,349,44,393,1,36,Player A
3628,Randy,300,70,370,5,45,Player A
3629,Randy,241,101,342,4,54,Player A
3630,Randy,298,63,361,2,47,Player A
3631,Randy,315,50,365,0,45,Player A
3632,Randy,308,58,366,1,45,Player A
3633,Randy,296,66,362,3,47,Player A
3634,Randy,290,65,355,2,49,Player A
3635,Randy,255,75,330,1,57,Player A
3636,Randy,320,55,375,1,42,Player A
3637,Randy,323,48,371,0,43,Player A
3638,Randy,246,96,342,7,55,Player A
3639,Randy,306,56,362,0,46,Player A
3640,Randy,309,54,363,1,46,Player A
3641,Randy,276,66,342,1,53,Player A
3642,Randy,283,58,341,0,53,Player A
3643,Randy,259,99,358,8,50,Player A
3644,Randy,253,113,366,10,48,Player A
3645,Randy,300,95,395,6,37,Player A
3646,Randy,283,58,341,0,53,Player A
3647,Randy,291,56,347,0,51,Player A
3648,Randy,319,49,368,0,44,Player A
3649,Randy,316,51,367,2,45,Player A
3650,Randy,298,73,371,3,44,Player A
3651,Randy,311,51,362,0,46,Player A
3652,Randy,309,54,363,1,46,Player A
3653,Randy,283,78,361,5,48,Player A
3654,Randy,283,58,341,0,53,Player A
3655,Randy,334,44,378,1,41,Player A
3656,Randy,306,61,367,2,45,Player A
3657,Randy,283,58,341,0,53,Player A
3658,Randy,324,54,378,1,41,Player A
3659,Randy,294,64,358,2,48,Player A
3660,Randy,291,56,347,0,51,Player A
3661,Randy,295,55,350,0,50,Player A
3662,Randy,227,172,399,19,40,Player A
3663,Randy,299,54,353,0,49,Player A
3664,Randy,312,57,369,1,44,Player A
3665,Randy,275,90,365,6,47,Player A
3666,Randy,300,65,365,3,46,Player A
3667,Randy,241,81,322,2,60,Player A
3668,Randy,324,69,393,7,38,Player A
3669,Randy,327,47,374,0,42,Player A
3670,Randy,271,76,347,3,52,Player A
3671,Randy,329,49,378,1,41,Player A
3672,Randy,287,57,344,0,52,Player A
3673,Randy,277,62,339,1,54,Player A
3674,Randy,247,82,329,3,58,Player A
3675,Randy,295,55,350,0,50,Player A
3676,Randy,296,86,382,5,41,Player A
3677,Randy,280,65,345,1,52,Player A
3678,Randy,299,79,378,7,43,Player A
3679,Randy,295,55,350,0,50,Player A
3680,Randy,331,46,377,0,41,Player A
3681,Randy,303,53,356,0,48,Player A
3682,Randy,307,52,359,0,47,Player A
3683,Randy,319,49,368,0,44,Player A
3684,Randy,327,47,374,0,42,Player A
3685,Randy,323,48,371,0,43,Player A
3686,Randy,292,67,359,3,48,Player A
3687,Randy,303,53,356,0,48,Player A
3688,Randy,327,47,374,0,42,Player A
3689,Randy,276,81,357,4,49,Player A
3690,Randy,295,55,350,0,50,Player A
3691,Randy,296,71,367,5,46,Player A
3692,Randy,283,123,406,14,36,Player A
3693,Randy,331,46,377,0,41,Player A
3694,Randy,279,99,378,10,44,Player A
3695,Randy,297,57,354,1,49,Player A
3696,Randy,288,63,351,1,50,Player A
3697,Randy,313,53,366,1,45,Player A
3698,Randy,334,64,398,6,36,Player A
3699,Randy,282,87,369,7,46,Player A
3700,Randy,232,152,384,13,43,Player A
3701,Randy,307,52,359,0,47,Player A
3702,Randy,291,56,347,0,51,Player A
3703,Randy,268,68,336,1,55,Player A
3704,Randy,354,39,393,1,36,Player A
3705,Randy,267,87,354,7,51,Player A
3706,Randy,261,126,387,10,41,Player A
3707,Randy,296,51,347,0,51,Player A
3708,Randy,287,57,344,0,52,Player A
3709,Randy,295,55,350,0,50,Player A
3710,Randy,299,54,353,0,49,Player A
3711,Randy,339,44,383,0,39,Player A
3712,Randy,275,60,335,0,55,Player A
3713,Randy,306,56,362,0,46,Player A
3714,Randy,298,58,356,0,48,Player A
3715,Randy,307,52,359,0,47,Player A
3716,Randy,275,60,335,0,55,Player A
3717,Randy,325,55,380,3,41,Player A
3718,Randy,282,67,349,2,51,Player A
3719,Randy,320,60,380,3,41,Player A
3720,Randy,307,52,359,0,47,Player A
3721,Randy,324,59,383,3,40,Player A
3722,Randy,315,50,365,0,45,Player A
3723,Randy,295,55,350,0,50,Player A
3724,Randy,291,56,347,0,51,Player A
3725,Randy,275,60,335,0,55,Player A
3726,Randy,315,50,365,0,45,Player A
3727,Randy,286,61,347,0,51,Player A
3728,Randy,267,62,329,0,57,Player A
3729,Randy,245,95,340,5,55,Player A
3730,Randy,287,72,359,3,48,Player A
3731,Randy,295,55,350,0,50,Player A
3732,Randy,286,61,347,0,51,Player A
3733,Randy,295,75,370,5,45,Player A
3734,Randy,307,52,359,0,47,Player A
3735,Randy,248,83,331,2,57,Player A
3736,Randy,284,69,353,3,50,Player A
3737,Randy,267,77,344,3,53,Player A
3738,Randy,297,67,364,2,46,Player A
3739,Randy,285,95,380,6,42,Player A
3740,Randy,335,45,380,0,40,Player A
3741,Randy,339,44,383,0,39,Player A
3742,Randy,291,56,347,0,51,Player A
3743,Randy,304,79,383,6,41,Player A
3744,Randy,275,60,335,0,55,Player A
3745,Randy,304,59,363,1,46,Player A
3746,Randy,305,55,360,1,47,Player A
3747,Randy,285,80,365,6,47,Player A
3748,Randy,295,55,350,0,50,Player A
3749,Randy,263,83,346,5,53,Player A
3750,Randy,278,73,351,4,51,Player A
3751,Randy,257,97,354,10,52,Player A
3752,Randy,292,82,374,6,44,Player A
3753,Randy,302,57,359,0,47,Player A
3754,Randy,339,44,383,0,39,Player A
3755,Randy,255,75,330,1,57,Player A
3756,Randy,275,60,335,0,55,Player A
3757,Randy,282,57,339,1,54,Player A
3758,Randy,283,128,411,16,35,Player A
3759,Randy,270,120,390,16,42,Player A
3760,Randy,287,57,344,0,52,Player A
3761,Randy,294,64,358,2,48,Player A
3762,Randy,283,58,341,0,53,Player A
3763,Randy,287,57,344,0,52,Player A
3764,Randy,290,65,355,2,49,Player A
3765,Randy,293,68,361,2,47,Player A
3766,Randy,303,53,356,0,48,Player A
3767,Randy,326,56,382,2,40,Player A
3768,Randy,278,68,346,2,52,Player A
3769,Randy,291,56,347,0,51,Player A
3770,Randy,287,57,344,0,52,Player A
3771,Randy,302,62,364,2,46,Player A
3772,Randy,323,48,371,0,43,Player A
3773,Randy,233,83,316,2,62,Player A
3774,Randy,275,60,335,0,55,Player A
3775,Randy,307,62,369,1,44,Player A
3776,Randy,310,70,380,6,42,Player A
3777,Randy,280,65,345,1,52,Player A
3778,Randy,295,55,350,0,50,Player A
3779,Randy,327,47,374,0,42,Player A
3780,Randy,357,42,399,1,34,Player A
3781,Randy,291,81,372,7,45,Player A
3782,Randy,323,48,371,0,43,Player A
3783,Randy,307,52,359,0,47,Player A
3784,Randy,323,48,371,0,43,Player A
3785,Randy,303,53,356,0,48,Player A
3786,Randy,300,65,365,3,46,Player A
3787,Randy,299,54,353,0,49,Player A
3788,Randy,299,54,353,0,49,Player A
3789,Randy,263,63,326,0,58,Player A
3790,Randy,249,109,358,8,50,Player A
3791,Randy,311,56,367,2,45,Player A
3792,Randy,284,64,348,1,51,Player A
3793,Randy,339,49,388,2,38,Player A
3794,Randy,320,55,375,1,42,Player A
3795,Randy,319,49,368,0,44,Player A
3796,Randy,279,59,338,0,54,Player A
3797,Randy,282,62,344,0,52,Player A
3798,Randy,276,71,347,3,52,Player A
3799,Randy,243,78,321,1,60,Player A
3800,Randy,319,49,368,0,44,Player A
3801,Randy,288,93,381,10,43,Player A
3802,Randy,308,58,366,1,45,Player A
3803,Randy,290,60,350,0,50,Player A
3804,Randy,291,56,347,0,51,Player A
3805,Randy,307,57,364,2,46,Player A
3806,Randy,267,82,349,5,52,Player A
3807,Randy,283,123,406,17,37,Player A
3808,Randy,278,58,336,1,55,Player A
3809,Randy,309,59,368,0,44,Player A
3810,Randy,264,84,348,7,53,Player A
3811,Randy,286,76,362,3,47,Player A
3812,Randy,262,117,379,11,44,Player A
3813,Randy,286,81,367,5,46,Player A
3814,Randy,270,90,360,7,49,Player A
3815,Randy,303,53,356,0,48,Player A
3816,Randy,319,49,368,0,44,Player A
3817,Randy,269,79,348,4,52,Player A
3818,Randy,311,51,362,0,46,Player A
3819,Randy,292,72,364,5,47,Player A
3820,Randy,291,56,347,0,51,Player A
3821,Randy,283,58,341,0,53,Player A
3822,Randy,295,55,350,0,50,Player A
3823,Randy,283,58,341,0,53,Player A
3824,Randy,265,75,340,2,54,Player A
3825,Randy,323,48,371,0,43,Player A
3826,Randy,291,56,347,0,51,Player A
3827,Randy,273,103,376,11,45,Player A
3828,Randy,298,63,361,2,47,Player A
3829,Randy,275,85,360,4,48,Player A
3830,Randy,282,67,349,2,51,Player A
3831,Randy,319,49,368,0,44,Player A
3832,Randy,308,63,371,3,44,Player A
3833,Randy,311,51,362,0,46,Player A
3834,Randy,316,71,387,7,40,Player A
3835,Randy,288,78,366,4,46,Player A
3836,Randy,263,63,326,0,58,Player A
3837,Randy,303,53,356,0,48,Player A
3838,Randy,263,63,326,0,58,Player A
3839,Randy,257,77,334,2,56,Player A
3840,Randy,299,54,353,0,49,Player A
3841,Randy,272,67,339,1,54,Player A
3842,Randy,290,75,365,6,47,Player A
3843,Randy,310,55,365,0,45,Player A
3844,Randy,311,51,362,0,46,Player A
3845,Randy,259,74,333,1,56,Player A
3846,Randy,289,59,348,1,51,Player A
3847,Randy,267,77,344,3,53,Player A
3848,Randy,294,64,358,2,48,Player A
3849,Randy,306,71,377,3,42,Player A
3850,Randy,272,77,349,5,52,Player A
3851,Randy,315,50,365,0,45,Player A
3852,Randy,253,78,331,2,57,Player A
3853,Randy,298,58,356,0,48,Player A
3854,Randy,328,53,381,4,41,Player A
3855,Randy,276,76,352,2,50,Player A
3856,Randy,322,52,374,3,43,Player A
3857,Randy,270,75,345,1,52,Player A
3858,Randy,322,47,369,1,44,Player A
3859,Randy,244,74,318,1,61,Player A
3860,Randy,287,67,354,1,49,Player A
3861,Randy,243,83,326,3,59,Player A
3862,Randy,306,61,367,2,45,Player A
3863,Randy,296,66,362,3,47,Player A
3864,Randy,284,89,373,5,44,Player A
3865,Randy,298,93,391,8,39,Player A
3866,Randy,319,49,368,0,44,Player A
3867,Randy,303,53,356,0,48,Player A
3868,Randy,279,59,338,0,54,Player A
3869,Randy,279,79,358,5,49,Player A
3870,Randy,272,67,339,1,54,Player A
3871,Randy,284,64,348,1,51,Player A
3872,Randy,274,69,343,2,53,Player A
3873,Randy,299,54,353,0,49,Player A
3874,Randy,298,63,361,2,47,Player A
3875,Randy,300,65,365,3,46,Player A
3876,Randy,309,69,378,4,42,Player A
3877,Randy,317,72,389,6,39,Player A
3878,Randy,285,125,410,15,35,Player A
3879,Randy,311,51,362,0,46,Player A
3880,Randy,280,65,345,1,52,Player A
3881,Randy,299,54,353,0,49,Player A
3882,Randy,287,57,344,0,52,Player A
3883,Randy,299,54,353,0,49,Player A
3884,Randy,321,56,377,3,42,Player A
3885,Randy,281,71,352,2,50,Player A
3886,Randy,299,54,353,0,49,Player A
3887,Randy,315,50,365,0,45,Player A
3888,Randy,283,58,341,0,53,Player A
3889,Randy,288,63,351,1,50,Player A
3890,Randy,294,64,358,2,48,Player A
3891,Randy,275,60,335,0,55,Player A
3892,Randy,321,51,372,1,43,Player A
3893,Randy,290,60,350,0,50,Player A
3894,Randy,302,57,359,0,47,Player A
3895,Randy,279,59,338,0,54,Player A
3896,Randy,266,66,332,0,56,Player A
3897,Randy,303,53,356,0,48,Player A
3898,Randy,300,65,365,6,47,Player A
3899,Randy,298,73,371,3,44,Player A
3900,Randy,279,79,358,5,49,Player A
3901,Randy,313,58,371,3,44,Player A
3902,Randy,306,56,362,0,46,Player A
3903,Randy,303,53,356,0,48,Player A
3904,Randy,311,51,362,0,46,Player A
3905,Randy,295,55,350,0,50,Player A
3906,Randy,269,79,348,4,52,Player A
3907,Randy,303,58,361,2,47,Player A
3908,Randy,293,58,351,1,50,Player A
3909,Randy,303,63,366,1,45,Player A
3910,Randy,302,52,354,1,49,Player A
3911,Randy,298,58,356,0,48,Player A
3912,Randy,306,66,372,4,44,Player A
3913,Randy,288,63,351,1,50,Player A
3914,Randy,327,47,374,0,42,Player A
3915,Randy,328,53,381,1,40,Player A
3916,Randy,258,68,326,0,58,Player A
3917,Randy,264,84,348,4,52,Player A
3918,Randy,327,47,374,0,42,Player A
3919,Randy,304,59,363,1,46,Player A
3920,Randy,275,60,335,0,55,Player A
3921,Randy,311,51,362,0,46,Player A
3922,Randy,278,68,346,2,52,Player A
3923,Randy,302,62,364,2,46,Player A
3924,Randy,302,62,364,2,46,Player A
3925,Randy,291,56,347,0,51,Player A
3926,Randy,331,51,382,2,40,Player A
3927,Randy,287,122,409,14,35,Player A
3928,Randy,258,88,346,5,53,Player A
3929,Randy,283,58,341,0,53,Player A
3930,Randy,307,52,359,0,47,Player A
3931,Randy,285,75,360,4,48,Player A
3932,Randy,282,67,349,2,51,Player A
3933,Randy,300,70,370,5,45,Player A
3934,Randy,258,68,326,0,58,Player A
3935,Randy,285,95,380,9,43,Player A
3936,Randy,299,54,353,0,49,Player A
3937,Randy,335,45,380,0,40,Player A
3938,Randy,315,50,365,0,45,Player A
3939,Randy,283,58,341,0,53,Player A
3940,Randy,286,61,347,0,51,Player A
3941,Randy,263,63,326,0,58,Player A
3942,Randy,272,67,339,1,54,Player A
3943,Randy,347,42,389,0,37,Player A
3944,Randy,274,69,343,2,53,Player A
3945,Randy,286,61,347,0,51,Player A
3946,Randy,297,57,354,1,49,Player A
3947,Randy,306,56,362,0,46,Player A
3948,Randy,319,49,368,0,44,Player A
3949,Randy,287,57,344,0,52,Player A
3950,Randy,295,55,350,0,50,Player A
3951,Randy,296,76,372,4,44,Player A
3952,Randy,311,56,367,2,45,Player A
3953,Randy,300,60,360,1,47,Player A
3954,Randy,294,69,363,4,47,Player A
3955,Randy,255,115,370,8,46,Player A
3956,Randy,306,56,362,3,47,Player A
3957,Randy,255,90,345,4,53,Player A
3958,Randy,270,65,335,0,55,Player A
3959,Randy,283,58,341,0,53,Player A
3960,Randy,309,54,363,1,46,Player A
3961,Randy,274,64,338,0,54,Player A
3962,Randy,283,58,341,0,53,Player A
3963,Randy,306,61,367,2,45,Player A
3964,Randy,295,55,350,0,50,Player A
3965,Randy,299,54,353,0,49,Player A
3966,Randy,320,65,385,5,40,Player A
3967,Randy,299,54,353,0,49,Player A
3968,Randy,227,202,429,25,32,Player A
3969,Randy,307,52,359,0,47,Player A
3970,Randy,263,93,356,6,50,Player A
3971,Randy,254,89,343,5,54,Player A
3972,Randy,296,61,357,1,48,Player A
3973,Randy,267,77,344,3,53,Player A
3974,Randy,312,62,374,3,43,Player A
3975,Randy,271,76,347,3,52,Player A
3976,Randy,287,57,344,0,52,Player A
3977,Randy,287,57,344,0,52,Player A
3978,Randy,303,53,356,0,48,Player A
3979,Randy,266,76,342,1,53,Player A
3980,Randy,266,71,337,2,55,Player A
3981,Randy,273,93,366,7,47,Player A
3982,Randy,295,55,350,0,50,Player A
3983,Randy,291,56,347,0,51,Player A
3984,Randy,267,62,329,0,57,Player A
3985,Randy,267,77,344,3,53,Player A
3986,Randy,309,54,363,1,46,Player A
3987,Randy,300,80,380,3,41,Player A
3988,Randy,275,90,365,6,47,Player A
3989,Randy,311,51,362,0,46,Player A
3990,Randy,309,54,363,1,46,Player A
3991,Randy,257,107,364,8,48,Player A
3992,Randy,286,66,352,2,50,Player A
3993,Randy,281,81,362,6,48,Player A
3994,Randy,315,50,365,0,45,Player A
3995,Randy,286,66,352,2,50,Player A
3996,Randy,291,56,347,0,51,Player A
3997,Randy,259,79,338,3,55,Player A
3998,Randy,299,64,363,4,47,Player A
3999,Randy,331,46,377,0,41,Player A
4000,Randy,284,89,373,8,45,Player A
4001,Randy,283,83,366,4,46,Player A
4002,Randy,311,51,362,0,46,Player A
4003,Randy,267,62,329,0,57,Player A
4004,Randy,287,57,344,0,52,Player A
4005,Randy,299,54,353,0,49,Player A
4006,Randy,275,80,355,5,50,Player A
4007,Randy,267,67,334,2,56,Player A
4008,Randy,294,64,358,2,48,Player A
4009,Randy,321,66,387,4,39,Player A
4010,Randy,305,65,370,2,44,Player A
4011,Randy,297,57,354,1,49,Player A
4012,Randy,289,64,353,0,49,Player A
4013,Randy,300,50,350,0,50,Player A
4014,Randy,279,59,338,0,54,Player A
4015,Randy,311,51,362,0,46,Player A
4016,Randy,252,72,324,1,59,Player A
4017,Randy,287,57,344,0,52,Player A
4018,Randy,286,61,347,0,51,Player A
4019,Randy,307,52,359,0,47,Player A
4020,Randy,283,58,341,0,53,Player A
4021,Randy,293,73,366,4,46,Player A
4022,Randy,287,57,344,0,52,Player A
4023,Randy,278,68,346,2,52,Player A
4024,Randy,298,63,361,2,47,Player A
4025,Randy,307,52,359,0,47,Player A
4026,Randy,299,54,353,0,49,Player A
4027,Randy,341,46,387,1,38,Player A
4028,Randy,274,64,338,0,54,Player A
4029,Randy,279,69,348,1,51,Player A
4030,Randy,307,52,359,0,47,Player A
4031,Randy,286,76,362,6,48,Player A
4032,Randy,302,57,359,0,47,Player A
4033,Randy,335,45,380,0,40,Player A
4034,Randy,289,69,358,2,48,Player A
4035,Randy,287,92,379,5,42,Player A
4036,Randy,286,66,352,2,50,Player A
4037,Randy,282,102,384,10,42,Player A
4038,Randy,311,51,362,0,46,Player A
4039,Randy,313,53,366,1,45,Player A
4040,Randy,246,71,317,0,61,Player A
4041,Randy,286,61,347,0,51,Player A
4042,Randy,275,60,335,0,55,Player A
4043,Randy,280,65,345,1,52,Player A
4044,Randy,278,98,376,8,44,Player A
4045,Randy,295,55,350,0,50,Player A
4046,Randy,283,58,341,0,53,Player A
4047,Randy,310,55,365,0,45,Player A
4048,Randy,303,53,356,0,48,Player A
4049,Randy,291,56,347,0,51,Player A
4050,Randy,287,57,344,0,52,Player A
4051,Randy,306,61,367,2,45,Player A
4052,Randy,269,74,343,2,53,Player A
4053,Randy,273,68,341,3,54,Player A
4054,Randy,271,71,342,1,53,Player A
4055,Randy,311,51,362,0,46,Player A
4056,Randy,289,59,348,1,51,Player A
4057,Randy,314,59,373,2,43,Player A
4058,Randy,274,84,358,5,49,Player A
4059,Randy,291,56,347,0,51,Player A
4060,Randy,322,62,384,4,40,Player A
4061,Randy,313,78,391,5,38,Player A
4062,Randy,320,55,375,1,42,Player A
4063,Randy,343,43,386,0,38,Player A
4064,Randy,288,53,341,0,53,Player A
4065,Randy,286,61,347,0,51,Player A
4066,Randy,302,62,364,2,46,Player A
4067,Randy,291,56,347,0,51,Player A
4068,Randy,299,54,353,0,49,Player A
4069,Randy,320,65,385,5,40,Player A
4070,Randy,266,66,332,0,56,Player A
4071,Randy,278,68,346,2,52,Player A
4072,Randy,261,76,337,2,55,Player A
4073,Randy,300,65,365,3,46,Player A
4074,Randy,319,49,368,0,44,Player A
4075,Randy,312,57,369,1,44,Player A
4076,Randy,289,74,363,4,47,Player A
4077,Randy,295,55,350,0,50,Player A
4078,Randy,286,81,367,5,46,Player A
4079,Randy,288,63,351,1,50,Player A
4080,Randy,278,63,341,0,53,Player A
4081,Randy,302,92,394,8,38,Player A
4082,Randy,287,57,344,0,52,Player A
4083,Randy,283,58,341,0,53,Player A
4084,Randy,267,62,329,0,57,Player A
4085,Randy,310,55,365,0,45,Player A
4086,Randy,327,47,374,0,42,Player A
4087,Randy,240,125,365,12,49,Player A
4088,Randy,276,76,352,5,51,Player A
4089,Randy,314,74,388,5,39,Player A
4090,Randy,296,61,357,1,48,Player A
4091,Randy,283,58,341,0,53,Player A
4092,Randy,307,52,359,0,47,Player A
4093,Randy,287,57,344,0,52,Player A
4094,Randy,291,56,347,0,51,Player A
4095,Randy,200,190,390,25,45,Player A
4096,Randy,288,98,386,6,40,Player A
4097,Randy,317,52,369,1,44,Player A
4098,Randy,300,75,375,4,43,Player A
4099,Randy,291,56,347,0,51,Player A
4100,Randy,295,55,350,0,50,Player A
4101,Randy,315,55,370,2,44,Player A
4102,Randy,290,70,360,4,48,Player A
4103,Randy,250,105,355,8,51,Player A
4104,Randy,307,52,359,0,47,Player A
4105,Randy,307,52,359,0,47,Player A
4106,Randy,297,57,354,1,49,Player A
4107,Randy,256,76,332,3,57,Player A
4108,Randy,290,60,350,0,50,Player A
4109,Randy,287,57,344,0,52,Player A
4110,Randy,325,50,375,1,42,Player A
4111,Randy,310,55,365,0,45,Player A
4112,Randy,256,111,367,14,49,Player A
4113,Randy,302,62,364,2,46,Player A
4114,Randy,257,102,359,6,49,Player A
4115,Randy,312,47,359,0,47,Player A
4116,Randy,289,74,363,4,47,Player A
4117,Randy,295,55,350,0,50,Player A
4118,Randy,312,62,374,3,43,Player A
4119,Randy,261,136,397,11,38,Player A
4120,Randy,271,76,347,3,52,Player A
4121,Randy,315,50,365,0,45,Player A
4122,Randy,315,50,365,0,45,Player A
4123,Randy,262,97,359,9,50,Player A
4124,Randy,347,47,394,2,36,Player A
4125,Randy,319,49,368,0,44,Player A
4126,Randy,311,51,362,0,46,Player A
4127,Randy,267,62,329,0,57,Player A
4128,Randy,265,75,340,2,54,Player A
4129,Randy,253,68,321,1,60,Player A
4130,Randy,277,82,359,3,48,Player A
4131,Randy,284,64,348,1,51,Player A
4132,Randy,299,54,353,0,49,Player A
4133,Randy,291,56,347,0,51,Player A
4134,Randy,290,65,355,2,49,Player A
4135,Randy,291,56,347,0,51,Player A
4136,Randy,315,50,365,0,45,Player A
4137,Randy,292,67,359,3,48,Player A
4138,Randy,264,69,333,1,56,Player A
4139,Randy,280,65,345,1,52,Player A
4140,Randy,335,45,380,0,40,Player A
4141,Randy,338,53,391,2,37,Player A
4142,Randy,315,50,365,0,45,Player A
4143,Randy,265,85,350,3,51,Player A
4144,Randy,343,43,386,0,38,Player A
4145,Randy,257,102,359,9,50,Player A
4146,Randy,295,55,350,0,50,Player A
4147,Randy,299,54,353,0,49,Player A
4148,Randy,302,62,364,2,46,Player A
4149,Randy,273,138,411,16,35,Player A
4150,Randy,224,214,438,28,30,Player A
4151,Randy,243,188,431,18,29,Player A
4152,Randy,319,49,368,0,44,Player A
4153,Randy,283,58,341,0,53,Player A
4154,Randy,303,53,356,0,48,Player A
4155,Randy,283,58,341,0,53,Player A
4156,Randy,316,56,372,1,43,Player A
4157,Randy,291,81,372,7,45,Player A
4158,Randy,270,65,335,0,55,Player A
4159,Randy,278,63,341,0,53,Player A
4160,Randy,278,63,341,0,53,Player A
4161,Randy,317,52,369,1,44,Player A
4162,Randy,310,55,365,0,45,Player A
4163,Randy,323,48,371,0,43,Player A
4164,Randy,264,69,333,1,56,Player A
4165,Randy,266,66,332,0,56,Player A
4166,Randy,332,42,374,0,42,Player A
4167,Randy,236,96,332,6,58,Player A
4168,Randy,286,86,372,4,44,Player A
4169,Randy,315,50,365,0,45,Player A
4170,Randy,299,54,353,0,49,Player A
4171,Randy,323,48,371,0,43,Player A
4172,Randy,276,66,342,1,53,Player A
4173,Randy,268,68,336,1,55,Player A
4174,Randy,271,61,332,0,56,Player A
4175,Randy,291,81,372,7,45,Player A
4176,Randy,278,68,346,2,52,Player A
4177,Randy,288,63,351,1,50,Player A
4178,Randy,266,106,372,7,45,Player A
4179,Randy,303,53,356,0,48,Player A
4180,Randy,247,187,434,24,30,Player A
4181,Randy,291,56,347,0,51,Player A
4182,Randy,313,53,366,1,45,Player A
4183,Randy,310,55,365,0,45,Player A
4184,Randy,299,54,353,0,49,Player A
4185,Randy,264,69,333,1,56,Player A
4186,Randy,279,59,338,0,54,Player A
4187,Randy,323,48,371,0,43,Player A
4188,Randy,276,66,342,1,53,Player A
4189,Randy,309,54,363,1,46,Player A
4190,Randy,313,83,396,10,38,Player A
4191,Randy,267,77,344,3,53,Player A
4192,Randy,292,67,359,3,48,Player A
4193,Randy,238,73,311,0,63,Player A
4194,Randy,300,60,360,1,47,Player A
4195,Randy,279,59,338,0,54,Player A
4196,Randy,259,89,348,7,53,Player A
4197,Randy,289,69,358,2,48,Player A
4198,Randy,284,69,353,3,50,Player A
4199,Randy,294,89,383,9,42,Player A
4200,Randy,303,53,356,0,48,Player A
4201,Randy,285,60,345,1,52,Player A
4202,Randy,318,53,371,0,43,Player A
4203,Randy,277,62,339,1,54,Player A
4204,Randy,272,82,354,4,50,Player A
4205,Randy,311,51,362,0,46,Player A
4206,Randy,307,52,359,0,47,Player A
4207,Randy,308,98,406,11,35,Player A
4208,Randy,311,91,402,10,36,Player A
4209,Randy,299,54,353,0,49,Player A
4210,Randy,311,51,362,0,46,Player A
4211,Randy,291,56,347,0,51,Player A
4212,Randy,329,49,378,1,41,Player A
4213,Randy,290,75,365,3,46,Player A
4214,Randy,248,173,421,20,33,Player A
4215,Randy,281,76,357,4,49,Player A
4216,Randy,301,66,367,2,45,Player A
4217,Randy,280,55,335,0,55,Player A
4218,Randy,327,47,374,0,42,Player A
4219,Randy,270,65,335,0,55,Player A
4220,Randy,312,62,374,3,43,Player A
4221,Randy,322,57,379,2,41,Player A
4222,Randy,314,59,373,2,43,Player A
4223,Randy,287,72,359,3,48,Player A
4224,Randy,299,54,353,0,49,Player A
4225,Randy,314,59,373,2,43,Player A
4226,Randy,303,53,356,0,48,Player A
4227,Randy,307,52,359,0,47,Player A
4228,Randy,285,100,385,11,42,Player A
4229,Randy,302,72,374,6,44,Player A
4230,Randy,264,69,333,1,56,Player A
4231,Randy,294,74,368,3,45,Player A
4232,Randy,325,50,375,1,42,Player A
4233,Randy,268,113,381,13,44,Player A
4234,Randy,310,90,400,8,36,Player A
4235,Randy,305,55,360,1,47,Player A
4236,Randy,283,78,361,5,48,Player A
4237,Randy,291,66,357,1,48,Player A
4238,Randy,307,52,359,0,47,Player A
4239,Randy,300,60,360,1,47,Player A
4240,Randy,315,50,365,0,45,Player A
4241,Randy,259,64,323,0,59,Player A
4242,Randy,278,63,341,0,53,Player A
4243,Randy,298,73,371,3,44,Player A
4244,Randy,269,74,343,2,53,Player A
4245,Randy,299,89,388,8,40,Player A
4246,Randy,283,58,341,0,53,Player A
4247,Randy,295,55,350,0,50,Player A
4248,Randy,310,60,370,2,44,Player A
4249,Randy,250,70,320,0,60,Player A
4250,Randy,251,81,332,3,57,Player A
4251,Randy,341,46,387,1,38,Player A
4252,Randy,317,52,369,1,44,Player A
4253,Randy,301,71,372,4,44,Player A
4254,Randy,278,68,346,2,52,Player A
4255,Randy,296,61,357,1,48,Player A
4256,Randy,297,97,394,8,38,Player A
4257,Randy,243,68,311,0,63,Player A
4258,Randy,307,52,359,0,47,Player A
4259,Randy,293,68,361,2,47,Player A
4260,Randy,299,69,368,3,45,Player A
4261,Randy,295,60,355,2,49,Player A
4262,Randy,269,89,358,5,49,Player A
4263,Randy,307,52,359,0,47,Player A
4264,Randy,283,58,341,0,53,Player A
4265,Randy,276,66,342,4,54,Player A
4266,Randy,312,77,389,3,38,Player A
4267,Randy,270,60,330,1,57,Player A
4268,Randy,306,56,362,0,46,Player A
4269,Randy,268,68,336,1,55,Player A
4270,Randy,297,77,374,3,43,Player A
4271,Randy,278,63,341,0,53,Player A
4272,Randy,291,56,347,0,51,Player A
4273,Randy,316,56,372,1,43,Player A
4274,Randy,338,63,401,6,35,Player A
4275,Randy,279,59,338,0,54,Player A
4276,Randy,279,59,338,0,54,Player A
4277,Randy,291,56,347,0,51,Player A
4278,Randy,303,53,356,0,48,Player A
4279,Randy,285,80,365,6,47,Player A
4280,Randy,311,51,362,0,46,Player A
4281,Randy,239,154,393,16,41,Player A
4282,Randy,299,54,353,0,49,Player A
4283,Randy,304,59,363,1,46,Player A
4284,Randy,275,60,335,0,55,Player A
4285,Randy,302,67,369,4,45,Player A
4286,Randy,323,48,371,0,43,Player A
4287,Randy,313,53,366,1,45,Player A
4288,Randy,314,54,368,0,44,Player A
4289,Randy,296,61,357,1,48,Player A
4290,Randy,254,124,378,13,45,Player A
4291,Randy,278,68,346,2,52,Player A
4292,Randy,303,53,356,0,48,Player A
4293,Randy,281,71,352,2,50,Player A
4294,Randy,302,77,379,5,42,Player A
4295,Randy,309,54,363,1,46,Player A
4296,Randy,257,77,334,2,56,Player A
4297,Randy,255,175,430,23,31,Player A
4298,Randy,257,132,389,9,40,Player A
4299,Randy,275,75,350,3,51,Player A
4300,Randy,312,57,369,1,44,Player A
4301,Randy,315,50,365,0,45,Player A
4302,Randy,307,52,359,0,47,Player A
4303,Randy,283,58,341,0,53,Player A
4304,Randy,309,64,373,2,43,Player A
4305,Randy,277,82,359,6,49,Player A
4306,Randy,286,61,347,0,51,Player A
4307,Randy,283,58,341,0,53,Player A
4308,Randy,307,52,359,0,47,Player A
4309,Randy,297,57,354,1,49,Player A
4310,Randy,266,66,332,0,56,Player A
4311,Randy,307,52,359,0,47,Player A
4312,Randy,295,55,350,0,50,Player A
4313,Randy,315,50,365,0,45,Player A
4314,Randy,252,72,324,1,59,Player A
4315,Randy,291,56,347,0,51,Player A
4316,Randy,296,61,357,1,48,Player A
4317,Randy,286,61,347,0,51,Player A
4318,Randy,295,55,350,0,50,Player A
4319,Randy,320,45,365,0,45,Player A
4320,Randy,268,98,366,7,47,Player A
4321,Randy,331,46,377,0,41,Player A
4322,Randy,280,65,345,1,52,Player A
4323,Randy,311,51,362,0,46,Player A
4324,Randy,307,52,359,0,47,Player A
4325,Randy,306,61,367,2,45,Player A
4326,Randy,282,62,344,0,52,Player A
4327,Randy,288,68,356,3,49,Player A
4328,Randy,286,61,347,0,51,Player A
4329,Randy,310,60,370,2,44,Player A
4330,Randy,295,55,350,0,50,Player A
4331,Randy,319,49,368,0,44,Player A
4332,Randy,271,61,332,0,56,Player A
4333,Randy,307,52,359,0,47,Player A
4334,Randy,299,54,353,0,49,Player A
4335,Randy,315,50,365,0,45,Player A
4336,Randy,307,52,359,0,47,Player A
4337,Randy,303,53,356,0,48,Player A
4338,Randy,275,60,335,0,55,Player A
4339,Randy,294,59,353,0,49,Player A
4340,Randy,301,81,382,5,41,Player A
4341,Randy,337,52,389,3,38,Player A
4342,Randy,289,69,358,2,48,Player A
4343,Randy,328,53,381,1,40,Player A
4344,Randy,307,52,359,0,47,Player A
4345,Randy,351,41,392,0,36,Player A
4346,Randy,259,64,323,0,59,Player A
4347,Randy,291,76,367,5,46,Player A
4348,Randy,313,53,366,1,45,Player A
